time,price,quantity,totalq,position,b1price,b1size,s1price,s1size,bors
2016-03-25 8:59:00,9285,860,860,400732,0,0,0,0,B
2016-03-25 9:00:00,9295,284,1144,64,9285,45,9295,12,B
2016-03-25 9:00:01,9295,406,1550,70,9290,105,9295,5,B
2016-03-25 9:00:01.5,9300,296,1846,44,9295,233,9300,55,B
2016-03-25 9:00:02,9300,358,2204,-44,9300,40,9305,83,B
2016-03-25 9:00:02.5,9305,282,2486,-116,9305,24,9310,257,B
2016-03-25 9:00:03,9305,376,2862,182,9300,60,9305,9,B
2016-03-25 9:00:03.5,9305,138,3000,-64,9300,91,9305,28,B
2016-03-25 9:00:04,9300,310,3310,-44,9295,162,9300,20,S
2016-03-25 9:00:04.5,9300,154,3464,4,9300,16,9305,15,S
2016-03-25 9:00:05,9300,410,3874,-126,9300,27,9305,100,S
2016-03-25 9:00:05.5,9300,248,4122,-106,9295,50,9300,8,S
2016-03-25 9:00:06,9290,230,4352,20,9290,75,9295,57,S
2016-03-25 9:00:06.5,9300,338,4690,34,9295,1,9300,146,B
2016-03-25 9:00:07,9295,150,4840,-134,9290,29,9295,110,S
2016-03-25 9:00:08,9295,64,4904,-20,9290,35,9295,54,S
2016-03-25 9:00:08.3333,9290,110,5014,-84,9290,94,9295,84,S
2016-03-25 9:00:08.6667,9290,130,5144,-48,9290,91,9295,33,S
2016-03-25 9:00:09,9295,158,5302,28,9295,193,9300,184,B
2016-03-25 9:00:10,9305,368,5670,28,9300,7,9305,41,B
2016-03-25 9:00:10.3333,9300,40,5710,-8,9300,40,9305,44,S
2016-03-25 9:00:10.6667,9300,100,5810,22,9300,59,9305,36,S
2016-03-25 9:00:11,9305,34,5844,26,9300,40,9305,35,B
2016-03-25 9:00:12,9300,282,6126,-144,9300,122,9305,53,S
2016-03-25 9:00:12.5,9300,26,6152,2,9300,114,9305,55,S
2016-03-25 9:00:13,9300,354,6506,40,9295,233,9300,360,S
2016-03-25 9:00:13.5,9300,178,6684,100,9295,241,9300,274,S
2016-03-25 9:00:14,9295,736,7420,16,9290,87,9300,60,S
2016-03-25 9:00:14.5,9295,264,7684,134,9290,53,9295,388,S
2016-03-25 9:00:15,9295,264,7948,134,9290,119,9295,283,S
2016-03-25 9:00:15.5,9290,274,8222,176,9285,253,9295,301,S
2016-03-25 9:00:16,9290,62,8284,32,9285,332,9290,25,S
2016-03-25 9:00:16.5,9295,260,8544,150,9290,12,9295,212,B
2016-03-25 9:00:17,9295,368,8912,366,9290,20,9295,72,B
2016-03-25 9:00:17.5,9295,92,9004,84,9290,40,9295,25,B
2016-03-25 9:00:18,9295,68,9072,-6,9290,115,9300,108,B
2016-03-25 9:00:18.5,9295,4,9076,4,9295,51,9300,108,B
2016-03-25 9:00:19,9295,16,9092,12,9295,109,9300,108,B
2016-03-25 9:00:19.5,9300,238,9330,206,9300,161,9305,46,B
2016-03-25 9:00:20,9310,160,9490,72,9305,17,9310,329,B
2016-03-25 9:00:20.5,9300,268,9758,-26,9300,155,9305,59,S
2016-03-25 9:00:21,9300,122,9880,-78,9295,58,9300,77,S
2016-03-25 9:00:21.5,9300,42,9922,18,9295,48,9300,124,S
2016-03-25 9:00:22,9300,42,9964,-12,9295,37,9300,117,S
2016-03-25 9:00:22.5,9295,212,10176,-72,9290,21,9295,33,S
2016-03-25 9:00:23,9295,196,10372,6,9295,163,9300,118,S
2016-03-25 9:00:23.5,9300,100,10472,46,9295,202,9300,35,B
2016-03-25 9:00:24,9295,576,11048,428,9290,133,9295,241,S
2016-03-25 9:00:24.5,9295,86,11134,66,9290,122,9295,202,S
2016-03-25 9:00:25,9295,382,11516,368,9290,116,9295,26,S
2016-03-25 9:00:25.5,9295,234,11750,22,9295,98,9300,45,S
2016-03-25 9:00:26,9300,80,11830,-8,9295,94,9300,43,B
2016-03-25 9:00:26.5,9300,68,11898,-62,9295,92,9300,31,B
2016-03-25 9:00:27,9300,74,11972,-24,9295,120,9300,46,B
2016-03-25 9:00:27.5,9300,84,12056,-2,9295,135,9300,5,B
2016-03-25 9:00:28,9300,32,12088,12,9300,62,9305,52,B
2016-03-25 9:00:28.5,9305,10,12098,6,9300,141,9305,49,B
2016-03-25 9:00:29,9305,122,12220,-4,9305,91,9310,449,B
2016-03-25 9:00:29.5,9305,182,12402,-114,9305,113,9310,408,B
2016-03-25 9:00:30,9310,916,13318,240,9310,119,9315,443,B
2016-03-25 9:00:30.5,9310,30,13348,8,9310,110,9315,433,B
2016-03-25 9:00:31,9315,40,13388,20,9310,223,9315,426,B
2016-03-25 9:00:31.5,9315,146,13534,-20,9310,220,9315,356,B
2016-03-25 9:00:32,9315,142,13676,-24,9310,293,9315,274,B
2016-03-25 9:00:32.5,9310,76,13752,-62,9310,280,9315,292,S
2016-03-25 9:00:33,9310,68,13820,0,9310,269,9315,269,S
2016-03-25 9:00:33.5,9315,292,14112,32,9310,262,9315,133,B
2016-03-25 9:00:34,9315,54,14166,-46,9310,261,9315,128,B
2016-03-25 9:00:34.5,9310,258,14424,14,9310,242,9315,19,S
2016-03-25 9:00:35,9315,168,14592,-112,9315,1,9320,279,B
2016-03-25 9:00:35.5,9315,76,14668,44,9310,137,9315,201,B
2016-03-25 9:00:36,9315,62,14730,8,9310,138,9315,166,B
2016-03-25 9:00:36.5,9315,270,15000,182,9310,180,9315,35,B
2016-03-25 9:00:37,9315,88,15088,62,9315,53,9320,293,B
2016-03-25 9:00:37.5,9320,148,15236,30,9315,29,9320,247,B
2016-03-25 9:00:38,9320,72,15308,24,9315,81,9320,234,B
2016-03-25 9:00:38.5,9320,24,15332,6,9315,176,9320,217,B
2016-03-25 9:00:39,9315,12,15344,2,9315,241,9320,223,S
2016-03-25 9:00:39.5,9320,42,15386,12,9315,230,9320,224,B
2016-03-25 9:00:40,9315,114,15500,36,9315,221,9320,188,S
2016-03-25 9:00:40.5,9320,158,15658,-42,9315,186,9320,137,B
2016-03-25 9:00:41,9320,182,15840,44,9315,181,9320,36,B
2016-03-25 9:00:41.5,9320,114,15954,-10,9320,99,9325,187,B
2016-03-25 9:00:42,9325,72,16026,-34,9320,14,9325,172,B
2016-03-25 9:00:42.5,9320,26,16052,6,9320,77,9325,194,S
2016-03-25 9:00:43,9320,192,16244,80,9320,31,9325,179,S
2016-03-25 9:00:43.5,9325,158,16402,-14,9320,181,9325,130,B
2016-03-25 9:00:44,9320,124,16526,-48,9320,144,9325,125,S
2016-03-25 9:00:44.5,9325,258,16784,36,9325,36,9330,217,B
2016-03-25 9:00:45,9325,66,16850,24,9325,16,9330,217,B
2016-03-25 9:00:45.5,9320,140,16990,2,9315,340,9325,120,S
2016-03-25 9:00:46,9320,52,17042,16,9315,339,9325,147,S
2016-03-25 9:00:46.5,9325,220,17262,172,9320,6,9325,414,B
2016-03-25 9:00:47,9320,62,17324,2,9315,340,9320,51,S
2016-03-25 9:00:47.5,9315,102,17426,-62,9315,326,9320,44,S
2016-03-25 9:00:48,9310,854,18280,316,9310,39,9315,2,S
2016-03-25 9:00:48.5,9315,262,18542,-56,9310,63,9315,75,B
2016-03-25 9:00:49,9315,28,18570,10,9310,55,9315,77,B
2016-03-25 9:00:49.5,9310,406,18976,98,9305,51,9310,375,S
2016-03-25 9:00:50,9310,74,19050,34,9305,91,9310,370,S
2016-03-25 9:00:50.5,9305,232,19282,-14,9300,109,9305,191,S
2016-03-25 9:00:51,9305,62,19344,-22,9300,118,9305,161,S
2016-03-25 9:00:51.5,9305,42,19386,-22,9300,95,9305,146,S
2016-03-25 9:00:52,9305,48,19434,-18,9300,57,9305,140,S
2016-03-25 9:00:52.5,9305,42,19476,12,9300,52,9305,137,S
2016-03-25 9:00:53,9300,206,19682,166,9295,87,9300,455,S
2016-03-25 9:00:53.5,9295,230,19912,108,9290,183,9295,75,S
2016-03-25 9:00:54,9295,118,20030,82,9290,168,9295,31,S
2016-03-25 9:00:54.5,9295,88,20118,4,9295,74,9300,483,S
2016-03-25 9:00:55,9295,178,20296,-112,9290,184,9295,6,S
2016-03-25 9:00:55.5,9295,126,20422,104,9295,3,9300,485,S
2016-03-25 9:00:56,9295,40,20462,36,9290,185,9300,490,S
2016-03-25 9:00:56.5,9300,36,20498,12,9295,7,9300,484,B
2016-03-25 9:00:57,9300,298,20796,-52,9295,82,9305,35,B
2016-03-25 9:00:57.5,9300,82,20878,-14,9300,50,9305,8,B
2016-03-25 9:00:58,9300,52,20930,-14,9300,44,9305,29,B
2016-03-25 9:00:58.5,9300,22,20952,2,9300,36,9305,29,B
2016-03-25 9:00:59,9300,140,21092,58,9300,129,9305,29,B
2016-03-25 9:00:59.5,9305,8,21100,-4,9300,133,9305,28,B
2016-03-25 9:01:00,9300,50,21150,14,9300,143,9305,21,S
2016-03-25 9:01:00.5,9310,408,21558,-136,9305,185,9310,58,B
2016-03-25 9:01:01,9310,60,21618,-8,9305,227,9310,29,B
2016-03-25 9:01:01.5,9300,826,22444,-160,9300,30,9305,28,S
2016-03-25 9:01:02,9300,22,22466,-6,9300,54,9305,32,S
2016-03-25 9:01:02.5,9305,12,22478,10,9300,55,9305,26,B
2016-03-25 9:01:03,9305,76,22554,66,9305,55,9310,93,B
2016-03-25 9:01:03.5,9305,38,22592,2,9305,48,9310,91,B
2016-03-25 9:01:04,9305,10,22602,4,9305,43,9310,91,B
2016-03-25 9:01:04.5,9305,202,22804,124,9305,17,9310,25,B
2016-03-25 9:01:05,9305,4,22808,2,9305,55,9310,41,B
2016-03-25 9:01:05.5,9305,4,22812,0,9305,222,9310,42,B
2016-03-25 9:01:06,9305,6,22818,-2,9305,286,9310,44,B
2016-03-25 9:01:06.5,9305,2,22820,2,9305,289,9310,39,B
2016-03-25 9:01:07,9310,80,22900,40,9305,247,9310,20,B
2016-03-25 9:01:08,9310,74,22974,38,9310,284,9315,66,B
2016-03-25 9:01:08.5,9310,20,22994,10,9310,278,9315,62,B
2016-03-25 9:01:09,9310,12,23006,12,9310,323,9315,63,B
2016-03-25 9:01:09.5,9315,150,23156,74,9315,228,9320,264,B
2016-03-25 9:01:10,9320,154,23310,68,9315,187,9320,271,B
2016-03-25 9:01:10.5,9320,544,23854,-408,9320,132,9325,410,B
2016-03-25 9:01:11,9320,284,24138,-240,9320,178,9325,268,B
2016-03-25 9:01:11.5,9325,10,24148,-8,9320,175,9325,155,B
2016-03-25 9:01:12,9320,42,24190,0,9320,160,9325,148,S
2016-03-25 9:01:12.5,9325,32,24222,0,9320,148,9325,142,B
2016-03-25 9:01:13,9325,4,24226,4,9320,148,9325,149,B
2016-03-25 9:01:13.5,9325,76,24302,4,9320,147,9325,145,B
2016-03-25 9:01:14,9320,18,24320,4,9320,146,9325,138,S
2016-03-25 9:01:14.5,9325,30,24350,26,9320,147,9325,124,B
2016-03-25 9:01:15,9325,94,24444,18,9320,153,9325,79,B
2016-03-25 9:01:15.5,9325,268,24712,82,9320,139,9325,241,B
2016-03-25 9:01:16,9320,8,24720,-2,9320,136,9325,237,S
2016-03-25 9:01:16.5,9325,14,24734,-6,9320,136,9325,233,B
2016-03-25 9:01:17,9325,28,24762,0,9320,177,9325,240,B
2016-03-25 9:01:17.5,9325,22,24784,-8,9320,217,9325,229,B
2016-03-25 9:01:18,9320,8,24792,0,9320,213,9325,232,S
2016-03-25 9:01:18.5,9320,4,24796,0,9320,166,9325,249,S
2016-03-25 9:01:19,9325,30,24826,-2,9320,202,9325,337,B
2016-03-25 9:01:20,9325,130,24956,-8,9320,193,9325,284,B
2016-03-25 9:01:20.3333,9325,94,25050,-2,9320,161,9325,244,B
2016-03-25 9:01:20.6667,9320,10,25060,-6,9320,214,9325,252,S
2016-03-25 9:01:21,9320,492,25552,180,9315,129,9320,574,S
2016-03-25 9:01:22,9320,360,25912,272,9310,248,9315,49,S
2016-03-25 9:01:22.5,9315,104,26016,-40,9310,119,9315,2,S
2016-03-25 9:01:23,9310,250,26266,174,9310,110,9315,250,S
2016-03-25 9:01:23.5,9315,210,26476,210,9310,119,9315,146,B
2016-03-25 9:01:24,9315,168,26644,138,9310,112,9315,63,B
2016-03-25 9:01:24.5,9320,136,26780,134,9310,162,9320,404,B
2016-03-25 9:01:25,9315,32,26812,12,9315,1,9320,414,S
2016-03-25 9:01:26,9310,122,26934,122,9315,1,9320,365,S
2016-03-25 9:01:26.5,9315,26,26960,26,9310,83,9315,69,B
2016-03-25 9:01:27,9310,100,27060,6,9310,103,9315,23,S
2016-03-25 9:01:27.5,9310,32,27092,2,9310,93,9315,20,S
2016-03-25 9:01:28,9320,100,27192,100,9310,141,9320,350,B
2016-03-25 9:01:28.5,9315,36,27228,32,9310,100,9315,17,S
2016-03-25 9:01:29,9315,32,27260,24,9310,111,9315,5,S
2016-03-25 9:01:29.5,9310,16,27276,12,9310,104,9315,9,S
2016-03-25 9:01:30,9315,30,27306,14,9315,5,9320,362,B
2016-03-25 9:01:30.5,9315,216,27522,2,9310,103,9315,89,B
2016-03-25 9:01:31,9315,298,27820,116,9310,85,9320,370,B
2016-03-25 9:01:31.5,9310,172,27992,108,9310,65,9315,92,S
2016-03-25 9:01:32,9315,330,28322,158,9315,191,9320,371,B
2016-03-25 9:01:33,9315,8,28330,0,9315,184,9320,395,B
2016-03-25 9:01:33.5,9315,2,28332,2,9315,286,9320,405,B
2016-03-25 9:01:34,9315,8,28340,6,9315,333,9320,405,B
2016-03-25 9:01:34.5,9315,116,28456,116,9315,276,9320,407,B
2016-03-25 9:01:35,9320,44,28500,42,9315,279,9320,391,B
2016-03-25 9:01:36,9315,20,28520,2,9315,293,9320,395,S
2016-03-25 9:01:36.5,9315,2,28522,2,9315,293,9320,386,S
2016-03-25 9:01:37,9315,2,28524,2,9315,292,9320,374,S
2016-03-25 9:01:38,9320,8,28532,4,9315,334,9320,359,B
2016-03-25 9:01:38.5,9315,62,28594,62,9315,303,9320,362,S
2016-03-25 9:01:39,9315,28,28622,8,9315,301,9320,349,S
2016-03-25 9:01:40,9320,218,28840,218,9315,286,9320,246,B
2016-03-25 9:01:40.5,9315,412,29252,338,9315,305,9320,44,S
2016-03-25 9:01:41,9320,86,29338,-24,9320,335,9325,424,B
2016-03-25 9:01:41.5,9320,100,29438,0,9320,141,9325,424,B
2016-03-25 9:01:42,9320,22,29460,20,9315,294,9320,72,B
2016-03-25 9:01:42.5,9325,202,29662,146,9315,296,9320,20,B
2016-03-25 9:01:43,9320,4,29666,4,9315,295,9320,23,S
2016-03-25 9:01:43.5,9320,2,29668,2,9315,326,9320,50,S
2016-03-25 9:01:44,9320,46,29714,44,9315,326,9320,33,S
2016-03-25 9:01:44.5,9320,70,29784,56,9320,65,9325,400,S
2016-03-25 9:01:45,9320,94,29878,52,9320,25,9325,405,S
2016-03-25 9:01:45.5,9320,112,29990,38,9320,16,9325,467,S
2016-03-25 9:01:46,9320,34,30024,-28,9315,355,9320,29,S
2016-03-25 9:01:46.5,9325,204,30228,66,9315,354,9320,2,B
2016-03-25 9:01:47,9320,42,30270,-18,9315,354,9320,41,S
2016-03-25 9:01:47.5,9320,2,30272,0,9315,349,9320,54,S
2016-03-25 9:01:48,9315,16,30288,14,9315,366,9320,59,S
2016-03-25 9:01:49,9320,104,30392,98,9315,366,9320,26,B
2016-03-25 9:01:49.5,9315,14,30406,4,9315,370,9320,25,S
2016-03-25 9:01:50,9315,2,30408,2,9315,378,9320,69,S
2016-03-25 9:01:51,9320,2,30410,0,9315,371,9320,84,B
2016-03-25 9:01:52,9315,8,30418,8,9315,367,9320,88,S
2016-03-25 9:01:53,9320,14,30432,2,9315,265,9320,88,B
2016-03-25 9:01:54,9320,38,30470,26,9315,201,9320,184,B
2016-03-25 9:01:54.5,9315,402,30872,308,9310,265,9315,34,S
2016-03-25 9:01:55,9315,180,31052,152,9310,245,9315,37,S
2016-03-25 9:01:55.5,9320,172,31224,132,9310,194,9320,195,B
2016-03-25 9:01:56,9315,26,31250,22,9315,132,9320,120,S
2016-03-25 9:01:57,9315,6,31256,6,9315,178,9320,198,S
2016-03-25 9:01:57.5,9320,30,31286,4,9315,166,9320,196,B
2016-03-25 9:01:58,9315,4,31290,2,9315,166,9320,180,S
2016-03-25 9:01:58.5,9315,4,31294,4,9315,164,9320,181,S
2016-03-25 9:01:59,9320,70,31364,18,9315,129,9320,174,B
2016-03-25 9:01:59.5,9320,70,31434,64,9315,185,9320,147,B
2016-03-25 9:02:00,9315,10,31444,10,9315,142,9320,147,S
2016-03-25 9:02:00.5,9320,20,31464,20,9315,120,9320,162,B
2016-03-25 9:02:01,9315,278,31742,158,9315,166,9320,26,S
2016-03-25 9:02:01.5,9320,76,31818,-34,9320,90,9325,272,B
2016-03-25 9:02:02,9320,8,31826,-6,9320,143,9325,275,B
2016-03-25 9:02:02.5,9325,432,32258,-346,9320,172,9325,74,B
2016-03-25 9:02:03,9325,156,32414,-76,9325,397,9330,424,B
2016-03-25 9:02:03.5,9325,26,32440,4,9325,448,9330,421,B
2016-03-25 9:02:04,9330,88,32528,-62,9325,500,9330,356,B
2016-03-25 9:02:04.5,9330,98,32626,28,9325,184,9330,316,B
2016-03-25 9:02:05,9330,716,33342,-366,9330,289,9335,313,B
2016-03-25 9:02:05.5,9330,10,33352,0,9330,392,9335,303,B
2016-03-25 9:02:06,9335,226,33578,-124,9330,413,9335,217,B
2016-03-25 9:02:06.5,9335,38,33616,30,9330,461,9335,213,B
2016-03-25 9:02:07,9330,18,33634,0,9330,461,9335,256,S
2016-03-25 9:02:07.5,9335,12,33646,2,9330,465,9335,246,B
2016-03-25 9:02:08,9330,44,33690,0,9330,419,9335,306,S
2016-03-25 9:02:08.5,9330,48,33738,6,9330,419,9335,283,S
2016-03-25 9:02:09,9330,16,33754,8,9330,413,9335,305,S
2016-03-25 9:02:09.5,9330,10,33764,6,9330,414,9335,314,S
2016-03-25 9:02:10,9330,78,33842,-32,9330,410,9335,275,S
2016-03-25 9:02:10.5,9335,256,34098,38,9330,451,9335,106,B
2016-03-25 9:02:11,9335,286,34384,-14,9335,174,9340,381,B
2016-03-25 9:02:11.5,9335,108,34492,108,9335,183,9340,342,B
2016-03-25 9:02:12,9335,16,34508,2,9335,297,9340,329,B
2016-03-25 9:02:13,9335,50,34558,10,9335,283,9340,301,B
2016-03-25 9:02:13.3333,9335,2,34560,2,9335,302,9340,298,B
2016-03-25 9:02:13.6667,9340,208,34768,70,9335,300,9340,191,B
2016-03-25 9:02:14,9340,6,34774,-2,9335,408,9340,166,B
2016-03-25 9:02:14.5,9340,120,34894,-38,9335,362,9340,85,B
2016-03-25 9:02:15,9340,218,35112,64,9340,31,9345,446,B
2016-03-25 9:02:16,9340,114,35226,28,9340,10,9345,519,B
2016-03-25 9:02:16.5,9340,106,35332,60,9340,104,9345,529,B
2016-03-25 9:02:17,9340,350,35682,108,9340,104,9345,364,B
2016-03-25 9:02:17.5,9340,4,35686,0,9340,175,9345,366,B
2016-03-25 9:02:18,9345,2,35688,-2,9340,192,9345,262,B
2016-03-25 9:02:18.5,9345,18,35706,-12,9340,198,9345,254,B
2016-03-25 9:02:19,9340,86,35792,60,9340,181,9345,248,S
2016-03-25 9:02:19.5,9340,28,35820,28,9340,168,9345,247,S
2016-03-25 9:02:20,9345,108,35928,60,9340,177,9345,195,B
2016-03-25 9:02:20.5,9340,478,36406,238,9335,395,9340,309,S
2016-03-25 9:02:21,9335,28,36434,0,9335,362,9340,351,S
2016-03-25 9:02:22,9335,792,37226,662,9330,574,9335,104,S
2016-03-25 9:02:22.5,9335,96,37322,60,9330,310,9335,119,S
2016-03-25 9:02:23,9335,26,37348,2,9330,274,9335,211,S
2016-03-25 9:02:23.5,9330,318,37666,238,9330,99,9335,209,S
2016-03-25 9:02:24,9330,4,37670,2,9330,79,9335,213,S
2016-03-25 9:02:24.5,9335,20,37690,-10,9330,116,9335,225,B
2016-03-25 9:02:25,9330,6,37696,-6,9330,137,9335,226,S
2016-03-25 9:02:26,9335,22,37718,20,9330,153,9335,215,B
2016-03-25 9:02:26.5,9330,24,37742,6,9330,142,9335,218,S
2016-03-25 9:02:27,9330,8,37750,4,9330,267,9335,219,S
2016-03-25 9:02:27.5,9330,72,37822,16,9330,202,9335,209,S
2016-03-25 9:02:28,9330,40,37862,6,9330,195,9335,194,S
2016-03-25 9:02:29,9335,310,38172,-52,9330,284,9335,35,B
2016-03-25 9:02:29.5,9335,90,38262,-2,9335,220,9340,418,B
2016-03-25 9:02:30,9335,422,38684,180,9335,73,9340,369,B
2016-03-25 9:02:30.5,9335,116,38800,-34,9335,81,9340,370,B
2016-03-25 9:02:31,9335,210,39010,196,9330,257,9340,366,B
2016-03-25 9:02:31.5,9340,102,39112,102,9335,98,9340,316,B
2016-03-25 9:02:32,9335,2,39114,2,9335,74,9340,316,S
2016-03-25 9:02:32.5,9335,2,39116,2,9335,70,9340,318,S
2016-03-25 9:02:33,9335,8,39124,8,9335,78,9340,327,S
2016-03-25 9:02:33.5,9335,266,39390,240,9335,118,9340,209,S
2016-03-25 9:02:34,9335,20,39410,20,9335,95,9340,204,S
2016-03-25 9:02:34.5,9335,24,39434,20,9335,40,9340,194,S
2016-03-25 9:02:35,9335,14,39448,0,9330,295,9340,196,S
2016-03-25 9:02:35.5,9335,20,39468,8,9330,297,9340,195,S
2016-03-25 9:02:36,9335,436,39904,200,9335,129,9340,30,S
2016-03-25 9:02:36.5,9340,180,40084,14,9335,186,9340,239,B
2016-03-25 9:02:37,9340,20,40104,-4,9335,131,9340,272,B
2016-03-25 9:02:37.5,9340,152,40256,-24,9335,121,9340,211,B
2016-03-25 9:02:38,9330,286,40542,114,9330,283,9335,402,S
2016-03-25 9:02:39,9335,190,40732,188,9330,275,9335,327,B
2016-03-25 9:02:39.5,9335,204,40936,202,9330,255,9335,226,B
2016-03-25 9:02:40,9335,6,40942,6,9330,277,9335,224,B
2016-03-25 9:02:41,9340,522,41464,118,9335,86,9340,214,B
2016-03-25 9:02:41.5,9340,4,41468,0,9335,94,9340,226,B
2016-03-25 9:02:42,9340,4,41472,4,9335,215,9340,264,B
2016-03-25 9:02:42.5,9335,324,41796,270,9335,67,9340,274,S
2016-03-25 9:02:43,9340,156,41952,38,9330,266,9340,220,B
2016-03-25 9:02:43.5,9335,32,41984,-16,9330,316,9340,248,S
2016-03-25 9:02:44,9340,94,42078,-76,9330,318,9340,211,B
2016-03-25 9:02:44.5,9340,8,42086,-8,9335,62,9340,214,B
2016-03-25 9:02:45,9340,20,42106,16,9335,44,9340,233,B
2016-03-25 9:02:45.5,9340,222,42328,62,9335,62,9340,164,B
2016-03-25 9:02:46,9340,324,42652,-216,9335,63,9340,12,B
2016-03-25 9:02:46.5,9335,44,42696,10,9335,117,9340,73,S
2016-03-25 9:02:47,9335,2,42698,0,9335,142,9340,102,S
2016-03-25 9:02:47.5,9340,4,42702,2,9335,67,9340,143,B
2016-03-25 9:02:48,9335,220,42922,100,9335,85,9340,111,S
2016-03-25 9:02:49,9335,4,42926,0,9335,85,9340,115,S
2016-03-25 9:02:49.5,9340,268,43194,126,9335,107,9340,1,B
2016-03-25 9:02:50,9340,72,43266,-52,9335,130,9345,373,B
2016-03-25 9:02:50.5,9335,56,43322,-6,9335,145,9340,45,S
2016-03-25 9:02:51,9340,122,43444,-22,9335,100,9340,19,B
2016-03-25 9:02:52,9340,40,43484,4,9340,83,9345,386,B
2016-03-25 9:02:52.5,9345,6,43490,4,9340,86,9345,384,B
2016-03-25 9:02:53,9340,22,43512,8,9340,137,9345,378,S
2016-03-25 9:02:53.5,9340,12,43524,12,9340,80,9345,378,S
2016-03-25 9:02:54,9340,20,43544,20,9340,80,9345,378,S
2016-03-25 9:02:55,9345,6,43550,6,9340,78,9345,381,B
2016-03-25 9:02:55.5,9340,40,43590,20,9340,68,9345,381,S
2016-03-25 9:02:56,9340,136,43726,-2,9335,150,9340,50,S
2016-03-25 9:02:56.5,9340,44,43770,-30,9335,139,9340,62,S
2016-03-25 9:02:57,9340,198,43968,16,9340,51,9345,404,S
2016-03-25 9:02:57.5,9340,38,44006,6,9340,169,9345,397,S
2016-03-25 9:02:58,9345,16,44022,-2,9340,694,9345,389,B
2016-03-25 9:02:58.5,9345,336,44358,332,9340,365,9345,355,B
2016-03-25 9:02:59,9345,2,44360,0,9340,221,9345,384,B
2016-03-25 9:02:59.5,9340,42,44402,40,9340,199,9345,385,S
2016-03-25 9:03:00,9340,270,44672,-210,9335,157,9345,389,S
2016-03-25 9:03:00.5,9340,74,44746,24,9335,136,9340,28,S
2016-03-25 9:03:01,9335,30,44776,0,9335,145,9340,31,S
2016-03-25 9:03:01.5,9340,60,44836,-28,9335,140,9340,238,B
2016-03-25 9:03:02,9335,6,44842,6,9335,124,9340,250,S
2016-03-25 9:03:02.5,9340,2,44844,2,9335,124,9340,255,B
2016-03-25 9:03:03,9335,6,44850,0,9335,120,9340,303,S
2016-03-25 9:03:04,9340,32,44882,16,9335,146,9340,481,B
2016-03-25 9:03:04.5,9340,356,45238,254,9335,152,9340,314,B
2016-03-25 9:03:05,9335,14,45252,-8,9335,146,9340,321,S
2016-03-25 9:03:05.5,9335,4,45256,4,9335,149,9340,322,S
2016-03-25 9:03:06,9335,50,45306,20,9335,135,9340,313,S
2016-03-25 9:03:06.5,9340,248,45554,42,9335,112,9340,218,B
2016-03-25 9:03:07,9340,2,45556,0,9335,132,9340,225,B
2016-03-25 9:03:07.5,9340,464,46020,328,9340,240,9345,573,B
2016-03-25 9:03:08,9340,18,46038,2,9340,234,9345,442,B
2016-03-25 9:03:09,9340,6,46044,0,9340,290,9345,412,B
2016-03-25 9:03:10,9345,206,46250,132,9340,288,9345,316,B
2016-03-25 9:03:10.5,9345,338,46588,-338,9340,337,9345,152,B
2016-03-25 9:03:11,9345,228,46816,82,9340,330,9345,36,B
2016-03-25 9:03:11.5,9345,26,46842,20,9340,400,9345,24,B
2016-03-25 9:03:12,9340,50,46892,8,9340,400,9350,733,S
2016-03-25 9:03:12.5,9340,4,46896,-2,9345,30,9350,701,S
2016-03-25 9:03:13,9345,30,46926,-8,9345,145,9350,620,B
2016-03-25 9:03:14,9350,20,46946,6,9345,137,9350,619,B
2016-03-25 9:03:14.5,9345,126,47072,106,9345,79,9350,612,S
2016-03-25 9:03:15,9345,18,47090,0,9345,83,9350,603,S
2016-03-25 9:03:15.5,9350,40,47130,40,9345,85,9350,583,B
2016-03-25 9:03:16,9345,4,47134,0,9345,90,9350,583,S
2016-03-25 9:03:16.5,9345,184,47318,-108,9340,272,9345,61,S
2016-03-25 9:03:17,9345,36,47354,-18,9340,171,9345,218,S
2016-03-25 9:03:17.5,9340,8,47362,6,9340,34,9345,229,S
2016-03-25 9:03:18,9340,110,47472,60,9335,249,9340,12,S
2016-03-25 9:03:18.5,9340,48,47520,-48,9335,277,9340,16,S
2016-03-25 9:03:19,9340,24,47544,-24,9335,270,9340,24,S
2016-03-25 9:03:19.5,9345,126,47670,-2,9335,316,9345,196,B
2016-03-25 9:03:20,9340,16,47686,-4,9335,315,9340,3,S
2016-03-25 9:03:20.5,9345,50,47736,30,9340,9,9345,190,B
2016-03-25 9:03:21,9340,30,47766,0,9340,135,9345,229,S
2016-03-25 9:03:22,9340,40,47806,16,9340,95,9345,219,S
2016-03-25 9:03:22.5,9340,6,47812,0,9340,182,9345,221,S
2016-03-25 9:03:23,9340,2,47814,0,9340,216,9345,221,S
2016-03-25 9:03:23.5,9345,130,47944,118,9340,216,9345,170,B
2016-03-25 9:03:24,9345,10,47954,10,9340,281,9345,153,B
2016-03-25 9:03:24.5,9345,32,47986,10,9340,215,9345,155,B
2016-03-25 9:03:25,9345,122,48108,116,9340,258,9345,94,B
2016-03-25 9:03:26,9345,10,48118,4,9340,222,9345,94,B
2016-03-25 9:03:27,9345,4,48122,4,9340,217,9345,94,B
2016-03-25 9:03:28,9340,2,48124,0,9340,261,9345,93,S
2016-03-25 9:03:28.5,9345,244,48368,108,9340,301,9345,7,B
2016-03-25 9:03:29,9345,28,48396,-2,9345,10,9350,623,B
2016-03-25 9:03:29.5,9345,30,48426,12,9340,262,9345,216,B
2016-03-25 9:03:30,9345,262,48688,-108,9340,251,9345,253,B
2016-03-25 9:03:30.5,9345,2,48690,0,9340,216,9345,253,B
2016-03-25 9:03:31,9345,12,48702,12,9340,196,9345,277,B
2016-03-25 9:03:31.5,9340,40,48742,0,9340,297,9345,264,S
2016-03-25 9:03:32,9340,42,48784,2,9340,273,9345,269,S
2016-03-25 9:03:32.5,9340,86,48870,-12,9340,147,9345,185,S
2016-03-25 9:03:33,9345,44,48914,26,9340,104,9345,187,B
2016-03-25 9:03:33.5,9345,370,49284,22,9335,394,9345,146,B
2016-03-25 9:03:34,9340,200,49484,36,9335,418,9340,131,S
2016-03-25 9:03:34.5,9340,14,49498,10,9335,419,9340,126,S
2016-03-25 9:03:35,9340,30,49528,30,9335,355,9340,136,S
2016-03-25 9:03:36,9340,380,49908,-4,9335,352,9340,63,S
2016-03-25 9:03:36.5,9340,232,50140,106,9340,27,9345,166,S
2016-03-25 9:03:37,9340,22,50162,0,9340,237,9345,189,S
2016-03-25 9:03:37.5,9340,2,50164,0,9340,227,9345,183,S
2016-03-25 9:03:38,9340,6,50170,2,9340,324,9345,168,S
2016-03-25 9:03:38.5,9340,202,50372,180,9340,369,9345,47,S
2016-03-25 9:03:39,9345,126,50498,-2,9340,253,9345,15,B
2016-03-25 9:03:39.5,9345,38,50536,-38,9345,182,9350,750,B
2016-03-25 9:03:40,9345,84,50620,-4,9345,140,9350,750,B
2016-03-25 9:03:41,9345,6,50626,0,9345,241,9350,753,B
2016-03-25 9:03:41.5,9345,4,50630,0,9345,241,9350,793,B
2016-03-25 9:03:42,9345,24,50654,0,9345,229,9350,793,B
2016-03-25 9:03:42.5,9350,98,50752,48,9345,194,9350,745,B
2016-03-25 9:03:43,9345,40,50792,0,9345,196,9350,745,S
2016-03-25 9:03:43.5,9345,10,50802,-10,9345,192,9350,750,S
2016-03-25 9:03:44,9350,324,51126,68,9345,153,9350,608,B
2016-03-25 9:03:44.5,9345,64,51190,0,9345,121,9350,607,S
2016-03-25 9:03:45,9350,44,51234,0,9345,146,9350,588,B
2016-03-25 9:03:45.5,9350,678,51912,-512,9345,205,9350,250,B
2016-03-25 9:03:46,9350,504,52416,-38,9350,77,9355,182,B
2016-03-25 9:03:46.5,9355,184,52600,54,9350,145,9355,95,B
2016-03-25 9:03:47,9350,24,52624,-20,9350,187,9355,111,S
2016-03-25 9:03:47.5,9355,218,52842,-38,9355,5,9360,738,B
2016-03-25 9:03:48,9350,38,52880,-4,9350,178,9355,163,S
2016-03-25 9:03:48.5,9355,288,53168,48,9350,178,9355,29,B
2016-03-25 9:03:49,9355,188,53356,130,9355,14,9360,435,B
2016-03-25 9:03:49.5,9350,60,53416,38,9350,107,9355,43,S
2016-03-25 9:03:50,9355,42,53458,-30,9350,123,9355,298,B
2016-03-25 9:03:50.5,9355,10,53468,10,9350,101,9355,326,B
2016-03-25 9:03:51,9355,298,53766,190,9350,98,9355,177,B
2016-03-25 9:03:51.5,9355,22,53788,22,9350,91,9355,171,B
2016-03-25 9:03:52,9355,22,53810,22,9350,119,9355,201,B
2016-03-25 9:03:52.5,9355,32,53842,2,9350,230,9355,188,B
2016-03-25 9:03:53,9355,150,53992,20,9350,228,9355,141,B
2016-03-25 9:03:54,9355,282,54274,84,9355,124,9360,468,B
2016-03-25 9:03:54.5,9355,2,54276,2,9355,196,9360,468,B
2016-03-25 9:03:55,9355,10,54286,0,9355,202,9360,479,B
2016-03-25 9:03:55.5,9355,162,54448,62,9355,227,9360,409,B
2016-03-25 9:03:56,9355,4,54452,4,9355,230,9360,437,B
2016-03-25 9:03:56.5,9355,316,54768,64,9355,222,9360,298,B
2016-03-25 9:03:57,9355,104,54872,0,9355,170,9360,321,B
2016-03-25 9:03:57.5,9360,60,54932,-30,9355,163,9360,295,B
2016-03-25 9:03:58,9355,38,54970,-18,9355,162,9360,291,S
2016-03-25 9:03:58.5,9355,2,54972,2,9355,183,9360,341,S
2016-03-25 9:03:59,9360,12,54984,-2,9355,182,9360,338,B
2016-03-25 9:04:00,9355,22,55006,22,9355,173,9360,332,S
2016-03-25 9:04:00.5,9360,138,55144,-18,9355,133,9360,265,B
2016-03-25 9:04:01,9360,6,55150,-2,9355,256,9360,264,B
2016-03-25 9:04:01.5,9355,46,55196,-40,9355,235,9360,246,S
2016-03-25 9:04:02,9355,166,55362,-84,9355,186,9360,226,S
2016-03-25 9:04:02.5,9360,268,55630,48,9355,166,9360,116,B
2016-03-25 9:04:03,9355,864,56494,544,9350,430,9355,91,S
2016-03-25 9:04:03.5,9355,224,56718,208,9355,200,9360,111,S
2016-03-25 9:04:04,9360,216,56934,110,9360,4,9365,507,B
2016-03-25 9:04:04.5,9355,52,56986,6,9355,185,9360,82,S
2016-03-25 9:04:05,9355,6,56992,-4,9355,168,9360,73,S
2016-03-25 9:04:05.5,9360,1392,58384,-198,9360,197,9365,21,B
2016-03-25 9:04:06,9370,852,59236,60,9365,175,9370,120,B
2016-03-25 9:04:06.5,9370,462,59698,-122,9370,69,9375,414,B
2016-03-25 9:04:07,9370,954,60652,-156,9365,130,9370,231,B
2016-03-25 9:04:07.5,9365,280,60932,130,9360,265,9365,380,S
2016-03-25 9:04:08,9365,10,60942,10,9360,197,9365,384,S
2016-03-25 9:04:08.5,9365,36,60978,2,9360,200,9365,368,S
2016-03-25 9:04:09,9365,54,61032,34,9360,213,9365,354,S
2016-03-25 9:04:09.5,9365,4,61036,4,9360,222,9365,353,S
2016-03-25 9:04:10,9365,42,61078,40,9360,239,9365,333,S
2016-03-25 9:04:10.5,9360,4,61082,4,9360,235,9365,346,S
2016-03-25 9:04:11,9365,36,61118,20,9360,234,9365,337,B
2016-03-25 9:04:11.5,9365,40,61158,20,9360,237,9365,323,B
2016-03-25 9:04:12,9360,2,61160,0,9360,234,9365,326,S
2016-03-25 9:04:12.5,9365,102,61262,100,9360,234,9365,277,B
2016-03-25 9:04:13,9360,72,61334,62,9360,228,9365,253,S
2016-03-25 9:04:13.5,9365,2,61336,0,9360,228,9365,275,B
2016-03-25 9:04:14,9360,20,61356,0,9360,248,9365,277,S
2016-03-25 9:04:14.5,9360,512,61868,-22,9355,316,9360,93,S
2016-03-25 9:04:15,9355,180,62048,-6,9355,208,9360,28,S
2016-03-25 9:04:15.5,9360,142,62190,110,9360,2,9365,361,B
2016-03-25 9:04:16,9365,32,62222,2,9360,23,9365,360,B
2016-03-25 9:04:16.5,9360,34,62256,4,9360,80,9365,309,S
2016-03-25 9:04:17,9360,222,62478,178,9355,279,9360,68,S
2016-03-25 9:04:17.5,9360,18,62496,18,9355,271,9360,71,S
2016-03-25 9:04:18,9355,2,62498,0,9355,224,9360,92,S
2016-03-25 9:04:18.5,9360,4,62502,0,9355,204,9360,130,B
2016-03-25 9:04:19,9355,468,62970,300,9350,291,9355,6,S
2016-03-25 9:04:19.5,9355,26,62996,20,9350,255,9355,54,S
2016-03-25 9:04:20,9355,12,63008,2,9350,240,9355,55,S
2016-03-25 9:04:20.5,9345,566,63574,410,9345,291,9350,257,S
2016-03-25 9:04:21,9350,102,63676,102,9345,291,9350,259,B
2016-03-25 9:04:21.5,9350,516,64192,-92,9350,71,9355,181,B
2016-03-25 9:04:22,9355,4,64196,0,9350,78,9355,186,B
2016-03-25 9:04:22.5,9350,110,64306,4,9350,50,9355,191,S
2016-03-25 9:04:23,9350,204,64510,96,9345,198,9355,196,S
2016-03-25 9:04:23.5,9355,52,64562,32,9350,178,9355,185,B
2016-03-25 9:04:24,9355,24,64586,14,9350,121,9355,173,B
2016-03-25 9:04:24.5,9350,210,64796,0,9350,21,9355,178,S
2016-03-25 9:04:25,9350,18,64814,-2,9350,49,9355,213,S
2016-03-25 9:04:25.5,9350,16,64830,-4,9350,42,9355,235,S
2016-03-25 9:04:26,9350,8,64838,4,9350,69,9355,274,S
2016-03-25 9:04:27,9350,30,64868,30,9350,56,9355,266,S
2016-03-25 9:04:28,9350,26,64894,20,9350,61,9355,271,S
2016-03-25 9:04:28.5,9350,102,64996,2,9350,248,9355,220,S
2016-03-25 9:04:29,9350,826,65822,736,9345,254,9350,133,S
2016-03-25 9:04:29.5,9350,420,66242,40,9345,81,9350,113,S
2016-03-25 9:04:30,9350,26,66268,0,9345,130,9350,73,S
2016-03-25 9:04:30.5,9350,152,66420,114,9350,146,9355,270,S
2016-03-25 9:04:31,9350,10,66430,10,9350,164,9355,280,S
2016-03-25 9:04:31.5,9350,4,66434,2,9350,163,9355,301,S
2016-03-25 9:04:32,9350,22,66456,2,9350,166,9355,213,S
2016-03-25 9:04:32.5,9350,6,66462,4,9350,206,9355,213,S
2016-03-25 9:04:33,9355,24,66486,0,9350,163,9355,255,B
2016-03-25 9:04:33.5,9350,2,66488,0,9350,165,9355,309,S
2016-03-25 9:04:34,9350,40,66528,40,9350,145,9355,232,S
2016-03-25 9:04:34.5,9355,2,66530,0,9350,195,9355,203,B
2016-03-25 9:04:35,9350,6,66536,2,9350,191,9355,168,S
2016-03-25 9:04:35.5,9350,446,66982,-118,9350,244,9360,289,S
2016-03-25 9:04:36,9350,2,66984,2,9350,261,9355,63,S
2016-03-25 9:04:36.5,9350,24,67008,24,9350,250,9355,68,S
2016-03-25 9:04:37,9350,18,67026,14,9350,241,9355,140,S
2016-03-25 9:04:37.5,9355,62,67088,-2,9350,240,9355,113,B
2016-03-25 9:04:38,9355,36,67124,-14,9350,234,9355,126,B
2016-03-25 9:04:39,9355,140,67264,110,9350,239,9355,38,B
2016-03-25 9:04:39.5,9350,24,67288,4,9350,237,9355,88,S
2016-03-25 9:04:41,9350,424,67712,318,9345,285,9350,373,S
2016-03-25 9:04:43,9350,460,68172,444,9345,257,9350,96,S
2016-03-25 9:04:44,9345,148,68320,124,9345,303,9350,23,S
2016-03-25 9:04:44.5,9350,28,68348,-24,9345,307,9350,46,B
2016-03-25 9:04:45,9350,8,68356,-6,9345,307,9350,43,B
2016-03-25 9:04:45.5,9345,2,68358,-2,9345,307,9350,43,S
2016-03-25 9:04:46,9350,100,68458,-28,9345,266,9355,219,B
2016-03-25 9:04:47,9345,76,68534,-50,9345,245,9350,10,S
2016-03-25 9:04:48,9350,210,68744,2,9345,288,9350,16,B
2016-03-25 9:04:48.5,9350,20,68764,6,9345,278,9350,24,B
2016-03-25 9:04:49,9350,120,68884,0,9345,258,9350,108,B
2016-03-25 9:04:49.5,9350,20,68904,2,9345,198,9350,101,B
2016-03-25 9:04:50,9350,12,68916,-2,9345,116,9350,161,B
2016-03-25 9:04:50.5,9350,20,68936,-20,9345,126,9350,151,B
2016-03-25 9:04:51,9350,120,69056,0,9345,171,9350,157,B
2016-03-25 9:04:52,9345,4,69060,0,9345,190,9350,167,S
2016-03-25 9:04:52.5,9345,36,69096,0,9345,369,9350,66,S
2016-03-25 9:04:53,9350,24,69120,4,9345,375,9350,76,B
2016-03-25 9:04:54,9345,6,69126,0,9345,367,9350,80,S
2016-03-25 9:04:54.5,9350,2,69128,0,9345,389,9350,80,B
2016-03-25 9:04:55,9350,20,69148,-20,9345,378,9350,71,B
2016-03-25 9:04:55.5,9350,58,69206,2,9345,381,9350,72,B
2016-03-25 9:04:56,9350,2,69208,0,9345,387,9350,73,B
2016-03-25 9:04:56.5,9345,64,69272,-24,9345,348,9350,53,S
2016-03-25 9:04:57,9350,108,69380,-18,9350,46,9355,243,B
2016-03-25 9:04:57.5,9350,10,69390,-6,9350,47,9355,249,B
2016-03-25 9:04:58,9350,104,69494,-96,9350,55,9355,199,B
2016-03-25 9:04:58.5,9350,26,69520,-6,9350,42,9355,200,B
2016-03-25 9:04:59,9350,20,69540,-18,9350,124,9355,200,B
2016-03-25 9:05:00,9355,144,69684,48,9350,150,9355,184,B
2016-03-25 9:05:00.5,9350,372,70056,130,9350,133,9355,52,S
2016-03-25 9:05:01,9355,252,70308,82,9355,502,9360,449,B
2016-03-25 9:05:01.5,9360,878,71186,-544,9360,87,9365,573,B
2016-03-25 9:05:02,9350,380,71566,-350,9355,8,9360,143,S
2016-03-25 9:05:02.5,9355,132,71698,-124,9350,116,9355,20,B
2016-03-25 9:05:03,9350,244,71942,-84,9350,2,9355,97,S
2016-03-25 9:05:03.5,9350,82,72024,-18,9350,63,9355,146,S
2016-03-25 9:05:04,9350,22,72046,2,9350,62,9355,198,S
2016-03-25 9:05:05,9350,128,72174,-102,9345,192,9355,195,S
2016-03-25 9:05:05.5,9355,4,72178,4,9350,25,9355,193,B
2016-03-25 9:05:06,9350,38,72216,36,9345,281,9350,1,S
2016-03-25 9:05:06.5,9350,58,72274,24,9350,173,9355,149,S
2016-03-25 9:05:07,9350,90,72364,-30,9350,139,9355,387,S
2016-03-25 9:05:07.5,9355,16,72380,-2,9350,145,9355,148,B
2016-03-25 9:05:08,9350,2,72382,0,9350,204,9355,151,S
2016-03-25 9:05:09,9350,14,72396,0,9350,216,9355,126,S
2016-03-25 9:05:11,9350,74,72470,0,9350,237,9355,113,S
2016-03-25 9:05:12,9355,14,72484,0,9350,259,9355,115,B
2016-03-25 9:05:13,9355,10,72494,10,9350,266,9355,194,B
2016-03-25 9:05:13.5,9350,8,72502,0,9350,262,9355,198,S
2016-03-25 9:05:14,9355,2,72504,2,9350,285,9355,198,B
2016-03-25 9:05:15,9355,44,72548,2,9350,271,9355,177,B
2016-03-25 9:05:16,9350,260,72808,124,9350,285,9355,6,S
2016-03-25 9:05:17,9355,22,72830,-16,9355,88,9360,309,B
2016-03-25 9:05:17.5,9355,12,72842,0,9355,97,9360,292,B
2016-03-25 9:05:18,9350,202,73044,-144,9355,12,9360,292,S
2016-03-25 9:05:18.5,9355,18,73062,14,9350,226,9355,75,B
2016-03-25 9:05:19,9350,110,73172,-26,9350,233,9360,302,S
2016-03-25 9:05:19.5,9355,12,73184,2,9355,7,9360,334,B
2016-03-25 9:05:20,9360,20,73204,-20,9355,40,9360,352,B
2016-03-25 9:05:20.5,9360,36,73240,28,9355,72,9360,388,B
2016-03-25 9:05:21,9355,196,73436,-84,9350,273,9355,37,S
2016-03-25 9:05:21.5,9350,38,73474,-30,9350,254,9355,33,S
2016-03-25 9:05:22,9355,26,73500,0,9350,223,9355,21,B
2016-03-25 9:05:22.5,9355,4,73504,0,9350,230,9355,55,B
2016-03-25 9:05:23,9355,12,73516,0,9350,271,9355,54,B
2016-03-25 9:05:23.5,9355,2,73518,2,9350,272,9355,104,B
2016-03-25 9:05:24,9350,2,73520,0,9350,264,9355,104,S
2016-03-25 9:05:24.5,9350,50,73570,-30,9350,226,9355,102,S
2016-03-25 9:05:25,9350,4,73574,0,9350,243,9355,104,S
2016-03-25 9:05:25.5,9350,4,73578,0,9350,242,9355,153,S
2016-03-25 9:05:26,9350,20,73598,0,9350,224,9355,155,S
2016-03-25 9:05:27,9355,22,73620,16,9350,223,9355,159,B
2016-03-25 9:05:27.5,9350,2,73622,0,9350,223,9355,194,S
2016-03-25 9:05:28,9355,68,73690,2,9350,223,9355,163,B
2016-03-25 9:05:30,9355,110,73800,88,9350,140,9355,281,B
2016-03-25 9:05:30.5,9350,316,74116,138,9345,488,9350,154,S
2016-03-25 9:05:31,9350,22,74138,14,9345,476,9350,176,S
2016-03-25 9:05:31.5,9350,20,74158,18,9345,467,9350,166,S
2016-03-25 9:05:32,9350,62,74220,62,9345,477,9350,140,S
2016-03-25 9:05:33,9350,252,74472,252,9345,488,9350,19,S
2016-03-25 9:05:34,9350,40,74512,10,9350,49,9355,205,S
2016-03-25 9:05:34.5,9350,24,74536,20,9350,157,9355,195,S
2016-03-25 9:05:35,9350,2,74538,0,9350,190,9355,201,S
2016-03-25 9:05:36,9350,10,74548,2,9350,187,9355,201,S
2016-03-25 9:05:37,9355,2,74550,2,9350,189,9355,196,B
2016-03-25 9:05:37.5,9350,26,74576,-26,9350,172,9355,196,S
2016-03-25 9:05:38,9350,2,74578,0,9350,171,9355,197,S
2016-03-25 9:05:38.5,9350,344,74922,224,9345,365,9350,138,S
2016-03-25 9:05:39,9350,32,74954,8,9345,367,9350,153,S
2016-03-25 9:05:39.5,9350,50,75004,0,9345,367,9350,128,S
2016-03-25 9:05:40,9350,4,75008,4,9345,371,9350,126,S
2016-03-25 9:05:41,9350,122,75130,100,9345,281,9350,65,S
2016-03-25 9:05:41.5,9345,748,75878,-228,9340,488,9345,5,S
2016-03-25 9:05:42,9345,4,75882,2,9340,446,9345,16,S
2016-03-25 9:05:42.5,9345,180,76062,92,9340,452,9345,11,S
2016-03-25 9:05:43,9345,260,76322,-156,9345,52,9350,33,S
2016-03-25 9:05:43.5,9345,2,76324,2,9345,91,9350,60,S
2016-03-25 9:05:44,9345,8,76332,8,9345,88,9350,60,S
2016-03-25 9:05:45,9345,2,76334,2,9345,87,9350,77,S
2016-03-25 9:05:45.5,9345,8,76342,0,9345,85,9350,80,S
2016-03-25 9:05:46,9345,2,76344,2,9345,90,9350,82,S
2016-03-25 9:05:46.5,9345,2,76346,2,9345,91,9350,85,S
2016-03-25 9:05:47,9350,2,76348,0,9345,308,9350,94,B
2016-03-25 9:05:47.5,9350,2,76350,0,9345,309,9350,95,B
2016-03-25 9:05:48,9345,20,76370,0,9345,93,9350,92,S
2016-03-25 9:05:49,9345,2,76372,0,9345,96,9350,108,S
2016-03-25 9:05:49.5,9345,10,76382,0,9345,90,9350,120,S
2016-03-25 9:05:50,9350,28,76410,-14,9345,87,9350,112,B
2016-03-25 9:05:51,9350,6,76416,6,9345,77,9350,131,B
2016-03-25 9:05:51.5,9345,2,76418,2,9345,80,9350,137,S
2016-03-25 9:05:52,9345,182,76600,-44,9340,471,9345,38,S
2016-03-25 9:05:52.5,9345,12,76612,12,9340,455,9345,53,S
2016-03-25 9:05:54,9340,2,76614,0,9340,465,9345,26,S
2016-03-25 9:05:54.5,9345,60,76674,38,9345,9,9350,325,B
2016-03-25 9:05:55,9345,34,76708,-10,9340,470,9345,57,B
2016-03-25 9:05:55.5,9340,24,76732,-24,9340,456,9345,58,S
2016-03-25 9:05:56,9345,100,76832,18,9340,466,9345,8,B
2016-03-25 9:05:56.5,9340,4,76836,-4,9340,485,9345,15,S
2016-03-25 9:05:57,9345,50,76886,-2,9340,475,9345,23,B
2016-03-25 9:05:57.5,9340,2,76888,-2,9340,476,9345,58,S
2016-03-25 9:05:58,9345,2,76890,-2,9340,476,9345,62,B
2016-03-25 9:05:59,9345,20,76910,0,9340,466,9345,64,B
2016-03-25 9:05:59.5,9345,50,76960,-22,9340,443,9345,43,B
2016-03-25 9:06:00,9340,28,76988,-22,9340,431,9345,42,S
2016-03-25 9:06:00.5,9340,22,77010,-18,9340,421,9345,42,S
2016-03-25 9:06:01,9345,88,77098,-10,9345,1,9350,415,B
2016-03-25 9:06:01.5,9345,32,77130,2,9340,427,9345,22,B
2016-03-25 9:06:02,9345,2,77132,0,9340,427,9345,32,B
2016-03-25 9:06:03,9350,92,77224,-22,9340,421,9345,2,B
2016-03-25 9:06:03.3333,9350,12,77236,10,9345,44,9350,324,B
2016-03-25 9:06:03.6667,9345,20,77256,0,9345,41,9350,324,S
2016-03-25 9:06:04,9345,16,77272,0,9345,39,9350,329,S
2016-03-25 9:06:05,9345,4,77276,0,9345,70,9350,329,S
2016-03-25 9:06:06,9345,8,77284,8,9345,67,9350,336,S
2016-03-25 9:06:07,9345,4,77288,2,9345,71,9350,337,S
2016-03-25 9:06:07.5,9345,48,77336,4,9345,84,9350,338,S
2016-03-25 9:06:08,9345,26,77362,-4,9345,81,9350,328,S
2016-03-25 9:06:08.3333,9345,8,77370,-8,9345,77,9350,327,S
2016-03-25 9:06:08.6667,9345,40,77410,-2,9345,60,9350,268,S
2016-03-25 9:06:09,9345,118,77528,-42,9340,486,9345,9,S
2016-03-25 9:06:10,9345,30,77558,-2,9340,434,9345,13,S
2016-03-25 9:06:11,9340,10,77568,-2,9340,470,9345,1,S
2016-03-25 9:06:12,9340,2,77570,0,9340,497,9345,15,S
2016-03-25 9:06:12.5,9345,26,77596,22,9345,17,9350,409,B
2016-03-25 9:06:13,9345,138,77734,-102,9340,444,9345,22,B
2016-03-25 9:06:13.5,9340,20,77754,2,9340,433,9345,22,S
2016-03-25 9:06:14,9345,8,77762,-8,9340,424,9345,21,B
2016-03-25 9:06:15,9345,2,77764,-2,9340,515,9345,20,B
2016-03-25 9:06:15.5,9345,18,77782,-2,9345,6,9350,328,B
2016-03-25 9:06:16,9345,22,77804,22,9340,543,9345,56,B
2016-03-25 9:06:17,9340,82,77886,-30,9340,506,9345,128,S
2016-03-25 9:06:18,9340,4,77890,-4,9340,507,9345,177,S
2016-03-25 9:06:19,9345,40,77930,0,9340,487,9345,160,B
2016-03-25 9:06:19.5,9340,14,77944,0,9340,503,9345,156,S
2016-03-25 9:06:20,9345,216,78160,46,9340,521,9345,147,B
2016-03-25 9:06:21,9340,36,78196,-18,9340,506,9345,145,S
2016-03-25 9:06:22,9340,24,78220,8,9340,494,9345,150,S
2016-03-25 9:06:22.5,9340,20,78240,20,9340,483,9345,151,S
2016-03-25 9:06:24,9345,28,78268,2,9340,482,9345,151,B
2016-03-25 9:06:26,9340,40,78308,-24,9340,513,9345,163,S
2016-03-25 9:06:27,9345,2,78310,2,9340,556,9345,163,B
2016-03-25 9:06:27.5,9340,30,78340,0,9340,626,9345,166,S
2016-03-25 9:06:28,9340,4,78344,-4,9340,559,9345,166,S
2016-03-25 9:06:29,9340,26,78370,-4,9340,528,9345,167,S
2016-03-25 9:06:29.5,9340,42,78412,12,9340,547,9345,157,S
2016-03-25 9:06:30,9340,210,78622,-70,9340,463,9345,272,S
2016-03-25 9:06:30.5,9340,90,78712,-22,9340,417,9345,261,S
2016-03-25 9:06:31,9340,24,78736,20,9340,406,9345,261,S
2016-03-25 9:06:31.5,9345,238,78974,-190,9340,391,9345,251,B
2016-03-25 9:06:32,9340,10,78984,10,9340,394,9345,250,S
2016-03-25 9:06:32.5,9340,12,78996,4,9340,387,9345,253,S
2016-03-25 9:06:33,9345,214,79210,-198,9340,409,9345,253,B
2016-03-25 9:06:33.5,9340,2,79212,0,9340,423,9345,253,S
2016-03-25 9:06:34,9345,110,79322,-64,9340,382,9345,250,B
2016-03-25 9:06:34.5,9340,202,79524,-202,9340,370,9345,350,S
2016-03-25 9:06:35,9340,104,79628,98,9340,368,9345,301,S
2016-03-25 9:06:35.5,9340,2,79630,-2,9340,368,9345,301,S
2016-03-25 9:06:36,9340,2,79632,0,9340,367,9345,301,S
2016-03-25 9:06:36.5,9345,10,79642,0,9340,369,9345,296,B
2016-03-25 9:06:37,9340,12,79654,2,9340,365,9345,315,S
2016-03-25 9:06:37.5,9345,50,79704,-10,9340,362,9345,295,B
2016-03-25 9:06:38,9340,4,79708,0,9340,362,9345,297,S
2016-03-25 9:06:38.5,9340,20,79728,0,9340,353,9345,296,S
2016-03-25 9:06:39,9340,4,79732,-4,9340,351,9345,296,S
2016-03-25 9:06:39.5,9340,30,79762,2,9340,336,9345,296,S
2016-03-25 9:06:40,9340,2,79764,2,9340,335,9345,297,S
2016-03-25 9:06:40.5,9340,22,79786,18,9340,324,9345,297,S
2016-03-25 9:06:41,9340,102,79888,62,9340,322,9345,247,S
2016-03-25 9:06:42,9340,2,79890,2,9340,326,9345,248,S
2016-03-25 9:06:43,9340,4,79894,4,9340,319,9345,249,S
2016-03-25 9:06:43.5,9345,80,79974,-76,9340,304,9345,238,B
2016-03-25 9:06:44,9345,12,79986,-12,9340,304,9345,237,B
2016-03-25 9:06:44.5,9345,8,79994,-8,9340,380,9345,234,B
2016-03-25 9:06:45,9345,470,80464,42,9345,284,9350,309,B
2016-03-25 9:06:45.5,9355,612,81076,354,9350,221,9355,501,B
2016-03-25 9:06:46,9350,4,81080,2,9350,430,9355,501,S
2016-03-25 9:06:47,9350,2,81082,0,9350,172,9355,501,S
2016-03-25 9:06:48,9350,68,81150,20,9350,138,9355,482,S
2016-03-25 9:06:48.5,9350,522,81672,-54,9350,137,9355,272,S
2016-03-25 9:06:49,9355,40,81712,40,9350,157,9355,251,B
2016-03-25 9:06:49.5,9350,2,81714,2,9350,183,9355,251,S
2016-03-25 9:06:50,9355,502,82216,-322,9355,307,9360,494,B
2016-03-25 9:06:50.5,9360,178,82394,-108,9355,321,9360,341,B
2016-03-25 9:06:51,9360,108,82502,-70,9355,353,9360,256,B
2016-03-25 9:06:52,9360,444,82946,212,9355,361,9360,35,B
2016-03-25 9:06:52.5,9360,66,83012,-30,9360,121,9365,492,B
2016-03-25 9:06:53,9365,4,83016,2,9360,202,9365,457,B
2016-03-25 9:06:53.5,9360,42,83058,0,9360,127,9365,486,S
2016-03-25 9:06:54,9360,4,83062,2,9360,90,9365,485,S
2016-03-25 9:06:54.5,9365,212,83274,-98,9355,44,9360,28,B
2016-03-25 9:06:55,9360,44,83318,-32,9355,38,9360,97,S
2016-03-25 9:06:55.3333,9360,10,83328,10,9355,55,9360,408,S
2016-03-25 9:06:55.6667,9355,74,83402,10,9350,281,9355,3,S
2016-03-25 9:06:56,9360,58,83460,28,9355,16,9360,466,B
2016-03-25 9:06:56.5,9355,44,83504,-24,9350,263,9355,7,S
2016-03-25 9:06:57,9355,4,83508,0,9350,275,9355,8,S
2016-03-25 9:06:58,9355,4,83512,4,9350,325,9355,20,S
2016-03-25 9:06:58.5,9350,44,83556,14,9350,324,9355,12,S
2016-03-25 9:06:59,9355,40,83596,34,9350,309,9355,46,B
2016-03-25 9:07:00,9355,122,83718,106,9355,6,9360,504,B
2016-03-25 9:07:00.5,9355,30,83748,-12,9350,227,9355,127,B
2016-03-25 9:07:01,9355,48,83796,-2,9350,215,9355,124,B
2016-03-25 9:07:01.5,9355,2,83798,-2,9350,206,9355,124,B
2016-03-25 9:07:02,9355,174,83972,36,9355,42,9360,483,B
2016-03-25 9:07:02.5,9355,66,84038,6,9355,62,9360,492,B
2016-03-25 9:07:03,9355,136,84174,-4,9350,137,9355,767,B
2016-03-25 9:07:03.5,9355,20,84194,-20,9350,133,9355,856,B
2016-03-25 9:07:04,9350,272,84466,48,9345,139,9350,135,S
2016-03-25 9:07:04.5,9345,148,84614,-42,9340,608,9345,659,S
2016-03-25 9:07:05,9345,2,84616,0,9340,562,9345,663,S
2016-03-25 9:07:05.5,9340,6,84622,-4,9340,611,9345,662,S
2016-03-25 9:07:06,9340,52,84674,-8,9340,594,9345,641,S
2016-03-25 9:07:06.5,9345,76,84750,-16,9345,45,9350,282,B
2016-03-25 9:07:07,9350,60,84810,-10,9345,28,9350,256,B
2016-03-25 9:07:07.5,9345,266,85076,-198,9345,60,9350,203,S
2016-03-25 9:07:08,9345,14,85090,0,9345,61,9350,233,S
2016-03-25 9:07:08.5,9345,76,85166,50,9345,63,9350,201,S
2016-03-25 9:07:09,9350,4,85170,0,9345,159,9350,194,B
2016-03-25 9:07:10,9345,20,85190,12,9345,316,9350,203,S
2016-03-25 9:07:11,9345,136,85326,-10,9345,294,9350,200,S
2016-03-25 9:07:11.5,9350,76,85402,2,9345,283,9350,169,B
2016-03-25 9:07:12,9345,6,85408,2,9345,357,9350,109,S
2016-03-25 9:07:12.5,9345,2,85410,0,9345,417,9350,110,S
2016-03-25 9:07:13,9350,66,85476,30,9345,473,9350,39,B
2016-03-25 9:07:13.5,9345,84,85560,60,9345,588,9355,206,S
2016-03-25 9:07:14,9350,12,85572,0,9350,7,9355,217,B
2016-03-25 9:07:14.5,9350,2,85574,2,9350,3,9355,247,B
2016-03-25 9:07:15,9350,14,85588,6,9345,608,9350,61,B
2016-03-25 9:07:16,9350,8,85596,0,9345,626,9350,76,B
2016-03-25 9:07:17,9350,180,85776,70,9350,90,9355,283,B
2016-03-25 9:07:17.5,9350,12,85788,2,9350,85,9355,285,B
2016-03-25 9:07:18,9350,42,85830,0,9350,66,9355,287,B
2016-03-25 9:07:18.5,9350,62,85892,4,9350,35,9355,288,B
2016-03-25 9:07:19,9350,92,85984,86,9345,618,9350,58,B
2016-03-25 9:07:19.5,9345,2,85986,0,9345,599,9350,99,S
2016-03-25 9:07:20,9350,206,86192,188,9350,29,9355,216,B
2016-03-25 9:07:20.5,9350,18,86210,6,9345,525,9350,29,B
2016-03-25 9:07:21,9350,138,86348,122,9350,37,9355,338,B
2016-03-25 9:07:22,9350,2,86350,0,9350,38,9355,343,B
2016-03-25 9:07:23,9350,2,86352,0,9350,84,9355,344,B
2016-03-25 9:07:23.5,9350,2,86354,2,9350,96,9355,344,B
2016-03-25 9:07:24,9350,4,86358,4,9350,94,9355,334,B
2016-03-25 9:07:24.5,9350,352,86710,154,9345,450,9350,58,B
2016-03-25 9:07:25,9350,8,86718,2,9345,400,9350,82,B
2016-03-25 9:07:26,9350,98,86816,38,9345,386,9350,65,B
2016-03-25 9:07:27,9350,140,86956,116,9350,19,9355,336,B
2016-03-25 9:07:27.5,9350,6,86962,6,9350,16,9355,336,B
2016-03-25 9:07:28,9350,12,86974,12,9350,13,9355,332,B
2016-03-25 9:07:28.5,9355,404,87378,-34,9350,62,9355,101,B
2016-03-25 9:07:29,9355,220,87598,196,9355,48,9360,336,B
2016-03-25 9:07:29.5,9355,4,87602,0,9355,57,9360,338,B
2016-03-25 9:07:30,9360,22,87624,14,9355,9,9360,257,B
2016-03-25 9:07:31,9350,32,87656,10,9350,250,9355,58,S
2016-03-25 9:07:31.5,9350,2,87658,2,9350,199,9355,99,S
2016-03-25 9:07:33,9355,54,87712,54,9350,169,9355,81,B
2016-03-25 9:07:34,9355,4,87716,2,9350,240,9355,83,B
2016-03-25 9:07:37,9355,18,87734,18,9350,181,9355,189,B
2016-03-25 9:07:37.5,9355,12,87746,12,9350,142,9355,187,B
2016-03-25 9:07:39,9355,120,87866,68,9350,257,9355,131,B
2016-03-25 9:07:39.5,9355,254,88120,142,9350,1193,9355,13,B
2016-03-25 9:07:40,9355,26,88146,2,9355,280,9360,242,B
2016-03-25 9:07:41,9360,44,88190,-24,9355,313,9360,192,B
2016-03-25 9:07:42,9360,300,88490,-260,9355,322,9360,45,B
2016-03-25 9:07:43,9360,90,88580,54,9360,122,9365,226,B
2016-03-25 9:07:43.5,9360,24,88604,2,9360,110,9365,213,B
2016-03-25 9:07:44,9365,50,88654,-2,9360,365,9365,203,B
2016-03-25 9:07:44.5,9365,342,88996,116,9365,32,9370,201,B
2016-03-25 9:07:45,9365,138,89134,-48,9360,274,9365,108,B
2016-03-25 9:07:45.3333,9365,138,89272,-76,9360,244,9365,72,B
2016-03-25 9:07:45.6667,9365,2,89274,2,9360,242,9365,338,B
2016-03-25 9:07:46,9360,12,89286,-4,9360,237,9365,337,S
2016-03-25 9:07:47,9365,14,89300,2,9360,251,9365,331,B
2016-03-25 9:07:47.5,9360,32,89332,2,9360,235,9365,325,S
2016-03-25 9:07:48,9365,2,89334,0,9360,235,9365,326,B
2016-03-25 9:07:49,9360,82,89416,-82,9360,197,9365,330,S
2016-03-25 9:07:49.5,9365,2,89418,2,9360,193,9365,336,B
2016-03-25 9:07:50,9365,10,89428,10,9360,142,9365,357,B
2016-03-25 9:07:50.5,9360,4,89432,2,9360,196,9365,340,S
2016-03-25 9:07:51,9360,12,89444,10,9360,219,9365,344,S
2016-03-25 9:07:52,9360,70,89514,10,9360,192,9365,344,S
2016-03-25 9:07:52.5,9365,16,89530,14,9360,195,9365,337,B
2016-03-25 9:07:53,9360,20,89550,0,9360,175,9365,340,S
2016-03-25 9:07:53.5,9365,56,89606,30,9360,231,9365,315,B
2016-03-25 9:07:54,9365,12,89618,12,9360,226,9365,314,B
2016-03-25 9:07:54.5,9360,2,89620,0,9360,376,9365,315,S
2016-03-25 9:07:55,9360,8,89628,-4,9360,380,9365,314,S
2016-03-25 9:07:55.5,9365,2,89630,2,9360,368,9365,313,B
2016-03-25 9:07:56,9360,4,89634,-2,9360,360,9365,314,S
2016-03-25 9:07:56.5,9360,4,89638,-4,9360,250,9365,352,S
2016-03-25 9:07:57,9365,6,89644,6,9360,252,9365,354,B
2016-03-25 9:07:57.5,9360,4,89648,-4,9360,251,9365,353,S
2016-03-25 9:07:58,9360,110,89758,-110,9360,197,9365,354,S
2016-03-25 9:07:58.5,9360,440,90198,-308,9355,429,9360,417,S
2016-03-25 9:07:59,9360,10,90208,-2,9355,429,9360,4,S
2016-03-25 9:07:59.5,9360,870,91078,-660,9355,62,9360,205,S
2016-03-25 9:08:00,9360,80,91158,-32,9355,69,9360,178,S
2016-03-25 9:08:00.5,9360,40,91198,-40,9355,58,9360,137,S
2016-03-25 9:08:01,9360,10,91208,-2,9355,66,9360,131,S
2016-03-25 9:08:01.5,9355,6,91214,-4,9355,82,9360,129,S
2016-03-25 9:08:02,9360,300,91514,-198,9355,113,9360,65,B
2016-03-25 9:08:03,9355,2,91516,0,9355,113,9360,61,S
2016-03-25 9:08:03.5,9355,22,91538,20,9355,104,9360,186,S
2016-03-25 9:08:04,9360,22,91560,22,9355,105,9360,177,B
2016-03-25 9:08:05,9355,4,91564,0,9355,103,9360,231,S
2016-03-25 9:08:06,9360,58,91622,6,9355,75,9360,222,B
2016-03-25 9:08:07,9355,384,92006,-84,9355,33,9360,74,S
2016-03-25 9:08:07.5,9355,24,92030,18,9355,85,9360,92,S
2016-03-25 9:08:08,9360,608,92638,-420,9360,16,9365,419,B
2016-03-25 9:08:08.5,9360,72,92710,-22,9355,142,9360,5,B
2016-03-25 9:08:09,9360,10,92720,-2,9355,140,9360,18,B
2016-03-25 9:08:10,9360,22,92742,0,9355,164,9360,150,B
2016-03-25 9:08:10.5,9360,6,92748,-2,9355,125,9360,150,B
2016-03-25 9:08:11,9360,52,92800,-12,9355,130,9360,124,B
2016-03-25 9:08:12,9355,2,92802,2,9355,140,9360,148,S
2016-03-25 9:08:12.5,9360,4,92806,0,9355,146,9360,152,B
2016-03-25 9:08:13,9355,2,92808,2,9355,145,9360,159,S
2016-03-25 9:08:14,9360,6,92814,6,9355,152,9360,158,B
2016-03-25 9:08:14.5,9355,2,92816,2,9355,161,9360,159,S
2016-03-25 9:08:18,9355,2,92818,0,9355,169,9360,194,S
2016-03-25 9:08:18.5,9360,2,92820,0,9355,158,9360,193,B
2016-03-25 9:08:19,9360,16,92836,0,9355,159,9360,195,B
2016-03-25 9:08:20,9355,2,92838,0,9355,167,9360,195,S
2016-03-25 9:08:20.5,9360,4,92842,0,9355,174,9360,197,B
2016-03-25 9:08:21,9355,2,92844,0,9355,172,9360,198,S
2016-03-25 9:08:23,9360,24,92868,4,9355,161,9360,342,B
2016-03-25 9:08:23.5,9355,10,92878,10,9355,148,9360,343,S
2016-03-25 9:08:24,9360,6,92884,0,9355,131,9360,236,B
2016-03-25 9:08:25,9355,2,92886,2,9355,105,9360,237,S
2016-03-25 9:08:25.5,9355,116,93002,-40,9355,47,9360,237,S
2016-03-25 9:08:26,9355,98,93100,14,9350,677,9360,243,S
2016-03-25 9:08:27,9355,80,93180,-10,9350,204,9360,311,S
2016-03-25 9:08:27.5,9350,408,93588,146,9345,350,9350,29,S
2016-03-25 9:08:28,9350,70,93658,0,9350,245,9355,90,S
2016-03-25 9:08:30,9355,18,93676,-2,9350,220,9355,197,B
2016-03-25 9:08:30.5,9350,2,93678,0,9350,233,9355,199,S
2016-03-25 9:08:31,9355,2,93680,0,9350,221,9355,198,B
2016-03-25 9:08:32,9350,20,93700,0,9350,212,9355,200,S
2016-03-25 9:08:33,9355,596,94296,-292,9355,149,9360,273,B
2016-03-25 9:08:34,9355,40,94336,-2,9355,106,9360,265,B
2016-03-25 9:08:34.5,9355,10,94346,-10,9355,81,9360,388,B
2016-03-25 9:08:35,9360,104,94450,56,9355,92,9360,338,B
2016-03-25 9:08:36,9355,2,94452,0,9355,79,9360,338,S
2016-03-25 9:08:36.5,9350,130,94582,12,9350,557,9360,337,S
2016-03-25 9:08:37,9355,28,94610,-6,9350,543,9355,20,B
2016-03-25 9:08:37.5,9355,40,94650,-8,9355,6,9360,334,B
2016-03-25 9:08:38,9355,30,94680,4,9350,522,9355,1,B
2016-03-25 9:08:38.5,9355,16,94696,0,9350,402,9360,345,B
2016-03-25 9:08:39,9355,38,94734,0,9350,553,9355,87,B
2016-03-25 9:08:39.5,9355,16,94750,0,9350,545,9355,80,B
2016-03-25 9:08:40,9355,48,94798,0,9350,524,9355,67,B
2016-03-25 9:08:40.5,9355,260,95058,86,9350,444,9355,18,B
2016-03-25 9:08:41,9350,32,95090,0,9350,428,9355,28,S
2016-03-25 9:08:42,9355,4,95094,-4,9350,426,9355,32,B
2016-03-25 9:08:42.5,9355,68,95162,-46,9350,308,9360,362,B
2016-03-25 9:08:43,9355,20,95182,0,9350,398,9355,5,B
2016-03-25 9:08:43.5,9355,164,95346,0,9350,316,9355,41,B
2016-03-25 9:08:44,9360,200,95546,162,9350,320,9360,342,B
2016-03-25 9:08:45,9355,38,95584,-12,9350,301,9355,24,S
2016-03-25 9:08:45.5,9355,4,95588,-4,9350,305,9355,71,S
2016-03-25 9:08:46,9350,2,95590,2,9350,298,9355,111,S
2016-03-25 9:08:46.5,9355,2,95592,0,9350,332,9355,111,B
2016-03-25 9:08:47,9350,220,95812,178,9350,332,9355,41,S
2016-03-25 9:08:47.5,9355,44,95856,22,9350,311,9355,67,B
2016-03-25 9:08:48,9355,6,95862,6,9350,311,9355,75,B
2016-03-25 9:08:49,9350,4,95866,4,9350,312,9355,84,S
2016-03-25 9:08:49.5,9350,4,95870,0,9350,309,9355,104,S
2016-03-25 9:08:50,9350,4,95874,4,9350,308,9355,224,S
2016-03-25 9:08:50.5,9355,6,95880,6,9350,306,9355,222,B
2016-03-25 9:08:51,9350,2,95882,2,9350,305,9355,222,S
2016-03-25 9:08:51.5,9355,4,95886,4,9350,305,9355,220,B
2016-03-25 9:08:52,9350,22,95908,22,9350,294,9355,221,S
2016-03-25 9:08:52.5,9350,2,95910,0,9350,293,9355,221,S
2016-03-25 9:08:54,9350,6,95916,6,9350,291,9355,229,S
2016-03-25 9:08:55,9350,2,95918,2,9350,249,9355,292,S
2016-03-25 9:08:55.5,9350,20,95938,20,9350,240,9355,292,S
2016-03-25 9:08:56,9350,2,95940,2,9350,239,9355,292,S
2016-03-25 9:08:56.5,9350,44,95984,0,9350,217,9355,353,S
2016-03-25 9:08:57,9350,14,95998,0,9350,212,9355,349,S
2016-03-25 9:08:58,9350,2,96000,2,9350,272,9355,339,S
2016-03-25 9:08:59,9350,4,96004,2,9350,270,9355,555,S
2016-03-25 9:08:59.5,9355,22,96026,0,9350,264,9355,551,B
2016-03-25 9:09:02,9350,2,96028,2,9350,224,9355,337,S
2016-03-25 9:09:03,9350,4,96032,2,9350,222,9355,337,S
2016-03-25 9:09:03.5,9350,118,96150,-50,9350,214,9355,318,S
2016-03-25 9:09:04,9355,2,96152,0,9350,215,9355,317,B
2016-03-25 9:09:07,9350,100,96252,-4,9350,175,9355,315,S
2016-03-25 9:09:08,9350,348,96600,-164,9350,166,9355,42,S
2016-03-25 9:09:08.5,9355,86,96686,80,9355,75,9360,389,B
2016-03-25 9:09:09,9355,2,96688,2,9355,89,9360,376,B
2016-03-25 9:09:10,9355,4,96692,4,9355,91,9360,372,B
2016-03-25 9:09:10.5,9355,6,96698,6,9355,147,9360,379,B
2016-03-25 9:09:11,9355,2,96700,2,9355,153,9360,362,B
2016-03-25 9:09:12,9355,40,96740,40,9355,141,9360,372,B
2016-03-25 9:09:12.5,9360,100,96840,-36,9355,129,9360,348,B
2016-03-25 9:09:13,9355,26,96866,12,9355,130,9360,346,S
2016-03-25 9:09:13.5,9360,40,96906,40,9355,116,9360,325,B
2016-03-25 9:09:14,9355,8,96914,-8,9355,139,9360,325,S
2016-03-25 9:09:14.5,9355,24,96938,-22,9355,129,9360,325,S
2016-03-25 9:09:15,9355,4,96942,-2,9355,127,9360,325,S
2016-03-25 9:09:16,9360,8,96950,0,9355,153,9360,324,B
2016-03-25 9:09:18,9355,2,96952,0,9355,166,9360,334,S
2016-03-25 9:09:22,9355,2,96954,0,9355,275,9360,345,S
2016-03-25 9:09:23,9355,2,96956,0,9355,274,9360,345,S
2016-03-25 9:09:23.5,9355,2,96958,-2,9355,273,9360,336,S
2016-03-25 9:09:25,9360,160,97118,160,9355,288,9360,293,B
2016-03-25 9:09:25.5,9355,590,97708,474,9355,335,9365,415,S
2016-03-25 9:09:26,9360,104,97812,22,9355,327,9360,39,B
2016-03-25 9:09:26.5,9360,90,97902,-42,9360,302,9365,413,B
2016-03-25 9:09:27,9360,34,97936,-34,9360,359,9365,413,B
2016-03-25 9:09:27.5,9365,8,97944,0,9360,359,9365,411,B
2016-03-25 9:09:28,9360,22,97966,-22,9360,348,9365,411,S
2016-03-25 9:09:28.5,9365,2,97968,0,9360,348,9365,400,B
2016-03-25 9:09:29,9360,4,97972,-2,9360,346,9365,395,S
2016-03-25 9:09:30,9365,100,98072,66,9360,306,9365,344,B
2016-03-25 9:09:30.5,9365,470,98542,-378,9360,305,9365,112,B
2016-03-25 9:09:31,9370,192,98734,92,9365,253,9370,329,B
2016-03-25 9:09:31.5,9370,792,99526,198,9370,17,9375,825,B
2016-03-25 9:09:32,9370,82,99608,-64,9365,378,9370,174,B
2016-03-25 9:09:32.5,9365,54,99662,-12,9365,355,9370,167,S
2016-03-25 9:09:33,9365,34,99696,-20,9365,300,9370,158,S
2016-03-25 9:09:33.5,9365,90,99786,-82,9365,298,9370,115,S
2016-03-25 9:09:34,9370,4,99790,-2,9365,296,9370,115,B
2016-03-25 9:09:34.5,9370,132,99922,-28,9365,301,9370,50,B
2016-03-25 9:09:35,9370,8,99930,0,9365,303,9370,47,B
2016-03-25 9:09:35.5,9370,588,100518,14,9370,34,9375,789,B
2016-03-25 9:09:36,9370,70,100588,-4,9365,302,9370,77,B
2016-03-25 9:09:36.5,9370,54,100642,42,9365,297,9370,50,B
2016-03-25 9:09:37,9370,46,100688,44,9365,369,9370,78,B
2016-03-25 9:09:37.5,9370,254,100942,-202,9365,297,9375,732,B
2016-03-25 9:09:38,9370,44,100986,-18,9370,106,9375,732,B
2016-03-25 9:09:38.5,9370,24,101010,4,9370,107,9375,732,B
2016-03-25 9:09:39,9370,64,101074,-26,9370,3,9375,733,B
2016-03-25 9:09:39.5,9370,20,101094,-10,9365,423,9370,183,B
2016-03-25 9:09:40,9370,2,101096,-2,9365,420,9370,184,B
2016-03-25 9:09:40.5,9370,44,101140,-40,9365,421,9370,136,B
2016-03-25 9:09:41,9370,28,101168,-8,9365,413,9370,122,B
2016-03-25 9:09:41.5,9370,24,101192,-22,9365,412,9370,107,B
2016-03-25 9:09:42,9370,20,101212,0,9365,384,9370,99,B
2016-03-25 9:09:42.5,9370,32,101244,-16,9365,387,9370,83,B
2016-03-25 9:09:43,9370,48,101292,46,9365,389,9370,60,B
2016-03-25 9:09:43.5,9370,10,101302,10,9365,388,9370,58,B
2016-03-25 9:09:44,9370,124,101426,116,9370,42,9375,809,B
2016-03-25 9:09:44.5,9370,92,101518,4,9370,1,9375,809,B
2016-03-25 9:09:45,9370,60,101578,-2,9370,134,9375,809,B
2016-03-25 9:09:45.5,9370,2,101580,0,9370,134,9375,809,B
2016-03-25 9:09:46,9370,22,101602,-22,9370,125,9375,809,B
2016-03-25 9:09:47,9375,2,101604,-2,9370,134,9375,808,B
2016-03-25 9:09:47.3333,9370,38,101642,-16,9370,128,9375,802,S
2016-03-25 9:09:47.6667,9370,100,101742,0,9370,96,9375,802,S
2016-03-25 9:09:48,9375,2,101744,2,9370,110,9375,813,B
2016-03-25 9:09:49,9370,26,101770,-20,9370,98,9375,813,S
2016-03-25 9:09:49.5,9375,26,101796,2,9370,87,9375,811,B
2016-03-25 9:09:50,9370,2,101798,0,9370,90,9375,812,S
2016-03-25 9:09:50.5,9370,154,101952,-96,9370,113,9375,812,S
2016-03-25 9:09:51,9375,34,101986,4,9370,105,9375,806,B
2016-03-25 9:09:51.5,9370,218,102204,90,9370,103,9375,708,S
2016-03-25 9:09:52,9375,4,102208,0,9370,126,9375,707,B
2016-03-25 9:09:52.5,9370,144,102352,144,9370,55,9375,711,S
2016-03-25 9:09:53,9370,6,102358,2,9370,55,9375,709,S
2016-03-25 9:09:54,9375,36,102394,2,9370,153,9375,696,B
2016-03-25 9:09:54.5,9375,26,102420,20,9370,142,9375,623,B
2016-03-25 9:09:55,9375,12,102432,-10,9370,172,9375,619,B
2016-03-25 9:09:55.5,9375,40,102472,-14,9370,157,9375,625,B
2016-03-25 9:09:56,9375,8,102480,-6,9370,177,9375,621,B
2016-03-25 9:09:56.5,9375,32,102512,-12,9370,175,9375,629,B
2016-03-25 9:09:57,9375,302,102814,-60,9370,186,9375,485,B
2016-03-25 9:09:57.5,9375,330,103144,-160,9370,186,9375,319,B
2016-03-25 9:09:58,9375,102,103246,12,9370,177,9375,270,B
2016-03-25 9:09:58.5,9375,532,103778,82,9375,4,9380,636,B
2016-03-25 9:09:59,9375,4,103782,0,9375,30,9380,625,B
2016-03-25 9:09:59.5,9375,46,103828,2,9375,30,9380,611,B
2016-03-25 9:10:00,9380,230,104058,78,9375,70,9380,535,B
2016-03-25 9:10:00.5,9380,204,104262,48,9375,96,9380,444,B
2016-03-25 9:10:01,9375,172,104434,-60,9375,99,9380,423,S
2016-03-25 9:10:01.5,9380,318,104752,32,9375,98,9380,268,B
2016-03-25 9:10:02,9380,312,105064,-14,9375,109,9380,110,B
2016-03-25 9:10:02.5,9375,32,105096,-24,9375,111,9380,143,S
2016-03-25 9:10:03,9380,270,105366,198,9380,10,9385,561,B
2016-03-25 9:10:03.5,9375,62,105428,16,9375,194,9380,13,S
2016-03-25 9:10:04,9380,22,105450,-8,9375,194,9380,23,B
2016-03-25 9:10:04.5,9380,128,105578,12,9380,44,9385,565,B
2016-03-25 9:10:05,9380,8,105586,4,9380,48,9385,570,B
2016-03-25 9:10:05.5,9385,40,105626,32,9380,49,9385,633,B
2016-03-25 9:10:06,9380,226,105852,18,9380,25,9385,589,S
2016-03-25 9:10:06.5,9380,112,105964,-92,9375,350,9380,229,S
2016-03-25 9:10:07,9380,8,105972,4,9375,300,9380,297,S
2016-03-25 9:10:07.5,9380,64,106036,60,9375,290,9380,270,S
2016-03-25 9:10:08,9380,340,106376,30,9370,108,9380,314,S
2016-03-25 9:10:08.5,9375,78,106454,-52,9370,161,9375,4,S
2016-03-25 9:10:09,9375,44,106498,16,9370,180,9375,116,S
2016-03-25 9:10:09.5,9375,84,106582,28,9375,1,9380,342,S
2016-03-25 9:10:10,9375,70,106652,-22,9375,20,9380,322,S
2016-03-25 9:10:10.5,9375,54,106706,2,9370,128,9380,355,S
2016-03-25 9:10:11,9380,44,106750,42,9370,160,9380,347,B
2016-03-25 9:10:11.5,9370,10,106760,0,9370,167,9375,45,S
2016-03-25 9:10:12,9375,4,106764,0,9370,198,9375,46,B
2016-03-25 9:10:12.5,9375,20,106784,12,9370,190,9375,39,B
2016-03-25 9:10:13,9375,60,106844,8,9370,192,9375,22,B
2016-03-25 9:10:13.5,9370,24,106868,8,9370,198,9375,14,S
2016-03-25 9:10:14,9370,188,107056,-182,9370,237,9375,46,S
2016-03-25 9:10:14.5,9370,4,107060,-4,9370,252,9375,217,S
2016-03-25 9:10:15,9370,30,107090,0,9370,109,9375,174,S
2016-03-25 9:10:15.5,9375,54,107144,16,9370,84,9375,173,B
2016-03-25 9:10:16,9375,680,107824,-174,9375,59,9380,158,B
2016-03-25 9:10:16.5,9375,130,107954,-12,9370,233,9375,1,B
2016-03-25 9:10:17,9370,12,107966,2,9370,220,9375,24,S
2016-03-25 9:10:17.5,9370,2,107968,2,9370,229,9375,327,S
2016-03-25 9:10:18,9370,2,107970,2,9370,135,9375,379,S
2016-03-25 9:10:19,9370,24,107994,4,9370,43,9375,400,S
2016-03-25 9:10:20,9375,8,108002,-2,9370,61,9375,403,B
2016-03-25 9:10:21,9375,22,108024,2,9370,52,9375,413,B
2016-03-25 9:10:21.5,9375,46,108070,38,9370,49,9375,405,B
2016-03-25 9:10:22,9370,2,108072,-2,9370,49,9375,407,S
2016-03-25 9:10:23,9370,22,108094,-12,9370,52,9375,414,S
2016-03-25 9:10:23.5,9375,2,108096,0,9370,54,9375,413,B
2016-03-25 9:10:25,9375,26,108122,6,9370,47,9375,403,B
2016-03-25 9:10:25.3333,9370,2,108124,0,9370,45,9375,404,S
2016-03-25 9:10:25.6667,9370,16,108140,0,9370,52,9375,404,S
2016-03-25 9:10:26,9370,4,108144,4,9370,82,9375,404,S
2016-03-25 9:10:26.5,9370,6,108150,2,9370,80,9375,405,S
2016-03-25 9:10:27,9370,4,108154,2,9370,72,9375,406,S
2016-03-25 9:10:27.5,9370,10,108164,0,9370,89,9375,431,S
2016-03-25 9:10:28,9370,4,108168,0,9370,112,9375,431,S
2016-03-25 9:10:29,9370,14,108182,8,9370,63,9375,431,S
2016-03-25 9:10:29.5,9370,6,108188,0,9370,59,9375,431,S
2016-03-25 9:10:30,9370,4,108192,2,9370,60,9375,430,S
2016-03-25 9:10:30.5,9375,28,108220,-2,9370,49,9375,428,B
2016-03-25 9:10:31,9375,6,108226,0,9370,73,9375,445,B
2016-03-25 9:10:32,9370,220,108446,96,9370,1,9375,445,S
2016-03-25 9:10:33,9370,50,108496,-4,9365,264,9375,461,S
2016-03-25 9:10:34,9370,82,108578,-16,9370,31,9375,464,S
2016-03-25 9:10:35,9370,28,108606,-12,9365,238,9375,465,S
2016-03-25 9:10:35.5,9370,2,108608,-2,9370,70,9375,465,S
2016-03-25 9:10:36,9370,14,108622,-4,9370,94,9375,466,S
2016-03-25 9:10:36.5,9370,12,108634,8,9370,80,9375,462,S
2016-03-25 9:10:37,9370,50,108684,2,9370,65,9375,442,S
2016-03-25 9:10:38,9375,4,108688,4,9370,59,9375,441,B
2016-03-25 9:10:38.5,9370,88,108776,-74,9365,409,9370,21,S
2016-03-25 9:10:39,9370,22,108798,-18,9365,400,9370,24,S
2016-03-25 9:10:39.5,9370,252,109050,124,9370,59,9375,389,S
2016-03-25 9:10:40,9370,42,109092,-32,9370,28,9375,376,S
2016-03-25 9:10:41,9375,212,109304,198,9370,24,9375,378,B
2016-03-25 9:10:41.5,9370,52,109356,52,9365,433,9370,72,S
2016-03-25 9:10:42,9365,2,109358,0,9365,432,9370,154,S
2016-03-25 9:10:43,9370,200,109558,168,9365,432,9370,54,B
2016-03-25 9:10:44,9370,2,109560,2,9365,432,9370,58,B
2016-03-25 9:10:44.5,9370,116,109676,114,9370,42,9375,391,B
2016-03-25 9:10:45,9370,8,109684,4,9370,45,9375,392,B
2016-03-25 9:10:45.5,9370,68,109752,66,9370,11,9375,391,B
2016-03-25 9:10:46,9365,32,109784,10,9365,428,9370,13,S
2016-03-25 9:10:46.5,9370,2,109786,2,9365,428,9370,15,B
2016-03-25 9:10:47,9370,50,109836,24,9370,75,9375,399,B
2016-03-25 9:10:47.5,9370,6,109842,4,9370,275,9375,403,B
2016-03-25 9:10:48,9370,10,109852,10,9370,282,9375,404,B
2016-03-25 9:10:48.5,9375,30,109882,0,9370,279,9375,394,B
2016-03-25 9:10:49,9375,14,109896,6,9370,282,9375,387,B
2016-03-25 9:10:50,9370,4,109900,4,9370,317,9375,378,S
2016-03-25 9:10:50.5,9370,144,110044,4,9370,306,9375,318,S
2016-03-25 9:10:51,9370,2,110046,0,9370,357,9375,317,S
2016-03-25 9:10:51.5,9370,4,110050,4,9370,366,9375,317,S
2016-03-25 9:10:52,9375,16,110066,16,9370,329,9375,314,B
2016-03-25 9:10:53,9375,40,110106,40,9370,329,9375,299,B
2016-03-25 9:10:53.5,9370,22,110128,22,9370,268,9375,301,S
2016-03-25 9:10:54,9370,12,110140,10,9370,262,9375,302,S
2016-03-25 9:10:54.5,9370,10,110150,0,9370,277,9375,298,S
2016-03-25 9:10:55,9375,10,110160,8,9370,273,9375,298,B
2016-03-25 9:10:55.5,9370,6,110166,6,9370,270,9375,298,S
2016-03-25 9:10:56,9375,46,110212,42,9370,248,9375,282,B
2016-03-25 9:10:56.5,9375,2,110214,2,9370,250,9375,281,B
2016-03-25 9:10:58,9375,106,110320,-70,9370,200,9375,280,B
2016-03-25 9:10:58.5,9370,10,110330,-10,9370,195,9375,286,S
2016-03-25 9:10:59,9370,14,110344,2,9370,188,9375,335,S
2016-03-25 9:10:59.5,9375,4,110348,2,9370,187,9375,386,B
2016-03-25 9:11:00,9370,6,110354,2,9370,185,9375,387,S
2016-03-25 9:11:00.5,9375,4,110358,0,9370,185,9375,385,B
2016-03-25 9:11:01,9370,38,110396,-38,9370,167,9375,388,S
2016-03-25 9:11:02,9370,14,110410,0,9370,161,9375,390,S
2016-03-25 9:11:02.5,9370,10,110420,-10,9370,161,9375,391,S
2016-03-25 9:11:03,9370,22,110442,-22,9370,150,9375,390,S
2016-03-25 9:11:04,9370,8,110450,-8,9370,151,9375,395,S
2016-03-25 9:11:04.5,9370,4,110454,-4,9370,149,9375,402,S
2016-03-25 9:11:05,9375,20,110474,20,9370,150,9375,392,B
2016-03-25 9:11:05.5,9375,4,110478,4,9370,150,9375,390,B
2016-03-25 9:11:06,9370,4,110482,-2,9370,149,9375,390,S
2016-03-25 9:11:06.5,9370,16,110498,0,9370,142,9375,390,S
2016-03-25 9:11:07,9370,4,110502,-2,9370,160,9375,391,S
2016-03-25 9:11:08,9370,8,110510,0,9370,156,9375,395,S
2016-03-25 9:11:08.5,9370,86,110596,-84,9370,115,9375,416,S
2016-03-25 9:11:09,9375,22,110618,14,9370,112,9375,429,B
2016-03-25 9:11:09.5,9375,712,111330,-228,9370,242,9375,92,B
2016-03-25 9:11:10,9375,184,111514,-16,9375,67,9380,625,B
2016-03-25 9:11:10.5,9375,44,111558,-40,9375,56,9380,570,B
2016-03-25 9:11:11,9370,140,111698,-130,9375,3,9380,580,S
2016-03-25 9:11:11.5,9375,36,111734,-24,9370,197,9380,579,B
2016-03-25 9:11:12,9375,26,111760,-22,9375,11,9380,582,B
2016-03-25 9:11:12.5,9370,46,111806,26,9370,204,9375,6,S
2016-03-25 9:11:13,9370,18,111824,-4,9370,197,9375,20,S
2016-03-25 9:11:13.5,9375,2,111826,2,9370,202,9375,24,B
2016-03-25 9:11:14,9370,42,111868,-40,9370,181,9375,31,S
2016-03-25 9:11:17,9370,80,111948,-2,9370,114,9375,115,S
2016-03-25 9:11:17.3333,9370,224,112172,142,9370,12,9375,146,S
2016-03-25 9:11:17.6667,9370,24,112196,16,9365,165,9370,60,S
2016-03-25 9:11:18,9370,20,112216,18,9365,154,9370,112,S
2016-03-25 9:11:18.5,9370,4,112220,4,9365,177,9370,112,S
2016-03-25 9:11:20,9370,2,112222,2,9365,261,9370,115,S
2016-03-25 9:11:21,9370,10,112232,10,9365,261,9370,110,S
2016-03-25 9:11:21.5,9370,20,112252,18,9365,262,9370,68,S
2016-03-25 9:11:23,9370,2,112254,2,9365,264,9370,171,S
2016-03-25 9:11:24,9365,10,112264,2,9365,178,9370,172,S
2016-03-25 9:11:25,9365,106,112370,-26,9365,103,9370,237,S
2016-03-25 9:11:25.5,9360,212,112582,-150,9360,239,9365,145,S
2016-03-25 9:11:26,9365,20,112602,20,9360,205,9365,138,B
2016-03-25 9:11:26.5,9365,2,112604,2,9360,215,9365,138,B
2016-03-25 9:11:27,9365,4,112608,2,9360,214,9365,142,B
2016-03-25 9:11:27.5,9365,40,112648,2,9360,196,9365,140,B
2016-03-25 9:11:28,9360,8,112656,6,9360,195,9365,138,S
2016-03-25 9:11:28.5,9360,2,112658,-2,9360,194,9365,138,S
2016-03-25 9:11:30,9360,22,112680,0,9360,189,9365,139,S
2016-03-25 9:11:31,9360,8,112688,0,9360,196,9365,140,S
2016-03-25 9:11:31.5,9365,4,112692,2,9360,195,9365,139,B
2016-03-25 9:11:32,9360,20,112712,-20,9360,220,9365,139,S
2016-03-25 9:11:33,9360,10,112722,-2,9360,217,9365,150,S
2016-03-25 9:11:33.5,9365,2,112724,2,9360,217,9365,149,B
2016-03-25 9:11:34,9360,104,112828,-68,9360,130,9365,167,S
2016-03-25 9:11:34.5,9365,1050,113878,-412,9365,77,9370,22,B
2016-03-25 9:11:35,9365,4,113882,-4,9365,85,9370,24,B
2016-03-25 9:11:35.5,9365,110,113992,-96,9365,30,9370,24,B
2016-03-25 9:11:36,9365,18,114010,2,9365,5,9370,107,B
2016-03-25 9:11:37,9365,12,114022,-6,9360,147,9365,23,B
2016-03-25 9:11:37.5,9360,4,114026,-4,9360,145,9365,38,S
2016-03-25 9:11:38,9360,4,114030,0,9360,144,9365,37,S
2016-03-25 9:11:39,9365,10,114040,10,9360,144,9365,55,B
2016-03-25 9:11:39.5,9365,2,114042,0,9360,144,9365,60,B
2016-03-25 9:11:40,9360,6,114048,0,9360,114,9365,111,S
2016-03-25 9:11:42,9365,86,114134,-80,9360,98,9365,114,B
2016-03-25 9:11:42.5,9360,4,114138,-4,9360,113,9365,116,S
2016-03-25 9:11:43,9360,32,114170,4,9360,97,9365,117,S
2016-03-25 9:11:43.5,9360,194,114364,-150,9355,333,9360,5,S
2016-03-25 9:11:44,9360,116,114480,-24,9360,265,9365,79,S
2016-03-25 9:11:44.5,9365,106,114586,92,9360,269,9370,278,B
2016-03-25 9:11:45,9365,4,114590,4,9365,32,9370,262,B
2016-03-25 9:11:45.5,9365,4,114594,0,9365,27,9370,265,B
2016-03-25 9:11:46,9365,54,114648,-12,9360,312,9365,25,B
2016-03-25 9:11:46.5,9360,32,114680,-22,9360,185,9365,27,S
2016-03-25 9:11:47,9365,4,114684,-2,9360,196,9365,26,B
2016-03-25 9:11:47.5,9360,2,114686,-2,9360,218,9365,27,S
2016-03-25 9:11:48,9360,2,114688,-2,9360,216,9365,27,S
2016-03-25 9:11:48.5,9365,80,114768,-24,9365,53,9370,266,B
2016-03-25 9:11:49,9365,10,114778,0,9365,99,9370,267,B
2016-03-25 9:11:50,9365,12,114790,0,9365,93,9370,253,B
2016-03-25 9:11:50.5,9365,12,114802,0,9365,91,9370,254,B
2016-03-25 9:11:51,9365,140,114942,-128,9365,21,9370,254,B
2016-03-25 9:11:51.5,9365,42,114984,-40,9360,244,9365,13,B
2016-03-25 9:11:52,9360,22,115006,0,9360,238,9365,23,S
2016-03-25 9:11:53,9365,90,115096,-66,9365,430,9370,254,B
2016-03-25 9:11:53.5,9370,62,115158,-28,9365,363,9370,245,B
2016-03-25 9:11:54,9365,2,115160,0,9365,363,9370,247,S
2016-03-25 9:11:54.5,9365,2,115162,2,9365,363,9370,249,S
2016-03-25 9:11:55,9365,16,115178,2,9360,213,9370,227,S
2016-03-25 9:11:56,9365,208,115386,0,9360,213,9370,228,S
2016-03-25 9:11:56.5,9365,10,115396,4,9360,228,9370,231,S
2016-03-25 9:11:57,9365,2,115398,0,9360,436,9365,57,S
2016-03-25 9:11:58,9360,48,115446,-26,9360,291,9365,41,S
2016-03-25 9:11:59,9365,2,115448,0,9360,278,9365,41,B
2016-03-25 9:11:59.5,9360,34,115482,-14,9360,264,9365,48,S
2016-03-25 9:12:00,9365,84,115566,40,9360,261,9365,28,B
2016-03-25 9:12:00.5,9365,2,115568,-2,9360,258,9365,58,B
2016-03-25 9:12:01,9360,6,115574,-4,9360,226,9365,128,S
2016-03-25 9:12:02,9360,10,115584,10,9360,224,9365,157,S
2016-03-25 9:12:02.5,9360,18,115602,14,9360,201,9365,159,S
2016-03-25 9:12:03,9365,20,115622,8,9360,196,9365,149,B
2016-03-25 9:12:03.5,9365,14,115636,-14,9360,202,9365,150,B
2016-03-25 9:12:04,9365,686,116322,-518,9360,156,9365,21,B
2016-03-25 9:12:04.5,9360,6,116328,-2,9360,155,9365,22,S
2016-03-25 9:12:05,9360,20,116348,0,9360,146,9365,27,S
2016-03-25 9:12:06,9360,8,116356,0,9360,157,9365,83,S
2016-03-25 9:12:07,9360,26,116382,-16,9360,157,9365,90,S
2016-03-25 9:12:08,9365,20,116402,0,9360,156,9365,81,B
2016-03-25 9:12:09,9360,2,116404,0,9360,155,9365,82,S
2016-03-25 9:12:09.5,9365,4,116408,-4,9360,166,9365,83,B
2016-03-25 9:12:10,9360,2,116410,-2,9360,217,9365,35,S
2016-03-25 9:12:10.5,9365,72,116482,-16,9365,131,9370,218,B
2016-03-25 9:12:11,9365,18,116500,-18,9365,180,9370,219,B
2016-03-25 9:12:11.5,9365,4,116504,-2,9365,182,9370,219,B
2016-03-25 9:12:13,9365,20,116524,-20,9365,185,9370,219,B
2016-03-25 9:12:14,9370,2,116526,-2,9365,135,9370,219,B
2016-03-25 9:12:15,9365,4,116530,-4,9365,136,9370,218,S
2016-03-25 9:12:15.5,9365,4,116534,0,9365,139,9370,218,S
2016-03-25 9:12:16,9365,204,116738,158,9365,52,9370,226,S
2016-03-25 9:12:16.5,9370,72,116810,0,9365,16,9370,225,B
2016-03-25 9:12:17,9365,34,116844,14,9360,235,9365,4,S
2016-03-25 9:12:18,9365,4,116848,-2,9360,236,9365,7,S
2016-03-25 9:12:18.5,9360,4,116852,0,9360,234,9365,7,S
2016-03-25 9:12:19,9365,10,116862,10,9360,234,9365,2,B
2016-03-25 9:12:19.5,9365,42,116904,14,9365,3,9370,225,B
2016-03-25 9:12:20,9365,4,116908,4,9365,8,9370,225,B
2016-03-25 9:12:20.5,9365,4,116912,2,9365,7,9370,226,B
2016-03-25 9:12:21,9365,6,116918,6,9365,12,9370,227,B
2016-03-25 9:12:21.5,9370,2,116920,-2,9365,20,9370,226,B
2016-03-25 9:12:22,9365,4,116924,2,9365,18,9370,229,S
2016-03-25 9:12:23,9365,6,116930,4,9365,16,9370,229,S
2016-03-25 9:12:23.5,9365,8,116938,2,9365,12,9370,236,S
2016-03-25 9:12:24,9365,132,117070,-58,9360,185,9365,3,S
2016-03-25 9:12:25,9370,590,117660,-128,9365,84,9375,281,B
2016-03-25 9:12:25.5,9370,42,117702,0,9365,113,9375,283,B
2016-03-25 9:12:26,9375,40,117742,-22,9365,122,9375,262,B
2016-03-25 9:12:26.5,9375,4,117746,2,9365,127,9375,262,B
2016-03-25 9:12:27,9370,2,117748,0,9365,131,9375,263,S
2016-03-25 9:12:28,9370,14,117762,-14,9370,228,9375,261,S
2016-03-25 9:12:28.5,9375,2,117764,0,9370,239,9375,236,B
2016-03-25 9:12:30,9370,4,117768,-2,9370,61,9375,280,S
2016-03-25 9:12:31,9370,26,117794,-16,9370,50,9375,289,S
2016-03-25 9:12:32,9370,4,117798,0,9370,50,9375,290,S
2016-03-25 9:12:33,9375,4,117802,-4,9370,55,9375,289,B
2016-03-25 9:12:34,9370,46,117848,-20,9370,34,9375,309,S
2016-03-25 9:12:34.3333,9375,6,117854,0,9370,35,9375,396,B
2016-03-25 9:12:34.6667,9375,16,117870,0,9370,36,9375,390,B
2016-03-25 9:12:35,9375,144,118014,40,9370,270,9375,318,B
2016-03-25 9:12:36,9370,20,118034,-14,9370,262,9375,319,S
2016-03-25 9:12:36.5,9370,2,118036,0,9370,261,9375,319,S
2016-03-25 9:12:38,9370,16,118052,2,9370,265,9375,325,S
2016-03-25 9:12:39,9370,100,118152,0,9370,216,9375,328,S
2016-03-25 9:12:39.5,9375,2,118154,0,9370,216,9375,329,B
2016-03-25 9:12:40,9370,88,118242,-44,9365,410,9370,170,S
2016-03-25 9:12:41,9365,2,118244,0,9365,395,9370,170,S
2016-03-25 9:12:42,9370,6,118250,0,9365,166,9370,171,B
2016-03-25 9:12:43,9370,2,118252,-2,9365,167,9370,172,B
2016-03-25 9:12:44,9370,6,118258,0,9365,167,9370,171,B
2016-03-25 9:12:47,9365,6,118264,4,9365,163,9370,236,S
2016-03-25 9:12:48,9370,2,118266,-2,9365,163,9370,242,B
2016-03-25 9:12:49,9365,2,118268,0,9365,162,9370,242,S
2016-03-25 9:12:49.5,9365,2,118270,0,9365,161,9370,242,S
2016-03-25 9:12:52,9370,22,118292,-2,9365,261,9370,294,B
2016-03-25 9:12:53,9365,10,118302,-10,9365,272,9370,290,S
2016-03-25 9:12:53.5,9365,20,118322,-20,9365,262,9370,289,S
2016-03-25 9:12:54,9365,10,118332,0,9365,257,9370,279,S
2016-03-25 9:12:54.5,9365,6,118338,6,9365,254,9370,310,S
2016-03-25 9:12:55,9365,10,118348,10,9365,249,9370,296,S
2016-03-25 9:12:56,9370,12,118360,4,9365,281,9370,286,B
2016-03-25 9:12:57,9370,8,118368,0,9365,281,9370,289,B
2016-03-25 9:12:57.5,9365,2,118370,0,9365,280,9370,289,S
2016-03-25 9:12:58,9370,4,118374,0,9365,280,9370,294,B
2016-03-25 9:12:58.5,9365,2,118376,-2,9365,278,9370,292,S
2016-03-25 9:12:59,9370,22,118398,0,9365,268,9370,275,B
2016-03-25 9:13:01,9365,656,119054,242,9365,122,9370,383,S
2016-03-25 9:13:01.5,9360,536,119590,342,9360,33,9365,223,S
2016-03-25 9:13:02,9360,10,119600,-2,9360,34,9365,261,S
2016-03-25 9:13:03,9365,6,119606,2,9360,38,9365,232,B
2016-03-25 9:13:04,9365,18,119624,8,9360,40,9365,231,B
2016-03-25 9:13:04.5,9360,2,119626,2,9360,64,9365,406,S
2016-03-25 9:13:06,9360,2,119628,2,9360,84,9365,411,S
2016-03-25 9:13:06.5,9360,12,119640,0,9360,78,9365,412,S
2016-03-25 9:13:07,9360,14,119654,-8,9360,71,9365,408,S
2016-03-25 9:13:07.5,9360,44,119698,2,9360,55,9365,403,S
2016-03-25 9:13:08,9360,36,119734,0,9360,44,9365,185,S
2016-03-25 9:13:10,9360,126,119860,10,9360,16,9365,378,S
2016-03-25 9:13:11,9360,70,119930,22,9355,360,9360,32,S
2016-03-25 9:13:11.5,9360,68,119998,-4,9360,189,9365,252,S
2016-03-25 9:13:12,9360,2,120000,-2,9360,188,9365,197,S
2016-03-25 9:13:12.5,9360,2,120002,-2,9360,204,9365,196,S
2016-03-25 9:13:13,9360,2,120004,-2,9360,204,9365,197,S
2016-03-25 9:13:14,9360,26,120030,-22,9360,191,9365,185,S
2016-03-25 9:13:14.5,9360,6,120036,0,9360,189,9365,185,S
2016-03-25 9:13:15,9360,2,120038,-2,9360,190,9365,181,S
2016-03-25 9:13:18,9360,22,120060,-20,9360,179,9365,178,S
2016-03-25 9:13:19,9360,20,120080,0,9360,170,9365,212,S
2016-03-25 9:13:20,9360,12,120092,-10,9360,225,9365,225,S
2016-03-25 9:13:20.5,9365,2,120094,0,9360,225,9365,220,B
2016-03-25 9:13:21,9365,2,120096,2,9360,226,9365,222,B
2016-03-25 9:13:22,9365,40,120136,40,9360,228,9365,173,B
2016-03-25 9:13:22.5,9360,6,120142,0,9360,229,9365,177,S
2016-03-25 9:13:23,9360,8,120150,6,9360,225,9365,177,S
2016-03-25 9:13:25,9365,2,120152,0,9360,227,9365,258,B
2016-03-25 9:13:25.5,9365,8,120160,8,9360,225,9365,261,B
2016-03-25 9:13:26,9365,2,120162,2,9360,236,9365,210,B
2016-03-25 9:13:26.5,9365,4,120166,0,9360,238,9365,213,B
2016-03-25 9:13:27,9360,16,120182,6,9360,247,9365,206,S
2016-03-25 9:13:28,9360,340,120522,-130,9360,277,9365,113,S
2016-03-25 9:13:30,9360,2,120524,2,9360,276,9365,96,S
2016-03-25 9:13:30.5,9365,2,120526,0,9360,276,9365,96,B
2016-03-25 9:13:31,9360,16,120542,0,9360,274,9365,97,S
2016-03-25 9:13:32,9360,2,120544,0,9360,274,9365,98,S
2016-03-25 9:13:33,9360,4,120548,0,9360,272,9365,100,S
2016-03-25 9:13:34,9360,2,120550,0,9360,271,9365,100,S
2016-03-25 9:13:35,9360,62,120612,20,9360,261,9365,80,S
2016-03-25 9:13:35.5,9360,42,120654,-2,9360,240,9365,80,S
2016-03-25 9:13:36,9360,28,120682,22,9360,230,9365,79,S
2016-03-25 9:13:36.5,9360,2,120684,2,9360,229,9365,79,S
2016-03-25 9:13:37,9360,2,120686,2,9360,228,9365,81,S
2016-03-25 9:13:37.5,9365,4,120690,-4,9360,228,9365,79,B
2016-03-25 9:13:38,9360,2,120692,0,9360,227,9365,79,S
2016-03-25 9:13:38.5,9360,28,120720,6,9360,216,9365,77,S
2016-03-25 9:13:39,9365,8,120728,8,9360,216,9365,74,B
2016-03-25 9:13:40,9365,2,120730,2,9360,220,9365,134,B
2016-03-25 9:13:41,9365,2,120732,2,9360,218,9365,205,B
2016-03-25 9:13:41.5,9360,4,120736,4,9360,216,9365,207,S
2016-03-25 9:13:42,9360,24,120760,-14,9360,225,9365,202,S
2016-03-25 9:13:42.5,9360,2,120762,2,9360,224,9365,202,S
2016-03-25 9:13:43,9360,2,120764,0,9360,220,9365,203,S
2016-03-25 9:13:44,9365,20,120784,-20,9360,225,9365,193,B
2016-03-25 9:13:45,9360,50,120834,-46,9360,225,9365,171,S
2016-03-25 9:13:46,9360,34,120868,-12,9360,226,9365,155,S
2016-03-25 9:13:46.5,9365,308,121176,246,9365,52,9370,247,B
2016-03-25 9:13:47,9370,112,121288,4,9365,57,9370,198,B
2016-03-25 9:13:47.5,9365,20,121308,-20,9365,92,9370,197,S
2016-03-25 9:13:48,9365,24,121332,-18,9365,82,9370,196,S
2016-03-25 9:13:48.5,9365,54,121386,0,9365,58,9370,245,S
2016-03-25 9:13:49,9365,24,121410,-18,9365,46,9370,245,S
2016-03-25 9:13:49.5,9365,2,121412,2,9365,40,9370,243,S
2016-03-25 9:13:50,9365,8,121420,8,9365,36,9370,243,S
2016-03-25 9:13:51,9365,4,121424,0,9365,32,9370,243,S
2016-03-25 9:13:51.5,9370,2,121426,-2,9365,37,9370,244,B
2016-03-25 9:13:52,9365,138,121564,32,9360,226,9365,62,S
2016-03-25 9:13:53,9365,54,121618,2,9360,226,9370,243,S
2016-03-25 9:13:53.5,9365,4,121622,4,9360,242,9370,353,S
2016-03-25 9:13:54,9360,124,121746,-6,9360,225,9370,240,S
2016-03-25 9:13:55,9360,44,121790,-4,9360,159,9365,125,S
2016-03-25 9:13:56,9360,34,121824,30,9360,143,9365,114,S
2016-03-25 9:13:57,9365,2,121826,2,9360,164,9365,124,B
2016-03-25 9:13:58,9360,2,121828,0,9360,163,9365,136,S
2016-03-25 9:13:59,9360,84,121912,2,9360,120,9365,188,S
2016-03-25 9:13:59.3333,9365,4,121916,2,9360,120,9365,186,B
2016-03-25 9:13:59.6667,9360,2,121918,0,9360,119,9365,186,S
2016-03-25 9:14:00,9365,40,121958,6,9360,169,9365,166,B
2016-03-25 9:14:01,9360,78,122036,24,9360,152,9365,131,S
2016-03-25 9:14:02,9365,4,122040,0,9360,152,9365,129,B
2016-03-25 9:14:03,9365,6,122046,-2,9360,150,9365,128,B
2016-03-25 9:14:04,9360,10,122056,10,9360,173,9365,180,S
2016-03-25 9:14:05,9360,12,122068,-2,9360,168,9365,178,S
2016-03-25 9:14:05.5,9365,12,122080,0,9360,168,9365,173,B
2016-03-25 9:14:08,9360,2,122082,0,9360,195,9365,173,S
2016-03-25 9:14:09,9360,10,122092,0,9360,192,9365,177,S
2016-03-25 9:14:09.5,9360,2,122094,0,9360,190,9365,176,S
2016-03-25 9:14:11,9360,2,122096,0,9360,170,9365,175,S
2016-03-25 9:14:11.5,9365,22,122118,0,9360,204,9365,174,B
2016-03-25 9:14:13,9365,2,122120,0,9360,226,9365,174,B
2016-03-25 9:14:14,9360,2,122122,-2,9360,276,9365,194,S
2016-03-25 9:14:15,9360,102,122224,-94,9360,178,9365,194,S
2016-03-25 9:14:15.5,9360,22,122246,-22,9360,168,9365,198,S
2016-03-25 9:14:16,9360,214,122460,162,9355,370,9365,199,S
2016-03-25 9:14:16.5,9360,14,122474,-4,9360,88,9365,200,S
2016-03-25 9:14:17,9360,58,122532,2,9360,60,9365,200,S
2016-03-25 9:14:17.5,9360,48,122580,40,9360,184,9365,200,S
2016-03-25 9:14:18,9360,4,122584,-4,9360,135,9365,201,S
2016-03-25 9:14:20,9360,188,122772,-12,9355,460,9360,98,S
2016-03-25 9:14:20.5,9360,4,122776,2,9355,459,9360,148,S
2016-03-25 9:14:22,9360,2,122778,0,9355,458,9360,158,S
2016-03-25 9:14:22.5,9360,2,122780,2,9355,438,9360,157,S
2016-03-25 9:14:23,9360,218,122998,174,9355,349,9360,228,S
2016-03-25 9:14:25,9355,4,123002,2,9355,306,9360,288,S
2016-03-25 9:14:25.3333,9355,2,123004,-2,9355,306,9360,288,S
2016-03-25 9:14:25.6667,9360,40,123044,0,9355,306,9360,316,B
2016-03-25 9:14:26,9360,4,123048,0,9355,305,9360,319,B
2016-03-25 9:14:26.5,9355,4,123052,-4,9355,303,9360,320,S
2016-03-25 9:14:27,9355,86,123138,-64,9355,260,9360,321,S
2016-03-25 9:14:28,9360,50,123188,10,9355,208,9360,310,B
2016-03-25 9:14:28.3333,9355,40,123228,-12,9355,190,9360,310,S
2016-03-25 9:14:28.6667,9355,64,123292,0,9355,159,9360,314,S
2016-03-25 9:14:29,9360,200,123492,-44,9355,76,9360,294,B
2016-03-25 9:14:29.5,9355,4,123496,-4,9355,74,9360,294,S
2016-03-25 9:14:30,9355,2,123498,0,9355,73,9360,297,S
2016-03-25 9:14:30.5,9360,116,123614,-46,9355,37,9360,275,B
2016-03-25 9:14:31,9355,2,123616,0,9355,36,9360,281,S
2016-03-25 9:14:32,9355,6,123622,-6,9355,56,9360,277,S
2016-03-25 9:14:32.5,9355,6,123628,-2,9355,53,9360,277,S
2016-03-25 9:14:33,9360,40,123668,-40,9355,103,9360,206,B
2016-03-25 9:14:34,9355,200,123868,-160,9355,46,9360,185,S
2016-03-25 9:14:34.5,9360,42,123910,-36,9355,46,9360,156,B
2016-03-25 9:14:35,9355,30,123940,16,9355,42,9360,158,S
2016-03-25 9:14:36,9355,24,123964,-8,9355,39,9360,225,S
2016-03-25 9:14:37,9355,2,123966,2,9355,39,9360,225,S
2016-03-25 9:14:38,9355,34,124000,32,9355,189,9360,143,S
2016-03-25 9:14:38.5,9355,40,124040,-18,9355,171,9360,143,S
2016-03-25 9:14:39,9355,4,124044,0,9355,169,9360,143,S
2016-03-25 9:14:39.5,9355,108,124152,72,9355,167,9365,231,S
2016-03-25 9:14:40,9355,6,124158,2,9355,175,9360,152,S
2016-03-25 9:14:40.5,9355,78,124236,66,9355,126,9360,115,S
2016-03-25 9:14:41,9355,16,124252,16,9355,125,9360,169,S
2016-03-25 9:14:41.5,9355,16,124268,16,9355,142,9360,161,S
2016-03-25 9:14:42,9355,14,124282,14,9355,136,9360,154,S
2016-03-25 9:14:42.5,9355,58,124340,44,9355,94,9360,132,S
2016-03-25 9:14:43,9355,326,124666,228,9350,683,9355,15,S
2016-03-25 9:14:43.5,9355,6,124672,2,9355,34,9360,290,S
2016-03-25 9:14:44,9355,40,124712,40,9355,118,9360,316,S
2016-03-25 9:14:44.5,9355,2,124714,0,9355,119,9360,320,S
2016-03-25 9:14:45,9360,60,124774,-44,9355,121,9360,290,B
2016-03-25 9:14:46,9355,200,124974,-14,9355,34,9360,292,S
2016-03-25 9:14:47,9355,48,125022,-4,9355,65,9360,313,S
2016-03-25 9:14:47.5,9355,40,125062,-36,9350,648,9360,311,S
2016-03-25 9:14:48,9355,50,125112,42,9355,101,9360,323,S
2016-03-25 9:14:48.3333,9355,18,125130,-10,9350,649,9360,319,S
2016-03-25 9:14:48.6667,9355,2,125132,0,9355,120,9360,319,S
2016-03-25 9:14:50,9355,24,125156,-4,9350,647,9360,322,S
2016-03-25 9:14:51,9360,10,125166,0,9355,179,9360,318,B
2016-03-25 9:14:51.5,9360,122,125288,16,9355,230,9360,209,B
2016-03-25 9:14:52,9355,62,125350,2,9355,231,9360,179,S
2016-03-25 9:14:53,9360,378,125728,318,9355,78,9360,193,B
2016-03-25 9:14:53.5,9355,182,125910,130,9355,54,9360,174,S
2016-03-25 9:14:54,9355,102,126012,-6,9355,4,9360,226,S
2016-03-25 9:14:54.5,9355,28,126040,2,9355,22,9360,260,S
2016-03-25 9:14:55,9355,170,126210,50,9355,1,9360,216,S
2016-03-25 9:14:55.5,9355,40,126250,-18,9355,24,9360,241,S
2016-03-25 9:14:56,9355,40,126290,2,9355,9,9360,217,S
2016-03-25 9:14:56.5,9360,10,126300,10,9355,12,9360,212,B
2016-03-25 9:14:57,9355,10,126310,-2,9355,96,9360,220,S
2016-03-25 9:14:58,9355,50,126360,46,9355,122,9360,214,S
2016-03-25 9:14:58.5,9355,102,126462,102,9355,71,9360,215,S
2016-03-25 9:14:59,9355,10,126472,6,9355,173,9360,213,S
2016-03-25 9:14:59.5,9355,6,126478,6,9355,173,9360,211,S
2016-03-25 9:15:00,9360,156,126634,78,9355,128,9360,181,B
2016-03-25 9:15:00.5,9360,18,126652,2,9355,156,9360,175,B
2016-03-25 9:15:01,9360,10,126662,0,9355,159,9360,168,B
2016-03-25 9:15:01.5,9360,40,126702,30,9355,163,9360,100,B
2016-03-25 9:15:02,9360,60,126762,-60,9355,173,9360,113,B
2016-03-25 9:15:02.5,9355,218,126980,-90,9355,270,9360,31,S
2016-03-25 9:15:03,9365,108,127088,40,9360,38,9365,275,B
2016-03-25 9:15:04,9365,34,127122,-32,9360,86,9365,232,B
2016-03-25 9:15:04.5,9360,2,127124,-2,9360,123,9365,233,S
2016-03-25 9:15:05,9360,2,127126,-2,9360,122,9365,233,S
2016-03-25 9:15:05.5,9360,16,127142,0,9360,74,9365,235,S
2016-03-25 9:15:06,9360,2,127144,-2,9360,74,9365,233,S
2016-03-25 9:15:07,9360,256,127400,90,9360,124,9365,133,S
2016-03-25 9:15:07.5,9360,8,127408,8,9360,85,9365,129,S
2016-03-25 9:15:08,9360,12,127420,0,9360,82,9365,127,S
2016-03-25 9:15:09,9360,2,127422,0,9360,84,9365,127,S
2016-03-25 9:15:09.5,9360,2,127424,0,9360,83,9365,128,S
2016-03-25 9:15:10,9365,4,127428,4,9360,133,9365,126,B
2016-03-25 9:15:10.5,9360,6,127434,4,9360,135,9365,125,S
2016-03-25 9:15:11,9360,6,127440,2,9360,84,9365,123,S
2016-03-25 9:15:11.5,9365,4,127444,4,9360,85,9365,126,B
2016-03-25 9:15:12,9360,6,127450,2,9360,213,9365,124,S
2016-03-25 9:15:12.5,9365,4,127454,0,9360,214,9365,120,B
2016-03-25 9:15:13,9365,4,127458,0,9360,210,9365,117,B
2016-03-25 9:15:13.5,9365,244,127702,-136,9365,104,9370,380,B
2016-03-25 9:15:14,9365,66,127768,-32,9365,74,9370,379,B
2016-03-25 9:15:14.5,9370,40,127808,-16,9365,74,9370,358,B
2016-03-25 9:15:15,9365,26,127834,-12,9365,99,9370,357,S
2016-03-25 9:15:15.5,9370,28,127862,-14,9365,103,9370,353,B
2016-03-25 9:15:16,9370,12,127874,2,9365,106,9370,347,B
2016-03-25 9:15:16.5,9370,4,127878,2,9365,107,9370,345,B
2016-03-25 9:15:17,9370,4,127882,4,9365,108,9370,343,B
2016-03-25 9:15:17.5,9365,4,127886,0,9365,109,9370,343,S
2016-03-25 9:15:18,9370,4,127890,2,9365,113,9370,343,B
2016-03-25 9:15:19,9365,4,127894,2,9365,117,9370,342,S
2016-03-25 9:15:19.5,9365,12,127906,-8,9365,112,9370,341,S
2016-03-25 9:15:20,9365,2,127908,0,9365,112,9370,342,S
2016-03-25 9:15:22,9365,24,127932,-22,9365,178,9370,290,S
2016-03-25 9:15:22.5,9365,14,127946,2,9365,175,9370,286,S
2016-03-25 9:15:23,9365,2,127948,-2,9365,224,9370,287,S
2016-03-25 9:15:23.5,9370,22,127970,12,9365,203,9370,276,B
2016-03-25 9:15:25,9370,502,128472,-348,9365,296,9370,27,B
2016-03-25 9:15:25.5,9370,64,128536,-30,9370,78,9375,389,B
2016-03-25 9:15:26,9370,58,128594,-40,9370,46,9375,379,B
2016-03-25 9:15:26.5,9370,98,128692,6,9365,289,9370,151,B
2016-03-25 9:15:28,9365,2,128694,0,9365,261,9370,193,S
2016-03-25 9:15:29,9370,32,128726,0,9365,260,9370,177,B
2016-03-25 9:15:29.5,9370,120,128846,-120,9365,57,9370,177,B
2016-03-25 9:15:30,9365,116,128962,28,9360,291,9365,30,S
2016-03-25 9:15:30.5,9365,92,129054,74,9360,257,9365,4,S
2016-03-25 9:15:31,9365,50,129104,-30,9365,49,9370,190,S
2016-03-25 9:15:31.5,9365,52,129156,36,9365,8,9370,178,S
2016-03-25 9:15:32,9360,326,129482,-278,9360,304,9365,206,S
2016-03-25 9:15:33,9365,20,129502,0,9360,306,9365,199,B
2016-03-25 9:15:35,9360,2,129504,-2,9360,247,9365,200,S
2016-03-25 9:15:36,9360,2,129506,0,9360,245,9365,200,S
2016-03-25 9:15:37,9360,8,129514,6,9360,217,9365,216,S
2016-03-25 9:15:38,9365,6,129520,0,9360,237,9365,218,B
2016-03-25 9:15:40,9360,10,129530,0,9360,235,9365,224,S
2016-03-25 9:15:40.5,9360,200,129730,0,9360,135,9365,224,S
2016-03-25 9:15:41,9360,270,130000,8,9355,370,9360,103,S
2016-03-25 9:15:42,9360,4,130004,2,9355,370,9360,105,S
2016-03-25 9:15:42.5,9355,2,130006,2,9355,370,9360,107,S
2016-03-25 9:15:43,9360,214,130220,-84,9360,2,9365,251,B
2016-03-25 9:15:44,9365,6,130226,0,9360,13,9365,223,B
2016-03-25 9:15:45,9360,10,130236,2,9360,7,9365,223,S
2016-03-25 9:15:46,9360,2,130238,-2,9360,39,9365,223,S
2016-03-25 9:15:46.5,9360,6,130244,-4,9360,97,9365,223,S
2016-03-25 9:15:47,9360,2,130246,2,9360,106,9365,224,S
2016-03-25 9:15:47.5,9365,24,130270,6,9360,596,9365,316,B
2016-03-25 9:15:48,9360,12,130282,-8,9360,876,9365,232,S
2016-03-25 9:15:49,9360,14,130296,0,9360,871,9365,215,S
2016-03-25 9:15:50,9365,2,130298,0,9360,834,9365,413,B
2016-03-25 9:15:51,9360,32,130330,0,9360,820,9365,486,S
2016-03-25 9:15:52,9360,2,130332,2,9360,819,9365,487,S
2016-03-25 9:15:53,9365,100,130432,2,9360,823,9365,432,B
2016-03-25 9:15:55,9365,2,130434,2,9360,813,9365,437,B
2016-03-25 9:15:56,9360,8,130442,-2,9360,811,9365,205,S
2016-03-25 9:15:56.5,9365,18,130460,2,9360,819,9365,178,B
2016-03-25 9:15:57,9365,100,130560,100,9360,819,9365,128,B
2016-03-25 9:15:58,9365,2,130562,2,9360,819,9365,126,B
2016-03-25 9:15:59,9365,6,130568,6,9360,817,9365,151,B
2016-03-25 9:15:59.5,9360,12,130580,-2,9360,813,9365,175,S
2016-03-25 9:16:00,9365,6,130586,0,9360,813,9365,173,B
2016-03-25 9:16:00.5,9365,16,130602,0,9360,813,9365,166,B
2016-03-25 9:16:01,9365,2,130604,0,9360,813,9365,173,B
2016-03-25 9:16:02,9365,20,130624,16,9360,804,9365,174,B
2016-03-25 9:16:02.5,9360,40,130664,-26,9360,786,9365,156,S
2016-03-25 9:16:04,9365,2,130666,2,9360,791,9365,167,B
2016-03-25 9:16:04.5,9365,10,130676,8,9360,791,9365,164,B
2016-03-25 9:16:05,9360,6,130682,-6,9360,788,9365,164,S
2016-03-25 9:16:06,9360,2,130684,-2,9360,787,9365,164,S
2016-03-25 9:16:07,9365,818,131502,0,9360,349,9365,163,B
2016-03-25 9:16:07.5,9360,2,131504,0,9360,348,9365,176,S
2016-03-25 9:16:08,9360,546,132050,20,9355,346,9360,34,S
2016-03-25 9:16:09,9360,10,132060,10,9355,269,9360,66,S
2016-03-25 9:16:10,9360,106,132166,92,9355,269,9360,13,S
2016-03-25 9:16:10.5,9355,2,132168,2,9355,268,9360,8,S
2016-03-25 9:16:11,9355,4,132172,0,9355,266,9360,8,S
2016-03-25 9:16:11.5,9355,4,132176,4,9355,264,9360,8,S
2016-03-25 9:16:12,9360,2,132178,2,9355,264,9360,7,B
2016-03-25 9:16:12.5,9365,16,132194,8,9360,9,9365,500,B
2016-03-25 9:16:14,9365,6,132200,2,9360,41,9365,507,B
2016-03-25 9:16:15,9360,8,132208,-4,9360,37,9365,507,S
2016-03-25 9:16:15.5,9360,76,132284,50,9355,405,9360,350,S
2016-03-25 9:16:16,9355,2,132286,0,9355,375,9360,355,S
2016-03-25 9:16:19,9360,4,132290,4,9355,375,9360,366,B
2016-03-25 9:16:20,9360,12,132302,2,9355,370,9360,365,B
2016-03-25 9:16:20.3333,9355,4,132306,4,9355,369,9360,365,S
2016-03-25 9:16:20.6667,9360,4,132310,4,9355,369,9360,370,B
2016-03-25 9:16:21,9355,6,132316,6,9355,385,9360,368,S
2016-03-25 9:16:21.5,9360,4,132320,4,9355,385,9360,366,B
2016-03-25 9:16:22,9355,204,132524,-4,9355,284,9360,364,S
2016-03-25 9:16:22.5,9360,4,132528,4,9355,284,9360,372,B
2016-03-25 9:16:24,9355,2,132530,2,9355,283,9360,374,S
2016-03-25 9:16:25,9355,2,132532,2,9355,287,9360,375,S
2016-03-25 9:16:25.3333,9355,12,132544,12,9355,282,9360,376,S
2016-03-25 9:16:25.6667,9355,100,132644,18,9355,230,9360,376,S
2016-03-25 9:16:26,9355,4,132648,0,9355,228,9360,377,S
2016-03-25 9:16:27,9355,2,132650,-2,9355,228,9360,377,S
2016-03-25 9:16:27.5,9355,2,132652,0,9355,227,9360,377,S
2016-03-25 9:16:28,9360,2,132654,2,9355,228,9360,376,B
2016-03-25 9:16:28.5,9360,2,132656,2,9355,230,9360,375,B
2016-03-25 9:16:29,9360,2,132658,2,9355,235,9360,375,B
2016-03-25 9:16:30,9360,2,132660,2,9355,235,9360,374,B
2016-03-25 9:16:30.5,9360,2,132662,2,9355,235,9360,373,B
2016-03-25 9:16:31,9355,424,133086,-98,9350,417,9360,343,S
2016-03-25 9:16:31.5,9355,2,133088,2,9350,402,9360,343,S
2016-03-25 9:16:32,9355,72,133160,-6,9355,129,9360,343,S
2016-03-25 9:16:32.5,9355,22,133182,-16,9355,127,9360,349,S
2016-03-25 9:16:33,9355,2,133184,-2,9355,126,9360,341,S
2016-03-25 9:16:34,9355,40,133224,0,9355,156,9360,343,S
2016-03-25 9:16:34.5,9355,2,133226,-2,9355,161,9360,344,S
2016-03-25 9:16:35,9355,4,133230,2,9355,160,9360,343,S
2016-03-25 9:16:35.5,9355,102,133332,-40,9355,151,9360,354,S
2016-03-25 9:16:36,9360,2,133334,0,9355,153,9360,347,B
2016-03-25 9:16:37,9355,2,133336,-2,9355,157,9360,350,S
2016-03-25 9:16:37.5,9355,6,133342,-2,9355,157,9360,371,S
2016-03-25 9:16:38,9360,82,133424,82,9355,117,9360,330,B
2016-03-25 9:16:39,9360,520,133944,516,9355,146,9360,69,B
2016-03-25 9:16:39.5,9360,142,134086,12,9360,72,9365,258,B
2016-03-25 9:16:40,9360,4,134090,-2,9360,77,9365,248,B
2016-03-25 9:16:40.5,9360,12,134102,0,9360,47,9365,248,B
2016-03-25 9:16:41,9360,8,134110,0,9360,42,9365,248,B
2016-03-25 9:16:41.5,9360,4,134114,0,9360,122,9365,249,B
2016-03-25 9:16:43,9360,4,134118,0,9360,164,9365,164,B
2016-03-25 9:16:44,9365,48,134166,46,9360,206,9365,152,B
2016-03-25 9:16:45,9360,4,134170,4,9360,209,9365,212,S
2016-03-25 9:16:46,9360,2,134172,0,9360,210,9365,214,S
2016-03-25 9:16:48,9360,2,134174,2,9360,127,9365,213,S
2016-03-25 9:16:49,9365,40,134214,36,9360,127,9365,193,B
2016-03-25 9:16:49.5,9360,24,134238,24,9360,115,9365,192,S
2016-03-25 9:16:50,9360,280,134518,-26,9355,179,9360,12,S
2016-03-25 9:16:51,9360,4,134522,4,9355,188,9360,10,S
2016-03-25 9:16:51.5,9360,20,134542,8,9360,42,9365,337,S
2016-03-25 9:16:52,9360,12,134554,0,9360,70,9365,287,S
2016-03-25 9:16:52.5,9360,4,134558,0,9360,70,9365,286,S
2016-03-25 9:16:54,9360,2,134560,2,9360,75,9365,286,S
2016-03-25 9:16:56,9360,2,134562,0,9360,116,9365,276,S
2016-03-25 9:16:56.5,9360,2,134564,0,9360,115,9365,276,S
2016-03-25 9:16:58,9360,2,134566,2,9360,105,9365,275,S
2016-03-25 9:16:59,9360,28,134594,4,9360,91,9365,276,S
2016-03-25 9:16:59.5,9360,20,134614,20,9360,91,9365,274,S
2016-03-25 9:17:00,9360,30,134644,-2,9360,76,9365,287,S
2016-03-25 9:17:01,9360,168,134812,-126,9355,208,9360,18,S
2016-03-25 9:17:01.3333,9360,8,134820,-8,9355,210,9360,7,S
2016-03-25 9:17:01.6667,9360,18,134838,-8,9355,208,9360,49,S
2016-03-25 9:17:03,9360,8,134846,0,9355,209,9360,50,S
2016-03-25 9:17:04,9360,12,134858,0,9355,212,9360,45,S
2016-03-25 9:17:04.5,9355,6,134864,-6,9355,209,9360,45,S
2016-03-25 9:17:06,9355,2,134866,-2,9355,210,9360,51,S
2016-03-25 9:17:08,9360,10,134876,0,9355,214,9360,60,B
2016-03-25 9:17:11,9360,2,134878,0,9355,214,9360,63,B
2016-03-25 9:17:11.5,9360,22,134900,0,9355,214,9360,87,B
2016-03-25 9:17:15,9360,4,134904,4,9355,203,9360,90,B
2016-03-25 9:17:16,9360,2,134906,2,9355,173,9360,92,B
2016-03-25 9:17:17,9355,42,134948,36,9355,178,9360,72,S
2016-03-25 9:17:17.5,9360,176,135124,30,9360,33,9365,175,B
2016-03-25 9:17:18,9360,70,135194,4,9355,188,9360,59,B
2016-03-25 9:17:19,9360,42,135236,40,9355,160,9360,35,B
2016-03-25 9:17:21,9355,10,135246,-10,9355,135,9360,107,S
2016-03-25 9:17:22,9355,2,135248,0,9355,135,9360,110,S
2016-03-25 9:17:23,9360,2,135250,2,9355,135,9360,76,B
2016-03-25 9:17:24,9360,100,135350,38,9355,138,9360,77,B
2016-03-25 9:17:25,9360,4,135354,0,9355,153,9360,85,B
2016-03-25 9:17:26,9360,2,135356,-2,9355,143,9360,85,B
2016-03-25 9:17:27,9355,2,135358,-2,9355,141,9360,85,S
2016-03-25 9:17:29,9355,2,135360,0,9355,146,9360,85,S
2016-03-25 9:17:30,9355,60,135420,-26,9355,114,9360,117,S
2016-03-25 9:17:31,9355,4,135424,-4,9355,111,9360,143,S
2016-03-25 9:17:32,9355,416,135840,286,9355,209,9360,144,S
2016-03-25 9:17:32.5,9355,2,135842,0,9355,216,9360,134,S
2016-03-25 9:17:33,9360,4,135846,-2,9355,216,9360,143,B
2016-03-25 9:17:33.5,9355,18,135864,10,9355,201,9360,177,S
2016-03-25 9:17:36,9355,2,135866,2,9355,201,9360,181,S
2016-03-25 9:17:37,9355,22,135888,0,9355,201,9360,174,S
2016-03-25 9:17:42,9355,14,135902,-4,9355,223,9360,142,S
2016-03-25 9:17:44,9355,2,135904,2,9355,222,9360,180,S
2016-03-25 9:17:45,9360,10,135914,-8,9355,223,9360,176,B
2016-03-25 9:17:47,9355,8,135922,4,9355,221,9360,175,S
2016-03-25 9:17:47.5,9355,2,135924,0,9355,220,9360,175,S
2016-03-25 9:17:49,9360,2,135926,0,9355,233,9360,175,B
2016-03-25 9:17:50,9355,4,135930,4,9355,232,9360,175,S
2016-03-25 9:17:52,9355,448,136378,14,9355,9,9360,191,S
2016-03-25 9:17:52.5,9355,18,136396,2,9350,457,9355,93,S
2016-03-25 9:17:53,9355,186,136582,-94,9355,61,9360,200,S
2016-03-25 9:17:53.5,9355,136,136718,-34,9350,457,9355,54,S
2016-03-25 9:17:54,9355,2,136720,0,9350,457,9355,52,S
2016-03-25 9:17:55,9350,36,136756,-8,9350,438,9355,27,S
2016-03-25 9:17:55.5,9355,60,136816,-36,9355,76,9360,200,B
2016-03-25 9:17:56,9355,78,136894,0,9355,37,9360,200,B
2016-03-25 9:17:57,9350,76,136970,-26,9350,438,9355,21,S
2016-03-25 9:17:57.5,9355,42,137012,-4,9350,421,9355,43,B
2016-03-25 9:17:58,9355,90,137102,-58,9355,57,9360,202,B
2016-03-25 9:17:58.5,9355,2,137104,-2,9355,63,9360,199,B
2016-03-25 9:17:59,9355,48,137152,-48,9355,51,9360,205,B
2016-03-25 9:18:00,9355,16,137168,-2,9355,43,9360,198,B
2016-03-25 9:18:00.5,9355,86,137254,-14,9350,430,9360,258,B
2016-03-25 9:18:01,9355,26,137280,-6,9355,6,9360,251,B
2016-03-25 9:18:01.5,9350,32,137312,-12,9355,118,9360,251,S
2016-03-25 9:18:02,9355,104,137416,-4,9355,209,9360,201,B
2016-03-25 9:18:02.5,9355,2,137418,-2,9355,228,9360,201,B
2016-03-25 9:18:03,9355,20,137438,0,9355,218,9360,210,B
2016-03-25 9:18:04,9360,4,137442,-4,9355,218,9360,208,B
2016-03-25 9:18:04.5,9355,4,137446,-4,9355,216,9360,207,S
2016-03-25 9:18:06,9355,4,137450,0,9355,237,9360,193,S
2016-03-25 9:18:07,9355,2,137452,0,9355,236,9360,213,S
2016-03-25 9:18:07.5,9360,192,137644,-154,9355,145,9360,209,B
2016-03-25 9:18:08,9355,18,137662,-18,9355,136,9360,229,S
2016-03-25 9:18:08.5,9355,282,137944,-240,9350,457,9355,62,S
2016-03-25 9:18:09,9355,112,138056,-8,9350,463,9355,7,S
2016-03-25 9:18:09.5,9355,16,138072,6,9355,136,9360,272,S
2016-03-25 9:18:10,9355,20,138092,0,9355,125,9360,253,S
2016-03-25 9:18:12,9355,2,138094,-2,9355,116,9360,240,S
2016-03-25 9:18:12.5,9355,8,138102,-8,9355,112,9360,242,S
2016-03-25 9:18:15,9355,2,138104,-2,9355,113,9360,231,S
2016-03-25 9:18:17,9355,284,138388,58,9350,435,9355,14,S
2016-03-25 9:18:17.5,9355,14,138402,-10,9350,438,9355,10,S
2016-03-25 9:18:18,9355,20,138422,-12,9355,252,9360,552,S
2016-03-25 9:18:18.5,9355,2,138424,-2,9355,292,9360,552,S
2016-03-25 9:18:20,9355,4,138428,-4,9355,256,9360,557,S
2016-03-25 9:18:20.5,9355,4,138432,0,9355,255,9360,557,S
2016-03-25 9:18:21,9355,10,138442,0,9355,251,9360,557,S
2016-03-25 9:18:21.5,9355,16,138458,-16,9355,243,9360,557,S
2016-03-25 9:18:22,9355,320,138778,-40,9355,83,9360,560,S
2016-03-25 9:18:22.5,9355,6,138784,0,9355,100,9360,560,S
2016-03-25 9:18:23,9355,210,138994,-142,9350,439,9355,3,S
2016-03-25 9:18:24,9355,202,139196,-182,9350,440,9355,246,S
2016-03-25 9:18:24.5,9350,4,139200,-2,9350,438,9355,290,S
2016-03-25 9:18:26,9350,2,139202,-2,9350,437,9355,241,S
2016-03-25 9:18:27,9350,44,139246,-44,9350,414,9355,248,S
2016-03-25 9:18:28,9355,202,139448,-202,9350,413,9355,150,B
2016-03-25 9:18:31,9350,10,139458,-10,9350,410,9355,214,S
2016-03-25 9:18:33,9350,180,139638,46,9350,382,9355,174,S
2016-03-25 9:18:33.5,9350,16,139654,-2,9350,375,9355,178,S
2016-03-25 9:18:34,9350,42,139696,-36,9350,405,9355,178,S
2016-03-25 9:18:34.5,9350,70,139766,-36,9350,370,9355,181,S
2016-03-25 9:18:35,9350,120,139886,-40,9350,309,9355,161,S
2016-03-25 9:18:35.5,9350,18,139904,-18,9350,300,9355,180,S
2016-03-25 9:18:36,9350,30,139934,-30,9350,285,9355,193,S
2016-03-25 9:18:37,9355,2,139936,0,9350,285,9355,163,B
2016-03-25 9:18:37.5,9355,204,140140,-126,9350,284,9355,47,B
2016-03-25 9:18:38,9350,16,140156,-14,9350,286,9355,68,S
2016-03-25 9:18:39,9355,60,140216,-52,9350,292,9360,439,B
2016-03-25 9:18:39.5,9350,476,140692,-270,9350,104,9355,91,S
2016-03-25 9:18:40,9355,202,140894,-96,9350,112,9360,440,B
2016-03-25 9:18:40.5,9355,30,140924,-6,9355,36,9360,470,B
2016-03-25 9:18:41,9355,22,140946,-22,9355,35,9360,477,B
2016-03-25 9:18:41.5,9355,2,140948,-2,9355,18,9360,465,B
2016-03-25 9:18:42,9355,142,141090,12,9355,55,9360,415,B
2016-03-25 9:18:42.5,9355,134,141224,-10,9350,138,9355,55,B
2016-03-25 9:18:43,9350,200,141424,-176,9350,84,9355,55,S
2016-03-25 9:18:44,9355,2,141426,-2,9350,211,9355,88,B
2016-03-25 9:18:45,9350,4,141430,0,9350,210,9355,93,S
2016-03-25 9:18:45.5,9355,20,141450,0,9350,210,9355,84,B
2016-03-25 9:18:46,9355,2,141452,-2,9350,210,9355,83,B
2016-03-25 9:18:46.5,9350,10,141462,-2,9350,205,9355,81,S
2016-03-25 9:18:47,9350,4,141466,0,9350,240,9355,88,S
2016-03-25 9:18:48,9350,2,141468,-2,9350,239,9355,88,S
2016-03-25 9:18:48.5,9355,8,141476,-8,9350,239,9355,84,B
2016-03-25 9:18:49,9350,20,141496,-20,9350,230,9355,84,S
2016-03-25 9:18:51,9350,20,141516,4,9350,227,9355,87,S
2016-03-25 9:18:51.5,9350,8,141524,-8,9350,226,9355,101,S
2016-03-25 9:18:52,9350,400,141924,-262,9350,129,9355,130,S
2016-03-25 9:18:53,9350,106,142030,-58,9350,81,9355,139,S
2016-03-25 9:18:54,9350,2,142032,0,9350,183,9355,153,S
2016-03-25 9:18:54.5,9350,4,142036,-4,9350,282,9355,153,S
2016-03-25 9:18:55,9355,4,142040,0,9350,281,9355,143,B
2016-03-25 9:18:55.5,9350,10,142050,0,9350,277,9355,143,S
2016-03-25 9:18:56,9350,2,142052,0,9350,276,9355,145,S
2016-03-25 9:18:56.5,9350,58,142110,-40,9350,256,9355,143,S
2016-03-25 9:18:57,9350,4,142114,0,9350,259,9355,135,S
2016-03-25 9:18:58,9355,2,142116,0,9350,264,9355,135,B
2016-03-25 9:18:58.5,9350,6,142122,-2,9350,262,9355,145,S
2016-03-25 9:18:59,9350,8,142130,-4,9350,266,9355,143,S
2016-03-25 9:18:59.5,9350,42,142172,0,9350,246,9355,149,S
2016-03-25 9:19:00,9355,50,142222,36,9350,313,9355,273,B
2016-03-25 9:19:01,9355,30,142252,30,9350,313,9355,257,B
2016-03-25 9:19:01.5,9350,10,142262,-10,9350,313,9355,257,S
2016-03-25 9:19:02,9355,2,142264,0,9350,421,9355,489,B
2016-03-25 9:19:02.5,9355,234,142498,170,9350,421,9355,372,B
2016-03-25 9:19:03,9355,74,142572,-66,9350,423,9360,385,B
2016-03-25 9:19:04,9355,234,142806,-168,9355,3,9360,389,B
2016-03-25 9:19:04.5,9355,150,142956,78,9350,423,9355,13,B
2016-03-25 9:19:05,9355,42,142998,28,9355,38,9360,359,B
2016-03-25 9:19:05.5,9355,2,143000,2,9355,57,9360,359,B
2016-03-25 9:19:07,9355,116,143116,-6,9350,441,9355,146,B
2016-03-25 9:19:07.5,9355,20,143136,0,9350,549,9355,136,B
2016-03-25 9:19:08,9350,2,143138,-2,9350,549,9355,219,S
2016-03-25 9:19:09,9355,10,143148,-4,9350,546,9355,218,B
2016-03-25 9:19:09.5,9355,20,143168,0,9350,546,9355,208,B
2016-03-25 9:19:10,9350,2,143170,-2,9350,545,9355,208,S
2016-03-25 9:19:10.5,9355,44,143214,-36,9350,520,9355,207,B
2016-03-25 9:19:11,9355,2,143216,0,9350,540,9355,211,B
2016-03-25 9:19:11.5,9355,182,143398,-82,9350,556,9355,161,B
2016-03-25 9:19:12,9350,2,143400,-2,9350,558,9355,161,S
2016-03-25 9:19:13,9350,6,143406,-6,9350,555,9355,163,S
2016-03-25 9:19:14,9355,2,143408,0,9350,527,9355,220,B
2016-03-25 9:19:14.5,9355,4,143412,0,9350,528,9355,218,B
2016-03-25 9:19:15,9350,4,143416,0,9350,526,9355,222,S
2016-03-25 9:19:17,9350,12,143428,-12,9350,521,9355,224,S
2016-03-25 9:19:17.5,9350,12,143440,-4,9350,518,9355,220,S
2016-03-25 9:19:18,9355,10,143450,-10,9350,519,9355,215,B
2016-03-25 9:19:19,9350,2,143452,-2,9350,563,9355,215,S
2016-03-25 9:19:20,9355,402,143854,-390,9350,367,9355,215,B
2016-03-25 9:19:22,9350,10,143864,-10,9350,360,9355,233,S
2016-03-25 9:19:23,9350,2,143866,0,9350,363,9355,234,S
2016-03-25 9:19:24,9350,4,143870,-4,9350,362,9355,219,S
2016-03-25 9:19:24.5,9355,2,143872,-2,9350,362,9355,211,B
2016-03-25 9:19:25,9355,46,143918,-36,9350,340,9355,209,B
2016-03-25 9:19:26,9350,2,143920,2,9350,343,9355,207,S
2016-03-25 9:19:27,9355,110,144030,-10,9350,290,9355,191,B
2016-03-25 9:19:27.5,9350,236,144266,-232,9350,171,9355,182,S
2016-03-25 9:19:28,9350,18,144284,-2,9350,163,9355,182,S
2016-03-25 9:19:29,9350,6,144290,0,9350,163,9355,185,S
2016-03-25 9:19:29.5,9350,6,144296,-6,9350,216,9355,185,S
2016-03-25 9:19:30,9355,10,144306,0,9350,225,9355,185,B
2016-03-25 9:19:30.5,9350,4,144310,0,9350,223,9355,185,S
2016-03-25 9:19:31,9350,2,144312,0,9350,222,9355,187,S
2016-03-25 9:19:32,9350,2,144314,0,9350,221,9355,186,S
2016-03-25 9:19:33,9350,652,144966,-616,9345,434,9350,79,S
2016-03-25 9:19:33.5,9345,80,145046,-18,9345,430,9350,96,S
2016-03-25 9:19:34,9345,230,145276,-196,9345,390,9350,47,S
2016-03-25 9:19:34.5,9345,32,145308,-32,9345,374,9350,55,S
2016-03-25 9:19:35,9350,210,145518,-140,9345,351,9350,28,B
2016-03-25 9:19:36,9345,30,145548,0,9345,334,9350,37,S
2016-03-25 9:19:37,9345,6,145554,0,9345,329,9350,100,S
2016-03-25 9:19:38,9350,2,145556,2,9345,308,9350,95,B
2016-03-25 9:19:39,9350,194,145750,-42,9350,11,9355,235,B
2016-03-25 9:19:39.5,9355,220,145970,-134,9350,13,9355,84,B
2016-03-25 9:19:40,9350,28,145998,-6,9350,65,9355,93,S
2016-03-25 9:19:41,9350,2,146000,2,9350,105,9355,145,S
2016-03-25 9:19:41.5,9350,16,146016,0,9350,98,9355,145,S
2016-03-25 9:19:42,9350,4,146020,-2,9350,97,9355,145,S
2016-03-25 9:19:42.5,9355,2,146022,-2,9350,119,9355,144,B
2016-03-25 9:19:43,9350,260,146282,50,9345,370,9355,197,S
2016-03-25 9:19:45,9355,90,146372,-62,9350,186,9355,198,B
2016-03-25 9:19:46,9350,84,146456,-40,9350,145,9355,199,S
2016-03-25 9:19:47,9350,8,146464,2,9350,187,9355,299,S
2016-03-25 9:19:48,9350,2,146466,0,9350,187,9355,303,S
2016-03-25 9:19:48.5,9350,10,146476,0,9350,182,9355,304,S
2016-03-25 9:19:49,9355,4,146480,0,9350,184,9355,304,B
2016-03-25 9:19:49.5,9350,2,146482,0,9350,205,9355,304,S
2016-03-25 9:19:50,9350,2,146484,-2,9350,205,9355,304,S
2016-03-25 9:19:50.5,9350,8,146492,0,9350,201,9355,304,S
2016-03-25 9:19:53,9355,202,146694,196,9350,215,9355,206,B
2016-03-25 9:19:53.5,9355,36,146730,-8,9350,226,9355,158,B
2016-03-25 9:19:54,9355,314,147044,88,9355,184,9360,553,B
2016-03-25 9:19:55,9355,2,147046,0,9355,187,9360,479,B
2016-03-25 9:19:56,9355,6,147052,-2,9355,186,9360,472,B
2016-03-25 9:19:57,9355,4,147056,-4,9355,183,9360,573,B
2016-03-25 9:19:57.5,9355,2,147058,-2,9355,188,9360,572,B
2016-03-25 9:19:58,9355,2,147060,0,9355,187,9360,621,B
2016-03-25 9:19:59,9355,6,147066,0,9355,185,9360,625,B
2016-03-25 9:19:59.5,9360,36,147102,18,9355,185,9360,507,B
2016-03-25 9:20:00,9355,6,147108,-6,9355,13,9360,506,S
2016-03-25 9:20:00.5,9360,4,147112,4,9355,15,9360,501,B
2016-03-25 9:20:01,9355,10,147122,0,9355,11,9360,502,S
2016-03-25 9:20:01.5,9355,12,147134,-10,9355,25,9360,497,S
2016-03-25 9:20:02,9355,4,147138,2,9355,74,9360,502,S
2016-03-25 9:20:02.5,9355,2,147140,0,9355,76,9360,505,S
2016-03-25 9:20:03,9355,4,147144,0,9355,104,9360,386,S
2016-03-25 9:20:04,9360,214,147358,146,9355,100,9360,278,B
2016-03-25 9:20:04.5,9355,38,147396,-8,9355,106,9360,358,S
2016-03-25 9:20:05,9355,2,147398,0,9355,107,9360,322,S
2016-03-25 9:20:05.5,9355,50,147448,30,9355,69,9360,293,S
2016-03-25 9:20:06,9360,482,147930,-26,9355,69,9360,259,B
2016-03-25 9:20:07,9360,2,147932,2,9355,69,9360,248,B
2016-03-25 9:20:07.5,9355,6,147938,-2,9355,87,9360,253,S
2016-03-25 9:20:08,9355,4,147942,0,9355,102,9360,251,S
2016-03-25 9:20:08.5,9360,2,147944,2,9355,104,9360,253,B
2016-03-25 9:20:09,9360,4,147948,0,9355,106,9360,231,B
2016-03-25 9:20:10,9355,2,147950,2,9355,105,9360,232,S
2016-03-25 9:20:10.5,9360,14,147964,2,9355,99,9360,221,B
2016-03-25 9:20:11,9360,2,147966,2,9355,102,9360,240,B
2016-03-25 9:20:12,9360,102,148068,50,9355,123,9360,255,B
2016-03-25 9:20:12.5,9355,6,148074,-6,9355,120,9360,254,S
2016-03-25 9:20:13,9360,16,148090,-12,9355,171,9360,258,B
2016-03-25 9:20:14,9355,2,148092,0,9355,188,9360,360,S
2016-03-25 9:20:15,9360,2,148094,0,9355,189,9360,360,B
2016-03-25 9:20:16,9360,2,148096,0,9355,198,9360,361,B
2016-03-25 9:20:16.5,9360,4,148100,-2,9355,197,9360,360,B
2016-03-25 9:20:17,9360,184,148284,-12,9355,154,9360,309,B
2016-03-25 9:20:17.5,9360,10,148294,0,9355,157,9360,303,B
2016-03-25 9:20:18,9360,100,148394,68,9355,157,9360,247,B
2016-03-25 9:20:18.5,9355,14,148408,14,9355,167,9360,247,S
2016-03-25 9:20:19,9360,2,148410,0,9355,167,9360,295,B
2016-03-25 9:20:19.5,9360,2,148412,-2,9355,158,9360,299,B
2016-03-25 9:20:20,9360,2,148414,2,9355,159,9360,305,B
2016-03-25 9:20:20.5,9360,44,148458,-16,9355,158,9360,292,B
2016-03-25 9:20:21,9360,196,148654,38,9355,160,9360,197,B
2016-03-25 9:20:21.5,9360,2,148656,-2,9355,171,9360,191,B
2016-03-25 9:20:22,9360,8,148664,-4,9355,172,9360,150,B
2016-03-25 9:20:23,9360,2,148666,-2,9355,184,9360,146,B
2016-03-25 9:20:24,9355,16,148682,-16,9355,171,9360,143,S
2016-03-25 9:20:25,9360,32,148714,4,9355,177,9360,72,B
2016-03-25 9:20:25.5,9360,2,148716,-2,9355,175,9360,78,B
2016-03-25 9:20:27,9355,26,148742,16,9355,200,9360,80,S
2016-03-25 9:20:27.5,9360,40,148782,40,9355,200,9360,60,B
2016-03-25 9:20:28,9360,212,148994,18,9360,46,9365,513,B
2016-03-25 9:20:28.5,9365,274,149268,4,9355,228,9360,47,B
2016-03-25 9:20:30,9360,16,149284,-6,9355,228,9360,40,S
2016-03-25 9:20:30.5,9355,8,149292,-2,9355,226,9360,39,S
2016-03-25 9:20:31,9355,4,149296,0,9355,224,9360,45,S
2016-03-25 9:20:31.5,9360,6,149302,2,9355,224,9360,76,B
2016-03-25 9:20:32,9360,2,149304,2,9355,224,9360,82,B
2016-03-25 9:20:32.5,9360,4,149308,0,9355,224,9360,81,B
2016-03-25 9:20:33,9355,6,149314,2,9355,224,9360,80,S
2016-03-25 9:20:33.5,9360,6,149320,4,9355,222,9360,118,B
2016-03-25 9:20:35,9355,10,149330,0,9355,207,9360,132,S
2016-03-25 9:20:36,9360,40,149370,38,9355,206,9360,113,B
2016-03-25 9:20:36.5,9360,8,149378,-8,9355,207,9360,109,B
2016-03-25 9:20:37,9360,2,149380,0,9355,207,9360,109,B
2016-03-25 9:20:37.5,9360,2,149382,0,9355,207,9360,108,B
2016-03-25 9:20:38,9360,102,149484,74,9355,155,9360,63,B
2016-03-25 9:20:39,9360,10,149494,2,9355,165,9360,58,B
2016-03-25 9:20:40,9355,188,149682,-150,9355,73,9360,57,S
2016-03-25 9:20:43,9355,10,149692,0,9355,115,9360,92,S
2016-03-25 9:20:44,9360,6,149698,0,9355,115,9360,109,B
2016-03-25 9:20:45,9355,16,149714,-12,9355,114,9360,106,S
2016-03-25 9:20:46,9355,10,149724,6,9355,111,9360,107,S
2016-03-25 9:20:48,9355,10,149734,-4,9355,109,9360,102,S
2016-03-25 9:20:52,9355,102,149836,40,9355,60,9360,172,S
2016-03-25 9:20:53,9360,20,149856,0,9355,72,9360,163,B
2016-03-25 9:20:53.5,9355,6,149862,0,9355,62,9360,163,S
2016-03-25 9:20:57,9355,82,149944,-56,9355,19,9360,198,S
2016-03-25 9:20:58,9355,90,150034,66,9355,61,9360,226,S
2016-03-25 9:20:58.5,9355,258,150292,-132,9350,544,9355,70,S
2016-03-25 9:20:59,9355,10,150302,0,9350,544,9355,68,S
2016-03-25 9:21:01,9350,4,150306,0,9350,563,9355,77,S
2016-03-25 9:21:02,9355,16,150322,-2,9350,578,9355,63,B
2016-03-25 9:21:03,9355,2,150324,-2,9350,595,9355,64,B
2016-03-25 9:21:04,9350,20,150344,-20,9350,601,9355,60,S
2016-03-25 9:21:04.5,9350,40,150384,-40,9350,581,9355,60,S
2016-03-25 9:21:05,9355,2,150386,0,9350,582,9355,59,B
2016-03-25 9:21:06,9355,2,150388,-2,9350,583,9355,97,B
2016-03-25 9:21:08,9355,60,150448,0,9350,586,9355,72,B
2016-03-25 9:21:09,9355,200,150648,58,9355,24,9360,297,B
2016-03-25 9:21:09.5,9355,56,150704,-48,9350,561,9355,37,B
2016-03-25 9:21:10,9355,22,150726,-10,9350,677,9355,5,B
2016-03-25 9:21:11,9355,26,150752,-4,9355,4,9360,283,B
2016-03-25 9:21:11.5,9355,334,151086,80,9350,569,9360,283,B
2016-03-25 9:21:12,9355,62,151148,60,9355,20,9360,286,B
2016-03-25 9:21:12.5,9360,8,151156,6,9355,21,9360,287,B
2016-03-25 9:21:14,9355,2,151158,0,9355,116,9360,289,S
2016-03-25 9:21:15,9355,12,151170,12,9355,167,9360,239,S
2016-03-25 9:21:16,9355,4,151174,4,9355,168,9360,247,S
2016-03-25 9:21:17,9355,2,151176,2,9355,188,9360,247,S
2016-03-25 9:21:17.5,9360,4,151180,0,9355,186,9360,281,B
2016-03-25 9:21:18,9355,12,151192,12,9355,180,9360,245,S
2016-03-25 9:21:19,9355,12,151204,8,9355,124,9360,346,S
2016-03-25 9:21:20,9360,100,151304,48,9355,171,9360,296,B
2016-03-25 9:21:20.5,9355,4,151308,2,9355,170,9360,296,S
2016-03-25 9:21:21,9360,42,151350,2,9355,149,9360,218,B
2016-03-25 9:21:22,9360,236,151586,172,9355,183,9360,108,B
2016-03-25 9:21:23,9360,220,151806,70,9360,2,9365,362,B
2016-03-25 9:21:23.3333,9360,14,151820,-6,9355,255,9360,48,B
2016-03-25 9:21:23.6667,9360,14,151834,-4,9355,249,9360,46,B
2016-03-25 9:21:24,9360,100,151934,0,9355,246,9360,116,B
2016-03-25 9:21:28,9355,12,151946,2,9355,223,9360,153,S
2016-03-25 9:21:29,9355,40,151986,-2,9355,223,9360,181,S
2016-03-25 9:21:30,9360,2,151988,0,9355,228,9360,234,B
2016-03-25 9:21:30.5,9355,2,151990,2,9355,228,9360,234,S
2016-03-25 9:21:33,9355,4,151994,4,9355,287,9360,236,S
2016-03-25 9:21:35,9360,2,151996,-2,9355,243,9360,242,B
2016-03-25 9:21:37,9355,2,151998,2,9355,245,9360,254,S
2016-03-25 9:21:37.5,9355,16,152014,16,9355,213,9360,254,S
2016-03-25 9:21:38,9360,10,152024,0,9355,213,9360,250,B
2016-03-25 9:21:39,9355,10,152034,8,9355,219,9360,258,S
2016-03-25 9:21:41,9355,2,152036,0,9355,223,9360,258,S
2016-03-25 9:21:42,9355,42,152078,-8,9355,212,9360,257,S
2016-03-25 9:21:43,9355,10,152088,0,9355,207,9360,316,S
2016-03-25 9:21:45,9355,80,152168,-24,9355,157,9360,329,S
2016-03-25 9:21:46,9355,296,152464,66,9350,680,9355,3,S
2016-03-25 9:21:46.5,9355,6,152470,-2,9350,680,9355,12,S
2016-03-25 9:21:49,9355,10,152480,-4,9350,638,9355,48,S
2016-03-25 9:21:49.5,9355,10,152490,0,9350,638,9355,43,S
2016-03-25 9:21:51,9355,8,152498,0,9350,647,9355,91,S
2016-03-25 9:21:52,9350,8,152506,-8,9350,643,9355,130,S
2016-03-25 9:21:53,9350,22,152528,0,9350,620,9355,182,S
2016-03-25 9:21:53.5,9350,6,152534,0,9350,517,9355,185,S
2016-03-25 9:21:55,9350,2,152536,-2,9350,516,9355,188,S
2016-03-25 9:21:57,9350,200,152736,40,9350,416,9355,216,S
2016-03-25 9:21:58,9350,14,152750,14,9350,409,9355,216,S
2016-03-25 9:21:58.5,9355,60,152810,-52,9350,409,9355,186,B
2016-03-25 9:21:59,9350,6,152816,6,9350,448,9355,187,S
2016-03-25 9:21:59.5,9350,220,153036,-86,9350,330,9355,187,S
2016-03-25 9:22:00,9350,10,153046,10,9350,325,9355,197,S
2016-03-25 9:22:00.5,9350,202,153248,-116,9350,172,9355,219,S
2016-03-25 9:22:01,9350,202,153450,158,9350,70,9355,219,S
2016-03-25 9:22:01.5,9345,146,153596,52,9345,561,9350,60,S
2016-03-25 9:22:02,9350,104,153700,-2,9345,554,9350,70,B
2016-03-25 9:22:03,9350,14,153714,-6,9345,561,9350,110,B
2016-03-25 9:22:04,9345,200,153914,68,9345,458,9350,163,S
2016-03-25 9:22:04.5,9345,10,153924,10,9345,453,9350,165,S
2016-03-25 9:22:05,9350,22,153946,10,9345,440,9350,156,B
2016-03-25 9:22:05.5,9350,106,154052,-98,9345,410,9350,103,B
2016-03-25 9:22:06,9350,102,154154,-88,9350,52,9355,210,B
2016-03-25 9:22:07,9350,208,154362,98,9350,8,9355,206,B
2016-03-25 9:22:07.3333,9350,78,154440,-46,9345,412,9355,210,B
2016-03-25 9:22:07.6667,9350,60,154500,22,9350,101,9355,210,B
2016-03-25 9:22:08,9350,2,154502,0,9350,100,9355,210,B
2016-03-25 9:22:09,9350,20,154522,0,9350,140,9355,231,B
2016-03-25 9:22:09.3333,9350,24,154546,0,9350,128,9355,231,B
2016-03-25 9:22:09.6667,9350,2,154548,-2,9350,147,9355,231,B
2016-03-25 9:22:11,9350,4,154552,-2,9350,150,9355,231,B
2016-03-25 9:22:11.5,9350,46,154598,-6,9350,84,9355,426,B
2016-03-25 9:22:12,9350,8,154606,0,9350,83,9355,399,B
2016-03-25 9:22:14,9350,2,154608,-2,9350,87,9355,414,B
2016-03-25 9:22:15,9355,2,154610,0,9350,90,9355,432,B
2016-03-25 9:22:15.5,9350,2,154612,-2,9350,89,9355,431,S
2016-03-25 9:22:16,9350,4,154616,-4,9350,93,9355,431,S
2016-03-25 9:22:18,9350,298,154914,-72,9345,584,9350,3,S
2016-03-25 9:22:18.5,9355,12,154926,-2,9350,37,9355,209,B
2016-03-25 9:22:19,9350,4,154930,0,9350,190,9355,202,S
2016-03-25 9:22:20,9350,8,154938,-4,9350,229,9355,172,S
2016-03-25 9:22:21,9355,4,154942,0,9350,283,9355,175,B
2016-03-25 9:22:23,9355,6,154948,2,9350,302,9355,154,B
2016-03-25 9:22:23.5,9350,10,154958,-10,9350,286,9355,170,S
2016-03-25 9:22:25,9350,34,154992,-34,9350,272,9355,187,S
2016-03-25 9:22:26,9350,4,154996,0,9350,284,9355,189,S
2016-03-25 9:22:28,9350,8,155004,-8,9350,266,9355,187,S
2016-03-25 9:22:29,9350,14,155018,-14,9350,276,9355,181,S
2016-03-25 9:22:29.5,9355,24,155042,-4,9350,270,9355,176,B
2016-03-25 9:22:31,9355,290,155332,148,9355,249,9360,639,B
2016-03-25 9:22:31.5,9360,102,155434,92,9355,301,9360,547,B
2016-03-25 9:22:32,9355,104,155538,-44,9350,328,9355,23,S
2016-03-25 9:22:32.5,9355,52,155590,50,9355,18,9360,544,S
2016-03-25 9:22:33,9360,2,155592,2,9355,24,9360,569,B
2016-03-25 9:22:33.5,9355,4,155596,4,9355,202,9360,547,S
2016-03-25 9:22:37,9355,30,155626,-14,9355,259,9360,421,S
2016-03-25 9:22:40,9355,2,155628,0,9355,258,9360,423,S
2016-03-25 9:22:40.5,9355,8,155636,4,9355,138,9360,424,S
2016-03-25 9:22:42,9355,2,155638,2,9355,178,9360,426,S
2016-03-25 9:22:42.5,9355,20,155658,-8,9355,169,9360,575,S
2016-03-25 9:22:43,9355,4,155662,0,9355,169,9360,585,S
2016-03-25 9:22:44,9360,10,155672,10,9355,169,9360,584,B
2016-03-25 9:22:44.5,9360,70,155742,-12,9355,142,9360,572,B
2016-03-25 9:22:45,9360,10,155752,-2,9355,170,9360,569,B
2016-03-25 9:22:45.5,9355,82,155834,-80,9355,131,9360,567,S
2016-03-25 9:22:46,9355,10,155844,-2,9355,125,9360,562,S
2016-03-25 9:22:46.5,9355,230,156074,14,9355,10,9360,559,S
2016-03-25 9:22:47,9355,20,156094,-2,9350,423,9355,165,S
2016-03-25 9:22:48,9355,56,156150,0,9350,374,9355,163,S
2016-03-25 9:22:48.5,9355,80,156230,0,9350,355,9355,194,S
2016-03-25 9:22:49,9355,2,156232,-2,9350,354,9355,143,S
2016-03-25 9:22:50,9355,10,156242,0,9350,359,9355,138,S
2016-03-25 9:22:51,9355,4,156246,-2,9350,361,9355,136,S
2016-03-25 9:22:52,9355,2,156248,-2,9350,361,9355,135,S
2016-03-25 9:22:54,9355,2,156250,0,9350,361,9355,135,S
2016-03-25 9:22:54.5,9355,8,156258,-8,9350,361,9355,131,S
2016-03-25 9:22:55,9350,2,156260,0,9350,371,9355,131,S
2016-03-25 9:22:58,9355,48,156308,-8,9350,396,9355,106,B
2016-03-25 9:22:59,9350,4,156312,0,9350,396,9355,106,S
2016-03-25 9:23:00,9355,8,156320,0,9350,397,9355,110,B
2016-03-25 9:23:01,9355,4,156324,2,9350,419,9355,108,B
2016-03-25 9:23:02,9355,8,156332,-8,9350,415,9355,128,B
2016-03-25 9:23:03,9355,104,156436,100,9350,415,9355,78,B
2016-03-25 9:23:05,9355,178,156614,104,9355,107,9360,337,B
2016-03-25 9:23:05.5,9360,20,156634,-18,9355,107,9360,318,B
2016-03-25 9:23:07,9355,2,156636,2,9355,117,9360,321,S
2016-03-25 9:23:08,9360,2,156638,-2,9355,138,9360,349,B
2016-03-25 9:23:10,9355,2,156640,0,9355,235,9360,307,S
2016-03-25 9:23:11,9360,2,156642,-2,9355,274,9360,303,B
2016-03-25 9:23:12,9360,2,156644,-2,9355,294,9360,307,B
2016-03-25 9:23:13,9360,6,156650,0,9355,295,9360,278,B
2016-03-25 9:23:13.5,9360,4,156654,-2,9355,297,9360,270,B
2016-03-25 9:23:14,9360,70,156724,70,9355,689,9360,219,B
2016-03-25 9:23:14.5,9360,398,157122,274,9360,91,9365,529,B
2016-03-25 9:23:15,9360,4,157126,2,9360,338,9365,492,B
2016-03-25 9:23:16,9360,2,157128,2,9360,362,9365,455,B
2016-03-25 9:23:17,9360,6,157134,6,9360,180,9365,469,B
2016-03-25 9:23:18,9360,4,157138,0,9360,103,9365,451,B
2016-03-25 9:23:20,9360,6,157144,-6,9360,100,9365,455,B
2016-03-25 9:23:24,9360,214,157358,106,9360,229,9365,364,B
2016-03-25 9:23:25,9365,2,157360,-2,9360,228,9365,362,B
2016-03-25 9:23:26,9365,226,157586,36,9360,180,9365,265,B
2016-03-25 9:23:28,9365,200,157786,180,9360,189,9365,145,B
2016-03-25 9:23:28.5,9365,136,157922,-32,9360,279,9370,421,B
2016-03-25 9:23:29,9365,4,157926,4,9360,259,9370,271,B
2016-03-25 9:23:29.5,9365,40,157966,0,9360,262,9365,2,B
2016-03-25 9:23:30,9365,30,157996,0,9365,33,9370,608,B
2016-03-25 9:23:30.5,9360,302,158298,182,9365,27,9370,463,S
2016-03-25 9:23:31,9365,28,158326,-26,9365,27,9370,452,B
2016-03-25 9:23:31.5,9365,2,158328,0,9365,28,9370,463,B
2016-03-25 9:23:32,9370,200,158528,48,9365,100,9370,333,B
2016-03-25 9:23:32.5,9370,10,158538,10,9365,117,9370,323,B
2016-03-25 9:23:33,9370,10,158548,0,9365,122,9370,314,B
2016-03-25 9:23:33.5,9365,76,158624,-30,9365,84,9370,314,S
2016-03-25 9:23:34,9365,2,158626,2,9365,83,9370,363,S
2016-03-25 9:23:34.5,9365,2,158628,0,9365,82,9370,365,S
2016-03-25 9:23:35,9370,2,158630,2,9365,82,9370,358,B
2016-03-25 9:23:35.5,9365,2,158632,0,9365,81,9370,355,S
2016-03-25 9:23:36,9365,2,158634,2,9365,82,9370,359,S
2016-03-25 9:23:36.5,9370,4,158638,0,9365,72,9370,358,B
2016-03-25 9:23:37,9365,2,158640,0,9365,71,9370,359,S
2016-03-25 9:23:38,9370,4,158644,2,9365,71,9370,342,B
2016-03-25 9:23:38.5,9370,340,158984,86,9365,202,9375,331,B
2016-03-25 9:23:39,9370,340,159324,-10,9365,135,9370,133,B
2016-03-25 9:23:39.5,9370,8,159332,-4,9365,136,9370,129,B
2016-03-25 9:23:40,9370,88,159420,-80,9365,135,9370,100,B
2016-03-25 9:23:40.5,9370,6,159426,0,9365,162,9370,64,B
2016-03-25 9:23:41,9370,4,159430,-2,9365,217,9370,180,B
2016-03-25 9:23:41.5,9370,28,159458,-16,9365,219,9370,157,B
2016-03-25 9:23:42,9370,36,159494,-8,9365,230,9370,143,B
2016-03-25 9:23:42.5,9370,2,159496,0,9365,290,9370,191,B
2016-03-25 9:23:43,9365,2,159498,0,9365,291,9370,262,S
2016-03-25 9:23:43.5,9370,100,159598,90,9365,291,9370,194,B
2016-03-25 9:23:44,9370,4,159602,0,9365,290,9370,143,B
2016-03-25 9:23:44.5,9370,2,159604,0,9365,291,9370,137,B
2016-03-25 9:23:45,9370,8,159612,2,9365,291,9370,132,B
2016-03-25 9:23:46,9370,38,159650,12,9370,36,9375,494,B
2016-03-25 9:23:46.5,9375,8,159658,-8,9370,34,9375,475,B
2016-03-25 9:23:47,9370,2,159660,2,9370,33,9375,473,S
2016-03-25 9:23:47.5,9375,4,159664,0,9370,36,9375,371,B
2016-03-25 9:23:48,9370,6,159670,0,9370,39,9375,347,S
2016-03-25 9:23:49,9375,10,159680,0,9370,45,9375,344,B
2016-03-25 9:23:49.5,9370,92,159772,-10,9365,342,9370,10,S
2016-03-25 9:23:50,9370,20,159792,4,9370,7,9375,379,S
2016-03-25 9:23:51,9370,4,159796,2,9370,7,9375,374,S
2016-03-25 9:23:51.5,9365,16,159812,2,9365,368,9370,27,S
2016-03-25 9:23:52,9370,2,159814,-2,9365,363,9370,37,B
2016-03-25 9:23:52.5,9370,74,159888,-24,9365,352,9370,6,B
2016-03-25 9:23:53,9370,8,159896,6,9365,356,9370,4,B
2016-03-25 9:23:55,9370,4,159900,2,9365,376,9370,31,B
2016-03-25 9:23:57,9370,2,159902,0,9365,375,9370,34,B
2016-03-25 9:23:58,9365,6,159908,2,9365,374,9370,33,S
2016-03-25 9:23:58.5,9370,92,160000,36,9365,362,9370,39,B
2016-03-25 9:24:00,9370,12,160012,0,9365,359,9370,51,B
2016-03-25 9:24:01,9370,10,160022,0,9365,359,9370,53,B
2016-03-25 9:24:01.5,9370,2,160024,0,9365,358,9370,56,B
2016-03-25 9:24:02,9370,8,160032,0,9365,356,9370,54,B
2016-03-25 9:24:04,9370,2,160034,0,9365,356,9370,51,B
2016-03-25 9:24:05,9370,98,160132,-52,9365,268,9370,163,B
2016-03-25 9:24:05.5,9370,4,160136,-2,9365,267,9370,177,B
2016-03-25 9:24:07,9365,10,160146,-10,9365,253,9370,200,S
2016-03-25 9:24:08,9370,10,160156,-10,9365,253,9370,195,B
2016-03-25 9:24:09,9370,2,160158,-2,9365,252,9370,196,B
2016-03-25 9:24:09.5,9370,100,160258,62,9365,302,9370,90,B
2016-03-25 9:24:10,9365,10,160268,0,9365,297,9370,90,S
2016-03-25 9:24:12,9365,8,160276,-8,9365,291,9370,99,S
2016-03-25 9:24:12.5,9365,10,160286,0,9365,286,9370,99,S
2016-03-25 9:24:13,9370,2,160288,2,9365,286,9370,97,B
2016-03-25 9:24:16,9365,2,160290,-2,9365,284,9370,103,S
2016-03-25 9:24:17,9370,8,160298,-6,9365,284,9370,120,B
2016-03-25 9:24:19,9365,2,160300,-2,9365,282,9370,120,S
2016-03-25 9:24:20,9370,8,160308,0,9365,282,9370,121,B
2016-03-25 9:24:22,9365,2,160310,-2,9365,280,9370,122,S
2016-03-25 9:24:23,9365,2,160312,-2,9365,279,9370,132,S
2016-03-25 9:24:23.5,9365,2,160314,0,9365,278,9370,132,S
2016-03-25 9:24:25,9365,2,160316,-2,9365,538,9370,134,S
2016-03-25 9:24:25.5,9365,6,160322,-4,9365,541,9370,132,S
2016-03-25 9:24:26,9370,72,160394,-2,9365,506,9370,122,B
2016-03-25 9:24:27,9370,6,160400,0,9365,525,9370,119,B
2016-03-25 9:24:28,9365,18,160418,-16,9365,508,9370,126,S
2016-03-25 9:24:29,9365,12,160430,-6,9365,490,9370,123,S
2016-03-25 9:24:31,9365,2,160432,0,9365,503,9370,124,S
2016-03-25 9:24:32,9365,2,160434,-2,9365,498,9370,130,S
2016-03-25 9:24:34,9370,2,160436,-2,9365,467,9370,147,B
2016-03-25 9:24:36,9370,8,160444,0,9365,473,9370,145,B
2016-03-25 9:24:37,9365,76,160520,-42,9365,467,9370,147,S
2016-03-25 9:24:37.5,9365,108,160628,-62,9365,388,9370,229,S
2016-03-25 9:24:38,9370,42,160670,-2,9365,387,9370,228,B
2016-03-25 9:24:41,9365,4,160674,0,9365,374,9370,239,S
2016-03-25 9:24:41.5,9365,2,160676,0,9365,372,9370,246,S
2016-03-25 9:24:43,9365,4,160680,4,9365,390,9370,248,S
2016-03-25 9:24:45,9365,10,160690,0,9365,409,9370,249,S
2016-03-25 9:24:45.5,9370,2,160692,0,9365,409,9370,253,B
2016-03-25 9:24:46,9365,2,160694,0,9365,408,9370,266,S
2016-03-25 9:24:46.5,9370,2,160696,0,9365,408,9370,269,B
2016-03-25 9:24:48,9365,14,160710,4,9365,406,9370,287,S
2016-03-25 9:24:49,9365,2,160712,0,9365,405,9370,289,S
2016-03-25 9:24:50,9365,200,160912,192,9365,304,9370,289,S
2016-03-25 9:24:50.5,9365,56,160968,8,9365,271,9370,320,S
2016-03-25 9:24:51,9365,346,161314,102,9360,359,9370,352,S
2016-03-25 9:24:51.5,9360,188,161502,-30,9360,404,9365,2,S
2016-03-25 9:24:52,9370,138,161640,30,9365,8,9370,413,B
2016-03-25 9:24:53,9365,56,161696,0,9365,107,9370,423,S
2016-03-25 9:24:53.5,9370,100,161796,62,9365,107,9370,378,B
2016-03-25 9:24:54,9370,102,161898,72,9365,166,9370,252,B
2016-03-25 9:24:55,9370,58,161956,36,9365,170,9370,224,B
2016-03-25 9:24:56,9365,6,161962,0,9365,196,9370,232,S
2016-03-25 9:24:56.5,9365,10,161972,0,9365,195,9370,239,S
2016-03-25 9:24:59,9365,22,161994,0,9365,265,9370,232,S
2016-03-25 9:25:00,9370,128,162122,-78,9365,251,9370,161,B
2016-03-25 9:25:01,9370,50,162172,16,9365,299,9370,157,B
2016-03-25 9:25:02,9370,40,162212,0,9365,388,9370,157,B
2016-03-25 9:25:03,9370,2,162214,0,9365,389,9370,157,B
2016-03-25 9:25:03.5,9370,16,162230,14,9365,389,9370,149,B
2016-03-25 9:25:04,9370,56,162286,0,9365,606,9370,121,B
2016-03-25 9:25:05,9370,240,162526,-2,9370,270,9375,588,B
2016-03-25 9:25:07,9370,2,162528,2,9370,214,9375,516,B
2016-03-25 9:25:07.5,9375,100,162628,-84,9370,214,9375,466,B
2016-03-25 9:25:08,9375,14,162642,4,9370,219,9375,462,B
2016-03-25 9:25:09,9370,4,162646,4,9370,217,9375,462,S
2016-03-25 9:25:09.5,9375,2,162648,0,9370,269,9375,461,B
2016-03-25 9:25:10,9375,240,162888,-148,9370,269,9375,292,B
2016-03-25 9:25:10.5,9375,14,162902,2,9370,268,9375,289,B
2016-03-25 9:25:13,9375,46,162948,-32,9370,268,9375,285,B
2016-03-25 9:25:13.5,9370,20,162968,20,9370,258,9375,295,S
2016-03-25 9:25:14,9375,22,162990,-4,9370,256,9375,283,B
2016-03-25 9:25:14.5,9375,4,162994,0,9370,259,9375,281,B
2016-03-25 9:25:15,9375,118,163112,90,9370,260,9375,243,B
2016-03-25 9:25:16,9375,204,163316,-76,9370,242,9375,146,B
2016-03-25 9:25:16.5,9375,292,163608,60,9370,266,9380,953,B
2016-03-25 9:25:17,9375,246,163854,-34,9370,268,9375,44,B
2016-03-25 9:25:17.5,9375,24,163878,0,9370,266,9375,70,B
2016-03-25 9:25:20,9375,12,163890,-10,9370,232,9375,122,B
2016-03-25 9:25:20.5,9375,10,163900,-6,9370,231,9375,145,B
2016-03-25 9:25:21,9375,20,163920,-20,9370,244,9375,338,B
2016-03-25 9:25:23,9375,2,163922,0,9370,235,9375,339,B
2016-03-25 9:25:26,9370,2,163924,2,9370,233,9375,352,S
2016-03-25 9:25:27,9375,12,163936,-2,9370,233,9375,346,B
2016-03-25 9:25:27.5,9375,2,163938,-2,9370,233,9375,345,B
2016-03-25 9:25:28,9370,2,163940,2,9370,231,9375,347,S
2016-03-25 9:25:28.5,9370,10,163950,0,9370,226,9375,348,S
2016-03-25 9:25:31,9375,6,163956,2,9370,225,9375,364,B
2016-03-25 9:25:31.5,9370,2,163958,2,9370,224,9375,364,S
2016-03-25 9:25:34,9375,4,163962,0,9370,298,9375,376,B
2016-03-25 9:25:35,9370,2,163964,2,9370,297,9375,376,S
2016-03-25 9:25:36,9370,12,163976,-4,9370,300,9375,372,S
2016-03-25 9:25:36.5,9375,2,163978,0,9370,300,9375,373,B
2016-03-25 9:25:37,9370,200,164178,58,9370,199,9375,402,S
2016-03-25 9:25:38,9375,6,164184,-2,9370,207,9375,403,B
2016-03-25 9:25:39,9375,414,164598,310,9365,324,9370,42,B
2016-03-25 9:25:39.5,9370,52,164650,-34,9365,280,9370,107,S
2016-03-25 9:25:40,9370,26,164676,-24,9365,270,9370,97,S
2016-03-25 9:25:40.5,9370,4,164680,0,9365,259,9370,99,S
2016-03-25 9:25:41,9370,58,164738,0,9365,276,9370,53,S
2016-03-25 9:25:41.5,9370,108,164846,82,9370,10,9375,426,S
2016-03-25 9:25:42,9370,22,164868,0,9370,6,9375,425,S
2016-03-25 9:25:43,9370,6,164874,0,9370,15,9375,430,S
2016-03-25 9:25:44,9375,4,164878,2,9370,29,9375,429,B
2016-03-25 9:25:45,9375,4,164882,4,9370,30,9375,470,B
2016-03-25 9:25:46,9375,2,164884,2,9370,235,9375,469,B
2016-03-25 9:25:48,9375,20,164904,20,9370,239,9375,461,B
2016-03-25 9:25:48.5,9370,12,164916,-6,9370,286,9375,461,S
2016-03-25 9:25:49,9370,14,164930,-6,9370,279,9375,462,S
2016-03-25 9:25:49.5,9370,2,164932,2,9370,283,9375,462,S
2016-03-25 9:25:50,9370,2,164934,2,9370,284,9375,462,S
2016-03-25 9:25:50.5,9370,10,164944,2,9370,279,9375,462,S
2016-03-25 9:25:52,9370,2,164946,0,9370,298,9375,462,S
2016-03-25 9:25:53,9370,100,165046,88,9370,250,9375,462,S
2016-03-25 9:25:55,9375,4,165050,4,9370,259,9375,461,B
2016-03-25 9:25:56,9370,4,165054,4,9370,258,9375,462,S
2016-03-25 9:25:57,9375,20,165074,20,9370,259,9375,451,B
2016-03-25 9:25:58,9375,62,165136,-50,9370,260,9375,396,B
2016-03-25 9:25:59,9370,42,165178,40,9370,249,9375,402,S
2016-03-25 9:26:00,9375,18,165196,0,9370,242,9375,402,B
2016-03-25 9:26:00.3333,9370,18,165214,0,9370,232,9375,402,S
2016-03-25 9:26:00.6667,9370,2,165216,0,9370,231,9375,402,S
2016-03-25 9:26:01,9375,20,165236,-18,9370,231,9375,403,B
2016-03-25 9:26:02,9370,2,165238,2,9370,230,9375,403,S
2016-03-25 9:26:02.5,9375,2,165240,-2,9370,230,9375,402,B
2016-03-25 9:26:03,9375,26,165266,0,9370,228,9375,391,B
2016-03-25 9:26:07,9375,846,166112,-360,9375,105,9380,1262,B
2016-03-25 9:26:09,9375,10,166122,-10,9375,103,9380,1258,B
2016-03-25 9:26:09.5,9380,10,166132,-8,9375,102,9380,1249,B
2016-03-25 9:26:10,9375,4,166136,-4,9375,101,9380,1218,S
2016-03-25 9:26:10.5,9380,8,166144,0,9375,108,9380,1212,B
2016-03-25 9:26:11,9380,4,166148,0,9375,108,9380,1192,B
2016-03-25 9:26:11.3333,9380,12,166160,-2,9375,110,9380,1186,B
2016-03-25 9:26:11.6667,9375,28,166188,0,9375,96,9380,1185,S
2016-03-25 9:26:12,9375,200,166388,-180,9370,354,9375,19,S
2016-03-25 9:26:13,9375,52,166440,0,9375,21,9380,1150,S
2016-03-25 9:26:13.5,9380,2,166442,-2,9375,21,9380,1150,B
2016-03-25 9:26:14,9380,8,166450,0,9375,33,9380,1144,B
2016-03-25 9:26:14.5,9375,2,166452,2,9375,133,9380,1121,S
2016-03-25 9:26:15,9380,10,166462,0,9375,135,9380,1120,B
2016-03-25 9:26:15.5,9375,304,166766,-112,9375,24,9380,1118,S
2016-03-25 9:26:16,9375,50,166816,48,9370,360,9375,88,S
2016-03-25 9:26:16.5,9370,4,166820,4,9370,369,9375,136,S
2016-03-25 9:26:17,9375,820,167640,-390,9375,11,9380,1028,B
2016-03-25 9:26:17.5,9375,98,167738,12,9375,37,9380,1011,B
2016-03-25 9:26:18,9375,52,167790,52,9375,11,9380,1015,B
2016-03-25 9:26:18.5,9375,26,167816,-4,9370,360,9375,91,B
2016-03-25 9:26:19,9375,4,167820,0,9370,360,9375,92,B
2016-03-25 9:26:19.5,9375,10,167830,0,9370,360,9375,88,B
2016-03-25 9:26:20,9375,6,167836,0,9370,361,9375,86,B
2016-03-25 9:26:21,9375,14,167850,-10,9370,382,9375,81,B
2016-03-25 9:26:21.5,9375,8,167858,0,9370,381,9375,77,B
2016-03-25 9:26:22,9375,42,167900,-2,9370,381,9375,56,B
2016-03-25 9:26:22.5,9375,18,167918,0,9370,378,9375,48,B
2016-03-25 9:26:23,9375,96,168014,-54,9375,30,9380,839,B
2016-03-25 9:26:24,9375,98,168112,0,9370,354,9375,116,B
2016-03-25 9:26:25,9375,2,168114,0,9370,361,9375,132,B
2016-03-25 9:26:26,9375,2,168116,0,9370,359,9375,132,B
2016-03-25 9:26:26.5,9375,4,168120,0,9370,363,9375,131,B
2016-03-25 9:26:27,9370,2,168122,0,9370,363,9375,137,S
2016-03-25 9:26:27.5,9375,4,168126,0,9370,363,9375,137,B
2016-03-25 9:26:28,9375,2,168128,0,9370,363,9375,136,B
2016-03-25 9:26:28.5,9375,2,168130,0,9370,363,9375,136,B
2016-03-25 9:26:29,9375,70,168200,6,9370,358,9375,108,B
2016-03-25 9:26:34,9370,2,168202,0,9370,362,9375,141,S
2016-03-25 9:26:36,9375,2,168204,0,9370,377,9375,144,B
2016-03-25 9:26:37,9375,40,168244,40,9370,377,9375,124,B
2016-03-25 9:26:38,9375,6,168250,-2,9370,375,9375,123,B
2016-03-25 9:26:39,9375,294,168544,246,9375,3,9380,1036,B
2016-03-25 9:26:39.5,9375,4,168548,-2,9370,375,9380,1040,B
2016-03-25 9:26:40,9375,28,168576,-28,9370,355,9375,4,B
2016-03-25 9:26:41,9375,8,168584,-6,9370,355,9375,2,B
2016-03-25 9:26:41.5,9375,8,168592,-2,9370,355,9375,2,B
2016-03-25 9:26:42,9375,10,168602,10,9375,6,9380,1054,B
2016-03-25 9:26:42.5,9375,2,168604,2,9375,5,9380,1055,B
2016-03-25 9:26:43,9375,4,168608,4,9375,23,9380,1063,B
2016-03-25 9:26:45,9375,24,168632,4,9375,21,9380,931,B
2016-03-25 9:26:46,9375,2,168634,2,9375,20,9380,878,B
2016-03-25 9:26:46.3333,9375,10,168644,10,9375,16,9380,864,B
2016-03-25 9:26:46.6667,9375,4,168648,4,9375,82,9380,865,B
2016-03-25 9:26:48,9380,4,168652,0,9375,143,9380,864,B
2016-03-25 9:26:49,9375,14,168666,-6,9375,140,9380,865,S
2016-03-25 9:26:51,9380,2,168668,0,9375,163,9380,840,B
2016-03-25 9:26:51.5,9380,20,168688,-20,9375,166,9380,829,B
2016-03-25 9:26:52,9380,14,168702,-14,9375,166,9380,822,B
2016-03-25 9:26:52.5,9380,4,168706,-4,9375,166,9380,823,B
2016-03-25 9:26:54,9380,2,168708,0,9375,167,9380,820,B
2016-03-25 9:26:55,9375,4,168712,0,9375,180,9380,822,S
2016-03-25 9:26:58,9375,4,168716,4,9375,187,9380,822,S
2016-03-25 9:26:59,9375,4,168720,4,9375,181,9380,825,S
2016-03-25 9:27:00,9375,4,168724,2,9375,179,9380,824,S
2016-03-25 9:27:01,9380,10,168734,-8,9375,715,9380,820,B
2016-03-25 9:27:02,9375,624,169358,-460,9375,354,9380,790,S
2016-03-25 9:27:03,9380,4,169362,0,9375,354,9380,787,B
2016-03-25 9:27:03.5,9380,10,169372,0,9375,350,9380,783,B
2016-03-25 9:27:04,9375,2,169374,0,9375,349,9380,767,S
2016-03-25 9:27:04.5,9375,2,169376,0,9375,349,9380,767,S
2016-03-25 9:27:05,9380,10,169386,-8,9375,349,9380,762,B
2016-03-25 9:27:06,9380,2,169388,0,9375,362,9380,764,B
2016-03-25 9:27:07,9380,16,169404,0,9375,362,9380,756,B
2016-03-25 9:27:07.5,9375,2,169406,0,9375,361,9380,756,S
2016-03-25 9:27:08,9375,32,169438,-10,9375,361,9380,746,S
2016-03-25 9:27:09,9380,2,169440,-2,9375,361,9380,745,B
2016-03-25 9:27:09.5,9380,4,169444,0,9375,360,9380,744,B
2016-03-25 9:27:11,9375,8,169452,0,9375,357,9380,758,S
2016-03-25 9:27:12,9375,716,170168,42,9370,379,9375,77,S
2016-03-25 9:27:13,9375,6,170174,6,9370,378,9375,121,S
2016-03-25 9:27:14,9375,2,170176,2,9370,378,9375,246,S
2016-03-25 9:27:15,9375,4,170180,2,9370,377,9375,297,S
2016-03-25 9:27:15.5,9375,4,170184,4,9370,377,9375,295,S
2016-03-25 9:27:18,9375,2,170186,0,9370,382,9375,295,S
2016-03-25 9:27:18.5,9375,12,170198,12,9370,382,9375,291,S
2016-03-25 9:27:19,9375,2,170200,0,9370,382,9375,290,S
2016-03-25 9:27:19.5,9375,10,170210,10,9370,382,9375,285,S
2016-03-25 9:27:26,9370,36,170246,-36,9370,317,9375,313,S
2016-03-25 9:27:26.5,9375,2,170248,2,9370,318,9375,312,B
2016-03-25 9:27:27,9370,634,170882,394,9365,275,9370,80,S
2016-03-25 9:27:27.5,9365,2,170884,2,9365,235,9370,87,S
2016-03-25 9:27:28,9370,4,170888,-4,9365,233,9370,85,B
2016-03-25 9:27:28.5,9370,20,170908,-6,9365,228,9370,129,B
2016-03-25 9:27:29,9365,4,170912,0,9365,205,9370,131,S
2016-03-25 9:27:30,9370,40,170952,2,9365,205,9370,111,B
2016-03-25 9:27:30.5,9370,6,170958,6,9365,215,9370,108,B
2016-03-25 9:27:31,9365,2,170960,0,9365,214,9370,108,S
2016-03-25 9:27:32,9365,4,170964,-4,9365,212,9370,113,S
2016-03-25 9:27:33,9365,6,170970,0,9365,225,9370,117,S
2016-03-25 9:27:34,9365,214,171184,110,9365,106,9370,146,S
2016-03-25 9:27:35,9370,2,171186,2,9365,117,9370,146,B
2016-03-25 9:27:35.5,9365,10,171196,0,9365,112,9370,147,S
2016-03-25 9:27:36,9365,264,171460,148,9365,72,9370,205,S
2016-03-25 9:27:36.5,9370,6,171466,2,9365,92,9370,214,B
2016-03-25 9:27:37,9365,12,171478,10,9365,86,9370,214,S
2016-03-25 9:27:37.5,9365,26,171504,24,9365,56,9370,214,S
2016-03-25 9:27:38,9365,118,171622,-6,9360,535,9365,93,S
2016-03-25 9:27:38.5,9365,4,171626,0,9360,507,9365,102,S
2016-03-25 9:27:40,9365,2,171628,2,9360,452,9365,104,S
2016-03-25 9:27:40.5,9365,234,171862,76,9360,352,9365,137,S
2016-03-25 9:27:41,9365,2,171864,2,9360,338,9365,141,S
2016-03-25 9:27:41.5,9365,4,171868,4,9360,347,9365,139,S
2016-03-25 9:27:42,9360,8,171876,6,9360,344,9365,136,S
2016-03-25 9:27:42.5,9360,32,171908,8,9360,328,9365,136,S
2016-03-25 9:27:43,9365,24,171932,24,9360,324,9365,124,B
2016-03-25 9:27:43.5,9360,24,171956,22,9360,349,9365,114,S
2016-03-25 9:27:44,9365,58,172014,0,9360,372,9365,35,B
2016-03-25 9:27:44.5,9365,70,172084,56,9365,4,9370,228,B
2016-03-25 9:27:45,9365,4,172088,-2,9365,2,9370,228,B
2016-03-25 9:27:46,9365,84,172172,-38,9365,238,9370,230,B
2016-03-25 9:27:46.5,9365,26,172198,0,9365,277,9370,215,B
2016-03-25 9:27:47,9370,2,172200,2,9365,320,9370,214,B
2016-03-25 9:27:48,9365,50,172250,-50,9365,295,9370,215,S
2016-03-25 9:27:49,9370,6,172256,2,9365,296,9370,203,B
2016-03-25 9:27:50,9365,4,172260,-4,9365,294,9370,203,S
2016-03-25 9:27:51,9365,10,172270,-10,9365,340,9370,212,S
2016-03-25 9:27:51.5,9365,2,172272,-2,9365,339,9370,198,S
2016-03-25 9:27:52,9370,452,172724,-362,9370,78,9375,349,B
2016-03-25 9:27:53,9370,2,172726,-2,9370,77,9375,323,B
2016-03-25 9:27:53.5,9370,4,172730,-2,9370,114,9375,361,B
2016-03-25 9:27:55,9370,2,172732,-2,9370,113,9375,355,B
2016-03-25 9:27:55.5,9370,50,172782,-46,9370,88,9375,358,B
2016-03-25 9:27:56,9370,174,172956,-96,9365,374,9370,15,B
2016-03-25 9:27:56.5,9365,2,172958,0,9365,373,9370,15,S
2016-03-25 9:27:58,9370,2,172960,0,9365,378,9370,66,B
2016-03-25 9:27:59,9370,6,172966,2,9365,379,9370,53,B
2016-03-25 9:28:01,9370,2,172968,0,9365,390,9370,53,B
2016-03-25 9:28:02,9365,12,172980,-12,9365,384,9370,53,S
2016-03-25 9:28:02.5,9370,104,173084,-14,9370,2,9375,361,B
2016-03-25 9:28:03,9370,40,173124,16,9370,41,9375,361,B
2016-03-25 9:28:04,9370,108,173232,-26,9365,384,9370,105,B
2016-03-25 9:28:06,9370,204,173436,4,9365,280,9370,202,B
2016-03-25 9:28:06.5,9370,10,173446,10,9365,280,9370,199,B
2016-03-25 9:28:08,9370,6,173452,6,9365,280,9370,199,B
2016-03-25 9:28:09,9370,20,173472,0,9365,278,9370,194,B
2016-03-25 9:28:13,9370,604,174076,-210,9370,89,9375,240,B
2016-03-25 9:28:13.5,9375,30,174106,20,9370,100,9375,218,B
2016-03-25 9:28:14,9375,244,174350,-118,9375,181,9380,849,B
2016-03-25 9:28:15,9375,2,174352,-2,9375,180,9380,840,B
2016-03-25 9:28:17,9375,4,174356,-4,9375,182,9380,818,B
2016-03-25 9:28:19,9375,2,174358,0,9375,182,9380,829,B
2016-03-25 9:28:19.5,9380,2,174360,0,9375,484,9380,827,B
2016-03-25 9:28:20,9375,12,174372,-2,9375,483,9380,827,S
2016-03-25 9:28:20.5,9380,202,174574,94,9375,533,9380,697,B
2016-03-25 9:28:21,9385,1396,175970,122,9380,149,9385,746,B
2016-03-25 9:28:22,9385,52,176022,-18,9380,176,9385,728,B
2016-03-25 9:28:22.5,9385,18,176040,-12,9380,258,9385,718,B
2016-03-25 9:28:23,9385,32,176072,26,9380,274,9385,702,B
2016-03-25 9:28:23.5,9385,20,176092,2,9380,275,9385,691,B
2016-03-25 9:28:24,9385,2,176094,0,9380,277,9385,690,B
2016-03-25 9:28:24.5,9385,122,176216,50,9380,276,9385,630,B
2016-03-25 9:28:25,9385,246,176462,84,9380,176,9385,607,B
2016-03-25 9:28:25.5,9385,2,176464,0,9380,177,9385,607,B
2016-03-25 9:28:26,9385,2,176466,0,9380,177,9385,606,B
2016-03-25 9:28:26.5,9385,36,176502,-30,9380,177,9385,588,B
2016-03-25 9:28:27,9385,122,176624,16,9380,176,9385,518,B
2016-03-25 9:28:27.5,9385,22,176646,20,9380,223,9385,512,B
2016-03-25 9:28:28,9385,12,176658,4,9380,222,9385,507,B
2016-03-25 9:28:28.5,9385,16,176674,2,9380,216,9385,510,B
2016-03-25 9:28:29,9380,24,176698,22,9380,215,9385,500,S
2016-03-25 9:28:30,9385,24,176722,24,9380,216,9385,488,B
2016-03-25 9:28:31,9380,2,176724,0,9380,215,9385,490,S
2016-03-25 9:28:31.5,9380,26,176750,22,9380,214,9385,479,S
2016-03-25 9:28:32,9385,14,176764,-10,9380,214,9385,467,B
2016-03-25 9:28:32.5,9385,2,176766,2,9380,214,9385,466,B
2016-03-25 9:28:33,9385,6,176772,0,9380,218,9385,463,B
2016-03-25 9:28:33.5,9380,2,176774,0,9380,217,9385,474,S
2016-03-25 9:28:35,9380,4,176778,0,9380,215,9385,481,S
2016-03-25 9:28:35.5,9380,2,176780,0,9380,214,9385,484,S
2016-03-25 9:28:36,9385,2,176782,0,9380,218,9385,484,B
2016-03-25 9:28:37,9385,20,176802,0,9380,167,9385,529,B
2016-03-25 9:28:37.5,9380,338,177140,-314,9375,581,9380,301,S
2016-03-25 9:28:38,9375,2,177142,-2,9375,581,9380,307,S
2016-03-25 9:28:38.5,9380,24,177166,-2,9375,581,9380,428,B
2016-03-25 9:28:39,9375,2,177168,0,9375,580,9380,344,S
2016-03-25 9:28:39.5,9380,2,177170,-2,9375,590,9380,345,B
2016-03-25 9:28:40,9375,200,177370,-200,9375,501,9380,347,S
2016-03-25 9:28:41,9380,2,177372,0,9375,498,9380,349,B
2016-03-25 9:28:41.5,9380,2,177374,-2,9375,499,9380,348,B
2016-03-25 9:28:42,9380,2,177376,-2,9375,500,9380,347,B
2016-03-25 9:28:43,9380,2,177378,0,9375,502,9380,299,B
2016-03-25 9:28:43.5,9380,2,177380,0,9375,503,9380,299,B
2016-03-25 9:28:44,9380,4,177384,0,9375,482,9380,310,B
2016-03-25 9:28:46,9375,430,177814,2,9375,354,9380,295,S
2016-03-25 9:28:48,9380,16,177830,-12,9375,353,9380,439,B
2016-03-25 9:28:48.5,9375,8,177838,-8,9375,350,9380,443,S
2016-03-25 9:28:49,9380,62,177900,0,9375,350,9380,412,B
2016-03-25 9:28:49.5,9375,4,177904,0,9375,348,9380,418,S
2016-03-25 9:28:50,9380,42,177946,-10,9375,368,9380,400,B
2016-03-25 9:28:51,9380,2,177948,0,9375,341,9380,400,B
2016-03-25 9:28:51.5,9375,6,177954,-2,9375,337,9380,400,S
2016-03-25 9:28:52,9375,20,177974,0,9375,326,9380,401,S
2016-03-25 9:28:52.5,9380,20,177994,0,9375,327,9380,391,B
2016-03-25 9:28:53,9375,4,177998,-2,9375,331,9380,391,S
2016-03-25 9:28:54,9380,2,178000,-2,9375,330,9380,469,B
2016-03-25 9:28:56,9380,36,178036,0,9375,328,9380,470,B
2016-03-25 9:28:58,9380,6,178042,0,9375,335,9380,477,B
2016-03-25 9:28:59,9380,10,178052,-10,9375,344,9380,472,B
2016-03-25 9:28:59.5,9380,8,178060,0,9375,344,9380,468,B
2016-03-25 9:29:00,9375,4,178064,-2,9375,343,9380,469,S
2016-03-25 9:29:01,9380,8,178072,-6,9375,342,9380,465,B
2016-03-25 9:29:02,9380,4,178076,0,9375,310,9380,474,B
2016-03-25 9:29:04,9375,50,178126,-50,9375,304,9380,474,S
2016-03-25 9:29:05,9380,116,178242,-16,9375,314,9380,381,B
2016-03-25 9:29:05.5,9380,32,178274,-32,9375,300,9380,364,B
2016-03-25 9:29:06,9375,2,178276,0,9375,295,9380,364,S
2016-03-25 9:29:07,9375,10,178286,0,9375,287,9380,356,S
2016-03-25 9:29:08,9375,6,178292,0,9375,284,9380,357,S
2016-03-25 9:29:09,9375,8,178300,0,9375,282,9380,364,S
2016-03-25 9:29:10,9380,6,178306,-6,9375,283,9380,361,B
2016-03-25 9:29:10.5,9380,22,178328,-20,9375,282,9380,351,B
2016-03-25 9:29:11,9380,44,178372,-4,9375,267,9380,337,B
2016-03-25 9:29:14,9380,10,178382,-8,9375,269,9380,332,B
2016-03-25 9:29:15,9380,2,178384,2,9375,271,9380,332,B
2016-03-25 9:29:16,9375,126,178510,-6,9375,211,9380,330,S
2016-03-25 9:29:16.5,9380,2,178512,-2,9375,211,9380,380,B
2016-03-25 9:29:17,9380,20,178532,-20,9375,211,9380,370,B
2016-03-25 9:29:18,9380,2,178534,-2,9375,212,9380,370,B
2016-03-25 9:29:19,9380,4,178538,-4,9375,513,9380,372,B
2016-03-25 9:29:19.5,9380,2,178540,0,9375,515,9380,321,B
2016-03-25 9:29:20,9375,10,178550,-2,9375,514,9380,312,S
2016-03-25 9:29:22,9380,8,178558,-8,9375,528,9380,318,B
2016-03-25 9:29:22.3333,9375,2,178560,-2,9375,527,9380,319,S
2016-03-25 9:29:22.6667,9375,4,178564,-4,9375,526,9380,318,S
2016-03-25 9:29:23,9380,4,178568,-4,9375,526,9380,316,B
2016-03-25 9:29:23.5,9375,10,178578,-10,9375,522,9380,313,S
2016-03-25 9:29:24,9380,2,178580,0,9375,548,9380,313,B
2016-03-25 9:29:25,9380,2,178582,-2,9375,549,9380,312,B
2016-03-25 9:29:25.5,9380,2,178584,0,9375,548,9380,313,B
2016-03-25 9:29:26,9380,2,178586,-2,9375,569,9380,307,B
2016-03-25 9:29:27,9380,56,178642,-10,9375,572,9380,279,B
2016-03-25 9:29:28,9380,10,178652,-10,9375,573,9380,274,B
2016-03-25 9:29:28.5,9380,4,178656,-4,9375,575,9380,272,B
2016-03-25 9:29:29,9380,44,178700,-8,9375,558,9380,271,B
2016-03-25 9:29:29.5,9380,4,178704,-4,9375,572,9380,269,B
2016-03-25 9:29:30,9380,10,178714,-10,9375,572,9380,259,B
2016-03-25 9:29:30.5,9380,8,178722,-4,9375,572,9380,256,B
2016-03-25 9:29:31,9380,6,178728,0,9375,584,9380,253,B
2016-03-25 9:29:32,9380,6,178734,4,9375,583,9380,253,B
2016-03-25 9:29:33,9380,2,178736,-2,9375,583,9380,255,B
2016-03-25 9:29:33.5,9380,4,178740,0,9375,524,9380,258,B
2016-03-25 9:29:34,9380,8,178748,0,9375,522,9380,254,B
2016-03-25 9:29:35,9380,4,178752,-4,9375,522,9380,262,B
2016-03-25 9:29:37,9380,2,178754,-2,9375,522,9380,261,B
2016-03-25 9:29:37.5,9380,18,178772,-10,9375,554,9380,250,B
2016-03-25 9:29:38,9380,40,178812,0,9375,559,9380,232,B
2016-03-25 9:29:38.5,9380,466,179278,-8,9380,40,9385,415,B
2016-03-25 9:29:40,9380,12,179290,-2,9380,59,9385,413,B
2016-03-25 9:29:40.5,9380,2,179292,0,9380,75,9385,413,B
2016-03-25 9:29:41,9380,2,179294,0,9380,203,9385,413,B
2016-03-25 9:29:42,9385,182,179476,26,9380,261,9385,274,B
2016-03-25 9:29:43,9385,36,179512,12,9380,260,9385,258,B
2016-03-25 9:29:43.5,9385,300,179812,124,9380,293,9385,58,B
2016-03-25 9:29:44,9385,116,179928,42,9385,159,9390,1393,B
2016-03-25 9:29:44.5,9390,250,180178,238,9385,185,9390,1241,B
2016-03-25 9:29:45,9390,210,180388,-20,9385,239,9390,1118,B
2016-03-25 9:29:45.5,9390,630,181018,-426,9385,281,9390,582,B
2016-03-25 9:29:46,9390,1120,182138,-18,9390,329,9395,456,B
2016-03-25 9:29:46.5,9395,428,182566,-144,9390,450,9395,171,B
2016-03-25 9:29:47,9400,328,182894,-62,9395,25,9400,1050,B
2016-03-25 9:29:47.5,9400,646,183540,-104,9395,91,9400,793,B
2016-03-25 9:29:48,9400,296,183836,-94,9395,185,9400,570,B
2016-03-25 9:29:48.5,9400,76,183912,2,9395,191,9400,542,B
2016-03-25 9:29:49,9400,1086,184998,-460,9400,409,9405,640,B
2016-03-25 9:29:49.5,9400,14,185012,-8,9400,429,9405,641,B
2016-03-25 9:29:50,9400,10,185022,0,9400,444,9405,620,B
2016-03-25 9:29:50.5,9400,28,185050,-16,9400,498,9405,615,B
2016-03-25 9:29:51,9405,288,185338,-82,9400,430,9405,585,B
2016-03-25 9:29:51.5,9405,284,185622,2,9400,425,9405,346,B
2016-03-25 9:29:52,9405,166,185788,42,9400,496,9405,264,B
2016-03-25 9:29:52.5,9400,50,185838,-14,9400,501,9405,240,S
2016-03-25 9:29:53,9405,96,185934,18,9400,484,9405,337,B
2016-03-25 9:29:53.5,9405,58,185992,8,9400,418,9405,316,B
2016-03-25 9:29:54,9405,90,186082,34,9400,398,9405,305,B
2016-03-25 9:29:54.5,9405,292,186374,158,9400,445,9405,187,B
2016-03-25 9:29:55,9400,30,186404,-4,9400,587,9405,181,S
2016-03-25 9:29:55.5,9400,72,186476,24,9400,562,9405,142,S
2016-03-25 9:29:56,9405,104,186580,-70,9400,560,9405,94,B
2016-03-25 9:29:56.5,9400,10,186590,4,9400,561,9405,340,S
2016-03-25 9:29:57,9400,72,186662,24,9400,504,9405,340,S
2016-03-25 9:29:57.5,9400,86,186748,18,9400,482,9405,303,S
2016-03-25 9:29:58,9405,390,187138,340,9400,498,9405,107,B
2016-03-25 9:29:58.5,9405,120,187258,-24,9400,484,9405,102,B
2016-03-25 9:29:59,9405,64,187322,40,9400,482,9405,106,B
2016-03-25 9:29:59.5,9400,38,187360,12,9400,476,9405,95,S
2016-03-25 9:30:00,9405,76,187436,16,9400,474,9405,71,B
2016-03-25 9:30:00.5,9410,226,187662,50,9405,101,9410,566,B
2016-03-25 9:30:01,9410,242,187904,-2,9405,206,9410,390,B
2016-03-25 9:30:01.5,9405,250,188154,86,9405,403,9410,241,S
2016-03-25 9:30:02,9410,388,188542,116,9405,413,9415,342,B
2016-03-25 9:30:02.5,9410,92,188634,0,9405,533,9415,698,B
2016-03-25 9:30:03,9410,18,188652,10,9410,8,9415,715,B
2016-03-25 9:30:03.5,9410,12,188664,4,9410,8,9415,745,B
2016-03-25 9:30:04,9415,296,188960,-40,9410,21,9415,733,B
2016-03-25 9:30:04.5,9415,224,189184,-120,9410,4,9415,1145,B
2016-03-25 9:30:05,9415,164,189348,-8,9410,26,9415,709,B
2016-03-25 9:30:06,9410,206,189554,46,9405,587,9410,418,S
2016-03-25 9:30:06.3333,9410,52,189606,0,9410,20,9415,706,S
2016-03-25 9:30:06.6667,9415,174,189780,-58,9405,569,9410,3,B
2016-03-25 9:30:07,9410,36,189816,-2,9405,589,9410,6,S
2016-03-25 9:30:08,9405,10,189826,-2,9405,492,9410,443,S
2016-03-25 9:30:08.3333,9410,58,189884,0,9405,483,9410,451,B
2016-03-25 9:30:08.6667,9410,664,190548,46,9405,479,9410,160,B
2016-03-25 9:30:09,9410,52,190600,-14,9405,466,9410,278,B
2016-03-25 9:30:09.5,9410,24,190624,12,9405,466,9410,268,B
2016-03-25 9:30:10,9405,28,190652,0,9405,455,9410,411,S
2016-03-25 9:30:10.5,9410,94,190746,-30,9405,418,9410,424,B
2016-03-25 9:30:11,9410,112,190858,-8,9405,395,9410,437,B
2016-03-25 9:30:12,9405,598,191456,394,9405,148,9410,388,S
2016-03-25 9:30:12.3333,9400,662,192118,132,9400,141,9405,270,S
2016-03-25 9:30:12.6667,9400,84,192202,-44,9400,110,9405,408,S
2016-03-25 9:30:13,9400,124,192326,46,9400,58,9405,400,S
2016-03-25 9:30:14,9405,12,192338,-10,9400,58,9405,396,B
2016-03-25 9:30:14.3333,9405,18,192356,-4,9400,276,9405,379,B
2016-03-25 9:30:14.6667,9400,24,192380,8,9400,318,9405,227,S
2016-03-25 9:30:15,9400,20,192400,8,9400,310,9405,226,S
2016-03-25 9:30:16,9400,112,192512,-62,9400,137,9405,230,S
2016-03-25 9:30:16.3333,9405,172,192684,-64,9400,25,9405,378,B
2016-03-25 9:30:16.6667,9405,8,192692,-6,9400,24,9405,376,B
2016-03-25 9:30:17,9405,14,192706,-4,9400,156,9405,372,B
2016-03-25 9:30:18,9400,2,192708,0,9400,171,9405,287,S
2016-03-25 9:30:18.3333,9400,206,192914,66,9400,91,9405,345,S
2016-03-25 9:30:18.6667,9400,124,193038,112,9400,103,9405,287,S
2016-03-25 9:30:19,9400,14,193052,-2,9400,149,9405,174,S
2016-03-25 9:30:20,9405,30,193082,0,9400,142,9405,186,B
2016-03-25 9:30:20.5,9400,22,193104,-20,9400,168,9405,191,S
2016-03-25 9:30:21,9400,258,193362,-126,9400,24,9405,242,S
2016-03-25 9:30:21.5,9405,26,193388,0,9400,27,9405,288,B
2016-03-25 9:30:22,9400,202,193590,-64,9400,77,9405,327,S
2016-03-25 9:30:22.5,9400,34,193624,16,9400,73,9405,209,S
2016-03-25 9:30:23,9400,104,193728,48,9400,116,9405,146,S
2016-03-25 9:30:23.5,9405,124,193852,-12,9400,201,9405,30,B
2016-03-25 9:30:24,9405,192,194044,54,9405,181,9410,457,B
2016-03-25 9:30:25,9405,12,194056,-4,9405,186,9410,457,B
2016-03-25 9:30:25.5,9405,104,194160,0,9405,134,9410,457,B
2016-03-25 9:30:26,9405,22,194182,-8,9405,125,9410,453,B
2016-03-25 9:30:26.5,9410,46,194228,-36,9405,32,9410,432,B
2016-03-25 9:30:27,9405,20,194248,-12,9405,23,9410,432,S
2016-03-25 9:30:27.5,9405,8,194256,-4,9405,19,9410,431,S
2016-03-25 9:30:28,9405,4,194260,0,9405,17,9410,430,S
2016-03-25 9:30:28.5,9405,6,194266,4,9405,14,9410,428,S
2016-03-25 9:30:29,9405,84,194350,4,9405,74,9410,436,S
2016-03-25 9:30:29.5,9405,120,194470,16,9405,35,9410,355,S
2016-03-25 9:30:30,9405,44,194514,16,9405,14,9410,342,S
2016-03-25 9:30:30.5,9405,30,194544,0,9400,232,9405,87,S
2016-03-25 9:30:31,9400,10,194554,-10,9400,154,9405,95,S
2016-03-25 9:30:31.5,9405,60,194614,-50,9400,134,9405,97,B
2016-03-25 9:30:32,9405,32,194646,0,9400,134,9405,138,B
2016-03-25 9:30:32.5,9400,2,194648,0,9400,131,9405,154,S
2016-03-25 9:30:34,9405,2,194650,0,9400,189,9405,180,B
2016-03-25 9:30:34.5,9405,2,194652,0,9400,193,9405,203,B
2016-03-25 9:30:35,9400,4,194656,-4,9400,223,9405,205,S
2016-03-25 9:30:35.5,9405,4,194660,-2,9400,223,9405,203,B
2016-03-25 9:30:36,9405,58,194718,-48,9400,197,9405,322,B
2016-03-25 9:30:36.5,9400,102,194820,0,9400,148,9405,324,S
2016-03-25 9:30:37,9400,2,194822,-2,9400,145,9405,324,S
2016-03-25 9:30:37.5,9405,82,194904,24,9400,123,9405,334,B
2016-03-25 9:30:38,9400,4,194908,0,9400,121,9405,323,S
2016-03-25 9:30:38.5,9400,54,194962,-18,9400,101,9405,323,S
2016-03-25 9:30:39,9400,4,194966,4,9400,101,9405,324,S
2016-03-25 9:30:40,9400,6,194972,4,9400,102,9405,331,S
2016-03-25 9:30:40.5,9400,24,194996,8,9400,91,9405,332,S
2016-03-25 9:30:41,9400,4,195000,4,9400,89,9405,338,S
2016-03-25 9:30:41.5,9400,60,195060,-18,9400,71,9405,336,S
2016-03-25 9:30:42,9400,146,195206,-10,9400,1,9405,335,S
2016-03-25 9:30:42.5,9400,44,195250,32,9395,335,9400,11,S
2016-03-25 9:30:43,9400,32,195282,-16,9400,12,9405,380,S
2016-03-25 9:30:44,9400,2,195284,2,9400,29,9405,365,S
2016-03-25 9:30:44.5,9400,6,195290,6,9400,28,9405,365,S
2016-03-25 9:30:45,9400,66,195356,-28,9395,337,9400,183,S
2016-03-25 9:30:46,9400,6,195362,-4,9395,337,9400,288,S
2016-03-25 9:30:47,9395,24,195386,-2,9395,336,9400,288,S
2016-03-25 9:30:48,9395,2,195388,0,9395,335,9400,288,S
2016-03-25 9:30:49,9400,10,195398,-10,9395,331,9400,233,B
2016-03-25 9:30:49.5,9400,50,195448,0,9395,321,9400,219,B
2016-03-25 9:30:50,9400,400,195848,18,9395,371,9400,40,B
2016-03-25 9:30:51,9400,96,195944,44,9400,54,9405,408,B
2016-03-25 9:30:52,9400,52,195996,50,9400,28,9405,374,B
2016-03-25 9:30:52.5,9400,2,195998,2,9400,39,9405,317,B
2016-03-25 9:30:53,9400,4,196002,4,9400,43,9405,286,B
2016-03-25 9:30:53.5,9400,4,196006,2,9400,39,9405,287,B
2016-03-25 9:30:54,9400,2,196008,0,9400,37,9405,312,B
2016-03-25 9:30:55,9400,82,196090,-10,9395,369,9400,11,B
2016-03-25 9:30:55.5,9400,18,196108,0,9395,371,9400,15,B
2016-03-25 9:30:56,9400,52,196160,-12,9400,152,9405,326,B
2016-03-25 9:30:56.5,9400,12,196172,-10,9400,246,9405,326,B
2016-03-25 9:30:57,9405,2,196174,0,9400,308,9405,299,B
2016-03-25 9:30:58,9400,2,196176,0,9400,308,9405,299,S
2016-03-25 9:30:58.5,9400,82,196258,-82,9400,277,9405,303,S
2016-03-25 9:30:59,9400,2,196260,0,9400,276,9405,309,S
2016-03-25 9:30:59.5,9405,4,196264,-4,9400,276,9405,305,B
2016-03-25 9:31:00,9405,14,196278,-2,9400,318,9405,277,B
2016-03-25 9:31:01,9405,4,196282,0,9400,339,9405,275,B
2016-03-25 9:31:01.5,9405,200,196482,124,9400,293,9405,184,B
2016-03-25 9:31:02,9400,248,196730,52,9400,292,9405,68,S
2016-03-25 9:31:03,9400,12,196742,12,9400,225,9405,61,S
2016-03-25 9:31:03.5,9405,18,196760,16,9400,225,9405,62,B
2016-03-25 9:31:04,9400,8,196768,6,9400,229,9405,60,S
2016-03-25 9:31:04.5,9405,188,196956,114,9405,8,9410,548,B
2016-03-25 9:31:05,9405,48,197004,14,9400,195,9405,101,B
2016-03-25 9:31:06,9400,6,197010,2,9400,115,9405,197,S
2016-03-25 9:31:06.5,9405,6,197016,4,9400,126,9405,317,B
2016-03-25 9:31:07,9405,32,197048,12,9400,64,9405,312,B
2016-03-25 9:31:07.3333,9405,200,197248,126,9400,114,9405,167,B
2016-03-25 9:31:07.6667,9400,238,197486,100,9395,337,9400,434,S
2016-03-25 9:31:08,9400,352,197838,162,9395,167,9400,313,S
2016-03-25 9:31:09,9400,22,197860,12,9395,126,9400,305,S
2016-03-25 9:31:09.5,9400,12,197872,12,9395,126,9400,318,S
2016-03-25 9:31:10,9400,200,198072,200,9395,177,9400,191,S
2016-03-25 9:31:11,9395,26,198098,-20,9395,164,9400,196,S
2016-03-25 9:31:11.5,9400,2,198100,2,9395,215,9400,196,B
2016-03-25 9:31:12,9400,6,198106,2,9395,215,9400,184,B
2016-03-25 9:31:12.5,9395,4,198110,0,9395,213,9400,173,S
2016-03-25 9:31:13,9400,4,198114,0,9395,214,9400,186,B
2016-03-25 9:31:13.5,9395,4,198118,4,9395,215,9400,209,S
2016-03-25 9:31:14,9400,10,198128,10,9395,166,9400,204,B
2016-03-25 9:31:14.5,9395,16,198144,-2,9395,157,9400,205,S
2016-03-25 9:31:15,9395,4,198148,0,9395,155,9400,197,S
2016-03-25 9:31:15.5,9395,202,198350,14,9390,654,9395,2,S
2016-03-25 9:31:16,9395,10,198360,2,9390,701,9395,10,S
2016-03-25 9:31:16.5,9395,26,198386,-20,9395,151,9400,346,S
2016-03-25 9:31:17,9395,10,198396,-2,9395,198,9400,612,S
2016-03-25 9:31:17.5,9395,20,198416,4,9395,299,9400,592,S
2016-03-25 9:31:18,9395,2,198418,0,9395,249,9400,591,S
2016-03-25 9:31:19,9395,20,198438,0,9395,239,9400,693,S
2016-03-25 9:31:20,9395,270,198708,106,9395,59,9400,763,S
2016-03-25 9:31:20.5,9395,140,198848,62,9390,573,9395,54,S
2016-03-25 9:31:21,9390,2,198850,-2,9390,573,9395,106,S
2016-03-25 9:31:22,9395,60,198910,60,9390,619,9395,52,B
2016-03-25 9:31:22.5,9390,8,198918,-8,9390,617,9395,56,S
2016-03-25 9:31:23,9390,14,198932,-4,9390,660,9395,61,S
2016-03-25 9:31:23.5,9390,24,198956,-18,9390,650,9395,63,S
2016-03-25 9:31:24,9390,24,198980,0,9390,628,9395,67,S
2016-03-25 9:31:24.5,9395,20,199000,20,9390,628,9395,66,B
2016-03-25 9:31:25,9390,4,199004,0,9390,632,9395,76,S
2016-03-25 9:31:26,9390,10,199014,0,9390,630,9395,76,S
2016-03-25 9:31:26.5,9390,4,199018,0,9390,628,9395,88,S
2016-03-25 9:31:27,9390,2,199020,0,9390,629,9395,89,S
2016-03-25 9:31:27.5,9390,2,199022,-2,9390,629,9395,92,S
2016-03-25 9:31:28,9395,2,199024,-2,9390,638,9395,91,B
2016-03-25 9:31:28.5,9395,22,199046,-20,9390,627,9395,92,B
2016-03-25 9:31:29,9390,2,199048,0,9390,627,9395,119,S
2016-03-25 9:31:31,9395,2,199050,2,9390,642,9395,704,B
2016-03-25 9:31:31.5,9390,90,199140,-50,9390,530,9395,720,S
2016-03-25 9:31:32,9390,4,199144,2,9390,527,9395,720,S
2016-03-25 9:31:34,9390,102,199246,54,9390,444,9395,898,S
2016-03-25 9:31:34.5,9390,352,199598,-176,9390,268,9395,961,S
2016-03-25 9:31:35,9390,536,200134,-38,9385,452,9390,117,S
2016-03-25 9:31:35.5,9390,12,200146,0,9385,451,9390,124,S
2016-03-25 9:31:36,9390,68,200214,0,9385,559,9390,205,S
2016-03-25 9:31:36.5,9385,6,200220,-4,9385,523,9390,211,S
2016-03-25 9:31:37,9385,30,200250,-12,9385,667,9390,211,S
2016-03-25 9:31:37.5,9390,14,200264,-2,9385,665,9390,209,B
2016-03-25 9:31:38,9390,38,200302,8,9385,665,9390,207,B
2016-03-25 9:31:38.5,9385,20,200322,-20,9385,656,9390,207,S
2016-03-25 9:31:40,9390,52,200374,-24,9385,658,9390,182,B
2016-03-25 9:31:41,9385,6,200380,0,9385,655,9390,172,S
2016-03-25 9:31:41.5,9390,340,200720,-52,9390,252,9395,923,B
2016-03-25 9:31:42,9390,22,200742,0,9390,296,9395,809,B
2016-03-25 9:31:42.5,9390,4,200746,-2,9390,321,9395,790,B
2016-03-25 9:31:43,9390,8,200754,0,9390,293,9395,792,B
2016-03-25 9:31:43.5,9390,106,200860,18,9390,294,9395,742,B
2016-03-25 9:31:44,9395,12,200872,-12,9390,304,9395,728,B
2016-03-25 9:31:44.5,9395,12,200884,2,9390,300,9395,776,B
2016-03-25 9:31:47,9390,2,200886,-2,9390,313,9395,776,S
2016-03-25 9:31:48,9390,10,200896,0,9390,321,9395,771,S
2016-03-25 9:31:49,9390,258,201154,0,9390,152,9395,799,S
2016-03-25 9:31:50,9390,2,201156,0,9390,161,9395,799,S
2016-03-25 9:31:50.5,9390,6,201162,0,9390,160,9395,796,S
2016-03-25 9:31:51,9390,6,201168,-2,9390,156,9395,793,S
2016-03-25 9:31:52,9390,2,201170,0,9390,155,9395,728,S
2016-03-25 9:31:52.5,9390,2,201172,-2,9390,154,9395,729,S
2016-03-25 9:31:53,9390,2,201174,0,9390,153,9395,735,S
2016-03-25 9:31:54,9390,28,201202,0,9390,141,9395,867,S
2016-03-25 9:31:54.5,9390,264,201466,-48,9390,10,9395,868,S
2016-03-25 9:31:55,9390,6,201472,0,9390,14,9395,868,S
2016-03-25 9:31:56,9390,12,201484,8,9390,18,9395,864,S
2016-03-25 9:31:56.5,9390,4,201488,0,9390,154,9395,868,S
2016-03-25 9:31:57,9390,2,201490,-2,9390,154,9395,868,S
2016-03-25 9:31:58,9390,6,201496,0,9390,204,9395,869,S
2016-03-25 9:31:58.5,9390,14,201510,-2,9390,218,9395,868,S
2016-03-25 9:31:59,9390,2,201512,2,9390,229,9395,821,S
2016-03-25 9:31:59.5,9390,12,201524,8,9390,224,9395,750,S
2016-03-25 9:32:00,9390,2,201526,0,9390,223,9395,738,S
2016-03-25 9:32:00.5,9390,52,201578,-22,9390,138,9395,737,S
2016-03-25 9:32:01,9390,84,201662,80,9390,100,9395,737,S
2016-03-25 9:32:02,9390,4,201666,-2,9390,99,9395,746,S
2016-03-25 9:32:02.5,9390,2,201668,0,9390,106,9395,614,S
2016-03-25 9:32:03,9390,32,201700,-18,9390,134,9395,106,S
2016-03-25 9:32:03.5,9395,256,201956,28,9395,48,9400,569,B
2016-03-25 9:32:04,9395,4,201960,4,9395,66,9400,567,B
2016-03-25 9:32:04.5,9395,20,201980,20,9395,57,9400,578,B
2016-03-25 9:32:05,9395,18,201998,0,9395,50,9400,579,B
2016-03-25 9:32:05.5,9395,20,202018,0,9395,40,9400,576,B
2016-03-25 9:32:06,9400,12,202030,2,9395,69,9400,571,B
2016-03-25 9:32:07,9400,24,202054,10,9395,69,9400,560,B
2016-03-25 9:32:08,9400,6,202060,0,9395,76,9400,557,B
2016-03-25 9:32:09,9400,22,202082,0,9395,67,9400,546,B
2016-03-25 9:32:09.5,9395,2,202084,2,9395,66,9400,547,S
2016-03-25 9:32:10,9395,88,202172,0,9395,51,9400,545,S
2016-03-25 9:32:11,9400,16,202188,12,9395,92,9400,539,B
2016-03-25 9:32:12,9395,52,202240,22,9395,71,9400,537,S
2016-03-25 9:32:13,9400,4,202244,4,9395,71,9400,535,B
2016-03-25 9:32:13.5,9395,2,202246,0,9395,71,9400,534,S
2016-03-25 9:32:14,9395,18,202264,-2,9395,63,9400,549,S
2016-03-25 9:32:14.5,9395,22,202286,0,9395,52,9400,549,S
2016-03-25 9:32:15,9395,4,202290,0,9395,50,9400,547,S
2016-03-25 9:32:15.5,9400,8,202298,8,9395,78,9400,524,B
2016-03-25 9:32:16,9400,6,202304,6,9395,78,9400,519,B
2016-03-25 9:32:17,9400,2,202306,2,9395,78,9400,520,B
2016-03-25 9:32:18,9395,12,202318,-6,9395,75,9400,520,S
2016-03-25 9:32:19,9400,2,202320,2,9395,80,9400,519,B
2016-03-25 9:32:19.5,9400,402,202722,-104,9395,92,9405,296,B
2016-03-25 9:32:20,9395,2,202724,0,9395,154,9405,250,S
2016-03-25 9:32:20.5,9400,2,202726,0,9395,157,9405,229,B
2016-03-25 9:32:21,9395,10,202736,4,9395,159,9405,230,S
2016-03-25 9:32:21.5,9400,16,202752,-4,9395,159,9400,161,B
2016-03-25 9:32:22,9395,2,202754,0,9395,139,9400,151,S
2016-03-25 9:32:22.5,9400,382,203136,122,9400,53,9405,384,B
2016-03-25 9:32:23,9400,26,203162,26,9400,58,9405,361,B
2016-03-25 9:32:24,9400,108,203270,-6,9400,4,9405,372,B
2016-03-25 9:32:24.5,9400,58,203328,20,9400,42,9405,365,B
2016-03-25 9:32:25,9405,10,203338,0,9400,38,9405,361,B
2016-03-25 9:32:25.5,9400,36,203374,36,9400,270,9405,368,S
2016-03-25 9:32:26,9405,6,203380,2,9400,300,9405,352,B
2016-03-25 9:32:26.5,9400,2,203382,2,9400,310,9405,353,S
2016-03-25 9:32:27,9400,8,203390,8,9400,307,9405,360,S
2016-03-25 9:32:27.5,9400,4,203394,0,9400,309,9405,360,S
2016-03-25 9:32:28,9405,12,203406,0,9400,319,9405,359,B
2016-03-25 9:32:28.5,9400,8,203414,8,9400,317,9405,359,S
2016-03-25 9:32:29,9405,2,203416,0,9400,319,9405,357,B
2016-03-25 9:32:30,9405,152,203568,-80,9400,334,9405,262,B
2016-03-25 9:32:31,9400,18,203586,-4,9400,327,9405,232,S
2016-03-25 9:32:31.5,9405,52,203638,32,9400,324,9405,201,B
2016-03-25 9:32:32,9405,420,204058,186,9405,28,9410,751,B
2016-03-25 9:32:32.5,9405,144,204202,-72,9405,113,9410,719,B
2016-03-25 9:32:33,9410,40,204242,26,9405,100,9410,701,B
2016-03-25 9:32:34,9405,2,204244,2,9405,100,9410,706,S
2016-03-25 9:32:35,9405,224,204468,24,9400,349,9405,2,S
2016-03-25 9:32:36,9405,4,204472,0,9405,90,9410,713,S
2016-03-25 9:32:37,9410,2,204474,-2,9405,90,9410,713,B
2016-03-25 9:32:37.3333,9405,16,204490,0,9405,88,9410,708,S
2016-03-25 9:32:37.6667,9410,24,204514,-12,9405,88,9410,700,B
2016-03-25 9:32:38,9405,2,204516,2,9405,90,9410,700,S
2016-03-25 9:32:39,9405,4,204520,0,9405,91,9410,700,S
2016-03-25 9:32:40,9405,32,204552,28,9405,81,9410,746,S
2016-03-25 9:32:41,9410,24,204576,0,9405,81,9410,734,B
2016-03-25 9:32:42,9410,12,204588,-8,9405,91,9410,721,B
2016-03-25 9:32:42.3333,9410,10,204598,-6,9405,103,9410,698,B
2016-03-25 9:32:42.6667,9410,50,204648,48,9405,79,9410,697,B
2016-03-25 9:32:44,9405,14,204662,4,9405,78,9410,693,S
2016-03-25 9:32:45,9405,4,204666,4,9405,68,9410,711,S
2016-03-25 9:32:45.5,9410,4,204670,0,9405,69,9410,721,B
2016-03-25 9:32:46,9405,2,204672,2,9405,73,9410,722,S
2016-03-25 9:32:46.5,9405,212,204884,-82,9400,364,9405,130,S
2016-03-25 9:32:47,9405,12,204896,-10,9400,331,9405,126,S
2016-03-25 9:32:47.5,9405,4,204900,0,9400,315,9405,128,S
2016-03-25 9:32:48,9405,46,204946,-4,9400,313,9405,134,S
2016-03-25 9:32:48.5,9400,82,205028,-82,9400,270,9405,137,S
2016-03-25 9:32:49,9405,2,205030,0,9400,270,9405,161,B
2016-03-25 9:32:49.5,9405,12,205042,-12,9400,270,9405,157,B
2016-03-25 9:32:50,9405,32,205074,0,9400,271,9405,142,B
2016-03-25 9:32:52,9405,12,205086,0,9400,273,9405,196,B
2016-03-25 9:32:53,9400,12,205098,-12,9400,272,9405,323,S
2016-03-25 9:32:53.5,9405,10,205108,-10,9400,273,9405,319,B
2016-03-25 9:32:54,9400,102,205210,-84,9400,272,9405,281,S
2016-03-25 9:32:56,9405,8,205218,0,9400,281,9405,355,B
2016-03-25 9:32:58,9400,12,205230,0,9400,274,9405,353,S
2016-03-25 9:32:58.5,9400,472,205702,-312,9400,275,9405,118,S
2016-03-25 9:32:59,9400,456,206158,4,9400,120,9405,110,S
2016-03-25 9:33:00,9400,2,206160,-2,9400,129,9405,96,S
2016-03-25 9:33:02,9400,20,206180,-18,9400,132,9405,100,S
2016-03-25 9:33:02.5,9400,10,206190,-10,9400,133,9405,162,S
2016-03-25 9:33:03,9405,2,206192,0,9400,125,9405,168,B
2016-03-25 9:33:03.5,9405,2,206194,0,9400,115,9405,180,B
2016-03-25 9:33:04,9405,44,206238,30,9400,113,9405,163,B
2016-03-25 9:33:04.5,9400,4,206242,4,9400,111,9405,158,S
2016-03-25 9:33:05,9400,12,206254,2,9400,287,9405,90,S
2016-03-25 9:33:07,9405,10,206264,-4,9400,165,9405,150,B
2016-03-25 9:33:08,9405,4,206268,0,9400,165,9405,197,B
2016-03-25 9:33:09,9400,2,206270,-2,9400,164,9405,216,S
2016-03-25 9:33:11,9400,8,206278,0,9400,116,9405,259,S
2016-03-25 9:33:12,9400,272,206550,60,9395,232,9400,92,S
2016-03-25 9:33:12.5,9400,10,206560,0,9395,213,9400,91,S
2016-03-25 9:33:13,9400,2,206562,0,9395,208,9400,92,S
2016-03-25 9:33:14,9400,202,206764,-10,9395,213,9400,3,S
2016-03-25 9:33:15,9400,72,206836,52,9395,267,9400,78,S
2016-03-25 9:33:16,9400,4,206840,-4,9395,182,9400,85,S
2016-03-25 9:33:16.5,9400,20,206860,0,9395,182,9400,77,S
2016-03-25 9:33:17,9400,20,206880,0,9395,172,9400,77,S
2016-03-25 9:33:17.5,9395,2,206882,0,9395,166,9400,77,S
2016-03-25 9:33:18,9395,2,206884,0,9395,165,9400,77,S
2016-03-25 9:33:20,9395,2,206886,0,9395,168,9400,93,S
2016-03-25 9:33:21,9395,10,206896,-10,9395,162,9400,140,S
2016-03-25 9:33:21.5,9395,422,207318,-248,9395,149,9400,8,S
2016-03-25 9:33:22,9395,44,207362,-36,9395,137,9400,20,S
2016-03-25 9:33:23,9395,4,207366,0,9395,138,9400,177,S
2016-03-25 9:33:27,9395,6,207372,-6,9395,149,9400,202,S
2016-03-25 9:33:27.5,9395,2,207374,-2,9395,141,9400,206,S
2016-03-25 9:33:28,9400,78,207452,8,9395,148,9400,170,B
2016-03-25 9:33:29,9395,100,207552,-90,9395,96,9400,175,S
2016-03-25 9:33:30,9395,16,207568,-14,9395,141,9400,185,S
2016-03-25 9:33:31,9395,6,207574,0,9395,138,9400,186,S
2016-03-25 9:33:31.3333,9395,2,207576,-2,9395,164,9400,186,S
2016-03-25 9:33:31.6667,9400,20,207596,20,9395,167,9400,166,B
2016-03-25 9:33:33,9395,2,207598,0,9395,166,9400,168,S
2016-03-25 9:33:34,9400,336,207934,-90,9400,34,9405,379,B
2016-03-25 9:33:34.5,9395,84,208018,-68,9395,168,9400,164,S
2016-03-25 9:33:35,9400,6,208024,0,9395,157,9400,168,B
2016-03-25 9:33:37,9395,2,208026,-2,9395,151,9400,225,S
2016-03-25 9:33:37.5,9400,44,208070,0,9395,153,9400,204,B
2016-03-25 9:33:38,9395,2,208072,0,9395,145,9400,207,S
2016-03-25 9:33:39,9395,2,208074,0,9395,145,9400,209,S
2016-03-25 9:33:40,9395,4,208078,-2,9395,143,9400,215,S
2016-03-25 9:33:41,9395,100,208178,16,9395,119,9400,187,S
2016-03-25 9:33:41.5,9395,4,208182,0,9395,127,9400,188,S
2016-03-25 9:33:42,9395,50,208232,22,9395,107,9400,168,S
2016-03-25 9:33:42.5,9400,12,208244,0,9395,108,9400,162,B
2016-03-25 9:33:44,9395,4,208248,0,9395,118,9400,162,S
2016-03-25 9:33:45,9400,8,208256,0,9395,124,9400,158,B
2016-03-25 9:33:47,9395,2,208258,0,9395,143,9400,162,S
2016-03-25 9:33:48,9395,2,208260,0,9395,142,9400,163,S
2016-03-25 9:33:48.5,9400,368,208628,-90,9400,88,9405,361,B
2016-03-25 9:33:49,9400,2,208630,0,9400,87,9405,362,B
2016-03-25 9:33:50,9400,2,208632,0,9400,86,9405,361,B
2016-03-25 9:33:50.5,9400,8,208640,-6,9400,82,9405,366,B
2016-03-25 9:33:51,9400,6,208646,0,9400,79,9405,367,B
2016-03-25 9:33:51.5,9405,100,208746,42,9400,79,9405,317,B
2016-03-25 9:33:52,9400,4,208750,-2,9400,89,9405,314,S
2016-03-25 9:33:52.5,9400,2,208752,-2,9400,88,9405,315,S
2016-03-25 9:33:53,9400,100,208852,0,9400,38,9405,315,S
2016-03-25 9:33:54,9400,44,208896,0,9400,34,9405,294,S
2016-03-25 9:33:55,9400,2,208898,-2,9400,43,9405,191,S
2016-03-25 9:33:55.5,9400,6,208904,-2,9400,53,9405,176,S
2016-03-25 9:33:56,9400,114,209018,42,9400,48,9405,108,S
2016-03-25 9:33:56.5,9400,84,209102,-34,9400,110,9405,87,S
2016-03-25 9:33:57,9400,24,209126,-4,9400,118,9405,61,S
2016-03-25 9:33:57.5,9405,100,209226,-22,9405,205,9410,630,B
2016-03-25 9:33:58,9405,16,209242,4,9405,196,9410,587,B
2016-03-25 9:33:58.5,9405,4,209246,0,9405,195,9410,587,B
2016-03-25 9:33:59,9410,30,209276,-30,9405,78,9410,571,B
2016-03-25 9:33:59.5,9405,562,209838,-86,9405,114,9410,290,S
2016-03-25 9:34:00,9410,250,210088,102,9405,131,9415,438,B
2016-03-25 9:34:01,9410,4,210092,4,9405,131,9410,179,B
2016-03-25 9:34:01.5,9405,44,210136,-30,9405,128,9410,162,S
2016-03-25 9:34:02,9405,2,210138,2,9405,127,9410,163,S
2016-03-25 9:34:02.5,9410,32,210170,-4,9405,127,9410,153,B
2016-03-25 9:34:03,9405,4,210174,4,9405,125,9410,153,S
2016-03-25 9:34:03.5,9405,10,210184,10,9405,120,9410,173,S
2016-03-25 9:34:04,9405,4,210188,0,9405,118,9410,175,S
2016-03-25 9:34:04.5,9410,4,210192,2,9405,118,9410,174,B
2016-03-25 9:34:05,9410,6,210198,2,9405,118,9410,173,B
2016-03-25 9:34:06,9410,10,210208,10,9405,118,9410,168,B
2016-03-25 9:34:08,9405,2,210210,0,9405,107,9410,171,S
2016-03-25 9:34:09,9410,2,210212,0,9405,107,9410,173,B
2016-03-25 9:34:09.5,9405,2,210214,2,9405,107,9410,175,S
2016-03-25 9:34:11,9410,2,210216,2,9405,118,9410,176,B
2016-03-25 9:34:11.5,9405,278,210494,50,9405,15,9410,137,S
2016-03-25 9:34:12,9400,34,210528,-2,9400,248,9405,80,S
2016-03-25 9:34:14,9405,62,210590,16,9400,212,9405,101,B
2016-03-25 9:34:16,9400,202,210792,-178,9400,146,9405,129,S
2016-03-25 9:34:16.5,9405,2,210794,2,9400,146,9405,160,B
2016-03-25 9:34:17,9400,292,211086,110,9395,182,9400,63,S
2016-03-25 9:34:18,9400,12,211098,12,9395,141,9400,92,S
2016-03-25 9:34:19,9395,8,211106,0,9395,138,9400,93,S
2016-03-25 9:34:21,9395,40,211146,-40,9395,178,9400,73,S
2016-03-25 9:34:21.5,9395,352,211498,86,9390,423,9395,19,S
2016-03-25 9:34:22,9395,52,211550,46,9395,303,9400,147,S
2016-03-25 9:34:22.5,9395,4,211554,4,9395,301,9400,109,S
2016-03-25 9:34:23,9395,4,211558,0,9395,276,9400,117,S
2016-03-25 9:34:24,9395,6,211564,4,9395,273,9400,137,S
2016-03-25 9:34:27,9395,2,211566,0,9395,298,9400,139,S
2016-03-25 9:34:28,9395,2,211568,2,9395,312,9400,139,S
2016-03-25 9:34:29,9395,8,211576,0,9395,283,9400,141,S
2016-03-25 9:34:30,9395,6,211582,6,9395,289,9400,141,S
2016-03-25 9:34:31,9395,20,211602,8,9395,272,9400,221,S
2016-03-25 9:34:33,9400,2,211604,2,9395,274,9400,229,B
2016-03-25 9:34:33.5,9395,4,211608,-4,9395,272,9400,229,S
2016-03-25 9:34:34,9395,30,211638,14,9395,270,9400,217,S
2016-03-25 9:34:36,9400,276,211914,228,9395,323,9405,141,B
2016-03-25 9:34:36.5,9400,56,211970,-40,9395,325,9405,121,B
2016-03-25 9:34:37,9400,14,211984,-10,9400,105,9405,159,B
2016-03-25 9:34:37.3333,9400,42,212026,0,9400,173,9405,139,B
2016-03-25 9:34:37.6667,9400,16,212042,8,9400,165,9405,140,B
2016-03-25 9:34:38,9400,2,212044,0,9400,164,9405,141,B
2016-03-25 9:34:39,9400,34,212078,-30,9400,164,9405,124,B
2016-03-25 9:34:39.5,9400,4,212082,0,9400,162,9405,124,B
2016-03-25 9:34:40,9400,2,212084,0,9400,161,9405,134,B
2016-03-25 9:34:40.5,9400,4,212088,0,9400,159,9405,135,B
2016-03-25 9:34:41,9405,276,212364,-80,9405,392,9410,337,B
2016-03-25 9:34:42,9405,2,212366,-2,9405,445,9410,250,B
2016-03-25 9:34:43,9405,2,212368,0,9405,444,9410,244,B
2016-03-25 9:34:44,9405,44,212412,24,9405,422,9410,213,B
2016-03-25 9:34:45,9405,422,212834,0,9405,211,9410,204,B
2016-03-25 9:34:46,9405,4,212838,-2,9405,209,9410,269,B
2016-03-25 9:34:47,9410,4,212842,0,9405,211,9410,281,B
2016-03-25 9:34:48,9405,422,213264,-6,9400,182,9405,2,S
2016-03-25 9:34:50,9405,6,213270,0,9400,152,9405,82,S
2016-03-25 9:34:50.5,9405,56,213326,0,9400,128,9405,116,S
2016-03-25 9:34:52,9400,124,213450,-118,9395,381,9400,2,S
2016-03-25 9:34:53,9400,44,213494,-8,9400,46,9405,159,S
2016-03-25 9:34:53.5,9400,6,213500,-4,9400,224,9405,135,S
2016-03-25 9:34:54,9400,2,213502,0,9400,97,9405,132,S
2016-03-25 9:34:55,9405,2,213504,2,9400,101,9405,131,B
2016-03-25 9:34:56,9405,42,213546,14,9400,177,9405,115,B
2016-03-25 9:34:56.5,9400,2,213548,2,9400,186,9405,123,S
2016-03-25 9:34:57,9400,2,213550,2,9400,186,9405,124,S
2016-03-25 9:34:57.5,9405,250,213800,-76,9405,408,9410,394,B
2016-03-25 9:34:58,9405,6,213806,-2,9405,405,9410,380,B
2016-03-25 9:34:58.5,9405,4,213810,-2,9405,403,9410,381,B
2016-03-25 9:34:59,9405,2,213812,0,9405,402,9410,389,B
2016-03-25 9:34:59.5,9405,8,213820,-2,9405,398,9410,389,B
2016-03-25 9:35:02,9405,2,213822,0,9405,398,9410,390,B
2016-03-25 9:35:03,9405,6,213828,0,9405,395,9410,401,B
2016-03-25 9:35:04,9405,2,213830,0,9405,395,9410,402,B
2016-03-25 9:35:06,9405,10,213840,0,9405,401,9410,403,B
2016-03-25 9:35:06.5,9405,2,213842,0,9405,400,9410,404,B
2016-03-25 9:35:07,9405,2,213844,0,9405,398,9410,405,B
2016-03-25 9:35:07.5,9405,44,213888,0,9405,377,9410,406,B
2016-03-25 9:35:08,9405,750,214638,-88,9400,264,9405,11,B
2016-03-25 9:35:10,9400,4,214642,4,9400,249,9405,52,S
2016-03-25 9:35:10.5,9405,10,214652,8,9400,249,9405,47,B
2016-03-25 9:35:11,9400,12,214664,6,9400,247,9405,18,S
2016-03-25 9:35:11.5,9405,18,214682,2,9405,131,9410,436,B
2016-03-25 9:35:12,9405,58,214740,-12,9405,113,9410,398,B
2016-03-25 9:35:12.5,9405,202,214942,102,9405,64,9410,393,B
2016-03-25 9:35:13,9410,248,215190,-172,9405,61,9410,271,B
2016-03-25 9:35:13.5,9405,2,215192,0,9405,198,9410,270,S
2016-03-25 9:35:14,9405,452,215644,244,9405,4,9410,292,S
2016-03-25 9:35:14.5,9405,24,215668,2,9400,270,9405,25,S
2016-03-25 9:35:15,9405,52,215720,24,9405,65,9410,268,S
2016-03-25 9:35:15.5,9405,14,215734,0,9405,78,9410,261,S
2016-03-25 9:35:16,9405,6,215740,2,9405,268,9410,261,S
2016-03-25 9:35:17,9405,6,215746,-2,9405,297,9410,266,S
2016-03-25 9:35:18,9410,410,216156,202,9405,297,9415,398,B
2016-03-25 9:35:18.3333,9410,48,216204,-48,9405,297,9410,41,B
2016-03-25 9:35:18.6667,9410,84,216288,-70,9410,77,9415,415,B
2016-03-25 9:35:19,9410,22,216310,-18,9410,97,9415,411,B
2016-03-25 9:35:21,9410,20,216330,0,9410,96,9415,303,B
2016-03-25 9:35:22,9410,2,216332,0,9410,95,9415,261,B
2016-03-25 9:35:22.5,9410,4,216336,0,9410,93,9415,237,B
2016-03-25 9:35:23,9410,2,216338,0,9410,92,9415,234,B
2016-03-25 9:35:23.5,9410,2,216340,0,9410,91,9415,236,B
2016-03-25 9:35:24,9410,4,216344,0,9410,90,9415,245,B
2016-03-25 9:35:24.3333,9410,4,216348,0,9410,89,9415,238,B
2016-03-25 9:35:24.6667,9410,10,216358,0,9410,88,9415,239,B
2016-03-25 9:35:25,9410,2,216360,0,9410,87,9415,240,B
2016-03-25 9:35:26,9410,68,216428,-54,9410,59,9415,245,B
2016-03-25 9:35:28,9410,2,216430,2,9410,60,9415,354,B
2016-03-25 9:35:29,9410,62,216492,0,9410,51,9415,336,B
2016-03-25 9:35:29.5,9410,2,216494,0,9410,50,9415,341,B
2016-03-25 9:35:30,9410,64,216558,52,9410,22,9415,366,B
2016-03-25 9:35:30.5,9410,8,216566,0,9410,177,9415,365,B
2016-03-25 9:35:31,9410,2,216568,0,9410,169,9415,366,B
2016-03-25 9:35:32,9415,12,216580,2,9410,175,9415,365,B
2016-03-25 9:35:32.5,9410,12,216592,-4,9410,177,9415,360,S
2016-03-25 9:35:33,9410,72,216664,-30,9410,141,9415,362,S
2016-03-25 9:35:33.5,9410,2,216666,-2,9410,152,9415,262,S
2016-03-25 9:35:34,9410,2,216668,0,9410,161,9415,313,S
2016-03-25 9:35:35,9410,42,216710,-40,9410,169,9415,313,S
2016-03-25 9:35:36,9410,4,216714,0,9410,173,9415,313,S
2016-03-25 9:35:36.5,9415,104,216818,-72,9410,172,9415,266,B
2016-03-25 9:35:37,9415,60,216878,46,9410,152,9415,236,B
2016-03-25 9:35:37.5,9415,12,216890,-6,9410,152,9415,234,B
2016-03-25 9:35:38,9415,4,216894,0,9410,152,9415,232,B
2016-03-25 9:35:39,9415,8,216902,2,9410,139,9415,227,B
2016-03-25 9:35:39.5,9415,26,216928,-2,9410,139,9415,213,B
2016-03-25 9:35:40,9415,6,216934,0,9410,166,9415,211,B
2016-03-25 9:35:40.5,9415,12,216946,0,9410,166,9415,205,B
2016-03-25 9:35:41,9415,6,216952,0,9410,166,9415,202,B
2016-03-25 9:35:41.5,9415,354,217306,-14,9410,196,9415,24,B
2016-03-25 9:35:42,9415,50,217356,-22,9415,332,9420,668,B
2016-03-25 9:35:42.5,9420,8,217364,8,9415,337,9420,690,B
2016-03-25 9:35:43,9420,408,217772,-150,9415,500,9420,491,B
2016-03-25 9:35:43.5,9415,454,218226,-120,9415,475,9425,613,S
2016-03-25 9:35:44,9425,1570,219796,-486,9420,340,9425,124,B
2016-03-25 9:35:44.5,9425,232,220028,116,9425,190,9430,370,B
2016-03-25 9:35:45,9425,74,220102,50,9425,170,9430,337,B
2016-03-25 9:35:45.5,9425,216,220318,64,9425,250,9430,254,B
2016-03-25 9:35:46,9425,50,220368,6,9425,234,9430,251,B
2016-03-25 9:35:46.5,9430,440,220808,194,9425,247,9435,295,B
2016-03-25 9:35:47,9425,214,221022,4,9425,171,9430,27,S
2016-03-25 9:35:47.5,9425,36,221058,18,9425,193,9430,145,S
2016-03-25 9:35:48,9425,52,221110,0,9425,174,9430,403,S
2016-03-25 9:35:48.5,9425,88,221198,32,9425,147,9430,508,S
2016-03-25 9:35:49,9425,10,221208,4,9425,143,9430,547,S
2016-03-25 9:35:49.5,9425,296,221504,-136,9420,185,9425,55,S
2016-03-25 9:35:50,9420,500,222004,114,9420,84,9425,28,S
2016-03-25 9:35:51,9425,18,222022,-12,9420,118,9425,132,B
2016-03-25 9:35:52,9420,136,222158,-46,9420,20,9425,248,S
2016-03-25 9:35:52.5,9425,208,222366,26,9415,514,9425,154,B
2016-03-25 9:35:53,9420,2,222368,0,9420,191,9425,156,S
2016-03-25 9:35:53.3333,9425,18,222386,0,9420,186,9425,154,B
2016-03-25 9:35:53.6667,9420,2,222388,2,9420,199,9425,154,S
2016-03-25 9:35:54,9425,34,222422,-2,9420,186,9425,152,B
2016-03-25 9:35:55,9425,254,222676,108,9420,161,9425,81,B
2016-03-25 9:35:55.5,9425,14,222690,2,9420,174,9425,76,B
2016-03-25 9:35:56,9425,14,222704,2,9420,175,9425,95,B
2016-03-25 9:35:56.5,9425,28,222732,4,9420,180,9425,84,B
2016-03-25 9:35:57,9425,22,222754,6,9420,177,9425,128,B
2016-03-25 9:35:57.5,9425,174,222928,-44,9420,188,9425,79,B
2016-03-25 9:35:58,9425,22,222950,-2,9420,195,9425,82,B
2016-03-25 9:35:58.5,9425,4,222954,0,9420,195,9425,84,B
2016-03-25 9:35:59,9425,6,222960,-2,9420,195,9425,81,B
2016-03-25 9:35:59.5,9425,40,223000,0,9420,198,9425,118,B
2016-03-25 9:36:00,9425,16,223016,-10,9420,195,9425,112,B
2016-03-25 9:36:00.5,9420,4,223020,0,9420,194,9425,115,S
2016-03-25 9:36:01,9420,4,223024,-2,9420,198,9425,181,S
2016-03-25 9:36:02,9420,54,223078,-12,9420,171,9425,234,S
2016-03-25 9:36:03,9420,4,223082,0,9420,171,9425,247,S
2016-03-25 9:36:04,9420,26,223108,22,9420,382,9425,240,S
2016-03-25 9:36:04.5,9425,2,223110,0,9420,403,9425,246,B
2016-03-25 9:36:05,9425,6,223116,0,9420,623,9425,245,B
2016-03-25 9:36:05.5,9420,2,223118,-2,9420,622,9425,247,S
2016-03-25 9:36:06,9420,88,223206,-84,9420,877,9425,250,S
2016-03-25 9:36:06.5,9425,6,223212,4,9420,882,9425,232,B
2016-03-25 9:36:07,9420,340,223552,-16,9420,59,9425,234,S
2016-03-25 9:36:07.5,9420,140,223692,-12,9415,520,9420,43,S
2016-03-25 9:36:08,9420,2,223694,2,9415,488,9420,54,S
2016-03-25 9:36:08.5,9425,112,223806,-64,9420,135,9425,348,B
2016-03-25 9:36:09,9420,4,223810,0,9420,164,9425,312,S
2016-03-25 9:36:10,9420,342,224152,178,9415,330,9420,89,S
2016-03-25 9:36:11,9420,2,224154,0,9415,332,9420,129,S
2016-03-25 9:36:11.5,9420,260,224414,234,9420,2,9425,352,S
2016-03-25 9:36:12,9420,44,224458,-14,9415,333,9420,63,S
2016-03-25 9:36:12.5,9420,12,224470,-10,9415,331,9420,61,S
2016-03-25 9:36:13,9420,54,224524,8,9415,332,9420,35,S
2016-03-25 9:36:14,9420,104,224628,66,9415,333,9420,24,S
2016-03-25 9:36:14.5,9420,60,224688,-36,9415,538,9420,63,S
2016-03-25 9:36:15,9415,24,224712,4,9415,536,9420,103,S
2016-03-25 9:36:16,9420,22,224734,-4,9415,317,9420,65,B
2016-03-25 9:36:16.5,9415,6,224740,2,9415,316,9420,76,S
2016-03-25 9:36:17,9415,14,224754,10,9415,311,9420,89,S
2016-03-25 9:36:17.5,9415,26,224780,20,9415,308,9420,91,S
2016-03-25 9:36:18,9420,2,224782,2,9415,310,9420,112,B
2016-03-25 9:36:19,9415,54,224836,40,9415,295,9420,109,S
2016-03-25 9:36:20,9415,6,224842,4,9415,198,9420,121,S
2016-03-25 9:36:20.5,9420,20,224862,16,9415,198,9420,142,B
2016-03-25 9:36:21,9420,4,224866,2,9415,197,9420,141,B
2016-03-25 9:36:22,9420,50,224916,26,9415,173,9420,173,B
2016-03-25 9:36:22.5,9415,56,224972,52,9415,128,9420,182,S
2016-03-25 9:36:23,9420,2,224974,-2,9415,128,9420,177,B
2016-03-25 9:36:23.5,9415,4,224978,-4,9415,136,9420,177,S
2016-03-25 9:36:24,9415,2,224980,0,9415,135,9420,178,S
2016-03-25 9:36:24.5,9415,4,224984,0,9415,134,9420,298,S
2016-03-25 9:36:25,9415,266,225250,-44,9410,179,9415,91,S
2016-03-25 9:36:26,9410,8,225258,0,9410,131,9415,140,S
2016-03-25 9:36:27,9410,10,225268,10,9410,101,9415,156,S
2016-03-25 9:36:27.5,9410,198,225466,-46,9405,274,9410,43,S
2016-03-25 9:36:28,9405,40,225506,-40,9405,213,9410,111,S
2016-03-25 9:36:28.5,9405,8,225514,-8,9405,213,9410,120,S
2016-03-25 9:36:29,9405,4,225518,-2,9405,199,9410,120,S
2016-03-25 9:36:30,9405,12,225530,0,9405,153,9410,165,S
2016-03-25 9:36:31,9405,12,225542,-8,9405,147,9410,167,S
2016-03-25 9:36:32,9405,4,225546,0,9405,142,9410,167,S
2016-03-25 9:36:33,9410,100,225646,82,9405,171,9410,119,B
2016-03-25 9:36:35,9410,4,225650,0,9405,171,9410,125,B
2016-03-25 9:36:36,9405,20,225670,0,9405,172,9410,117,S
2016-03-25 9:36:37,9405,40,225710,0,9405,152,9410,122,S
2016-03-25 9:36:38,9405,2,225712,0,9405,152,9410,124,S
2016-03-25 9:36:38.5,9405,90,225802,-26,9405,312,9410,126,S
2016-03-25 9:36:40,9410,310,226112,2,9410,4,9415,244,B
2016-03-25 9:36:40.5,9410,2,226114,0,9410,20,9415,249,B
2016-03-25 9:36:41,9410,42,226156,32,9405,155,9410,57,B
2016-03-25 9:36:41.5,9410,6,226162,0,9405,138,9410,91,B
2016-03-25 9:36:42,9410,2,226164,2,9405,138,9410,102,B
2016-03-25 9:36:43,9410,2,226166,2,9405,138,9410,101,B
2016-03-25 9:36:43.5,9410,22,226188,2,9405,129,9410,252,B
2016-03-25 9:36:44,9405,4,226192,0,9405,117,9410,253,S
2016-03-25 9:36:44.5,9410,2,226194,0,9405,117,9410,254,B
2016-03-25 9:36:45,9405,20,226214,-20,9405,153,9410,255,S
2016-03-25 9:36:46,9410,8,226222,0,9405,153,9410,251,B
2016-03-25 9:36:46.5,9405,8,226230,-8,9405,149,9410,251,S
2016-03-25 9:36:47,9405,68,226298,-52,9405,116,9410,259,S
2016-03-25 9:36:49,9405,456,226754,-184,9400,556,9405,2,S
2016-03-25 9:36:49.5,9405,64,226818,0,9405,129,9410,181,S
2016-03-25 9:36:50,9405,2,226820,2,9405,157,9410,182,S
2016-03-25 9:36:53,9405,2,226822,0,9405,135,9410,247,S
2016-03-25 9:36:54,9405,4,226826,2,9405,134,9410,260,S
2016-03-25 9:36:54.5,9405,26,226852,26,9405,132,9410,249,S
2016-03-25 9:36:55,9405,2,226854,2,9405,137,9410,250,S
2016-03-25 9:36:55.5,9405,6,226860,4,9405,135,9410,250,S
2016-03-25 9:36:56,9405,4,226864,4,9405,133,9410,250,S
2016-03-25 9:36:56.5,9405,10,226874,10,9405,130,9410,250,S
2016-03-25 9:36:57,9410,20,226894,20,9405,131,9410,240,B
2016-03-25 9:37:00,9405,6,226900,4,9405,151,9410,175,S
2016-03-25 9:37:01,9410,2,226902,2,9405,151,9410,171,B
2016-03-25 9:37:01.5,9405,2,226904,2,9405,150,9410,122,S
2016-03-25 9:37:02,9410,66,226970,64,9405,150,9410,93,B
2016-03-25 9:37:03,9410,4,226974,4,9405,158,9410,104,B
2016-03-25 9:37:05,9410,20,226994,20,9405,220,9410,94,B
2016-03-25 9:37:06,9405,30,227024,0,9405,206,9410,95,S
2016-03-25 9:37:06.5,9405,4,227028,2,9405,204,9410,100,S
2016-03-25 9:37:07,9410,10,227038,10,9405,204,9410,95,B
2016-03-25 9:37:07.5,9410,4,227042,0,9405,205,9410,94,B
2016-03-25 9:37:08,9405,2,227044,2,9405,204,9410,93,S
2016-03-25 9:37:08.5,9410,10,227054,-2,9405,204,9410,88,B
2016-03-25 9:37:10,9410,2,227056,0,9405,215,9410,129,B
2016-03-25 9:37:10.5,9410,6,227062,6,9405,215,9410,126,B
2016-03-25 9:37:11,9405,40,227102,-18,9405,195,9410,126,S
2016-03-25 9:37:12,9405,2,227104,-2,9405,194,9410,130,S
2016-03-25 9:37:13,9410,6,227110,0,9405,194,9410,128,B
2016-03-25 9:37:13.5,9405,2,227112,0,9405,193,9410,128,S
2016-03-25 9:37:14,9405,2,227114,0,9405,194,9410,138,S
2016-03-25 9:37:15,9405,2,227116,0,9405,193,9410,143,S
2016-03-25 9:37:15.5,9405,2,227118,0,9405,194,9410,143,S
2016-03-25 9:37:20,9405,2,227120,-2,9405,229,9410,143,S
2016-03-25 9:37:21,9410,4,227124,4,9405,229,9410,162,B
2016-03-25 9:37:22,9410,4,227128,4,9405,244,9410,160,B
2016-03-25 9:37:23,9405,6,227134,0,9405,241,9410,160,S
2016-03-25 9:37:25,9410,4,227138,0,9405,262,9410,161,B
2016-03-25 9:37:26,9405,2,227140,-2,9405,261,9410,181,S
2016-03-25 9:37:27,9405,2,227142,0,9405,260,9410,200,S
2016-03-25 9:37:30,9405,224,227366,98,9405,296,9410,123,S
2016-03-25 9:37:31,9405,10,227376,0,9405,294,9410,126,S
2016-03-25 9:37:32,9405,4,227380,0,9405,293,9410,126,S
2016-03-25 9:37:33,9410,6,227386,0,9405,293,9410,123,B
2016-03-25 9:37:34,9405,62,227448,-34,9405,287,9410,150,S
2016-03-25 9:37:34.5,9405,10,227458,0,9405,286,9410,204,S
2016-03-25 9:37:37,9410,82,227540,-34,9405,252,9410,230,B
2016-03-25 9:37:38,9405,20,227560,16,9405,247,9410,230,S
2016-03-25 9:37:39,9405,2,227562,2,9405,245,9410,230,S
2016-03-25 9:37:41,9405,4,227566,0,9405,242,9410,221,S
2016-03-25 9:37:42,9405,2,227568,0,9405,242,9410,220,S
2016-03-25 9:37:43,9405,6,227574,6,9405,238,9410,221,S
2016-03-25 9:37:44,9405,2,227576,0,9405,222,9410,241,S
2016-03-25 9:37:45,9405,2,227578,2,9405,221,9410,251,S
2016-03-25 9:37:47,9405,6,227584,6,9405,211,9410,256,S
2016-03-25 9:37:47.5,9405,20,227604,18,9405,201,9410,256,S
2016-03-25 9:37:48,9405,78,227682,0,9405,170,9410,257,S
2016-03-25 9:37:48.5,9405,278,227960,92,9405,29,9410,209,S
2016-03-25 9:37:49,9405,58,228018,-14,9400,663,9405,510,S
2016-03-25 9:37:49.5,9405,40,228058,-40,9400,655,9405,535,S
2016-03-25 9:37:52,9400,16,228074,-2,9400,650,9405,534,S
2016-03-25 9:37:52.5,9405,10,228084,0,9400,545,9405,530,B
2016-03-25 9:37:54,9400,406,228490,-320,9400,321,9405,332,S
2016-03-25 9:37:55,9400,2,228492,0,9400,321,9405,335,S
2016-03-25 9:37:55.5,9400,6,228498,0,9400,318,9405,338,S
2016-03-25 9:37:56,9400,2,228500,0,9400,319,9405,242,S
2016-03-25 9:37:57,9400,2,228502,-2,9400,318,9405,242,S
2016-03-25 9:37:57.5,9400,6,228508,-6,9400,314,9405,242,S
2016-03-25 9:37:58,9405,2,228510,0,9400,316,9405,241,B
2016-03-25 9:37:59,9400,42,228552,0,9400,315,9405,223,S
2016-03-25 9:38:00,9405,102,228654,38,9400,310,9405,173,B
2016-03-25 9:38:01,9400,12,228666,10,9400,304,9405,174,S
2016-03-25 9:38:02,9400,4,228670,-2,9400,302,9405,175,S
2016-03-25 9:38:02.5,9405,22,228692,22,9400,301,9405,169,B
2016-03-25 9:38:03,9405,200,228892,-14,9400,313,9405,150,B
2016-03-25 9:38:03.5,9405,56,228948,-56,9400,313,9405,121,B
2016-03-25 9:38:04,9405,2,228950,0,9400,313,9405,120,B
2016-03-25 9:38:05,9405,150,229100,-100,9400,263,9405,45,B
2016-03-25 9:38:05.5,9405,88,229188,52,9405,205,9410,205,B
2016-03-25 9:38:06,9410,2,229190,0,9405,219,9410,203,B
2016-03-25 9:38:06.5,9405,26,229216,0,9405,207,9410,203,S
2016-03-25 9:38:08,9405,2,229218,0,9405,186,9410,202,S
2016-03-25 9:38:08.5,9405,2,229220,0,9405,171,9410,202,S
2016-03-25 9:38:10,9410,2,229222,2,9405,173,9410,201,B
2016-03-25 9:38:11,9410,22,229244,2,9405,163,9410,203,B
2016-03-25 9:38:11.5,9405,4,229248,-2,9405,161,9410,202,S
2016-03-25 9:38:14,9405,2,229250,0,9405,162,9410,202,S
2016-03-25 9:38:15,9405,2,229252,0,9405,163,9410,202,S
2016-03-25 9:38:15.5,9405,8,229260,8,9405,157,9410,218,S
2016-03-25 9:38:16,9405,60,229320,0,9405,129,9410,224,S
2016-03-25 9:38:16.5,9405,50,229370,0,9405,115,9410,224,S
2016-03-25 9:38:17,9410,4,229374,0,9405,112,9410,222,B
2016-03-25 9:38:18,9405,224,229598,174,9400,374,9405,27,S
2016-03-25 9:38:18.5,9405,16,229614,2,9400,316,9405,93,S
2016-03-25 9:38:19,9405,4,229618,0,9400,314,9405,92,S
2016-03-25 9:38:21,9405,214,229832,160,9400,319,9405,3,S
2016-03-25 9:38:21.5,9405,10,229842,-2,9405,59,9410,198,S
2016-03-25 9:38:22,9405,150,229992,76,9405,2,9410,253,S
2016-03-25 9:38:23,9405,10,230002,0,9400,319,9405,63,S
2016-03-25 9:38:23.5,9405,4,230006,4,9400,323,9405,66,S
2016-03-25 9:38:24,9405,138,230144,126,9405,34,9410,254,S
2016-03-25 9:38:25,9405,60,230204,0,9405,5,9410,230,S
2016-03-25 9:38:26,9405,24,230228,18,9400,356,9405,18,S
2016-03-25 9:38:26.5,9405,136,230364,-40,9405,27,9410,230,S
2016-03-25 9:38:27,9405,6,230370,0,9405,26,9410,230,S
2016-03-25 9:38:28,9405,10,230380,0,9405,113,9410,232,S
2016-03-25 9:38:28.5,9405,220,230600,126,9405,114,9410,160,S
2016-03-25 9:38:30,9410,4,230604,-4,9405,136,9410,210,B
2016-03-25 9:38:30.5,9405,26,230630,-6,9405,125,9410,210,S
2016-03-25 9:38:31,9410,206,230836,76,9405,124,9410,110,B
2016-03-25 9:38:32,9410,20,230856,0,9405,152,9410,98,B
2016-03-25 9:38:33,9410,12,230868,-2,9405,179,9410,98,B
2016-03-25 9:38:34,9410,214,231082,78,9405,603,9410,53,B
2016-03-25 9:38:35,9410,40,231122,18,9410,55,9415,181,B
2016-03-25 9:38:36,9410,4,231126,0,9410,95,9415,160,B
2016-03-25 9:38:37,9410,2,231128,2,9410,94,9415,162,B
2016-03-25 9:38:38,9415,204,231332,182,9410,92,9415,62,B
2016-03-25 9:38:38.5,9410,2,231334,2,9410,115,9415,60,S
2016-03-25 9:38:41,9415,22,231356,20,9410,111,9415,145,B
2016-03-25 9:38:42,9410,2,231358,2,9410,110,9415,145,S
2016-03-25 9:38:42.5,9415,10,231368,0,9410,110,9415,142,B
2016-03-25 9:38:44,9410,200,231568,-66,9410,321,9415,140,S
2016-03-25 9:38:44.5,9410,10,231578,10,9410,315,9415,139,S
2016-03-25 9:38:46,9415,2,231580,2,9410,619,9415,145,B
2016-03-25 9:38:46.5,9410,2,231582,2,9410,618,9415,145,S
2016-03-25 9:38:49,9410,100,231682,0,9410,900,9415,191,S
2016-03-25 9:38:49.5,9410,2,231684,2,9410,899,9415,192,S
2016-03-25 9:38:50,9415,30,231714,-2,9410,899,9415,176,B
2016-03-25 9:38:51,9410,4,231718,4,9410,897,9415,249,S
2016-03-25 9:38:52,9410,114,231832,-24,9405,137,9410,242,S
2016-03-25 9:38:53,9410,10,231842,10,9405,153,9410,205,S
2016-03-25 9:38:54,9410,10,231852,-8,9405,153,9410,202,S
2016-03-25 9:38:55,9410,2,231854,0,9405,163,9410,201,S
2016-03-25 9:38:56,9405,2,231856,0,9405,162,9410,221,S
2016-03-25 9:38:58,9405,2,231858,2,9405,160,9410,222,S
2016-03-25 9:39:00,9405,26,231884,-18,9405,67,9410,275,S
2016-03-25 9:39:00.5,9405,20,231904,6,9405,57,9410,276,S
2016-03-25 9:39:01,9405,20,231924,-20,9405,42,9410,276,S
2016-03-25 9:39:01.5,9405,86,232010,-52,9400,416,9405,111,S
2016-03-25 9:39:02,9405,10,232020,-10,9400,399,9405,100,S
2016-03-25 9:39:02.5,9405,40,232060,-40,9400,397,9405,72,S
2016-03-25 9:39:03,9405,2,232062,0,9400,401,9405,92,S
2016-03-25 9:39:04,9405,2,232064,2,9400,400,9405,92,S
2016-03-25 9:39:06,9405,2,232066,2,9400,428,9405,108,S
2016-03-25 9:39:08,9405,2,232068,2,9400,439,9405,131,S
2016-03-25 9:39:08.5,9405,42,232110,42,9400,425,9405,110,S
2016-03-25 9:39:09,9405,2,232112,2,9400,425,9405,110,S
2016-03-25 9:39:12,9405,2,232114,2,9400,411,9405,162,S
2016-03-25 9:39:14,9400,40,232154,4,9400,391,9405,163,S
2016-03-25 9:39:14.5,9405,10,232164,0,9400,389,9405,148,B
2016-03-25 9:39:16,9400,4,232168,0,9400,389,9405,113,S
2016-03-25 9:39:18,9400,2,232170,2,9400,395,9405,96,S
2016-03-25 9:39:18.5,9400,4,232174,4,9400,399,9405,96,S
2016-03-25 9:39:19,9400,6,232180,0,9400,401,9405,96,S
2016-03-25 9:39:20,9400,110,232290,-2,9400,353,9405,99,S
2016-03-25 9:39:21,9400,110,232400,-14,9400,304,9405,103,S
2016-03-25 9:39:21.5,9400,18,232418,-18,9400,294,9405,103,S
2016-03-25 9:39:22,9400,724,233142,190,9395,386,9400,189,S
2016-03-25 9:39:22.5,9395,150,233292,-90,9395,202,9400,238,S
2016-03-25 9:39:23,9400,136,233428,-58,9395,139,9400,286,B
2016-03-25 9:39:23.5,9395,206,233634,-162,9390,404,9400,287,S
2016-03-25 9:39:24,9395,240,233874,-212,9395,6,9400,337,S
2016-03-25 9:39:24.5,9395,120,233994,-20,9390,268,9400,379,S
2016-03-25 9:39:25,9390,136,234130,-92,9390,259,9400,384,S
2016-03-25 9:39:25.5,9395,214,234344,-164,9395,3,9400,387,B
2016-03-25 9:39:26,9395,62,234406,46,9390,180,9395,80,B
2016-03-25 9:39:26.5,9390,8,234414,2,9390,177,9395,93,S
2016-03-25 9:39:27,9390,4,234418,-4,9390,268,9395,106,S
2016-03-25 9:39:27.5,9390,234,234652,-50,9390,159,9395,97,S
2016-03-25 9:39:28,9390,210,234862,-206,9390,57,9395,109,S
2016-03-25 9:39:28.5,9390,114,234976,-4,9385,441,9390,231,S
2016-03-25 9:39:29,9390,378,235354,-356,9385,405,9390,36,S
2016-03-25 9:39:29.5,9390,112,235466,-26,9390,22,9395,171,S
2016-03-25 9:39:30,9390,6,235472,0,9390,40,9395,175,S
2016-03-25 9:39:30.5,9390,20,235492,4,9390,415,9395,174,S
2016-03-25 9:39:31,9395,70,235562,-2,9390,384,9395,161,B
2016-03-25 9:39:31.5,9390,4,235566,-4,9390,390,9395,149,S
2016-03-25 9:39:32,9390,268,235834,-194,9390,280,9395,126,S
2016-03-25 9:39:32.5,9390,26,235860,-18,9390,373,9395,125,S
2016-03-25 9:39:33,9390,2,235862,0,9390,374,9395,125,S
2016-03-25 9:39:33.5,9390,2,235864,0,9390,375,9395,126,S
2016-03-25 9:39:34,9390,6,235870,-4,9390,391,9395,125,S
2016-03-25 9:39:35,9390,2,235872,-2,9390,400,9395,125,S
2016-03-25 9:39:35.5,9390,24,235896,-22,9390,388,9395,147,S
2016-03-25 9:39:36,9390,22,235918,-2,9390,379,9395,146,S
2016-03-25 9:39:36.5,9390,6,235924,-4,9390,377,9395,151,S
2016-03-25 9:39:37,9390,2,235926,-2,9390,376,9395,156,S
2016-03-25 9:39:38,9395,272,236198,118,9390,518,9395,7,B
2016-03-25 9:39:39,9395,18,236216,0,9395,44,9400,297,B
2016-03-25 9:39:40,9395,12,236228,-12,9395,53,9400,297,B
2016-03-25 9:39:40.5,9390,138,236366,-90,9390,466,9395,131,S
2016-03-25 9:39:41,9395,14,236380,-10,9390,446,9395,139,B
2016-03-25 9:39:41.5,9395,2,236382,0,9390,407,9395,138,B
2016-03-25 9:39:42,9390,12,236394,-12,9390,529,9395,143,S
2016-03-25 9:39:43,9395,6,236400,0,9390,358,9395,143,B
2016-03-25 9:39:43.5,9390,202,236602,2,9390,257,9395,143,S
2016-03-25 9:39:45,9390,10,236612,-10,9390,356,9395,143,S
2016-03-25 9:39:45.5,9390,4,236616,0,9390,371,9395,170,S
2016-03-25 9:39:46,9390,2,236618,-2,9390,370,9395,170,S
2016-03-25 9:39:46.5,9395,4,236622,-4,9390,372,9395,172,B
2016-03-25 9:39:47,9390,48,236670,-48,9390,412,9395,209,S
2016-03-25 9:39:48,9390,4,236674,0,9390,406,9395,209,S
2016-03-25 9:39:48.5,9390,6,236680,-6,9390,403,9395,209,S
2016-03-25 9:39:50,9395,22,236702,-22,9390,404,9395,200,B
2016-03-25 9:39:50.5,9390,8,236710,0,9390,400,9395,211,S
2016-03-25 9:39:51,9390,10,236720,0,9390,395,9395,212,S
2016-03-25 9:39:51.5,9390,10,236730,0,9390,428,9395,212,S
2016-03-25 9:39:52,9390,50,236780,-20,9390,404,9395,712,S
2016-03-25 9:39:52.5,9390,12,236792,8,9390,398,9395,744,S
2016-03-25 9:39:53,9390,2,236794,2,9390,501,9395,746,S
2016-03-25 9:39:54,9390,6,236800,0,9390,498,9395,746,S
2016-03-25 9:39:55,9390,20,236820,20,9390,493,9395,721,S
2016-03-25 9:39:55.5,9390,108,236928,-34,9390,444,9395,721,S
2016-03-25 9:39:56,9390,20,236948,0,9390,537,9395,721,S
2016-03-25 9:39:56.5,9390,6,236954,0,9390,534,9395,722,S
2016-03-25 9:39:57,9390,30,236984,0,9390,519,9395,722,S
2016-03-25 9:39:58,9390,130,237114,-98,9390,460,9395,722,S
2016-03-25 9:39:58.5,9390,4,237118,0,9390,458,9395,722,S
2016-03-25 9:39:59,9390,8,237126,-8,9390,559,9395,722,S
2016-03-25 9:40:00,9390,2,237128,0,9390,666,9395,722,S
2016-03-25 9:40:00.5,9395,6,237134,6,9390,668,9395,719,B
2016-03-25 9:40:01,9395,388,237522,-156,9395,60,9400,205,B
2016-03-25 9:40:01.5,9400,10,237532,10,9395,82,9400,175,B
2016-03-25 9:40:02,9395,8,237540,-4,9395,181,9400,184,S
2016-03-25 9:40:02.5,9395,4,237544,-4,9395,185,9400,207,S
2016-03-25 9:40:03,9395,10,237554,-6,9395,180,9400,200,S
2016-03-25 9:40:04,9395,4,237558,0,9395,100,9400,200,S
2016-03-25 9:40:06,9395,2,237560,0,9395,56,9400,210,S
2016-03-25 9:40:07,9395,2,237562,2,9395,55,9400,210,S
2016-03-25 9:40:08,9395,2,237564,0,9395,62,9400,209,S
2016-03-25 9:40:09,9395,10,237574,-10,9395,113,9400,250,S
2016-03-25 9:40:11,9395,2,237576,-2,9395,247,9400,253,S
2016-03-25 9:40:12,9395,8,237584,4,9395,254,9400,201,S
2016-03-25 9:40:14,9400,2,237586,2,9395,280,9400,208,B
2016-03-25 9:40:16,9400,2,237588,0,9395,279,9400,251,B
2016-03-25 9:40:16.5,9400,40,237628,-18,9395,282,9400,231,B
2016-03-25 9:40:17,9395,14,237642,-8,9395,275,9400,231,S
2016-03-25 9:40:18,9395,2,237644,-2,9395,275,9400,232,S
2016-03-25 9:40:19,9395,12,237656,0,9395,272,9400,232,S
2016-03-25 9:40:22,9395,2,237658,-2,9395,378,9400,241,S
2016-03-25 9:40:24,9400,4,237662,0,9395,329,9400,249,B
2016-03-25 9:40:24.5,9395,2,237664,0,9395,328,9400,280,S
2016-03-25 9:40:25,9400,8,237672,8,9395,330,9400,276,B
2016-03-25 9:40:26,9395,60,237732,40,9395,300,9400,276,S
2016-03-25 9:40:27,9400,200,237932,88,9395,310,9400,169,B
2016-03-25 9:40:27.5,9400,48,237980,-16,9395,307,9400,144,B
2016-03-25 9:40:28,9400,22,238002,22,9395,316,9400,133,B
2016-03-25 9:40:28.5,9400,52,238054,16,9395,343,9400,107,B
2016-03-25 9:40:29,9400,134,238188,62,9400,99,9405,211,B
2016-03-25 9:40:31,9400,10,238198,10,9400,130,9405,179,B
2016-03-25 9:40:31.5,9400,24,238222,24,9400,118,9405,190,B
2016-03-25 9:40:33,9400,4,238226,4,9400,113,9405,200,B
2016-03-25 9:40:33.5,9400,202,238428,-42,9400,12,9405,200,B
2016-03-25 9:40:34,9400,26,238454,-18,9395,400,9400,33,B
2016-03-25 9:40:34.5,9400,2,238456,-2,9395,394,9400,42,B
2016-03-25 9:40:35,9400,118,238574,12,9400,1,9405,226,B
2016-03-25 9:40:36,9400,2,238576,2,9395,403,9400,60,B
2016-03-25 9:40:37,9395,2,238578,0,9395,350,9400,168,S
2016-03-25 9:40:37.5,9395,260,238838,-246,9395,200,9400,218,S
2016-03-25 9:40:43,9395,252,239090,226,9395,25,9400,291,S
2016-03-25 9:40:43.5,9395,54,239144,-6,9390,286,9395,50,S
2016-03-25 9:40:44,9395,216,239360,182,9390,309,9395,152,S
2016-03-25 9:40:45,9395,220,239580,16,9390,184,9395,143,S
2016-03-25 9:40:45.5,9390,366,239946,-210,9385,430,9390,219,S
2016-03-25 9:40:46,9390,20,239966,-20,9385,367,9390,210,S
2016-03-25 9:40:47,9390,2,239968,0,9385,372,9390,209,S
2016-03-25 9:40:51,9390,272,240240,-208,9385,354,9390,74,S
2016-03-25 9:40:51.5,9390,144,240384,-124,9390,106,9395,169,S
2016-03-25 9:40:52,9390,4,240388,4,9390,209,9395,165,S
2016-03-25 9:40:53,9390,22,240410,0,9390,220,9395,180,S
2016-03-25 9:40:55,9395,18,240428,0,9390,201,9395,172,B
2016-03-25 9:40:57,9395,2,240430,2,9390,212,9395,172,B
2016-03-25 9:40:57.5,9390,2,240432,2,9390,211,9395,173,S
2016-03-25 9:41:03,9395,60,240492,0,9390,236,9395,153,B
2016-03-25 9:41:03.5,9390,4,240496,0,9390,247,9395,154,S
2016-03-25 9:41:04,9395,2,240498,2,9390,250,9395,155,B
2016-03-25 9:41:05,9395,312,240810,284,9395,77,9400,368,B
2016-03-25 9:41:05.5,9400,10,240820,10,9395,80,9400,290,B
2016-03-25 9:41:06,9395,12,240832,12,9395,74,9400,291,S
2016-03-25 9:41:08,9395,2,240834,2,9395,185,9400,291,S
2016-03-25 9:41:10,9395,8,240842,6,9395,183,9400,269,S
2016-03-25 9:41:11,9395,2,240844,2,9395,431,9400,249,S
2016-03-25 9:41:13,9395,20,240864,20,9395,422,9400,256,S
2016-03-25 9:41:14,9395,4,240868,4,9395,421,9400,255,S
2016-03-25 9:41:20,9395,4,240872,4,9395,611,9400,313,S
2016-03-25 9:41:21,9400,34,240906,34,9395,611,9400,295,B
2016-03-25 9:41:21.5,9395,8,240914,8,9395,607,9400,299,S
2016-03-25 9:41:23,9400,20,240934,0,9395,607,9400,285,B
2016-03-25 9:41:26,9395,2,240936,2,9395,597,9400,284,S
2016-03-25 9:41:26.3333,9395,200,241136,-4,9395,598,9400,284,S
2016-03-25 9:41:26.6667,9395,100,241236,0,9395,547,9400,284,S
2016-03-25 9:41:27,9395,112,241348,100,9395,490,9400,284,S
2016-03-25 9:41:27.5,9395,30,241378,-22,9390,320,9395,154,S
2016-03-25 9:41:28,9390,570,241948,-128,9385,473,9390,25,S
2016-03-25 9:41:28.5,9390,6,241954,0,9385,446,9390,43,S
2016-03-25 9:41:29,9390,2,241956,-2,9385,437,9390,42,S
2016-03-25 9:41:30,9390,114,242070,-76,9385,389,9390,75,S
2016-03-25 9:41:30.5,9390,8,242078,-6,9385,388,9390,67,S
2016-03-25 9:41:31,9385,2,242080,0,9385,387,9390,7,S
2016-03-25 9:41:31.5,9385,22,242102,-8,9385,377,9390,8,S
2016-03-25 9:41:32,9390,58,242160,8,9390,4,9395,272,B
2016-03-25 9:41:33,9390,78,242238,-70,9390,19,9395,272,B
2016-03-25 9:41:33.5,9390,2,242240,0,9390,249,9395,273,B
2016-03-25 9:41:34,9390,2,242242,-2,9390,260,9395,253,B
2016-03-25 9:41:36,9395,2,242244,0,9390,262,9395,303,B
2016-03-25 9:41:36.5,9395,2,242246,-2,9390,32,9395,363,B
2016-03-25 9:41:37,9390,2,242248,-2,9390,81,9395,364,S
2016-03-25 9:41:38,9390,6,242254,0,9390,78,9395,364,S
2016-03-25 9:41:40,9390,4,242258,0,9390,87,9395,822,S
2016-03-25 9:41:41,9390,24,242282,-16,9390,153,9395,822,S
2016-03-25 9:41:41.5,9390,4,242286,0,9390,152,9395,306,S
2016-03-25 9:41:42,9390,2,242288,0,9390,154,9395,305,S
2016-03-25 9:41:45,9390,8,242296,0,9390,163,9395,315,S
2016-03-25 9:41:46,9390,4,242300,0,9390,276,9395,315,S
2016-03-25 9:41:46.5,9390,4,242304,-2,9390,275,9395,316,S
2016-03-25 9:41:47,9390,8,242312,-2,9390,272,9395,317,S
2016-03-25 9:41:48,9390,6,242318,-4,9390,270,9395,326,S
2016-03-25 9:41:49,9390,16,242334,-16,9390,246,9395,328,S
2016-03-25 9:41:49.5,9390,2,242336,-2,9390,245,9395,328,S
2016-03-25 9:41:50,9395,20,242356,-20,9390,246,9395,318,B
2016-03-25 9:41:53,9395,34,242390,-34,9390,248,9395,302,B
2016-03-25 9:41:56,9395,2,242392,0,9390,254,9395,301,B
2016-03-25 9:41:57,9395,2,242394,0,9390,255,9395,300,B
2016-03-25 9:41:58,9395,2,242396,-2,9390,255,9395,310,B
2016-03-25 9:41:59,9395,10,242406,-2,9390,254,9395,325,B
2016-03-25 9:41:59.5,9395,2,242408,-2,9390,224,9395,314,B
2016-03-25 9:42:02,9390,76,242484,-60,9390,203,9395,278,S
2016-03-25 9:42:06,9395,20,242504,-20,9390,207,9395,268,B
2016-03-25 9:42:07,9395,2,242506,-2,9390,207,9395,279,B
2016-03-25 9:42:09,9390,2,242508,0,9390,223,9395,279,S
2016-03-25 9:42:10,9390,2,242510,-2,9390,1225,9395,249,S
2016-03-25 9:42:15,9395,24,242534,-24,9390,1227,9395,237,B
2016-03-25 9:42:15.5,9390,8,242542,0,9390,225,9395,237,S
2016-03-25 9:42:16,9395,2,242544,0,9390,224,9395,236,B
2016-03-25 9:42:18,9390,2,242546,0,9390,275,9395,240,S
2016-03-25 9:42:19,9390,4,242550,-4,9390,274,9395,239,S
2016-03-25 9:42:19.5,9395,4,242554,-4,9390,273,9395,238,B
2016-03-25 9:42:24,9390,2,242556,0,9390,279,9395,240,S
2016-03-25 9:42:25,9395,100,242656,-100,9390,230,9395,189,B
2016-03-25 9:42:26,9395,4,242660,-4,9390,233,9395,187,B
2016-03-25 9:42:27,9395,2,242662,-2,9390,233,9395,186,B
2016-03-25 9:42:28,9395,4,242666,0,9390,233,9395,184,B
2016-03-25 9:42:32,9390,2,242668,-2,9390,236,9395,209,S
2016-03-25 9:42:34,9395,2,242670,-2,9390,228,9395,219,B
2016-03-25 9:42:36,9390,2,242672,-2,9390,210,9395,222,S
2016-03-25 9:42:40,9390,4,242676,-2,9390,213,9395,257,S
2016-03-25 9:42:41,9390,200,242876,-116,9390,112,9395,257,S
2016-03-25 9:42:42,9390,220,243096,60,9385,433,9390,2,S
2016-03-25 9:42:43,9385,10,243106,0,9385,397,9390,59,S
2016-03-25 9:42:43.5,9390,118,243224,-114,9390,33,9395,280,B
2016-03-25 9:42:44,9390,66,243290,-58,9385,389,9390,31,B
2016-03-25 9:42:45,9390,2,243292,-2,9385,369,9390,30,B
2016-03-25 9:42:45.3333,9390,86,243378,-48,9390,25,9395,283,B
2016-03-25 9:42:45.6667,9390,2,243380,0,9390,30,9395,333,B
2016-03-25 9:42:47,9390,16,243396,-10,9390,26,9395,329,B
2016-03-25 9:42:48,9390,18,243414,-10,9390,79,9395,330,B
2016-03-25 9:42:49,9390,6,243420,0,9390,77,9395,344,B
2016-03-25 9:42:49.5,9390,10,243430,-8,9390,72,9395,345,B
2016-03-25 9:42:50,9390,40,243470,12,9390,113,9395,345,B
2016-03-25 9:42:50.5,9390,16,243486,0,9390,105,9395,346,B
2016-03-25 9:42:51,9390,2,243488,0,9390,110,9395,347,B
2016-03-25 9:42:52,9390,40,243528,-40,9390,90,9395,347,B
2016-03-25 9:42:52.5,9390,2,243530,0,9390,89,9395,351,B
2016-03-25 9:42:53,9390,78,243608,-4,9390,51,9395,350,B
2016-03-25 9:42:53.5,9390,10,243618,0,9390,46,9395,350,B
2016-03-25 9:42:54,9390,128,243746,-22,9385,434,9390,1,B
2016-03-25 9:42:54.5,9390,4,243750,2,9385,403,9390,8,B
2016-03-25 9:42:55,9390,100,243850,0,9385,361,9390,4,B
2016-03-25 9:42:57,9390,2,243852,2,9385,326,9390,63,B
2016-03-25 9:42:58,9390,138,243990,-12,9390,6,9395,395,B
2016-03-25 9:42:58.5,9390,12,244002,-4,9385,357,9390,23,B
2016-03-25 9:42:59,9390,6,244008,6,9385,357,9390,31,B
2016-03-25 9:43:01,9390,8,244016,-2,9385,359,9390,48,B
2016-03-25 9:43:01.5,9390,2,244018,0,9385,359,9390,50,B
2016-03-25 9:43:02,9390,4,244022,4,9385,360,9390,71,B
2016-03-25 9:43:03,9385,4,244026,2,9385,359,9390,92,S
2016-03-25 9:43:04,9385,332,244358,152,9385,186,9390,98,S
2016-03-25 9:43:04.5,9390,122,244480,-44,9385,114,9390,137,B
2016-03-25 9:43:05,9385,20,244500,-4,9385,104,9390,169,S
2016-03-25 9:43:05.5,9385,214,244714,-136,9380,727,9385,59,S
2016-03-25 9:43:06,9385,18,244732,-2,9380,717,9385,54,S
2016-03-25 9:43:07,9385,2,244734,-2,9380,688,9385,68,S
2016-03-25 9:43:08,9385,2,244736,0,9380,584,9385,67,S
2016-03-25 9:43:09,9385,2,244738,-2,9380,556,9385,64,S
2016-03-25 9:43:10,9380,4,244742,4,9380,540,9385,66,S
2016-03-25 9:43:10.5,9380,94,244836,12,9380,480,9385,92,S
2016-03-25 9:43:11,9380,26,244862,8,9380,453,9385,131,S
2016-03-25 9:43:11.5,9380,2,244864,0,9380,462,9385,131,S
2016-03-25 9:43:12,9385,36,244900,10,9380,457,9385,118,B
2016-03-25 9:43:12.5,9380,12,244912,8,9380,452,9385,117,S
2016-03-25 9:43:13,9380,14,244926,2,9380,444,9385,117,S
2016-03-25 9:43:14,9380,6,244932,2,9380,441,9385,318,S
2016-03-25 9:43:15,9380,20,244952,0,9380,931,9385,323,S
2016-03-25 9:43:15.5,9380,128,245080,24,9380,872,9385,322,S
2016-03-25 9:43:16,9385,10,245090,6,9380,867,9385,324,B
2016-03-25 9:43:16.5,9380,4,245094,0,9380,366,9385,326,S
2016-03-25 9:43:17,9380,20,245114,20,9380,355,9385,327,S
2016-03-25 9:43:17.5,9380,12,245126,10,9380,349,9385,331,S
2016-03-25 9:43:18,9380,722,245848,138,9375,485,9380,103,S
2016-03-25 9:43:18.5,9380,208,246056,8,9375,453,9380,133,S
2016-03-25 9:43:19,9380,60,246116,28,9375,430,9380,137,S
2016-03-25 9:43:19.5,9380,74,246190,44,9375,405,9380,128,S
2016-03-25 9:43:20,9375,2,246192,2,9375,380,9380,129,S
2016-03-25 9:43:21,9375,80,246272,-36,9375,339,9380,162,S
2016-03-25 9:43:21.5,9375,30,246302,-28,9375,321,9380,163,S
2016-03-25 9:43:22,9375,32,246334,-2,9375,317,9380,150,S
2016-03-25 9:43:23,9375,16,246350,2,9375,310,9380,158,S
2016-03-25 9:43:24,9375,62,246412,0,9375,355,9380,160,S
2016-03-25 9:43:24.5,9375,8,246420,6,9375,355,9380,213,S
2016-03-25 9:43:25,9375,32,246452,-12,9375,332,9380,213,S
2016-03-25 9:43:25.3333,9380,6,246458,-6,9375,329,9380,216,B
2016-03-25 9:43:25.6667,9375,32,246490,-12,9375,303,9380,211,S
2016-03-25 9:43:26,9380,36,246526,-34,9375,338,9380,205,B
2016-03-25 9:43:27,9380,6,246532,-6,9375,335,9380,202,B
2016-03-25 9:43:27.5,9375,6,246538,-2,9375,342,9380,200,S
2016-03-25 9:43:28,9380,2,246540,-2,9375,299,9380,218,B
2016-03-25 9:43:29,9375,8,246548,2,9375,297,9380,218,S
2016-03-25 9:43:30,9375,30,246578,-30,9375,283,9380,219,S
2016-03-25 9:43:30.5,9380,4,246582,-4,9375,283,9380,218,B
2016-03-25 9:43:31,9375,20,246602,-20,9375,273,9380,209,S
2016-03-25 9:43:32,9375,6,246608,-6,9375,270,9380,209,S
2016-03-25 9:43:33,9375,12,246620,-10,9375,260,9380,209,S
2016-03-25 9:43:33.5,9380,30,246650,-30,9375,260,9380,290,B
2016-03-25 9:43:34,9380,2,246652,0,9375,262,9380,291,B
2016-03-25 9:43:35,9380,2,246654,0,9375,283,9380,290,B
2016-03-25 9:43:35.5,9375,6,246660,-6,9375,280,9380,292,S
2016-03-25 9:43:36,9375,6,246666,-6,9375,278,9380,290,S
2016-03-25 9:43:38,9375,2,246668,-2,9375,288,9380,480,S
2016-03-25 9:43:38.5,9375,408,247076,40,9375,89,9380,465,S
2016-03-25 9:43:39,9375,102,247178,-54,9375,41,9380,464,S
2016-03-25 9:43:39.5,9375,64,247242,-24,9375,60,9380,462,S
2016-03-25 9:43:40,9375,220,247462,96,9370,522,9375,7,S
2016-03-25 9:43:40.5,9375,36,247498,14,9375,169,9380,475,S
2016-03-25 9:43:41,9375,2,247500,-2,9375,224,9380,474,S
2016-03-25 9:43:41.5,9375,24,247524,0,9375,229,9380,469,S
2016-03-25 9:43:42,9375,10,247534,0,9375,236,9380,470,S
2016-03-25 9:43:42.5,9380,2,247536,2,9375,242,9380,469,B
2016-03-25 9:43:44,9380,48,247584,-14,9375,278,9380,497,B
2016-03-25 9:43:44.5,9375,34,247618,0,9375,263,9380,497,S
2016-03-25 9:43:45,9375,10,247628,-2,9375,259,9380,530,S
2016-03-25 9:43:45.5,9375,84,247712,12,9375,225,9380,520,S
2016-03-25 9:43:46,9375,12,247724,10,9375,219,9380,520,S
2016-03-25 9:43:47,9375,212,247936,136,9375,113,9380,558,S
2016-03-25 9:43:47.5,9375,2,247938,0,9375,112,9380,558,S
2016-03-25 9:43:48,9375,178,248116,48,9375,23,9380,558,S
2016-03-25 9:43:48.5,9375,60,248176,-6,9370,476,9375,84,S
2016-03-25 9:43:49,9370,74,248250,72,9370,420,9375,84,S
2016-03-25 9:43:49.5,9375,4,248254,2,9370,307,9375,56,B
2016-03-25 9:43:50,9375,36,248290,-22,9370,290,9375,50,B
2016-03-25 9:43:50.5,9370,8,248298,-4,9370,286,9375,60,S
2016-03-25 9:43:51,9370,38,248336,-2,9370,260,9375,58,S
2016-03-25 9:43:51.5,9370,32,248368,8,9370,248,9375,230,S
2016-03-25 9:43:52,9370,170,248538,-54,9370,189,9375,425,S
2016-03-25 9:43:52.5,9375,90,248628,-64,9370,202,9375,396,B
2016-03-25 9:43:53,9370,308,248936,-248,9370,48,9375,397,S
2016-03-25 9:43:53.5,9370,54,248990,-6,9370,24,9375,698,S
2016-03-25 9:43:54,9370,130,249120,6,9370,64,9375,744,S
2016-03-25 9:43:55,9370,4,249124,-2,9370,71,9375,722,S
2016-03-25 9:43:55.3333,9370,10,249134,0,9370,68,9375,722,S
2016-03-25 9:43:55.6667,9370,38,249172,-26,9370,69,9375,716,S
2016-03-25 9:43:56,9370,2,249174,0,9370,81,9375,717,S
2016-03-25 9:43:57,9370,2,249176,0,9370,187,9375,723,S
2016-03-25 9:43:57.3333,9370,24,249200,-16,9370,183,9375,823,S
2016-03-25 9:43:57.6667,9370,2,249202,0,9370,191,9375,824,S
2016-03-25 9:43:58,9370,8,249210,-6,9370,189,9375,825,S
2016-03-25 9:43:58.5,9370,430,249640,-178,9365,499,9370,26,S
2016-03-25 9:43:59,9370,2,249642,2,9365,478,9370,34,S
2016-03-25 9:44:00,9370,56,249698,50,9365,462,9370,155,S
2016-03-25 9:44:00.3333,9370,10,249708,2,9365,439,9370,155,S
2016-03-25 9:44:00.6667,9370,90,249798,-6,9365,422,9370,124,S
2016-03-25 9:44:01,9375,272,250070,-24,9370,127,9375,137,B
2016-03-25 9:44:02,9370,890,250960,-578,9370,4,9375,183,S
2016-03-25 9:44:02.5,9370,26,250986,0,9365,39,9370,98,S
2016-03-25 9:44:03,9370,2,250988,0,9365,147,9370,144,S
2016-03-25 9:44:04,9370,30,251018,10,9365,196,9370,121,S
2016-03-25 9:44:05,9370,248,251266,-58,9370,44,9375,189,S
2016-03-25 9:44:06,9370,64,251330,40,9370,37,9375,187,S
2016-03-25 9:44:06.5,9370,22,251352,10,9370,29,9375,192,S
2016-03-25 9:44:07,9370,4,251356,0,9370,29,9375,185,S
2016-03-25 9:44:07.5,9375,22,251378,0,9370,30,9375,174,B
2016-03-25 9:44:08,9370,26,251404,0,9370,29,9375,162,S
2016-03-25 9:44:08.5,9375,404,251808,-36,9375,11,9380,362,B
2016-03-25 9:44:09,9375,26,251834,10,9375,58,9380,361,B
2016-03-25 9:44:09.5,9375,74,251908,48,9375,133,9380,365,B
2016-03-25 9:44:10,9380,94,252002,-12,9375,127,9380,334,B
2016-03-25 9:44:10.5,9375,2,252004,2,9375,126,9380,338,S
2016-03-25 9:44:11,9375,4,252008,0,9375,124,9380,339,S
2016-03-25 9:44:11.5,9375,2,252010,2,9375,133,9380,337,S
2016-03-25 9:44:12,9375,2,252012,2,9375,133,9380,338,S
2016-03-25 9:44:12.5,9375,14,252026,14,9375,127,9380,337,S
2016-03-25 9:44:13,9380,2,252028,0,9375,127,9380,334,B
2016-03-25 9:44:13.5,9375,8,252036,4,9375,125,9380,334,S
2016-03-25 9:44:14,9375,2,252038,2,9375,144,9380,329,S
2016-03-25 9:44:15,9375,14,252052,-8,9375,139,9380,326,S
2016-03-25 9:44:16,9375,6,252058,-6,9375,137,9380,339,S
2016-03-25 9:44:17,9375,2,252060,0,9375,161,9380,310,S
2016-03-25 9:44:18,9375,102,252162,-100,9375,113,9380,312,S
2016-03-25 9:44:19,9380,46,252208,36,9375,92,9380,288,B
2016-03-25 9:44:19.5,9380,32,252240,0,9375,102,9380,290,B
2016-03-25 9:44:20,9380,6,252246,-6,9375,113,9380,288,B
2016-03-25 9:44:21,9375,10,252256,0,9375,132,9380,284,S
2016-03-25 9:44:21.5,9380,2,252258,-2,9375,132,9380,289,B
2016-03-25 9:44:22,9375,40,252298,-40,9375,117,9380,289,S
2016-03-25 9:44:23,9375,4,252302,0,9375,116,9380,291,S
2016-03-25 9:44:25,9375,2,252304,-2,9375,126,9380,297,S
2016-03-25 9:44:25.5,9375,4,252308,0,9375,126,9380,296,S
2016-03-25 9:44:26,9380,2,252310,0,9375,126,9380,295,B
2016-03-25 9:44:27,9375,4,252314,0,9375,124,9380,263,S
2016-03-25 9:44:28,9375,2,252316,0,9375,125,9380,168,S
2016-03-25 9:44:29,9380,30,252346,-16,9375,124,9380,173,B
2016-03-25 9:44:29.5,9380,24,252370,-2,9375,151,9380,163,B
2016-03-25 9:44:30,9375,100,252470,-98,9375,112,9380,143,S
2016-03-25 9:44:30.5,9380,2,252472,0,9375,116,9380,142,B
2016-03-25 9:44:31,9380,6,252478,0,9375,116,9380,141,B
2016-03-25 9:44:33,9375,22,252500,-14,9375,105,9380,141,S
2016-03-25 9:44:33.3333,9380,32,252532,20,9375,105,9380,125,B
2016-03-25 9:44:33.6667,9375,10,252542,-6,9375,203,9380,124,S
2016-03-25 9:44:34,9375,2,252544,0,9375,202,9380,124,S
2016-03-25 9:44:35,9375,44,252588,24,9375,180,9380,124,S
2016-03-25 9:44:36,9375,4,252592,4,9375,287,9380,167,S
2016-03-25 9:44:36.5,9380,4,252596,0,9375,292,9380,163,B
2016-03-25 9:44:38,9380,6,252602,6,9375,306,9380,170,B
2016-03-25 9:44:38.5,9375,2,252604,0,9375,305,9380,169,S
2016-03-25 9:44:39,9380,6,252610,6,9375,303,9380,169,B
2016-03-25 9:44:39.5,9380,2,252612,0,9375,303,9380,170,B
2016-03-25 9:44:43,9380,24,252636,0,9375,306,9380,254,B
2016-03-25 9:44:43.5,9380,2,252638,0,9375,306,9380,253,B
2016-03-25 9:44:45,9375,10,252648,0,9375,302,9380,252,S
2016-03-25 9:44:46,9380,6,252654,6,9375,302,9380,249,B
2016-03-25 9:44:46.5,9380,2,252656,2,9375,302,9380,250,B
2016-03-25 9:44:50,9380,4,252660,0,9375,358,9380,218,B
2016-03-25 9:44:52,9380,2,252662,2,9375,354,9380,216,B
2016-03-25 9:44:56,9380,4,252666,0,9375,357,9380,215,B
2016-03-25 9:45:00,9380,2,252668,0,9375,353,9380,220,B
2016-03-25 9:45:01,9375,70,252738,26,9375,343,9380,195,S
2016-03-25 9:45:01.5,9380,6,252744,-4,9375,342,9380,192,B
2016-03-25 9:45:02,9380,2,252746,-2,9375,344,9380,201,B
2016-03-25 9:45:02.5,9380,20,252766,8,9375,344,9380,194,B
2016-03-25 9:45:04,9375,2,252768,2,9375,343,9380,195,S
2016-03-25 9:45:05,9375,2,252770,0,9375,344,9380,198,S
2016-03-25 9:45:05.5,9380,4,252774,-4,9375,344,9380,196,B
2016-03-25 9:45:08,9375,2,252776,0,9375,343,9380,196,S
2016-03-25 9:45:08.3333,9380,14,252790,-4,9375,343,9380,189,B
2016-03-25 9:45:08.6667,9375,6,252796,6,9375,340,9380,189,S
2016-03-25 9:45:09,9375,12,252808,4,9375,334,9380,189,S
2016-03-25 9:45:10,9380,2,252810,-2,9375,332,9380,189,B
2016-03-25 9:45:10.5,9380,4,252814,2,9375,332,9380,187,B
2016-03-25 9:45:12,9380,10,252824,8,9375,332,9380,200,B
2016-03-25 9:45:14,9380,2,252826,-2,9375,341,9380,201,B
2016-03-25 9:45:16,9380,2,252828,0,9375,340,9380,200,B
2016-03-25 9:45:17,9380,258,253086,16,9375,383,9380,71,B
2016-03-25 9:45:17.5,9380,138,253224,26,9380,577,9385,422,B
2016-03-25 9:45:18,9385,36,253260,-8,9380,569,9385,414,B
2016-03-25 9:45:19,9380,24,253284,-22,9380,34,9385,414,S
2016-03-25 9:45:20,9380,76,253360,-8,9375,465,9380,75,S
2016-03-25 9:45:21,9380,220,253580,-138,9380,40,9385,414,S
2016-03-25 9:45:21.5,9380,2,253582,0,9380,40,9385,414,S
2016-03-25 9:45:23,9380,4,253586,0,9380,38,9385,401,S
2016-03-25 9:45:24,9380,44,253630,0,9380,78,9385,401,S
2016-03-25 9:45:24.5,9385,10,253640,0,9380,81,9385,398,B
2016-03-25 9:45:25,9385,20,253660,0,9380,77,9385,393,B
2016-03-25 9:45:27,9380,42,253702,20,9380,73,9385,393,S
2016-03-25 9:45:29,9385,6,253708,-2,9380,81,9385,383,B
2016-03-25 9:45:30,9385,2,253710,0,9380,99,9385,382,B
2016-03-25 9:45:34,9385,2,253712,0,9380,93,9385,387,B
2016-03-25 9:45:35,9385,4,253716,0,9380,100,9385,385,B
2016-03-25 9:45:36,9380,2,253718,2,9380,99,9385,385,S
2016-03-25 9:45:37,9380,10,253728,10,9380,105,9385,389,S
2016-03-25 9:45:37.5,9385,2,253730,-2,9380,133,9385,389,B
2016-03-25 9:45:38,9380,4,253734,2,9380,133,9385,398,S
2016-03-25 9:45:38.5,9380,4,253738,2,9380,133,9385,398,S
2016-03-25 9:45:39,9385,2,253740,0,9380,133,9385,397,B
2016-03-25 9:45:40,9380,4,253744,2,9380,134,9385,396,S
2016-03-25 9:45:41,9385,4,253748,-2,9380,136,9385,391,B
2016-03-25 9:45:42,9385,2,253750,0,9380,170,9385,390,B
2016-03-25 9:45:43,9380,6,253756,6,9380,136,9385,390,S
2016-03-25 9:45:44,9385,2,253758,2,9380,188,9385,390,B
2016-03-25 9:45:44.5,9385,2,253760,2,9380,188,9385,389,B
2016-03-25 9:45:45,9385,2,253762,2,9380,186,9385,389,B
2016-03-25 9:45:46,9385,4,253766,4,9380,187,9385,387,B
2016-03-25 9:45:47,9385,4,253770,0,9380,200,9385,386,B
2016-03-25 9:45:48,9385,10,253780,10,9380,202,9385,381,B
2016-03-25 9:45:49,9385,12,253792,12,9380,202,9385,375,B
2016-03-25 9:45:51,9380,2,253794,0,9380,215,9385,386,S
2016-03-25 9:45:53,9385,352,254146,338,9380,216,9385,210,B
2016-03-25 9:45:53.5,9385,222,254368,144,9380,228,9385,97,B
2016-03-25 9:45:54,9385,194,254562,0,9385,220,9390,237,B
2016-03-25 9:45:54.5,9385,4,254566,-2,9385,243,9390,256,B
2016-03-25 9:45:57,9390,16,254582,0,9385,227,9390,297,B
2016-03-25 9:45:58,9385,60,254642,-52,9380,285,9385,29,S
2016-03-25 9:45:59,9385,58,254700,-58,9385,72,9390,302,S
2016-03-25 9:45:59.5,9390,402,255102,342,9385,86,9390,101,B
2016-03-25 9:46:01,9385,32,255134,-32,9385,95,9390,130,S
2016-03-25 9:46:01.5,9390,2,255136,2,9385,95,9390,129,B
2016-03-25 9:46:02,9385,22,255158,4,9385,94,9390,120,S
2016-03-25 9:46:02.5,9385,48,255206,-46,9385,71,9390,120,S
2016-03-25 9:46:03,9385,126,255332,-116,9380,259,9385,128,S
2016-03-25 9:46:03.5,9385,2,255334,-2,9380,184,9385,137,S
2016-03-25 9:46:04,9385,88,255422,56,9380,184,9385,102,S
2016-03-25 9:46:06,9385,4,255426,2,9380,174,9385,112,S
2016-03-25 9:46:07,9385,4,255430,4,9380,175,9385,228,S
2016-03-25 9:46:08,9385,2,255432,0,9380,177,9385,229,S
2016-03-25 9:46:09,9385,2,255434,0,9380,177,9385,115,S
2016-03-25 9:46:10,9385,18,255452,18,9380,178,9385,108,S
2016-03-25 9:46:12,9385,2,255454,2,9380,189,9385,104,S
2016-03-25 9:46:14,9385,2,255456,0,9380,190,9385,111,S
2016-03-25 9:46:14.5,9385,12,255468,12,9380,187,9385,108,S
2016-03-25 9:46:15,9380,108,255576,40,9380,132,9385,118,S
2016-03-25 9:46:17,9380,2,255578,-2,9380,142,9385,135,S
2016-03-25 9:46:18,9385,2,255580,0,9380,142,9385,151,B
2016-03-25 9:46:20,9380,4,255584,0,9380,139,9385,178,S
2016-03-25 9:46:20.5,9380,4,255588,0,9380,137,9385,179,S
2016-03-25 9:46:24,9385,2,255590,0,9380,244,9385,162,B
2016-03-25 9:46:25,9385,6,255596,2,9380,249,9385,159,B
2016-03-25 9:46:25.5,9380,2,255598,-2,9380,262,9385,159,S
2016-03-25 9:46:29,9385,40,255638,40,9380,245,9385,188,B
2016-03-25 9:46:30,9385,2,255640,0,9380,277,9385,186,B
2016-03-25 9:46:33,9380,2,255642,-2,9380,286,9385,189,S
2016-03-25 9:46:35,9385,184,255826,42,9380,244,9385,97,B
2016-03-25 9:46:35.5,9385,2,255828,0,9380,245,9385,96,B
2016-03-25 9:46:36,9385,106,255934,-58,9380,244,9385,43,B
2016-03-25 9:46:36.5,9385,42,255976,0,9380,244,9385,84,B
2016-03-25 9:46:37,9385,2,255978,-2,9380,244,9385,160,B
2016-03-25 9:46:38,9385,2,255980,0,9380,243,9385,161,B
2016-03-25 9:46:38.5,9380,10,255990,0,9380,238,9385,161,S
2016-03-25 9:46:40,9385,12,256002,0,9380,246,9385,156,B
2016-03-25 9:46:40.5,9380,72,256074,34,9380,118,9385,321,S
2016-03-25 9:46:41,9380,306,256380,188,9375,404,9380,53,S
2016-03-25 9:46:41.5,9380,120,256500,8,9375,380,9380,31,S
2016-03-25 9:46:42,9380,24,256524,-4,9375,382,9380,6,S
2016-03-25 9:46:43,9380,8,256532,-8,9375,382,9380,2,S
2016-03-25 9:46:44,9380,10,256542,8,9380,29,9385,330,S
2016-03-25 9:46:45,9380,8,256550,8,9380,5,9385,305,S
2016-03-25 9:46:45.5,9385,68,256618,52,9375,407,9380,2,B
2016-03-25 9:46:46,9385,26,256644,10,9380,36,9385,275,B
2016-03-25 9:46:47,9380,22,256666,0,9380,17,9385,275,S
2016-03-25 9:46:49,9380,10,256676,10,9380,52,9385,271,S
2016-03-25 9:46:50,9380,8,256684,4,9380,60,9385,272,S
2016-03-25 9:46:51,9380,40,256724,18,9380,41,9385,272,S
2016-03-25 9:46:51.5,9380,16,256740,16,9380,33,9385,273,S
2016-03-25 9:46:52,9380,64,256804,-4,9375,449,9380,2,S
2016-03-25 9:46:53,9380,4,256808,4,9375,394,9385,350,S
2016-03-25 9:46:55,9380,24,256832,20,9380,23,9385,248,S
2016-03-25 9:46:56,9380,4,256836,-4,9380,21,9385,251,S
2016-03-25 9:46:56.5,9385,42,256878,40,9380,23,9385,231,B
2016-03-25 9:46:57,9380,2,256880,0,9380,22,9385,237,S
2016-03-25 9:46:58,9380,42,256922,10,9380,1,9385,237,S
2016-03-25 9:46:58.5,9380,14,256936,2,9375,396,9380,48,S
2016-03-25 9:46:59,9380,2,256938,0,9375,396,9380,61,S
2016-03-25 9:47:01,9380,2,256940,0,9375,396,9380,62,S
2016-03-25 9:47:01.5,9380,4,256944,-2,9375,396,9380,65,S
2016-03-25 9:47:03,9380,152,257096,-68,9375,402,9380,6,S
2016-03-25 9:47:03.5,9380,18,257114,6,9380,58,9385,246,S
2016-03-25 9:47:06,9385,106,257220,60,9380,15,9385,194,B
2016-03-25 9:47:06.5,9385,2,257222,-2,9380,18,9385,194,B
2016-03-25 9:47:07,9380,2,257224,2,9380,18,9385,194,S
2016-03-25 9:47:07.5,9380,20,257244,18,9380,6,9385,188,S
2016-03-25 9:47:08,9380,8,257252,6,9380,7,9385,201,S
2016-03-25 9:47:09,9385,18,257270,-8,9380,80,9385,104,B
2016-03-25 9:47:11,9385,210,257480,-42,9385,102,9390,375,B
2016-03-25 9:47:12,9390,4,257484,0,9385,142,9390,319,B
2016-03-25 9:47:13,9385,2,257486,2,9385,142,9390,300,S
2016-03-25 9:47:14,9385,6,257492,4,9385,141,9390,289,S
2016-03-25 9:47:16,9380,656,258148,274,9375,447,9385,119,S
2016-03-25 9:47:17,9380,88,258236,4,9375,447,9380,103,S
2016-03-25 9:47:18,9380,4,258240,-4,9375,425,9380,101,S
2016-03-25 9:47:20,9380,2,258242,-2,9375,412,9380,111,S
2016-03-25 9:47:20.5,9380,2,258244,-2,9375,412,9380,112,S
2016-03-25 9:47:22,9380,4,258248,-2,9375,412,9380,111,S
2016-03-25 9:47:23,9380,102,258350,100,9375,411,9380,62,S
2016-03-25 9:47:23.5,9380,6,258356,6,9375,411,9380,65,S
2016-03-25 9:47:24,9380,116,258472,-24,9380,2,9385,162,S
2016-03-25 9:47:25,9380,4,258476,0,9380,1,9385,163,S
2016-03-25 9:47:25.5,9385,8,258484,-8,9380,11,9385,159,B
2016-03-25 9:47:28,9380,20,258504,6,9380,13,9385,156,S
2016-03-25 9:47:28.5,9380,96,258600,2,9380,12,9385,116,S
2016-03-25 9:47:29,9385,38,258638,0,9380,64,9385,110,B
2016-03-25 9:47:30,9385,20,258658,-20,9380,80,9385,100,B
2016-03-25 9:47:32,9385,12,258670,-2,9380,80,9385,95,B
2016-03-25 9:47:33,9385,2,258672,-2,9380,81,9385,98,B
2016-03-25 9:47:34,9380,10,258682,10,9380,77,9385,98,S
2016-03-25 9:47:35,9380,10,258692,0,9380,72,9385,98,S
2016-03-25 9:47:36,9380,68,258760,56,9375,486,9380,54,S
2016-03-25 9:47:36.5,9380,58,258818,58,9375,420,9380,36,S
2016-03-25 9:47:37,9380,40,258858,40,9375,417,9380,22,S
2016-03-25 9:47:38,9380,2,258860,0,9375,419,9380,24,S
2016-03-25 9:47:40,9380,2,258862,2,9375,419,9380,80,S
2016-03-25 9:47:42,9380,4,258866,2,9375,419,9380,98,S
2016-03-25 9:47:43,9380,2,258868,-2,9375,422,9380,124,S
2016-03-25 9:47:44,9380,4,258872,0,9375,422,9380,123,S
2016-03-25 9:47:46,9380,4,258876,4,9375,422,9380,121,S
2016-03-25 9:47:49,9380,2,258878,-2,9375,422,9380,133,S
2016-03-25 9:47:49.5,9380,2,258880,0,9375,422,9380,136,S
2016-03-25 9:47:51,9380,2,258882,0,9375,422,9380,140,S
2016-03-25 9:47:52,9380,2,258884,0,9375,422,9380,146,S
2016-03-25 9:47:54,9380,2,258886,-2,9375,426,9380,149,S
2016-03-25 9:47:55,9380,6,258892,0,9375,423,9380,146,S
2016-03-25 9:47:56,9380,12,258904,0,9375,424,9380,141,S
2016-03-25 9:47:58,9375,2,258906,0,9375,438,9380,142,S
2016-03-25 9:47:59,9380,8,258914,2,9375,437,9380,138,B
2016-03-25 9:48:00,9380,6,258920,6,9375,437,9380,136,B
2016-03-25 9:48:01,9375,2,258922,-2,9375,332,9380,136,S
2016-03-25 9:48:01.5,9380,4,258926,0,9375,332,9380,133,B
2016-03-25 9:48:03,9375,2,258928,0,9375,337,9380,157,S
2016-03-25 9:48:03.5,9375,20,258948,-20,9375,327,9380,158,S
2016-03-25 9:48:04,9375,2,258950,0,9375,326,9380,159,S
2016-03-25 9:48:05,9380,4,258954,-2,9375,325,9380,158,B
2016-03-25 9:48:07,9375,4,258958,-2,9375,324,9380,146,S
2016-03-25 9:48:07.5,9375,22,258980,18,9375,322,9380,136,S
2016-03-25 9:48:08,9375,6,258986,4,9375,329,9380,134,S
2016-03-25 9:48:09,9375,4,258990,0,9375,340,9380,130,S
2016-03-25 9:48:09.5,9375,4,258994,-4,9375,333,9380,130,S
2016-03-25 9:48:10,9380,2,258996,-2,9375,333,9380,129,B
2016-03-25 9:48:10.5,9380,4,259000,-4,9375,334,9380,117,B
2016-03-25 9:48:11,9375,20,259020,4,9375,323,9380,118,S
2016-03-25 9:48:12,9375,2,259022,2,9375,302,9380,129,S
2016-03-25 9:48:13,9375,80,259102,74,9375,261,9380,129,S
2016-03-25 9:48:14,9375,2,259104,2,9375,260,9380,129,S
2016-03-25 9:48:15,9375,380,259484,332,9375,69,9380,129,S
2016-03-25 9:48:15.5,9375,20,259504,-4,9375,59,9380,129,S
2016-03-25 9:48:16,9375,12,259516,-10,9375,53,9380,129,S
2016-03-25 9:48:16.5,9375,40,259556,-28,9375,63,9380,129,S
2016-03-25 9:48:17,9375,194,259750,-140,9370,312,9380,130,S
2016-03-25 9:48:17.5,9375,4,259754,2,9375,6,9380,129,S
2016-03-25 9:48:18,9375,12,259766,12,9375,10,9380,137,S
2016-03-25 9:48:18.5,9380,2,259768,0,9375,10,9380,146,B
2016-03-25 9:48:20,9375,122,259890,-58,9370,340,9375,2,S
2016-03-25 9:48:20.5,9375,32,259922,-16,9375,63,9380,94,S
2016-03-25 9:48:21,9375,2,259924,-2,9375,72,9380,94,S
2016-03-25 9:48:23,9375,20,259944,-12,9375,45,9380,94,S
2016-03-25 9:48:24,9375,2,259946,0,9375,42,9380,106,S
2016-03-25 9:48:25,9375,84,260030,34,9370,364,9375,51,S
2016-03-25 9:48:26,9375,2,260032,0,9370,339,9375,88,S
2016-03-25 9:48:27,9370,4,260036,0,9370,328,9375,97,S
2016-03-25 9:48:27.5,9370,2,260038,-2,9370,331,9375,97,S
2016-03-25 9:48:28,9370,48,260086,-16,9370,279,9375,113,S
2016-03-25 9:48:29,9370,496,260582,-24,9365,361,9370,50,S
2016-03-25 9:48:29.5,9370,30,260612,-2,9365,170,9370,564,S
2016-03-25 9:48:30,9365,6,260618,4,9365,154,9370,672,S
2016-03-25 9:48:30.5,9365,68,260686,22,9365,171,9370,671,S
2016-03-25 9:48:31,9365,102,260788,-52,9365,120,9370,621,S
2016-03-25 9:48:31.5,9370,4,260792,0,9365,220,9370,622,B
2016-03-25 9:48:32,9370,58,260850,28,9365,192,9370,607,B
2016-03-25 9:48:32.5,9370,28,260878,28,9365,178,9370,594,B
2016-03-25 9:48:33,9365,26,260904,-4,9365,164,9370,594,S
2016-03-25 9:48:33.5,9365,2,260906,0,9365,165,9370,594,S
2016-03-25 9:48:34,9365,332,261238,-60,9360,454,9365,269,S
2016-03-25 9:48:34.5,9360,108,261346,24,9360,401,9365,327,S
2016-03-25 9:48:35,9360,20,261366,-6,9360,317,9365,354,S
2016-03-25 9:48:35.5,9360,828,262194,-512,9360,269,9370,175,S
2016-03-25 9:48:36,9360,64,262258,-2,9360,248,9365,70,S
2016-03-25 9:48:36.5,9365,118,262376,38,9365,4,9370,160,B
2016-03-25 9:48:37,9365,152,262528,-128,9365,62,9370,171,B
2016-03-25 9:48:37.5,9365,14,262542,-6,9365,70,9370,99,B
2016-03-25 9:48:38,9365,2,262544,0,9365,71,9370,101,B
2016-03-25 9:48:38.5,9365,60,262604,0,9365,43,9370,102,B
2016-03-25 9:48:39,9370,2,262606,0,9365,45,9370,101,B
2016-03-25 9:48:40,9365,2,262608,-2,9365,78,9370,102,S
2016-03-25 9:48:40.5,9365,4,262612,0,9365,178,9370,106,S
2016-03-25 9:48:41,9365,20,262632,0,9365,168,9370,118,S
2016-03-25 9:48:41.5,9365,8,262640,0,9365,163,9370,108,S
2016-03-25 9:48:42,9365,4,262644,-2,9365,161,9370,107,S
2016-03-25 9:48:42.5,9365,160,262804,-108,9365,81,9370,107,S
2016-03-25 9:48:43,9365,10,262814,0,9365,77,9370,110,S
2016-03-25 9:48:44,9365,4,262818,0,9365,76,9370,116,S
2016-03-25 9:48:48,9365,52,262870,10,9365,67,9370,120,S
2016-03-25 9:48:48.5,9365,2,262872,2,9365,80,9370,120,S
2016-03-25 9:48:49,9365,52,262924,0,9365,54,9370,120,S
2016-03-25 9:48:50,9365,134,263058,76,9365,59,9370,191,S
2016-03-25 9:48:50.5,9365,6,263064,-4,9365,48,9370,113,S
2016-03-25 9:48:51,9365,10,263074,-10,9365,25,9370,117,S
2016-03-25 9:48:51.5,9365,10,263084,10,9365,51,9370,115,S
2016-03-25 9:48:52,9370,6,263090,4,9365,45,9370,114,B
2016-03-25 9:48:53,9365,4,263094,0,9365,26,9370,116,S
2016-03-25 9:48:55,9365,2,263096,2,9365,27,9370,111,S
2016-03-25 9:48:55.5,9365,14,263110,-2,9365,21,9370,111,S
2016-03-25 9:48:56,9365,4,263114,0,9365,25,9370,111,S
2016-03-25 9:48:57,9365,4,263118,2,9365,19,9370,116,S
2016-03-25 9:48:58,9370,4,263122,2,9365,19,9370,116,B
2016-03-25 9:48:59,9365,42,263164,-18,9360,311,9365,10,S
2016-03-25 9:49:00,9365,52,263216,-6,9365,17,9370,126,S
2016-03-25 9:49:00.5,9365,6,263222,0,9365,15,9370,126,S
2016-03-25 9:49:01,9370,88,263310,50,9365,19,9370,88,B
2016-03-25 9:49:02,9365,84,263394,8,9365,26,9370,69,S
2016-03-25 9:49:02.5,9365,4,263398,2,9365,26,9370,96,S
2016-03-25 9:49:03,9370,76,263474,-46,9360,317,9370,262,B
2016-03-25 9:49:03.5,9365,22,263496,-8,9360,319,9365,23,S
2016-03-25 9:49:04,9365,2,263498,2,9360,295,9365,43,S
2016-03-25 9:49:05,9365,4,263502,-2,9360,327,9365,48,S
2016-03-25 9:49:06,9365,4,263506,-4,9360,327,9365,47,S
2016-03-25 9:49:06.5,9365,6,263512,0,9360,337,9365,44,S
2016-03-25 9:49:07,9365,2,263514,0,9360,337,9365,45,S
2016-03-25 9:49:08,9365,24,263538,-16,9360,338,9365,44,S
2016-03-25 9:49:09,9365,44,263582,6,9360,313,9365,42,S
2016-03-25 9:49:09.5,9360,38,263620,28,9360,368,9365,28,S
2016-03-25 9:49:10,9365,26,263646,24,9360,370,9365,42,B
2016-03-25 9:49:10.5,9365,18,263664,0,9360,370,9365,34,B
2016-03-25 9:49:11,9360,366,264030,154,9360,194,9365,67,S
2016-03-25 9:49:12,9360,94,264124,18,9360,149,9365,69,S
2016-03-25 9:49:13,9365,2,264126,0,9360,144,9365,69,B
2016-03-25 9:49:14,9360,4,264130,0,9360,154,9365,100,S
2016-03-25 9:49:15,9365,10,264140,4,9360,152,9365,161,B
2016-03-25 9:49:15.3333,9360,6,264146,-4,9360,154,9365,162,S
2016-03-25 9:49:15.6667,9360,22,264168,0,9360,133,9365,166,S
2016-03-25 9:49:16,9360,364,264532,72,9360,118,9365,194,S
2016-03-25 9:49:17,9360,238,264770,106,9355,587,9360,42,S
2016-03-25 9:49:17.5,9355,224,264994,-38,9355,479,9360,79,S
2016-03-25 9:49:18,9355,92,265086,42,9355,471,9360,56,S
2016-03-25 9:49:18.5,9355,60,265146,28,9355,466,9360,36,S
2016-03-25 9:49:19,9355,2,265148,2,9355,467,9360,48,S
2016-03-25 9:49:19.5,9355,16,265164,0,9355,461,9360,48,S
2016-03-25 9:49:20,9360,20,265184,-20,9355,464,9360,39,B
2016-03-25 9:49:20.5,9355,84,265268,-76,9355,463,9360,2,S
2016-03-25 9:49:21,9360,36,265304,0,9360,129,9365,234,B
2016-03-25 9:49:21.5,9360,262,265566,-44,9360,10,9365,225,B
2016-03-25 9:49:22,9355,58,265624,4,9355,463,9360,31,S
2016-03-25 9:49:23,9360,64,265688,0,9360,18,9365,234,B
2016-03-25 9:49:23.5,9360,42,265730,6,9360,5,9365,216,B
2016-03-25 9:49:24,9365,20,265750,2,9360,3,9365,215,B
2016-03-25 9:49:24.5,9360,40,265790,-16,9360,96,9365,175,S
2016-03-25 9:49:25,9360,50,265840,-38,9360,83,9365,168,S
2016-03-25 9:49:25.5,9360,50,265890,-8,9360,187,9365,167,S
2016-03-25 9:49:26,9360,2,265892,0,9360,169,9365,169,S
2016-03-25 9:49:26.5,9360,2,265894,0,9360,169,9365,173,S
2016-03-25 9:49:27,9360,140,266034,36,9360,116,9365,169,S
2016-03-25 9:49:27.5,9365,2,266036,2,9360,120,9365,173,B
2016-03-25 9:49:28,9360,2,266038,0,9360,141,9365,174,S
2016-03-25 9:49:32,9360,2,266040,0,9360,236,9365,212,S
2016-03-25 9:49:32.5,9360,42,266082,0,9360,243,9365,192,S
2016-03-25 9:49:33,9365,24,266106,20,9360,241,9365,209,B
2016-03-25 9:49:33.5,9360,18,266124,16,9360,254,9365,209,S
2016-03-25 9:49:34,9360,6,266130,2,9360,196,9365,208,S
2016-03-25 9:49:34.5,9365,2,266132,2,9360,196,9365,217,B
2016-03-25 9:49:35,9360,16,266148,0,9360,188,9365,241,S
2016-03-25 9:49:36,9365,4,266152,4,9360,200,9365,240,B
2016-03-25 9:49:39,9360,14,266166,4,9360,211,9365,238,S
2016-03-25 9:49:39.5,9360,6,266172,-2,9360,210,9365,236,S
2016-03-25 9:49:40,9360,10,266182,-4,9360,206,9365,241,S
2016-03-25 9:49:41,9365,10,266192,-4,9360,205,9365,235,B
2016-03-25 9:49:41.5,9365,34,266226,30,9360,205,9365,218,B
2016-03-25 9:49:42,9360,348,266574,126,9360,3,9365,210,S
2016-03-25 9:49:43,9360,2,266576,0,9360,6,9365,195,S
2016-03-25 9:49:44,9360,2,266578,0,9360,46,9365,194,S
2016-03-25 9:49:44.5,9360,6,266584,2,9360,47,9365,191,S
2016-03-25 9:49:45,9360,8,266592,-4,9360,49,9365,179,S
2016-03-25 9:49:46,9360,4,266596,4,9360,68,9365,171,S
2016-03-25 9:49:46.5,9360,2,266598,2,9360,67,9365,169,S
2016-03-25 9:49:47,9365,4,266602,0,9360,69,9365,163,B
2016-03-25 9:49:48,9365,4,266606,0,9360,93,9365,158,B
2016-03-25 9:49:48.5,9360,4,266610,4,9360,91,9365,173,S
2016-03-25 9:49:49,9360,2,266612,2,9360,90,9365,164,S
2016-03-25 9:49:50,9360,168,266780,96,9355,497,9360,49,S
2016-03-25 9:49:51,9360,6,266786,2,9355,497,9360,62,S
2016-03-25 9:49:51.5,9360,2,266788,-2,9355,496,9360,63,S
2016-03-25 9:49:52,9360,6,266794,2,9355,496,9360,79,S
2016-03-25 9:49:53,9360,6,266800,0,9355,497,9360,110,S
2016-03-25 9:49:53.5,9360,4,266804,0,9355,497,9360,113,S
2016-03-25 9:49:54,9355,28,266832,12,9355,483,9360,120,S
2016-03-25 9:49:55,9360,22,266854,22,9355,473,9360,124,B
2016-03-25 9:49:55.5,9355,10,266864,10,9355,468,9360,124,S
2016-03-25 9:49:56,9360,2,266866,0,9355,469,9360,216,B
2016-03-25 9:49:57,9355,14,266880,-2,9355,462,9360,221,S
2016-03-25 9:49:58,9360,4,266884,2,9355,459,9360,221,B
2016-03-25 9:49:58.5,9360,8,266892,8,9355,459,9360,170,B
2016-03-25 9:49:59,9355,44,266936,-10,9355,459,9360,88,S
2016-03-25 9:49:59.5,9355,10,266946,-2,9355,455,9360,94,S
2016-03-25 9:50:00,9355,20,266966,-20,9355,441,9360,99,S
2016-03-25 9:50:01,9360,46,267012,44,9355,441,9360,85,B
2016-03-25 9:50:01.5,9355,100,267112,-76,9355,393,9360,85,S
2016-03-25 9:50:02,9355,4,267116,2,9355,398,9360,130,S
2016-03-25 9:50:03,9355,6,267122,-2,9355,396,9360,144,S
2016-03-25 9:50:03.3333,9355,2,267124,2,9355,445,9360,165,S
2016-03-25 9:50:03.6667,9355,20,267144,2,9355,437,9360,169,S
2016-03-25 9:50:05,9355,8,267152,0,9355,435,9360,218,S
2016-03-25 9:50:05.5,9360,20,267172,2,9355,399,9360,229,B
2016-03-25 9:50:06,9360,2,267174,0,9355,350,9360,228,B
2016-03-25 9:50:07,9360,8,267182,-2,9355,349,9360,226,B
2016-03-25 9:50:07.5,9355,82,267264,-40,9355,309,9360,276,S
2016-03-25 9:50:08,9355,2,267266,2,9355,308,9360,286,S
2016-03-25 9:50:08.5,9360,2,267268,0,9355,330,9360,286,B
2016-03-25 9:50:09,9355,6,267274,6,9355,327,9360,288,S
2016-03-25 9:50:10,9355,4,267278,4,9355,397,9360,298,S
2016-03-25 9:50:10.5,9360,24,267302,4,9355,391,9360,280,B
2016-03-25 9:50:11,9360,108,267410,0,9355,394,9360,202,B
2016-03-25 9:50:11.5,9360,428,267838,-148,9360,181,9365,250,B
2016-03-25 9:50:12,9360,4,267842,0,9360,189,9365,150,B
2016-03-25 9:50:12.3333,9360,156,267998,-152,9360,126,9365,176,B
2016-03-25 9:50:12.6667,9365,56,268054,-2,9360,160,9365,155,B
2016-03-25 9:50:13,9360,2,268056,0,9360,162,9365,154,S
2016-03-25 9:50:14,9360,2,268058,-2,9360,164,9365,154,S
2016-03-25 9:50:14.5,9360,202,268260,160,9360,70,9365,133,S
2016-03-25 9:50:15,9365,4,268264,0,9360,71,9365,132,B
2016-03-25 9:50:16,9360,48,268312,4,9360,307,9365,130,S
2016-03-25 9:50:16.5,9365,2,268314,0,9360,307,9365,157,B
2016-03-25 9:50:17,9360,8,268322,2,9360,308,9365,194,S
2016-03-25 9:50:17.5,9360,10,268332,0,9360,308,9365,191,S
2016-03-25 9:50:18,9360,10,268342,10,9360,305,9365,192,S
2016-03-25 9:50:19,9365,64,268406,-8,9360,311,9365,163,B
2016-03-25 9:50:19.5,9365,10,268416,0,9360,321,9365,159,B
2016-03-25 9:50:20,9365,12,268428,-2,9360,324,9365,152,B
2016-03-25 9:50:21,9365,6,268434,-2,9360,323,9365,150,B
2016-03-25 9:50:21.5,9365,12,268446,4,9360,321,9365,159,B
2016-03-25 9:50:22,9365,12,268458,-8,9360,322,9365,174,B
2016-03-25 9:50:22.5,9365,4,268462,-4,9360,324,9365,167,B
2016-03-25 9:50:23,9365,4,268466,-4,9360,325,9365,166,B
2016-03-25 9:50:23.5,9365,4,268470,0,9360,325,9365,164,B
2016-03-25 9:50:24,9365,4,268474,-2,9360,330,9365,163,B
2016-03-25 9:50:24.5,9365,326,268800,68,9365,140,9370,484,B
2016-03-25 9:50:25,9370,376,269176,128,9365,221,9370,450,B
2016-03-25 9:50:25.5,9370,24,269200,-2,9365,521,9370,424,B
2016-03-25 9:50:27,9370,6,269206,2,9365,555,9370,400,B
2016-03-25 9:50:27.5,9365,2,269208,-2,9365,554,9370,407,S
2016-03-25 9:50:28,9370,2,269210,2,9365,554,9370,407,B
2016-03-25 9:50:29,9365,2,269212,-2,9365,573,9370,417,S
2016-03-25 9:50:31,9370,2,269214,2,9365,573,9370,417,B
2016-03-25 9:50:31.5,9365,10,269224,0,9365,668,9370,427,S
2016-03-25 9:50:32,9370,2,269226,2,9365,670,9370,426,B
2016-03-25 9:50:33,9365,100,269326,-100,9365,620,9370,411,S
2016-03-25 9:50:34,9370,2,269328,0,9365,621,9370,370,B
2016-03-25 9:50:34.5,9370,4,269332,2,9365,621,9370,368,B
2016-03-25 9:50:35,9370,2,269334,0,9365,621,9370,365,B
2016-03-25 9:50:35.5,9370,2,269336,2,9365,621,9370,357,B
2016-03-25 9:50:36,9370,4,269340,2,9365,621,9370,354,B
2016-03-25 9:50:36.5,9370,6,269346,0,9365,621,9370,351,B
2016-03-25 9:50:37,9370,6,269352,0,9365,621,9370,338,B
2016-03-25 9:50:37.5,9370,6,269358,-2,9365,621,9370,357,B
2016-03-25 9:50:38,9370,2,269360,0,9365,621,9370,356,B
2016-03-25 9:50:38.5,9370,12,269372,-12,9365,626,9370,349,B
2016-03-25 9:50:39,9370,4,269376,-4,9365,629,9370,320,B
2016-03-25 9:50:40,9370,4,269380,-4,9365,629,9370,312,B
2016-03-25 9:50:40.5,9365,30,269410,-10,9365,624,9370,400,S
2016-03-25 9:50:41,9370,2,269412,0,9365,624,9370,398,B
2016-03-25 9:50:41.5,9370,2,269414,-2,9365,625,9370,398,B
2016-03-25 9:50:42,9370,2,269416,0,9365,625,9370,396,B
2016-03-25 9:50:43,9365,24,269440,-2,9365,950,9370,389,S
2016-03-25 9:50:44,9365,4,269444,0,9365,949,9370,391,S
2016-03-25 9:50:44.5,9370,6,269450,2,9365,948,9370,390,B
2016-03-25 9:50:46,9365,22,269472,2,9365,968,9370,389,S
2016-03-25 9:50:47,9370,6,269478,6,9365,968,9370,386,B
2016-03-25 9:50:48,9370,802,270280,24,9370,148,9375,423,B
2016-03-25 9:50:48.5,9370,14,270294,14,9370,163,9375,395,B
2016-03-25 9:50:49,9370,470,270764,-92,9365,113,9370,117,B
2016-03-25 9:50:50,9370,8,270772,-8,9365,125,9370,116,B
2016-03-25 9:50:50.5,9365,4,270776,0,9365,123,9370,127,S
2016-03-25 9:50:52,9370,6,270782,-2,9365,122,9370,126,B
2016-03-25 9:50:52.5,9370,4,270786,-2,9365,122,9370,152,B
2016-03-25 9:50:53,9370,8,270794,-2,9365,122,9370,149,B
2016-03-25 9:50:53.5,9365,424,271218,-132,9365,12,9370,49,S
2016-03-25 9:50:55,9370,4,271222,-4,9365,157,9370,89,B
2016-03-25 9:50:55.5,9365,20,271242,6,9365,147,9370,94,S
2016-03-25 9:50:56,9375,200,271442,52,9370,2,9375,424,B
2016-03-25 9:50:57,9370,444,271886,250,9365,88,9370,124,S
2016-03-25 9:50:57.5,9370,200,272086,46,9365,100,9370,35,S
2016-03-25 9:50:59,9370,2,272088,0,9365,145,9370,87,S
2016-03-25 9:51:01,9370,178,272266,-118,9370,60,9375,438,S
2016-03-25 9:51:01.5,9370,2,272268,0,9370,62,9375,439,S
2016-03-25 9:51:02,9375,4,272272,0,9370,61,9375,488,B
2016-03-25 9:51:02.3333,9370,124,272396,-118,9365,187,9370,44,S
2016-03-25 9:51:02.6667,9370,2,272398,0,9365,187,9370,48,S
2016-03-25 9:51:03,9370,12,272410,-2,9365,188,9370,43,S
2016-03-25 9:51:05,9370,4,272414,0,9365,208,9370,48,S
2016-03-25 9:51:06,9365,244,272658,138,9365,79,9370,347,S
2016-03-25 9:51:07,9370,2,272660,-2,9365,99,9370,348,B
2016-03-25 9:51:07.5,9365,60,272720,-8,9365,70,9370,349,S
2016-03-25 9:51:08,9365,6,272726,6,9365,67,9370,349,S
2016-03-25 9:51:09,9370,2,272728,0,9365,69,9370,338,B
2016-03-25 9:51:09.5,9370,20,272748,-20,9365,69,9370,328,B
2016-03-25 9:51:10,9370,2,272750,-2,9365,73,9370,326,B
2016-03-25 9:51:10.5,9365,2,272752,2,9365,97,9370,307,S
2016-03-25 9:51:11,9365,4,272756,2,9365,96,9370,296,S
2016-03-25 9:51:11.5,9365,308,273064,-146,9360,517,9365,48,S
2016-03-25 9:51:12,9365,100,273164,-66,9365,91,9370,310,S
2016-03-25 9:51:12.5,9370,4,273168,-4,9365,97,9370,302,B
2016-03-25 9:51:14,9365,2,273170,-2,9365,98,9370,293,S
2016-03-25 9:51:14.5,9365,38,273208,0,9365,82,9370,313,S
2016-03-25 9:51:16,9365,166,273374,2,9360,555,9365,3,S
2016-03-25 9:51:16.5,9365,92,273466,-72,9365,148,9370,249,S
2016-03-25 9:51:17,9365,8,273474,0,9365,144,9370,246,S
2016-03-25 9:51:17.5,9365,26,273500,-24,9365,134,9370,247,S
2016-03-25 9:51:18,9365,6,273506,-4,9365,133,9370,251,S
2016-03-25 9:51:18.5,9365,266,273772,-78,9360,530,9365,60,S
2016-03-25 9:51:20,9365,6,273778,-2,9360,521,9365,16,S
2016-03-25 9:51:21,9365,44,273822,14,9365,8,9370,207,S
2016-03-25 9:51:21.5,9365,58,273880,-28,9365,32,9370,177,S
2016-03-25 9:51:22,9365,2,273882,0,9365,53,9370,201,S
2016-03-25 9:51:24,9370,488,274370,218,9365,126,9370,50,B
2016-03-25 9:51:24.5,9365,40,274410,0,9365,117,9370,51,S
2016-03-25 9:51:25,9370,106,274516,82,9370,55,9375,548,B
2016-03-25 9:51:26,9370,384,274900,-100,9365,76,9370,61,B
2016-03-25 9:51:28,9365,2,274902,-2,9365,142,9370,73,S
2016-03-25 9:51:29,9365,2,274904,0,9365,141,9370,102,S
2016-03-25 9:51:29.5,9365,2,274906,0,9365,140,9370,106,S
2016-03-25 9:51:31,9365,2,274908,-2,9365,148,9370,123,S
2016-03-25 9:51:31.5,9365,20,274928,0,9365,138,9370,123,S
2016-03-25 9:51:32,9365,2,274930,0,9365,142,9370,127,S
2016-03-25 9:51:34,9365,2,274932,-2,9365,149,9370,148,S
2016-03-25 9:51:36,9370,10,274942,10,9365,150,9370,144,B
2016-03-25 9:51:37,9365,16,274958,-4,9365,141,9370,201,S
2016-03-25 9:51:39,9370,8,274966,2,9365,103,9370,266,B
2016-03-25 9:51:39.5,9370,2,274968,0,9365,104,9370,265,B
2016-03-25 9:51:40,9365,212,275180,-150,9360,624,9365,199,S
2016-03-25 9:51:41,9365,2,275182,-2,9360,626,9365,211,S
2016-03-25 9:51:42,9365,8,275190,-8,9360,519,9365,271,S
2016-03-25 9:51:44,9365,12,275202,-12,9360,519,9365,265,S
2016-03-25 9:51:44.5,9365,2,275204,-2,9360,519,9365,265,S
2016-03-25 9:51:45,9360,60,275264,-58,9360,489,9365,277,S
2016-03-25 9:51:46,9365,30,275294,-10,9360,489,9365,262,B
2016-03-25 9:51:47,9360,2,275296,0,9360,492,9365,262,S
2016-03-25 9:51:48,9360,30,275326,-16,9360,477,9365,269,S
2016-03-25 9:51:48.5,9360,4,275330,0,9360,515,9365,282,S
2016-03-25 9:51:49,9360,2,275332,0,9360,519,9365,294,S
2016-03-25 9:51:51,9360,714,276046,-484,9360,163,9365,320,S
2016-03-25 9:51:51.5,9360,586,276632,124,9355,691,9360,47,S
2016-03-25 9:51:52,9360,124,276756,-82,9360,17,9365,181,S
2016-03-25 9:51:53,9360,4,276760,-2,9360,21,9365,180,S
2016-03-25 9:51:53.5,9360,62,276822,16,9355,740,9360,135,S
2016-03-25 9:51:54,9360,24,276846,-10,9355,742,9365,157,S
2016-03-25 9:51:54.5,9360,24,276870,20,9355,742,9365,148,S
2016-03-25 9:51:55,9360,188,277058,-6,9355,768,9365,267,S
2016-03-25 9:51:55.5,9360,2,277060,0,9360,54,9365,160,S
2016-03-25 9:51:56,9360,126,277186,-28,9355,692,9360,109,S
2016-03-25 9:51:58,9355,182,277368,-148,9355,602,9360,205,S
2016-03-25 9:51:58.5,9360,42,277410,0,9355,582,9360,156,B
2016-03-25 9:51:59,9355,42,277452,-42,9355,561,9360,183,S
2016-03-25 9:51:59.5,9355,50,277502,-10,9355,533,9360,159,S
2016-03-25 9:52:00,9355,4,277506,-2,9355,531,9360,188,S
2016-03-25 9:52:02,9355,70,277576,-70,9355,498,9360,210,S
2016-03-25 9:52:02.5,9355,4,277580,-4,9355,496,9360,212,S
2016-03-25 9:52:03,9355,414,277994,178,9355,286,9360,190,S
2016-03-25 9:52:03.5,9355,30,278024,30,9355,252,9360,163,S
2016-03-25 9:52:04,9355,464,278488,84,9350,762,9355,255,S
2016-03-25 9:52:04.5,9355,4,278492,2,9350,739,9355,377,S
2016-03-25 9:52:05,9350,6,278498,0,9350,734,9355,294,S
2016-03-25 9:52:05.5,9350,30,278528,0,9350,731,9355,324,S
2016-03-25 9:52:06,9350,116,278644,-94,9350,665,9355,314,S
2016-03-25 9:52:06.5,9350,2,278646,2,9350,640,9355,306,S
2016-03-25 9:52:07,9350,64,278710,0,9350,609,9355,304,S
2016-03-25 9:52:08,9355,46,278756,44,9350,602,9355,139,B
2016-03-25 9:52:08.5,9355,6,278762,0,9350,813,9355,138,B
2016-03-25 9:52:09,9355,12,278774,0,9350,614,9355,135,B
2016-03-25 9:52:10,9355,10,278784,10,9350,614,9355,165,B
2016-03-25 9:52:10.5,9350,4,278788,4,9350,615,9355,162,S
2016-03-25 9:52:11,9355,22,278810,0,9350,615,9355,149,B
2016-03-25 9:52:11.5,9355,12,278822,0,9350,616,9355,84,B
2016-03-25 9:52:12,9355,2,278824,0,9350,619,9355,106,B
2016-03-25 9:52:13,9350,124,278948,-72,9350,555,9355,160,S
2016-03-25 9:52:14,9355,10,278958,-10,9350,559,9355,199,B
2016-03-25 9:52:14.5,9350,2,278960,2,9350,558,9355,199,S
2016-03-25 9:52:15,9350,6,278966,0,9350,545,9355,209,S
2016-03-25 9:52:16,9350,100,279066,66,9350,495,9355,257,S
2016-03-25 9:52:17,9350,2,279068,0,9350,497,9355,259,S
2016-03-25 9:52:18,9350,1010,280078,412,9345,593,9350,217,S
2016-03-25 9:52:18.5,9350,4,280082,0,9345,572,9350,226,S
2016-03-25 9:52:19,9345,6,280088,2,9345,548,9350,228,S
2016-03-25 9:52:20,9345,698,280786,-492,9340,279,9350,340,S
2016-03-25 9:52:20.5,9350,186,280972,-114,9340,259,9350,340,B
2016-03-25 9:52:21,9345,24,280996,-2,9340,258,9350,339,S
2016-03-25 9:52:22,9345,8,281004,-6,9340,259,9350,339,S
2016-03-25 9:52:22.5,9345,14,281018,-14,9345,83,9350,340,S
2016-03-25 9:52:23,9350,14,281032,2,9340,419,9350,341,B
2016-03-25 9:52:23.5,9350,4,281036,-2,9345,67,9350,340,B
2016-03-25 9:52:24,9345,40,281076,-2,9340,435,9350,336,S
2016-03-25 9:52:24.5,9350,102,281178,-2,9345,101,9350,236,B
2016-03-25 9:52:25,9350,2,281180,0,9345,158,9350,218,B
2016-03-25 9:52:25.5,9345,62,281242,-60,9345,140,9350,218,S
2016-03-25 9:52:26,9350,106,281348,-100,9345,139,9350,168,B
2016-03-25 9:52:26.5,9345,4,281352,0,9345,137,9350,168,S
2016-03-25 9:52:27,9345,60,281412,-20,9345,109,9350,169,S
2016-03-25 9:52:28,9345,16,281428,12,9345,105,9350,167,S
2016-03-25 9:52:28.5,9345,14,281442,0,9345,88,9350,167,S
2016-03-25 9:52:29,9350,772,282214,-38,9350,130,9360,362,B
2016-03-25 9:52:30,9355,44,282258,4,9355,252,9360,258,B
2016-03-25 9:52:30.5,9355,64,282322,-64,9355,232,9360,118,B
2016-03-25 9:52:31,9355,76,282398,-10,9355,197,9360,113,B
2016-03-25 9:52:31.5,9360,252,282650,216,9360,42,9365,247,B
2016-03-25 9:52:32,9365,10,282660,-4,9360,49,9365,348,B
2016-03-25 9:52:32.5,9355,142,282802,44,9355,260,9360,34,S
2016-03-25 9:52:33,9355,2,282804,-2,9355,260,9360,34,S
2016-03-25 9:52:34,9360,2,282806,0,9355,251,9360,38,B
2016-03-25 9:52:36,9360,6,282812,0,9355,253,9360,65,B
2016-03-25 9:52:37,9360,2,282814,0,9355,253,9360,122,B
2016-03-25 9:52:37.5,9360,10,282824,0,9355,253,9360,119,B
2016-03-25 9:52:38,9355,4,282828,0,9355,248,9360,123,S
2016-03-25 9:52:38.5,9360,62,282890,52,9355,248,9360,246,B
2016-03-25 9:52:39,9360,2,282892,2,9355,248,9360,255,B
2016-03-25 9:52:40,9360,6,282898,0,9355,250,9360,265,B
2016-03-25 9:52:40.5,9360,10,282908,-8,9355,250,9360,264,B
2016-03-25 9:52:41,9360,2,282910,-2,9355,258,9360,257,B
2016-03-25 9:52:42,9360,2,282912,0,9355,258,9360,258,B
2016-03-25 9:52:44,9360,2,282914,0,9355,260,9360,353,B
2016-03-25 9:52:45,9355,22,282936,0,9355,182,9360,356,S
2016-03-25 9:52:45.5,9360,4,282940,-2,9355,181,9360,354,B
2016-03-25 9:52:47,9355,24,282964,22,9355,170,9360,356,S
2016-03-25 9:52:49,9360,2,282966,0,9355,170,9360,356,B
2016-03-25 9:52:49.5,9360,42,283008,40,9355,150,9360,355,B
2016-03-25 9:52:51,9355,6,283014,-2,9355,251,9360,354,S
2016-03-25 9:52:52,9360,16,283030,-16,9355,244,9360,353,B
2016-03-25 9:52:54,9355,2,283032,0,9355,243,9360,352,S
2016-03-25 9:52:54.5,9360,2,283034,0,9355,244,9360,350,B
2016-03-25 9:52:55,9360,2,283036,0,9355,246,9360,349,B
2016-03-25 9:52:56,9355,4,283040,4,9355,245,9360,349,S
2016-03-25 9:52:56.5,9355,10,283050,-10,9355,240,9360,349,S
2016-03-25 9:52:57,9360,2,283052,0,9355,245,9360,348,B
2016-03-25 9:52:58,9355,6,283058,6,9355,243,9360,349,S
2016-03-25 9:52:58.5,9360,106,283164,-100,9355,293,9360,295,B
2016-03-25 9:52:59,9360,2,283166,0,9355,293,9360,294,B
2016-03-25 9:53:00,9360,16,283182,-16,9355,285,9360,337,B
2016-03-25 9:53:04,9360,2,283184,-2,9355,295,9360,324,B
2016-03-25 9:53:05,9360,6,283190,0,9355,299,9360,321,B
2016-03-25 9:53:05.3333,9355,24,283214,12,9355,289,9360,321,S
2016-03-25 9:53:05.6667,9360,6,283220,6,9355,289,9360,318,B
2016-03-25 9:53:06,9360,4,283224,2,9355,289,9360,316,B
2016-03-25 9:53:08,9355,20,283244,-12,9355,282,9360,307,S
2016-03-25 9:53:09,9360,740,283984,-288,9360,158,9365,330,B
2016-03-25 9:53:10,9365,2,283986,0,9360,167,9365,316,B
2016-03-25 9:53:11,9365,4,283990,-2,9360,168,9365,348,B
2016-03-25 9:53:14,9365,2,283992,0,9360,247,9365,332,B
2016-03-25 9:53:15,9365,32,284024,2,9360,250,9365,315,B
2016-03-25 9:53:15.5,9365,8,284032,2,9360,248,9365,313,B
2016-03-25 9:53:16,9360,2,284034,0,9360,247,9365,314,S
2016-03-25 9:53:17,9360,100,284134,-100,9360,197,9365,282,S
2016-03-25 9:53:17.5,9365,2,284136,-2,9360,197,9365,281,B
2016-03-25 9:53:20,9365,4,284140,0,9360,151,9365,260,B
2016-03-25 9:53:21,9365,2,284142,0,9360,173,9365,139,B
2016-03-25 9:53:23,9365,2,284144,0,9360,258,9365,144,B
2016-03-25 9:53:23.5,9360,24,284168,-22,9360,247,9365,143,S
2016-03-25 9:53:24,9365,2,284170,0,9360,247,9365,152,B
2016-03-25 9:53:25,9360,2,284172,0,9360,246,9365,152,S
2016-03-25 9:53:25.5,9365,4,284176,-2,9360,246,9365,150,B
2016-03-25 9:53:26,9365,2,284178,0,9360,241,9365,144,B
2016-03-25 9:53:27,9360,2,284180,0,9360,241,9365,176,S
2016-03-25 9:53:29,9365,430,284610,168,9365,81,9370,514,B
2016-03-25 9:53:30,9365,64,284674,0,9365,55,9370,501,B
2016-03-25 9:53:31,9365,132,284806,100,9360,273,9365,26,B
2016-03-25 9:53:31.5,9360,14,284820,0,9360,268,9365,30,S
2016-03-25 9:53:32,9365,2,284822,0,9360,237,9365,192,B
2016-03-25 9:53:33,9365,10,284832,-10,9360,237,9365,187,B
2016-03-25 9:53:34,9365,10,284842,-2,9360,238,9365,185,B
2016-03-25 9:53:34.5,9365,2,284844,0,9360,239,9365,184,B
2016-03-25 9:53:35,9365,40,284884,-40,9360,228,9365,174,B
2016-03-25 9:53:36,9365,146,285030,32,9360,172,9365,152,B
2016-03-25 9:53:36.5,9360,2,285032,2,9360,113,9365,393,S
2016-03-25 9:53:37,9360,268,285300,72,9355,402,9360,263,S
2016-03-25 9:53:38,9355,2,285302,-2,9355,362,9360,283,S
2016-03-25 9:53:39,9360,2,285304,2,9355,396,9360,284,B
2016-03-25 9:53:39.5,9360,2,285306,2,9355,396,9360,283,B
2016-03-25 9:53:41,9360,2,285308,0,9355,446,9360,282,B
2016-03-25 9:53:45,9360,2,285310,0,9355,479,9360,282,B
2016-03-25 9:53:46,9355,232,285542,148,9355,364,9360,185,S
2016-03-25 9:53:46.5,9355,20,285562,0,9355,354,9360,178,S
2016-03-25 9:53:47,9355,30,285592,30,9355,344,9360,184,S
2016-03-25 9:53:49,9360,48,285640,0,9355,479,9360,161,B
2016-03-25 9:53:50,9360,8,285648,8,9355,499,9360,157,B
2016-03-25 9:53:51,9360,10,285658,0,9355,499,9360,152,B
2016-03-25 9:53:52,9360,48,285706,48,9355,513,9360,129,B
2016-03-25 9:53:53,9360,256,285962,100,9355,513,9365,522,B
2016-03-25 9:53:53.5,9360,20,285982,6,9355,540,9360,15,B
2016-03-25 9:53:54,9360,52,286034,-36,9360,99,9365,498,B
2016-03-25 9:53:55,9365,40,286074,0,9360,272,9365,478,B
2016-03-25 9:53:57,9365,8,286082,0,9360,457,9365,323,B
2016-03-25 9:53:57.5,9365,2,286084,0,9360,457,9365,292,B
2016-03-25 9:53:58,9360,6,286090,0,9360,453,9365,292,S
2016-03-25 9:53:59,9360,2,286092,-2,9360,442,9365,292,S
2016-03-25 9:54:00,9365,2,286094,0,9360,443,9365,292,B
2016-03-25 9:54:03,9365,4,286098,-2,9360,450,9365,297,B
2016-03-25 9:54:03.5,9360,224,286322,-14,9360,340,9365,321,S
2016-03-25 9:54:07,9360,196,286518,40,9360,244,9365,343,S
2016-03-25 9:54:08,9365,2,286520,0,9360,244,9365,342,B
2016-03-25 9:54:08.5,9365,6,286526,-2,9360,243,9365,340,B
2016-03-25 9:54:09,9360,330,286856,130,9360,40,9365,340,S
2016-03-25 9:54:09.5,9360,80,286936,-56,9355,656,9360,137,S
2016-03-25 9:54:10,9360,20,286956,-20,9355,659,9360,124,S
2016-03-25 9:54:10.5,9360,2,286958,0,9355,632,9360,123,S
2016-03-25 9:54:11,9360,248,287206,-68,9360,128,9365,421,S
2016-03-25 9:54:12,9360,528,287734,-374,9355,662,9360,11,S
2016-03-25 9:54:13,9360,2,287736,0,9355,611,9360,13,S
2016-03-25 9:54:14,9360,2,287738,0,9355,524,9360,28,S
2016-03-25 9:54:16,9360,2,287740,-2,9355,522,9360,27,S
2016-03-25 9:54:17,9360,10,287750,-10,9355,622,9360,21,S
2016-03-25 9:54:17.5,9360,62,287812,-12,9355,698,9360,8,S
2016-03-25 9:54:18,9360,40,287852,-4,9355,675,9360,6,S
2016-03-25 9:54:18.5,9360,2,287854,0,9355,675,9360,5,S
2016-03-25 9:54:19,9365,2,287856,2,9360,7,9365,335,B
2016-03-25 9:54:19.5,9360,4,287860,0,9360,17,9365,317,S
2016-03-25 9:54:20,9360,2,287862,0,9360,17,9365,317,S
2016-03-25 9:54:21,9360,30,287892,0,9360,12,9365,363,S
2016-03-25 9:54:22,9365,20,287912,20,9360,25,9365,353,B
2016-03-25 9:54:22.5,9360,54,287966,-20,9355,701,9360,20,S
2016-03-25 9:54:23,9360,44,288010,-34,9360,53,9365,308,S
2016-03-25 9:54:23.5,9360,4,288014,0,9360,51,9365,308,S
2016-03-25 9:54:24,9365,2,288016,2,9360,51,9365,312,B
2016-03-25 9:54:24.5,9360,2,288018,0,9360,50,9365,312,S
2016-03-25 9:54:26,9360,2,288020,0,9360,58,9365,327,S
2016-03-25 9:54:27,9360,8,288028,0,9360,54,9365,327,S
2016-03-25 9:54:27.5,9365,20,288048,20,9360,54,9365,318,B
2016-03-25 9:54:28,9360,2,288050,0,9360,54,9365,317,S
2016-03-25 9:54:29,9365,4,288054,4,9360,59,9365,335,B
2016-03-25 9:54:30,9360,4,288058,0,9360,63,9365,340,S
2016-03-25 9:54:31,9365,4,288062,2,9360,65,9365,338,B
2016-03-25 9:54:31.5,9360,4,288066,-4,9360,64,9365,339,S
2016-03-25 9:54:32,9360,2,288068,0,9360,68,9365,344,S
2016-03-25 9:54:34,9365,2,288070,2,9360,71,9365,300,B
2016-03-25 9:54:35,9360,2,288072,-2,9360,73,9365,300,S
2016-03-25 9:54:36,9360,10,288082,0,9360,75,9365,363,S
2016-03-25 9:54:37,9360,6,288088,0,9360,73,9365,364,S
2016-03-25 9:54:38,9360,6,288094,0,9360,72,9365,362,S
2016-03-25 9:54:39,9360,82,288176,-66,9360,31,9365,364,S
2016-03-25 9:54:39.5,9365,144,288320,88,9355,340,9365,362,B
2016-03-25 9:54:41,9360,2,288322,0,9360,12,9365,336,S
2016-03-25 9:54:42,9365,2,288324,0,9360,12,9365,336,B
2016-03-25 9:54:45,9360,12,288336,4,9360,17,9365,415,S
2016-03-25 9:54:45.5,9360,58,288394,48,9355,292,9360,101,S
2016-03-25 9:54:46,9355,34,288428,34,9355,245,9360,134,S
2016-03-25 9:54:46.5,9360,270,288698,54,9355,116,9360,103,B
2016-03-25 9:54:47,9360,44,288742,-42,9355,112,9360,140,B
2016-03-25 9:54:50,9360,4,288746,0,9355,112,9360,146,B
2016-03-25 9:54:50.5,9360,8,288754,8,9355,110,9360,143,B
2016-03-25 9:54:52,9355,44,288798,-4,9355,99,9360,130,S
2016-03-25 9:54:53,9355,44,288842,-16,9355,76,9360,130,S
2016-03-25 9:54:53.5,9360,2,288844,2,9355,86,9360,129,B
2016-03-25 9:54:54,9360,2,288846,0,9355,86,9360,128,B
2016-03-25 9:54:55,9355,4,288850,0,9355,87,9360,132,S
2016-03-25 9:55:00,9360,2,288852,2,9355,101,9360,151,B
2016-03-25 9:55:00.5,9355,4,288856,0,9355,100,9360,150,S
2016-03-25 9:55:01,9360,2,288858,2,9355,110,9360,149,B
2016-03-25 9:55:04,9355,6,288864,0,9355,123,9360,151,S
2016-03-25 9:55:04.5,9355,12,288876,4,9355,119,9360,150,S
2016-03-25 9:55:05,9355,38,288914,-30,9355,99,9360,150,S
2016-03-25 9:55:05.5,9355,198,289112,66,9350,376,9355,93,S
2016-03-25 9:55:06,9355,24,289136,2,9350,409,9355,84,S
2016-03-25 9:55:07,9355,2,289138,2,9350,409,9355,93,S
2016-03-25 9:55:08,9355,2,289140,2,9350,409,9355,94,S
2016-03-25 9:55:09,9355,4,289144,2,9350,407,9355,92,S
2016-03-25 9:55:11,9350,8,289152,0,9350,393,9355,100,S
2016-03-25 9:55:12,9355,2,289154,0,9350,399,9355,102,B
2016-03-25 9:55:14,9350,4,289158,0,9350,397,9355,103,S
2016-03-25 9:55:16,9350,2,289160,2,9350,406,9355,111,S
2016-03-25 9:55:18,9355,50,289210,0,9350,401,9355,101,B
2016-03-25 9:55:18.5,9355,2,289212,0,9350,399,9355,99,B
2016-03-25 9:55:19,9355,4,289216,4,9350,401,9355,97,B
2016-03-25 9:55:19.5,9355,20,289236,0,9350,411,9355,87,B
2016-03-25 9:55:20,9350,2,289238,2,9350,401,9355,86,S
2016-03-25 9:55:21,9355,20,289258,0,9350,403,9355,76,B
2016-03-25 9:55:22,9355,12,289270,0,9350,464,9355,70,B
2016-03-25 9:55:22.5,9355,24,289294,20,9350,464,9355,58,B
2016-03-25 9:55:23,9355,4,289298,0,9350,467,9355,56,B
2016-03-25 9:55:23.5,9355,16,289314,12,9350,467,9355,48,B
2016-03-25 9:55:25,9350,2,289316,2,9350,467,9355,47,S
2016-03-25 9:55:26,9355,48,289364,46,9350,430,9355,43,B
2016-03-25 9:55:26.3333,9355,14,289378,-8,9350,430,9355,37,B
2016-03-25 9:55:26.6667,9355,2,289380,0,9350,430,9355,38,B
2016-03-25 9:55:27,9355,2,289382,2,9350,430,9355,49,B
2016-03-25 9:55:28,9350,10,289392,-2,9350,426,9355,48,S
2016-03-25 9:55:29,9355,34,289426,-22,9350,415,9355,47,B
2016-03-25 9:55:31,9355,138,289564,124,9355,39,9360,229,B
2016-03-25 9:55:32,9355,34,289598,-12,9350,467,9355,27,B
2016-03-25 9:55:32.3333,9355,18,289616,-14,9355,5,9360,229,B
2016-03-25 9:55:32.6667,9355,8,289624,-8,9355,4,9360,229,B
2016-03-25 9:55:37,9355,82,289706,-34,9355,24,9360,325,B
2016-03-25 9:55:38,9355,56,289762,-24,9350,520,9355,10,B
2016-03-25 9:55:38.5,9355,768,290530,-340,9350,362,9355,22,B
2016-03-25 9:55:39,9355,2,290532,0,9350,363,9355,28,B
2016-03-25 9:55:39.5,9355,2,290534,0,9350,363,9355,39,B
2016-03-25 9:55:40,9355,20,290554,20,9350,382,9355,29,B
2016-03-25 9:55:41,9350,6,290560,0,9350,378,9355,31,S
2016-03-25 9:55:42,9355,4,290564,0,9350,381,9355,29,B
2016-03-25 9:55:44,9355,98,290662,50,9355,74,9360,289,B
2016-03-25 9:55:44.5,9355,72,290734,22,9355,38,9360,289,B
2016-03-25 9:55:45,9355,86,290820,72,9350,451,9355,74,B
2016-03-25 9:55:46,9355,2,290822,2,9350,450,9355,74,B
2016-03-25 9:55:46.5,9350,4,290826,4,9350,449,9355,73,S
2016-03-25 9:55:47,9355,4,290830,4,9350,449,9355,71,B
2016-03-25 9:55:47.5,9355,8,290838,0,9350,449,9355,63,B
2016-03-25 9:55:48,9350,2,290840,0,9350,322,9355,90,S
2016-03-25 9:55:49,9355,2,290842,2,9350,319,9355,95,B
2016-03-25 9:55:50,9355,2,290844,2,9350,319,9355,94,B
2016-03-25 9:55:50.5,9350,2,290846,2,9350,318,9355,95,S
2016-03-25 9:55:51,9355,2,290848,2,9350,321,9355,117,B
2016-03-25 9:55:52,9355,10,290858,2,9350,321,9355,125,B
2016-03-25 9:55:53,9355,4,290862,4,9350,321,9355,133,B
2016-03-25 9:55:54,9350,42,290904,40,9350,283,9355,187,S
2016-03-25 9:55:57,9350,20,290924,-6,9350,311,9355,211,S
2016-03-25 9:55:58,9350,2,290926,2,9350,321,9355,211,S
2016-03-25 9:55:58.5,9350,6,290932,0,9350,318,9355,211,S
2016-03-25 9:55:59,9350,4,290936,4,9350,325,9355,210,S
2016-03-25 9:56:02,9350,18,290954,18,9350,341,9355,210,S
2016-03-25 9:56:03,9350,44,290998,40,9350,318,9355,210,S
2016-03-25 9:56:04,9350,10,291008,10,9350,314,9355,210,S
2016-03-25 9:56:07,9355,2,291010,0,9350,310,9355,221,B
2016-03-25 9:56:10,9355,8,291018,8,9350,366,9355,218,B
2016-03-25 9:56:11,9350,4,291022,4,9350,364,9355,218,S
2016-03-25 9:56:12,9355,2,291024,0,9350,379,9355,217,B
2016-03-25 9:56:14,9355,102,291126,98,9350,428,9355,117,B
2016-03-25 9:56:15,9355,228,291354,-26,9355,37,9360,442,B
2016-03-25 9:56:15.5,9360,2,291356,-2,9355,16,9360,472,B
2016-03-25 9:56:17,9355,4,291360,0,9355,15,9360,482,S
2016-03-25 9:56:17.5,9355,2,291362,-2,9355,14,9360,482,S
2016-03-25 9:56:19,9355,2,291364,0,9355,9,9360,482,S
2016-03-25 9:56:19.5,9355,44,291408,4,9350,484,9360,479,S
2016-03-25 9:56:20,9355,22,291430,-2,9350,461,9355,2,S
2016-03-25 9:56:21,9355,26,291456,-4,9350,486,9355,42,S
2016-03-25 9:56:21.5,9355,6,291462,0,9350,462,9355,45,S
2016-03-25 9:56:23,9355,4,291466,0,9350,498,9355,43,S
2016-03-25 9:56:24,9355,8,291474,8,9355,25,9360,477,S
2016-03-25 9:56:24.5,9355,40,291514,20,9355,11,9360,476,S
2016-03-25 9:56:25,9355,22,291536,12,9355,6,9360,477,S
2016-03-25 9:56:26,9355,2,291538,0,9355,8,9360,478,S
2016-03-25 9:56:27,9355,2,291540,0,9355,11,9360,478,S
2016-03-25 9:56:27.5,9355,2,291542,0,9355,20,9360,478,S
2016-03-25 9:56:30,9355,2,291544,-2,9355,43,9360,478,S
2016-03-25 9:56:36,9355,318,291862,-268,9350,464,9355,49,S
2016-03-25 9:56:37,9355,8,291870,0,9350,466,9355,45,S
2016-03-25 9:56:37.5,9355,68,291938,-18,9350,447,9355,11,S
2016-03-25 9:56:38,9355,24,291962,-20,9355,16,9360,385,S
2016-03-25 9:56:38.5,9355,104,292066,-26,9350,443,9355,149,S
2016-03-25 9:56:40,9355,4,292070,-2,9350,418,9355,149,S
2016-03-25 9:56:43,9355,20,292090,-16,9350,425,9355,139,S
2016-03-25 9:56:43.3333,9355,2,292092,-2,9350,425,9355,138,S
2016-03-25 9:56:43.6667,9355,4,292096,-4,9350,444,9355,136,S
2016-03-25 9:56:45,9350,402,292498,-226,9350,173,9355,215,S
2016-03-25 9:56:45.5,9355,12,292510,-2,9350,173,9355,211,B
2016-03-25 9:56:46,9355,14,292524,-10,9350,174,9355,204,B
2016-03-25 9:56:46.5,9355,8,292532,0,9350,173,9355,200,B
2016-03-25 9:56:47,9350,2,292534,-2,9350,187,9355,205,S
2016-03-25 9:56:52,9350,4,292538,-2,9350,190,9355,206,S
2016-03-25 9:56:52.5,9355,2,292540,-2,9350,205,9355,205,B
2016-03-25 9:56:53,9350,400,292940,-280,9345,449,9355,207,S
2016-03-25 9:56:53.5,9350,12,292952,-12,9345,485,9350,8,S
2016-03-25 9:56:55,9350,4,292956,2,9345,486,9350,23,S
2016-03-25 9:56:55.5,9350,22,292978,-14,9345,487,9350,43,S
2016-03-25 9:56:56,9350,4,292982,4,9345,487,9350,41,S
2016-03-25 9:56:57,9350,484,293466,-146,9345,302,9350,70,S
2016-03-25 9:56:57.5,9350,2,293468,-2,9345,302,9350,88,S
2016-03-25 9:56:58,9350,176,293644,-174,9350,214,9355,280,S
2016-03-25 9:57:02,9350,24,293668,10,9350,319,9355,69,S
2016-03-25 9:57:02.5,9355,254,293922,-232,9350,207,9355,66,B
2016-03-25 9:57:06,9355,42,293964,-10,9350,160,9355,156,B
2016-03-25 9:57:07,9355,20,293984,0,9350,162,9355,146,B
2016-03-25 9:57:08,9350,8,293992,-8,9350,169,9355,156,S
2016-03-25 9:57:09,9355,2,293994,0,9350,221,9355,126,B
2016-03-25 9:57:10,9355,4,293998,-4,9350,221,9355,125,B
2016-03-25 9:57:11,9355,2,294000,0,9350,224,9355,124,B
2016-03-25 9:57:12,9355,2,294002,2,9350,226,9355,123,B
2016-03-25 9:57:13,9355,26,294028,26,9350,223,9355,111,B
2016-03-25 9:57:16,9355,410,294438,-266,9350,381,9355,111,B
2016-03-25 9:57:17,9355,6,294444,6,9350,358,9355,174,B
2016-03-25 9:57:18,9355,12,294456,2,9350,343,9355,170,B
2016-03-25 9:57:18.5,9355,2,294458,2,9350,343,9355,169,B
2016-03-25 9:57:19,9355,2,294460,0,9350,343,9355,168,B
2016-03-25 9:57:19.5,9355,416,294876,-326,9350,377,9355,29,B
2016-03-25 9:57:20,9355,14,294890,-12,9355,3,9360,392,B
2016-03-25 9:57:20.5,9355,14,294904,-4,9350,335,9355,249,B
2016-03-25 9:57:21,9355,10,294914,0,9350,334,9355,246,B
2016-03-25 9:57:21.5,9355,434,295348,-236,9355,10,9360,440,B
2016-03-25 9:57:24,9360,402,295750,-140,9355,22,9360,191,B
2016-03-25 9:57:24.5,9360,40,295790,-40,9355,151,9360,109,B
2016-03-25 9:57:25,9360,218,296008,-178,9360,96,9365,469,B
2016-03-25 9:57:26,9365,8,296016,0,9360,96,9365,451,B
2016-03-25 9:57:27,9365,12,296028,0,9360,100,9365,449,B
2016-03-25 9:57:27.5,9365,20,296048,-4,9360,99,9365,440,B
2016-03-25 9:57:29,9360,24,296072,-18,9360,128,9365,424,S
2016-03-25 9:57:30,9360,316,296388,-16,9355,142,9360,172,S
2016-03-25 9:57:30.5,9360,2,296390,0,9355,131,9360,146,S
2016-03-25 9:57:33,9360,2,296392,2,9355,262,9360,154,S
2016-03-25 9:57:34,9360,4,296396,2,9355,262,9360,152,S
2016-03-25 9:57:35,9360,2,296398,0,9355,262,9360,151,S
2016-03-25 9:57:36,9360,2,296400,2,9355,263,9360,150,S
2016-03-25 9:57:37,9360,4,296404,2,9355,273,9360,151,S
2016-03-25 9:57:38,9355,2,296406,0,9355,273,9360,164,S
2016-03-25 9:57:40,9360,4,296410,4,9355,334,9360,143,B
2016-03-25 9:57:42,9360,6,296416,6,9355,339,9360,170,B
2016-03-25 9:57:43,9360,2,296418,0,9355,340,9360,170,B
2016-03-25 9:57:45,9355,4,296422,2,9355,332,9360,226,S
2016-03-25 9:57:46,9360,10,296432,10,9355,333,9360,211,B
2016-03-25 9:57:47,9355,4,296436,4,9355,331,9360,211,S
2016-03-25 9:57:47.5,9355,2,296438,-2,9355,330,9360,212,S
2016-03-25 9:57:49,9355,236,296674,78,9355,214,9360,216,S
2016-03-25 9:57:49.5,9355,56,296730,-40,9355,137,9360,236,S
2016-03-25 9:57:50,9355,10,296740,-10,9355,132,9360,260,S
2016-03-25 9:57:50.5,9355,2,296742,0,9355,131,9360,260,S
2016-03-25 9:57:51,9360,60,296802,60,9355,133,9360,232,B
2016-03-25 9:57:52,9360,10,296812,0,9355,133,9360,204,B
2016-03-25 9:57:55,9355,2,296814,-2,9355,135,9360,205,S
2016-03-25 9:57:57,9360,382,297196,-226,9360,61,9365,468,B
2016-03-25 9:57:58,9365,4,297200,0,9360,61,9365,443,B
2016-03-25 9:57:59,9365,2,297202,2,9360,61,9365,442,B
2016-03-25 9:57:59.5,9360,2,297204,-2,9360,60,9365,441,S
2016-03-25 9:58:01,9365,8,297212,0,9360,61,9365,437,B
2016-03-25 9:58:02,9360,2,297214,0,9360,60,9365,437,S
2016-03-25 9:58:03,9365,6,297220,0,9360,60,9365,435,B
2016-03-25 9:58:05,9360,10,297230,-10,9360,55,9365,437,S
2016-03-25 9:58:06,9365,2,297232,2,9360,55,9365,436,B
2016-03-25 9:58:06.5,9365,40,297272,40,9360,55,9365,416,B
2016-03-25 9:58:08,9360,2,297274,-2,9360,59,9365,414,S
2016-03-25 9:58:10,9360,10,297284,0,9360,56,9365,415,S
2016-03-25 9:58:11,9365,2,297286,0,9360,56,9365,415,B
2016-03-25 9:58:12,9365,340,297626,12,9360,137,9365,208,B
2016-03-25 9:58:13,9360,20,297646,-20,9360,174,9365,182,S
2016-03-25 9:58:14,9365,40,297686,30,9360,174,9365,162,B
2016-03-25 9:58:15,9365,4,297690,2,9360,180,9365,162,B
2016-03-25 9:58:15.5,9365,2,297692,0,9360,181,9365,161,B
2016-03-25 9:58:17,9365,4,297696,0,9360,184,9365,159,B
2016-03-25 9:58:17.5,9360,10,297706,0,9360,179,9365,161,S
2016-03-25 9:58:19,9365,22,297728,20,9360,153,9365,155,B
2016-03-25 9:58:20,9365,2,297730,0,9360,153,9365,163,B
2016-03-25 9:58:22,9365,10,297740,0,9360,159,9365,156,B
2016-03-25 9:58:28,9360,4,297744,-4,9360,152,9365,216,S
2016-03-25 9:58:32,9365,22,297766,-8,9360,102,9365,316,B
2016-03-25 9:58:33,9360,60,297826,4,9360,61,9365,325,S
2016-03-25 9:58:34,9360,62,297888,-48,9360,30,9365,326,S
2016-03-25 9:58:34.5,9360,68,297956,30,9355,208,9360,17,S
2016-03-25 9:58:36,9360,2,297958,0,9355,219,9360,22,S
2016-03-25 9:58:40,9360,52,298010,6,9355,252,9360,42,S
2016-03-25 9:58:43,9360,10,298020,8,9355,252,9360,51,S
2016-03-25 9:58:44,9360,6,298026,6,9355,254,9360,48,S
2016-03-25 9:58:47,9360,4,298030,4,9355,254,9360,49,S
2016-03-25 9:58:47.5,9360,114,298144,-16,9355,254,9365,306,S
2016-03-25 9:58:48,9360,24,298168,-12,9360,44,9365,331,S
2016-03-25 9:58:52,9365,6,298174,2,9360,130,9365,297,B
2016-03-25 9:58:53,9360,6,298180,0,9360,128,9365,288,S
2016-03-25 9:58:53.5,9365,6,298186,4,9360,178,9365,257,B
2016-03-25 9:58:54,9365,30,298216,30,9360,213,9365,244,B
2016-03-25 9:58:55,9365,50,298266,12,9360,213,9365,198,B
2016-03-25 9:58:55.5,9365,2,298268,0,9360,215,9365,159,B
2016-03-25 9:58:56,9360,2,298270,-2,9360,217,9365,158,S
2016-03-25 9:58:56.5,9365,2,298272,2,9360,223,9365,198,B
2016-03-25 9:58:58,9360,10,298282,0,9360,218,9365,300,S
2016-03-25 9:59:00,9365,86,298368,-68,9360,180,9365,258,B
2016-03-25 9:59:01,9360,10,298378,0,9360,176,9365,310,S
2016-03-25 9:59:01.5,9365,32,298410,12,9360,175,9365,295,B
2016-03-25 9:59:03,9365,4,298414,2,9360,182,9365,300,B
2016-03-25 9:59:03.3333,9365,2,298416,-2,9360,182,9365,299,B
2016-03-25 9:59:03.6667,9365,8,298424,2,9360,182,9365,295,B
2016-03-25 9:59:05,9365,6,298430,-6,9360,179,9365,296,B
2016-03-25 9:59:07,9365,2,298432,0,9360,182,9365,301,B
2016-03-25 9:59:07.5,9360,4,298436,-4,9360,180,9365,300,S
2016-03-25 9:59:08,9360,8,298444,-8,9360,176,9365,300,S
2016-03-25 9:59:09,9360,2,298446,0,9360,178,9365,301,S
2016-03-25 9:59:09.5,9360,2,298448,0,9360,177,9365,302,S
2016-03-25 9:59:12,9365,2,298450,2,9360,177,9365,301,B
2016-03-25 9:59:13,9365,2,298452,2,9360,177,9365,304,B
2016-03-25 9:59:13.5,9360,2,298454,0,9360,178,9365,304,S
2016-03-25 9:59:14,9360,104,298558,-70,9360,126,9365,304,S
2016-03-25 9:59:14.5,9360,254,298812,-2,9355,430,9360,86,S
2016-03-25 9:59:15,9360,102,298914,16,9355,295,9360,93,S
2016-03-25 9:59:16,9360,10,298924,10,9355,295,9360,90,S
2016-03-25 9:59:18,9360,2,298926,2,9355,301,9360,133,S
2016-03-25 9:59:20,9360,4,298930,4,9355,351,9360,161,S
2016-03-25 9:59:22,9360,2,298932,2,9355,352,9360,161,S
2016-03-25 9:59:23,9360,4,298936,4,9355,353,9360,175,S
2016-03-25 9:59:25,9360,2,298938,2,9355,375,9360,133,S
2016-03-25 9:59:26,9355,2,298940,-2,9355,374,9360,133,S
2016-03-25 9:59:26.5,9360,2,298942,2,9355,374,9360,132,B
2016-03-25 9:59:29,9355,12,298954,0,9355,371,9360,264,S
2016-03-25 9:59:30,9355,2,298956,0,9355,370,9360,264,S
2016-03-25 9:59:33,9355,2,298958,0,9355,370,9360,272,S
2016-03-25 9:59:33.5,9360,6,298964,0,9355,370,9360,279,B
2016-03-25 9:59:34,9355,200,299164,72,9355,273,9360,280,S
2016-03-25 9:59:35,9360,40,299204,40,9355,272,9360,314,B
2016-03-25 9:59:35.5,9355,6,299210,0,9355,269,9360,312,S
2016-03-25 9:59:38,9355,4,299214,0,9355,300,9360,307,S
2016-03-25 9:59:39,9360,10,299224,8,9355,301,9360,252,B
2016-03-25 9:59:43,9360,4,299228,4,9355,574,9360,252,B
2016-03-25 9:59:43.5,9360,8,299236,8,9355,584,9360,248,B
2016-03-25 9:59:44,9360,20,299256,20,9355,594,9360,238,B
2016-03-25 9:59:45,9360,2,299258,2,9355,596,9360,237,B
2016-03-25 9:59:45.5,9360,2,299260,0,9355,319,9360,236,B
2016-03-25 9:59:48,9360,34,299294,34,9355,323,9360,220,B
2016-03-25 9:59:53,9355,2,299296,0,9355,329,9360,225,S
2016-03-25 9:59:54,9355,16,299312,0,9355,322,9360,225,S
2016-03-25 9:59:56,9360,20,299332,-8,9355,356,9360,224,B
2016-03-25 9:59:57,9360,10,299342,10,9355,378,9360,219,B
2016-03-25 9:59:58,9360,2,299344,-2,9355,378,9360,219,B
2016-03-25 10:00:00,9360,48,299392,0,9355,338,9360,196,B
2016-03-25 10:00:01,9360,166,299558,-24,9355,324,9360,129,B
2016-03-25 10:00:01.5,9360,116,299674,4,9355,355,9360,75,B
2016-03-25 10:00:02,9360,12,299686,2,9355,368,9360,69,B
2016-03-25 10:00:02.5,9360,138,299824,-30,9360,53,9365,358,B
2016-03-25 10:00:03,9360,28,299852,-28,9360,39,9365,358,B
2016-03-25 10:00:03.5,9360,2,299854,-2,9360,49,9365,358,B
2016-03-25 10:00:04,9360,64,299918,-28,9360,18,9365,358,B
2016-03-25 10:00:05,9360,2,299920,-2,9360,19,9365,357,B
2016-03-25 10:00:05.5,9360,40,299960,28,9355,468,9360,2,B
2016-03-25 10:00:06,9360,72,300032,-50,9355,468,9360,5,B
2016-03-25 10:00:06.5,9360,30,300062,6,9360,16,9365,357,B
2016-03-25 10:00:08,9365,20,300082,0,9360,32,9365,346,B
2016-03-25 10:00:09,9365,40,300122,0,9360,24,9365,339,B
2016-03-25 10:00:11,9365,4,300126,4,9360,84,9365,337,B
2016-03-25 10:00:13,9365,2,300128,0,9360,192,9365,309,B
2016-03-25 10:00:13.5,9365,562,300690,-72,9365,89,9370,735,B
2016-03-25 10:00:15,9370,200,300890,-98,9365,180,9370,285,B
2016-03-25 10:00:16,9370,12,300902,12,9365,193,9370,221,B
2016-03-25 10:00:16.5,9365,2,300904,0,9365,192,9370,221,S
2016-03-25 10:00:17,9370,20,300924,18,9365,192,9370,210,B
2016-03-25 10:00:18,9370,2,300926,0,9365,193,9370,209,B
2016-03-25 10:00:20,9370,2,300928,-2,9365,204,9370,209,B
2016-03-25 10:00:20.5,9370,130,301058,-2,9365,204,9370,144,B
2016-03-25 10:00:21,9370,16,301074,-4,9365,204,9370,136,B
2016-03-25 10:00:21.5,9370,266,301340,-196,9370,1,9375,509,B
2016-03-25 10:00:22,9370,2,301342,0,9370,44,9375,496,B
2016-03-25 10:00:22.5,9375,54,301396,2,9370,45,9375,469,B
2016-03-25 10:00:23,9375,46,301442,-6,9370,45,9375,446,B
2016-03-25 10:00:23.5,9375,64,301506,-10,9370,129,9375,415,B
2016-03-25 10:00:24,9370,6,301512,6,9370,127,9375,395,S
2016-03-25 10:00:24.5,9375,4,301516,-4,9370,129,9375,393,B
2016-03-25 10:00:25,9370,12,301528,2,9370,127,9375,388,S
2016-03-25 10:00:26,9370,2,301530,-2,9370,126,9375,388,S
2016-03-25 10:00:26.5,9375,8,301538,0,9370,125,9375,384,B
2016-03-25 10:00:28,9370,60,301598,-4,9370,19,9375,387,S
2016-03-25 10:00:28.5,9370,34,301632,4,9365,188,9370,75,S
2016-03-25 10:00:29,9370,10,301642,10,9365,156,9370,73,S
2016-03-25 10:00:29.5,9365,8,301650,-8,9365,117,9370,83,S
2016-03-25 10:00:30,9370,10,301660,8,9365,117,9370,82,B
2016-03-25 10:00:30.5,9370,4,301664,0,9365,126,9370,80,B
2016-03-25 10:00:31,9370,40,301704,40,9365,126,9370,72,B
2016-03-25 10:00:31.5,9370,4,301708,2,9365,129,9370,71,B
2016-03-25 10:00:33,9370,2,301710,0,9365,129,9370,101,B
2016-03-25 10:00:34,9370,20,301730,20,9365,129,9370,136,B
2016-03-25 10:00:35,9370,6,301736,0,9365,130,9370,133,B
2016-03-25 10:00:35.5,9370,2,301738,0,9365,130,9370,132,B
2016-03-25 10:00:37,9370,4,301742,0,9365,219,9370,114,B
2016-03-25 10:00:37.5,9370,230,301972,-36,9370,91,9375,433,B
2016-03-25 10:00:39,9370,16,301988,0,9370,99,9375,429,B
2016-03-25 10:00:40,9370,24,302012,-10,9370,87,9375,431,B
2016-03-25 10:00:41,9370,10,302022,-10,9370,82,9375,431,B
2016-03-25 10:00:42,9370,2,302024,0,9370,87,9375,431,B
2016-03-25 10:00:43,9370,6,302030,2,9370,80,9375,430,B
2016-03-25 10:00:44,9370,10,302040,10,9370,75,9375,433,B
2016-03-25 10:00:45,9370,2,302042,2,9370,76,9375,433,B
2016-03-25 10:00:46,9375,2,302044,0,9370,76,9375,432,B
2016-03-25 10:00:46.5,9370,2,302046,0,9370,89,9375,436,S
2016-03-25 10:00:48,9370,4,302050,4,9370,88,9375,436,S
2016-03-25 10:00:50,9370,190,302240,98,9365,301,9370,112,S
2016-03-25 10:00:50.5,9370,2,302242,2,9365,301,9370,116,S
2016-03-25 10:00:55,9370,32,302274,-10,9365,307,9370,110,S
2016-03-25 10:00:55.5,9370,20,302294,0,9365,307,9370,108,S
2016-03-25 10:00:56,9370,2,302296,0,9365,307,9370,107,S
2016-03-25 10:00:58,9370,14,302310,0,9365,308,9370,108,S
2016-03-25 10:00:59,9370,24,302334,-4,9365,308,9370,97,S
2016-03-25 10:00:59.5,9370,2,302336,0,9365,308,9370,96,S
2016-03-25 10:01:02,9365,500,302836,220,9360,314,9365,61,S
2016-03-25 10:01:03,9365,4,302840,-2,9360,284,9365,103,S
2016-03-25 10:01:03.5,9365,2,302842,0,9360,284,9365,74,S
2016-03-25 10:01:05,9365,124,302966,-122,9360,272,9370,328,S
2016-03-25 10:01:07,9370,10,302976,0,9365,69,9370,299,B
2016-03-25 10:01:08,9365,2,302978,-2,9365,120,9370,300,S
2016-03-25 10:01:10,9365,12,302990,-2,9365,116,9370,306,S
2016-03-25 10:01:10.5,9365,48,303038,0,9365,91,9370,306,S
2016-03-25 10:01:11,9365,2,303040,0,9365,40,9370,306,S
2016-03-25 10:01:13,9370,6,303046,0,9365,29,9370,304,B
2016-03-25 10:01:14,9365,20,303066,-20,9365,21,9370,304,S
2016-03-25 10:01:14.5,9365,4,303070,-4,9365,28,9370,304,S
2016-03-25 10:01:16,9365,2,303072,-2,9365,132,9370,275,S
2016-03-25 10:01:17,9370,450,303522,94,9370,5,9375,577,B
2016-03-25 10:01:18,9370,2,303524,2,9370,24,9375,552,B
2016-03-25 10:01:22,9370,6,303530,0,9370,52,9375,558,B
2016-03-25 10:01:22.5,9370,6,303536,0,9370,49,9375,558,B
2016-03-25 10:01:25,9375,2,303538,0,9370,75,9375,558,B
2016-03-25 10:01:26,9370,4,303542,0,9370,74,9375,558,S
2016-03-25 10:01:27,9370,32,303574,0,9370,58,9375,558,S
2016-03-25 10:01:27.5,9375,4,303578,4,9370,58,9375,470,B
2016-03-25 10:01:28,9370,8,303586,8,9370,99,9375,470,S
2016-03-25 10:01:29,9375,12,303598,12,9370,149,9375,463,B
2016-03-25 10:01:29.5,9375,2,303600,0,9370,154,9375,462,B
2016-03-25 10:01:30,9370,2,303602,0,9370,164,9375,412,S
2016-03-25 10:01:31,9370,2,303604,2,9370,166,9375,412,S
2016-03-25 10:01:31.5,9380,724,304328,328,9375,26,9380,454,B
2016-03-25 10:01:32,9380,64,304392,-40,9375,314,9380,376,B
2016-03-25 10:01:32.5,9380,56,304448,18,9375,326,9380,310,B
2016-03-25 10:01:33,9380,2,304450,0,9375,106,9380,309,B
2016-03-25 10:01:34,9375,40,304490,40,9375,90,9380,326,S
2016-03-25 10:01:34.5,9380,4,304494,4,9375,90,9380,275,B
2016-03-25 10:01:35,9380,50,304544,-2,9375,90,9380,254,B
2016-03-25 10:01:37,9380,14,304558,8,9375,90,9380,233,B
2016-03-25 10:01:37.5,9380,6,304564,0,9375,90,9380,230,B
2016-03-25 10:01:38,9375,4,304568,4,9375,89,9380,230,S
2016-03-25 10:01:38.5,9380,6,304574,0,9375,89,9380,228,B
2016-03-25 10:01:39,9380,24,304598,22,9375,90,9380,218,B
2016-03-25 10:01:40,9380,20,304618,0,9375,90,9380,208,B
2016-03-25 10:01:42,9375,8,304626,8,9375,93,9380,211,S
2016-03-25 10:01:43,9380,2,304628,2,9375,96,9380,211,B
2016-03-25 10:01:44,9380,2,304630,2,9375,97,9380,212,B
2016-03-25 10:01:46,9375,22,304652,20,9375,112,9380,208,S
2016-03-25 10:01:47,9380,2,304654,0,9375,122,9380,212,B
2016-03-25 10:01:47.5,9375,8,304662,2,9375,121,9380,209,S
2016-03-25 10:01:48,9380,4,304666,4,9375,121,9380,208,B
2016-03-25 10:01:48.5,9380,2,304668,0,9375,122,9380,207,B
2016-03-25 10:01:49,9380,30,304698,26,9375,123,9380,192,B
2016-03-25 10:01:49.5,9380,2,304700,-2,9375,123,9380,190,B
2016-03-25 10:01:50,9380,2,304702,-2,9375,124,9380,201,B
2016-03-25 10:01:51,9380,4,304706,0,9375,131,9380,211,B
2016-03-25 10:01:52,9375,150,304856,-128,9375,55,9380,230,S
2016-03-25 10:01:52.5,9380,2,304858,-2,9375,55,9380,229,B
2016-03-25 10:01:54,9375,4,304862,-4,9375,90,9380,229,S
2016-03-25 10:01:55,9375,22,304884,-2,9375,90,9380,219,S
2016-03-25 10:01:55.5,9380,6,304890,0,9375,101,9380,217,B
2016-03-25 10:01:56,9380,6,304896,0,9375,103,9380,214,B
2016-03-25 10:01:57,9380,4,304900,0,9375,103,9380,226,B
2016-03-25 10:01:59,9380,22,304922,12,9375,157,9380,185,B
2016-03-25 10:02:00,9380,4,304926,0,9375,169,9380,186,B
2016-03-25 10:02:01,9380,4,304930,4,9375,174,9380,181,B
2016-03-25 10:02:02,9380,6,304936,4,9375,172,9380,181,B
2016-03-25 10:02:02.5,9380,2,304938,2,9375,190,9380,192,B
2016-03-25 10:02:03,9380,10,304948,10,9375,199,9380,187,B
2016-03-25 10:02:04,9380,14,304962,12,9375,217,9380,153,B
2016-03-25 10:02:04.5,9380,166,305128,96,9375,246,9380,67,B
2016-03-25 10:02:05,9380,134,305262,-64,9380,276,9385,389,B
2016-03-25 10:02:06,9380,4,305266,-4,9380,285,9385,363,B
2016-03-25 10:02:07,9385,22,305288,-20,9380,278,9385,354,B
2016-03-25 10:02:07.5,9385,218,305506,-114,9380,396,9385,222,B
2016-03-25 10:02:08,9385,24,305530,-20,9380,402,9385,225,B
2016-03-25 10:02:08.5,9380,48,305578,-42,9380,382,9385,236,S
2016-03-25 10:02:09,9380,2,305580,0,9380,403,9385,238,S
2016-03-25 10:02:10,9385,12,305592,-2,9380,386,9385,234,B
2016-03-25 10:02:11,9385,2,305594,2,9380,383,9385,249,B
2016-03-25 10:02:12,9380,2,305596,0,9380,254,9385,308,S
2016-03-25 10:02:13,9380,4,305600,4,9380,202,9385,333,S
2016-03-25 10:02:13.5,9385,2,305602,0,9380,202,9385,335,B
2016-03-25 10:02:14,9380,14,305616,-2,9380,195,9385,235,S
2016-03-25 10:02:14.5,9380,8,305624,-2,9380,191,9385,239,S
2016-03-25 10:02:15,9380,2,305626,-2,9380,220,9385,240,S
2016-03-25 10:02:15.5,9380,4,305630,0,9380,322,9385,240,S
2016-03-25 10:02:16,9385,6,305636,-4,9380,322,9385,237,B
2016-03-25 10:02:17,9385,2,305638,-2,9380,324,9385,258,B
2016-03-25 10:02:18,9385,2,305640,0,9380,318,9385,257,B
2016-03-25 10:02:18.5,9385,12,305652,-8,9380,319,9385,251,B
2016-03-25 10:02:19,9380,46,305698,-34,9380,299,9385,229,S
2016-03-25 10:02:22,9385,2,305700,0,9380,326,9385,238,B
2016-03-25 10:02:22.5,9385,2,305702,0,9380,315,9385,247,B
2016-03-25 10:02:23,9380,624,306326,-20,9375,310,9380,2,S
2016-03-25 10:02:23.5,9380,2,306328,0,9375,223,9380,77,S
2016-03-25 10:02:25,9375,6,306334,6,9375,172,9380,93,S
2016-03-25 10:02:26,9380,10,306344,-6,9375,172,9380,89,B
2016-03-25 10:02:27,9380,20,306364,0,9375,172,9380,80,B
2016-03-25 10:02:27.5,9375,112,306476,32,9375,115,9380,139,S
2016-03-25 10:02:28,9375,194,306670,-94,9370,224,9375,94,S
2016-03-25 10:02:28.5,9375,192,306862,-60,9370,296,9375,21,S
2016-03-25 10:02:29,9375,106,306968,-28,9370,315,9375,13,S
2016-03-25 10:02:29.5,9375,42,307010,-12,9375,14,9380,188,S
2016-03-25 10:02:30,9375,48,307058,-8,9375,43,9380,216,S
2016-03-25 10:02:33,9375,30,307088,4,9370,355,9375,37,S
2016-03-25 10:02:34,9375,6,307094,4,9370,280,9375,47,S
2016-03-25 10:02:35,9375,2,307096,2,9370,281,9375,38,S
2016-03-25 10:02:36,9375,2,307098,2,9370,283,9375,38,S
2016-03-25 10:02:37,9370,2,307100,0,9370,282,9375,39,S
2016-03-25 10:02:37.5,9375,84,307184,80,9375,11,9380,245,B
2016-03-25 10:02:38,9375,20,307204,-2,9375,1,9380,222,B
2016-03-25 10:02:38.5,9375,2,307206,-2,9370,279,9375,247,B
2016-03-25 10:02:40,9375,20,307226,0,9370,246,9375,263,B
2016-03-25 10:02:46,9375,10,307236,0,9370,250,9375,248,B
2016-03-25 10:02:48,9370,10,307246,10,9370,236,9375,248,S
2016-03-25 10:02:55,9370,40,307286,30,9370,211,9375,286,S
2016-03-25 10:02:58,9370,20,307306,0,9370,197,9375,212,S
2016-03-25 10:02:59,9370,400,307706,-238,9365,430,9370,22,S
2016-03-25 10:03:00,9370,60,307766,-18,9370,77,9375,237,S
2016-03-25 10:03:03,9370,2,307768,0,9370,134,9375,234,S
2016-03-25 10:03:04,9370,2,307770,0,9370,133,9375,270,S
2016-03-25 10:03:05,9370,50,307820,0,9370,87,9375,276,S
2016-03-25 10:03:06,9370,2,307822,-2,9370,86,9375,276,S
2016-03-25 10:03:07,9370,10,307832,0,9370,87,9375,276,S
2016-03-25 10:03:08,9370,2,307834,0,9370,86,9375,282,S
2016-03-25 10:03:08.5,9370,2,307836,0,9370,85,9375,282,S
2016-03-25 10:03:10,9375,20,307856,0,9370,85,9375,252,B
2016-03-25 10:03:11,9370,2,307858,-2,9370,94,9375,253,S
2016-03-25 10:03:13,9375,48,307906,2,9370,75,9375,260,B
2016-03-25 10:03:13.5,9370,6,307912,0,9370,74,9375,258,S
2016-03-25 10:03:14,9370,148,308060,104,9365,439,9370,18,S
2016-03-25 10:03:14.5,9370,8,308068,0,9365,416,9370,56,S
2016-03-25 10:03:16,9370,2,308070,2,9365,422,9370,99,S
2016-03-25 10:03:16.5,9370,8,308078,8,9365,422,9370,95,S
2016-03-25 10:03:17,9370,6,308084,6,9365,422,9370,92,S
2016-03-25 10:03:17.5,9365,2,308086,-2,9365,415,9370,93,S
2016-03-25 10:03:18,9370,38,308124,-18,9365,398,9370,91,B
2016-03-25 10:03:19,9370,64,308188,38,9365,380,9370,72,B
2016-03-25 10:03:20,9370,14,308202,2,9365,370,9370,65,B
2016-03-25 10:03:20.5,9370,10,308212,10,9365,369,9370,62,B
2016-03-25 10:03:21,9370,2,308214,0,9365,369,9370,61,B
2016-03-25 10:03:22,9370,12,308226,12,9365,368,9370,55,B
2016-03-25 10:03:22.5,9370,2,308228,2,9365,368,9370,54,B
2016-03-25 10:03:23,9370,10,308238,0,9365,368,9370,50,B
2016-03-25 10:03:24,9370,4,308242,2,9365,368,9370,48,B
2016-03-25 10:03:24.5,9370,98,308340,-2,9370,43,9375,287,B
2016-03-25 10:03:25,9370,2,308342,0,9370,45,9375,262,B
2016-03-25 10:03:25.5,9370,4,308346,4,9370,43,9375,263,B
2016-03-25 10:03:27,9370,44,308390,28,9370,5,9375,260,B
2016-03-25 10:03:28,9370,14,308404,-8,9370,6,9375,261,B
2016-03-25 10:03:28.5,9370,10,308414,10,9370,56,9375,261,B
2016-03-25 10:03:31,9370,20,308434,10,9370,52,9375,262,B
2016-03-25 10:03:31.5,9370,2,308436,2,9370,51,9375,262,B
2016-03-25 10:03:32,9370,8,308444,0,9370,68,9375,262,B
2016-03-25 10:03:51,9370,4,308448,0,9370,137,9375,254,B
2016-03-25 10:03:52,9375,2,308450,0,9370,138,9375,253,B
2016-03-25 10:03:53,9370,284,308734,238,9365,355,9370,68,S
2016-03-25 10:03:54,9370,2,308736,2,9365,336,9370,68,S
2016-03-25 10:03:57,9370,2,308738,2,9365,275,9370,69,S
2016-03-25 10:04:00,9370,4,308742,4,9365,279,9370,87,S
2016-03-25 10:04:01,9370,6,308748,6,9365,283,9370,82,S
2016-03-25 10:04:02,9370,2,308750,2,9365,286,9370,81,S
2016-03-25 10:04:08,9370,4,308754,4,9365,295,9370,99,S
2016-03-25 10:04:08.5,9370,8,308762,8,9365,297,9370,95,S
2016-03-25 10:04:10,9370,2,308764,2,9365,299,9370,95,S
2016-03-25 10:04:12,9365,2,308766,-2,9365,247,9370,627,S
2016-03-25 10:04:12.5,9365,54,308820,2,9365,221,9370,627,S
2016-03-25 10:04:13,9365,10,308830,-10,9365,214,9370,627,S
2016-03-25 10:04:20,9365,4,308834,0,9365,235,9370,638,S
2016-03-25 10:04:23,9365,2,308836,0,9365,212,9370,645,S
2016-03-25 10:04:25,9370,4,308840,4,9365,206,9370,643,B
2016-03-25 10:04:25.5,9365,2,308842,-2,9365,205,9370,643,S
2016-03-25 10:04:28,9365,12,308854,0,9365,198,9370,643,S
2016-03-25 10:04:29,9365,10,308864,0,9365,192,9370,643,S
2016-03-25 10:04:30,9365,394,309258,104,9360,424,9365,59,S
2016-03-25 10:04:31,9365,16,309274,16,9360,404,9365,101,S
2016-03-25 10:04:31.5,9360,6,309280,0,9360,402,9365,111,S
2016-03-25 10:04:32,9360,2,309282,-2,9360,401,9365,113,S
2016-03-25 10:04:32.5,9360,10,309292,-10,9360,386,9365,120,S
2016-03-25 10:04:33,9360,2,309294,-2,9360,385,9365,120,S
2016-03-25 10:04:33.5,9360,10,309304,-10,9360,380,9365,120,S
2016-03-25 10:04:34,9360,2,309306,-2,9360,379,9365,120,S
2016-03-25 10:04:34.5,9365,140,309446,44,9360,379,9365,45,B
2016-03-25 10:04:35,9365,2,309448,2,9360,377,9365,54,B
2016-03-25 10:04:37,9365,40,309488,40,9360,356,9365,35,B
2016-03-25 10:04:38,9360,6,309494,0,9360,353,9365,35,S
2016-03-25 10:04:38.5,9360,8,309502,-8,9360,566,9365,45,S
2016-03-25 10:04:39,9365,100,309602,-22,9365,97,9370,181,B
2016-03-25 10:04:39.5,9365,2,309604,-2,9365,97,9370,191,B
2016-03-25 10:04:40,9365,194,309798,-116,9360,566,9365,49,B
2016-03-25 10:04:41,9360,2,309800,-2,9360,565,9365,85,S
2016-03-25 10:04:44,9360,8,309808,-8,9360,345,9365,158,S
2016-03-25 10:04:45,9360,4,309812,-4,9360,294,9365,162,S
2016-03-25 10:04:46,9360,14,309826,-6,9360,300,9365,160,S
2016-03-25 10:04:48,9360,42,309868,-18,9360,301,9365,167,S
2016-03-25 10:04:49,9360,2,309870,0,9360,297,9365,170,S
2016-03-25 10:04:50,9365,2,309872,2,9360,297,9365,220,B
2016-03-25 10:04:51,9360,6,309878,-6,9360,298,9365,225,S
2016-03-25 10:04:53,9360,2,309880,0,9360,296,9365,235,S
2016-03-25 10:04:55,9360,2,309882,0,9360,289,9365,237,S
2016-03-25 10:04:58,9360,2,309884,-2,9360,292,9365,259,S
2016-03-25 10:05:00,9365,6,309890,0,9360,300,9365,263,B
2016-03-25 10:05:01,9365,74,309964,2,9360,330,9365,228,B
2016-03-25 10:05:02,9365,64,310028,-38,9360,330,9365,195,B
2016-03-25 10:05:02.5,9365,4,310032,-4,9360,330,9365,200,B
2016-03-25 10:05:04,9365,18,310050,-6,9360,329,9365,206,B
2016-03-25 10:05:04.5,9365,12,310062,0,9360,329,9365,200,B
2016-03-25 10:05:05,9365,40,310102,0,9360,328,9365,181,B
2016-03-25 10:05:05.5,9365,4,310106,0,9360,328,9365,179,B
2016-03-25 10:05:06,9365,4,310110,0,9360,328,9365,209,B
2016-03-25 10:05:09,9365,40,310150,2,9360,339,9365,190,B
2016-03-25 10:05:10,9365,380,310530,236,9365,12,9370,240,B
2016-03-25 10:05:11,9360,32,310562,4,9360,339,9365,75,S
2016-03-25 10:05:11.5,9365,104,310666,44,9360,339,9365,201,B
2016-03-25 10:05:12,9360,22,310688,0,9360,328,9365,204,S
2016-03-25 10:05:12.3333,9360,38,310726,2,9360,308,9365,205,S
2016-03-25 10:05:12.6667,9360,2,310728,0,9360,307,9365,205,S
2016-03-25 10:05:13,9360,4,310732,0,9360,306,9365,210,S
2016-03-25 10:05:14,9360,18,310750,2,9360,301,9365,210,S
2016-03-25 10:05:14.5,9360,6,310756,4,9360,298,9365,213,S
2016-03-25 10:05:15,9360,22,310778,-2,9360,287,9365,213,S
2016-03-25 10:05:16,9360,42,310820,42,9360,266,9365,265,S
2016-03-25 10:05:18,9360,6,310826,6,9360,266,9365,280,S
2016-03-25 10:05:18.5,9365,2,310828,0,9360,266,9365,274,B
2016-03-25 10:05:20,9365,10,310838,10,9360,266,9365,276,B
2016-03-25 10:05:22,9365,2,310840,2,9360,267,9365,375,B
2016-03-25 10:05:23,9360,532,311372,-122,9355,424,9360,128,S
2016-03-25 10:05:24,9355,16,311388,8,9355,373,9360,128,S
2016-03-25 10:05:26,9360,4,311392,0,9355,372,9360,263,B
2016-03-25 10:05:26.5,9360,2,311394,0,9355,372,9360,264,B
2016-03-25 10:05:27,9355,8,311402,-8,9355,368,9360,266,S
2016-03-25 10:05:28,9355,6,311408,0,9355,365,9360,275,S
2016-03-25 10:05:29,9355,4,311412,-4,9355,360,9360,275,S
2016-03-25 10:05:29.5,9360,84,311496,82,9355,359,9360,234,B
2016-03-25 10:05:30,9360,12,311508,12,9355,357,9360,232,B
2016-03-25 10:05:30.5,9355,94,311602,-94,9355,310,9360,233,S
2016-03-25 10:05:32,9355,208,311810,28,9355,191,9360,237,S
2016-03-25 10:05:33,9355,22,311832,2,9355,180,9360,381,S
2016-03-25 10:05:34,9360,4,311836,2,9355,185,9360,409,B
2016-03-25 10:05:34.5,9355,4,311840,4,9355,183,9360,411,S
2016-03-25 10:05:35,9355,14,311854,2,9355,177,9360,424,S
2016-03-25 10:05:35.5,9355,4,311858,0,9355,175,9360,437,S
2016-03-25 10:05:36,9355,20,311878,0,9355,166,9360,427,S
2016-03-25 10:05:37,9355,50,311928,2,9355,136,9360,442,S
2016-03-25 10:05:37.5,9355,4,311932,-4,9355,134,9360,432,S
2016-03-25 10:05:38,9355,14,311946,0,9355,123,9360,440,S
2016-03-25 10:05:39,9355,2,311948,2,9355,122,9360,412,S
2016-03-25 10:05:40,9360,36,311984,24,9355,117,9360,408,B
2016-03-25 10:05:42,9355,2,311986,0,9355,116,9360,415,S
2016-03-25 10:05:42.5,9355,4,311990,0,9355,114,9360,413,S
2016-03-25 10:05:43,9355,100,312090,90,9355,64,9360,444,S
2016-03-25 10:05:43.5,9355,144,312234,-48,9350,429,9355,51,S
2016-03-25 10:05:44,9350,6,312240,-4,9350,410,9355,61,S
2016-03-25 10:05:45,9355,184,312424,-152,9350,410,9355,32,B
2016-03-25 10:05:45.5,9355,20,312444,-2,9350,410,9355,36,B
2016-03-25 10:05:46,9350,24,312468,-8,9350,398,9355,41,S
2016-03-25 10:05:46.3333,9350,2,312470,-2,9350,382,9355,43,S
2016-03-25 10:05:46.6667,9355,2,312472,-2,9350,382,9355,56,B
2016-03-25 10:05:49,9355,12,312484,-10,9350,323,9355,205,B
2016-03-25 10:05:50,9355,16,312500,0,9350,327,9355,199,B
2016-03-25 10:05:51,9350,100,312600,-92,9350,277,9355,198,S
2016-03-25 10:05:52,9350,20,312620,0,9350,234,9355,193,S
2016-03-25 10:05:52.3333,9350,30,312650,-26,9350,219,9355,195,S
2016-03-25 10:05:52.6667,9350,80,312730,14,9350,191,9355,183,S
2016-03-25 10:05:54,9350,34,312764,-24,9350,174,9355,169,S
2016-03-25 10:05:54.5,9350,2,312766,0,9350,173,9355,211,S
2016-03-25 10:05:55,9350,20,312786,-2,9350,164,9355,220,S
2016-03-25 10:05:55.5,9350,72,312858,-36,9350,128,9355,221,S
2016-03-25 10:05:56,9350,330,313188,146,9345,193,9355,132,S
2016-03-25 10:05:56.5,9350,82,313270,-18,9345,174,9350,109,S
2016-03-25 10:05:57,9345,44,313314,-4,9345,166,9350,121,S
2016-03-25 10:05:57.5,9345,16,313330,-4,9345,161,9350,95,S
2016-03-25 10:05:58,9345,60,313390,-12,9345,150,9350,77,S
2016-03-25 10:05:58.5,9345,6,313396,4,9345,248,9350,14,S
2016-03-25 10:05:59,9350,72,313468,66,9350,22,9355,175,B
2016-03-25 10:05:59.5,9350,6,313474,2,9350,17,9355,172,B
2016-03-25 10:06:00,9350,10,313484,10,9350,23,9355,175,B
2016-03-25 10:06:00.5,9350,94,313578,34,9350,40,9355,203,B
2016-03-25 10:06:01,9355,2,313580,-2,9350,32,9355,185,B
2016-03-25 10:06:01.5,9350,50,313630,0,9350,15,9355,175,S
2016-03-25 10:06:02,9350,10,313640,2,9350,28,9355,175,S
2016-03-25 10:06:02.5,9350,78,313718,62,9350,29,9355,151,S
2016-03-25 10:06:03,9350,4,313722,0,9350,30,9355,150,S
2016-03-25 10:06:04,9350,2,313724,0,9350,32,9355,161,S
2016-03-25 10:06:06,9350,12,313736,-6,9350,30,9355,158,S
2016-03-25 10:06:07,9350,30,313766,0,9350,40,9355,120,S
2016-03-25 10:06:07.5,9350,6,313772,-4,9350,97,9355,120,S
2016-03-25 10:06:08,9350,2,313774,0,9350,96,9355,120,S
2016-03-25 10:06:09,9355,2,313776,-2,9350,102,9355,119,B
2016-03-25 10:06:09.5,9355,240,314016,-108,9355,99,9360,400,B
2016-03-25 10:06:10,9355,4,314020,-2,9355,97,9360,400,B
2016-03-25 10:06:11,9355,6,314026,-6,9350,231,9355,29,B
2016-03-25 10:06:11.5,9355,54,314080,-52,9350,208,9355,36,B
2016-03-25 10:06:12,9355,6,314086,-2,9350,208,9355,19,B
2016-03-25 10:06:15,9350,60,314146,-16,9350,185,9355,33,S
2016-03-25 10:06:16,9355,6,314152,2,9350,188,9355,37,B
2016-03-25 10:06:17,9355,2,314154,2,9350,190,9355,36,B
2016-03-25 10:06:17.5,9350,2,314156,2,9350,199,9355,36,S
2016-03-25 10:06:18,9350,4,314160,2,9350,201,9355,37,S
2016-03-25 10:06:19,9355,2,314162,0,9350,230,9355,48,B
2016-03-25 10:06:19.5,9350,20,314182,20,9350,220,9355,48,S
2016-03-25 10:06:21,9350,2,314184,0,9350,230,9355,55,S
2016-03-25 10:06:23,9350,100,314284,78,9350,182,9355,100,S
2016-03-25 10:06:23.5,9350,248,314532,152,9350,59,9355,98,S
2016-03-25 10:06:24,9350,130,314662,24,9345,414,9350,94,S
2016-03-25 10:06:24.5,9345,2,314664,2,9345,408,9350,86,S
2016-03-25 10:06:27,9345,2,314666,2,9345,420,9350,100,S
2016-03-25 10:06:27.5,9350,6,314672,4,9345,420,9350,97,B
2016-03-25 10:06:28,9345,2,314674,2,9345,419,9350,97,S
2016-03-25 10:06:31,9345,60,314734,-14,9345,409,9350,99,S
2016-03-25 10:06:32,9350,100,314834,100,9345,402,9350,51,B
2016-03-25 10:06:33,9350,72,314906,-26,9345,427,9350,17,B
2016-03-25 10:06:34,9350,52,314958,-20,9350,11,9355,211,B
2016-03-25 10:06:34.5,9350,6,314964,4,9350,9,9355,211,B
2016-03-25 10:06:35,9350,10,314974,10,9350,1,9355,211,B
2016-03-25 10:06:36,9350,4,314978,2,9345,430,9350,6,B
2016-03-25 10:06:36.3333,9350,12,314990,-2,9350,78,9355,212,B
2016-03-25 10:06:36.6667,9355,2,314992,0,9350,74,9355,212,B
2016-03-25 10:06:38,9350,182,315174,42,9345,405,9350,16,S
2016-03-25 10:06:38.5,9355,34,315208,22,9350,3,9355,211,B
2016-03-25 10:06:39,9350,22,315230,2,9345,391,9350,4,S
2016-03-25 10:06:40,9345,2,315232,0,9345,366,9350,132,S
2016-03-25 10:06:42,9350,10,315242,10,9345,386,9350,130,B
2016-03-25 10:06:43,9350,2,315244,2,9345,389,9350,129,B
2016-03-25 10:06:43.5,9350,2,315246,2,9345,389,9350,128,B
2016-03-25 10:06:45,9350,274,315520,38,9350,78,9355,211,B
2016-03-25 10:06:47,9350,22,315542,-20,9350,25,9355,211,B
2016-03-25 10:06:48,9350,2,315544,0,9350,82,9355,223,B
2016-03-25 10:06:49,9350,2,315546,0,9350,84,9355,222,B
2016-03-25 10:06:52,9350,2,315548,0,9350,96,9355,205,B
2016-03-25 10:06:52.5,9350,4,315552,-4,9350,96,9355,205,B
2016-03-25 10:06:53,9350,4,315556,0,9350,103,9355,206,B
2016-03-25 10:06:53.5,9350,2,315558,0,9350,57,9355,206,B
2016-03-25 10:06:54,9350,2,315560,0,9350,87,9355,206,B
2016-03-25 10:06:55,9350,4,315564,4,9350,85,9355,206,B
2016-03-25 10:06:55.5,9350,10,315574,10,9350,82,9355,206,B
2016-03-25 10:06:56,9350,2,315576,2,9350,91,9355,206,B
2016-03-25 10:06:57,9350,2,315578,2,9350,90,9355,207,B
2016-03-25 10:06:57.5,9350,210,315788,30,9350,69,9355,182,B
2016-03-25 10:06:59,9350,112,315900,22,9350,8,9355,182,B
2016-03-25 10:07:01,9350,98,315998,0,9345,373,9350,2,B
2016-03-25 10:07:03,9350,2,316000,2,9345,350,9350,40,B
2016-03-25 10:07:05,9350,4,316004,0,9345,372,9350,167,B
2016-03-25 10:07:05.5,9350,2,316006,-2,9345,373,9350,173,B
2016-03-25 10:07:08,9345,200,316206,110,9345,271,9350,177,S
2016-03-25 10:07:11,9350,32,316238,20,9345,253,9350,59,B
2016-03-25 10:07:11.5,9350,10,316248,0,9345,256,9350,54,B
2016-03-25 10:07:12,9345,64,316312,-40,9345,237,9350,80,S
2016-03-25 10:07:12.5,9345,4,316316,0,9345,235,9350,81,S
2016-03-25 10:07:14,9350,2,316318,0,9345,404,9350,80,B
2016-03-25 10:07:15,9345,6,316324,6,9345,403,9350,80,S
2016-03-25 10:07:17,9350,4,316328,0,9345,400,9350,83,B
2016-03-25 10:07:18,9350,10,316338,-6,9345,401,9350,79,B
2016-03-25 10:07:19,9345,4,316342,4,9345,379,9350,79,S
2016-03-25 10:07:20,9350,252,316594,42,9350,180,9355,348,B
2016-03-25 10:07:21,9350,30,316624,-28,9350,167,9355,323,B
2016-03-25 10:07:21.5,9350,2,316626,-2,9350,166,9355,323,B
2016-03-25 10:07:22,9350,24,316650,-4,9350,155,9355,325,B
2016-03-25 10:07:23,9350,2,316652,-2,9350,159,9355,325,B
2016-03-25 10:07:24,9350,74,316726,-4,9345,391,9350,8,B
2016-03-25 10:07:25,9350,34,316760,16,9345,380,9350,79,B
2016-03-25 10:07:27,9350,22,316782,2,9345,329,9350,96,B
2016-03-25 10:07:29,9350,12,316794,12,9345,362,9350,48,B
2016-03-25 10:07:30,9350,24,316818,0,9345,363,9350,36,B
2016-03-25 10:07:30.5,9350,22,316840,22,9345,361,9350,77,B
2016-03-25 10:07:31,9350,6,316846,6,9345,359,9350,74,B
2016-03-25 10:07:32,9350,54,316900,-20,9345,361,9350,11,B
2016-03-25 10:07:32.5,9350,70,316970,24,9350,13,9355,236,B
2016-03-25 10:07:34,9350,26,316996,-2,9350,16,9355,240,B
2016-03-25 10:07:35,9355,2,316998,0,9350,26,9355,239,B
2016-03-25 10:07:37,9350,2,317000,0,9350,48,9355,229,S
2016-03-25 10:07:39,9350,4,317004,2,9350,52,9355,231,S
2016-03-25 10:07:39.5,9350,10,317014,2,9350,48,9355,230,S
2016-03-25 10:07:40,9350,2,317016,-2,9350,48,9355,230,S
2016-03-25 10:07:43,9350,2,317018,-2,9350,71,9355,216,S
2016-03-25 10:07:44,9350,4,317022,0,9350,111,9355,206,S
2016-03-25 10:07:45,9355,10,317032,-2,9350,121,9355,201,B
2016-03-25 10:07:46,9350,62,317094,-12,9350,103,9355,200,S
2016-03-25 10:07:48,9350,2,317096,2,9350,105,9355,200,S
2016-03-25 10:07:49,9350,4,317100,-2,9350,106,9355,200,S
2016-03-25 10:07:50,9355,2,317102,2,9350,106,9355,200,B
2016-03-25 10:07:51,9355,10,317112,0,9350,107,9355,194,B
2016-03-25 10:07:54,9350,18,317130,10,9350,113,9355,196,S
2016-03-25 10:07:55,9355,10,317140,10,9350,115,9355,191,B
2016-03-25 10:07:56,9355,2,317142,0,9350,118,9355,189,B
2016-03-25 10:07:56.5,9355,204,317346,-52,9350,153,9355,87,B
2016-03-25 10:07:57,9355,170,317516,-72,9355,339,9360,313,B
2016-03-25 10:07:58,9360,2,317518,2,9355,371,9360,291,B
2016-03-25 10:07:58.5,9360,62,317580,-60,9355,348,9360,276,B
2016-03-25 10:07:59,9360,8,317588,4,9355,200,9360,272,B
2016-03-25 10:08:00,9355,22,317610,-22,9355,184,9360,272,S
2016-03-25 10:08:01,9360,2,317612,0,9355,182,9360,270,B
2016-03-25 10:08:08,9360,2,317614,2,9355,201,9360,287,B
2016-03-25 10:08:08.5,9355,100,317714,-12,9355,143,9360,288,S
2016-03-25 10:08:09,9355,272,317986,28,9355,15,9360,288,S
2016-03-25 10:08:10,9355,34,318020,-30,9350,267,9355,163,S
2016-03-25 10:08:10.5,9355,20,318040,0,9350,267,9355,245,S
2016-03-25 10:08:13,9355,20,318060,-20,9350,237,9355,178,S
2016-03-25 10:08:15,9355,2,318062,-2,9350,235,9355,180,S
2016-03-25 10:08:15.5,9355,380,318442,-174,9355,63,9360,307,S
2016-03-25 10:08:16,9355,134,318576,-128,9350,282,9355,24,S
2016-03-25 10:08:24,9355,2,318578,-2,9350,257,9355,37,S
2016-03-25 10:08:29,9350,4,318582,4,9350,258,9355,39,S
2016-03-25 10:08:30,9350,2,318584,0,9350,257,9355,39,S
2016-03-25 10:08:34,9355,4,318588,-4,9350,259,9355,43,B
2016-03-25 10:08:35,9355,2,318590,-2,9350,265,9355,43,B
2016-03-25 10:08:35.5,9355,14,318604,-14,9350,264,9355,36,B
2016-03-25 10:08:36,9350,2,318606,-2,9350,263,9355,36,S
2016-03-25 10:08:38,9355,2,318608,-2,9350,264,9355,36,B
2016-03-25 10:08:43,9350,20,318628,0,9350,241,9355,59,S
2016-03-25 10:08:46,9355,78,318706,48,9350,240,9355,43,B
2016-03-25 10:08:46.5,9355,8,318714,0,9350,240,9355,39,B
2016-03-25 10:08:55,9350,2,318716,0,9350,243,9355,57,S
2016-03-25 10:08:56,9355,20,318736,20,9350,243,9355,47,B
2016-03-25 10:08:59,9355,2,318738,0,9350,244,9355,62,B
2016-03-25 10:09:00,9355,2,318740,0,9350,243,9355,62,B
2016-03-25 10:09:01,9355,126,318866,52,9355,4,9360,381,B
2016-03-25 10:09:02,9355,20,318886,2,9350,206,9355,69,B
2016-03-25 10:09:03,9355,10,318896,2,9350,222,9355,65,B
2016-03-25 10:09:04,9355,8,318904,6,9355,6,9360,399,B
2016-03-25 10:09:04.3333,9355,2,318906,2,9355,8,9360,379,B
2016-03-25 10:09:04.6667,9355,4,318910,-2,9355,6,9360,379,B
2016-03-25 10:09:05,9355,12,318922,12,9350,250,9355,26,B
2016-03-25 10:09:06,9355,120,319042,-90,9355,47,9360,379,B
2016-03-25 10:09:09,9355,72,319114,-72,9355,12,9360,378,B
2016-03-25 10:09:09.5,9355,24,319138,6,9350,254,9355,30,B
2016-03-25 10:09:10,9355,2,319140,0,9350,253,9355,25,B
2016-03-25 10:09:10.5,9355,52,319192,-12,9355,5,9360,402,B
2016-03-25 10:09:11,9355,18,319210,8,9350,224,9355,6,B
2016-03-25 10:09:12,9355,2,319212,2,9350,213,9355,5,B
2016-03-25 10:09:13,9355,2,319214,0,9350,213,9355,4,B
2016-03-25 10:09:14,9355,10,319224,10,9355,47,9360,424,B
2016-03-25 10:09:15,9355,2,319226,2,9355,56,9360,416,B
2016-03-25 10:09:16,9355,94,319320,90,9355,7,9360,416,B
2016-03-25 10:09:16.5,9355,64,319384,-30,9350,231,9355,8,B
2016-03-25 10:09:17,9355,224,319608,40,9355,50,9360,416,B
2016-03-25 10:09:18,9355,100,319708,96,9350,171,9355,18,B
2016-03-25 10:09:19,9350,2,319710,-2,9350,185,9355,72,S
2016-03-25 10:09:19.5,9350,6,319716,4,9350,184,9355,70,S
2016-03-25 10:09:20,9350,4,319720,-4,9350,181,9355,70,S
2016-03-25 10:09:22,9355,2,319722,0,9350,181,9355,69,B
2016-03-25 10:09:29,9350,20,319742,0,9350,171,9355,87,S
2016-03-25 10:09:29.5,9350,40,319782,4,9350,151,9355,102,S
2016-03-25 10:09:30,9355,34,319816,18,9350,143,9355,86,B
2016-03-25 10:09:30.5,9355,2,319818,2,9350,143,9355,117,B
2016-03-25 10:09:31,9350,200,320018,66,9350,79,9355,118,S
2016-03-25 10:09:31.5,9355,100,320118,98,9350,77,9355,137,B
2016-03-25 10:09:32,9350,2,320120,2,9350,85,9355,137,S
2016-03-25 10:09:32.5,9350,240,320360,88,9350,26,9355,102,S
2016-03-25 10:09:34,9355,2,320362,0,9350,26,9355,101,B
2016-03-25 10:09:34.5,9350,10,320372,0,9350,31,9355,106,S
2016-03-25 10:09:35,9350,16,320388,14,9350,23,9355,107,S
2016-03-25 10:09:37,9355,2,320390,0,9350,23,9355,107,B
2016-03-25 10:09:37.5,9350,6,320396,0,9350,20,9355,107,S
2016-03-25 10:09:38,9350,4,320400,-2,9350,20,9355,127,S
2016-03-25 10:09:39,9350,10,320410,0,9350,20,9355,132,S
2016-03-25 10:09:40,9350,2,320412,0,9350,23,9355,132,S
2016-03-25 10:09:44,9350,12,320424,-2,9350,26,9355,133,S
2016-03-25 10:09:47,9355,6,320430,0,9350,32,9355,136,B
2016-03-25 10:09:48,9350,84,320514,58,9345,505,9350,9,S
2016-03-25 10:09:49,9350,20,320534,12,9350,219,9355,142,S
2016-03-25 10:09:49.5,9350,2,320536,0,9350,218,9355,139,S
2016-03-25 10:09:51,9350,2,320538,0,9350,300,9355,140,S
2016-03-25 10:09:51.5,9350,2,320540,0,9350,302,9355,140,S
2016-03-25 10:09:59,9350,20,320560,0,9350,326,9355,150,S
2016-03-25 10:10:12,9350,10,320570,0,9350,337,9355,169,S
2016-03-25 10:10:13,9350,2,320572,0,9350,337,9355,172,S
2016-03-25 10:10:14,9350,2,320574,0,9350,336,9355,172,S
2016-03-25 10:10:18,9350,2,320576,0,9350,336,9355,172,S
2016-03-25 10:10:19,9355,2,320578,-2,9350,335,9355,171,B
2016-03-25 10:10:19.5,9350,2,320580,0,9350,334,9355,167,S
2016-03-25 10:10:23,9355,192,320772,-154,9355,86,9360,379,B
2016-03-25 10:10:23.5,9355,60,320832,-2,9355,56,9360,311,B
2016-03-25 10:10:26,9355,2,320834,2,9355,28,9360,312,B
2016-03-25 10:10:27,9355,52,320886,4,9350,411,9355,17,B
2016-03-25 10:10:28,9355,8,320894,0,9350,411,9355,10,B
2016-03-25 10:10:28.5,9355,6,320900,6,9350,394,9355,8,B
2016-03-25 10:10:30,9355,10,320910,6,9350,397,9355,4,B
2016-03-25 10:10:31,9355,54,320964,34,9355,12,9360,313,B
2016-03-25 10:10:31.5,9355,24,320988,-16,9350,341,9355,151,B
2016-03-25 10:10:32,9350,2,320990,0,9350,339,9355,151,S
2016-03-25 10:10:32.5,9350,2,320992,0,9350,338,9355,179,S
2016-03-25 10:10:35,9355,2,320994,0,9350,338,9355,188,B
2016-03-25 10:10:36,9350,2,320996,0,9350,337,9355,188,S
2016-03-25 10:10:39,9355,2,320998,-2,9350,359,9355,200,B
2016-03-25 10:10:40,9355,202,321200,-32,9350,300,9355,72,B
2016-03-25 10:10:41,9355,142,321342,-14,9355,7,9360,352,B
2016-03-25 10:10:41.5,9360,122,321464,86,9355,24,9360,250,B
2016-03-25 10:10:42,9360,44,321508,0,9355,25,9360,227,B
2016-03-25 10:10:43,9355,42,321550,12,9355,6,9360,227,S
2016-03-25 10:10:44,9355,4,321554,2,9355,15,9360,228,S
2016-03-25 10:10:45,9360,2,321556,-2,9355,113,9360,227,B
2016-03-25 10:10:47,9355,2,321558,0,9355,112,9360,227,S
2016-03-25 10:10:48,9355,20,321578,2,9355,102,9360,226,S
2016-03-25 10:10:50,9355,104,321682,-12,9355,44,9360,252,S
2016-03-25 10:10:50.5,9355,2,321684,0,9355,46,9360,227,S
2016-03-25 10:10:52,9355,4,321688,-4,9355,57,9360,227,S
2016-03-25 10:10:54,9355,10,321698,-10,9355,67,9360,228,S
2016-03-25 10:10:55,9355,16,321714,-16,9355,55,9360,243,S
2016-03-25 10:10:55.5,9355,128,321842,-122,9350,392,9355,32,S
2016-03-25 10:10:56,9355,6,321848,0,9350,392,9355,14,S
2016-03-25 10:10:58,9355,30,321878,-6,9355,50,9360,277,S
2016-03-25 10:10:58.5,9355,6,321884,6,9355,5,9360,278,S
2016-03-25 10:10:59,9355,10,321894,-8,9350,395,9355,16,S
2016-03-25 10:11:00,9355,2,321896,2,9350,423,9355,11,S
2016-03-25 10:11:05,9355,20,321916,-6,9350,426,9355,15,S
2016-03-25 10:11:07,9355,10,321926,-2,9350,425,9355,60,S
2016-03-25 10:11:20,9355,4,321930,-4,9350,446,9355,69,S
2016-03-25 10:11:27,9350,2,321932,-2,9350,438,9355,158,S
2016-03-25 10:11:29,9350,4,321936,4,9350,440,9355,157,S
2016-03-25 10:11:30,9355,2,321938,-2,9350,440,9355,177,B
2016-03-25 10:11:37,9350,100,322038,-70,9350,392,9355,180,S
2016-03-25 10:11:38,9350,2,322040,2,9350,391,9355,180,S
2016-03-25 10:11:40,9350,6,322046,6,9350,388,9355,184,S
2016-03-25 10:11:40.5,9350,20,322066,0,9350,378,9355,194,S
2016-03-25 10:11:41,9350,242,322308,242,9350,248,9355,245,S
2016-03-25 10:11:41.5,9350,316,322624,20,9350,87,9355,209,S
2016-03-25 10:11:42,9350,4,322628,0,9350,85,9355,210,S
2016-03-25 10:11:42.5,9350,72,322700,0,9350,44,9355,210,S
2016-03-25 10:11:43,9350,10,322710,-10,9350,51,9355,211,S
2016-03-25 10:11:43.5,9350,102,322812,12,9345,332,9350,287,S
2016-03-25 10:11:51,9350,24,322836,4,9345,321,9350,392,S
2016-03-25 10:11:54,9350,2,322838,2,9345,333,9350,388,S
2016-03-25 10:11:56,9345,4,322842,4,9345,335,9350,349,S
2016-03-25 10:11:57,9350,2,322844,0,9345,334,9350,386,B
2016-03-25 10:11:57.5,9345,2,322846,2,9345,333,9350,391,S
2016-03-25 10:11:58,9345,302,323148,180,9345,232,9350,320,S
2016-03-25 10:11:59,9345,8,323156,0,9345,228,9350,347,S
2016-03-25 10:11:59.5,9345,4,323160,0,9345,227,9350,349,S
2016-03-25 10:12:02,9345,6,323166,0,9345,225,9350,361,S
2016-03-25 10:12:04,9345,12,323178,-10,9345,221,9350,364,S
2016-03-25 10:12:05,9350,6,323184,0,9345,225,9350,364,B
2016-03-25 10:12:06,9345,60,323244,0,9345,195,9350,364,S
2016-03-25 10:12:08,9350,200,323444,200,9345,196,9350,256,B
2016-03-25 10:12:08.5,9345,2,323446,0,9345,210,9350,256,S
2016-03-25 10:12:09,9345,30,323476,0,9345,194,9350,256,S
2016-03-25 10:12:09.5,9350,60,323536,0,9345,194,9350,226,B
2016-03-25 10:12:10,9345,2,323538,0,9345,195,9350,226,S
2016-03-25 10:12:12,9345,6,323544,0,9345,196,9350,205,S
2016-03-25 10:12:13,9345,30,323574,-30,9345,182,9350,206,S
2016-03-25 10:12:14,9345,6,323580,-6,9345,181,9350,207,S
2016-03-25 10:12:15,9345,6,323586,0,9345,178,9350,172,S
2016-03-25 10:12:17,9345,2,323588,0,9345,178,9350,172,S
2016-03-25 10:12:18,9345,90,323678,-84,9345,120,9350,172,S
2016-03-25 10:12:21,9345,6,323684,-4,9345,123,9350,173,S
2016-03-25 10:12:22,9345,32,323716,2,9345,110,9350,173,S
2016-03-25 10:12:23,9350,4,323720,-2,9345,111,9350,172,B
2016-03-25 10:12:23.5,9345,22,323742,0,9345,99,9350,173,S
2016-03-25 10:12:24,9350,114,323856,-68,9345,99,9350,117,B
2016-03-25 10:12:24.5,9345,6,323862,-6,9345,123,9350,119,S
2016-03-25 10:12:25,9345,2,323864,0,9345,123,9350,120,S
2016-03-25 10:12:26,9345,2,323866,-2,9345,123,9350,120,S
2016-03-25 10:12:26.5,9345,2,323868,0,9345,143,9350,130,S
2016-03-25 10:12:27,9350,6,323874,6,9345,141,9350,162,B
2016-03-25 10:12:27.5,9345,2,323876,2,9345,141,9350,173,S
2016-03-25 10:12:29,9345,2,323878,2,9345,141,9350,175,S
2016-03-25 10:12:30,9345,10,323888,-4,9345,107,9350,167,S
2016-03-25 10:12:30.5,9345,224,324112,-116,9340,531,9345,48,S
2016-03-25 10:12:33,9340,4,324116,-2,9340,517,9345,85,S
2016-03-25 10:12:34,9340,120,324236,-110,9340,465,9345,122,S
2016-03-25 10:12:34.5,9340,44,324280,-40,9340,443,9345,122,S
2016-03-25 10:12:35,9340,10,324290,-6,9340,430,9345,120,S
2016-03-25 10:12:35.5,9345,4,324294,-2,9340,403,9345,119,B
2016-03-25 10:12:36,9340,100,324394,30,9340,353,9345,131,S
2016-03-25 10:12:37,9340,4,324398,2,9340,351,9345,143,S
2016-03-25 10:12:38,9340,2,324400,2,9340,342,9345,154,S
2016-03-25 10:12:38.5,9340,12,324412,-8,9340,341,9345,161,S
2016-03-25 10:12:39,9340,100,324512,46,9340,284,9345,162,S
2016-03-25 10:12:39.5,9340,2,324514,0,9340,283,9345,164,S
2016-03-25 10:12:40,9340,8,324522,-2,9340,280,9345,165,S
2016-03-25 10:12:40.5,9340,2,324524,0,9340,286,9345,165,S
2016-03-25 10:12:41,9340,2,324526,0,9340,285,9345,170,S
2016-03-25 10:12:42,9345,262,324788,-106,9345,30,9350,216,B
2016-03-25 10:12:43,9345,18,324806,-2,9345,263,9350,194,B
2016-03-25 10:12:43.5,9350,22,324828,-22,9345,263,9350,152,B
2016-03-25 10:12:44,9345,12,324840,-12,9345,257,9350,151,S
2016-03-25 10:12:44.5,9345,4,324844,0,9345,255,9350,152,S
2016-03-25 10:12:45,9350,4,324848,-4,9345,254,9350,151,B
2016-03-25 10:12:49,9345,4,324852,-2,9345,256,9350,182,S
2016-03-25 10:12:50,9345,4,324856,-4,9345,254,9350,182,S
2016-03-25 10:12:50.5,9345,2,324858,0,9345,253,9350,190,S
2016-03-25 10:12:51,9345,106,324964,6,9345,205,9350,191,S
2016-03-25 10:12:51.5,9345,28,324992,-2,9340,294,9345,75,S
2016-03-25 10:12:52,9345,32,325024,0,9340,299,9345,81,S
2016-03-25 10:12:53,9345,224,325248,-16,9345,164,9350,216,S
2016-03-25 10:12:54,9345,8,325256,0,9345,164,9350,194,S
2016-03-25 10:12:58,9345,6,325262,-2,9345,172,9350,214,S
2016-03-25 10:12:59,9350,100,325362,-68,9345,174,9350,164,B
2016-03-25 10:13:00,9350,6,325368,-2,9345,175,9350,191,B
2016-03-25 10:13:00.5,9350,20,325388,20,9345,175,9350,183,B
2016-03-25 10:13:01,9345,2,325390,0,9345,176,9350,175,S
2016-03-25 10:13:02,9345,60,325450,0,9345,148,9350,175,S
2016-03-25 10:13:03,9350,20,325470,0,9345,150,9350,165,B
2016-03-25 10:13:05,9345,72,325542,-62,9345,118,9350,147,S
2016-03-25 10:13:06,9345,236,325778,18,9340,301,9345,89,S
2016-03-25 10:13:07,9345,2,325780,0,9340,301,9345,89,S
2016-03-25 10:13:08,9340,2,325782,-2,9340,301,9345,129,S
2016-03-25 10:13:09,9345,6,325788,0,9340,299,9345,224,B
2016-03-25 10:13:09.5,9340,4,325792,-2,9340,297,9345,228,S
2016-03-25 10:13:12,9340,2,325794,0,9340,298,9345,261,S
2016-03-25 10:13:12.5,9340,18,325812,-10,9340,300,9345,259,S
2016-03-25 10:13:13,9345,2,325814,-2,9340,300,9345,261,B
2016-03-25 10:13:13.5,9340,80,325894,-24,9340,260,9345,269,S
2016-03-25 10:13:14,9340,4,325898,0,9340,258,9345,272,S
2016-03-25 10:13:14.5,9340,4,325902,-4,9340,256,9345,283,S
2016-03-25 10:13:15,9340,4,325906,0,9340,255,9345,304,S
2016-03-25 10:13:16,9345,4,325910,2,9340,260,9345,302,B
2016-03-25 10:13:17,9340,36,325946,0,9340,242,9345,302,S
2016-03-25 10:13:18,9340,264,326210,156,9340,110,9345,303,S
2016-03-25 10:13:18.5,9340,28,326238,0,9340,92,9345,279,S
2016-03-25 10:13:19,9340,84,326322,-58,9340,49,9345,277,S
2016-03-25 10:13:19.5,9340,48,326370,22,9340,28,9345,277,S
2016-03-25 10:13:20,9345,60,326430,4,9340,25,9345,247,B
2016-03-25 10:13:20.5,9340,66,326496,-26,9340,43,9345,244,S
2016-03-25 10:13:21,9340,24,326520,-22,9340,42,9345,266,S
2016-03-25 10:13:21.5,9345,100,326620,86,9340,44,9345,250,B
2016-03-25 10:13:22,9340,4,326624,0,9340,54,9345,250,S
2016-03-25 10:13:23,9340,56,326680,-38,9340,27,9345,253,S
2016-03-25 10:13:24,9345,2,326682,2,9340,48,9345,254,B
2016-03-25 10:13:25,9340,10,326692,0,9340,53,9345,256,S
2016-03-25 10:13:25.5,9340,2,326694,0,9340,52,9345,255,S
2016-03-25 10:13:26,9345,10,326704,0,9340,52,9345,246,B
2016-03-25 10:13:26.5,9340,486,327190,154,9340,9,9345,218,S
2016-03-25 10:13:27,9340,186,327376,-166,9335,375,9340,2,S
2016-03-25 10:13:27.5,9340,326,327702,106,9335,375,9340,68,S
2016-03-25 10:13:28,9340,8,327710,0,9335,376,9340,99,S
2016-03-25 10:13:29,9335,400,328110,226,9335,173,9340,139,S
2016-03-25 10:13:29.5,9335,204,328314,-88,9335,90,9340,145,S
2016-03-25 10:13:30,9335,24,328338,-18,9335,82,9340,143,S
2016-03-25 10:13:30.5,9340,368,328706,-190,9340,156,9345,178,B
2016-03-25 10:13:31,9340,2,328708,0,9340,156,9345,188,B
2016-03-25 10:13:31.5,9340,2,328710,0,9340,155,9345,190,B
2016-03-25 10:13:32,9340,20,328730,-20,9340,145,9345,213,B
2016-03-25 10:13:33,9340,280,329010,-60,9340,7,9345,239,B
2016-03-25 10:13:33.5,9340,14,329024,-10,9335,92,9340,156,B
2016-03-25 10:13:34,9340,44,329068,-2,9335,80,9340,131,B
2016-03-25 10:13:34.5,9340,28,329096,0,9335,90,9340,118,B
2016-03-25 10:13:36,9340,22,329118,20,9335,106,9340,108,B
2016-03-25 10:13:36.5,9335,22,329140,0,9335,95,9340,108,S
2016-03-25 10:13:37,9340,2,329142,2,9335,113,9340,109,B
2016-03-25 10:13:39,9340,10,329152,0,9335,157,9340,181,B
2016-03-25 10:13:40,9340,2,329154,2,9335,146,9340,200,B
2016-03-25 10:13:41,9335,22,329176,-8,9335,128,9340,205,S
2016-03-25 10:13:43,9335,2,329178,0,9335,135,9340,208,S
2016-03-25 10:13:44,9340,4,329182,0,9335,134,9340,211,B
2016-03-25 10:13:44.5,9335,4,329186,0,9335,132,9340,211,S
2016-03-25 10:13:45,9335,20,329206,0,9335,123,9340,197,S
2016-03-25 10:13:47,9335,6,329212,-2,9335,121,9340,199,S
2016-03-25 10:13:47.5,9335,2,329214,2,9335,120,9340,199,S
2016-03-25 10:13:48,9335,2,329216,2,9335,119,9340,199,S
2016-03-25 10:13:48.5,9335,2,329218,2,9335,121,9340,199,S
2016-03-25 10:13:49,9335,4,329222,0,9335,120,9340,208,S
2016-03-25 10:13:49.5,9335,20,329242,16,9335,112,9340,208,S
2016-03-25 10:13:50,9340,80,329322,0,9335,114,9340,168,B
2016-03-25 10:13:50.5,9335,4,329326,2,9335,114,9340,187,S
2016-03-25 10:13:51,9340,458,329784,-98,9340,13,9345,318,B
2016-03-25 10:13:51.5,9335,100,329884,6,9335,49,9340,99,S
2016-03-25 10:13:52,9340,2,329886,0,9335,78,9340,110,B
2016-03-25 10:13:52.5,9340,26,329912,-8,9335,80,9340,109,B
2016-03-25 10:13:54,9340,2,329914,0,9335,236,9340,97,B
2016-03-25 10:13:54.5,9340,98,330012,-6,9340,299,9345,294,B
2016-03-25 10:13:55,9340,4,330016,-4,9340,299,9345,266,B
2016-03-25 10:13:55.5,9340,2,330018,2,9340,272,9345,264,B
2016-03-25 10:13:56,9340,2,330020,2,9340,276,9345,256,B
2016-03-25 10:13:58,9340,4,330024,0,9340,132,9345,279,B
2016-03-25 10:13:58.5,9340,84,330108,0,9340,91,9345,281,B
2016-03-25 10:14:00,9340,40,330148,0,9340,72,9345,277,B
2016-03-25 10:14:00.5,9340,2,330150,0,9340,73,9345,277,B
2016-03-25 10:14:01,9340,30,330180,-30,9340,58,9345,282,B
2016-03-25 10:14:02,9340,4,330184,0,9340,116,9345,304,B
2016-03-25 10:14:04,9345,8,330192,-2,9340,141,9345,302,B
2016-03-25 10:14:04.5,9345,4,330196,0,9340,141,9345,302,B
2016-03-25 10:14:05,9345,10,330206,0,9340,342,9345,297,B
2016-03-25 10:14:05.5,9340,2,330208,0,9340,343,9345,297,S
2016-03-25 10:14:06,9345,398,330606,-48,9340,344,9345,94,B
2016-03-25 10:14:06.5,9340,188,330794,86,9340,344,9350,278,S
2016-03-25 10:14:07,9345,4,330798,0,9345,40,9350,257,B
2016-03-25 10:14:08,9345,2,330800,2,9345,41,9350,224,B
2016-03-25 10:14:09,9345,4,330804,0,9345,51,9350,223,B
2016-03-25 10:14:10,9345,4,330808,0,9345,50,9350,224,B
2016-03-25 10:14:12,9345,4,330812,0,9345,51,9350,231,B
2016-03-25 10:14:14,9345,94,330906,14,9340,182,9345,33,B
2016-03-25 10:14:14.5,9345,4,330910,2,9340,166,9345,66,B
2016-03-25 10:14:15,9340,2,330912,0,9340,155,9345,82,S
2016-03-25 10:14:15.5,9345,4,330916,4,9340,155,9345,80,B
2016-03-25 10:14:16,9345,6,330922,4,9340,155,9345,79,B
2016-03-25 10:14:17,9345,2,330924,2,9340,155,9345,78,B
2016-03-25 10:14:17.5,9345,156,331080,-40,9345,123,9350,273,B
2016-03-25 10:14:19,9345,56,331136,-56,9345,97,9350,250,B
2016-03-25 10:14:20,9345,192,331328,-162,9340,151,9345,8,B
2016-03-25 10:14:20.5,9345,16,331344,-8,9340,150,9345,42,B
2016-03-25 10:14:21,9345,88,331432,-20,9345,87,9350,297,B
2016-03-25 10:14:21.5,9350,2,331434,0,9345,87,9350,288,B
2016-03-25 10:14:22,9345,6,331440,0,9345,88,9350,290,S
2016-03-25 10:14:23,9345,2,331442,-2,9345,90,9350,290,S
2016-03-25 10:14:24,9345,40,331482,-40,9345,118,9350,339,S
2016-03-25 10:14:25,9350,2,331484,0,9345,122,9350,337,B
2016-03-25 10:14:26,9350,4,331488,-4,9345,143,9350,334,B
2016-03-25 10:14:27,9350,2,331490,-2,9345,150,9350,304,B
2016-03-25 10:14:27.5,9350,8,331498,-8,9345,150,9350,300,B
2016-03-25 10:14:29,9350,8,331506,2,9345,103,9350,296,B
2016-03-25 10:14:30,9345,10,331516,0,9345,109,9350,297,S
2016-03-25 10:14:32,9350,8,331524,-4,9345,110,9350,269,B
2016-03-25 10:14:34,9350,30,331554,24,9345,114,9350,303,B
2016-03-25 10:14:36,9345,4,331558,-4,9345,117,9350,299,S
2016-03-25 10:14:40,9345,2,331560,0,9345,167,9350,342,S
2016-03-25 10:14:41,9350,4,331564,-2,9345,166,9350,341,B
2016-03-25 10:14:42,9350,4,331568,0,9345,166,9350,339,B
2016-03-25 10:14:45,9350,60,331628,-6,9345,168,9350,340,B
2016-03-25 10:14:46,9345,32,331660,-32,9345,151,9350,341,S
2016-03-25 10:14:46.5,9345,2,331662,-2,9345,150,9350,343,S
2016-03-25 10:14:49,9350,4,331666,-4,9345,143,9350,361,B
2016-03-25 10:14:52,9350,20,331686,-8,9345,143,9350,330,B
2016-03-25 10:14:53,9345,4,331690,-4,9345,148,9350,330,S
2016-03-25 10:14:55,9350,10,331700,8,9345,153,9350,327,B
2016-03-25 10:14:57,9350,62,331762,-2,9345,129,9350,287,B
2016-03-25 10:14:57.5,9350,40,331802,22,9345,139,9350,287,B
2016-03-25 10:14:58,9350,6,331808,6,9345,139,9350,283,B
2016-03-25 10:14:59,9350,12,331820,0,9345,138,9350,273,B
2016-03-25 10:30:01,9345,200,332020,36,9345,53,9350,265,S
2016-03-25 10:30:01.5,9350,6,332026,4,9345,52,9350,263,B
2016-03-25 10:30:02,9350,8,332034,0,9345,61,9350,264,B
2016-03-25 10:30:02.5,9345,24,332058,-8,9345,54,9350,258,S
2016-03-25 10:30:03,9350,2,332060,2,9345,59,9350,255,B
2016-03-25 10:30:03.5,9345,8,332068,-4,9345,57,9350,255,S
2016-03-25 10:30:04,9350,108,332176,70,9345,88,9350,201,B
2016-03-25 10:30:04.5,9350,4,332180,0,9345,97,9350,199,B
2016-03-25 10:30:05,9350,4,332184,2,9345,97,9350,196,B
2016-03-25 10:30:05.5,9345,18,332202,-10,9345,88,9350,196,S
2016-03-25 10:30:06,9345,4,332206,2,9345,92,9350,197,S
2016-03-25 10:30:06.5,9345,26,332232,-6,9345,79,9350,197,S
2016-03-25 10:30:10,9350,4,332236,4,9345,107,9350,201,B
2016-03-25 10:30:12,9350,344,332580,-68,9345,107,9350,27,B
2016-03-25 10:30:13,9350,162,332742,70,9345,119,9350,17,B
2016-03-25 10:30:13.5,9350,2,332744,0,9345,81,9350,56,B
2016-03-25 10:30:14,9350,2,332746,2,9345,81,9350,64,B
2016-03-25 10:30:14.5,9350,72,332818,56,9345,134,9350,28,B
2016-03-25 10:30:15,9350,56,332874,2,9350,1,9355,382,B
2016-03-25 10:30:17,9350,2,332876,2,9350,113,9355,382,B
2016-03-25 10:30:18,9355,4,332880,0,9350,113,9355,380,B
2016-03-25 10:30:19,9350,38,332918,12,9350,99,9355,378,S
2016-03-25 10:30:19.5,9355,2,332920,2,9350,55,9355,387,B
2016-03-25 10:30:20,9350,100,333020,-2,9350,6,9355,389,S
2016-03-25 10:30:20.5,9350,12,333032,-2,9345,112,9350,42,S
2016-03-25 10:30:21,9350,2,333034,0,9345,113,9350,37,S
2016-03-25 10:30:23,9350,44,333078,4,9345,168,9350,28,S
2016-03-25 10:30:24,9350,4,333082,0,9345,169,9350,17,S
2016-03-25 10:30:24.5,9350,38,333120,-16,9345,169,9350,30,S
2016-03-25 10:30:25,9350,6,333126,4,9345,169,9350,29,S
2016-03-25 10:30:25.5,9350,2,333128,2,9345,169,9350,28,S
2016-03-25 10:30:26,9350,4,333132,0,9345,169,9350,27,S
2016-03-25 10:30:28,9350,12,333144,6,9345,169,9350,21,S
2016-03-25 10:30:31,9350,128,333272,62,9350,37,9355,388,S
2016-03-25 10:30:31.5,9350,6,333278,6,9350,36,9355,386,S
2016-03-25 10:30:32,9355,2,333280,0,9350,37,9355,384,B
2016-03-25 10:30:34,9350,6,333286,6,9350,35,9355,386,S
2016-03-25 10:30:37,9350,80,333366,76,9345,128,9350,121,S
2016-03-25 10:30:38,9350,2,333368,0,9345,128,9350,120,S
2016-03-25 10:30:39,9350,70,333438,52,9345,69,9350,176,S
2016-03-25 10:30:43,9345,20,333458,16,9345,59,9350,193,S
2016-03-25 10:30:44,9350,6,333464,6,9345,61,9350,190,B
2016-03-25 10:30:44.5,9350,2,333466,2,9345,91,9350,198,B
2016-03-25 10:30:45,9345,80,333546,-54,9345,53,9350,198,S
2016-03-25 10:30:46,9350,40,333586,0,9345,53,9350,178,B
2016-03-25 10:30:47,9345,20,333606,-14,9345,43,9350,178,S
2016-03-25 10:30:48,9350,22,333628,-4,9345,39,9350,171,B
2016-03-25 10:30:49,9345,8,333636,-6,9345,29,9350,182,S
2016-03-25 10:30:49.5,9350,2,333638,2,9345,29,9350,181,B
2016-03-25 10:30:50,9345,58,333696,14,9340,315,9345,71,S
2016-03-25 10:30:51,9345,46,333742,6,9340,229,9345,81,S
2016-03-25 10:30:53,9345,30,333772,30,9340,202,9345,85,S
2016-03-25 10:30:58,9345,56,333828,46,9340,161,9345,77,S
2016-03-25 10:31:02,9345,4,333832,2,9340,182,9345,71,S
2016-03-25 10:31:04,9340,2,333834,0,9340,181,9345,70,S
2016-03-25 10:31:05,9340,4,333838,-4,9340,179,9345,72,S
2016-03-25 10:31:09,9340,20,333858,2,9340,180,9345,73,S
2016-03-25 10:31:09.5,9345,4,333862,4,9340,184,9345,65,B
2016-03-25 10:31:11,9345,14,333876,-2,9340,177,9345,72,B
2016-03-25 10:31:12,9345,142,334018,98,9345,1,9350,235,B
2016-03-25 10:31:12.5,9345,10,334028,2,9345,8,9350,210,B
2016-03-25 10:31:14,9345,46,334074,22,9345,82,9350,190,B
2016-03-25 10:31:16,9345,2,334076,2,9345,87,9350,191,B
2016-03-25 10:31:17,9345,2,334078,2,9345,82,9350,207,B
2016-03-25 10:31:19,9345,168,334246,86,9345,34,9350,272,B
2016-03-25 10:31:19.5,9345,76,334322,64,9340,200,9345,67,B
2016-03-25 10:31:20,9345,106,334428,88,9340,253,9345,54,B
2016-03-25 10:31:22,9345,2,334430,2,9340,204,9345,17,B
2016-03-25 10:31:22.5,9345,34,334464,30,9345,9,9350,235,B
2016-03-25 10:31:23,9350,20,334484,0,9345,27,9350,200,B
2016-03-25 10:31:25,9345,220,334704,178,9340,221,9350,253,S
2016-03-25 10:31:26,9345,2,334706,2,9340,198,9345,76,S
2016-03-25 10:31:27,9345,4,334710,0,9340,187,9345,113,S
2016-03-25 10:31:27.5,9345,100,334810,46,9340,185,9345,63,S
2016-03-25 10:31:29,9345,2,334812,0,9340,183,9345,62,S
2016-03-25 10:31:29.5,9345,2,334814,2,9340,183,9345,62,S
2016-03-25 10:31:32,9340,2,334816,0,9340,182,9345,71,S
2016-03-25 10:31:33,9340,2,334818,-2,9340,183,9345,71,S
2016-03-25 10:31:34,9340,370,335188,-286,9335,259,9340,148,S
2016-03-25 10:31:36,9335,16,335204,-14,9335,206,9340,142,S
2016-03-25 10:31:36.3333,9335,32,335236,-16,9335,191,9340,142,S
2016-03-25 10:31:36.6667,9335,4,335240,0,9335,176,9340,142,S
2016-03-25 10:31:38,9335,44,335284,18,9335,148,9340,176,S
2016-03-25 10:31:38.5,9335,4,335288,-2,9335,146,9340,176,S
2016-03-25 10:31:39,9335,28,335316,16,9335,131,9340,187,S
2016-03-25 10:31:40,9335,2,335318,2,9335,130,9340,188,S
2016-03-25 10:31:40.5,9335,10,335328,0,9335,124,9340,188,S
2016-03-25 10:31:41,9335,56,335384,32,9335,99,9340,188,S
2016-03-25 10:31:42,9335,16,335400,0,9335,96,9340,188,S
2016-03-25 10:31:43,9335,2,335402,0,9335,95,9340,188,S
2016-03-25 10:31:44,9335,20,335422,-20,9335,92,9340,188,S
2016-03-25 10:31:45,9340,384,335806,-32,9335,147,9340,10,B
2016-03-25 10:31:45.5,9340,26,335832,-20,9340,127,9345,140,B
2016-03-25 10:31:46,9340,20,335852,0,9340,232,9345,103,B
2016-03-25 10:31:47,9345,200,336052,98,9345,2,9350,334,B
2016-03-25 10:31:47.5,9345,4,336056,0,9345,16,9350,333,B
2016-03-25 10:31:48,9345,20,336076,10,9345,23,9350,312,B
2016-03-25 10:31:51,9345,4,336080,4,9345,21,9350,315,B
2016-03-25 10:31:52,9345,62,336142,56,9345,15,9350,305,B
2016-03-25 10:31:53,9350,2,336144,0,9345,19,9350,291,B
2016-03-25 10:31:53.5,9345,46,336190,-2,9340,186,9345,29,S
2016-03-25 10:31:54,9345,58,336248,2,9345,56,9350,192,S
2016-03-25 10:31:55,9345,4,336252,4,9345,162,9350,191,S
2016-03-25 10:31:58,9345,4,336256,0,9345,64,9350,192,S
2016-03-25 10:32:00,9350,2,336258,2,9345,64,9350,192,B
2016-03-25 10:32:02,9345,10,336268,10,9345,78,9350,204,S
2016-03-25 10:32:04,9345,2,336270,2,9345,87,9350,205,S
2016-03-25 10:32:05,9345,2,336272,2,9345,138,9350,206,S
2016-03-25 10:32:06,9345,40,336312,40,9345,118,9350,206,S
2016-03-25 10:32:08,9350,2,336314,0,9345,129,9350,205,B
2016-03-25 10:32:09,9350,4,336318,4,9345,129,9350,203,B
2016-03-25 10:32:13,9350,10,336328,0,9345,132,9350,199,B
2016-03-25 10:32:15,9350,2,336330,2,9345,137,9350,197,B
2016-03-25 10:32:16,9350,2,336332,2,9345,139,9350,196,B
2016-03-25 10:32:18,9345,2,336334,2,9345,152,9350,197,S
2016-03-25 10:32:19,9345,110,336444,98,9345,102,9350,197,S
2016-03-25 10:32:20,9350,4,336448,2,9345,100,9350,195,B
2016-03-25 10:32:20.5,9345,116,336564,100,9345,43,9350,195,S
2016-03-25 10:32:21,9350,4,336568,4,9345,44,9350,195,B
2016-03-25 10:32:24,9350,28,336596,0,9345,113,9350,178,B
2016-03-25 10:32:25,9350,28,336624,28,9345,117,9350,163,B
2016-03-25 10:32:29,9350,4,336628,0,9345,161,9350,180,B
2016-03-25 10:32:29.5,9350,100,336728,100,9345,161,9350,130,B
2016-03-25 10:32:30,9350,162,336890,56,9345,163,9350,47,B
2016-03-25 10:32:30.5,9350,94,336984,44,9350,114,9355,376,B
2016-03-25 10:32:31,9350,14,336998,-6,9350,109,9355,350,B
2016-03-25 10:32:31.5,9355,6,337004,0,9350,121,9355,347,B
2016-03-25 10:32:34,9355,2,337006,2,9350,146,9355,418,B
2016-03-25 10:32:35,9355,300,337306,-136,9350,167,9355,268,B
2016-03-25 10:32:39,9355,2,337308,0,9350,183,9355,313,B
2016-03-25 10:32:41,9355,42,337350,2,9350,183,9355,293,B
2016-03-25 10:32:44,9355,8,337358,8,9350,171,9355,293,B
2016-03-25 10:32:47,9355,2,337360,0,9350,172,9355,331,B
2016-03-25 10:32:47.5,9355,8,337368,0,9350,172,9355,327,B
2016-03-25 10:32:48,9355,2,337370,0,9350,66,9355,326,B
2016-03-25 10:32:49,9350,4,337374,2,9350,72,9355,325,S
2016-03-25 10:32:53,9350,2,337376,-2,9350,82,9355,324,S
2016-03-25 10:32:54,9350,40,337416,38,9350,64,9355,324,S
2016-03-25 10:32:56,9350,2,337418,2,9350,62,9355,317,S
2016-03-25 10:32:57,9355,2,337420,2,9350,62,9355,316,B
2016-03-25 10:32:57.5,9350,20,337440,2,9350,52,9355,316,S
2016-03-25 10:32:59,9350,104,337544,-74,9345,232,9350,50,S
2016-03-25 10:32:59.5,9345,2,337546,0,9345,205,9350,79,S
2016-03-25 10:33:00,9350,166,337712,-62,9345,217,9350,11,B
2016-03-25 10:33:00.5,9350,24,337736,-22,9350,22,9355,254,B
2016-03-25 10:33:01,9350,22,337758,0,9350,13,9355,250,B
2016-03-25 10:33:02,9355,62,337820,0,9350,12,9355,220,B
2016-03-25 10:33:03,9350,24,337844,22,9345,249,9350,91,S
2016-03-25 10:33:04,9350,2,337846,2,9345,250,9350,92,S
2016-03-25 10:33:05,9350,2,337848,2,9345,251,9350,91,S
2016-03-25 10:33:06,9350,100,337948,100,9345,262,9350,41,S
2016-03-25 10:33:07,9350,88,338036,74,9350,28,9355,226,S
2016-03-25 10:33:08,9350,6,338042,4,9350,89,9355,225,S
2016-03-25 10:33:08.5,9350,2,338044,2,9350,90,9355,225,S
2016-03-25 10:33:10,9355,2,338046,-2,9350,90,9355,224,B
2016-03-25 10:33:10.5,9355,2,338048,0,9350,104,9355,220,B
2016-03-25 10:33:11,9355,4,338052,4,9350,115,9355,219,B
2016-03-25 10:33:12,9350,4,338056,0,9350,116,9355,219,S
2016-03-25 10:33:13,9350,4,338060,4,9350,128,9355,226,S
2016-03-25 10:33:14,9355,4,338064,0,9350,138,9355,224,B
2016-03-25 10:33:15,9355,20,338084,-12,9350,150,9355,214,B
2016-03-25 10:33:15.5,9355,200,338284,-144,9350,188,9355,114,B
2016-03-25 10:33:16,9355,234,338518,-130,9355,37,9360,263,B
2016-03-25 10:33:16.5,9360,8,338526,8,9355,40,9360,245,B
2016-03-25 10:33:17,9360,4,338530,0,9355,40,9360,243,B
2016-03-25 10:33:17.5,9360,8,338538,4,9355,41,9360,239,B
2016-03-25 10:33:18,9355,14,338552,-12,9355,36,9360,358,S
2016-03-25 10:33:18.5,9355,28,338580,-28,9355,22,9360,359,S
2016-03-25 10:33:19,9355,44,338624,-40,9350,265,9355,38,S
2016-03-25 10:33:20,9350,100,338724,0,9350,220,9355,32,S
2016-03-25 10:33:21,9355,46,338770,2,9355,68,9360,419,B
2016-03-25 10:33:22,9360,40,338810,38,9355,82,9360,352,B
2016-03-25 10:33:23,9360,128,338938,46,9355,80,9360,290,B
2016-03-25 10:33:23.5,9360,6,338944,-4,9355,80,9360,288,B
2016-03-25 10:33:24,9360,480,339424,314,9355,107,9360,47,B
2016-03-25 10:33:24.5,9360,94,339518,42,9355,118,9360,7,B
2016-03-25 10:33:25,9360,6,339524,0,9355,118,9360,14,B
2016-03-25 10:33:26,9360,2,339526,-2,9355,136,9360,91,B
2016-03-25 10:33:27,9360,6,339532,0,9355,136,9360,148,B
2016-03-25 10:33:27.5,9360,4,339536,0,9355,138,9360,154,B
2016-03-25 10:33:28,9360,2,339538,-2,9355,150,9360,169,B
2016-03-25 10:33:29,9360,2,339540,-2,9355,151,9360,199,B
2016-03-25 10:33:33,9360,100,339640,-94,9355,149,9360,171,B
2016-03-25 10:33:36,9360,122,339762,-2,9355,102,9360,171,B
2016-03-25 10:33:37,9355,62,339824,0,9355,91,9360,143,S
2016-03-25 10:33:37.5,9360,4,339828,0,9355,120,9360,141,B
2016-03-25 10:33:38,9355,2,339830,0,9355,119,9360,144,S
2016-03-25 10:33:40,9360,2,339832,0,9355,125,9360,172,B
2016-03-25 10:33:40.5,9360,8,339840,-8,9355,126,9360,168,B
2016-03-25 10:33:41,9360,14,339854,-4,9355,155,9360,152,B
2016-03-25 10:33:42,9360,34,339888,18,9355,156,9360,134,B
2016-03-25 10:33:43,9360,40,339928,20,9355,161,9360,113,B
2016-03-25 10:33:43.5,9360,2,339930,0,9355,171,9360,111,B
2016-03-25 10:33:44,9360,26,339956,14,9355,171,9360,98,B
2016-03-25 10:33:44.5,9360,12,339968,0,9355,171,9360,92,B
2016-03-25 10:33:45,9360,2,339970,2,9355,171,9360,91,B
2016-03-25 10:33:46,9360,2,339972,0,9355,191,9360,100,B
2016-03-25 10:33:47,9360,14,339986,4,9355,206,9360,93,B
2016-03-25 10:33:47.5,9355,22,340008,-20,9355,205,9360,84,S
2016-03-25 10:33:48,9360,10,340018,0,9355,206,9360,82,B
2016-03-25 10:33:49,9360,28,340046,0,9355,211,9360,67,B
2016-03-25 10:33:50,9360,4,340050,4,9355,210,9360,65,B
2016-03-25 10:33:52,9360,14,340064,2,9355,223,9360,32,B
2016-03-25 10:33:52.5,9360,22,340086,18,9355,223,9360,17,B
2016-03-25 10:33:53,9360,2,340088,2,9355,222,9360,67,B
2016-03-25 10:33:53.5,9360,82,340170,-6,9355,228,9360,27,B
2016-03-25 10:33:55,9360,94,340264,20,9360,76,9365,654,B
2016-03-25 10:33:56,9360,8,340272,0,9360,108,9365,621,B
2016-03-25 10:33:56.5,9360,2,340274,2,9360,107,9365,619,B
2016-03-25 10:33:58,9365,24,340298,0,9360,101,9365,605,B
2016-03-25 10:33:59,9360,4,340302,2,9360,100,9365,605,S
2016-03-25 10:33:59.5,9360,40,340342,0,9360,80,9365,605,S
2016-03-25 10:34:01,9360,14,340356,0,9360,76,9365,605,S
2016-03-25 10:34:01.5,9365,22,340378,2,9360,78,9365,600,B
2016-03-25 10:34:02,9365,64,340442,60,9360,68,9365,577,B
2016-03-25 10:34:02.5,9365,38,340480,0,9360,68,9365,558,B
2016-03-25 10:34:03,9365,4,340484,4,9360,68,9365,557,B
2016-03-25 10:34:04,9365,4,340488,2,9360,67,9365,556,B
2016-03-25 10:34:04.5,9360,2,340490,0,9360,68,9365,556,S
2016-03-25 10:34:07,9365,2,340492,2,9360,84,9365,570,B
2016-03-25 10:34:07.5,9360,2,340494,2,9360,83,9365,570,S
2016-03-25 10:34:09,9360,4,340498,2,9360,82,9365,569,S
2016-03-25 10:34:10,9360,4,340502,0,9360,87,9365,580,S
2016-03-25 10:34:11,9360,2,340504,0,9360,107,9365,585,S
2016-03-25 10:34:11.5,9360,2,340506,2,9360,106,9365,585,S
2016-03-25 10:34:13,9365,2,340508,0,9360,106,9365,583,B
2016-03-25 10:34:15,9360,228,340736,-36,9355,228,9360,5,S
2016-03-25 10:34:15.5,9360,14,340750,12,9355,228,9360,3,S
2016-03-25 10:34:16,9360,2,340752,0,9355,228,9360,5,S
2016-03-25 10:34:19,9360,8,340760,4,9355,220,9360,18,S
2016-03-25 10:34:19.5,9360,2,340762,2,9355,219,9360,17,S
2016-03-25 10:34:20,9360,20,340782,0,9355,219,9360,13,S
2016-03-25 10:34:22,9360,18,340800,4,9355,244,9360,7,S
2016-03-25 10:34:23,9360,2,340802,0,9355,245,9360,37,S
2016-03-25 10:34:27,9360,8,340810,-6,9355,239,9360,111,S
2016-03-25 10:34:30,9355,10,340820,0,9355,233,9360,158,S
2016-03-25 10:34:38,9355,2,340822,0,9355,307,9360,303,S
2016-03-25 10:34:42,9355,10,340832,0,9355,316,9360,245,S
2016-03-25 10:34:43,9360,12,340844,0,9355,316,9360,242,B
2016-03-25 10:34:44,9360,2,340846,-2,9355,316,9360,241,B
2016-03-25 10:34:49,9355,4,340850,2,9355,316,9360,289,S
2016-03-25 10:34:51,9355,18,340868,0,9355,307,9360,303,S
2016-03-25 10:34:57,9360,20,340888,0,9355,314,9360,304,B
2016-03-25 10:35:01,9360,40,340928,14,9355,317,9360,286,B
2016-03-25 10:35:02,9360,2,340930,0,9355,317,9360,285,B
2016-03-25 10:35:03,9355,10,340940,-6,9355,311,9360,285,S
2016-03-25 10:35:05,9360,4,340944,0,9355,315,9360,283,B
2016-03-25 10:35:08,9355,2,340946,0,9355,314,9360,283,S
2016-03-25 10:35:09,9360,2,340948,0,9355,315,9360,281,B
2016-03-25 10:35:09.5,9355,2,340950,-2,9355,314,9360,281,S
2016-03-25 10:35:10,9355,2,340952,0,9355,313,9360,281,S
2016-03-25 10:35:11,9360,6,340958,0,9355,313,9360,278,B
2016-03-25 10:35:12,9360,6,340964,6,9355,313,9360,275,B
2016-03-25 10:35:12.5,9355,2,340966,0,9355,312,9360,275,S
2016-03-25 10:35:14,9360,2,340968,0,9355,312,9360,242,B
2016-03-25 10:35:14.3333,9355,2,340970,0,9355,311,9360,242,S
2016-03-25 10:35:14.6667,9355,4,340974,-4,9355,309,9360,242,S
2016-03-25 10:35:17,9355,4,340978,0,9355,307,9360,241,S
2016-03-25 10:35:21,9355,2,340980,0,9355,306,9360,253,S
2016-03-25 10:35:24,9355,4,340984,2,9355,305,9360,257,S
2016-03-25 10:35:25,9360,2,340986,0,9355,305,9360,260,B
2016-03-25 10:35:31,9355,4,340990,0,9355,310,9360,343,S
2016-03-25 10:35:37,9355,10,341000,0,9355,299,9360,344,S
2016-03-25 10:35:38,9355,2,341002,0,9355,300,9360,344,S
2016-03-25 10:35:49,9360,30,341032,30,9355,297,9360,359,B
2016-03-25 10:36:00,9355,2,341034,-2,9355,299,9360,356,S
2016-03-25 10:36:01,9360,4,341038,0,9355,299,9360,354,B
2016-03-25 10:36:10,9360,4,341042,0,9355,316,9360,354,B
2016-03-25 10:36:12,9360,4,341046,4,9355,316,9360,352,B
2016-03-25 10:36:14,9355,4,341050,-4,9355,324,9360,352,S
2016-03-25 10:36:14.5,9355,4,341054,-4,9355,322,9360,352,S
2016-03-25 10:36:16,9360,6,341060,4,9355,305,9360,360,B
2016-03-25 10:36:16.5,9360,2,341062,0,9355,305,9360,359,B
2016-03-25 10:36:24,9355,2,341064,0,9355,304,9360,365,S
2016-03-25 10:36:25,9360,28,341092,8,9355,304,9360,351,B
2016-03-25 10:36:31,9360,4,341096,4,9355,310,9360,365,B
2016-03-25 10:36:31.5,9360,2,341098,2,9355,310,9360,364,B
2016-03-25 10:36:32,9355,2,341100,-2,9355,309,9360,364,S
2016-03-25 10:36:34,9355,2,341102,-2,9355,306,9360,363,S
2016-03-25 10:36:37,9360,2,341104,0,9355,306,9360,362,B
2016-03-25 10:36:40,9355,6,341110,-6,9355,306,9360,372,S
2016-03-25 10:36:41,9360,2,341112,2,9355,306,9360,372,B
2016-03-25 10:36:44,9360,2,341114,2,9355,306,9360,371,B
2016-03-25 10:36:45,9360,2,341116,0,9355,309,9360,370,B
2016-03-25 10:36:48,9355,2,341118,0,9355,307,9360,370,S
2016-03-25 10:37:04,9360,52,341170,-12,9355,325,9360,368,B
2016-03-25 10:37:05,9360,52,341222,52,9355,326,9360,343,B
2016-03-25 10:37:05.5,9360,24,341246,24,9355,326,9360,331,B
2016-03-25 10:37:07,9360,202,341448,-64,9355,325,9360,229,B
2016-03-25 10:37:08,9360,2,341450,-2,9355,322,9360,229,B
2016-03-25 10:37:09,9360,2,341452,-2,9355,322,9360,229,B
2016-03-25 10:37:09.5,9360,8,341460,-8,9355,324,9360,225,B
2016-03-25 10:37:10,9360,2,341462,-2,9355,328,9360,223,B
2016-03-25 10:37:11,9355,84,341546,72,9355,368,9360,182,S
2016-03-25 10:37:11.5,9360,4,341550,0,9355,368,9360,181,B
2016-03-25 10:37:12,9360,26,341576,4,9355,367,9360,168,B
2016-03-25 10:37:14,9360,6,341582,6,9355,357,9360,171,B
2016-03-25 10:37:15,9360,2,341584,2,9355,357,9360,170,B
2016-03-25 10:37:18,9360,2,341586,0,9355,361,9360,171,B
2016-03-25 10:37:21,9360,2,341588,0,9355,361,9360,170,B
2016-03-25 10:37:24,9360,4,341592,4,9355,371,9360,167,B
2016-03-25 10:37:26,9360,20,341612,0,9355,372,9360,157,B
2016-03-25 10:37:28,9360,4,341616,4,9355,372,9360,155,B
2016-03-25 10:37:29,9360,2,341618,2,9355,392,9360,157,B
2016-03-25 10:37:30,9360,4,341622,4,9355,391,9360,154,B
2016-03-25 10:37:35,9355,40,341662,-38,9355,372,9360,188,S
2016-03-25 10:37:38,9355,672,342334,344,9350,403,9355,129,S
2016-03-25 10:37:39,9355,14,342348,14,9350,318,9355,374,S
2016-03-25 10:37:43,9355,4,342352,4,9350,318,9355,154,S
2016-03-25 10:37:45,9355,2,342354,0,9350,318,9355,153,S
2016-03-25 10:37:47,9355,4,342358,4,9350,318,9355,158,S
2016-03-25 10:37:47.5,9350,4,342362,-2,9350,316,9355,158,S
2016-03-25 10:37:48,9350,16,342378,-2,9350,313,9355,153,S
2016-03-25 10:37:48.5,9355,2,342380,0,9350,313,9355,160,B
2016-03-25 10:37:49,9350,8,342388,0,9350,289,9355,160,S
2016-03-25 10:37:55,9350,2,342390,-2,9350,290,9355,164,S
2016-03-25 10:37:55.5,9350,2,342392,-2,9350,289,9355,164,S
2016-03-25 10:37:56,9355,6,342398,6,9350,293,9355,161,B
2016-03-25 10:37:58,9350,6,342404,0,9350,290,9355,162,S
2016-03-25 10:38:01,9355,2,342406,2,9350,291,9355,172,B
2016-03-25 10:38:10,9355,4,342410,4,9350,309,9355,179,B
2016-03-25 10:38:11,9350,2,342412,0,9350,308,9355,179,S
2016-03-25 10:38:13,9355,4,342416,2,9350,300,9355,179,B
2016-03-25 10:38:13.5,9355,10,342426,2,9350,295,9355,142,B
2016-03-25 10:38:15,9355,14,342440,4,9350,288,9355,146,B
2016-03-25 10:38:17,9355,2,342442,0,9350,288,9355,146,B
2016-03-25 10:38:21,9355,324,342766,300,9355,2,9360,486,B
2016-03-25 10:38:21.5,9360,122,342888,104,9350,311,9360,441,B
2016-03-25 10:38:25,9360,6,342894,0,9355,53,9360,467,B
2016-03-25 10:38:26,9355,78,342972,0,9355,14,9360,463,S
2016-03-25 10:38:27,9355,46,343018,2,9350,332,9355,7,S
2016-03-25 10:38:27.5,9355,16,343034,12,9350,332,9355,3,S
2016-03-25 10:38:28,9355,2,343036,2,9350,332,9355,32,S
2016-03-25 10:38:29,9355,12,343048,2,9350,326,9355,37,S
2016-03-25 10:38:31,9355,2,343050,2,9350,326,9355,41,S
2016-03-25 10:38:32,9355,44,343094,0,9350,326,9355,20,S
2016-03-25 10:38:33,9355,42,343136,36,9355,38,9360,444,S
2016-03-25 10:38:39,9355,2,343138,2,9355,89,9360,300,S
2016-03-25 10:38:40,9355,2,343140,2,9355,104,9360,350,S
2016-03-25 10:38:42,9355,20,343160,0,9355,105,9360,368,S
2016-03-25 10:38:43,9355,2,343162,2,9355,107,9360,368,S
2016-03-25 10:38:46,9355,2,343164,0,9355,113,9360,368,S
2016-03-25 10:38:49,9355,4,343168,4,9355,114,9360,367,S
2016-03-25 10:38:51,9355,230,343398,-28,9350,354,9355,2,S
2016-03-25 10:38:52,9355,8,343406,2,9350,330,9355,5,S
2016-03-25 10:38:53,9355,2,343408,0,9350,330,9355,44,S
2016-03-25 10:38:54,9355,2,343410,0,9350,330,9355,53,S
2016-03-25 10:38:56,9355,2,343412,0,9350,330,9355,41,S
2016-03-25 10:38:56.5,9355,82,343494,2,9355,3,9360,398,S
2016-03-25 10:38:57,9355,14,343508,-2,9355,27,9360,353,S
2016-03-25 10:38:57.5,9355,2,343510,0,9355,26,9360,353,S
2016-03-25 10:38:58,9355,4,343514,0,9355,24,9360,357,S
2016-03-25 10:38:59,9355,2,343516,-2,9355,33,9360,362,S
2016-03-25 10:38:59.5,9360,16,343532,0,9355,33,9360,353,B
2016-03-25 10:39:02,9360,32,343564,0,9355,23,9360,341,B
2016-03-25 10:39:04,9360,20,343584,20,9355,13,9360,330,B
2016-03-25 10:39:04.5,9360,4,343588,0,9355,14,9360,329,B
2016-03-25 10:39:05,9360,4,343592,0,9355,18,9360,321,B
2016-03-25 10:39:09,9360,4,343596,0,9355,21,9360,305,B
2016-03-25 10:39:11,9355,12,343608,0,9355,17,9360,306,S
2016-03-25 10:39:12,9355,20,343628,0,9355,35,9360,299,S
2016-03-25 10:39:13,9360,4,343632,2,9355,35,9360,297,B
2016-03-25 10:39:29,9360,20,343652,20,9355,127,9360,237,B
2016-03-25 10:39:30,9360,2,343654,2,9355,135,9360,241,B
2016-03-25 10:39:32,9360,2,343656,2,9355,165,9360,242,B
2016-03-25 10:39:34,9355,372,344028,24,9350,510,9355,76,S
2016-03-25 10:39:35,9355,2,344030,0,9350,381,9355,84,S
2016-03-25 10:39:36,9355,2,344032,0,9350,359,9355,105,S
2016-03-25 10:39:38,9355,280,344312,168,9350,381,9355,43,S
2016-03-25 10:39:40,9355,2,344314,0,9350,356,9355,66,S
2016-03-25 10:39:44,9355,2,344316,0,9350,364,9355,140,S
2016-03-25 10:39:50,9355,2,344318,0,9350,364,9355,142,S
2016-03-25 10:39:51,9355,40,344358,0,9350,364,9355,122,S
2016-03-25 10:39:53,9350,2,344360,-2,9350,363,9355,123,S
2016-03-25 10:39:55,9355,10,344370,0,9350,365,9355,83,B
2016-03-25 10:39:56,9355,100,344470,4,9350,365,9355,33,B
2016-03-25 10:39:56.5,9355,68,344538,-46,9355,23,9360,374,B
2016-03-25 10:39:57,9355,34,344572,-18,9350,359,9355,7,B
2016-03-25 10:40:01,9355,28,344600,-4,9350,359,9355,2,B
2016-03-25 10:40:04,9355,34,344634,-10,9350,359,9355,41,B
2016-03-25 10:40:07,9350,10,344644,0,9350,356,9355,45,S
2016-03-25 10:40:10,9355,2,344646,2,9350,356,9355,47,B
2016-03-25 10:40:10.5,9355,2,344648,2,9350,356,9355,46,B
2016-03-25 10:40:13,9355,12,344660,0,9350,366,9355,40,B
2016-03-25 10:40:14,9355,4,344664,4,9350,391,9355,38,B
2016-03-25 10:40:15,9355,104,344768,84,9355,6,9360,373,B
2016-03-25 10:40:15.5,9355,12,344780,-12,9350,392,9355,160,B
2016-03-25 10:40:20,9355,22,344802,-2,9350,392,9355,221,B
2016-03-25 10:40:21,9355,2,344804,0,9350,392,9355,220,B
2016-03-25 10:40:24,9350,46,344850,-38,9350,370,9355,219,S
2016-03-25 10:40:25,9350,46,344896,-46,9350,346,9355,224,S
2016-03-25 10:40:27,9350,2,344898,-2,9350,344,9355,226,S
2016-03-25 10:40:27.5,9350,2,344900,0,9350,342,9355,226,S
2016-03-25 10:40:31,9350,4,344904,-4,9350,340,9355,218,S
2016-03-25 10:40:36,9350,6,344910,0,9350,306,9355,221,S
2016-03-25 10:40:37,9350,606,345516,-338,9345,327,9350,201,S
2016-03-25 10:40:37.5,9345,2,345518,-2,9345,281,9350,201,S
2016-03-25 10:40:38,9345,38,345556,-8,9345,248,9350,212,S
2016-03-25 10:40:38.5,9350,2,345558,0,9345,240,9350,197,B
2016-03-25 10:40:41,9345,4,345562,4,9345,212,9350,187,S
2016-03-25 10:40:44,9350,2,345564,0,9345,185,9350,186,B
2016-03-25 10:40:45,9345,2,345566,2,9345,186,9350,188,S
2016-03-25 10:40:47,9345,2,345568,2,9345,193,9350,188,S
2016-03-25 10:40:50,9350,22,345590,-18,9345,186,9350,193,B
2016-03-25 10:40:52,9345,2,345592,-2,9345,186,9350,199,S
2016-03-25 10:40:55,9345,2,345594,0,9345,237,9350,199,S
2016-03-25 10:41:01,9345,32,345626,0,9345,223,9350,204,S
2016-03-25 10:41:03,9345,436,346062,276,9340,301,9345,4,S
2016-03-25 10:41:03.5,9345,100,346162,52,9345,17,9350,228,S
2016-03-25 10:41:04,9345,74,346236,26,9340,268,9345,5,S
2016-03-25 10:41:08,9345,28,346264,24,9340,239,9345,30,S
2016-03-25 10:41:09,9345,4,346268,-2,9340,240,9345,30,S
2016-03-25 10:41:10,9345,28,346296,20,9340,230,9345,26,S
2016-03-25 10:41:11,9345,4,346300,0,9340,231,9345,23,S
2016-03-25 10:41:11.5,9345,2,346302,0,9340,231,9345,22,S
2016-03-25 10:41:12,9345,6,346308,-6,9340,231,9345,22,S
2016-03-25 10:41:13,9345,6,346314,4,9340,231,9345,19,S
2016-03-25 10:41:13.5,9345,2,346316,0,9340,231,9345,22,S
2016-03-25 10:41:14,9345,2,346318,0,9340,233,9345,23,S
2016-03-25 10:41:15,9345,10,346328,10,9340,233,9345,20,S
2016-03-25 10:41:16,9345,8,346336,8,9340,253,9345,38,S
2016-03-25 10:41:16.5,9345,2,346338,2,9340,253,9345,37,S
2016-03-25 10:41:18,9345,4,346342,2,9340,252,9345,40,S
2016-03-25 10:41:19,9345,4,346346,4,9340,254,9345,49,S
2016-03-25 10:41:20,9345,24,346370,0,9340,255,9345,38,S
2016-03-25 10:41:20.5,9340,56,346426,4,9340,247,9345,21,S
2016-03-25 10:41:21,9340,6,346432,-6,9340,244,9345,26,S
2016-03-25 10:41:23,9345,2,346434,0,9340,244,9345,28,B
2016-03-25 10:41:24,9340,78,346512,8,9340,205,9345,55,S
2016-03-25 10:41:25,9340,52,346564,52,9340,178,9345,67,S
2016-03-25 10:41:25.5,9345,2,346566,2,9340,179,9345,66,B
2016-03-25 10:41:26,9340,2,346568,2,9340,198,9345,68,S
2016-03-25 10:41:28,9340,14,346582,0,9340,190,9345,85,S
2016-03-25 10:41:28.5,9340,2,346584,0,9340,181,9345,85,S
2016-03-25 10:41:29,9345,40,346624,38,9340,165,9345,69,B
2016-03-25 10:41:29.5,9345,2,346626,0,9340,166,9345,68,B
2016-03-25 10:41:30,9345,4,346630,0,9340,171,9345,66,B
2016-03-25 10:41:30.5,9345,2,346632,0,9340,171,9345,65,B
2016-03-25 10:41:31,9345,4,346636,4,9340,171,9345,63,B
2016-03-25 10:41:34,9340,100,346736,74,9340,140,9345,97,S
2016-03-25 10:41:35,9340,2,346738,-2,9340,139,9345,99,S
2016-03-25 10:41:35.5,9340,6,346744,0,9340,138,9345,100,S
2016-03-25 10:41:37,9340,8,346752,0,9340,134,9345,100,S
2016-03-25 10:41:37.5,9345,2,346754,0,9340,134,9345,99,B
2016-03-25 10:41:38,9340,2,346756,-2,9340,134,9345,99,S
2016-03-25 10:41:39,9340,2,346758,0,9340,133,9345,99,S
2016-03-25 10:41:40,9340,2,346760,0,9340,132,9345,99,S
2016-03-25 10:41:40.3333,9340,6,346766,-2,9340,129,9345,101,S
2016-03-25 10:41:40.6667,9340,102,346868,6,9340,98,9345,101,S
2016-03-25 10:41:41,9340,2,346870,-2,9340,97,9345,101,S
2016-03-25 10:41:42,9340,86,346956,-52,9335,285,9345,101,S
2016-03-25 10:41:42.3333,9340,108,347064,8,9340,17,9345,101,S
2016-03-25 10:41:42.6667,9340,42,347106,30,9340,57,9345,133,S
2016-03-25 10:41:43,9340,4,347110,-4,9340,165,9345,133,S
2016-03-25 10:41:44,9340,2,347112,0,9340,146,9345,133,S
2016-03-25 10:41:44.5,9340,30,347142,-10,9340,136,9345,254,S
2016-03-25 10:41:45,9340,272,347414,-10,9335,489,9340,152,S
2016-03-25 10:41:46,9340,2,347416,0,9335,493,9340,156,S
2016-03-25 10:41:46.5,9340,316,347732,-6,9340,147,9345,246,S
2016-03-25 10:41:47,9340,100,347832,0,9340,99,9345,246,S
2016-03-25 10:41:48,9340,4,347836,0,9340,97,9345,244,S
2016-03-25 10:41:49,9340,2,347838,0,9340,96,9345,246,S
2016-03-25 10:41:51,9340,4,347842,0,9340,97,9345,222,S
2016-03-25 10:41:51.5,9340,194,348036,-52,9335,253,9340,36,S
2016-03-25 10:41:52,9340,20,348056,10,9335,253,9340,22,S
2016-03-25 10:41:52.5,9340,178,348234,82,9335,253,9340,31,S
2016-03-25 10:41:53,9340,94,348328,34,9335,252,9340,4,S
2016-03-25 10:41:53.5,9340,14,348342,-8,9340,7,9345,233,S
2016-03-25 10:41:54,9340,126,348468,92,9340,4,9345,234,S
2016-03-25 10:41:55,9340,20,348488,-4,9335,246,9345,151,S
2016-03-25 10:41:55.5,9335,36,348524,-4,9335,247,9345,143,S
2016-03-25 10:41:56,9335,28,348552,-20,9335,235,9345,143,S
2016-03-25 10:41:56.5,9335,10,348562,0,9335,234,9345,143,S
2016-03-25 10:41:57,9335,2,348564,0,9335,233,9340,37,S
2016-03-25 10:41:57.5,9340,80,348644,-74,9340,19,9345,163,B
2016-03-25 10:41:58,9340,8,348652,-8,9340,18,9345,159,B
2016-03-25 10:41:59,9340,22,348674,-14,9340,8,9345,189,B
2016-03-25 10:41:59.5,9340,10,348684,-10,9340,9,9345,185,B
2016-03-25 10:42:00,9340,2,348686,0,9340,9,9345,185,B
2016-03-25 10:42:00.5,9340,100,348786,22,9335,231,9340,17,B
2016-03-25 10:42:01,9340,72,348858,-6,9340,18,9345,194,B
2016-03-25 10:42:01.5,9340,10,348868,0,9340,19,9345,229,B
2016-03-25 10:42:02,9340,2,348870,0,9340,8,9345,231,B
2016-03-25 10:42:02.5,9340,24,348894,12,9335,241,9345,233,B
2016-03-25 10:42:03,9335,6,348900,-2,9335,243,9345,233,S
2016-03-25 10:42:04,9335,4,348904,0,9335,240,9345,239,S
2016-03-25 10:42:06,9340,10,348914,2,9335,240,9340,15,B
2016-03-25 10:42:06.5,9340,20,348934,0,9335,239,9340,11,B
2016-03-25 10:42:08,9335,2,348936,0,9335,251,9340,29,S
2016-03-25 10:42:08.5,9340,12,348948,2,9335,253,9340,24,B
2016-03-25 10:42:09,9335,60,349008,-56,9335,243,9340,29,S
2016-03-25 10:42:10,9340,6,349014,-4,9335,243,9340,28,B
2016-03-25 10:42:12,9340,38,349052,-36,9335,253,9340,9,B
2016-03-25 10:42:12.5,9340,218,349270,-68,9340,76,9345,247,B
2016-03-25 10:42:13,9340,6,349276,0,9340,223,9345,236,B
2016-03-25 10:42:14,9340,12,349288,-12,9340,64,9345,186,B
2016-03-25 10:42:15,9340,4,349292,0,9340,67,9345,176,B
2016-03-25 10:42:15.5,9340,4,349296,0,9340,173,9345,176,B
2016-03-25 10:42:16,9340,328,349624,294,9335,244,9345,174,B
2016-03-25 10:42:16.5,9340,6,349630,4,9335,252,9345,275,B
2016-03-25 10:42:18,9345,104,349734,42,9340,190,9345,220,B
2016-03-25 10:42:22,9340,2,349736,0,9340,84,9345,221,S
2016-03-25 10:42:24,9340,4,349740,2,9340,88,9345,221,S
2016-03-25 10:42:25,9340,4,349744,0,9340,108,9345,221,S
2016-03-25 10:42:26,9345,2,349746,-2,9340,119,9345,221,B
2016-03-25 10:42:30,9340,102,349848,82,9340,67,9345,224,S
2016-03-25 10:42:32,9345,2,349850,-2,9340,69,9345,223,B
2016-03-25 10:42:34,9340,10,349860,10,9340,44,9345,328,S
2016-03-25 10:42:35,9340,92,349952,-66,9335,320,9340,4,S
2016-03-25 10:42:36,9340,16,349968,4,9335,331,9345,333,S
2016-03-25 10:42:36.5,9340,88,350056,-56,9340,15,9345,333,S
2016-03-25 10:42:38,9340,36,350092,6,9335,302,9340,37,S
2016-03-25 10:42:38.5,9340,74,350166,-4,9340,8,9345,337,S
2016-03-25 10:42:41,9340,6,350172,4,9340,178,9345,335,S
2016-03-25 10:42:42,9345,40,350212,0,9340,165,9345,337,B
2016-03-25 10:42:43,9340,42,350254,40,9340,144,9345,336,S
2016-03-25 10:42:43.5,9340,10,350264,10,9340,140,9345,336,S
2016-03-25 10:42:46,9340,18,350282,18,9340,136,9345,318,S
2016-03-25 10:42:47,9340,102,350384,82,9340,87,9345,320,S
2016-03-25 10:42:47.5,9340,30,350414,-14,9340,82,9345,319,S
2016-03-25 10:42:51,9345,4,350418,0,9340,117,9345,318,B
2016-03-25 10:42:53,9340,4,350422,0,9340,127,9345,315,S
2016-03-25 10:42:54,9345,10,350432,0,9340,154,9345,311,B
2016-03-25 10:42:55,9340,2,350434,2,9340,154,9345,312,S
2016-03-25 10:43:00,9340,2,350436,2,9340,177,9345,310,S
2016-03-25 10:43:00.5,9345,2,350438,0,9340,177,9345,310,B
2016-03-25 10:43:03,9345,618,351056,164,9345,103,9350,855,B
2016-03-25 10:43:04,9345,10,351066,0,9345,162,9350,846,B
2016-03-25 10:43:07,9345,2,351068,2,9345,408,9350,866,B
2016-03-25 10:43:07.5,9350,2,351070,0,9345,408,9350,561,B
2016-03-25 10:43:08,9345,8,351078,0,9345,407,9350,539,S
2016-03-25 10:43:09,9350,2,351080,-2,9345,414,9350,543,B
2016-03-25 10:43:10,9350,12,351092,-12,9345,414,9350,539,B
2016-03-25 10:43:11,9350,12,351104,0,9345,414,9350,542,B
2016-03-25 10:43:12,9350,48,351152,-48,9345,414,9350,518,B
2016-03-25 10:43:12.5,9350,48,351200,38,9345,444,9350,494,B
2016-03-25 10:43:13,9350,4,351204,4,9345,634,9350,489,B
2016-03-25 10:43:14,9350,8,351212,0,9345,632,9350,465,B
2016-03-25 10:43:15,9345,430,351642,-28,9345,423,9350,443,S
2016-03-25 10:43:16,9350,100,351742,90,9345,427,9350,391,B
2016-03-25 10:43:17,9350,4,351746,-4,9345,434,9350,374,B
2016-03-25 10:43:21,9350,2,351748,-2,9345,510,9350,378,B
2016-03-25 10:43:25,9350,750,352498,-208,9350,60,9355,646,B
2016-03-25 10:43:25.3333,9350,132,352630,-8,9350,4,9355,619,B
2016-03-25 10:43:25.6667,9355,4,352634,-4,9350,9,9355,592,B
2016-03-25 10:43:26,9350,2,352636,2,9350,13,9355,693,S
2016-03-25 10:43:26.5,9350,26,352662,-14,9345,532,9350,183,S
2016-03-25 10:43:28,9350,12,352674,0,9345,532,9350,222,S
2016-03-25 10:43:33,9350,2,352676,-2,9345,538,9350,291,S
2016-03-25 10:43:33.5,9350,202,352878,-200,9345,649,9350,241,S
2016-03-25 10:43:41,9350,28,352906,-28,9345,720,9350,245,S
2016-03-25 10:43:41.5,9350,4,352910,-4,9345,720,9350,263,S
2016-03-25 10:43:43,9350,8,352918,0,9345,720,9350,260,S
2016-03-25 10:43:47,9345,2,352920,0,9345,821,9350,274,S
2016-03-25 10:43:48,9345,12,352932,12,9345,815,9350,274,S
2016-03-25 10:43:50,9350,4,352936,-4,9345,817,9350,272,B
2016-03-25 10:43:51,9345,120,353056,-72,9340,314,9345,324,S
2016-03-25 10:43:53,9345,22,353078,-20,9340,249,9345,367,S
2016-03-25 10:43:54,9345,4,353082,-4,9340,249,9345,363,S
2016-03-25 10:44:00,9345,600,353682,-600,9340,278,9345,66,S
2016-03-25 10:44:00.5,9345,116,353798,-24,9345,4,9350,231,S
2016-03-25 10:44:01,9345,2,353800,2,9345,3,9350,231,S
2016-03-25 10:44:01.5,9345,90,353890,4,9345,8,9350,231,S
2016-03-25 10:44:02,9345,22,353912,8,9340,309,9345,227,S
2016-03-25 10:44:05,9345,2,353914,0,9340,304,9345,740,S
2016-03-25 10:44:06,9345,108,354022,-60,9345,277,9350,186,S
2016-03-25 10:44:12,9345,2,354024,2,9345,252,9350,273,S
2016-03-25 10:44:26,9350,442,354466,30,9345,254,9355,890,B
2016-03-25 10:44:26.5,9350,40,354506,-40,9345,254,9350,102,B
2016-03-25 10:44:29,9350,2,354508,0,9345,268,9350,96,B
2016-03-25 10:44:30,9350,20,354528,20,9345,355,9350,26,B
2016-03-25 10:44:31,9350,2,354530,2,9345,355,9350,64,B
2016-03-25 10:44:32,9350,2,354532,0,9345,355,9350,64,B
2016-03-25 10:44:33,9350,2,354534,2,9345,354,9350,63,B
2016-03-25 10:44:37,9345,200,354734,100,9345,253,9350,99,S
2016-03-25 10:44:38,9345,58,354792,-2,9345,224,9350,109,S
2016-03-25 10:44:38.5,9350,20,354812,20,9345,224,9350,99,B
2016-03-25 10:44:40,9350,6,354818,6,9345,225,9350,96,B
2016-03-25 10:44:40.5,9350,8,354826,-8,9345,225,9350,92,B
2016-03-25 10:44:44,9350,6,354832,0,9345,226,9350,282,B
2016-03-25 10:44:47,9345,2,354834,0,9345,224,9350,384,S
2016-03-25 10:44:49,9350,2,354836,2,9345,224,9350,383,B
2016-03-25 10:44:55,9350,22,354858,-2,9345,240,9350,475,B
2016-03-25 10:45:01,9350,8,354866,0,9345,241,9350,512,B
2016-03-25 10:45:02,9350,2,354868,0,9345,241,9350,511,B
2016-03-25 10:45:04,9345,16,354884,-16,9345,233,9350,651,S
2016-03-25 10:45:04.5,9350,2,354886,0,9345,235,9350,650,B
2016-03-25 10:45:06,9345,4,354890,0,9345,234,9350,648,S
2016-03-25 10:45:13,9345,4,354894,0,9345,239,9350,649,S
2016-03-25 10:45:15,9345,4,354898,0,9345,237,9350,651,S
2016-03-25 10:45:16,9345,10,354908,0,9345,232,9350,651,S
2016-03-25 10:45:19,9345,2,354910,0,9345,231,9350,651,S
2016-03-25 10:45:20,9350,4,354914,4,9345,231,9350,649,B
2016-03-25 10:45:21,9345,2,354916,0,9345,230,9350,649,S
2016-03-25 10:45:37,9345,4,354920,-4,9345,229,9350,660,S
2016-03-25 10:45:37.5,9345,4,354924,0,9345,224,9350,660,S
2016-03-25 10:45:38,9345,2,354926,0,9345,223,9350,708,S
2016-03-25 10:45:43,9345,2,354928,0,9345,225,9350,708,S
2016-03-25 10:45:44,9345,158,355086,-158,9345,147,9350,784,S
2016-03-25 10:45:44.5,9345,292,355378,-138,9340,354,9345,100,S
2016-03-25 10:45:50,9345,2,355380,2,9340,281,9345,156,S
2016-03-25 10:45:54,9340,6,355386,0,9340,277,9345,367,S
2016-03-25 10:45:56,9345,2,355388,2,9340,277,9345,369,B
2016-03-25 10:45:58,9345,10,355398,10,9340,278,9345,367,B
2016-03-25 10:46:02,9340,8,355406,0,9340,274,9345,558,S
2016-03-25 10:46:05,9345,300,355706,48,9340,270,9345,470,B
2016-03-25 10:46:06,9345,4,355710,0,9340,275,9345,468,B
2016-03-25 10:46:06.5,9345,56,355766,0,9340,276,9345,440,B
2016-03-25 10:46:08,9345,20,355786,-14,9345,336,9350,248,B
2016-03-25 10:46:09,9345,2,355788,0,9345,337,9350,236,B
2016-03-25 10:46:10,9345,2,355790,0,9345,336,9350,245,B
2016-03-25 10:46:11,9350,488,356278,292,9350,232,9355,433,B
2016-03-25 10:46:13,9355,598,356876,52,9355,6,9360,620,B
2016-03-25 10:46:13.5,9355,2,356878,0,9355,21,9360,606,B
2016-03-25 10:46:14,9360,4,356882,2,9355,61,9360,594,B
2016-03-25 10:46:15,9360,4,356886,-4,9355,70,9360,583,B
2016-03-25 10:46:16,9360,6,356892,-2,9355,72,9360,580,B
2016-03-25 10:46:17,9355,2,356894,-2,9355,62,9360,882,S
2016-03-25 10:46:20,9355,2,356896,0,9355,264,9360,889,S
2016-03-25 10:46:21,9360,10,356906,2,9355,570,9360,844,B
2016-03-25 10:46:23,9360,4,356910,0,9355,570,9360,847,B
2016-03-25 10:46:24,9360,2,356912,0,9355,570,9360,846,B
2016-03-25 10:46:24.5,9360,20,356932,-8,9355,570,9360,548,B
2016-03-25 10:46:26,9355,4,356936,0,9355,597,9360,544,S
2016-03-25 10:46:28,9360,2,356938,-2,9355,595,9360,542,B
2016-03-25 10:46:32,9355,2,356940,0,9355,594,9360,554,S
2016-03-25 10:46:32.5,9355,2,356942,2,9355,593,9360,554,S
2016-03-25 10:46:34,9355,4,356946,0,9355,591,9360,554,S
2016-03-25 10:46:35,9355,4,356950,4,9355,590,9360,554,S
2016-03-25 10:46:36,9360,20,356970,-20,9355,590,9360,545,B
2016-03-25 10:46:40,9360,48,357018,-4,9355,591,9360,527,B
2016-03-25 10:46:41,9360,384,357402,328,9355,591,9360,336,B
2016-03-25 10:46:42,9360,662,358064,-108,9360,23,9365,618,B
2016-03-25 10:46:42.5,9365,202,358266,196,9360,54,9365,452,B
2016-03-25 10:46:43,9365,68,358334,0,9360,100,9365,328,B
2016-03-25 10:46:43.5,9360,8,358342,8,9360,96,9365,328,S
2016-03-25 10:46:44,9365,2,358344,0,9360,99,9365,430,B
2016-03-25 10:46:45,9365,16,358360,0,9360,331,9365,423,B
2016-03-25 10:46:45.5,9365,6,358366,0,9360,331,9365,419,B
2016-03-25 10:46:46,9365,2,358368,0,9360,335,9365,418,B
2016-03-25 10:46:46.5,9365,34,358402,30,9360,336,9365,403,B
2016-03-25 10:46:47,9365,4,358406,2,9360,339,9365,400,B
2016-03-25 10:46:47.5,9360,12,358418,0,9360,334,9365,399,S
2016-03-25 10:46:48,9365,12,358430,0,9360,344,9365,393,B
2016-03-25 10:46:48.5,9365,2,358432,2,9360,344,9365,392,B
2016-03-25 10:46:49,9360,10,358442,0,9360,582,9365,397,S
2016-03-25 10:46:49.5,9365,6,358448,6,9360,581,9365,396,B
2016-03-25 10:46:51,9365,32,358480,0,9360,579,9365,389,B
2016-03-25 10:46:52,9365,40,358520,40,9360,584,9365,368,B
2016-03-25 10:46:53,9365,24,358544,12,9360,578,9365,358,B
2016-03-25 10:46:53.5,9365,4,358548,2,9360,578,9365,356,B
2016-03-25 10:46:54,9365,8,358556,0,9360,574,9365,352,B
2016-03-25 10:46:55,9365,6,358562,0,9360,577,9365,349,B
2016-03-25 10:46:56,9365,2,358564,0,9360,584,9365,348,B
2016-03-25 10:46:58,9365,2,358566,0,9360,611,9365,346,B
2016-03-25 10:46:58.5,9365,694,359260,-548,9365,160,9370,305,B
2016-03-25 10:46:59,9370,78,359338,0,9365,174,9370,188,B
2016-03-25 10:46:59.3333,9370,514,359852,-368,9365,188,9370,155,B
2016-03-25 10:46:59.6667,9370,24,359876,-18,9365,205,9370,147,B
2016-03-25 10:47:00,9370,2,359878,0,9365,205,9370,145,B
2016-03-25 10:47:01,9370,2,359880,0,9365,209,9370,144,B
2016-03-25 10:47:02,9370,62,359942,0,9365,209,9370,114,B
2016-03-25 10:47:02.5,9370,200,360142,86,9365,209,9370,12,B
2016-03-25 10:47:03,9370,24,360166,-20,9370,39,9375,279,B
2016-03-25 10:47:03.5,9370,144,360310,-64,9365,132,9370,211,B
2016-03-25 10:47:04,9370,14,360324,-12,9365,133,9370,211,B
2016-03-25 10:47:04.5,9370,2,360326,0,9365,135,9370,210,B
2016-03-25 10:47:05,9370,6,360332,-2,9365,167,9370,278,B
2016-03-25 10:47:05.5,9370,20,360352,-12,9365,195,9370,269,B
2016-03-25 10:47:06,9370,104,360456,-2,9365,152,9370,271,B
2016-03-25 10:47:07,9365,356,360812,172,9365,25,9370,276,S
2016-03-25 10:47:07.5,9365,116,360928,-22,9360,582,9365,10,S
2016-03-25 10:47:08,9365,10,360938,10,9360,600,9365,12,S
2016-03-25 10:47:08.5,9370,48,360986,2,9365,2,9370,279,B
2016-03-25 10:47:09,9370,16,361002,0,9365,46,9370,265,B
2016-03-25 10:47:11,9365,98,361100,6,9360,574,9365,154,S
2016-03-25 10:47:11.5,9365,20,361120,0,9360,582,9365,146,S
2016-03-25 10:47:13,9360,28,361148,20,9360,582,9365,133,S
2016-03-25 10:47:14,9365,2,361150,2,9360,587,9365,143,B
2016-03-25 10:47:16,9360,104,361254,-2,9360,532,9365,172,S
2016-03-25 10:47:16.5,9365,2,361256,0,9360,614,9365,176,B
2016-03-25 10:47:17,9360,410,361666,-198,9355,282,9360,25,S
2016-03-25 10:47:17.5,9360,154,361820,8,9355,245,9360,131,S
2016-03-25 10:47:18,9360,142,361962,-6,9355,227,9360,82,S
2016-03-25 10:47:18.5,9360,50,362012,40,9355,229,9360,59,S
2016-03-25 10:47:19,9360,40,362052,20,9355,242,9360,39,S
2016-03-25 10:47:20,9360,78,362130,72,9360,12,9365,241,S
2016-03-25 10:47:21,9360,8,362138,8,9360,8,9365,241,S
2016-03-25 10:47:21.5,9360,22,362160,-4,9355,296,9360,222,S
2016-03-25 10:47:22,9360,22,362182,-2,9355,296,9360,211,S
2016-03-25 10:47:24,9360,160,362342,0,9355,295,9360,135,S
2016-03-25 10:47:24.5,9360,20,362362,-20,9355,300,9360,125,S
2016-03-25 10:47:25,9360,12,362374,-2,9355,282,9360,119,S
2016-03-25 10:47:26,9355,2,362376,0,9355,285,9360,129,S
2016-03-25 10:47:26.5,9360,2,362378,0,9355,296,9360,128,B
2016-03-25 10:47:27,9360,2,362380,0,9355,296,9360,127,B
2016-03-25 10:47:28,9360,148,362528,-48,9355,332,9360,53,B
2016-03-25 10:47:29,9360,104,362632,-80,9355,417,9365,264,B
2016-03-25 10:47:30,9360,66,362698,-66,9360,28,9365,264,B
2016-03-25 10:47:30.5,9360,56,362754,0,9360,48,9365,246,B
2016-03-25 10:47:31,9360,2,362756,0,9360,76,9365,507,B
2016-03-25 10:47:32,9360,4,362760,4,9360,74,9365,482,B
2016-03-25 10:47:33,9360,2,362762,2,9360,73,9365,476,B
2016-03-25 10:47:34,9360,56,362818,0,9360,45,9365,708,B
2016-03-25 10:47:35,9360,132,362950,10,9355,375,9360,16,B
2016-03-25 10:47:36,9360,32,362982,-12,9360,76,9365,710,B
2016-03-25 10:47:37,9365,6,362988,6,9360,77,9365,708,B
2016-03-25 10:47:39,9360,154,363142,-40,9355,378,9360,27,S
2016-03-25 10:47:41,9360,6,363148,-4,9355,374,9360,109,S
2016-03-25 10:47:41.5,9360,2,363150,-2,9355,376,9360,136,S
2016-03-25 10:47:43,9360,20,363170,0,9355,376,9360,134,S
2016-03-25 10:47:43.5,9360,20,363190,-20,9355,377,9360,124,S
2016-03-25 10:47:47,9360,6,363196,0,9355,338,9360,138,S
2016-03-25 10:47:49,9360,282,363478,-234,9360,5,9365,370,S
2016-03-25 10:47:50,9360,26,363504,-14,9355,365,9360,12,S
2016-03-25 10:47:50.5,9360,76,363580,-24,9360,44,9365,370,S
2016-03-25 10:47:53,9360,10,363590,0,9360,61,9365,370,S
2016-03-25 10:47:54,9360,10,363600,4,9360,61,9365,368,S
2016-03-25 10:47:55,9365,4,363604,4,9360,61,9365,366,B
2016-03-25 10:48:00,9365,10,363614,10,9360,158,9365,241,B
2016-03-25 10:48:01,9365,2,363616,2,9360,159,9365,240,B
2016-03-25 10:48:04,9360,22,363638,0,9360,179,9365,234,S
2016-03-25 10:48:05,9360,4,363642,0,9360,192,9365,232,S
2016-03-25 10:48:07,9360,6,363648,2,9360,197,9365,234,S
2016-03-25 10:48:10,9360,2,363650,2,9360,201,9365,234,S
2016-03-25 10:48:13,9360,22,363672,0,9360,99,9365,221,S
2016-03-25 10:48:13.5,9360,8,363680,-6,9360,100,9365,221,S
2016-03-25 10:48:17,9360,186,363866,-166,9360,7,9365,233,S
2016-03-25 10:48:17.5,9360,16,363882,16,9355,403,9360,25,S
2016-03-25 10:48:18,9360,4,363886,-4,9355,402,9360,30,S
2016-03-25 10:48:19,9360,2,363888,0,9355,402,9360,29,S
2016-03-25 10:48:21,9360,6,363894,4,9355,401,9360,27,S
2016-03-25 10:48:24,9360,52,363946,-42,9360,2,9365,236,S
2016-03-25 10:48:24.5,9360,8,363954,0,9355,394,9360,8,S
2016-03-25 10:48:26,9360,2,363956,-2,9355,401,9360,14,S
2016-03-25 10:48:27,9360,2,363958,-2,9355,401,9360,20,S
2016-03-25 10:48:33,9360,4,363962,0,9355,327,9360,88,S
2016-03-25 10:48:33.5,9360,32,363994,22,9355,327,9360,73,S
2016-03-25 10:48:37,9360,6,364000,6,9355,324,9360,70,S
2016-03-25 10:48:38,9360,4,364004,4,9355,323,9360,68,S
2016-03-25 10:48:39,9360,4,364008,0,9355,311,9360,66,S
2016-03-25 10:48:39.5,9360,2,364010,0,9355,311,9360,68,S
2016-03-25 10:48:40,9360,100,364110,20,9355,303,9360,18,S
2016-03-25 10:48:41,9360,58,364168,34,9360,8,9365,356,S
2016-03-25 10:48:41.5,9360,18,364186,-10,9355,314,9360,5,S
2016-03-25 10:48:42,9360,4,364190,-4,9355,314,9360,5,S
2016-03-25 10:48:44,9360,20,364210,-10,9355,311,9360,16,S
2016-03-25 10:48:44.5,9360,16,364226,-12,9355,307,9360,12,S
2016-03-25 10:48:45,9360,20,364246,-16,9355,307,9360,41,S
2016-03-25 10:48:47,9360,126,364372,90,9360,90,9365,341,S
2016-03-25 10:48:48,9365,10,364382,2,9360,86,9365,336,B
2016-03-25 10:48:50,9360,2,364384,2,9360,134,9365,336,S
2016-03-25 10:48:52,9360,2,364386,2,9360,133,9365,337,S
2016-03-25 10:48:53,9360,4,364390,0,9360,131,9365,337,S
2016-03-25 10:48:54,9360,12,364402,6,9360,125,9365,331,S
2016-03-25 10:48:57,9360,4,364406,4,9360,124,9365,210,S
2016-03-25 10:48:57.5,9360,10,364416,0,9360,119,9365,210,S
2016-03-25 10:48:58,9365,22,364438,10,9360,113,9365,262,B
2016-03-25 10:49:02,9360,2,364440,0,9360,117,9365,268,S
2016-03-25 10:49:03,9360,2,364442,2,9360,116,9365,266,S
2016-03-25 10:49:03.5,9365,2,364444,2,9360,116,9365,267,B
2016-03-25 10:49:07,9360,60,364504,60,9360,96,9365,277,S
2016-03-25 10:49:08,9360,2,364506,2,9360,96,9365,288,S
2016-03-25 10:49:08.5,9360,2,364508,2,9360,95,9365,288,S
2016-03-25 10:49:09,9365,2,364510,0,9360,96,9365,287,B
2016-03-25 10:49:11,9365,218,364728,104,9355,289,9365,285,B
2016-03-25 10:49:12,9360,80,364808,70,9360,8,9365,286,S
2016-03-25 10:49:12.5,9360,42,364850,28,9355,289,9360,1,S
2016-03-25 10:49:13,9360,4,364854,-4,9360,40,9365,285,S
2016-03-25 10:49:16,9365,36,364890,8,9360,45,9365,285,B
2016-03-25 10:49:18,9360,6,364896,0,9360,43,9365,290,S
2016-03-25 10:49:19,9360,2,364898,0,9360,42,9365,293,S
2016-03-25 10:49:20,9360,30,364928,20,9360,27,9365,294,S
2016-03-25 10:49:21,9360,2,364930,2,9360,38,9365,284,S
2016-03-25 10:49:23,9360,8,364938,0,9360,35,9365,241,S
2016-03-25 10:49:30,9360,2,364940,0,9360,165,9365,190,S
2016-03-25 10:49:34,9365,232,365172,188,9360,668,9365,47,B
2016-03-25 10:49:35,9365,90,365262,-40,9365,141,9370,439,B
2016-03-25 10:49:40,9370,52,365314,-6,9365,624,9370,298,B
2016-03-25 10:49:40.5,9365,62,365376,-6,9365,617,9370,255,S
2016-03-25 10:49:41,9370,16,365392,4,9365,611,9370,244,B
2016-03-25 10:49:42,9370,144,365536,42,9365,611,9370,161,B
2016-03-25 10:49:43,9365,2,365538,0,9365,611,9370,156,S
2016-03-25 10:49:44,9370,4,365542,0,9365,618,9370,173,B
2016-03-25 10:49:45,9370,4,365546,-2,9365,618,9370,158,B
2016-03-25 10:49:46,9370,4,365550,-4,9365,618,9370,155,B
2016-03-25 10:49:47,9370,2,365552,-2,9365,618,9370,149,B
2016-03-25 10:49:48,9370,2,365554,0,9365,618,9370,146,B
2016-03-25 10:49:49,9370,30,365584,-30,9365,622,9370,132,B
2016-03-25 10:49:50,9370,2,365586,0,9365,622,9370,132,B
2016-03-25 10:49:51,9370,2,365588,-2,9365,606,9370,144,B
2016-03-25 10:49:51.5,9370,2,365590,-2,9365,606,9370,143,B
2016-03-25 10:49:52,9370,50,365640,-50,9365,607,9370,93,B
2016-03-25 10:49:53,9370,2,365642,0,9365,612,9370,66,B
2016-03-25 10:49:54,9370,16,365658,-8,9365,613,9370,78,B
2016-03-25 10:49:54.5,9370,102,365760,26,9365,613,9370,29,B
2016-03-25 10:49:55,9370,66,365826,14,9365,557,9370,4,B
2016-03-25 10:49:56,9370,44,365870,12,9370,25,9375,362,B
2016-03-25 10:49:56.5,9370,14,365884,10,9370,26,9375,357,B
2016-03-25 10:49:57,9370,34,365918,14,9365,572,9370,186,B
2016-03-25 10:49:59,9370,8,365926,0,9365,72,9370,334,B
2016-03-25 10:50:00,9365,4,365930,-2,9365,56,9370,365,S
2016-03-25 10:50:01,9365,112,366042,-76,9360,215,9365,47,S
2016-03-25 10:50:01.5,9365,124,366166,2,9360,217,9365,49,S
2016-03-25 10:50:02,9365,76,366242,-74,9360,245,9365,14,S
2016-03-25 10:50:02.5,9365,4,366246,0,9360,246,9365,10,S
2016-03-25 10:50:03,9365,6,366252,-6,9360,236,9365,4,S
2016-03-25 10:50:04,9365,8,366260,-8,9365,31,9370,426,S
2016-03-25 10:50:05,9365,2,366262,0,9365,35,9370,424,S
2016-03-25 10:50:05.5,9365,2,366264,0,9365,34,9370,395,S
2016-03-25 10:50:08,9365,6,366270,-6,9365,386,9370,378,S
2016-03-25 10:50:09,9365,20,366290,0,9365,387,9370,378,S
2016-03-25 10:50:11,9370,32,366322,32,9365,491,9370,340,B
2016-03-25 10:50:12,9370,2,366324,0,9365,490,9370,340,B
2016-03-25 10:50:13,9370,12,366336,0,9365,490,9370,334,B
2016-03-25 10:50:15,9365,2,366338,0,9365,490,9370,335,S
2016-03-25 10:50:15.5,9370,22,366360,16,9365,490,9370,324,B
2016-03-25 10:50:17,9370,4,366364,0,9365,491,9370,332,B
2016-03-25 10:50:18,9370,12,366376,2,9365,987,9370,298,B
2016-03-25 10:50:18.5,9370,2,366378,0,9365,887,9370,297,B
2016-03-25 10:50:20,9370,2,366380,2,9365,890,9370,299,B
2016-03-25 10:50:22,9370,2,366382,2,9365,910,9370,299,B
2016-03-25 10:50:22.5,9365,6,366388,0,9365,907,9370,299,S
2016-03-25 10:50:23,9370,2,366390,2,9365,906,9370,298,B
2016-03-25 10:50:23.5,9370,2,366392,2,9365,906,9370,297,B
2016-03-25 10:50:26,9365,14,366406,-14,9365,901,9370,381,S
2016-03-25 10:50:26.5,9370,206,366612,0,9365,901,9370,278,B
2016-03-25 10:50:28,9365,30,366642,10,9365,885,9370,286,S
2016-03-25 10:50:29,9370,6,366648,6,9365,886,9370,283,B
2016-03-25 10:50:29.5,9370,16,366664,0,9365,890,9370,286,B
2016-03-25 10:50:30,9370,12,366676,10,9365,890,9370,280,B
2016-03-25 10:50:31,9370,4,366680,4,9365,890,9370,208,B
2016-03-25 10:50:32,9370,22,366702,-2,9365,891,9370,197,B
2016-03-25 10:50:32.5,9370,34,366736,-2,9365,875,9370,179,B
2016-03-25 10:50:33,9370,4,366740,-2,9365,876,9370,176,B
2016-03-25 10:50:33.5,9370,6,366746,-4,9365,874,9370,174,B
2016-03-25 10:50:35,9370,10,366756,0,9365,874,9370,169,B
2016-03-25 10:50:35.5,9365,4,366760,-2,9365,874,9370,168,S
2016-03-25 10:50:38,9365,2,366762,-2,9365,877,9370,179,S
2016-03-25 10:50:41,9370,2,366764,-2,9365,881,9370,201,B
2016-03-25 10:50:42,9370,12,366776,-2,9365,882,9370,196,B
2016-03-25 10:50:44,9370,4,366780,0,9365,882,9370,212,B
2016-03-25 10:50:45,9365,2,366782,0,9365,882,9370,212,S
2016-03-25 10:50:46,9370,2,366784,-2,9365,883,9370,211,B
2016-03-25 10:50:47,9370,4,366788,-2,9365,883,9370,215,B
2016-03-25 10:50:50,9370,26,366814,-26,9365,885,9370,251,B
2016-03-25 10:50:50.5,9365,2,366816,2,9365,884,9370,251,S
2016-03-25 10:50:54,9370,212,367028,130,9365,884,9370,153,B
2016-03-25 10:50:55,9370,314,367342,8,9370,142,9375,246,B
2016-03-25 10:50:57,9370,2,367344,0,9370,276,9375,186,B
2016-03-25 10:50:58,9375,4,367348,4,9370,281,9375,179,B
2016-03-25 10:50:58.5,9375,26,367374,6,9370,276,9375,175,B
2016-03-25 10:50:59,9375,20,367394,0,9370,276,9375,167,B
2016-03-25 10:51:01,9370,2,367396,2,9370,277,9375,168,S
2016-03-25 10:51:04,9375,4,367400,4,9370,224,9375,178,B
2016-03-25 10:51:05,9375,2,367402,0,9370,224,9375,177,B
2016-03-25 10:51:05.5,9375,2,367404,2,9370,224,9375,176,B
2016-03-25 10:51:08,9375,4,367408,0,9370,231,9375,179,B
2016-03-25 10:51:12,9375,10,367418,8,9370,228,9375,175,B
2016-03-25 10:51:12.5,9375,46,367464,-14,9370,234,9375,155,B
2016-03-25 10:51:15,9375,2,367466,-2,9370,234,9375,154,B
2016-03-25 10:51:15.5,9375,20,367486,-20,9370,234,9375,145,B
2016-03-25 10:51:18,9370,10,367496,-10,9370,230,9375,155,S
2016-03-25 10:51:20,9370,2,367498,0,9370,229,9375,158,S
2016-03-25 10:51:25,9370,458,367956,-314,9365,520,9370,2,S
2016-03-25 10:51:26,9370,104,368060,36,9370,114,9375,178,S
2016-03-25 10:51:26.5,9370,166,368226,-16,9365,396,9375,265,S
2016-03-25 10:51:27,9370,16,368242,12,9365,491,9370,11,S
2016-03-25 10:51:33,9370,22,368264,8,9365,470,9370,373,S
2016-03-25 10:51:37,9370,400,368664,220,9365,473,9370,176,S
2016-03-25 10:51:37.5,9370,368,369032,214,9370,50,9375,280,S
2016-03-25 10:51:38,9370,2,369034,2,9370,67,9375,279,S
2016-03-25 10:51:39,9370,20,369054,20,9370,39,9375,269,S
2016-03-25 10:51:41,9370,2,369056,0,9370,330,9375,262,S
2016-03-25 10:51:42,9370,200,369256,18,9370,230,9375,266,S
2016-03-25 10:51:43,9370,2,369258,-2,9370,233,9375,465,S
2016-03-25 10:51:52,9370,2,369260,-2,9370,260,9375,381,S
2016-03-25 10:51:52.5,9370,20,369280,-20,9370,250,9375,381,S
2016-03-25 10:51:57,9370,2,369282,-2,9370,239,9375,404,S
2016-03-25 10:51:57.5,9370,6,369288,-6,9370,236,9375,404,S
2016-03-25 10:51:59,9370,2,369290,0,9370,307,9375,408,S
2016-03-25 10:52:05,9375,40,369330,0,9370,328,9375,388,B
2016-03-25 10:52:05.5,9370,2,369332,0,9370,327,9375,408,S
2016-03-25 10:52:07,9370,2,369334,-2,9370,326,9375,411,S
2016-03-25 10:52:08,9370,2,369336,0,9370,331,9375,411,S
2016-03-25 10:52:09,9370,40,369376,-40,9370,311,9375,411,S
2016-03-25 10:52:10,9370,86,369462,-86,9370,268,9375,374,S
2016-03-25 10:52:11,9370,534,369996,-88,9365,377,9370,112,S
2016-03-25 10:52:12,9370,4,370000,0,9365,377,9370,78,S
2016-03-25 10:52:16,9365,2,370002,0,9365,366,9370,88,S
2016-03-25 10:52:17,9370,10,370012,-10,9365,365,9370,83,B
2016-03-25 10:52:17.5,9370,2,370014,-2,9365,365,9370,82,B
2016-03-25 10:52:18,9370,8,370022,-8,9365,365,9370,79,B
2016-03-25 10:52:21,9370,10,370032,-10,9365,365,9370,95,B
2016-03-25 10:52:21.5,9370,2,370034,-2,9365,365,9370,99,B
2016-03-25 10:52:23,9365,2,370036,2,9365,364,9370,95,S
2016-03-25 10:52:23.5,9370,2,370038,-2,9365,373,9370,98,B
2016-03-25 10:52:24,9370,30,370068,0,9365,373,9370,83,B
2016-03-25 10:52:26,9370,118,370186,82,9370,103,9375,505,B
2016-03-25 10:52:27,9370,6,370192,0,9370,140,9375,510,B
2016-03-25 10:52:28,9375,2,370194,0,9370,103,9375,534,B
2016-03-25 10:52:29,9370,22,370216,22,9370,94,9375,488,S
2016-03-25 10:52:32,9370,2,370218,0,9370,95,9375,442,S
2016-03-25 10:52:33,9370,6,370224,6,9370,92,9375,442,S
2016-03-25 10:52:34,9370,86,370310,2,9370,47,9375,445,S
2016-03-25 10:52:35,9370,104,370414,36,9365,509,9370,43,S
2016-03-25 10:52:35.5,9365,2,370416,2,9365,508,9370,39,S
2016-03-25 10:52:38,9370,10,370426,-2,9365,510,9370,40,B
2016-03-25 10:52:40,9370,10,370436,0,9365,513,9370,36,B
2016-03-25 10:52:40.5,9370,10,370446,-10,9365,513,9370,29,B
2016-03-25 10:52:44,9370,20,370466,0,9365,503,9370,95,B
2016-03-25 10:52:47,9370,8,370474,6,9365,506,9370,130,B
2016-03-25 10:52:50,9370,2,370476,0,9365,511,9370,259,B
2016-03-25 10:52:53,9370,4,370480,2,9365,522,9370,262,B
2016-03-25 10:52:55,9370,2,370482,0,9365,522,9370,264,B
2016-03-25 10:52:57,9370,20,370502,0,9365,522,9370,255,B
2016-03-25 10:53:00,9370,2,370504,0,9365,524,9370,283,B
2016-03-25 10:53:01,9370,20,370524,0,9365,524,9370,278,B
2016-03-25 10:53:06,9370,2,370526,2,9365,524,9370,113,B
2016-03-25 10:53:06.5,9370,100,370626,80,9365,524,9370,61,B
2016-03-25 10:53:08,9370,104,370730,34,9365,524,9370,7,B
2016-03-25 10:53:08.5,9370,32,370762,12,9365,524,9370,19,B
2016-03-25 10:53:15,9370,8,370770,-4,9365,525,9370,71,B
2016-03-25 10:53:18,9365,20,370790,0,9365,517,9370,71,S
2016-03-25 10:53:18.5,9370,60,370850,-60,9365,517,9370,70,B
2016-03-25 10:53:19,9370,4,370854,-4,9365,517,9370,67,B
2016-03-25 10:53:19.5,9370,4,370858,-4,9365,516,9370,65,B
2016-03-25 10:53:20,9365,2,370860,2,9365,515,9370,65,S
2016-03-25 10:53:21,9370,2,370862,-2,9365,516,9370,64,B
2016-03-25 10:53:25,9365,2,370864,2,9365,515,9370,64,S
2016-03-25 10:53:25.5,9365,34,370898,0,9365,499,9370,63,S
2016-03-25 10:53:26,9370,2,370900,0,9365,499,9370,65,B
2016-03-25 10:53:27,9370,8,370908,-8,9365,499,9370,66,B
2016-03-25 10:53:32,9370,10,370918,0,9365,499,9370,74,B
2016-03-25 10:53:42,9365,20,370938,0,9365,495,9370,112,S
2016-03-25 10:53:44,9370,2,370940,-2,9365,495,9370,111,B
2016-03-25 10:53:44.5,9365,2,370942,0,9365,494,9370,112,S
2016-03-25 10:53:46,9365,2,370944,0,9365,493,9370,125,S
2016-03-25 10:53:51,9365,2,370946,0,9365,487,9370,288,S
2016-03-25 10:53:51.5,9365,2,370948,0,9365,487,9370,288,S
2016-03-25 10:53:52,9365,6,370954,0,9365,484,9370,288,S
2016-03-25 10:53:52.5,9365,78,371032,0,9365,445,9370,289,S
2016-03-25 10:54:02,9365,4,371036,4,9365,442,9370,300,S
2016-03-25 10:54:05,9365,16,371052,0,9365,435,9370,326,S
2016-03-25 10:54:05.5,9365,8,371060,8,9365,401,9370,326,S
2016-03-25 10:54:06,9365,78,371138,0,9365,362,9370,326,S
2016-03-25 10:54:07,9365,724,371862,218,9360,335,9365,332,S
2016-03-25 10:54:07.3333,9360,128,371990,102,9360,239,9365,364,S
2016-03-25 10:54:07.6667,9360,60,372050,36,9360,208,9365,364,S
2016-03-25 10:54:09,9360,2,372052,2,9360,207,9365,364,S
2016-03-25 10:54:13,9365,2,372054,2,9360,223,9365,363,B
2016-03-25 10:54:14,9360,4,372058,0,9360,222,9365,363,S
2016-03-25 10:54:16,9360,2,372060,0,9360,220,9365,364,S
2016-03-25 10:54:19,9360,6,372066,4,9360,219,9365,366,S
2016-03-25 10:54:19.3333,9360,240,372306,128,9360,98,9365,366,S
2016-03-25 10:54:19.6667,9360,54,372360,-34,9360,71,9365,366,S
2016-03-25 10:54:21,9360,20,372380,-20,9360,62,9365,366,S
2016-03-25 10:54:22,9360,2,372382,0,9360,61,9365,366,S
2016-03-25 10:54:23,9360,2,372384,-2,9360,60,9365,366,S
2016-03-25 10:54:25,9360,118,372502,22,9355,322,9360,49,S
2016-03-25 10:54:25.5,9360,56,372558,0,9355,373,9360,26,S
2016-03-25 10:54:26,9360,58,372616,44,9360,9,9365,390,S
2016-03-25 10:54:26.5,9360,18,372634,0,9355,361,9360,51,S
2016-03-25 10:54:28,9360,104,372738,16,9360,52,9365,392,S
2016-03-25 10:54:29,9360,2,372740,2,9360,7,9365,392,S
2016-03-25 10:54:30,9360,12,372752,-10,9360,5,9365,392,S
2016-03-25 10:54:30.5,9360,30,372782,-24,9355,327,9360,149,S
2016-03-25 10:54:32,9355,2,372784,0,9355,318,9360,151,S
2016-03-25 10:54:32.5,9355,10,372794,-10,9355,311,9360,151,S
2016-03-25 10:54:34,9360,20,372814,0,9355,312,9360,143,B
2016-03-25 10:54:35,9355,10,372824,-10,9355,307,9360,143,S
2016-03-25 10:54:37,9360,6,372830,0,9355,308,9360,144,B
2016-03-25 10:54:40,9355,442,373272,158,9355,59,9360,175,S
2016-03-25 10:54:41,9355,120,373392,-50,9350,384,9355,54,S
2016-03-25 10:54:41.5,9350,6,373398,2,9350,356,9355,118,S
2016-03-25 10:54:42,9350,32,373430,-4,9350,435,9355,123,S
2016-03-25 10:54:46,9350,8,373438,0,9350,481,9355,129,S
2016-03-25 10:54:49,9355,44,373482,-2,9350,494,9355,38,B
2016-03-25 10:54:49.5,9355,82,373564,-16,9355,76,9360,236,B
2016-03-25 10:54:50,9355,6,373570,0,9355,47,9360,237,B
2016-03-25 10:54:51,9355,6,373576,-2,9355,17,9360,238,B
2016-03-25 10:54:51.5,9355,34,373610,-12,9350,487,9355,42,B
2016-03-25 10:54:52,9350,6,373616,-6,9350,482,9355,16,S
2016-03-25 10:54:54,9355,2,373618,2,9350,484,9355,20,B
2016-03-25 10:54:55,9355,40,373658,-10,9350,483,9355,1,B
2016-03-25 10:54:57,9355,6,373664,4,9350,475,9355,29,B
2016-03-25 10:54:58,9355,2,373666,2,9350,479,9355,33,B
2016-03-25 10:55:00,9355,76,373742,62,9355,38,9360,256,B
2016-03-25 10:55:01,9360,2,373744,0,9355,93,9360,252,B
2016-03-25 10:55:02,9355,2,373746,2,9355,92,9360,252,S
2016-03-25 10:55:03,9355,16,373762,-12,9355,117,9360,252,S
2016-03-25 10:55:04,9355,4,373766,0,9355,115,9360,257,S
2016-03-25 10:55:07,9360,4,373770,0,9355,123,9360,255,B
2016-03-25 10:55:07.5,9360,8,373778,0,9355,123,9360,251,B
2016-03-25 10:55:14,9360,12,373790,0,9355,142,9360,244,B
2016-03-25 10:55:17,9360,368,374158,-128,9360,37,9365,131,B
2016-03-25 10:55:17.5,9360,2,374160,0,9360,52,9365,142,B
2016-03-25 10:55:22,9360,10,374170,8,9360,190,9365,90,B
2016-03-25 10:55:26,9365,2,374172,2,9360,190,9365,91,B
2016-03-25 10:55:29,9365,2,374174,0,9360,190,9365,100,B
2016-03-25 10:55:29.5,9365,6,374180,6,9360,190,9365,97,B
2016-03-25 10:55:32,9360,10,374190,8,9360,189,9365,94,S
2016-03-25 10:55:33,9365,2,374192,2,9360,190,9365,93,B
2016-03-25 10:55:37,9365,2,374194,0,9360,190,9365,97,B
2016-03-25 10:55:46,9360,2,374196,2,9360,190,9365,106,S
2016-03-25 10:55:47,9360,2,374198,2,9360,189,9365,106,S
2016-03-25 10:55:54,9360,10,374208,8,9360,194,9365,176,S
2016-03-25 10:55:59,9360,324,374532,-152,9360,31,9365,223,S
2016-03-25 10:56:00,9360,62,374594,30,9355,295,9360,162,S
2016-03-25 10:56:00.5,9360,20,374614,20,9355,295,9360,153,S
2016-03-25 10:56:03,9360,4,374618,4,9355,295,9360,250,S
2016-03-25 10:56:06,9360,2,374620,2,9355,245,9360,251,S
2016-03-25 10:56:06.5,9360,2,374622,2,9355,246,9360,250,S
2016-03-25 10:56:08,9360,2,374624,2,9355,245,9360,249,S
2016-03-25 10:56:09,9360,6,374630,0,9355,245,9360,246,S
2016-03-25 10:56:10,9360,2,374632,2,9355,245,9360,245,S
2016-03-25 10:56:18,9360,2,374634,0,9355,250,9360,259,S
2016-03-25 10:56:20,9360,2,374636,-2,9355,250,9360,118,S
2016-03-25 10:56:22,9360,2,374638,0,9355,251,9360,117,S
2016-03-25 10:56:24,9360,68,374706,-62,9355,251,9360,83,S
2016-03-25 10:56:25,9355,2,374708,0,9355,250,9360,84,S
2016-03-25 10:56:30,9355,2,374710,0,9355,320,9360,124,S
2016-03-25 10:56:37,9360,4,374714,0,9355,320,9360,131,B
2016-03-25 10:56:39,9355,282,374996,132,9355,173,9360,143,S
2016-03-25 10:56:40,9355,342,375338,132,9350,431,9355,362,S
2016-03-25 10:56:41,9355,2,375340,0,9350,422,9355,432,S
2016-03-25 10:56:43,9355,10,375350,10,9350,421,9355,427,S
2016-03-25 10:56:45,9350,40,375390,2,9350,404,9355,426,S
2016-03-25 10:56:49,9350,2,375392,2,9350,395,9355,429,S
2016-03-25 10:56:49.5,9350,14,375406,0,9350,387,9355,429,S
2016-03-25 10:56:50,9350,12,375418,6,9350,382,9355,429,S
2016-03-25 10:56:52,9350,24,375442,2,9350,370,9355,451,S
2016-03-25 10:56:53,9350,4,375446,0,9350,382,9355,451,S
2016-03-25 10:56:55,9350,4,375450,-4,9350,380,9355,451,S
2016-03-25 10:56:57,9350,2,375452,0,9350,399,9355,451,S
2016-03-25 10:56:57.5,9350,2,375454,0,9350,396,9355,451,S
2016-03-25 10:56:59,9350,8,375462,0,9350,392,9355,453,S
2016-03-25 10:56:59.5,9350,2,375464,-2,9350,391,9355,453,S
2016-03-25 10:57:00,9350,4,375468,-4,9350,383,9355,463,S
2016-03-25 10:57:01,9350,6,375474,0,9350,380,9355,514,S
2016-03-25 10:57:01.5,9350,26,375500,-6,9350,368,9355,489,S
2016-03-25 10:57:02,9350,202,375702,38,9350,267,9355,485,S
2016-03-25 10:57:03,9350,78,375780,0,9350,228,9355,484,S
2016-03-25 10:57:03.5,9350,56,375836,2,9350,200,9355,495,S
2016-03-25 10:57:04,9350,24,375860,0,9350,188,9355,498,S
2016-03-25 10:57:04.5,9350,2,375862,0,9350,188,9355,496,S
2016-03-25 10:57:05,9350,22,375884,-22,9350,177,9355,495,S
2016-03-25 10:57:06,9350,4,375888,-4,9350,175,9355,496,S
2016-03-25 10:57:09,9350,200,376088,12,9350,116,9355,494,S
2016-03-25 10:57:09.5,9350,6,376094,0,9350,123,9355,495,S
2016-03-25 10:57:10,9350,246,376340,64,9345,232,9350,177,S
2016-03-25 10:57:14,9345,4,376344,-4,9345,199,9350,286,S
2016-03-25 10:57:14.5,9350,4,376348,-2,9345,319,9350,285,B
2016-03-25 10:57:15,9350,10,376358,2,9345,314,9350,280,B
2016-03-25 10:57:16,9350,2,376360,0,9345,324,9350,279,B
2016-03-25 10:57:17,9350,26,376386,-6,9345,324,9350,269,B
2016-03-25 10:57:18,9345,18,376404,4,9345,321,9350,276,S
2016-03-25 10:57:21,9345,2,376406,2,9345,386,9350,288,S
2016-03-25 10:57:24,9350,2,376408,0,9345,387,9350,280,B
2016-03-25 10:57:25,9350,4,376412,-4,9345,392,9350,278,B
2016-03-25 10:57:27,9345,2,376414,2,9345,391,9350,278,S
2016-03-25 10:57:30,9350,2,376416,0,9345,610,9350,283,B
2016-03-25 10:57:31,9350,2,376418,0,9345,619,9350,282,B
2016-03-25 10:57:31.5,9345,2,376420,0,9345,617,9350,302,S
2016-03-25 10:57:32,9350,200,376620,-200,9345,617,9350,202,B
2016-03-25 10:57:32.5,9350,420,377040,10,9350,5,9355,480,B
2016-03-25 10:57:33,9350,10,377050,-2,9350,261,9355,480,B
2016-03-25 10:57:33.5,9350,2,377052,0,9350,263,9355,480,B
2016-03-25 10:57:35,9355,74,377126,-58,9350,224,9355,36,B
2016-03-25 10:57:35.5,9355,2,377128,0,9350,224,9355,45,B
2016-03-25 10:57:37,9350,6,377134,-6,9350,223,9355,33,S
2016-03-25 10:57:39,9355,82,377216,36,9350,264,9355,6,B
2016-03-25 10:57:40,9355,54,377270,0,9355,14,9360,245,B
2016-03-25 10:57:41,9355,114,377384,-10,9350,224,9355,33,B
2016-03-25 10:57:43,9355,4,377388,-4,9350,234,9355,32,B
2016-03-25 10:57:45,9355,2,377390,-2,9350,236,9355,63,B
2016-03-25 10:57:48,9355,6,377396,-6,9350,246,9355,88,B
2016-03-25 10:57:52,9355,4,377400,-4,9350,251,9355,190,B
2016-03-25 10:57:55,9355,24,377424,0,9350,264,9355,188,B
2016-03-25 10:57:56,9355,40,377464,10,9350,266,9355,168,B
2016-03-25 10:58:00,9355,40,377504,36,9350,288,9355,148,B
2016-03-25 10:58:00.5,9355,4,377508,4,9350,309,9355,146,B
2016-03-25 10:58:01,9355,40,377548,26,9350,309,9355,126,B
2016-03-25 10:58:01.5,9355,252,377800,-44,9355,21,9360,298,B
2016-03-25 10:58:02,9355,48,377848,-48,9350,310,9355,59,B
2016-03-25 10:58:04,9355,2,377850,-2,9350,341,9355,60,B
2016-03-25 10:58:19,9355,126,377976,24,9350,412,9355,8,B
2016-03-25 10:58:20,9355,24,378000,-22,9355,115,9360,194,B
2016-03-25 10:58:20.5,9355,40,378040,32,9355,96,9360,169,B
2016-03-25 10:58:22,9355,20,378060,0,9355,86,9360,174,B
2016-03-25 10:58:23,9355,8,378068,8,9355,83,9360,178,B
2016-03-25 10:58:28,9355,2,378070,2,9355,87,9360,143,B
2016-03-25 10:58:32,9360,20,378090,16,9355,115,9360,118,B
2016-03-25 10:58:34,9355,4,378094,0,9355,115,9360,119,S
2016-03-25 10:58:36,9355,2,378096,0,9355,115,9360,121,S
2016-03-25 10:58:43,9355,22,378118,22,9355,104,9360,125,S
2016-03-25 10:58:44,9355,2,378120,2,9355,103,9360,125,S
2016-03-25 10:58:47,9355,2,378122,2,9355,112,9360,147,S
2016-03-25 10:58:48,9360,2,378124,0,9355,112,9360,156,B
2016-03-25 10:58:51,9355,6,378130,0,9355,111,9360,154,S
2016-03-25 10:58:52,9355,2,378132,2,9355,110,9360,154,S
2016-03-25 10:58:53,9355,2,378134,2,9355,109,9360,152,S
2016-03-25 10:58:55,9360,34,378168,-8,9355,109,9360,136,B
2016-03-25 10:58:57,9355,2,378170,2,9355,110,9360,136,S
2016-03-25 10:59:08,9355,2,378172,2,9355,111,9360,138,S
2016-03-25 10:59:11,9360,2,378174,0,9355,113,9360,150,B
2016-03-25 10:59:20,9355,6,378180,0,9355,113,9360,274,S
2016-03-25 10:59:21,9355,14,378194,2,9355,111,9360,269,S
2016-03-25 10:59:23,9355,20,378214,0,9355,102,9360,269,S
2016-03-25 10:59:24,9355,50,378264,0,9355,76,9360,269,S
2016-03-25 10:59:25,9355,10,378274,10,9355,44,9360,269,S
2016-03-25 10:59:27,9355,40,378314,16,9355,22,9360,350,S
2016-03-25 10:59:28,9355,2,378316,-2,9355,41,9360,392,S
2016-03-25 10:59:29,9355,4,378320,0,9355,39,9360,392,S
2016-03-25 10:59:37,9355,60,378380,-46,9350,582,9355,4,S
2016-03-25 10:59:38,9355,8,378388,-6,9350,582,9360,392,S
2016-03-25 10:59:39,9355,24,378412,8,9355,32,9360,392,S
2016-03-25 10:59:39.5,9355,2,378414,0,9355,31,9360,405,S
2016-03-25 10:59:40,9355,20,378434,-20,9350,576,9355,32,S
2016-03-25 10:59:40.5,9355,44,378478,0,9350,576,9355,13,S
2016-03-25 10:59:41,9355,40,378518,40,9355,22,9360,395,S
2016-03-25 10:59:41.3333,9355,2,378520,2,9355,21,9360,401,S
2016-03-25 10:59:41.6667,9360,8,378528,0,9355,14,9360,397,B
2016-03-25 10:59:44,9355,2,378530,0,9355,2,9360,399,S
2016-03-25 10:59:44.5,9360,10,378540,10,9355,2,9360,385,B
2016-03-25 10:59:46,9355,60,378600,-20,9355,5,9360,411,S
2016-03-25 10:59:48,9355,62,378662,-40,9350,458,9355,27,S
2016-03-25 10:59:51,9355,6,378668,0,9350,460,9355,95,S
2016-03-25 10:59:57,9355,22,378690,0,9350,460,9355,42,S
2016-03-25 10:59:59,9355,6,378696,0,9350,462,9355,47,S
2016-03-25 11:00:01,9350,2,378698,-2,9350,460,9355,48,S
2016-03-25 11:00:02,9355,48,378746,12,9350,469,9355,51,B
2016-03-25 11:00:02.5,9350,8,378754,-8,9350,465,9355,53,S
2016-03-25 11:00:03,9355,18,378772,16,9350,464,9355,45,B
2016-03-25 11:00:03.5,9355,4,378776,0,9350,464,9355,43,B
2016-03-25 11:00:05,9355,6,378782,4,9350,464,9355,78,B
2016-03-25 11:00:10,9350,4,378786,-4,9350,444,9355,148,S
2016-03-25 11:00:11,9350,888,379674,382,9345,600,9350,58,S
2016-03-25 11:00:14,9345,2,379676,-2,9345,503,9350,82,S
2016-03-25 11:00:16,9350,4,379680,0,9345,518,9350,80,B
2016-03-25 11:00:17,9345,248,379928,168,9345,513,9350,2,S
2016-03-25 11:00:18,9350,30,379958,-22,9345,502,9350,18,B
2016-03-25 11:00:18.5,9350,58,380016,-4,9350,2,9355,353,B
2016-03-25 11:00:19,9350,8,380024,4,9350,8,9355,357,B
2016-03-25 11:00:20,9350,6,380030,0,9350,7,9355,357,B
2016-03-25 11:00:20.5,9350,4,380034,-4,9350,5,9355,357,B
2016-03-25 11:00:21,9350,10,380044,-4,9345,592,9355,357,B
2016-03-25 11:00:22,9350,8,380052,0,9350,10,9355,336,B
2016-03-25 11:00:22.5,9350,4,380056,2,9350,3,9355,340,B
2016-03-25 11:00:23,9350,26,380082,24,9345,594,9350,72,B
2016-03-25 11:00:24,9345,2,380084,-2,9345,591,9350,72,S
2016-03-25 11:00:27,9345,24,380108,0,9345,576,9350,86,S
2016-03-25 11:00:28,9345,60,380168,0,9345,545,9350,87,S
2016-03-25 11:00:32,9345,12,380180,-2,9345,549,9350,87,S
2016-03-25 11:00:38,9350,40,380220,34,9345,590,9350,19,B
2016-03-25 11:00:39,9350,40,380260,-8,9350,223,9355,173,B
2016-03-25 11:00:40,9350,4,380264,0,9350,223,9355,161,B
2016-03-25 11:00:41,9350,28,380292,0,9350,213,9355,160,B
2016-03-25 11:00:42,9350,2,380294,-2,9350,213,9355,160,B
2016-03-25 11:00:44,9350,2,380296,0,9350,215,9355,160,B
2016-03-25 11:00:47,9350,2,380298,0,9350,208,9355,183,B
2016-03-25 11:00:49,9355,2,380300,0,9350,208,9355,182,B
2016-03-25 11:00:49.5,9350,10,380310,0,9350,203,9355,179,S
2016-03-25 11:00:50,9350,4,380314,-4,9350,201,9355,179,S
2016-03-25 11:00:51,9350,2,380316,0,9350,201,9355,179,S
2016-03-25 11:00:52,9350,12,380328,0,9350,195,9355,172,S
2016-03-25 11:00:57,9350,18,380346,0,9350,191,9355,172,S
2016-03-25 11:00:57.5,9350,30,380376,-30,9350,177,9355,172,S
2016-03-25 11:01:01,9355,2,380378,0,9350,177,9355,175,B
2016-03-25 11:01:01.5,9350,2,380380,-2,9350,176,9355,175,S
2016-03-25 11:01:03,9355,20,380400,10,9350,176,9355,168,B
2016-03-25 11:01:04,9350,40,380440,-40,9350,156,9355,168,S
2016-03-25 11:01:06,9355,2,380442,0,9350,161,9355,167,B
2016-03-25 11:01:22,9355,2,380444,0,9350,187,9355,147,B
2016-03-25 11:01:27,9355,2,380446,0,9350,209,9355,139,B
2016-03-25 11:01:29,9355,88,380534,52,9350,209,9355,68,B
2016-03-25 11:01:29.5,9355,98,380632,10,9355,166,9360,515,B
2016-03-25 11:01:30,9355,30,380662,0,9355,163,9360,486,B
2016-03-25 11:01:31,9355,2,380664,2,9355,136,9360,424,B
2016-03-25 11:01:34,9355,6,380670,6,9355,133,9360,420,B
2016-03-25 11:01:35,9355,6,380676,0,9355,130,9360,420,B
2016-03-25 11:01:35.5,9355,200,380876,0,9355,30,9360,420,B
2016-03-25 11:01:36,9355,58,380934,-30,9350,345,9355,48,B
2016-03-25 11:01:36.5,9355,2,380936,0,9350,339,9355,89,B
2016-03-25 11:01:37,9355,2,380938,0,9350,341,9355,90,B
2016-03-25 11:01:40,9355,6,380944,-6,9350,300,9355,85,B
2016-03-25 11:01:41,9355,134,381078,34,9355,51,9360,414,B
2016-03-25 11:01:42,9355,106,381184,82,9350,193,9355,32,B
2016-03-25 11:01:50,9355,10,381194,-2,9350,128,9355,13,B
2016-03-25 11:01:52,9355,10,381204,2,9355,8,9360,473,B
2016-03-25 11:01:52.5,9355,16,381220,-4,9355,5,9360,475,B
2016-03-25 11:01:54,9355,2,381222,2,9355,7,9360,475,B
2016-03-25 11:01:57,9355,2,381224,0,9355,22,9360,510,B
2016-03-25 11:02:00,9355,12,381236,-4,9355,22,9360,451,B
2016-03-25 11:02:00.5,9355,196,381432,-32,9355,17,9360,461,B
2016-03-25 11:02:01,9355,8,381440,-4,9355,18,9360,461,B
2016-03-25 11:02:02,9355,30,381470,8,9355,3,9360,462,B
2016-03-25 11:02:04,9355,2,381472,0,9355,2,9360,462,B
2016-03-25 11:02:06,9355,32,381504,10,9355,24,9360,462,B
2016-03-25 11:02:06.5,9355,44,381548,40,9355,13,9360,462,B
2016-03-25 11:02:10,9360,2,381550,2,9355,149,9360,461,B
2016-03-25 11:02:13,9355,2,381552,0,9355,154,9360,441,S
2016-03-25 11:02:19,9355,2,381554,0,9355,185,9360,450,S
2016-03-25 11:02:22,9355,6,381560,0,9355,185,9360,450,S
2016-03-25 11:02:29,9360,600,382160,-134,9355,190,9360,155,B
2016-03-25 11:02:30,9360,60,382220,-20,9355,200,9360,103,B
2016-03-25 11:02:33,9360,4,382224,-2,9355,230,9360,102,B
2016-03-25 11:02:34,9360,2,382226,0,9355,232,9360,101,B
2016-03-25 11:02:35,9355,2,382228,0,9355,235,9360,104,S
2016-03-25 11:02:40,9355,2,382230,0,9355,222,9360,127,S
2016-03-25 11:02:43,9355,4,382234,4,9355,160,9360,137,S
2016-03-25 11:02:45,9360,90,382324,82,9355,120,9360,130,B
2016-03-25 11:03:02,9360,2,382326,-2,9355,125,9360,132,B
2016-03-25 11:03:07,9360,34,382360,28,9355,125,9360,119,B
2016-03-25 11:03:08,9360,2,382362,0,9355,125,9360,118,B
2016-03-25 11:03:14,9355,10,382372,10,9355,127,9360,120,S
2016-03-25 11:03:18,9355,6,382378,0,9355,226,9360,121,S
2016-03-25 11:03:36,9355,2,382380,2,9355,118,9360,134,S
2016-03-25 11:03:37,9355,8,382388,0,9355,113,9360,134,S
2016-03-25 11:03:44,9355,40,382428,22,9355,104,9360,147,S
2016-03-25 11:03:45,9355,2,382430,-2,9355,100,9360,147,S
2016-03-25 11:03:48,9355,2,382432,-2,9355,99,9360,147,S
2016-03-25 11:03:48.5,9355,6,382438,2,9355,96,9360,147,S
2016-03-25 11:03:52,9355,2,382440,-2,9355,105,9360,147,S
2016-03-25 11:03:57,9360,4,382444,0,9355,541,9360,146,B
2016-03-25 11:04:02,9355,2,382446,0,9355,108,9360,176,S
2016-03-25 11:04:09,9360,6,382452,0,9355,110,9360,171,B
2016-03-25 11:04:23,9360,34,382486,0,9355,117,9360,155,B
2016-03-25 11:04:38,9360,2,382488,0,9355,128,9360,143,B
2016-03-25 11:04:39,9360,2,382490,0,9355,128,9360,142,B
2016-03-25 11:04:42,9360,120,382610,54,9355,342,9360,82,B
2016-03-25 11:04:42.5,9360,166,382776,-104,9360,90,9365,384,B
2016-03-25 11:04:48,9360,190,382966,-18,9355,124,9360,207,B
2016-03-25 11:04:48.5,9360,4,382970,-4,9355,83,9360,176,B
2016-03-25 11:04:56,9360,2,382972,-2,9355,88,9360,184,B
2016-03-25 11:04:59,9355,2,382974,0,9355,87,9360,184,S
2016-03-25 11:04:59.5,9360,2,382976,-2,9355,96,9360,183,B
2016-03-25 11:05:01,9355,2,382978,0,9355,86,9360,183,S
2016-03-25 11:05:02,9355,4,382982,0,9355,84,9360,183,S
2016-03-25 11:05:07,9355,2,382984,0,9355,85,9360,185,S
2016-03-25 11:05:09,9355,2,382986,0,9355,94,9360,186,S
2016-03-25 11:05:09.5,9355,4,382990,0,9355,97,9360,186,S
2016-03-25 11:05:10,9355,2,382992,0,9355,96,9360,186,S
2016-03-25 11:05:11,9355,2,382994,0,9355,95,9360,195,S
2016-03-25 11:05:13,9355,6,383000,0,9355,105,9360,190,S
2016-03-25 11:05:14,9360,4,383004,-4,9355,105,9360,188,B
2016-03-25 11:05:29,9360,6,383010,-6,9355,109,9360,198,B
2016-03-25 11:05:36,9360,2,383012,0,9355,105,9360,198,B
2016-03-25 11:05:53,9360,2,383014,0,9355,110,9360,198,B
2016-03-25 11:05:54,9360,2,383016,-2,9355,110,9360,198,B
2016-03-25 11:05:57,9360,2,383018,0,9355,112,9360,194,B
2016-03-25 11:06:00,9360,10,383028,-10,9355,112,9360,189,B
2016-03-25 11:06:01,9360,2,383030,-2,9355,115,9360,188,B
2016-03-25 11:06:02,9360,84,383114,0,9355,115,9360,146,B
2016-03-25 11:06:02.5,9360,100,383214,0,9355,115,9360,96,B
2016-03-25 11:06:03,9360,2,383216,0,9355,115,9360,95,B
2016-03-25 11:06:03.5,9360,102,383318,-24,9355,118,9360,44,B
2016-03-25 11:06:04,9360,90,383408,52,9355,118,9360,32,B
2016-03-25 11:06:04.5,9360,116,383524,-12,9360,19,9365,365,B
2016-03-25 11:06:06,9360,30,383554,-6,9355,149,9360,11,B
2016-03-25 11:06:06.3333,9360,36,383590,6,9355,149,9360,34,B
2016-03-25 11:06:06.6667,9360,16,383606,-16,9355,149,9360,35,B
2016-03-25 11:06:07,9360,16,383622,0,9355,149,9360,27,B
2016-03-25 11:06:08,9360,4,383626,-4,9355,149,9360,25,B
2016-03-25 11:06:09,9360,2,383628,0,9355,148,9360,24,B
2016-03-25 11:06:10,9360,4,383632,-4,9355,148,9360,22,B
2016-03-25 11:06:11,9360,4,383636,-2,9355,148,9360,42,B
2016-03-25 11:06:11.5,9360,12,383648,-12,9355,148,9360,36,B
2016-03-25 11:06:12,9360,2,383650,0,9355,151,9360,113,B
2016-03-25 11:06:23,9355,32,383682,-16,9355,93,9360,113,S
2016-03-25 11:06:24,9355,182,383864,-100,9350,323,9355,71,S
2016-03-25 11:06:26,9355,2,383866,-2,9350,302,9355,82,S
2016-03-25 11:06:31,9355,2,383868,-2,9350,256,9355,110,S
2016-03-25 11:06:46,9355,2,383870,-2,9350,271,9355,126,S
2016-03-25 11:06:49,9355,2,383872,-2,9350,271,9355,137,S
2016-03-25 11:06:53,9355,10,383882,0,9350,272,9355,132,S
2016-03-25 11:06:54,9355,2,383884,-2,9350,272,9355,131,S
2016-03-25 11:07:01,9355,2,383886,0,9350,276,9355,131,S
2016-03-25 11:07:04,9355,6,383892,-6,9350,276,9355,129,S
2016-03-25 11:07:08,9350,20,383912,-10,9350,266,9355,131,S
2016-03-25 11:07:10,9355,4,383916,0,9350,265,9355,90,B
2016-03-25 11:07:10.5,9355,2,383918,0,9350,266,9355,89,B
2016-03-25 11:07:12,9350,2,383920,2,9350,265,9355,100,S
2016-03-25 11:07:14,9350,2,383922,0,9350,264,9355,121,S
2016-03-25 11:07:15,9350,112,384034,-54,9350,207,9355,121,S
2016-03-25 11:07:15.5,9350,406,384440,178,9345,570,9350,164,S
2016-03-25 11:07:18,9350,2,384442,-2,9345,550,9350,173,S
2016-03-25 11:07:19,9350,78,384520,-14,9345,568,9350,136,S
2016-03-25 11:07:20,9350,156,384676,76,9345,568,9350,58,S
2016-03-25 11:07:20.5,9350,116,384792,-18,9350,296,9355,151,S
2016-03-25 11:07:24,9350,2,384794,0,9350,298,9355,88,S
2016-03-25 11:07:25,9350,2,384796,0,9350,297,9355,88,S
2016-03-25 11:07:28,9350,2,384798,0,9350,294,9355,99,S
2016-03-25 11:07:28.5,9355,2,384800,-2,9350,295,9355,98,B
2016-03-25 11:07:33,9355,2,384802,0,9350,296,9355,108,B
2016-03-25 11:07:36,9355,4,384806,-4,9350,296,9355,107,B
2016-03-25 11:07:41,9355,2,384808,0,9350,302,9355,98,B
2016-03-25 11:07:41.5,9355,4,384812,0,9350,301,9355,97,B
2016-03-25 11:07:59,9355,2,384814,0,9350,303,9355,92,B
2016-03-25 11:08:00,9350,10,384824,-10,9350,298,9355,92,S
2016-03-25 11:08:13,9350,2,384826,0,9350,302,9355,93,S
2016-03-25 11:08:23,9350,2,384828,0,9350,301,9355,93,S
2016-03-25 11:08:27,9350,2,384830,0,9350,301,9355,129,S
2016-03-25 11:08:27.5,9350,2,384832,0,9350,300,9355,129,S
2016-03-25 11:08:30,9355,10,384842,-6,9350,300,9355,123,B
2016-03-25 11:08:34,9355,172,385014,-48,9350,312,9355,40,B
2016-03-25 11:08:34.5,9360,212,385226,-28,9355,133,9360,285,B
2016-03-25 11:08:35,9355,2,385228,0,9355,111,9360,289,S
2016-03-25 11:08:36,9355,46,385274,-32,9355,88,9360,289,S
2016-03-25 11:08:37,9355,24,385298,0,9355,76,9360,289,S
2016-03-25 11:08:39,9355,152,385450,-6,9350,214,9355,60,S
2016-03-25 11:08:41,9355,14,385464,-12,9350,214,9355,54,S
2016-03-25 11:08:42,9355,4,385468,0,9350,215,9355,52,S
2016-03-25 11:08:55,9350,10,385478,0,9350,212,9355,59,S
2016-03-25 11:08:56,9355,2,385480,0,9350,212,9355,63,B
2016-03-25 11:08:57,9355,50,385530,0,9350,212,9355,42,B
2016-03-25 11:09:02,9350,450,385980,356,9350,9,9355,110,S
2016-03-25 11:09:02.5,9350,58,386038,-34,9345,443,9350,277,S
2016-03-25 11:09:09,9345,20,386058,-20,9345,412,9350,279,S
2016-03-25 11:09:10,9350,8,386066,-8,9345,410,9350,296,B
2016-03-25 11:09:10.5,9345,40,386106,-20,9345,390,9350,296,S
2016-03-25 11:09:11,9345,208,386314,-150,9345,290,9350,291,S
2016-03-25 11:09:12,9345,80,386394,-80,9345,250,9350,291,S
2016-03-25 11:09:12.5,9345,24,386418,-20,9345,248,9350,291,S
2016-03-25 11:09:14,9350,2,386420,0,9345,248,9350,290,B
2016-03-25 11:09:16,9345,10,386430,0,9345,262,9350,299,S
2016-03-25 11:09:17,9345,12,386442,-12,9345,257,9350,300,S
2016-03-25 11:09:18,9345,22,386464,-20,9345,256,9350,291,S
2016-03-25 11:09:22,9350,2,386466,-2,9345,258,9350,261,B
2016-03-25 11:09:23,9350,2,386468,-2,9345,258,9350,261,B
2016-03-25 11:09:24,9345,2,386470,-2,9345,257,9350,261,S
2016-03-25 11:09:26,9345,114,386584,-68,9345,215,9350,272,S
2016-03-25 11:09:27,9345,4,386588,4,9345,213,9350,272,S
2016-03-25 11:09:27.5,9345,12,386600,4,9345,207,9350,273,S
2016-03-25 11:09:28,9345,2,386602,0,9345,206,9350,273,S
2016-03-25 11:09:29,9345,2,386604,0,9345,205,9350,273,S
2016-03-25 11:09:30,9345,2,386606,0,9345,204,9350,274,S
2016-03-25 11:09:31,9345,2,386608,0,9345,203,9350,283,S
2016-03-25 11:09:32,9345,2,386610,0,9345,203,9350,283,S
2016-03-25 11:09:33,9345,2,386612,-2,9345,205,9350,283,S
2016-03-25 11:09:36,9345,38,386650,2,9345,185,9350,286,S
2016-03-25 11:09:37,9345,146,386796,-20,9345,112,9350,284,S
2016-03-25 11:09:38,9345,258,387054,74,9340,760,9345,7,S
2016-03-25 11:09:38.5,9340,10,387064,2,9340,747,9345,42,S
2016-03-25 11:09:39,9340,6,387070,0,9340,744,9345,47,S
2016-03-25 11:09:40,9345,2,387072,0,9340,743,9345,39,B
2016-03-25 11:09:41,9345,2,387074,2,9340,753,9345,39,B
2016-03-25 11:09:42,9345,2,387076,0,9340,753,9345,54,B
2016-03-25 11:09:44,9345,2,387078,2,9340,755,9345,55,B
2016-03-25 11:09:46,9345,132,387210,-38,9340,760,9345,1,B
2016-03-25 11:09:46.5,9345,6,387216,4,9345,52,9350,293,B
2016-03-25 11:09:47,9345,2,387218,2,9345,103,9350,304,B
2016-03-25 11:09:49,9345,4,387222,4,9345,102,9350,304,B
2016-03-25 11:09:50,9345,2,387224,2,9345,110,9350,285,B
2016-03-25 11:09:51,9345,2,387226,2,9345,125,9350,295,B
2016-03-25 11:09:55,9345,10,387236,0,9345,130,9350,275,B
2016-03-25 11:09:55.5,9345,26,387262,14,9345,120,9350,272,B
2016-03-25 11:09:57,9345,8,387270,0,9345,141,9350,273,B
2016-03-25 11:09:58,9345,2,387272,2,9345,140,9350,273,B
2016-03-25 11:09:58.5,9345,2,387274,2,9345,139,9350,274,B
2016-03-25 11:10:01,9350,22,387296,-2,9345,132,9350,272,B
2016-03-25 11:10:01.5,9350,10,387306,-10,9345,133,9350,267,B
2016-03-25 11:10:03,9345,4,387310,4,9345,133,9350,268,S
2016-03-25 11:10:03.5,9350,2,387312,-2,9345,133,9350,267,B
2016-03-25 11:10:05,9345,4,387316,2,9345,131,9350,267,S
2016-03-25 11:10:06,9345,42,387358,20,9345,112,9350,267,S
2016-03-25 11:10:12,9345,218,387576,66,9345,95,9350,149,S
2016-03-25 11:10:13,9350,206,387782,-8,9350,40,9355,235,B
2016-03-25 11:10:13.5,9350,20,387802,20,9350,77,9355,214,B
2016-03-25 11:10:14,9355,44,387846,-2,9350,74,9355,182,B
2016-03-25 11:10:14.5,9350,2,387848,2,9350,78,9355,182,S
2016-03-25 11:10:16,9350,40,387888,-16,9350,311,9355,183,S
2016-03-25 11:10:18,9355,2,387890,0,9350,311,9355,182,B
2016-03-25 11:10:19,9350,10,387900,-10,9350,307,9355,182,S
2016-03-25 11:10:24,9350,2,387902,0,9350,45,9355,198,S
2016-03-25 11:10:24.5,9355,2,387904,0,9350,45,9355,201,B
2016-03-25 11:10:26,9350,20,387924,-14,9350,34,9355,202,S
2016-03-25 11:10:27,9355,80,388004,16,9350,37,9355,166,B
2016-03-25 11:10:28,9355,2,388006,0,9350,37,9355,166,B
2016-03-25 11:10:29,9350,2,388008,-2,9350,46,9355,166,S
2016-03-25 11:10:35,9350,198,388206,38,9345,214,9350,2,S
2016-03-25 11:10:36,9350,16,388222,2,9350,24,9355,157,S
2016-03-25 11:10:37,9350,8,388230,-2,9345,233,9350,34,S
2016-03-25 11:10:38,9350,16,388246,4,9350,13,9355,172,S
2016-03-25 11:10:39,9350,6,388252,0,9350,15,9355,173,S
2016-03-25 11:10:41,9350,6,388258,2,9350,18,9355,175,S
2016-03-25 11:10:44,9350,24,388282,-8,9350,6,9355,176,S
2016-03-25 11:10:51,9350,10,388292,6,9350,54,9355,176,S
2016-03-25 11:10:53,9355,30,388322,30,9350,54,9355,161,B
2016-03-25 11:10:54,9350,4,388326,-4,9345,263,9350,4,S
2016-03-25 11:10:54.5,9350,20,388346,-4,9350,7,9355,160,S
2016-03-25 11:10:57,9350,44,388390,-20,9345,258,9350,7,S
2016-03-25 11:11:00,9350,4,388394,-2,9345,157,9350,20,S
2016-03-25 11:11:02,9350,4,388398,-4,9345,159,9350,18,S
2016-03-25 11:11:03,9350,2,388400,0,9345,159,9350,17,S
2016-03-25 11:11:08,9350,24,388424,8,9345,159,9350,7,S
2016-03-25 11:11:09,9350,14,388438,6,9350,96,9355,165,S
2016-03-25 11:11:10,9350,56,388494,0,9350,68,9355,174,S
2016-03-25 11:11:14,9350,4,388498,0,9350,79,9355,176,S
2016-03-25 11:11:15,9350,10,388508,10,9350,74,9355,176,S
2016-03-25 11:11:26,9350,162,388670,-36,9350,9,9355,193,S
2016-03-25 11:11:26.5,9350,18,388688,-6,9345,173,9350,76,S
2016-03-25 11:11:27,9350,100,388788,100,9345,331,9350,26,S
2016-03-25 11:11:27.5,9350,50,388838,30,9350,42,9355,178,S
2016-03-25 11:11:29,9350,116,388954,-68,9350,20,9355,179,S
2016-03-25 11:11:30,9350,2,388956,0,9350,7,9355,179,S
2016-03-25 11:11:30.5,9355,6,388962,0,9350,7,9355,176,B
2016-03-25 11:11:34,9350,22,388984,-10,9350,55,9355,178,S
2016-03-25 11:11:39,9350,4,388988,0,9350,58,9355,185,S
2016-03-25 11:11:41,9355,8,388996,0,9350,58,9355,180,B
2016-03-25 11:11:43,9355,2,388998,2,9350,62,9355,199,B
2016-03-25 11:11:44,9350,4,389002,0,9350,60,9355,200,S
2016-03-25 11:11:45,9355,40,389042,20,9350,60,9355,180,B
2016-03-25 11:11:47,9350,10,389052,-2,9350,66,9355,175,S
2016-03-25 11:11:48,9355,100,389152,100,9350,66,9355,125,B
2016-03-25 11:11:49,9355,102,389254,60,9350,86,9355,78,B
2016-03-25 11:11:50,9355,122,389376,28,9355,2,9360,344,B
2016-03-25 11:11:50.5,9355,10,389386,0,9350,178,9355,54,B
2016-03-25 11:11:51,9355,2,389388,0,9350,430,9355,53,B
2016-03-25 11:11:52,9355,2,389390,2,9350,460,9355,52,B
2016-03-25 11:11:53,9355,28,389418,16,9355,14,9360,344,B
2016-03-25 11:11:53.5,9355,20,389438,0,9355,7,9360,346,B
2016-03-25 11:11:56,9355,10,389448,-4,9350,464,9355,27,B
2016-03-25 11:11:59,9355,116,389564,2,9350,466,9355,29,B
2016-03-25 11:12:01,9350,4,389568,0,9350,464,9355,86,S
2016-03-25 11:12:01.5,9355,2,389570,0,9350,466,9355,86,B
2016-03-25 11:12:02,9355,12,389582,0,9350,461,9355,85,B
2016-03-25 11:12:04,9355,2,389584,0,9350,461,9355,90,B
2016-03-25 11:12:06,9355,182,389766,-108,9355,10,9360,360,B
2016-03-25 11:12:06.5,9355,34,389800,-32,9350,461,9355,177,B
2016-03-25 11:12:08,9350,924,390724,28,9345,279,9350,94,S
2016-03-25 11:12:10,9350,102,390826,80,9345,259,9350,12,S
2016-03-25 11:12:11,9345,32,390858,-6,9345,244,9350,308,S
2016-03-25 11:12:11.5,9340,508,391366,-28,9340,750,9345,16,S
2016-03-25 11:12:13,9340,2,391368,2,9340,756,9345,27,S
2016-03-25 11:12:13.5,9345,10,391378,-2,9340,756,9345,22,B
2016-03-25 11:12:15,9340,20,391398,0,9340,747,9345,39,S
2016-03-25 11:12:16,9345,2,391400,0,9340,747,9345,38,B
2016-03-25 11:12:17,9345,20,391420,0,9340,697,9345,28,B
2016-03-25 11:12:18,9345,118,391538,30,9340,697,9345,30,B
2016-03-25 11:12:19,9345,10,391548,0,9345,83,9350,384,B
2016-03-25 11:12:20,9345,2,391550,0,9345,244,9350,384,B
2016-03-25 11:12:22,9345,2,391552,0,9345,253,9350,366,B
2016-03-25 11:12:38,9345,10,391562,0,9345,118,9350,355,B
2016-03-25 11:12:38.5,9345,80,391642,-80,9345,77,9350,355,B
2016-03-25 11:12:39,9345,6,391648,-6,9345,74,9350,355,B
2016-03-25 11:12:43,9350,100,391748,78,9345,74,9350,305,B
2016-03-25 11:12:45,9345,20,391768,0,9345,67,9350,305,S
2016-03-25 11:12:48,9345,20,391788,0,9345,57,9350,307,S
2016-03-25 11:12:53,9345,14,391802,-14,9345,49,9350,307,S
2016-03-25 11:12:54,9350,2,391804,2,9345,79,9350,306,B
2016-03-25 11:12:59,9345,6,391810,-6,9345,91,9350,310,S
2016-03-25 11:13:00,9350,2,391812,0,9345,91,9350,309,B
2016-03-25 11:13:01,9345,2,391814,0,9345,90,9350,309,S
2016-03-25 11:13:10,9350,30,391844,30,9345,100,9350,296,B
2016-03-25 11:13:11,9350,322,392166,0,9345,110,9350,78,B
2016-03-25 11:13:12,9350,158,392324,-14,9350,86,9355,158,B
2016-03-25 11:13:15,9355,10,392334,6,9350,109,9355,144,B
2016-03-25 11:13:20,9355,68,392402,42,9350,374,9355,79,B
2016-03-25 11:13:21,9355,108,392510,-4,9355,60,9360,442,B
2016-03-25 11:13:21.5,9355,20,392530,0,9355,47,9360,444,B
2016-03-25 11:13:25,9355,100,392630,6,9350,366,9355,112,B
2016-03-25 11:13:26,9355,2,392632,2,9350,368,9355,256,B
2016-03-25 11:13:26.5,9355,2,392634,2,9350,368,9355,256,B
2016-03-25 11:13:27,9355,6,392640,6,9350,368,9355,253,B
2016-03-25 11:13:27.5,9355,24,392664,22,9350,358,9355,251,B
2016-03-25 11:13:28,9355,200,392864,200,9350,358,9355,151,B
2016-03-25 11:13:28.5,9355,298,393162,10,9350,358,9360,436,B
2016-03-25 11:13:29,9355,4,393166,0,9355,14,9360,412,B
2016-03-25 11:13:29.5,9355,2,393168,0,9355,15,9360,411,B
2016-03-25 11:13:30,9355,4,393172,-2,9355,13,9360,409,B
2016-03-25 11:13:32,9355,8,393180,0,9355,13,9360,412,B
2016-03-25 11:13:34,9360,4,393184,0,9355,13,9360,409,B
2016-03-25 11:13:34.5,9355,8,393192,-8,9355,11,9360,409,S
2016-03-25 11:13:35,9355,2,393194,0,9355,10,9360,408,S
2016-03-25 11:13:36,9355,2,393196,0,9355,9,9360,406,S
2016-03-25 11:13:37,9355,4,393200,-4,9355,7,9360,406,S
2016-03-25 11:13:38,9355,6,393206,2,9355,8,9360,402,S
2016-03-25 11:13:39,9355,2,393208,2,9355,35,9360,402,S
2016-03-25 11:13:39.5,9360,10,393218,0,9355,41,9360,397,B
2016-03-25 11:13:40,9360,2,393220,2,9355,45,9360,396,B
2016-03-25 11:13:41,9355,4,393224,2,9355,44,9360,396,S
2016-03-25 11:13:41.5,9360,4,393228,0,9355,52,9360,394,B
2016-03-25 11:13:42,9360,2,393230,2,9355,94,9360,394,B
2016-03-25 11:13:44,9360,2,393232,0,9355,118,9360,340,B
2016-03-25 11:13:46,9360,2,393234,0,9355,122,9360,329,B
2016-03-25 11:13:47,9360,2,393236,2,9355,124,9360,305,B
2016-03-25 11:13:50,9360,2,393238,2,9355,135,9360,282,B
2016-03-25 11:13:52,9360,4,393242,0,9355,226,9360,284,B
2016-03-25 11:13:52.5,9360,2,393244,0,9355,229,9360,283,B
2016-03-25 11:13:55,9360,4,393248,4,9355,232,9360,280,B
2016-03-25 11:13:56,9360,200,393448,76,9355,235,9360,180,B
2016-03-25 11:13:56.5,9360,142,393590,74,9355,235,9360,120,B
2016-03-25 11:13:57,9360,26,393616,2,9355,235,9360,107,B
2016-03-25 11:13:58,9360,2,393618,2,9355,235,9360,106,B
2016-03-25 11:13:59,9360,4,393622,2,9355,237,9360,104,B
2016-03-25 11:13:59.5,9360,208,393830,188,9360,100,9365,391,B
2016-03-25 11:14:00,9365,20,393850,0,9360,100,9365,366,B
2016-03-25 11:14:01,9365,40,393890,-4,9360,112,9365,326,B
2016-03-25 11:14:01.5,9365,4,393894,0,9360,113,9365,323,B
2016-03-25 11:14:02,9365,2,393896,0,9360,123,9365,322,B
2016-03-25 11:14:03,9365,2,393898,0,9360,122,9365,317,B
2016-03-25 11:14:05,9365,8,393906,2,9360,122,9365,327,B
2016-03-25 11:14:05.5,9360,100,394006,0,9360,72,9365,327,S
2016-03-25 11:14:06,9360,128,394134,-34,9360,8,9365,327,S
2016-03-25 11:14:06.5,9360,18,394152,2,9355,325,9360,78,S
2016-03-25 11:14:09,9360,2,394154,2,9355,325,9360,87,S
2016-03-25 11:14:09.5,9360,2,394156,0,9355,325,9360,86,S
2016-03-25 11:14:12,9360,4,394160,0,9355,325,9360,110,S
2016-03-25 11:14:13,9360,2,394162,0,9355,323,9360,109,S
2016-03-25 11:14:17,9360,4,394166,2,9355,310,9360,138,S
2016-03-25 11:14:19,9360,4,394170,4,9355,311,9360,137,S
2016-03-25 11:14:29,9355,140,394310,-8,9355,235,9360,154,S
2016-03-25 11:14:31,9355,2,394312,0,9355,230,9360,160,S
2016-03-25 11:14:35,9355,6,394318,0,9355,228,9360,167,S
2016-03-25 11:14:36,9355,2,394320,0,9355,227,9360,167,S
2016-03-25 11:14:37,9355,2,394322,0,9355,226,9360,167,S
2016-03-25 11:14:41,9355,10,394332,0,9355,211,9360,121,S
2016-03-25 11:14:43,9360,244,394576,100,9360,20,9365,274,B
2016-03-25 11:14:43.5,9360,50,394626,-46,9355,210,9360,11,B
2016-03-25 11:14:45,9360,2,394628,0,9355,210,9360,31,B
2016-03-25 11:14:45.5,9360,68,394696,-66,9360,130,9365,172,B
2016-03-25 11:14:46,9360,10,394706,-8,9360,131,9365,168,B
2016-03-25 11:14:48,9360,2,394708,0,9360,131,9365,168,B
2016-03-25 11:14:49,9365,20,394728,-20,9360,158,9365,158,B
2016-03-25 11:14:51,9360,202,394930,148,9360,158,9365,55,S
2016-03-25 11:14:51.5,9360,4,394934,0,9360,168,9365,57,S
2016-03-25 11:14:53,9365,2,394936,0,9360,168,9365,158,B
2016-03-25 11:14:55,9365,2,394938,2,9360,168,9365,258,B
2016-03-25 11:14:56,9360,2,394940,0,9360,167,9365,259,S
2016-03-25 11:14:56.5,9365,2,394942,2,9360,167,9365,258,B
2016-03-25 11:14:58,9365,2,394944,2,9360,51,9365,278,B
2016-03-25 11:14:58.5,9365,4,394948,0,9360,51,9365,276,B
2016-03-25 11:14:59,9360,2,394950,0,9360,52,9365,276,S
2016-03-25 11:14:59.5,9360,10,394960,0,9360,48,9365,276,S
2016-03-25 11:15:00,9365,260,395220,72,9360,80,9365,148,B
2016-03-25 11:15:01,9365,10,395230,-2,9360,84,9365,146,B
2016-03-25 11:15:01.5,9360,8,395238,2,9360,85,9365,143,S
2016-03-25 11:15:02,9360,2,395240,0,9360,86,9365,143,S
2016-03-25 11:15:06,9365,2,395242,-2,9360,87,9365,142,B
2016-03-25 11:15:06.5,9365,6,395248,0,9360,87,9365,140,B
2016-03-25 11:15:07,9360,8,395256,0,9360,82,9365,167,S
2016-03-25 11:15:08,9365,2,395258,-2,9360,83,9365,171,B
2016-03-25 11:15:11,9365,200,395458,174,9360,105,9365,76,B
2016-03-25 11:15:13,9365,2,395460,0,9360,118,9365,75,B
2016-03-25 11:15:13.5,9365,172,395632,70,9365,22,9370,532,B
2016-03-25 11:15:14,9365,160,395792,0,9360,121,9365,167,B
2016-03-25 11:15:14.5,9360,16,395808,4,9360,119,9365,162,S
2016-03-25 11:15:15,9365,8,395816,-2,9360,116,9365,158,B
2016-03-25 11:15:15.5,9365,100,395916,-100,9360,116,9365,108,B
2016-03-25 11:15:18,9365,10,395926,0,9360,118,9365,130,B
2016-03-25 11:15:19,9365,2,395928,-2,9360,118,9365,139,B
2016-03-25 11:15:23,9365,40,395968,-20,9360,160,9365,139,B
2016-03-25 11:15:24,9365,2,395970,-2,9360,170,9365,139,B
2016-03-25 11:15:27,9365,40,396010,-40,9360,177,9365,126,B
2016-03-25 11:15:28,9365,10,396020,-10,9360,180,9365,121,B
2016-03-25 11:15:34,9365,4,396024,-4,9360,133,9365,136,B
2016-03-25 11:15:36,9365,42,396066,-22,9360,133,9365,116,B
2016-03-25 11:15:38,9365,2,396068,2,9360,133,9365,116,B
2016-03-25 11:15:39,9365,2,396070,0,9360,133,9365,115,B
2016-03-25 11:15:41,9365,2,396072,0,9360,140,9365,115,B
2016-03-25 11:15:47,9360,4,396076,4,9360,177,9365,116,S
2016-03-25 11:15:50,9365,62,396138,56,9360,142,9365,86,B
2016-03-25 11:15:51,9365,8,396146,0,9360,113,9365,82,B
2016-03-25 11:15:52,9365,40,396186,-40,9360,113,9365,62,B
2016-03-25 11:15:56,9365,202,396388,64,9360,128,9365,23,B
2016-03-25 11:15:57,9365,102,396490,22,9360,121,9365,22,B
2016-03-25 11:15:58,9365,14,396504,-14,9365,13,9370,414,B
2016-03-25 11:15:59,9365,16,396520,0,9365,5,9370,391,B
2016-03-25 11:16:01,9365,44,396564,-22,9365,20,9370,387,B
2016-03-25 11:16:02,9365,62,396626,-14,9360,180,9365,5,B
2016-03-25 11:16:02.5,9365,8,396634,0,9360,174,9365,48,B
2016-03-25 11:16:03,9365,40,396674,-4,9360,180,9365,41,B
2016-03-25 11:16:03.5,9365,24,396698,24,9360,185,9365,29,B
2016-03-25 11:16:04,9365,2,396700,0,9360,185,9365,28,B
2016-03-25 11:16:05,9365,2,396702,0,9360,215,9365,27,B
2016-03-25 11:16:06,9365,2,396704,2,9360,194,9365,27,B
2016-03-25 11:16:07,9365,56,396760,-30,9365,24,9370,387,B
2016-03-25 11:16:08,9365,42,396802,-20,9365,9,9370,387,B
2016-03-25 11:16:08.5,9365,2,396804,0,9365,18,9370,387,B
2016-03-25 11:16:09,9365,40,396844,-2,9360,678,9365,20,B
2016-03-25 11:16:09.5,9365,20,396864,-20,9360,685,9365,61,B
2016-03-25 11:16:10,9365,62,396926,2,9360,252,9365,31,B
2016-03-25 11:16:11,9365,20,396946,10,9360,252,9365,2,B
2016-03-25 11:16:11.5,9365,2,396948,0,9360,252,9365,1,B
2016-03-25 11:16:12,9365,16,396964,-16,9365,7,9370,390,B
2016-03-25 11:16:12.5,9365,26,396990,16,9360,246,9365,29,B
2016-03-25 11:16:13,9365,54,397044,-34,9365,6,9370,390,B
2016-03-25 11:16:14,9365,24,397068,4,9360,249,9365,13,B
2016-03-25 11:16:14.5,9365,34,397102,26,9365,46,9370,403,B
2016-03-25 11:16:15,9370,10,397112,0,9365,46,9370,399,B
2016-03-25 11:16:15.5,9370,16,397128,0,9365,56,9370,393,B
2016-03-25 11:16:16,9365,2,397130,0,9365,56,9370,393,S
2016-03-25 11:16:18,9370,2,397132,0,9365,57,9370,391,B
2016-03-25 11:16:21,9365,4,397136,4,9365,61,9370,391,S
2016-03-25 11:16:22,9370,2,397138,0,9365,75,9370,390,B
2016-03-25 11:16:22.5,9365,4,397142,0,9365,73,9370,391,S
2016-03-25 11:16:24,9365,94,397236,-30,9360,247,9365,68,S
2016-03-25 11:16:24.5,9365,6,397242,-2,9360,232,9365,65,S
2016-03-25 11:16:25,9365,46,397288,-46,9360,232,9365,49,S
2016-03-25 11:16:26,9365,98,397386,8,9365,53,9370,402,S
2016-03-25 11:16:26.5,9365,114,397500,52,9360,245,9365,33,S
2016-03-25 11:16:27,9360,4,397504,4,9360,228,9365,33,S
2016-03-25 11:16:27.5,9365,2,397506,0,9360,248,9365,32,B
2016-03-25 11:16:28,9365,2,397508,0,9360,249,9365,33,B
2016-03-25 11:16:29,9365,6,397514,-6,9360,249,9365,33,B
2016-03-25 11:16:34,9365,372,397886,-178,9365,14,9370,400,B
2016-03-25 11:16:34.5,9365,98,397984,-66,9365,8,9370,401,B
2016-03-25 11:16:35,9365,12,397996,-6,9360,256,9365,156,B
2016-03-25 11:16:36,9365,70,398066,-40,9360,236,9365,123,B
2016-03-25 11:16:39,9360,40,398106,0,9360,197,9365,176,S
2016-03-25 11:16:45,9365,2,398108,-2,9360,201,9365,190,B
2016-03-25 11:16:48,9365,104,398212,-24,9360,208,9365,135,B
2016-03-25 11:16:48.5,9360,2,398214,0,9360,205,9365,134,S
2016-03-25 11:16:49,9365,276,398490,-108,9360,206,9365,11,B
2016-03-25 11:16:50,9365,34,398524,-4,9365,209,9370,403,B
2016-03-25 11:16:53,9365,2,398526,0,9365,216,9370,403,B
2016-03-25 11:16:54,9365,2,398528,0,9365,215,9370,403,B
2016-03-25 11:16:55,9370,4,398532,-4,9365,215,9370,400,B
2016-03-25 11:16:56,9365,4,398536,-4,9365,213,9370,401,S
2016-03-25 11:17:00,9365,2,398538,0,9365,223,9370,402,S
2016-03-25 11:17:02,9370,42,398580,0,9365,226,9370,381,B
2016-03-25 11:17:03,9370,202,398782,-32,9365,237,9370,278,B
2016-03-25 11:17:05,9370,96,398878,0,9365,190,9370,229,B
2016-03-25 11:17:09,9370,4,398882,4,9365,192,9370,209,B
2016-03-25 11:17:09.5,9365,2,398884,0,9365,191,9370,209,S
2016-03-25 11:17:11,9365,8,398892,-8,9365,178,9370,210,S
2016-03-25 11:17:12,9365,12,398904,-12,9365,192,9370,262,S
2016-03-25 11:17:13,9370,2,398906,-2,9365,192,9370,261,B
2016-03-25 11:17:14,9370,2,398908,0,9365,193,9370,262,B
2016-03-25 11:17:16,9370,10,398918,0,9365,198,9370,257,B
2016-03-25 11:17:16.5,9365,4,398922,0,9365,217,9370,257,S
2016-03-25 11:17:21,9365,2,398924,0,9365,218,9370,222,S
2016-03-25 11:17:23,9370,30,398954,0,9365,219,9370,207,B
2016-03-25 11:17:24,9370,4,398958,0,9365,209,9370,207,B
2016-03-25 11:17:26,9370,140,399098,0,9365,209,9370,125,B
2016-03-25 11:17:27,9370,22,399120,-12,9365,211,9370,114,B
2016-03-25 11:17:28,9370,20,399140,6,9365,211,9370,109,B
2016-03-25 11:17:29,9365,2,399142,-2,9365,210,9370,109,S
2016-03-25 11:17:30,9370,2,399144,0,9365,210,9370,233,B
2016-03-25 11:17:35,9365,160,399304,-108,9365,165,9370,236,S
2016-03-25 11:17:38,9365,8,399312,2,9365,90,9370,237,S
2016-03-25 11:17:39,9365,2,399314,0,9365,89,9370,242,S
2016-03-25 11:17:40,9365,100,399414,0,9365,39,9370,245,S
2016-03-25 11:17:40.5,9365,76,399490,-44,9360,363,9365,126,S
2016-03-25 11:17:41,9365,14,399504,4,9360,361,9365,136,S
2016-03-25 11:17:41.5,9365,4,399508,-2,9360,361,9365,134,S
2016-03-25 11:17:43,9365,2,399510,-2,9360,361,9365,133,S
2016-03-25 11:17:44,9365,2,399512,-2,9360,363,9365,136,S
2016-03-25 11:17:46,9365,2,399514,-2,9360,363,9365,135,S
2016-03-25 11:17:46.5,9365,40,399554,0,9360,363,9365,116,S
2016-03-25 11:17:47,9365,230,399784,136,9365,84,9370,133,S
2016-03-25 11:17:48,9365,4,399788,4,9365,65,9370,160,S
2016-03-25 11:17:50,9365,4,399792,4,9365,69,9370,166,S
2016-03-25 11:17:53,9365,10,399802,10,9365,82,9370,191,S
2016-03-25 11:17:57,9365,2,399804,2,9365,111,9370,192,S
2016-03-25 11:17:59,9365,20,399824,20,9365,102,9370,192,S
2016-03-25 11:18:07,9365,4,399828,0,9365,128,9370,172,S
2016-03-25 11:18:17,9365,4,399832,0,9365,168,9370,177,S
2016-03-25 11:18:25,9365,2,399834,0,9365,172,9370,183,S
2016-03-25 11:18:27,9365,2,399836,0,9365,176,9370,232,S
2016-03-25 11:18:27.5,9370,2,399838,-2,9365,175,9370,232,B
2016-03-25 11:18:28,9365,2,399840,0,9365,151,9370,233,S
2016-03-25 11:18:34,9370,4,399844,-4,9365,204,9370,231,B
2016-03-25 11:18:37,9370,22,399866,4,9365,225,9370,273,B
2016-03-25 11:18:39,9370,4,399870,-4,9365,225,9370,276,B
2016-03-25 11:18:40,9365,10,399880,4,9365,220,9370,278,S
2016-03-25 11:18:43,9365,40,399920,26,9365,221,9370,277,S
2016-03-25 11:18:43.5,9370,2,399922,2,9365,221,9370,276,B
2016-03-25 11:18:44,9370,60,399982,24,9365,221,9370,246,B
2016-03-25 11:18:47,9370,490,400472,212,9370,70,9375,428,B
2016-03-25 11:18:48,9370,20,400492,0,9370,63,9375,392,B
2016-03-25 11:18:52,9370,2,400494,0,9370,73,9375,411,B
2016-03-25 11:18:54,9370,2,400496,2,9370,104,9375,411,B
2016-03-25 11:18:55,9375,16,400512,16,9370,98,9375,409,B
2016-03-25 11:18:55.5,9375,2,400514,0,9370,122,9375,409,B
2016-03-25 11:18:56,9375,2,400516,0,9370,122,9375,408,B
2016-03-25 11:18:56.5,9375,2,400518,0,9370,123,9375,407,B
2016-03-25 11:18:57,9370,2,400520,2,9370,112,9375,407,S
2016-03-25 11:18:59,9375,20,400540,0,9370,122,9375,393,B
2016-03-25 11:19:00,9375,30,400570,-10,9370,125,9375,378,B
2016-03-25 11:19:03,9375,4,400574,-4,9370,137,9375,376,B
2016-03-25 11:19:05,9370,20,400594,20,9370,137,9375,377,S
2016-03-25 11:19:05.5,9375,22,400616,-22,9370,137,9375,363,B
2016-03-25 11:19:06,9370,2,400618,2,9370,136,9375,363,S
2016-03-25 11:19:09,9370,4,400622,0,9370,171,9375,314,S
2016-03-25 11:19:11,9370,6,400628,0,9370,189,9375,274,S
2016-03-25 11:19:13,9370,30,400658,0,9370,235,9375,284,S
2016-03-25 11:19:14,9370,2,400660,2,9370,235,9375,286,S
2016-03-25 11:19:16,9370,6,400666,6,9370,262,9375,287,S
2016-03-25 11:19:17,9375,200,400866,88,9370,262,9375,185,B
2016-03-25 11:19:18,9375,340,401206,-224,9370,261,9380,403,B
2016-03-25 11:19:19,9375,84,401290,-10,9375,8,9380,596,B
2016-03-25 11:19:20,9375,60,401350,-2,9370,262,9375,4,B
2016-03-25 11:19:20.5,9375,16,401366,-12,9370,262,9375,19,B
2016-03-25 11:19:21,9375,202,401568,166,9370,262,9375,131,B
2016-03-25 11:19:22,9375,16,401584,0,9370,266,9375,124,B
2016-03-25 11:19:24,9375,2,401586,2,9370,265,9375,139,B
2016-03-25 11:19:24.5,9375,2,401588,2,9370,265,9375,167,B
2016-03-25 11:19:25,9375,10,401598,2,9370,265,9375,164,B
2016-03-25 11:19:25.5,9375,12,401610,0,9370,265,9375,158,B
2016-03-25 11:19:26,9370,20,401630,20,9370,255,9375,180,S
2016-03-25 11:19:28,9375,228,401858,14,9370,245,9375,77,B
2016-03-25 11:19:29,9375,10,401868,2,9370,245,9375,98,B
2016-03-25 11:19:30,9375,16,401884,-14,9370,246,9375,96,B
2016-03-25 11:19:32,9370,2,401886,2,9370,276,9375,221,S
2016-03-25 11:19:33,9370,2,401888,2,9370,277,9375,221,S
2016-03-25 11:19:36,9370,2,401890,0,9370,279,9375,222,S
2016-03-25 11:19:38,9370,2,401892,0,9370,279,9375,224,S
2016-03-25 11:19:41,9375,40,401932,-16,9370,283,9375,207,B
2016-03-25 11:19:42,9375,60,401992,40,9370,615,9375,167,B
2016-03-25 11:19:45,9370,32,402024,0,9370,600,9375,277,S
2016-03-25 11:19:46,9375,4,402028,-2,9370,599,9375,283,B
2016-03-25 11:19:48,9370,2,402030,2,9370,598,9375,285,S
2016-03-25 11:19:48.5,9375,42,402072,-40,9370,598,9375,265,B
2016-03-25 11:19:50,9375,8,402080,0,9370,599,9375,262,B
2016-03-25 11:19:52,9370,58,402138,-54,9370,571,9375,262,S
2016-03-25 11:19:56,9370,2,402140,2,9370,673,9375,262,S
2016-03-25 11:19:58,9370,2,402142,0,9370,672,9375,264,S
2016-03-25 11:20:02,9375,4,402146,-4,9370,672,9375,268,B
2016-03-25 11:20:02.5,9370,2,402148,-2,9370,671,9375,272,S
2016-03-25 11:20:03,9375,2,402150,-2,9370,671,9375,261,B
2016-03-25 11:20:07,9375,4,402154,-4,9370,668,9375,259,B
2016-03-25 11:20:09,9370,10,402164,-10,9370,664,9375,262,S
2016-03-25 11:20:11,9370,10,402174,-6,9370,658,9375,301,S
2016-03-25 11:20:12,9370,56,402230,-34,9370,629,9375,301,S
2016-03-25 11:20:12.5,9370,72,402302,24,9370,619,9375,281,S
2016-03-25 11:20:16,9375,2,402304,2,9370,629,9375,280,B
2016-03-25 11:20:19,9370,2,402306,0,9370,628,9375,277,S
2016-03-25 11:20:23,9370,4,402310,-2,9370,626,9375,279,S
2016-03-25 11:20:24,9375,4,402314,0,9370,626,9375,278,B
2016-03-25 11:20:26,9370,2,402316,-2,9370,625,9375,283,S
2016-03-25 11:20:28,9375,2,402318,0,9370,626,9375,284,B
2016-03-25 11:20:30,9375,2,402320,0,9370,627,9375,284,B
2016-03-25 11:20:31,9375,2,402322,0,9370,627,9375,283,B
2016-03-25 11:20:31.5,9375,10,402332,10,9370,622,9375,295,B
2016-03-25 11:20:33,9375,374,402706,290,9370,598,9375,109,B
2016-03-25 11:20:34,9375,156,402862,118,9370,598,9375,31,B
2016-03-25 11:20:34.5,9375,64,402926,-24,9375,367,9380,470,B
2016-03-25 11:20:35,9375,2,402928,0,9375,368,9380,470,B
2016-03-25 11:20:38,9375,74,403002,-74,9375,334,9380,456,B
2016-03-25 11:20:38.5,9375,112,403114,36,9375,88,9380,456,B
2016-03-25 11:20:39,9375,174,403288,74,9370,622,9375,14,B
2016-03-25 11:20:39.5,9370,20,403308,0,9370,616,9375,14,S
2016-03-25 11:20:40,9375,238,403546,18,9375,82,9380,457,B
2016-03-25 11:20:40.5,9375,2,403548,2,9375,79,9380,468,B
2016-03-25 11:20:47,9375,2,403550,2,9375,145,9380,453,B
2016-03-25 11:20:48,9380,2,403552,0,9375,145,9380,452,B
2016-03-25 11:20:48.5,9380,36,403588,-30,9375,145,9380,435,B
2016-03-25 11:20:49,9380,8,403596,-2,9375,182,9380,431,B
2016-03-25 11:20:49.5,9380,862,404458,-282,9380,135,9385,1029,B
2016-03-25 11:20:50,9380,60,404518,-60,9380,106,9385,964,B
2016-03-25 11:20:51,9380,2,404520,0,9380,105,9385,954,B
2016-03-25 11:20:53,9380,110,404630,-100,9380,79,9385,917,B
2016-03-25 11:20:53.5,9385,20,404650,-10,9380,79,9385,878,B
2016-03-25 11:20:54,9380,28,404678,-22,9380,78,9385,837,S
2016-03-25 11:20:54.5,9380,60,404738,-8,9380,72,9385,810,S
2016-03-25 11:20:55,9385,40,404778,-2,9380,94,9385,789,B
2016-03-25 11:20:56,9380,6,404784,2,9380,131,9385,691,S
2016-03-25 11:20:57,9385,4,404788,0,9380,156,9385,547,B
2016-03-25 11:20:58,9385,2,404790,0,9380,156,9385,546,B
2016-03-25 11:20:58.5,9385,4,404794,0,9380,156,9385,544,B
2016-03-25 11:20:59,9385,42,404836,-10,9380,206,9385,522,B
2016-03-25 11:20:59.5,9385,12,404848,12,9380,203,9385,607,B
2016-03-25 11:21:00,9380,2,404850,-2,9380,203,9385,647,S
2016-03-25 11:21:00.5,9385,2,404852,0,9380,203,9385,646,B
2016-03-25 11:21:01,9385,12,404864,-10,9380,212,9385,641,B
2016-03-25 11:21:01.5,9385,6,404870,-2,9380,213,9385,590,B
2016-03-25 11:21:03,9385,2,404872,2,9380,214,9385,591,B
2016-03-25 11:21:03.5,9385,94,404966,-72,9380,214,9385,1044,B
2016-03-25 11:21:04,9385,516,405482,-278,9380,209,9385,837,B
2016-03-25 11:21:05,9385,2,405484,0,9380,240,9385,835,B
2016-03-25 11:21:05.5,9380,10,405494,0,9380,235,9385,835,S
2016-03-25 11:21:06,9380,552,406046,-288,9375,304,9380,31,S
2016-03-25 11:21:06.5,9380,62,406108,-56,9380,8,9385,866,S
2016-03-25 11:21:07,9380,6,406114,2,9380,9,9385,866,S
2016-03-25 11:21:07.5,9385,414,406528,-314,9380,7,9385,631,B
2016-03-25 11:21:08,9385,410,406938,406,9380,46,9385,385,B
2016-03-25 11:21:09,9385,206,407144,96,9380,141,9385,19,B
2016-03-25 11:21:09.5,9385,250,407394,-166,9385,420,9390,446,B
2016-03-25 11:21:10,9385,10,407404,-4,9385,428,9390,380,B
2016-03-25 11:21:10.5,9385,2,407406,-2,9385,442,9390,298,B
2016-03-25 11:21:11,9390,2,407408,0,9385,512,9390,349,B
2016-03-25 11:21:12,9390,188,407596,-44,9385,583,9390,206,B
2016-03-25 11:21:12.5,9390,48,407644,-46,9385,586,9390,180,B
2016-03-25 11:21:13,9390,10,407654,-10,9385,600,9390,177,B
2016-03-25 11:21:13.5,9390,198,407852,60,9385,689,9390,77,B
2016-03-25 11:21:14,9390,20,407872,-8,9385,697,9390,87,B
2016-03-25 11:21:14.5,9390,20,407892,4,9385,693,9390,79,B
2016-03-25 11:21:15,9390,2,407894,2,9385,695,9390,78,B
2016-03-25 11:21:15.5,9390,2,407896,2,9385,745,9390,77,B
2016-03-25 11:21:16,9390,6,407902,2,9385,781,9390,90,B
2016-03-25 11:21:16.5,9385,12,407914,-12,9385,779,9390,90,S
2016-03-25 11:21:17,9390,10,407924,-10,9385,779,9390,199,B
2016-03-25 11:21:17.5,9390,20,407944,0,9385,791,9390,201,B
2016-03-25 11:21:18,9390,4,407948,-4,9385,791,9390,200,B
2016-03-25 11:21:18.5,9390,42,407990,-2,9385,786,9390,179,B
2016-03-25 11:21:19,9390,2,407992,-2,9385,785,9390,184,B
2016-03-25 11:21:20,9390,4,407996,-2,9385,777,9390,184,B
2016-03-25 11:21:21,9385,36,408032,-24,9385,717,9390,182,S
2016-03-25 11:21:21.5,9385,1224,409256,78,9380,304,9390,233,S
2016-03-25 11:21:22,9385,8,409264,0,9380,142,9385,82,S
2016-03-25 11:21:23,9385,4,409268,0,9380,157,9385,96,S
2016-03-25 11:21:23.5,9385,10,409278,-10,9380,160,9385,95,S
2016-03-25 11:21:24,9385,20,409298,0,9380,159,9385,185,S
2016-03-25 11:21:24.5,9385,10,409308,0,9380,143,9385,216,S
2016-03-25 11:21:26,9380,24,409332,0,9380,131,9385,215,S
2016-03-25 11:21:26.5,9380,160,409492,-104,9380,85,9385,211,S
2016-03-25 11:21:28,9380,8,409500,-8,9380,78,9385,258,S
2016-03-25 11:21:28.5,9380,4,409504,4,9380,74,9385,315,S
2016-03-25 11:21:29,9380,82,409586,32,9380,35,9385,322,S
2016-03-25 11:21:29.5,9375,80,409666,-12,9375,390,9380,15,S
2016-03-25 11:21:30,9380,12,409678,-2,9375,392,9380,61,B
2016-03-25 11:21:30.5,9380,2,409680,0,9375,388,9380,61,B
2016-03-25 11:21:31,9380,20,409700,8,9375,390,9380,63,B
2016-03-25 11:21:32,9380,2,409702,0,9375,391,9380,65,B
2016-03-25 11:21:32.5,9380,8,409710,0,9375,387,9380,62,B
2016-03-25 11:21:34,9375,100,409810,-96,9375,338,9380,114,S
2016-03-25 11:21:34.5,9375,24,409834,24,9375,325,9380,458,S
2016-03-25 11:21:36,9380,102,409936,14,9375,237,9380,414,B
2016-03-25 11:21:36.5,9380,160,410096,44,9375,287,9380,355,B
2016-03-25 11:21:37,9375,2,410098,0,9375,287,9380,354,S
2016-03-25 11:21:38,9375,2,410100,-2,9375,394,9380,356,S
2016-03-25 11:21:38.5,9380,100,410200,100,9375,384,9380,306,B
2016-03-25 11:21:39,9375,2,410202,-2,9375,384,9380,306,S
2016-03-25 11:21:40,9375,6,410208,-6,9375,383,9380,306,S
2016-03-25 11:21:40.5,9380,2,410210,0,9375,383,9380,305,B
2016-03-25 11:21:42,9380,20,410230,16,9375,383,9380,301,B
2016-03-25 11:21:43,9380,20,410250,20,9375,343,9380,292,B
2016-03-25 11:21:46,9375,6,410256,0,9375,341,9380,292,S
2016-03-25 11:21:49,9380,16,410272,0,9375,331,9380,289,B
2016-03-25 11:21:51,9380,4,410276,0,9375,332,9380,292,B
2016-03-25 11:21:51.5,9380,4,410280,4,9375,332,9380,290,B
2016-03-25 11:21:54,9375,2,410282,0,9375,333,9380,291,S
2016-03-25 11:21:56,9375,2,410284,-2,9375,333,9380,292,S
2016-03-25 11:21:58,9375,20,410304,0,9375,322,9380,314,S
2016-03-25 11:21:59,9375,2,410306,0,9375,322,9380,318,S
2016-03-25 11:22:00,9380,6,410312,4,9375,323,9380,315,B
2016-03-25 11:22:02,9380,10,410322,0,9375,323,9380,310,B
2016-03-25 11:22:03,9380,4,410326,4,9375,248,9380,308,B
2016-03-25 11:22:03.5,9375,2,410328,-2,9375,209,9380,369,S
2016-03-25 11:22:05,9375,4,410332,0,9375,207,9380,390,S
2016-03-25 11:22:06,9375,6,410338,4,9375,206,9380,388,S
2016-03-25 11:22:08,9375,6,410344,0,9375,203,9380,390,S
2016-03-25 11:22:08.5,9375,2,410346,0,9375,202,9380,389,S
2016-03-25 11:22:10,9375,4,410350,0,9375,200,9380,382,S
2016-03-25 11:22:10.5,9375,2,410352,0,9375,198,9380,379,S
2016-03-25 11:22:16,9375,6,410358,0,9375,197,9380,492,S
2016-03-25 11:22:17,9375,20,410378,-12,9375,187,9380,499,S
2016-03-25 11:22:18,9375,18,410396,-18,9375,178,9380,499,S
2016-03-25 11:22:19,9375,4,410400,-4,9375,176,9380,501,S
2016-03-25 11:22:19.5,9375,8,410408,0,9375,172,9380,502,S
2016-03-25 11:22:20,9375,4,410412,0,9375,170,9380,501,S
2016-03-25 11:22:21,9375,12,410424,0,9375,164,9380,524,S
2016-03-25 11:22:23,9380,4,410428,0,9375,164,9380,523,B
2016-03-25 11:22:23.5,9375,4,410432,0,9375,162,9380,533,S
2016-03-25 11:22:25,9375,2,410434,-2,9375,161,9380,534,S
2016-03-25 11:22:26,9375,8,410442,-8,9375,157,9380,537,S
2016-03-25 11:22:26.5,9375,18,410460,-14,9375,148,9380,537,S
2016-03-25 11:22:27,9380,2,410462,0,9375,148,9380,537,B
2016-03-25 11:22:27.5,9375,22,410484,0,9375,136,9380,541,S
2016-03-25 11:22:29,9380,2,410486,2,9375,136,9380,619,B
2016-03-25 11:22:30,9375,8,410494,0,9375,132,9380,619,S
2016-03-25 11:22:33,9375,120,410614,-60,9375,82,9380,628,S
2016-03-25 11:22:34,9375,2,410616,0,9375,107,9380,663,S
2016-03-25 11:22:35,9375,2,410618,-2,9375,111,9380,667,S
2016-03-25 11:22:35.5,9375,30,410648,0,9375,97,9380,667,S
2016-03-25 11:22:36,9375,10,410658,0,9375,94,9380,708,S
2016-03-25 11:22:37,9375,12,410670,-12,9375,124,9380,708,S
2016-03-25 11:22:40,9375,56,410726,-50,9375,112,9380,706,S
2016-03-25 11:22:43,9375,4,410730,0,9375,110,9380,705,S
2016-03-25 11:22:45,9375,2,410732,0,9375,110,9380,706,S
2016-03-25 11:22:45.5,9375,6,410738,0,9375,108,9380,706,S
2016-03-25 11:22:48,9380,80,410818,80,9375,225,9380,669,B
2016-03-25 11:22:50,9380,1334,412152,56,9380,207,9385,379,B
2016-03-25 11:22:51,9380,2,412154,2,9380,206,9385,279,B
2016-03-25 11:22:55,9385,2,412156,-2,9380,206,9385,264,B
2016-03-25 11:22:56,9385,202,412358,94,9380,287,9385,175,B
2016-03-25 11:22:57,9385,350,412708,64,9385,113,9390,247,B
2016-03-25 11:22:58,9390,30,412738,20,9385,148,9390,197,B
2016-03-25 11:22:59,9385,2,412740,0,9385,179,9390,297,S
2016-03-25 11:23:00,9385,2,412742,0,9385,178,9390,297,S
2016-03-25 11:23:01,9390,8,412750,0,9385,178,9390,295,B
2016-03-25 11:23:02,9385,10,412760,-10,9385,173,9390,297,S
2016-03-25 11:23:02.5,9385,2,412762,0,9385,173,9390,304,S
2016-03-25 11:23:03,9385,2,412764,0,9385,172,9390,360,S
2016-03-25 11:23:03.5,9385,2,412766,0,9385,173,9390,361,S
2016-03-25 11:23:04,9385,24,412790,0,9385,163,9390,359,S
2016-03-25 11:23:04.5,9390,8,412798,-4,9385,160,9390,359,B
2016-03-25 11:23:05,9385,4,412802,0,9385,175,9390,361,S
2016-03-25 11:23:06,9390,20,412822,18,9385,175,9390,351,B
2016-03-25 11:23:09,9390,14,412836,12,9385,182,9390,343,B
2016-03-25 11:23:11,9385,4,412840,-2,9385,180,9390,343,S
2016-03-25 11:23:12,9390,20,412860,20,9385,205,9390,333,B
2016-03-25 11:23:14,9385,6,412866,0,9385,221,9390,333,S
2016-03-25 11:23:14.5,9390,2,412868,2,9385,192,9390,332,B
2016-03-25 11:23:15,9385,2,412870,0,9385,201,9390,333,S
2016-03-25 11:23:16,9385,2,412872,0,9385,203,9390,333,S
2016-03-25 11:23:16.5,9385,2,412874,-2,9385,202,9390,313,S
2016-03-25 11:23:18,9390,70,412944,-54,9385,300,9390,291,B
2016-03-25 11:23:19,9390,20,412964,0,9385,297,9390,281,B
2016-03-25 11:23:19.5,9385,2,412966,0,9385,266,9390,281,S
2016-03-25 11:23:20,9390,32,412998,-32,9385,266,9390,264,B
2016-03-25 11:23:21,9390,4,413002,2,9385,269,9390,212,B
2016-03-25 11:23:22,9390,62,413064,-46,9385,269,9390,182,B
2016-03-25 11:23:23,9390,6,413070,-4,9385,319,9390,221,B
2016-03-25 11:23:23.5,9385,62,413132,-58,9385,318,9390,194,S
2016-03-25 11:23:24,9390,4,413136,2,9385,319,9390,208,B
2016-03-25 11:23:25,9390,2,413138,-2,9385,319,9390,212,B
2016-03-25 11:23:26,9390,4,413142,2,9385,319,9390,210,B
2016-03-25 11:23:27,9390,10,413152,-10,9385,319,9390,311,B
2016-03-25 11:23:28,9385,10,413162,0,9385,273,9390,314,S
2016-03-25 11:23:29,9385,4,413166,-4,9385,271,9390,316,S
2016-03-25 11:23:30,9390,24,413190,-20,9385,258,9390,316,B
2016-03-25 11:23:31,9390,2,413192,-2,9385,258,9390,495,B
2016-03-25 11:23:32,9385,64,413256,-64,9385,223,9390,714,S
2016-03-25 11:23:32.5,9385,466,413722,-22,9380,314,9385,8,S
2016-03-25 11:23:33,9380,10,413732,-10,9380,176,9385,454,S
2016-03-25 11:23:34,9385,2,413734,-2,9380,176,9385,453,B
2016-03-25 11:23:37,9380,6,413740,0,9380,147,9385,452,S
2016-03-25 11:23:40,9380,20,413760,-2,9380,150,9385,340,S
2016-03-25 11:23:41,9385,2,413762,-2,9380,150,9385,339,B
2016-03-25 11:23:41.5,9385,2,413764,-2,9380,150,9385,338,B
2016-03-25 11:23:43,9385,2,413766,0,9380,150,9385,338,B
2016-03-25 11:23:44,9380,2,413768,2,9380,151,9385,338,S
2016-03-25 11:23:44.5,9385,4,413772,0,9380,150,9385,337,B
2016-03-25 11:23:46,9380,10,413782,10,9380,155,9385,340,S
2016-03-25 11:23:46.5,9380,104,413886,-30,9380,103,9385,360,S
2016-03-25 11:23:47,9380,206,414092,-126,9375,277,9380,2,S
2016-03-25 11:23:47.5,9380,2,414094,-2,9375,277,9380,4,S
2016-03-25 11:23:48,9380,2,414096,0,9375,272,9380,9,S
2016-03-25 11:23:48.5,9380,2,414098,2,9375,245,9380,61,S
2016-03-25 11:23:49,9380,16,414114,-2,9375,238,9380,72,S
2016-03-25 11:23:49.5,9375,2,414116,-2,9375,237,9380,97,S
2016-03-25 11:23:50,9375,4,414120,-4,9375,235,9380,159,S
2016-03-25 11:23:50.5,9375,340,414460,-126,9370,258,9375,26,S
2016-03-25 11:23:52,9370,20,414480,0,9370,69,9375,360,S
2016-03-25 11:23:52.5,9370,214,414694,150,9370,8,9375,391,S
2016-03-25 11:23:53,9370,16,414710,-14,9365,296,9370,488,S
2016-03-25 11:23:54,9365,2,414712,2,9365,246,9370,271,S
2016-03-25 11:23:54.5,9365,208,414920,6,9365,171,9370,272,S
2016-03-25 11:23:56,9365,334,415254,110,9360,436,9365,70,S
2016-03-25 11:23:56.5,9365,26,415280,2,9360,421,9365,58,S
2016-03-25 11:23:57,9365,2,415282,0,9360,420,9365,58,S
2016-03-25 11:23:57.5,9365,64,415346,10,9360,392,9365,58,S
2016-03-25 11:23:58,9360,162,415508,-62,9360,278,9365,110,S
2016-03-25 11:23:59,9360,2,415510,-2,9360,247,9365,111,S
2016-03-25 11:23:59.5,9365,26,415536,-22,9360,229,9365,110,B
2016-03-25 11:24:00,9360,4,415540,-4,9360,225,9365,110,S
2016-03-25 11:24:02,9360,22,415562,-20,9360,201,9365,144,S
2016-03-25 11:24:02.5,9360,28,415590,0,9360,192,9365,145,S
2016-03-25 11:24:03,9360,14,415604,-10,9360,187,9365,144,S
2016-03-25 11:24:04,9360,80,415684,-20,9360,147,9365,144,S
2016-03-25 11:24:05,9365,2,415686,0,9360,167,9365,182,B
2016-03-25 11:24:05.5,9365,4,415690,0,9360,165,9365,182,B
2016-03-25 11:24:06,9360,22,415712,20,9360,149,9365,183,S
2016-03-25 11:24:07,9360,10,415722,10,9360,166,9365,183,S
2016-03-25 11:24:08,9365,42,415764,0,9360,149,9365,161,B
2016-03-25 11:24:09,9360,20,415784,0,9360,142,9365,161,S
2016-03-25 11:24:10,9365,12,415796,0,9360,150,9365,155,B
2016-03-25 11:24:11,9360,10,415806,0,9360,140,9365,153,S
2016-03-25 11:24:13,9360,20,415826,20,9360,104,9365,162,S
2016-03-25 11:24:15,9360,4,415830,-2,9360,92,9365,197,S
2016-03-25 11:24:15.5,9360,40,415870,26,9360,70,9365,197,S
2016-03-25 11:24:16,9360,170,416040,-74,9360,85,9365,226,S
2016-03-25 11:24:16.5,9360,184,416224,170,9355,456,9360,54,S
2016-03-25 11:24:17,9360,2,416226,2,9355,445,9360,70,S
2016-03-25 11:24:17.5,9355,2,416228,0,9355,427,9360,77,S
2016-03-25 11:24:18,9355,18,416246,-6,9355,411,9360,76,S
2016-03-25 11:24:19,9360,16,416262,0,9355,411,9360,80,B
2016-03-25 11:24:19.5,9360,4,416266,4,9355,412,9360,99,B
2016-03-25 11:24:20,9355,2,416268,-2,9355,399,9360,151,S
2016-03-25 11:24:21,9360,22,416290,-16,9355,348,9360,146,B
2016-03-25 11:24:22,9355,4,416294,0,9355,366,9360,180,S
2016-03-25 11:24:22.5,9355,6,416300,-2,9355,358,9360,179,S
2016-03-25 11:24:23,9355,2,416302,0,9355,309,9360,179,S
2016-03-25 11:24:23.5,9360,60,416362,38,9355,310,9360,149,B
2016-03-25 11:24:25,9360,314,416676,-220,9360,54,9365,335,B
2016-03-25 11:24:25.5,9360,22,416698,-10,9360,44,9365,343,B
2016-03-25 11:24:26,9360,4,416702,0,9360,52,9365,338,B
2016-03-25 11:24:26.5,9360,2,416704,0,9360,52,9365,336,B
2016-03-25 11:24:27,9360,4,416708,0,9360,52,9365,335,B
2016-03-25 11:24:27.5,9360,108,416816,-60,9355,366,9360,1,B
2016-03-25 11:24:28,9360,40,416856,20,9355,365,9360,39,B
2016-03-25 11:24:29,9360,34,416890,-8,9360,19,9365,334,B
2016-03-25 11:24:30,9360,6,416896,0,9355,370,9365,336,B
2016-03-25 11:24:30.5,9355,100,416996,-100,9355,320,9360,50,S
2016-03-25 11:24:31,9360,2,416998,2,9355,422,9360,82,B
2016-03-25 11:24:32,9360,6,417004,0,9355,433,9360,59,B
2016-03-25 11:24:32.5,9355,4,417008,0,9355,433,9360,60,S
2016-03-25 11:24:33,9355,4,417012,0,9355,431,9360,72,S
2016-03-25 11:24:33.5,9355,2,417014,0,9355,430,9360,120,S
2016-03-25 11:24:34,9360,12,417026,-10,9355,383,9360,116,B
2016-03-25 11:24:35,9355,2,417028,0,9355,382,9360,118,S
2016-03-25 11:24:35.5,9355,2,417030,0,9355,382,9360,118,S
2016-03-25 11:24:37,9355,20,417050,0,9355,405,9360,122,S
2016-03-25 11:24:37.5,9355,20,417070,0,9355,394,9360,125,S
2016-03-25 11:24:38,9360,8,417078,-6,9355,393,9360,225,B
2016-03-25 11:24:39,9355,2,417080,0,9355,394,9360,230,S
2016-03-25 11:24:40,9355,2,417082,0,9355,395,9360,230,S
2016-03-25 11:24:41,9355,670,417752,240,9355,61,9360,291,S
2016-03-25 11:24:42,9355,122,417874,-96,9350,723,9355,113,S
2016-03-25 11:24:42.5,9355,4,417878,-4,9350,697,9355,161,S
2016-03-25 11:24:43,9350,2,417880,-2,9350,554,9355,162,S
2016-03-25 11:24:43.5,9350,32,417912,-12,9350,543,9355,158,S
2016-03-25 11:24:44,9350,2,417914,2,9350,542,9355,174,S
2016-03-25 11:24:44.5,9350,20,417934,10,9350,531,9355,176,S
2016-03-25 11:24:45,9355,4,417938,-2,9350,531,9355,229,B
2016-03-25 11:24:46,9350,304,418242,-36,9350,375,9355,236,S
2016-03-25 11:24:47,9350,4,418246,-2,9350,372,9355,238,S
2016-03-25 11:24:47.5,9350,182,418428,160,9350,281,9355,179,S
2016-03-25 11:24:48,9350,4,418432,0,9350,287,9355,179,S
2016-03-25 11:24:48.5,9350,62,418494,60,9350,256,9355,180,S
2016-03-25 11:24:49,9350,2,418496,0,9350,255,9355,180,S
2016-03-25 11:24:50,9350,2,418498,2,9350,256,9355,177,S
2016-03-25 11:24:51,9350,2,418500,0,9350,255,9355,179,S
2016-03-25 11:24:52,9350,2,418502,2,9350,258,9355,181,S
2016-03-25 11:24:54,9350,2,418504,2,9350,312,9355,128,S
2016-03-25 11:24:54.5,9350,104,418608,-64,9350,261,9355,128,S
2016-03-25 11:24:56,9355,2,418610,0,9350,265,9355,157,B
2016-03-25 11:24:58,9350,4,418614,-4,9350,264,9355,186,S
2016-03-25 11:24:59,9350,64,418678,-56,9350,240,9355,181,S
2016-03-25 11:24:59.5,9350,4,418682,0,9350,241,9355,181,S
2016-03-25 11:25:00,9350,20,418702,0,9350,232,9355,181,S
2016-03-25 11:25:00.5,9350,10,418712,0,9350,238,9355,182,S
2016-03-25 11:25:01,9350,162,418874,4,9350,132,9355,232,S
2016-03-25 11:25:01.5,9350,6,418880,-2,9350,128,9355,247,S
2016-03-25 11:25:02,9350,34,418914,-20,9350,111,9355,270,S
2016-03-25 11:25:02.5,9350,10,418924,0,9350,106,9355,275,S
2016-03-25 11:25:03,9355,2,418926,0,9350,106,9355,272,B
2016-03-25 11:25:03.5,9350,6,418932,4,9350,112,9355,271,S
2016-03-25 11:25:04,9355,24,418956,18,9350,107,9355,259,B
2016-03-25 11:25:04.5,9350,2,418958,0,9350,156,9355,254,S
2016-03-25 11:25:05,9350,22,418980,0,9350,175,9355,264,S
2016-03-25 11:25:11,9350,20,419000,0,9350,199,9355,198,S
2016-03-25 11:25:11.5,9355,398,419398,162,9355,25,9360,482,B
2016-03-25 11:25:12,9355,12,419410,12,9355,19,9360,487,B
2016-03-25 11:25:12.3333,9355,34,419444,-2,9355,8,9360,486,B
2016-03-25 11:25:12.6667,9355,2,419446,0,9355,8,9360,486,B
2016-03-25 11:25:13,9355,2,419448,2,9355,8,9360,486,B
2016-03-25 11:25:14,9355,16,419464,0,9350,275,9355,15,B
2016-03-25 11:25:14.5,9355,134,419598,52,9355,1,9360,484,B
2016-03-25 11:25:15,9360,2,419600,-2,9355,313,9360,486,B
2016-03-25 11:25:16,9355,10,419610,0,9355,308,9360,501,S
2016-03-25 11:25:18,9355,200,419810,0,9355,349,9360,502,S
2016-03-25 11:25:22,9360,70,419880,-68,9355,381,9360,308,B
2016-03-25 11:25:23,9360,24,419904,0,9355,382,9360,256,B
2016-03-25 11:25:23.5,9360,436,420340,-26,9355,382,9360,38,B
2016-03-25 11:25:24,9360,74,420414,30,9360,161,9365,320,B
2016-03-25 11:25:24.5,9360,6,420420,0,9360,158,9365,318,B
2016-03-25 11:25:25,9360,2,420422,-2,9360,160,9365,318,B
2016-03-25 11:25:25.5,9360,2,420424,0,9360,159,9365,318,B
2016-03-25 11:25:26,9360,10,420434,0,9360,154,9365,314,B
2016-03-25 11:25:28,9360,14,420448,0,9360,147,9365,314,B
2016-03-25 11:25:28.5,9360,100,420548,18,9360,97,9365,295,B
2016-03-25 11:25:29,9360,204,420752,106,9355,419,9360,83,B
2016-03-25 11:25:31,9355,4,420756,0,9355,395,9360,84,S
2016-03-25 11:25:32,9355,2,420758,0,9355,398,9360,85,S
2016-03-25 11:25:34,9360,8,420766,0,9355,451,9360,96,B
2016-03-25 11:25:34.5,9360,2,420768,2,9355,460,9360,198,B
2016-03-25 11:25:37,9355,2,420770,-2,9355,558,9360,296,S
2016-03-25 11:25:38,9355,16,420786,0,9355,551,9360,287,S
2016-03-25 11:25:44,9355,2,420788,-2,9355,464,9360,310,S
2016-03-25 11:25:46,9360,6,420794,0,9355,473,9360,350,B
2016-03-25 11:25:52,9360,2,420796,0,9355,478,9360,398,B
2016-03-25 11:25:59,9360,2,420798,0,9355,480,9360,500,B
2016-03-25 11:26:00,9360,6,420804,6,9355,480,9360,497,B
2016-03-25 11:26:01,9355,2,420806,0,9355,479,9360,492,S
2016-03-25 11:26:02,9355,2,420808,-2,9355,480,9360,533,S
2016-03-25 11:26:03,9360,2,420810,2,9355,483,9360,522,B
2016-03-25 11:26:08,9355,10,420820,-10,9355,478,9360,480,S
2016-03-25 11:26:10,9355,30,420850,0,9355,463,9360,478,S
2016-03-25 11:26:10.5,9360,10,420860,0,9355,463,9360,473,B
2016-03-25 11:26:11,9355,2,420862,0,9355,462,9360,473,S
2016-03-25 11:26:14,9355,20,420882,0,9355,455,9360,515,S
2016-03-25 11:26:15,9355,20,420902,0,9355,445,9360,515,S
2016-03-25 11:26:17,9355,2,420904,0,9355,443,9360,515,S
2016-03-25 11:26:20,9355,2,420906,0,9355,442,9360,516,S
2016-03-25 11:26:22,9360,10,420916,0,9355,442,9360,511,B
2016-03-25 11:26:24,9355,2,420918,0,9355,441,9360,471,S
2016-03-25 11:26:25,9360,2,420920,2,9355,441,9360,470,B
2016-03-25 11:26:29,9360,4,420924,2,9355,523,9360,314,B
2016-03-25 11:26:31,9360,264,421188,-76,9355,523,9360,125,B
2016-03-25 11:26:32,9360,250,421438,80,9360,159,9365,414,B
2016-03-25 11:26:32.5,9360,2,421440,-2,9360,133,9365,415,B
2016-03-25 11:26:33,9360,40,421480,-40,9360,117,9365,396,B
2016-03-25 11:26:36,9360,16,421496,-4,9360,113,9365,385,B
2016-03-25 11:26:37,9360,10,421506,2,9360,131,9365,374,B
2016-03-25 11:26:39,9360,4,421510,4,9360,137,9365,375,B
2016-03-25 11:26:40,9360,2,421512,0,9360,141,9365,375,B
2016-03-25 11:26:43,9360,6,421518,6,9360,141,9365,338,B
2016-03-25 11:26:49,9365,2,421520,-2,9360,202,9365,358,B
2016-03-25 11:26:59,9360,2,421522,0,9360,211,9365,174,S
2016-03-25 11:27:00,9360,6,421528,0,9360,219,9365,142,S
2016-03-25 11:27:01,9365,2,421530,0,9360,221,9365,141,B
2016-03-25 11:27:05,9360,2,421532,0,9360,223,9365,131,S
2016-03-25 11:27:07,9360,446,421978,-232,9355,590,9365,418,S
2016-03-25 11:27:09,9355,10,421988,-10,9355,548,9365,434,S
2016-03-25 11:27:10,9355,14,422002,-10,9355,537,9365,434,S
2016-03-25 11:27:11,9360,2,422004,-2,9360,28,9365,433,B
2016-03-25 11:27:12,9360,20,422024,-20,9360,2,9365,434,B
2016-03-25 11:27:12.3333,9360,4,422028,-4,9355,532,9360,6,B
2016-03-25 11:27:12.6667,9360,36,422064,-2,9355,532,9360,38,B
2016-03-25 11:27:14,9360,30,422094,28,9355,534,9360,46,B
2016-03-25 11:27:15,9360,2,422096,0,9355,534,9360,46,B
2016-03-25 11:27:17,9360,2,422098,2,9355,534,9360,49,B
2016-03-25 11:27:18,9360,4,422102,0,9355,553,9360,47,B
2016-03-25 11:27:20,9360,2,422104,2,9355,566,9360,58,B
2016-03-25 11:27:23,9360,4,422108,0,9355,574,9360,110,B
2016-03-25 11:27:27,9360,2,422110,0,9355,454,9360,200,B
2016-03-25 11:27:28,9355,2,422112,-2,9355,453,9360,210,S
2016-03-25 11:27:29,9360,130,422242,-64,9355,430,9360,118,B
2016-03-25 11:27:29.5,9355,2,422244,0,9355,433,9360,118,S
2016-03-25 11:27:35,9360,12,422256,0,9355,439,9360,123,B
2016-03-25 11:27:36,9360,12,422268,12,9355,440,9360,117,B
2016-03-25 11:27:40,9360,2,422270,0,9355,440,9360,121,B
2016-03-25 11:27:49,9360,2,422272,0,9355,430,9360,175,B
2016-03-25 11:27:50,9360,240,422512,146,9360,51,9365,428,B
2016-03-25 11:27:54,9360,2,422514,2,9360,63,9365,351,B
2016-03-25 11:27:54.5,9360,24,422538,14,9360,7,9365,335,B
2016-03-25 11:27:56,9360,2,422540,2,9360,4,9365,267,B
2016-03-25 11:27:56.5,9360,10,422550,8,9355,425,9360,1,B
2016-03-25 11:27:57,9360,8,422558,6,9360,3,9365,266,B
2016-03-25 11:28:01,9365,2,422560,-2,9360,73,9365,265,B
2016-03-25 11:28:02,9360,2,422562,0,9360,76,9365,265,S
2016-03-25 11:28:03,9360,84,422646,0,9360,27,9365,265,S
2016-03-25 11:28:04,9360,8,422654,2,9360,25,9365,275,S
2016-03-25 11:28:04.5,9360,22,422676,2,9360,15,9365,275,S
2016-03-25 11:28:05,9360,2,422678,0,9360,13,9365,275,S
2016-03-25 11:28:06,9360,30,422708,-20,9355,382,9365,280,S
2016-03-25 11:28:08,9360,4,422712,4,9355,377,9365,281,S
2016-03-25 11:28:09,9360,22,422734,-2,9355,361,9360,43,S
2016-03-25 11:28:11,9360,2,422736,-2,9355,361,9360,131,S
2016-03-25 11:28:12,9360,4,422740,-4,9355,361,9360,129,S
2016-03-25 11:28:13,9360,2,422742,-2,9355,360,9360,130,S
2016-03-25 11:28:13.5,9360,6,422748,-6,9355,360,9360,91,S
2016-03-25 11:28:14,9360,102,422850,-52,9360,4,9365,278,S
2016-03-25 11:28:15,9360,4,422854,0,9360,22,9365,278,S
2016-03-25 11:28:15.5,9360,2,422856,0,9360,21,9365,278,S
2016-03-25 11:28:18,9360,2,422858,0,9360,53,9365,261,S
2016-03-25 11:28:18.5,9360,2,422860,0,9360,52,9365,261,S
2016-03-25 11:28:21,9365,14,422874,2,9360,486,9365,140,B
2016-03-25 11:28:22,9365,276,423150,-64,9365,131,9370,276,B
2016-03-25 11:28:23,9365,20,423170,20,9365,164,9370,247,B
2016-03-25 11:28:28,9370,4,423174,2,9365,544,9370,251,B
2016-03-25 11:28:29,9370,2,423176,0,9365,544,9370,250,B
2016-03-25 11:28:34,9365,4,423180,-4,9365,104,9370,272,S
2016-03-25 11:28:35,9365,4,423184,-2,9365,103,9370,271,S
2016-03-25 11:28:35.5,9365,4,423188,-4,9365,101,9370,271,S
2016-03-25 11:28:36,9365,2,423190,-2,9365,100,9370,271,S
2016-03-25 11:28:37,9365,22,423212,-22,9365,89,9370,271,S
2016-03-25 11:28:38,9365,4,423216,0,9365,87,9370,271,S
2016-03-25 11:28:45,9365,2,423218,0,9365,110,9370,272,S
2016-03-25 11:28:49,9370,40,423258,0,9365,111,9370,284,B
2016-03-25 11:28:50,9365,2,423260,0,9365,110,9370,284,S
2016-03-25 11:28:51,9365,2,423262,-2,9365,110,9370,284,S
2016-03-25 11:28:55,9370,8,423270,-8,9365,205,9370,243,B
2016-03-25 11:28:56,9370,482,423752,-128,9370,87,9375,350,B
2016-03-25 11:28:56.5,9375,200,423952,42,9370,207,9375,203,B
2016-03-25 11:28:57,9375,86,424038,18,9370,213,9375,40,B
2016-03-25 11:28:57.5,9375,78,424116,16,9375,183,9380,89,B
2016-03-25 11:28:58,9380,10,424126,-4,9375,217,9380,64,B
2016-03-25 11:28:59,9375,8,424134,2,9375,223,9380,102,S
2016-03-25 11:29:02,9380,30,424164,-18,9375,226,9380,96,B
2016-03-25 11:29:02.5,9380,2,424166,0,9375,226,9380,94,B
2016-03-25 11:29:03,9380,122,424288,-94,9375,225,9380,34,B
2016-03-25 11:29:03.5,9380,60,424348,-48,9380,64,9385,165,B
2016-03-25 11:29:04,9380,40,424388,20,9380,104,9385,115,B
2016-03-25 11:29:04.5,9385,8,424396,-8,9380,216,9385,95,B
2016-03-25 11:29:05,9385,12,424408,-4,9380,218,9385,127,B
2016-03-25 11:29:05.5,9380,2,424410,2,9380,217,9385,127,S
2016-03-25 11:29:06,9380,18,424428,2,9380,208,9385,128,S
2016-03-25 11:29:07,9380,56,424484,-2,9380,57,9385,397,S
2016-03-25 11:29:07.5,9380,116,424600,-94,9375,174,9380,73,S
2016-03-25 11:29:08,9380,6,424606,-6,9375,129,9380,135,S
2016-03-25 11:29:08.5,9380,2,424608,-2,9375,130,9380,136,S
2016-03-25 11:29:09,9380,4,424612,-4,9375,130,9380,134,S
2016-03-25 11:29:09.5,9380,10,424622,-10,9375,130,9380,129,S
2016-03-25 11:29:10,9380,10,424632,-10,9375,131,9380,129,S
2016-03-25 11:29:11,9380,12,424644,0,9375,116,9380,124,S
2016-03-25 11:29:12,9380,2,424646,-2,9375,116,9380,123,S
2016-03-25 11:29:13,9375,8,424654,-8,9375,144,9380,124,S
2016-03-25 11:29:15,9380,102,424756,-40,9375,270,9380,27,B
2016-03-25 11:29:16,9380,6,424762,-6,9375,231,9380,205,B
2016-03-25 11:29:17,9380,22,424784,-18,9375,232,9380,197,B
2016-03-25 11:29:18,9380,4,424788,2,9375,231,9380,195,B
2016-03-25 11:29:20,9375,2,424790,0,9375,336,9380,152,S
2016-03-25 11:29:21,9380,2,424792,0,9375,337,9380,156,B
2016-03-25 11:29:22,9380,70,424862,-2,9375,233,9380,172,B
2016-03-25 11:29:22.5,9380,8,424870,0,9375,286,9380,120,B
2016-03-25 11:29:23,9380,62,424932,0,9375,296,9380,123,B
2016-03-25 11:29:25,9375,20,424952,-20,9375,285,9380,124,S
2016-03-25 11:29:26,9380,14,424966,-2,9375,211,9380,177,B
2016-03-25 11:29:26.5,9375,6,424972,2,9375,210,9380,175,S
2016-03-25 11:29:27,9380,4,424976,4,9375,208,9380,173,B
2016-03-25 11:29:31,9380,6,424982,0,9375,231,9380,183,B
2016-03-25 11:29:32,9375,4,424986,-4,9375,226,9380,182,S
2016-03-25 11:29:33,9380,2,424988,2,9375,161,9380,132,B
2016-03-25 11:29:34,9375,12,425000,0,9375,156,9380,162,S
2016-03-25 11:29:35,9380,6,425006,0,9375,156,9380,160,B
2016-03-25 11:29:36,9380,2,425008,2,9375,156,9380,159,B
2016-03-25 11:29:37,9375,82,425090,-32,9375,118,9380,165,S
2016-03-25 11:29:39,9375,2,425092,0,9375,119,9380,178,S
2016-03-25 11:29:39.5,9380,2,425094,0,9375,119,9380,177,B
2016-03-25 11:29:40,9380,96,425190,96,9375,119,9380,129,B
2016-03-25 11:29:41,9375,60,425250,-22,9375,89,9380,128,S
2016-03-25 11:29:42,9380,4,425254,0,9375,94,9380,127,B
2016-03-25 11:29:43,9380,40,425294,20,9375,157,9380,111,B
2016-03-25 11:29:44,9375,4,425298,4,9375,152,9380,113,S
2016-03-25 11:29:46,9380,96,425394,4,9375,120,9380,96,B
2016-03-25 11:29:48,9380,4,425398,2,9375,62,9380,96,B
2016-03-25 11:29:49,9380,112,425510,70,9375,62,9380,40,B
2016-03-25 11:29:49.5,9380,28,425538,-2,9375,62,9380,27,B
2016-03-25 11:29:50,9380,20,425558,-12,9375,79,9380,20,B
2016-03-25 11:29:50.5,9380,20,425578,-6,9375,65,9380,158,B
2016-03-25 11:29:51,9380,20,425598,-4,9375,65,9380,148,B
2016-03-25 11:29:52,9380,10,425608,-10,9375,65,9380,143,B
2016-03-25 11:29:53,9380,20,425628,-20,9375,65,9380,143,B
2016-03-25 11:29:53.5,9375,2,425630,0,9375,70,9380,143,S
2016-03-25 11:29:54,9380,32,425662,-32,9375,67,9380,128,B
2016-03-25 11:29:55,9375,38,425700,-26,9375,47,9380,129,S
2016-03-25 11:29:56,9380,2,425702,0,9375,47,9380,128,B
2016-03-25 11:29:57,9380,10,425712,0,9375,46,9380,123,B
2016-03-25 11:29:58,9380,10,425722,-10,9375,46,9380,118,B
2016-03-25 11:29:59,9375,8,425730,-6,9375,76,9380,118,S
2016-03-25 11:30:00,9380,34,425764,0,9375,79,9380,101,B
2016-03-25 13:30:01,9380,318,426082,-120,9380,15,9385,348,B
2016-03-25 13:30:01.5,9385,60,426142,8,9380,126,9385,239,B
2016-03-25 13:30:02,9380,238,426380,88,9380,127,9385,127,S
2016-03-25 13:30:02.5,9385,100,426480,64,9380,125,9385,77,B
2016-03-25 13:30:03,9385,148,426628,64,9385,3,9390,168,B
2016-03-25 13:30:03.5,9390,2,426630,0,9385,56,9390,167,B
2016-03-25 13:30:04,9390,48,426678,-28,9385,69,9390,142,B
2016-03-25 13:30:05,9385,4,426682,4,9385,93,9390,142,S
2016-03-25 13:30:05.5,9390,22,426704,-20,9385,94,9390,231,B
2016-03-25 13:30:06,9385,6,426710,4,9385,92,9390,233,S
2016-03-25 13:30:06.5,9385,340,427050,-28,9375,101,9385,35,S
2016-03-25 13:30:07,9385,2,427052,-2,9380,49,9385,108,S
2016-03-25 13:30:07.5,9385,4,427056,-4,9380,48,9385,186,S
2016-03-25 13:30:08,9385,18,427074,-2,9380,52,9385,309,S
2016-03-25 13:30:08.5,9380,4,427078,0,9380,83,9385,309,S
2016-03-25 13:30:09,9380,4,427082,0,9380,63,9385,308,S
2016-03-25 13:30:10,9380,112,427194,92,9375,220,9380,260,S
2016-03-25 13:30:10.5,9380,4,427198,-4,9375,222,9380,262,S
2016-03-25 13:30:11,9380,14,427212,-14,9375,215,9380,255,S
2016-03-25 13:30:11.5,9380,4,427216,-4,9375,234,9380,225,S
2016-03-25 13:30:16,9380,38,427254,10,9375,209,9380,111,S
2016-03-25 13:30:17,9380,40,427294,0,9375,208,9380,88,S
2016-03-25 13:30:19,9380,14,427308,-10,9375,208,9380,148,S
2016-03-25 13:30:20,9380,6,427314,0,9375,208,9380,145,S
2016-03-25 13:30:22,9380,8,427322,-2,9375,210,9380,142,S
2016-03-25 13:30:23,9380,4,427326,-2,9375,211,9380,143,S
2016-03-25 13:30:24,9380,10,427336,0,9375,211,9380,138,S
2016-03-25 13:30:25,9375,24,427360,2,9375,200,9380,186,S
2016-03-25 13:30:25.5,9380,2,427362,0,9375,200,9380,185,B
2016-03-25 13:30:27,9380,38,427400,-28,9375,182,9380,166,B
2016-03-25 13:30:27.5,9375,200,427600,58,9375,82,9380,199,S
2016-03-25 13:30:28,9375,90,427690,40,9370,247,9380,201,S
2016-03-25 13:30:28.5,9375,52,427742,12,9370,131,9380,172,S
2016-03-25 13:30:29,9375,22,427764,12,9370,245,9375,5,S
2016-03-25 13:30:29.5,9375,36,427800,-26,9375,18,9380,79,S
2016-03-25 13:30:30,9375,6,427806,-6,9375,10,9380,88,S
2016-03-25 13:30:31,9375,178,427984,44,9375,29,9385,320,S
2016-03-25 13:30:32,9375,26,428010,-2,9375,41,9380,8,S
2016-03-25 13:30:32.5,9380,16,428026,-16,9375,42,9380,14,B
2016-03-25 13:30:33,9375,2,428028,0,9375,130,9380,15,S
2016-03-25 13:30:34,9380,34,428062,-2,9380,15,9385,265,B
2016-03-25 13:30:34.5,9375,36,428098,0,9375,187,9380,69,S
2016-03-25 13:30:36,9380,20,428118,20,9375,246,9380,125,B
2016-03-25 13:30:39,9380,2,428120,2,9375,249,9380,126,B
2016-03-25 13:30:39.5,9375,4,428124,0,9375,247,9380,126,S
2016-03-25 13:30:40,9380,6,428130,6,9375,248,9380,123,B
2016-03-25 13:30:41,9380,10,428140,-8,9375,248,9380,118,B
2016-03-25 13:30:41.5,9380,2,428142,0,9375,248,9380,117,B
2016-03-25 13:30:46,9380,10,428152,-10,9375,246,9380,117,B
2016-03-25 13:30:46.5,9380,234,428386,-212,9380,33,9385,275,B
2016-03-25 13:30:47,9380,2,428388,-2,9380,32,9385,286,B
2016-03-25 13:30:48,9385,24,428412,-6,9380,36,9385,274,B
2016-03-25 13:30:49,9380,4,428416,0,9380,36,9385,274,S
2016-03-25 13:30:51,9380,4,428420,0,9380,34,9385,273,S
2016-03-25 13:30:52,9385,54,428474,-20,9380,5,9385,248,B
2016-03-25 13:30:56,9380,2,428476,2,9380,19,9385,248,S
2016-03-25 13:30:58,9385,22,428498,22,9380,35,9385,237,B
2016-03-25 13:31:00,9385,50,428548,50,9380,59,9385,212,B
2016-03-25 13:31:00.5,9380,2,428550,2,9380,62,9385,212,S
2016-03-25 13:31:01,9385,4,428554,4,9380,63,9385,210,B
2016-03-25 13:31:02,9385,10,428564,10,9380,64,9385,205,B
2016-03-25 13:31:03,9385,10,428574,10,9380,249,9385,200,B
2016-03-25 13:31:04,9385,10,428584,10,9380,249,9385,195,B
2016-03-25 13:31:05,9385,12,428596,12,9380,249,9385,198,B
2016-03-25 13:31:06,9380,4,428600,4,9380,249,9385,200,S
2016-03-25 13:31:07,9385,398,428998,184,9385,9,9390,283,B
2016-03-25 13:31:07.5,9385,4,429002,4,9385,23,9390,282,B
2016-03-25 13:31:08,9385,126,429128,-20,9385,4,9390,282,B
2016-03-25 13:31:09,9385,2,429130,0,9385,14,9390,282,B
2016-03-25 13:31:10,9385,2,429132,2,9385,14,9390,282,B
2016-03-25 13:31:10.5,9385,24,429156,0,9385,3,9390,281,B
2016-03-25 13:31:11,9390,2,429158,2,9385,4,9390,280,B
2016-03-25 13:31:12,9385,2,429160,0,9385,6,9390,328,S
2016-03-25 13:31:12.5,9385,2,429162,2,9385,5,9390,328,S
2016-03-25 13:31:13,9385,12,429174,12,9380,387,9385,21,S
2016-03-25 13:31:13.5,9385,10,429184,10,9380,387,9385,16,S
2016-03-25 13:31:14,9385,32,429216,-14,9385,34,9390,349,S
2016-03-25 13:31:14.5,9385,68,429284,-68,9385,4,9390,350,S
2016-03-25 13:31:15,9385,20,429304,2,9385,7,9390,349,S
2016-03-25 13:31:15.5,9385,14,429318,0,9380,377,9385,20,S
2016-03-25 13:31:16,9385,2,429320,2,9380,377,9385,19,S
2016-03-25 13:31:17,9385,24,429344,12,9385,1,9390,358,S
2016-03-25 13:31:17.5,9390,62,429406,54,9385,10,9390,330,B
2016-03-25 13:31:18,9385,2,429408,2,9385,66,9390,329,S
2016-03-25 13:31:19,9385,6,429414,4,9385,113,9390,335,S
2016-03-25 13:31:21,9390,38,429452,16,9385,141,9390,317,B
2016-03-25 13:31:21.5,9385,2,429454,2,9385,141,9390,317,S
2016-03-25 13:31:22,9385,4,429458,0,9385,191,9390,316,S
2016-03-25 13:31:23,9385,2,429460,2,9385,190,9390,306,S
2016-03-25 13:31:23.5,9390,4,429464,4,9385,191,9390,304,B
2016-03-25 13:31:24,9385,2,429466,2,9385,294,9390,304,S
2016-03-25 13:31:27,9385,100,429566,100,9385,185,9390,305,S
2016-03-25 13:31:30,9385,2,429568,0,9385,204,9390,312,S
2016-03-25 13:31:31,9385,4,429572,0,9385,204,9390,304,S
2016-03-25 13:31:33,9390,40,429612,36,9385,184,9390,305,B
2016-03-25 13:31:33.5,9390,20,429632,20,9385,184,9390,296,B
2016-03-25 13:31:34,9390,12,429644,0,9385,195,9390,291,B
2016-03-25 13:31:34.5,9385,4,429648,4,9385,193,9390,291,S
2016-03-25 13:31:35,9385,28,429676,28,9385,179,9390,294,S
2016-03-25 13:31:36,9385,2,429678,2,9385,178,9390,294,S
2016-03-25 13:31:37,9385,6,429684,2,9385,175,9390,294,S
2016-03-25 13:31:40,9385,2,429686,2,9385,164,9390,318,S
2016-03-25 13:31:41,9385,4,429690,4,9385,162,9390,328,S
2016-03-25 13:31:45,9390,10,429700,0,9385,163,9390,334,B
2016-03-25 13:31:45.5,9385,2,429702,0,9385,161,9390,334,S
2016-03-25 13:31:46,9385,12,429714,2,9385,155,9390,334,S
2016-03-25 13:31:47,9390,10,429724,10,9385,155,9390,329,B
2016-03-25 13:31:47.5,9390,2,429726,0,9385,161,9390,328,B
2016-03-25 13:31:48,9385,6,429732,-6,9385,158,9390,328,S
2016-03-25 13:31:49,9390,12,429744,12,9385,159,9390,324,B
2016-03-25 13:31:49.5,9385,4,429748,0,9385,157,9390,324,S
2016-03-25 13:31:50,9390,48,429796,-32,9385,137,9390,320,B
2016-03-25 13:31:50.5,9390,2,429798,2,9385,164,9390,320,B
2016-03-25 13:31:51,9385,22,429820,0,9385,153,9390,320,S
2016-03-25 13:31:52,9390,2,429822,2,9385,158,9390,332,B
2016-03-25 13:31:53,9390,106,429928,100,9385,155,9390,282,B
2016-03-25 13:31:54,9390,8,429936,4,9385,155,9390,275,B
2016-03-25 13:31:56,9390,2,429938,2,9385,155,9390,274,B
2016-03-25 13:31:57,9385,4,429942,2,9385,154,9390,273,S
2016-03-25 13:31:57.5,9390,2,429944,2,9385,154,9390,272,B
2016-03-25 13:31:58,9385,2,429946,-2,9385,153,9390,272,S
2016-03-25 13:32:00,9390,4,429950,2,9385,152,9390,272,B
2016-03-25 13:32:01,9390,2,429952,0,9385,155,9390,271,B
2016-03-25 13:32:09,9385,4,429956,-2,9385,169,9390,293,S
2016-03-25 13:32:12,9385,2,429958,0,9385,130,9390,293,S
2016-03-25 13:32:13,9390,4,429962,4,9385,130,9390,291,B
2016-03-25 13:32:16,9385,6,429968,-4,9385,130,9390,293,S
2016-03-25 13:32:17,9385,2,429970,2,9385,129,9390,293,S
2016-03-25 13:32:19,9385,2,429972,2,9385,128,9390,303,S
2016-03-25 13:32:21,9385,2,429974,2,9385,129,9390,303,S
2016-03-25 13:32:25,9385,2,429976,2,9385,152,9390,312,S
2016-03-25 13:32:27,9385,20,429996,-16,9385,142,9390,317,S
2016-03-25 13:32:28,9385,60,430056,-16,9385,112,9390,316,S
2016-03-25 13:32:29,9385,42,430098,-20,9385,112,9390,317,S
2016-03-25 13:32:29.3333,9385,48,430146,42,9385,108,9390,317,S
2016-03-25 13:32:29.6667,9390,16,430162,2,9385,107,9390,310,B
2016-03-25 13:32:30,9385,2,430164,2,9385,106,9390,310,S
2016-03-25 13:32:31,9385,56,430220,-12,9380,228,9390,291,S
2016-03-25 13:32:31.3333,9385,2,430222,0,9380,228,9390,291,S
2016-03-25 13:32:31.6667,9390,8,430230,0,9385,50,9390,287,B
2016-03-25 13:32:32,9385,28,430258,0,9380,228,9390,287,S
2016-03-25 13:32:33,9385,6,430264,-2,9380,296,9385,4,S
2016-03-25 13:32:35,9380,2,430266,2,9380,295,9385,112,S
2016-03-25 13:32:36,9380,4,430270,0,9380,294,9385,117,S
2016-03-25 13:32:38,9385,2,430272,0,9380,294,9385,116,B
2016-03-25 13:32:39,9385,234,430506,-26,9385,77,9390,372,B
2016-03-25 13:32:40,9385,12,430518,-10,9385,126,9390,310,B
2016-03-25 13:32:40.5,9385,4,430522,0,9385,95,9390,310,B
2016-03-25 13:32:41,9385,6,430528,-4,9385,106,9390,311,B
2016-03-25 13:32:42,9390,206,430734,16,9385,110,9390,209,B
2016-03-25 13:32:43,9385,14,430748,-6,9385,133,9390,208,S
2016-03-25 13:32:44,9390,16,430764,-4,9385,176,9390,203,B
2016-03-25 13:32:48,9385,2,430766,0,9385,167,9390,208,S
2016-03-25 13:32:50,9390,2,430768,-2,9385,167,9390,204,B
2016-03-25 13:32:52,9385,4,430772,-4,9385,161,9390,204,S
2016-03-25 13:32:53,9385,30,430802,0,9385,146,9390,204,S
2016-03-25 13:32:54,9390,4,430806,-2,9385,144,9390,203,B
2016-03-25 13:32:59,9385,10,430816,0,9385,147,9390,203,S
2016-03-25 13:33:03,9385,4,430820,-4,9385,154,9390,211,S
2016-03-25 13:33:03.5,9390,40,430860,10,9385,154,9390,201,B
2016-03-25 13:33:04,9385,2,430862,-2,9385,164,9390,201,S
2016-03-25 13:33:05,9390,8,430870,-2,9385,161,9390,197,B
2016-03-25 13:33:06,9390,72,430942,56,9385,152,9390,161,B
2016-03-25 13:33:06.5,9390,48,430990,-20,9385,150,9390,136,B
2016-03-25 13:33:07,9390,128,431118,34,9385,160,9390,71,B
2016-03-25 13:33:07.5,9390,38,431156,18,9385,147,9390,52,B
2016-03-25 13:33:08,9390,34,431190,18,9385,144,9390,35,B
2016-03-25 13:33:09,9390,54,431244,-24,9385,144,9390,100,B
2016-03-25 13:33:10,9390,10,431254,4,9385,144,9390,96,B
2016-03-25 13:33:11,9390,2,431256,0,9385,140,9390,101,B
2016-03-25 13:33:11.5,9385,2,431258,-2,9385,137,9390,102,S
2016-03-25 13:33:12,9390,8,431266,-6,9385,155,9390,98,B
2016-03-25 13:33:13,9390,6,431272,0,9385,161,9390,97,B
2016-03-25 13:33:17,9390,4,431276,0,9385,143,9390,177,B
2016-03-25 13:33:18,9385,4,431280,-4,9385,132,9390,199,S
2016-03-25 13:33:22,9390,2,431282,0,9385,123,9390,260,B
2016-03-25 13:33:26,9390,132,431414,-24,9385,123,9390,253,B
2016-03-25 13:33:27,9390,2,431416,-2,9385,147,9390,252,B
2016-03-25 13:33:27.5,9385,2,431418,-2,9385,146,9390,252,S
2016-03-25 13:33:28,9390,2,431420,0,9385,146,9390,251,B
2016-03-25 13:33:29,9390,54,431474,-40,9385,221,9390,223,B
2016-03-25 13:33:33,9385,2,431476,0,9385,230,9390,224,S
2016-03-25 13:33:38,9385,2,431478,-2,9385,230,9390,225,S
2016-03-25 13:33:39,9390,8,431486,-8,9385,230,9390,221,B
2016-03-25 13:33:40,9390,2,431488,0,9385,231,9390,221,B
2016-03-25 13:33:42,9385,392,431880,108,9380,263,9385,96,S
2016-03-25 13:33:42.5,9385,16,431896,0,9380,230,9385,112,S
2016-03-25 13:33:43,9380,12,431908,-10,9380,208,9385,207,S
2016-03-25 13:33:44,9380,42,431950,-40,9380,187,9385,107,S
2016-03-25 13:33:44.5,9380,200,432150,74,9380,86,9385,107,S
2016-03-25 13:33:45,9380,22,432172,0,9380,72,9385,108,S
2016-03-25 13:33:45.5,9380,2,432174,-2,9380,72,9385,138,S
2016-03-25 13:33:46,9380,12,432186,2,9380,66,9385,158,S
2016-03-25 13:33:46.5,9380,164,432350,90,9375,427,9380,18,S
2016-03-25 13:33:47,9380,2,432352,2,9375,427,9380,35,S
2016-03-25 13:33:47.5,9380,30,432382,20,9375,427,9380,23,S
2016-03-25 13:33:48,9380,48,432430,-22,9380,27,9385,164,S
2016-03-25 13:33:49,9380,6,432436,-4,9380,32,9385,165,S
2016-03-25 13:33:49.5,9385,12,432448,-8,9380,37,9385,164,B
2016-03-25 13:33:50,9380,38,432486,0,9380,19,9385,164,S
2016-03-25 13:33:50.5,9380,38,432524,14,9375,405,9380,8,S
2016-03-25 13:33:52,9380,2,432526,2,9375,405,9380,63,S
2016-03-25 13:33:55,9380,4,432530,-2,9375,386,9380,82,S
2016-03-25 13:33:55.5,9380,42,432572,30,9375,386,9380,71,S
2016-03-25 13:33:57,9380,40,432612,0,9375,387,9380,56,S
2016-03-25 13:34:01,9380,100,432712,-2,9380,35,9385,242,S
2016-03-25 13:34:02,9380,2,432714,-2,9380,66,9385,202,S
2016-03-25 13:34:03,9380,2,432716,0,9380,58,9385,202,S
2016-03-25 13:34:04,9380,30,432746,-30,9380,46,9385,207,S
2016-03-25 13:34:04.5,9380,20,432766,0,9380,51,9385,207,S
2016-03-25 13:34:05,9380,22,432788,6,9380,71,9385,207,S
2016-03-25 13:34:06,9380,2,432790,2,9380,68,9385,207,S
2016-03-25 13:34:07,9380,4,432794,4,9380,66,9385,207,S
2016-03-25 13:34:10,9380,20,432814,-16,9380,25,9385,211,S
2016-03-25 13:34:10.5,9380,4,432818,-4,9380,12,9385,212,S
2016-03-25 13:34:11,9380,64,432882,16,9375,408,9380,26,S
2016-03-25 13:34:11.5,9380,26,432908,0,9375,403,9380,52,S
2016-03-25 13:34:20,9380,2,432910,2,9375,416,9380,144,S
2016-03-25 13:34:20.5,9375,2,432912,-2,9375,415,9380,149,S
2016-03-25 13:34:21,9375,6,432918,-6,9375,413,9380,149,S
2016-03-25 13:34:22,9380,246,433164,-234,9375,412,9380,26,B
2016-03-25 13:34:23,9380,50,433214,-32,9380,3,9385,258,B
2016-03-25 13:34:26,9380,8,433222,-8,9380,116,9385,176,B
2016-03-25 13:34:28,9380,2,433224,0,9380,183,9385,176,B
2016-03-25 13:34:30,9380,2,433226,0,9380,195,9385,176,B
2016-03-25 13:34:31,9385,2,433228,0,9380,195,9385,166,B
2016-03-25 13:34:32,9385,2,433230,2,9380,205,9385,170,B
2016-03-25 13:34:37,9380,4,433234,0,9380,205,9385,174,S
2016-03-25 13:34:38,9380,2,433236,0,9380,200,9385,173,S
2016-03-25 13:34:40,9380,2,433238,2,9380,201,9385,173,S
2016-03-25 13:34:54,9380,2,433240,0,9380,199,9385,216,S
2016-03-25 13:34:59,9380,2,433242,-2,9380,192,9385,225,S
2016-03-25 13:35:02,9380,2,433244,0,9380,170,9385,226,S
2016-03-25 13:35:03,9385,20,433264,6,9380,149,9385,215,B
2016-03-25 13:35:08,9380,2,433266,0,9380,153,9385,216,S
2016-03-25 13:35:12,9385,2,433268,0,9380,184,9385,216,B
2016-03-25 13:35:12.5,9385,2,433270,0,9380,184,9385,215,B
2016-03-25 13:35:13,9380,2,433272,0,9380,183,9385,215,S
2016-03-25 13:35:15,9385,20,433292,-20,9380,186,9385,205,B
2016-03-25 13:35:17,9380,2,433294,-2,9380,185,9385,205,S
2016-03-25 13:35:17.5,9380,20,433314,10,9380,174,9385,205,S
2016-03-25 13:35:22,9380,2,433316,2,9380,173,9385,206,S
2016-03-25 13:35:23,9380,2,433318,2,9380,172,9385,206,S
2016-03-25 13:35:24,9385,2,433320,-2,9380,172,9385,225,B
2016-03-25 13:35:27,9385,96,433416,-84,9380,193,9385,139,B
2016-03-25 13:35:28,9385,280,433696,52,9385,141,9390,340,B
2016-03-25 13:35:28.5,9390,44,433740,-22,9385,115,9390,296,B
2016-03-25 13:35:29,9390,8,433748,-8,9385,103,9390,232,B
2016-03-25 13:35:30,9385,2,433750,-2,9385,102,9390,231,S
2016-03-25 13:35:32,9385,2,433752,0,9385,103,9390,231,S
2016-03-25 13:35:36,9385,4,433756,-4,9385,152,9390,213,S
2016-03-25 13:35:37,9390,2,433758,0,9385,148,9390,212,B
2016-03-25 13:35:43,9390,2,433760,0,9385,173,9390,210,B
2016-03-25 13:35:46,9390,30,433790,-20,9385,191,9390,196,B
2016-03-25 13:35:47,9385,2,433792,0,9385,193,9390,196,S
2016-03-25 13:35:50,9390,82,433874,0,9385,437,9390,165,B
2016-03-25 13:35:50.5,9390,10,433884,-8,9385,436,9390,162,B
2016-03-25 13:35:51,9390,2,433886,0,9385,446,9390,161,B
2016-03-25 13:35:52,9390,16,433902,-10,9385,446,9390,153,B
2016-03-25 13:35:53,9390,4,433906,2,9385,446,9390,151,B
2016-03-25 13:35:55,9390,20,433926,-16,9385,446,9390,141,B
2016-03-25 13:35:56,9390,32,433958,-26,9385,431,9390,126,B
2016-03-25 13:35:57,9390,2,433960,2,9385,411,9390,125,B
2016-03-25 13:35:58,9390,44,434004,-22,9385,389,9390,103,B
2016-03-25 13:35:58.5,9390,12,434016,0,9385,383,9390,97,B
2016-03-25 13:35:59,9390,66,434082,54,9385,363,9390,64,B
2016-03-25 13:36:00,9390,2,434084,2,9385,363,9390,63,B
2016-03-25 13:36:00.5,9390,6,434090,2,9385,364,9390,60,B
2016-03-25 13:36:01,9390,118,434208,-18,9390,1,9395,526,B
2016-03-25 13:36:01.5,9390,6,434214,-2,9385,578,9390,166,B
2016-03-25 13:36:02,9390,4,434218,-4,9385,586,9390,166,B
2016-03-25 13:36:04,9390,4,434222,-4,9385,578,9390,193,B
2016-03-25 13:36:07,9390,4,434226,0,9385,567,9390,198,B
2016-03-25 13:36:11,9390,2,434228,0,9385,568,9390,197,B
2016-03-25 13:36:14,9390,200,434428,-200,9385,513,9390,175,B
2016-03-25 13:36:15,9385,2,434430,0,9385,509,9390,181,S
2016-03-25 13:36:16,9390,2,434432,0,9385,507,9390,181,B
2016-03-25 13:36:19,9390,2,434434,0,9385,400,9390,184,B
2016-03-25 13:36:19.5,9390,10,434444,-10,9385,400,9390,178,B
2016-03-25 13:36:20,9390,2,434446,0,9385,400,9390,150,B
2016-03-25 13:36:20.5,9390,6,434452,-6,9385,409,9390,147,B
2016-03-25 13:36:25,9385,24,434476,-24,9385,164,9390,147,S
2016-03-25 13:36:28,9385,4,434480,0,9385,183,9390,176,S
2016-03-25 13:36:29,9390,2,434482,-2,9385,184,9390,175,B
2016-03-25 13:36:32,9390,2,434484,0,9385,185,9390,174,B
2016-03-25 13:36:35,9390,300,434784,228,9385,197,9390,22,B
2016-03-25 13:36:36,9390,48,434832,-48,9390,186,9395,491,B
2016-03-25 13:36:37,9390,4,434836,0,9390,185,9395,485,B
2016-03-25 13:36:38,9395,20,434856,-6,9390,197,9395,475,B
2016-03-25 13:36:39,9395,14,434870,2,9390,197,9395,471,B
2016-03-25 13:36:40,9395,30,434900,2,9390,196,9395,456,B
2016-03-25 13:36:40.5,9395,4,434904,0,9390,199,9395,455,B
2016-03-25 13:36:41,9395,4,434908,4,9390,199,9395,455,B
2016-03-25 13:36:42,9390,2,434910,0,9390,207,9395,461,S
2016-03-25 13:36:44,9395,16,434926,0,9390,207,9395,431,B
2016-03-25 13:36:45,9395,12,434938,2,9390,198,9395,425,B
2016-03-25 13:36:46,9395,12,434950,10,9390,199,9395,418,B
2016-03-25 13:36:47,9395,2,434952,0,9390,200,9395,417,B
2016-03-25 13:36:49,9390,4,434956,0,9390,198,9395,438,S
2016-03-25 13:36:49.5,9390,4,434960,-4,9390,196,9395,439,S
2016-03-25 13:36:52,9390,200,435160,-86,9390,200,9395,442,S
2016-03-25 13:36:53,9390,12,435172,12,9390,169,9395,431,S
2016-03-25 13:36:54,9390,2,435174,2,9390,164,9395,440,S
2016-03-25 13:36:55,9390,32,435206,0,9390,141,9395,446,S
2016-03-25 13:36:56,9390,2,435208,2,9390,139,9395,433,S
2016-03-25 13:36:56.5,9390,280,435488,252,9385,206,9390,60,S
2016-03-25 13:36:57,9390,2,435490,2,9385,167,9390,66,S
2016-03-25 13:36:58,9390,2,435492,2,9385,140,9390,93,S
2016-03-25 13:37:00,9390,2,435494,0,9385,139,9390,87,S
2016-03-25 13:37:01,9390,2,435496,0,9385,139,9390,106,S
2016-03-25 13:37:02,9390,2,435498,0,9385,139,9390,105,S
2016-03-25 13:37:03,9390,2,435500,0,9385,129,9390,106,S
2016-03-25 13:37:03.5,9385,2,435502,-2,9385,131,9390,108,S
2016-03-25 13:37:08,9390,18,435520,8,9385,322,9390,229,B
2016-03-25 13:37:09,9385,2,435522,0,9385,284,9390,234,S
2016-03-25 13:37:10,9385,2,435524,-2,9385,288,9390,235,S
2016-03-25 13:37:13,9385,2,435526,0,9385,295,9390,230,S
2016-03-25 13:37:14,9390,6,435532,0,9385,316,9390,234,B
2016-03-25 13:37:18,9385,2,435534,-2,9385,315,9390,238,S
2016-03-25 13:37:19,9385,10,435544,6,9385,310,9390,238,S
2016-03-25 13:37:22,9390,200,435744,-100,9385,669,9390,139,B
2016-03-25 13:37:22.3333,9390,282,436026,216,9390,56,9395,462,B
2016-03-25 13:37:22.6667,9390,2,436028,2,9390,71,9395,461,B
2016-03-25 13:37:24,9390,68,436096,66,9385,678,9390,4,B
2016-03-25 13:37:24.5,9390,22,436118,-2,9390,5,9395,461,B
2016-03-25 13:37:26,9390,20,436138,14,9390,109,9395,460,B
2016-03-25 13:37:27,9390,2,436140,2,9390,108,9395,460,B
2016-03-25 13:37:27.5,9390,2,436142,2,9390,107,9395,440,B
2016-03-25 13:37:29,9390,2,436144,2,9390,110,9395,440,B
2016-03-25 13:37:29.5,9395,2,436146,2,9390,110,9395,439,B
2016-03-25 13:37:30,9390,4,436150,0,9390,109,9395,439,S
2016-03-25 13:37:30.5,9395,12,436162,12,9390,122,9395,443,B
2016-03-25 13:37:31,9395,46,436208,46,9390,159,9395,419,B
2016-03-25 13:37:31.5,9395,4,436212,0,9390,161,9395,418,B
2016-03-25 13:37:32,9390,4,436216,4,9390,173,9395,420,S
2016-03-25 13:37:34,9395,2,436218,2,9390,229,9395,522,B
2016-03-25 13:37:38,9390,10,436228,0,9390,236,9395,524,S
2016-03-25 13:37:40,9390,60,436288,0,9390,214,9395,525,S
2016-03-25 13:37:40.5,9390,428,436716,212,9385,442,9390,54,S
2016-03-25 13:37:41,9390,16,436732,-8,9385,416,9390,49,S
2016-03-25 13:37:41.5,9390,38,436770,-4,9385,415,9390,31,S
2016-03-25 13:37:42,9390,24,436794,0,9385,415,9390,35,S
2016-03-25 13:37:44,9390,6,436800,-6,9385,278,9390,32,S
2016-03-25 13:37:45,9390,64,436864,12,9390,66,9395,601,S
2016-03-25 13:37:45.3333,9390,136,437000,-62,9385,161,9395,527,S
2016-03-25 13:37:45.6667,9390,40,437040,6,9385,230,9395,555,S
2016-03-25 13:37:46,9390,24,437064,0,9385,227,9390,21,S
2016-03-25 13:37:46.5,9390,6,437070,0,9385,235,9390,5,S
2016-03-25 13:37:47,9390,38,437108,-4,9385,225,9390,91,S
2016-03-25 13:37:48,9390,92,437200,-6,9385,180,9390,46,S
2016-03-25 13:37:48.5,9390,2,437202,-2,9385,180,9390,27,S
2016-03-25 13:37:49,9390,2,437204,0,9385,179,9390,31,S
2016-03-25 13:37:51,9390,4,437208,0,9385,179,9390,145,S
2016-03-25 13:37:55,9390,14,437222,0,9385,132,9390,241,S
2016-03-25 13:37:56,9385,2,437224,2,9385,131,9390,240,S
2016-03-25 13:38:03,9390,14,437238,-10,9385,245,9390,130,B
2016-03-25 13:38:07,9390,20,437258,20,9385,235,9390,120,B
2016-03-25 13:38:07.5,9390,240,437498,72,9390,25,9395,606,B
2016-03-25 13:38:08,9390,14,437512,4,9390,26,9395,581,B
2016-03-25 13:38:09,9390,2,437514,2,9390,26,9395,588,B
2016-03-25 13:38:10,9395,2,437516,0,9390,17,9395,587,B
2016-03-25 13:38:11,9395,2,437518,0,9390,17,9395,587,B
2016-03-25 13:38:11.5,9390,82,437600,-10,9385,212,9390,162,S
2016-03-25 13:38:15,9390,2,437602,2,9385,177,9390,166,S
2016-03-25 13:38:21,9385,6,437608,0,9385,202,9390,165,S
2016-03-25 13:38:23,9385,10,437618,0,9385,207,9390,166,S
2016-03-25 13:38:23.5,9385,2,437620,2,9385,206,9390,167,S
2016-03-25 13:38:26,9390,220,437840,0,9385,207,9390,57,B
2016-03-25 13:38:26.5,9390,2,437842,-2,9385,207,9390,56,B
2016-03-25 13:38:28,9390,118,437960,6,9390,24,9395,679,B
2016-03-25 13:38:28.5,9390,22,437982,0,9390,15,9395,593,B
2016-03-25 13:38:31,9390,2,437984,2,9390,17,9395,592,B
2016-03-25 13:38:31.5,9390,4,437988,0,9390,16,9395,592,B
2016-03-25 13:38:32,9390,2,437990,0,9390,15,9395,592,B
2016-03-25 13:38:32.5,9390,30,438020,30,9385,484,9390,61,B
2016-03-25 13:38:33,9390,136,438156,46,9390,41,9395,590,B
2016-03-25 13:38:35,9390,6,438162,0,9390,91,9395,591,B
2016-03-25 13:38:36,9390,22,438184,20,9390,100,9395,591,B
2016-03-25 13:38:36.5,9395,200,438384,200,9390,100,9395,487,B
2016-03-25 13:38:38,9390,2,438386,2,9390,123,9395,489,S
2016-03-25 13:38:41,9395,2,438388,2,9390,126,9395,491,B
2016-03-25 13:38:44,9395,2,438390,2,9390,129,9395,491,B
2016-03-25 13:38:46,9390,2,438392,2,9390,75,9395,489,S
2016-03-25 13:38:47,9390,2,438394,2,9390,74,9395,489,S
2016-03-25 13:38:51,9395,8,438402,8,9390,89,9395,490,B
2016-03-25 13:38:56,9395,60,438462,48,9390,253,9395,462,B
2016-03-25 13:38:58,9395,2,438464,0,9390,259,9395,481,B
2016-03-25 13:38:59,9390,2,438466,2,9390,157,9395,481,S
2016-03-25 13:38:59.5,9395,2,438468,0,9390,158,9395,480,B
2016-03-25 13:39:00,9395,2,438470,-2,9390,154,9395,479,B
2016-03-25 13:39:00.5,9390,2,438472,2,9390,240,9395,479,S
2016-03-25 13:39:01,9395,2,438474,0,9390,240,9395,472,B
2016-03-25 13:39:02,9395,2,438476,-2,9390,288,9395,471,B
2016-03-25 13:39:03,9390,2,438478,0,9390,286,9395,470,S
2016-03-25 13:39:05,9395,2,438480,0,9390,309,9395,476,B
2016-03-25 13:39:06,9395,2,438482,2,9390,314,9395,475,B
2016-03-25 13:39:10,9395,2,438484,0,9390,520,9395,475,B
2016-03-25 13:39:11,9395,22,438506,2,9390,511,9395,474,B
2016-03-25 13:39:12,9390,4,438510,0,9390,791,9395,474,S
2016-03-25 13:39:14,9395,2,438512,2,9390,516,9395,472,B
2016-03-25 13:39:14.5,9395,4,438516,2,9390,517,9395,470,B
2016-03-25 13:39:17,9395,2,438518,2,9390,521,9395,468,B
2016-03-25 13:39:18,9395,6,438524,4,9390,520,9395,465,B
2016-03-25 13:39:21,9395,180,438704,100,9390,410,9395,372,B
2016-03-25 13:39:21.5,9395,16,438720,0,9390,410,9395,364,B
2016-03-25 13:39:22,9390,438,439158,334,9385,291,9395,364,S
2016-03-25 13:39:23,9390,32,439190,20,9385,293,9395,364,S
2016-03-25 13:39:23.5,9390,2,439192,0,9385,293,9395,415,S
2016-03-25 13:39:24,9390,10,439202,10,9385,293,9395,425,S
2016-03-25 13:39:24.5,9390,20,439222,20,9385,293,9395,425,S
2016-03-25 13:39:25,9395,2,439224,-2,9385,285,9395,424,B
2016-03-25 13:39:27,9395,2,439226,2,9385,444,9390,48,B
2016-03-25 13:39:31,9390,6,439232,2,9385,422,9390,143,S
2016-03-25 13:39:31.5,9390,2,439234,2,9385,423,9390,157,S
2016-03-25 13:39:32,9390,2,439236,-2,9385,422,9390,156,S
2016-03-25 13:39:32.5,9390,6,439242,-6,9385,416,9390,153,S
2016-03-25 13:39:33,9390,2,439244,0,9385,427,9390,152,S
2016-03-25 13:39:34,9390,306,439550,48,9390,14,9395,417,S
2016-03-25 13:39:34.5,9390,60,439610,2,9385,281,9390,173,S
2016-03-25 13:39:35,9390,4,439614,0,9385,281,9390,171,S
2016-03-25 13:39:35.5,9390,16,439630,0,9385,281,9390,163,S
2016-03-25 13:39:37,9385,554,440184,246,9380,556,9385,97,S
2016-03-25 13:39:37.5,9385,2,440186,0,9380,553,9385,93,S
2016-03-25 13:39:38,9385,10,440196,10,9380,553,9385,89,S
2016-03-25 13:39:39,9385,10,440206,10,9380,553,9385,84,S
2016-03-25 13:39:40,9385,120,440326,0,9380,411,9385,26,S
2016-03-25 13:39:41,9385,58,440384,-20,9385,17,9390,216,S
2016-03-25 13:39:42,9385,2,440386,0,9385,23,9390,216,S
2016-03-25 13:39:43,9390,2,440388,-2,9385,126,9390,307,B
2016-03-25 13:39:46,9385,4,440392,-4,9385,124,9390,309,S
2016-03-25 13:39:48,9385,2,440394,-2,9385,128,9390,308,S
2016-03-25 13:39:48.5,9385,4,440398,-4,9385,126,9390,310,S
2016-03-25 13:39:49,9385,4,440402,-4,9385,129,9390,310,S
2016-03-25 13:39:50,9385,42,440444,-40,9385,128,9390,290,S
2016-03-25 13:39:55,9390,2,440446,0,9385,131,9390,349,B
2016-03-25 13:39:56,9390,2,440448,-2,9385,132,9390,350,B
2016-03-25 13:39:58,9385,26,440474,-24,9385,122,9390,341,S
2016-03-25 13:39:59,9385,258,440732,86,9380,431,9385,22,S
2016-03-25 13:40:00,9385,64,440796,56,9385,33,9390,350,S
2016-03-25 13:40:00.5,9385,30,440826,10,9380,431,9385,24,S
2016-03-25 13:40:01,9380,96,440922,40,9380,418,9385,2,S
2016-03-25 13:40:01.5,9380,46,440968,10,9380,404,9385,52,S
2016-03-25 13:40:02,9385,14,440982,14,9380,394,9385,99,B
2016-03-25 13:40:03,9385,12,440994,12,9380,394,9385,119,B
2016-03-25 13:40:04,9385,20,441014,20,9380,393,9385,129,B
2016-03-25 13:40:05,9385,4,441018,0,9380,393,9385,127,B
2016-03-25 13:40:08,9385,2,441020,0,9380,420,9385,161,B
2016-03-25 13:40:10,9385,296,441316,98,9380,452,9385,12,B
2016-03-25 13:40:11,9385,26,441342,-20,9385,72,9390,496,B
2016-03-25 13:40:11.5,9385,44,441386,0,9385,56,9390,496,B
2016-03-25 13:40:12,9385,2,441388,2,9385,86,9390,496,B
2016-03-25 13:40:12.5,9390,200,441588,134,9385,94,9390,393,B
2016-03-25 13:40:13,9385,202,441790,-68,9385,9,9390,391,S
2016-03-25 13:40:13.5,9385,10,441800,4,9385,7,9390,391,S
2016-03-25 13:40:14,9385,12,441812,2,9385,32,9390,386,S
2016-03-25 13:40:14.5,9390,206,442018,132,9385,30,9390,286,B
2016-03-25 13:40:16,9390,200,442218,110,9385,64,9390,185,B
2016-03-25 13:40:17,9390,2,442220,0,9385,123,9390,183,B
2016-03-25 13:40:18,9390,200,442420,4,9385,146,9390,86,B
2016-03-25 13:40:19,9390,268,442688,-220,9385,173,9390,7,B
2016-03-25 13:40:19.5,9390,74,442762,-2,9390,4,9395,318,B
2016-03-25 13:40:20,9390,2,442764,0,9390,3,9395,318,B
2016-03-25 13:40:20.5,9390,2,442766,0,9390,3,9395,318,B
2016-03-25 13:40:21,9390,202,442968,94,9390,6,9395,215,B
2016-03-25 13:40:23,9390,34,443002,-2,9385,227,9390,41,B
2016-03-25 13:40:25,9390,2,443004,-2,9385,228,9390,62,B
2016-03-25 13:40:25.5,9390,2,443006,0,9385,227,9390,67,B
2016-03-25 13:40:27,9390,2,443008,-2,9385,227,9390,66,B
2016-03-25 13:40:28,9390,20,443028,0,9385,248,9390,56,B
2016-03-25 13:40:29,9390,4,443032,0,9385,258,9390,54,B
2016-03-25 13:40:36,9390,4,443036,-4,9385,291,9390,119,B
2016-03-25 13:40:36.5,9390,4,443040,-2,9385,292,9390,117,B
2016-03-25 13:40:37,9390,160,443200,38,9385,282,9390,37,B
2016-03-25 13:40:38,9390,6,443206,-6,9385,287,9390,34,B
2016-03-25 13:40:39,9390,6,443212,6,9385,287,9390,31,B
2016-03-25 13:40:40,9385,22,443234,20,9385,280,9390,32,S
2016-03-25 13:40:42,9390,2,443236,0,9385,284,9390,41,B
2016-03-25 13:40:46,9390,8,443244,8,9385,273,9390,40,B
2016-03-25 13:40:46.5,9385,8,443252,0,9385,269,9390,44,S
2016-03-25 13:40:49,9385,434,443686,88,9385,31,9390,165,S
2016-03-25 13:40:50,9385,20,443706,-20,9385,24,9390,192,S
2016-03-25 13:40:51,9390,6,443712,4,9385,23,9390,209,B
2016-03-25 13:40:52,9390,2,443714,0,9385,23,9390,208,B
2016-03-25 13:40:53,9380,800,444514,-480,9380,226,9385,27,S
2016-03-25 13:40:53.5,9385,58,444572,-48,9380,200,9385,25,B
2016-03-25 13:40:54,9385,16,444588,16,9380,200,9385,30,B
2016-03-25 13:40:54.5,9385,12,444600,6,9380,199,9385,36,B
2016-03-25 13:40:55,9380,2,444602,0,9380,300,9385,45,S
2016-03-25 13:40:56,9385,2,444604,2,9380,294,9385,50,B
2016-03-25 13:40:58,9380,2,444606,0,9380,293,9385,90,S
2016-03-25 13:40:59,9385,6,444612,6,9380,295,9385,87,B
2016-03-25 13:41:03,9380,16,444628,-4,9380,280,9385,160,S
2016-03-25 13:41:05,9385,4,444632,4,9380,302,9385,161,B
2016-03-25 13:41:06,9385,2,444634,-2,9380,296,9385,160,B
2016-03-25 13:41:09,9380,12,444646,-6,9380,307,9385,160,S
2016-03-25 13:41:10,9380,12,444658,6,9380,303,9385,161,S
2016-03-25 13:41:10.5,9380,12,444670,10,9380,297,9385,161,S
2016-03-25 13:41:11,9380,8,444678,-8,9380,293,9385,162,S
2016-03-25 13:41:15,9380,104,444782,0,9380,225,9385,214,S
2016-03-25 13:41:19,9380,6,444788,-6,9380,223,9385,220,S
2016-03-25 13:41:19.5,9380,6,444794,0,9380,222,9385,220,S
2016-03-25 13:41:20,9380,20,444814,0,9380,211,9385,221,S
2016-03-25 13:41:22,9380,20,444834,0,9380,203,9385,222,S
2016-03-25 13:41:23,9380,2,444836,-2,9380,202,9385,222,S
2016-03-25 13:41:26,9380,2,444838,0,9380,205,9385,221,S
2016-03-25 13:41:28,9385,2,444840,-2,9380,205,9385,223,B
2016-03-25 13:41:29,9380,2,444842,0,9380,204,9385,223,S
2016-03-25 13:41:30,9380,48,444890,-6,9380,180,9385,223,S
2016-03-25 13:41:31,9380,96,444986,14,9380,134,9385,221,S
2016-03-25 13:41:31.5,9380,268,445254,66,9375,435,9380,147,S
2016-03-25 13:41:34,9380,2,445256,0,9375,430,9380,180,S
2016-03-25 13:41:35,9380,170,445426,-38,9380,39,9385,242,S
2016-03-25 13:41:36,9380,16,445442,-12,9380,73,9385,222,S
2016-03-25 13:41:36.5,9380,2,445444,-2,9380,83,9385,222,S
2016-03-25 13:41:37,9380,12,445456,0,9380,77,9385,222,S
2016-03-25 13:41:38,9380,6,445462,-6,9380,75,9385,222,S
2016-03-25 13:41:39,9380,164,445626,-144,9375,393,9380,26,S
2016-03-25 13:41:39.5,9380,4,445630,-2,9375,385,9380,42,S
2016-03-25 13:41:40,9380,140,445770,-46,9380,193,9385,242,S
2016-03-25 13:41:41,9380,2,445772,0,9380,225,9385,217,S
2016-03-25 13:41:42,9380,6,445778,-4,9380,239,9385,217,S
2016-03-25 13:41:45,9380,2,445780,0,9380,262,9385,217,S
2016-03-25 13:41:47,9380,2,445782,0,9380,249,9385,192,S
2016-03-25 13:41:52,9380,200,445982,-200,9380,132,9385,207,S
2016-03-25 13:41:54,9385,418,446400,-176,9385,49,9390,228,B
2016-03-25 13:41:55,9385,4,446404,-2,9385,57,9390,233,B
2016-03-25 13:41:56,9385,4,446408,0,9385,55,9390,234,B
2016-03-25 13:41:57,9385,84,446492,-76,9380,174,9390,217,B
2016-03-25 13:41:58,9385,24,446516,16,9380,176,9390,214,B
2016-03-25 13:41:58.5,9385,2,446518,0,9380,176,9390,214,B
2016-03-25 13:41:59,9380,8,446526,4,9380,233,9390,221,S
2016-03-25 13:42:00,9380,200,446726,-198,9380,134,9390,298,S
2016-03-25 13:42:07,9380,20,446746,-18,9380,160,9385,92,S
2016-03-25 13:42:09,9380,4,446750,0,9380,158,9385,95,S
2016-03-25 13:42:09.5,9380,4,446754,4,9380,156,9385,95,S
2016-03-25 13:42:11,9380,40,446794,-14,9380,145,9385,106,S
2016-03-25 13:42:15,9380,2,446796,0,9380,148,9385,113,S
2016-03-25 13:42:19,9380,2,446798,2,9380,149,9385,113,S
2016-03-25 13:42:22,9380,4,446802,4,9380,148,9385,114,S
2016-03-25 13:42:25,9385,186,446988,62,9385,10,9390,256,B
2016-03-25 13:42:26,9390,4,446992,0,9385,32,9390,230,B
2016-03-25 13:42:26.5,9390,2,446994,0,9385,64,9390,194,B
2016-03-25 13:42:27,9385,4,446998,4,9385,88,9390,194,S
2016-03-25 13:42:28,9385,36,447034,12,9385,71,9390,195,S
2016-03-25 13:42:29,9385,2,447036,2,9385,79,9390,195,S
2016-03-25 13:42:31,9385,4,447040,-2,9385,21,9390,201,S
2016-03-25 13:42:31.5,9385,2,447042,-2,9385,11,9390,201,S
2016-03-25 13:42:32,9390,6,447048,-6,9385,11,9390,198,B
2016-03-25 13:42:35,9385,4,447052,0,9385,88,9390,219,S
2016-03-25 13:42:36,9390,14,447066,-2,9385,98,9390,212,B
2016-03-25 13:42:46,9390,8,447074,-2,9385,137,9390,199,B
2016-03-25 13:42:49,9390,20,447094,-20,9385,139,9390,188,B
2016-03-25 13:42:51,9385,2,447096,-2,9385,133,9390,188,S
2016-03-25 13:42:53,9390,2,447098,0,9385,134,9390,189,B
2016-03-25 13:42:57,9385,6,447104,0,9385,116,9390,188,S
2016-03-25 13:42:58,9390,34,447138,-8,9385,116,9390,171,B
2016-03-25 13:42:59,9390,4,447142,4,9385,125,9390,170,B
2016-03-25 13:43:00,9390,68,447210,26,9385,194,9390,139,B
2016-03-25 13:43:01,9390,4,447214,2,9385,148,9390,138,B
2016-03-25 13:43:02,9390,2,447216,2,9385,122,9390,137,B
2016-03-25 13:43:03,9385,2,447218,0,9385,123,9390,148,S
2016-03-25 13:43:06,9390,6,447224,6,9385,202,9390,158,B
2016-03-25 13:43:06.5,9390,2,447226,2,9385,202,9390,156,B
2016-03-25 13:43:09,9390,2,447228,2,9385,202,9390,138,B
2016-03-25 13:43:17,9390,10,447238,-4,9385,258,9390,143,B
2016-03-25 13:43:18,9385,4,447242,4,9385,259,9390,143,S
2016-03-25 13:43:27,9390,2,447244,-2,9385,198,9390,133,B
2016-03-25 13:43:30,9385,10,447254,6,9385,193,9390,139,S
2016-03-25 13:43:35,9390,202,447456,86,9385,188,9390,38,B
2016-03-25 13:43:36,9390,86,447542,42,9385,214,9390,47,B
2016-03-25 13:43:36.5,9390,2,447544,0,9385,190,9390,22,B
2016-03-25 13:43:37,9385,68,447612,-36,9385,229,9390,27,S
2016-03-25 13:43:37.5,9390,6,447618,0,9385,204,9390,6,B
2016-03-25 13:43:45,9385,2,447620,0,9385,203,9390,133,S
2016-03-25 13:43:51,9385,12,447632,0,9385,201,9390,145,S
2016-03-25 13:43:57,9385,2,447634,0,9385,195,9390,165,S
2016-03-25 13:43:57.5,9385,4,447638,0,9385,194,9390,165,S
2016-03-25 13:43:58,9385,2,447640,0,9385,193,9390,165,S
2016-03-25 13:43:58.5,9385,20,447660,-4,9385,183,9390,165,S
2016-03-25 13:44:01,9385,20,447680,20,9385,176,9390,167,S
2016-03-25 13:44:06,9385,12,447692,2,9385,172,9390,174,S
2016-03-25 13:44:07,9385,2,447694,0,9385,168,9390,174,S
2016-03-25 13:44:11,9390,2,447696,-2,9385,168,9390,169,B
2016-03-25 13:44:12,9385,2,447698,0,9385,167,9390,171,S
2016-03-25 13:44:15,9385,4,447702,0,9385,172,9390,170,S
2016-03-25 13:44:16,9385,2,447704,0,9385,171,9390,170,S
2016-03-25 13:44:17,9390,4,447708,-4,9385,171,9390,175,B
2016-03-25 13:44:19,9385,2,447710,0,9385,171,9390,176,S
2016-03-25 13:44:23,9385,2,447712,0,9385,179,9390,205,S
2016-03-25 13:44:23.5,9385,4,447716,-2,9385,176,9390,205,S
2016-03-25 13:44:24,9390,2,447718,-2,9385,176,9390,204,B
2016-03-25 13:44:26,9385,14,447732,0,9385,145,9390,205,S
2016-03-25 13:44:26.5,9385,10,447742,10,9385,140,9390,205,S
2016-03-25 13:44:27,9385,24,447766,24,9385,128,9390,105,S
2016-03-25 13:44:27.3333,9385,202,447968,-18,9385,30,9390,106,S
2016-03-25 13:44:27.6667,9385,2,447970,-2,9385,29,9390,119,S
2016-03-25 13:44:29,9385,4,447974,-4,9385,27,9390,136,S
2016-03-25 13:44:29.3333,9385,12,447986,8,9385,21,9390,136,S
2016-03-25 13:44:29.6667,9390,4,447990,0,9385,20,9390,135,B
2016-03-25 13:44:30,9385,10,448000,4,9385,15,9390,135,S
2016-03-25 13:44:32,9385,2,448002,0,9385,14,9390,145,S
2016-03-25 13:44:34,9385,2,448004,0,9385,13,9390,148,S
2016-03-25 13:44:35,9385,2,448006,-2,9385,13,9390,157,S
2016-03-25 13:44:36,9390,2,448008,-2,9385,13,9390,156,B
2016-03-25 13:44:36.5,9385,42,448050,28,9380,411,9385,14,S
2016-03-25 13:44:37,9385,114,448164,64,9385,14,9390,159,S
2016-03-25 13:44:38,9385,2,448166,0,9385,12,9390,161,S
2016-03-25 13:44:39,9385,42,448208,-22,9380,361,9385,1,S
2016-03-25 13:44:39.5,9385,2,448210,2,9385,37,9390,161,S
2016-03-25 13:44:41,9390,38,448248,36,9385,10,9390,144,B
2016-03-25 13:44:41.5,9390,132,448380,58,9385,10,9390,77,B
2016-03-25 13:44:42,9385,40,448420,12,9380,553,9385,7,S
2016-03-25 13:44:42.5,9385,14,448434,0,9385,33,9390,140,S
2016-03-25 13:44:44,9385,2,448436,0,9385,44,9390,141,S
2016-03-25 13:44:45,9385,2,448438,0,9385,86,9390,116,S
2016-03-25 13:44:46,9390,58,448496,22,9385,87,9390,104,B
2016-03-25 13:44:47,9385,2,448498,0,9385,86,9390,106,S
2016-03-25 13:44:48,9385,4,448502,0,9385,86,9390,106,S
2016-03-25 13:44:49,9385,4,448506,4,9385,49,9390,107,S
2016-03-25 13:44:49.5,9385,78,448584,48,9380,490,9385,81,S
2016-03-25 13:44:50,9385,46,448630,46,9380,406,9385,72,S
2016-03-25 13:44:54,9385,2,448632,0,9380,227,9385,84,S
2016-03-25 13:44:57,9385,2,448634,2,9380,227,9385,93,S
2016-03-25 13:44:58,9385,4,448638,0,9380,227,9385,92,S
2016-03-25 13:45:00,9380,4,448642,4,9380,247,9385,104,S
2016-03-25 13:45:00.5,9385,6,448648,0,9380,294,9385,101,B
2016-03-25 13:45:01,9385,4,448652,2,9380,294,9385,99,B
2016-03-25 13:45:02,9390,262,448914,174,9385,7,9390,257,B
2016-03-25 13:45:02.5,9390,6,448920,0,9385,53,9390,256,B
2016-03-25 13:45:03,9385,14,448934,0,9385,72,9390,229,S
2016-03-25 13:45:05,9385,2,448936,-2,9385,106,9390,160,S
2016-03-25 13:45:05.3333,9390,24,448960,22,9385,106,9390,149,B
2016-03-25 13:45:05.6667,9390,8,448968,8,9385,106,9390,146,B
2016-03-25 13:45:06,9390,12,448980,12,9385,106,9390,180,B
2016-03-25 13:45:07,9390,16,448996,8,9385,105,9390,175,B
2016-03-25 13:45:08,9390,6,449002,6,9385,106,9390,176,B
2016-03-25 13:45:09,9390,8,449010,8,9385,108,9390,174,B
2016-03-25 13:45:10,9390,80,449090,40,9385,109,9390,132,B
2016-03-25 13:45:10.5,9390,210,449300,-40,9385,156,9390,26,B
2016-03-25 13:45:11,9390,94,449394,-44,9390,10,9395,427,B
2016-03-25 13:45:11.5,9395,32,449426,0,9390,2,9395,502,B
2016-03-25 13:45:12,9385,8,449434,-2,9385,183,9390,29,S
2016-03-25 13:45:12.3333,9390,66,449500,8,9385,184,9390,8,B
2016-03-25 13:45:12.6667,9390,32,449532,-22,9390,11,9395,520,B
2016-03-25 13:45:13,9395,2,449534,-2,9390,57,9395,519,B
2016-03-25 13:45:15,9395,72,449606,-38,9390,113,9395,484,B
2016-03-25 13:45:16,9395,4,449610,0,9390,116,9395,480,B
2016-03-25 13:45:17,9390,2,449612,2,9390,151,9395,399,S
2016-03-25 13:45:17.5,9395,772,450384,272,9395,1,9400,897,B
2016-03-25 13:45:18,9395,8,450392,8,9395,47,9400,895,B
2016-03-25 13:45:19,9400,2,450394,0,9395,51,9400,894,B
2016-03-25 13:45:19.5,9400,1826,452220,1216,9400,419,9405,530,B
2016-03-25 13:45:20,9405,338,452558,280,9400,432,9405,350,B
2016-03-25 13:45:20.5,9405,512,453070,86,9400,430,9405,80,B
2016-03-25 13:45:21,9405,168,453238,-116,9405,213,9410,377,B
2016-03-25 13:45:21.5,9410,60,453298,34,9405,96,9410,317,B
2016-03-25 13:45:22,9410,62,453360,-4,9405,110,9410,285,B
2016-03-25 13:45:22.5,9410,294,453654,-150,9405,119,9410,142,B
2016-03-25 13:45:23,9410,72,453726,-26,9405,114,9410,131,B
2016-03-25 13:45:23.5,9410,30,453756,0,9405,103,9410,231,B
2016-03-25 13:45:24,9410,76,453832,14,9405,113,9410,177,B
2016-03-25 13:45:24.5,9405,24,453856,-16,9405,96,9410,158,S
2016-03-25 13:45:25,9410,6,453862,-2,9405,98,9410,147,B
2016-03-25 13:45:25.5,9410,2,453864,-2,9405,99,9410,198,B
2016-03-25 13:45:26,9410,20,453884,-16,9405,89,9410,210,B
2016-03-25 13:45:26.5,9410,2,453886,0,9405,84,9410,199,B
2016-03-25 13:45:27,9410,76,453962,-14,9405,82,9410,175,B
2016-03-25 13:45:27.5,9410,12,453974,0,9405,81,9410,204,B
2016-03-25 13:45:28,9410,2,453976,0,9405,81,9410,206,B
2016-03-25 13:45:28.5,9410,8,453984,0,9405,81,9410,239,B
2016-03-25 13:45:29,9405,4,453988,0,9405,78,9410,240,S
2016-03-25 13:45:29.5,9405,2,453990,0,9405,89,9410,249,S
2016-03-25 13:45:30,9410,12,454002,-4,9405,125,9410,251,B
2016-03-25 13:45:30.5,9410,10,454012,0,9405,126,9410,200,B
2016-03-25 13:45:31,9405,40,454052,-40,9405,126,9410,176,S
2016-03-25 13:45:32,9410,4,454056,0,9405,124,9410,175,B
2016-03-25 13:45:32.5,9405,6,454062,-2,9405,120,9410,182,S
2016-03-25 13:45:33,9405,2,454064,-2,9405,120,9410,187,S
2016-03-25 13:45:34,9410,2,454066,0,9405,120,9410,186,B
2016-03-25 13:45:34.5,9410,4,454070,0,9405,124,9410,185,B
2016-03-25 13:45:35,9410,2,454072,0,9405,144,9410,184,B
2016-03-25 13:45:35.5,9410,4,454076,0,9405,148,9410,184,B
2016-03-25 13:45:36,9410,20,454096,0,9405,149,9410,191,B
2016-03-25 13:45:37,9405,32,454128,2,9405,139,9410,191,S
2016-03-25 13:45:37.5,9410,32,454160,-22,9405,149,9410,180,B
2016-03-25 13:45:40,9410,10,454170,0,9405,158,9410,188,B
2016-03-25 13:45:40.3333,9410,100,454270,6,9405,161,9410,187,B
2016-03-25 13:45:40.6667,9410,4,454274,0,9405,162,9410,185,B
2016-03-25 13:45:42,9410,14,454288,12,9405,176,9410,191,B
2016-03-25 13:45:42.5,9410,18,454306,6,9405,249,9410,184,B
2016-03-25 13:45:44,9410,100,454406,-48,9405,268,9410,137,B
2016-03-25 13:45:44.5,9410,6,454412,-4,9405,268,9410,134,B
2016-03-25 13:45:45,9410,8,454420,-2,9405,279,9410,131,B
2016-03-25 13:45:45.5,9410,4,454424,0,9405,331,9410,127,B
2016-03-25 13:45:46,9410,4,454428,0,9405,331,9410,126,B
2016-03-25 13:45:46.5,9410,252,454680,-104,9410,13,9415,312,B
2016-03-25 13:45:47,9410,26,454706,-6,9410,30,9415,297,B
2016-03-25 13:45:47.5,9410,6,454712,-2,9410,43,9415,297,B
2016-03-25 13:45:48,9410,22,454734,-2,9410,50,9415,298,B
2016-03-25 13:45:48.5,9410,10,454744,-6,9410,45,9415,299,B
2016-03-25 13:45:49,9415,26,454770,-26,9410,34,9415,296,B
2016-03-25 13:45:49.5,9410,4,454774,2,9410,32,9415,302,S
2016-03-25 13:45:50,9410,74,454848,16,9405,363,9410,16,S
2016-03-25 13:45:50.5,9410,44,454892,-4,9410,26,9415,304,S
2016-03-25 13:45:51,9410,6,454898,-4,9410,26,9415,303,S
2016-03-25 13:45:52,9410,14,454912,-6,9410,20,9415,306,S
2016-03-25 13:45:52.5,9415,16,454928,0,9410,48,9415,281,B
2016-03-25 13:45:53,9410,2,454930,-2,9410,57,9415,281,S
2016-03-25 13:45:53.5,9410,8,454938,2,9410,66,9415,280,S
2016-03-25 13:45:54,9415,6,454944,0,9410,68,9415,277,B
2016-03-25 13:45:55,9410,4,454948,-4,9410,102,9415,281,S
2016-03-25 13:45:55.5,9415,8,454956,8,9410,107,9415,284,B
2016-03-25 13:45:56,9415,100,455056,60,9410,123,9415,237,B
2016-03-25 13:45:57,9410,60,455116,-38,9410,126,9415,219,S
2016-03-25 13:45:57.5,9415,130,455246,-72,9410,174,9415,156,B
2016-03-25 13:45:58,9415,148,455394,44,9410,177,9415,82,B
2016-03-25 13:45:58.5,9415,186,455580,90,9415,55,9420,654,B
2016-03-25 13:45:59,9415,14,455594,10,9415,201,9420,656,B
2016-03-25 13:45:59.5,9415,40,455634,34,9415,154,9420,638,B
2016-03-25 13:46:00,9420,104,455738,42,9415,166,9420,587,B
2016-03-25 13:46:00.5,9420,392,456130,-188,9415,163,9420,395,B
2016-03-25 13:46:01,9415,284,456414,114,9415,163,9420,266,S
2016-03-25 13:46:01.5,9420,548,456962,-358,9420,65,9425,1031,B
2016-03-25 13:46:02,9420,26,456988,-22,9420,140,9425,1008,B
2016-03-25 13:46:02.5,9420,280,457268,-94,9415,175,9420,241,B
2016-03-25 13:46:03,9420,14,457282,0,9415,175,9420,242,B
2016-03-25 13:46:03.5,9415,10,457292,0,9415,171,9420,370,S
2016-03-25 13:46:04,9420,100,457392,0,9415,171,9420,328,B
2016-03-25 13:46:04.5,9415,28,457420,-20,9415,167,9420,328,S
2016-03-25 13:46:05,9420,298,457718,-52,9415,118,9420,203,B
2016-03-25 13:46:05.5,9420,56,457774,-48,9415,143,9420,175,B
2016-03-25 13:46:07,9420,2,457776,0,9415,195,9420,290,B
2016-03-25 13:46:07.5,9415,12,457788,4,9415,193,9420,356,S
2016-03-25 13:46:08,9420,4,457792,-4,9415,186,9420,304,B
2016-03-25 13:46:08.5,9420,10,457802,2,9415,185,9420,299,B
2016-03-25 13:46:09,9420,34,457836,-34,9415,185,9420,288,B
2016-03-25 13:46:09.5,9420,40,457876,32,9415,186,9420,271,B
2016-03-25 13:46:10,9420,104,457980,100,9415,186,9420,221,B
2016-03-25 13:46:11,9420,124,458104,2,9415,126,9420,254,B
2016-03-25 13:46:11.3333,9420,4,458108,2,9415,135,9420,264,B
2016-03-25 13:46:11.6667,9420,100,458208,98,9415,135,9420,245,B
2016-03-25 13:46:12,9415,32,458240,8,9415,96,9420,244,S
2016-03-25 13:46:12.5,9420,2,458242,0,9415,86,9420,259,B
2016-03-25 13:46:13,9415,4,458246,2,9415,85,9420,292,S
2016-03-25 13:46:14,9415,6,458252,-2,9415,91,9420,314,S
2016-03-25 13:46:14.3333,9415,52,458304,-28,9415,71,9420,301,S
2016-03-25 13:46:14.6667,9415,198,458502,-42,9415,1,9420,329,S
2016-03-25 13:46:15,9420,204,458706,108,9415,2,9420,266,B
2016-03-25 13:46:16,9415,12,458718,6,9410,361,9420,203,S
2016-03-25 13:46:16.5,9420,24,458742,16,9415,166,9420,222,B
2016-03-25 13:46:17,9415,62,458804,8,9415,156,9420,224,S
2016-03-25 13:46:17.5,9415,40,458844,-34,9415,137,9420,274,S
2016-03-25 13:46:18,9415,2,458846,2,9415,111,9420,277,S
2016-03-25 13:46:19,9415,6,458852,2,9415,123,9420,290,S
2016-03-25 13:46:19.5,9420,64,458916,64,9415,107,9420,295,B
2016-03-25 13:46:20,9420,26,458942,20,9415,125,9420,328,B
2016-03-25 13:46:20.5,9415,8,458950,6,9415,126,9420,328,S
2016-03-25 13:46:21,9420,46,458996,44,9415,106,9420,269,B
2016-03-25 13:46:22,9415,8,459004,2,9415,103,9420,275,S
2016-03-25 13:46:23,9415,100,459104,84,9415,103,9420,244,S
2016-03-25 13:46:23.5,9420,2,459106,0,9415,103,9420,286,B
2016-03-25 13:46:24,9415,20,459126,0,9415,94,9420,301,S
2016-03-25 13:46:24.5,9420,6,459132,6,9415,97,9420,299,B
2016-03-25 13:46:25,9415,8,459140,0,9415,95,9420,299,S
2016-03-25 13:46:25.5,9415,8,459148,6,9415,92,9420,311,S
2016-03-25 13:46:26,9415,12,459160,12,9415,86,9420,313,S
2016-03-25 13:46:26.5,9415,6,459166,0,9415,83,9420,313,S
2016-03-25 13:46:27,9415,12,459178,10,9415,76,9420,314,S
2016-03-25 13:46:27.5,9420,14,459192,14,9415,70,9420,310,B
2016-03-25 13:46:28,9415,96,459288,-20,9415,23,9420,312,S
2016-03-25 13:46:28.5,9415,16,459304,8,9415,20,9420,314,S
2016-03-25 13:46:29,9415,6,459310,2,9415,17,9420,319,S
2016-03-25 13:46:29.5,9415,4,459314,2,9415,15,9420,320,S
2016-03-25 13:46:30,9415,82,459396,52,9410,392,9415,16,S
2016-03-25 13:46:30.5,9415,8,459404,8,9410,392,9415,22,S
2016-03-25 13:46:31,9415,60,459464,-12,9415,75,9420,332,S
2016-03-25 13:46:31.5,9415,4,459468,0,9415,73,9420,337,S
2016-03-25 13:46:32,9415,6,459474,0,9415,160,9420,338,S
2016-03-25 13:46:32.5,9420,2,459476,-2,9415,172,9420,338,B
2016-03-25 13:46:33,9415,8,459484,-4,9415,208,9420,339,S
2016-03-25 13:46:33.5,9415,8,459492,-8,9415,204,9420,342,S
2016-03-25 13:46:34,9415,34,459526,-32,9415,192,9420,342,S
2016-03-25 13:46:34.5,9420,2,459528,0,9415,205,9420,345,B
2016-03-25 13:46:35,9420,100,459628,26,9415,199,9420,311,B
2016-03-25 13:46:35.5,9415,50,459678,0,9415,175,9420,311,S
2016-03-25 13:46:36,9420,72,459750,42,9415,133,9420,277,B
2016-03-25 13:46:36.5,9415,48,459798,22,9415,131,9420,255,S
2016-03-25 13:46:37,9420,10,459808,8,9415,162,9420,261,B
2016-03-25 13:46:37.5,9420,6,459814,6,9415,162,9420,259,B
2016-03-25 13:46:38,9415,4,459818,-2,9415,176,9420,261,S
2016-03-25 13:46:38.5,9420,142,459960,140,9415,177,9420,191,B
2016-03-25 13:46:39,9420,14,459974,-6,9415,172,9420,189,B
2016-03-25 13:46:40,9415,16,459990,16,9415,165,9420,321,S
2016-03-25 13:46:40.5,9420,18,460008,-6,9415,165,9420,315,B
2016-03-25 13:46:41,9420,6,460014,4,9415,201,9420,320,B
2016-03-25 13:46:42,9415,2,460016,2,9415,220,9420,321,S
2016-03-25 13:46:43,9415,30,460046,0,9415,175,9420,322,S
2016-03-25 13:46:43.5,9415,362,460408,306,9410,363,9415,323,S
2016-03-25 13:46:44,9415,2,460410,2,9410,363,9415,346,S
2016-03-25 13:46:44.5,9410,10,460420,10,9410,358,9415,347,S
2016-03-25 13:46:45,9415,2,460422,2,9410,339,9415,346,B
2016-03-25 13:46:46,9415,8,460430,8,9410,339,9415,353,B
2016-03-25 13:46:46.3333,9415,16,460446,16,9410,331,9415,345,B
2016-03-25 13:46:46.6667,9415,8,460454,8,9410,323,9415,353,B
2016-03-25 13:46:47,9410,62,460516,62,9410,329,9415,333,S
2016-03-25 13:46:48,9415,14,460530,12,9410,352,9415,328,B
2016-03-25 13:46:49,9415,940,461470,584,9415,145,9420,427,B
2016-03-25 13:46:49.5,9415,2,461472,2,9415,164,9420,340,B
2016-03-25 13:46:50,9415,10,461482,10,9415,184,9420,340,B
2016-03-25 13:46:50.5,9415,2,461484,2,9415,183,9420,340,B
2016-03-25 13:46:51,9415,10,461494,2,9415,178,9420,340,B
2016-03-25 13:46:51.5,9415,10,461504,8,9415,230,9420,340,B
2016-03-25 13:46:52,9415,22,461526,6,9415,219,9420,344,B
2016-03-25 13:46:52.5,9415,446,461972,176,9415,216,9420,123,B
2016-03-25 13:46:53,9420,266,462238,132,9420,115,9425,1151,B
2016-03-25 13:46:53.5,9420,6,462244,2,9420,124,9425,1152,B
2016-03-25 13:46:54,9425,12,462256,0,9420,124,9425,1146,B
2016-03-25 13:46:54.5,9420,64,462320,10,9420,122,9425,1118,S
2016-03-25 13:46:55,9420,24,462344,24,9420,114,9425,1117,S
2016-03-25 13:46:55.5,9420,2,462346,2,9420,71,9425,1117,S
2016-03-25 13:46:56,9420,18,462364,18,9420,70,9425,1109,S
2016-03-25 13:46:56.3333,9420,38,462402,2,9420,52,9425,1109,S
2016-03-25 13:46:56.6667,9420,6,462408,0,9420,48,9425,1109,S
2016-03-25 13:46:57,9420,20,462428,20,9420,39,9425,1109,S
2016-03-25 13:46:58,9420,8,462436,8,9420,55,9425,1109,S
2016-03-25 13:46:58.5,9420,70,462506,8,9420,37,9425,1094,S
2016-03-25 13:46:59,9420,126,462632,-14,9415,235,9420,4,S
2016-03-25 13:46:59.5,9420,20,462652,16,9415,233,9420,8,S
2016-03-25 13:47:00,9415,4,462656,2,9415,244,9420,7,S
2016-03-25 13:47:00.5,9420,28,462684,24,9420,42,9425,1087,B
2016-03-25 13:47:01,9420,100,462784,30,9415,312,9420,18,B
2016-03-25 13:47:01.5,9420,30,462814,4,9415,307,9420,10,B
2016-03-25 13:47:02,9420,96,462910,64,9420,8,9425,1060,B
2016-03-25 13:47:03,9420,30,462940,0,9415,310,9420,21,B
2016-03-25 13:47:03.5,9420,6,462946,4,9415,312,9420,30,B
2016-03-25 13:47:04,9420,4,462950,4,9415,322,9420,36,B
2016-03-25 13:47:04.5,9420,46,462996,22,9415,289,9420,27,B
2016-03-25 13:47:05,9420,4,463000,0,9415,288,9420,114,B
2016-03-25 13:47:05.5,9415,4,463004,-4,9415,289,9420,144,S
2016-03-25 13:47:06,9420,8,463012,-2,9415,298,9420,170,B
2016-03-25 13:47:08,9420,104,463116,76,9415,173,9420,243,B
2016-03-25 13:47:09,9415,2,463118,2,9415,172,9420,233,S
2016-03-25 13:47:10,9415,344,463462,292,9410,350,9415,81,S
2016-03-25 13:47:11,9415,202,463664,-72,9410,250,9415,85,S
2016-03-25 13:47:11.5,9410,6,463670,-6,9410,246,9415,98,S
2016-03-25 13:47:13,9415,4,463674,0,9410,247,9415,119,B
2016-03-25 13:47:13.5,9410,2,463676,0,9410,247,9415,121,S
2016-03-25 13:47:14,9410,8,463684,4,9410,243,9415,125,S
2016-03-25 13:47:14.5,9415,4,463688,4,9410,242,9415,123,B
2016-03-25 13:47:15,9410,2,463690,0,9410,241,9415,107,S
2016-03-25 13:47:16,9410,2,463692,0,9410,240,9415,108,S
2016-03-25 13:47:16.5,9410,8,463700,0,9410,238,9415,76,S
2016-03-25 13:47:17,9410,100,463800,100,9410,187,9415,76,S
2016-03-25 13:47:17.5,9410,104,463904,24,9410,197,9415,28,S
2016-03-25 13:47:18,9410,4,463908,0,9410,221,9415,54,S
2016-03-25 13:47:19,9415,2,463910,2,9410,221,9415,165,B
2016-03-25 13:47:19.5,9410,6,463916,6,9410,245,9415,173,S
2016-03-25 13:47:20,9415,60,463976,8,9410,244,9415,147,B
2016-03-25 13:47:20.5,9410,6,463982,4,9410,237,9415,146,S
2016-03-25 13:47:21,9410,10,463992,10,9410,232,9415,147,S
2016-03-25 13:47:22,9410,448,464440,148,9410,44,9415,199,S
2016-03-25 13:47:22.5,9410,2,464442,0,9410,50,9415,203,S
2016-03-25 13:47:23,9415,14,464456,-12,9410,49,9415,234,B
2016-03-25 13:47:23.5,9410,12,464468,-8,9410,56,9415,245,S
2016-03-25 13:47:24,9410,10,464478,10,9410,77,9415,245,S
2016-03-25 13:47:24.5,9410,12,464490,4,9410,76,9415,241,S
2016-03-25 13:47:25,9410,4,464494,4,9410,91,9415,242,S
2016-03-25 13:47:25.5,9410,16,464510,16,9410,83,9415,242,S
2016-03-25 13:47:26,9410,4,464514,0,9410,83,9415,284,S
2016-03-25 13:47:26.5,9410,92,464606,40,9410,40,9415,305,S
2016-03-25 13:47:27,9410,2,464608,0,9410,39,9415,307,S
2016-03-25 13:47:27.5,9410,2,464610,0,9410,38,9415,310,S
2016-03-25 13:47:28,9410,2,464612,2,9410,37,9415,310,S
2016-03-25 13:47:28.5,9410,104,464716,30,9410,14,9415,290,S
2016-03-25 13:47:29,9410,6,464722,0,9410,38,9415,295,S
2016-03-25 13:47:30,9410,12,464734,-4,9410,33,9415,296,S
2016-03-25 13:47:30.5,9410,20,464754,20,9410,53,9415,298,S
2016-03-25 13:47:32,9410,2,464756,0,9410,55,9415,301,S
2016-03-25 13:47:32.5,9410,24,464780,24,9410,43,9415,301,S
2016-03-25 13:47:34,9410,12,464792,-4,9410,63,9415,306,S
2016-03-25 13:47:35,9410,4,464796,4,9410,61,9415,324,S
2016-03-25 13:47:36,9410,2,464798,2,9410,60,9415,378,S
2016-03-25 13:47:36.5,9410,6,464804,6,9410,57,9415,378,S
2016-03-25 13:47:37,9410,2,464806,2,9410,56,9415,378,S
2016-03-25 13:47:37.5,9410,22,464828,2,9410,45,9415,378,S
2016-03-25 13:47:38,9410,90,464918,68,9405,509,9410,4,S
2016-03-25 13:47:39,9405,36,464954,-20,9405,497,9410,1,S
2016-03-25 13:47:39.5,9410,118,465072,-46,9410,197,9415,370,B
2016-03-25 13:47:40,9410,42,465114,42,9410,633,9415,345,B
2016-03-25 13:47:40.5,9410,10,465124,10,9410,870,9415,345,B
2016-03-25 13:47:41,9410,24,465148,22,9410,880,9415,345,B
2016-03-25 13:47:41.5,9410,2,465150,2,9410,884,9415,345,B
2016-03-25 13:47:42,9410,2,465152,0,9410,883,9415,345,B
2016-03-25 13:47:43,9410,2,465154,0,9410,757,9415,344,B
2016-03-25 13:47:44,9410,6,465160,4,9410,754,9415,345,B
2016-03-25 13:47:45,9410,10,465170,0,9410,753,9415,315,B
2016-03-25 13:47:46,9415,300,465470,-212,9410,554,9415,166,B
2016-03-25 13:47:47,9415,2,465472,2,9410,555,9415,164,B
2016-03-25 13:47:48,9415,60,465532,-24,9410,555,9415,136,B
2016-03-25 13:47:48.5,9410,2,465534,0,9410,554,9415,136,S
2016-03-25 13:47:49,9415,28,465562,0,9410,559,9415,121,B
2016-03-25 13:47:49.5,9415,12,465574,-12,9410,559,9415,115,B
2016-03-25 13:47:50,9415,244,465818,120,9415,85,9420,645,B
2016-03-25 13:47:50.5,9415,170,465988,-4,9410,587,9415,29,B
2016-03-25 13:47:51,9410,12,466000,-4,9410,610,9415,58,S
2016-03-25 13:47:51.5,9415,60,466060,0,9410,601,9415,39,B
2016-03-25 13:47:52,9415,4,466064,0,9410,600,9415,39,B
2016-03-25 13:47:52.5,9415,86,466150,82,9415,17,9420,703,B
2016-03-25 13:47:53,9410,38,466188,-4,9410,557,9415,5,S
2016-03-25 13:47:54,9410,20,466208,0,9410,553,9415,107,S
2016-03-25 13:47:57,9415,6,466214,2,9410,553,9415,112,B
2016-03-25 13:47:57.5,9415,42,466256,4,9410,558,9415,92,B
2016-03-25 13:47:58,9415,6,466262,0,9410,564,9415,91,B
2016-03-25 13:47:59,9415,10,466272,-10,9410,574,9415,102,B
2016-03-25 13:48:00,9410,2,466274,0,9410,568,9415,103,S
2016-03-25 13:48:02,9415,14,466288,0,9410,574,9415,101,B
2016-03-25 13:48:03,9410,14,466302,10,9410,571,9415,111,S
2016-03-25 13:48:04,9415,20,466322,0,9410,571,9415,105,B
2016-03-25 13:48:04.5,9410,18,466340,-14,9410,573,9415,97,S
2016-03-25 13:48:05,9415,196,466536,82,9415,137,9420,694,B
2016-03-25 13:48:05.5,9415,4,466540,4,9415,138,9420,688,B
2016-03-25 13:48:06,9415,2,466542,2,9415,137,9420,686,B
2016-03-25 13:48:06.5,9415,94,466636,52,9415,91,9420,686,B
2016-03-25 13:48:07,9415,2,466638,-2,9415,110,9420,684,B
2016-03-25 13:48:08,9415,2,466640,0,9415,109,9420,675,B
2016-03-25 13:48:08.5,9415,76,466716,0,9415,71,9420,676,B
2016-03-25 13:48:09,9415,60,466776,-60,9415,42,9420,586,B
2016-03-25 13:48:10,9415,2,466778,0,9415,93,9420,586,B
2016-03-25 13:48:10.5,9415,22,466800,-20,9415,91,9420,586,B
2016-03-25 13:48:11,9415,4,466804,0,9415,90,9420,707,B
2016-03-25 13:48:12,9415,2,466806,0,9415,99,9420,707,B
2016-03-25 13:48:13,9415,18,466824,-6,9415,90,9420,708,B
2016-03-25 13:48:13.3333,9415,2,466826,0,9415,90,9420,718,B
2016-03-25 13:48:13.6667,9420,22,466848,0,9415,85,9420,715,B
2016-03-25 13:48:14,9415,80,466928,-20,9415,50,9420,676,S
2016-03-25 13:48:15,9415,120,467048,-4,9410,595,9415,69,S
2016-03-25 13:48:15.5,9415,52,467100,-28,9410,570,9415,47,S
2016-03-25 13:48:16,9415,94,467194,12,9415,77,9420,670,S
2016-03-25 13:48:17,9415,12,467206,12,9415,81,9420,660,S
2016-03-25 13:48:17.5,9415,4,467210,0,9415,1281,9420,655,S
2016-03-25 13:48:18,9420,12,467222,6,9415,1326,9420,643,B
2016-03-25 13:48:18.5,9415,20,467242,0,9415,1316,9420,566,S
2016-03-25 13:48:19,9420,2,467244,0,9415,1275,9420,563,B
2016-03-25 13:48:19.5,9420,14,467258,2,9415,103,9420,556,B
2016-03-25 13:48:20,9420,10,467268,10,9415,103,9420,551,B
2016-03-25 13:48:20.5,9415,6,467274,6,9415,102,9420,551,S
2016-03-25 13:48:21,9415,20,467294,20,9415,97,9420,550,S
2016-03-25 13:48:21.5,9415,48,467342,44,9415,110,9420,547,S
2016-03-25 13:48:24,9415,2,467344,2,9415,113,9420,547,S
2016-03-25 13:48:26,9415,6,467350,-4,9415,116,9420,548,S
2016-03-25 13:48:26.5,9415,4,467354,0,9415,116,9420,549,S
2016-03-25 13:48:28,9420,2,467356,2,9415,119,9420,547,B
2016-03-25 13:48:29,9415,14,467370,2,9415,114,9420,545,S
2016-03-25 13:48:29.5,9415,2,467372,0,9415,118,9420,553,S
2016-03-25 13:48:31,9415,62,467434,-58,9415,92,9420,553,S
2016-03-25 13:48:31.5,9415,82,467516,22,9415,62,9420,544,S
2016-03-25 13:48:32,9415,138,467654,32,9410,619,9415,34,S
2016-03-25 13:48:33,9410,2,467656,2,9410,593,9415,37,S
2016-03-25 13:48:35,9410,6,467662,6,9410,588,9415,48,S
2016-03-25 13:48:35.5,9415,2,467664,2,9410,588,9415,89,B
2016-03-25 13:48:36,9415,6,467670,2,9410,586,9415,88,B
2016-03-25 13:48:37,9415,8,467678,4,9410,586,9415,84,B
2016-03-25 13:48:37.5,9415,38,467716,38,9410,586,9415,70,B
2016-03-25 13:48:40,9415,10,467726,0,9410,587,9415,190,B
2016-03-25 13:48:41,9410,12,467738,12,9410,591,9415,205,S
2016-03-25 13:48:42,9410,2,467740,2,9410,591,9415,208,S
2016-03-25 13:48:43,9410,4,467744,0,9410,588,9415,211,S
2016-03-25 13:48:45,9415,200,467944,46,9410,588,9415,113,B
2016-03-25 13:48:46,9415,4,467948,0,9410,580,9415,249,B
2016-03-25 13:48:47,9410,16,467964,0,9410,571,9415,241,S
2016-03-25 13:48:50,9410,12,467976,12,9410,565,9415,234,S
2016-03-25 13:48:52,9410,186,468162,158,9410,471,9415,238,S
2016-03-25 13:48:53,9410,2,468164,0,9410,473,9415,264,S
2016-03-25 13:48:53.5,9410,4,468168,4,9410,474,9415,264,S
2016-03-25 13:48:54,9410,6,468174,-2,9410,472,9415,275,S
2016-03-25 13:48:55,9415,12,468186,0,9410,482,9415,271,B
2016-03-25 13:48:55.5,9410,14,468200,2,9410,481,9415,278,S
2016-03-25 13:48:56,9415,12,468212,0,9410,481,9415,272,B
2016-03-25 13:48:57,9415,10,468222,0,9410,481,9415,267,B
2016-03-25 13:48:59,9415,2,468224,0,9410,486,9415,268,B
2016-03-25 13:49:00,9415,202,468426,72,9410,486,9415,172,B
2016-03-25 13:49:00.5,9415,2,468428,-2,9410,582,9415,174,B
2016-03-25 13:49:01,9415,266,468694,-152,9410,583,9420,473,B
2016-03-25 13:49:01.5,9415,10,468704,-10,9410,583,9415,52,B
2016-03-25 13:49:02,9415,22,468726,-12,9410,583,9415,12,B
2016-03-25 13:49:02.5,9415,82,468808,0,9410,583,9415,106,B
2016-03-25 13:49:04,9415,2,468810,0,9410,582,9415,130,B
2016-03-25 13:49:04.5,9415,22,468832,-10,9410,580,9415,122,B
2016-03-25 13:49:06,9415,6,468838,-6,9410,587,9415,167,B
2016-03-25 13:49:07,9415,2,468840,0,9410,588,9415,182,B
2016-03-25 13:49:09,9410,8,468848,8,9410,588,9415,194,S
2016-03-25 13:49:10,9410,4,468852,4,9410,586,9415,197,S
2016-03-25 13:49:12,9410,12,468864,4,9410,584,9415,194,S
2016-03-25 13:49:15,9410,10,468874,10,9410,580,9415,207,S
2016-03-25 13:49:16,9410,124,468998,4,9410,578,9415,149,S
2016-03-25 13:49:17,9410,2,469000,2,9410,577,9415,153,S
2016-03-25 13:49:18,9410,4,469004,2,9410,577,9415,159,S
2016-03-25 13:49:20,9415,12,469016,0,9410,573,9415,157,B
2016-03-25 13:49:20.5,9410,2,469018,2,9410,572,9415,167,S
2016-03-25 13:49:21,9415,194,469212,60,9410,476,9420,475,B
2016-03-25 13:49:21.5,9415,4,469216,4,9410,1176,9415,94,B
2016-03-25 13:49:23,9410,48,469264,44,9410,1175,9415,81,S
2016-03-25 13:49:25,9410,6,469270,6,9410,1679,9415,93,S
2016-03-25 13:49:25.5,9415,62,469332,-38,9410,1687,9415,85,B
2016-03-25 13:49:26,9410,126,469458,0,9410,1671,9415,128,S
2016-03-25 13:49:26.5,9410,4,469462,4,9410,1671,9415,128,S
2016-03-25 13:49:27,9415,14,469476,0,9410,461,9415,128,B
2016-03-25 13:49:28,9410,2,469478,2,9410,460,9415,148,S
2016-03-25 13:49:29,9410,180,469658,0,9410,367,9415,152,S
2016-03-25 13:49:29.5,9410,2,469660,0,9410,366,9415,156,S
2016-03-25 13:49:30,9410,2,469662,2,9410,366,9415,159,S
2016-03-25 13:49:30.5,9410,14,469676,14,9410,359,9415,160,S
2016-03-25 13:49:34,9410,2,469678,2,9410,353,9415,227,S
2016-03-25 13:49:35,9410,2,469680,2,9410,353,9415,232,S
2016-03-25 13:49:35.5,9415,4,469684,0,9410,353,9415,231,B
2016-03-25 13:49:37,9410,2,469686,0,9410,352,9415,236,S
2016-03-25 13:49:39,9410,4,469690,4,9410,351,9415,257,S
2016-03-25 13:49:39.5,9410,42,469732,42,9410,330,9415,380,S
2016-03-25 13:49:40,9410,8,469740,8,9410,326,9415,379,S
2016-03-25 13:49:41,9410,2,469742,0,9410,325,9415,382,S
2016-03-25 13:49:41.5,9410,4,469746,4,9410,323,9415,382,S
2016-03-25 13:49:42,9410,2,469748,0,9410,322,9415,1182,S
2016-03-25 13:49:42.5,9410,20,469768,20,9410,312,9415,1586,S
2016-03-25 13:49:43,9410,2,469770,0,9410,311,9415,1591,S
2016-03-25 13:49:43.5,9410,490,470260,-26,9410,101,9415,1591,S
2016-03-25 13:49:44,9410,198,470458,96,9405,535,9410,180,S
2016-03-25 13:49:45,9410,4,470462,0,9405,535,9410,186,S
2016-03-25 13:49:45.5,9405,8,470470,-8,9405,536,9410,187,S
2016-03-25 13:49:47,9410,6,470476,-2,9405,465,9410,186,B
2016-03-25 13:49:47.5,9405,34,470510,2,9405,437,9410,187,S
2016-03-25 13:49:48,9405,2,470512,0,9405,437,9410,188,S
2016-03-25 13:49:49,9410,4,470516,0,9405,437,9410,190,B
2016-03-25 13:49:49.5,9405,2,470518,-2,9405,436,9410,191,S
2016-03-25 13:49:50,9410,74,470592,-40,9405,395,9410,236,B
2016-03-25 13:49:51,9405,210,470802,196,9405,289,9410,249,S
2016-03-25 13:49:51.5,9400,642,471444,-168,9400,241,9405,595,S
2016-03-25 13:49:52,9400,146,471590,-34,9400,83,9405,597,S
2016-03-25 13:49:52.5,9400,178,471768,-38,9395,187,9400,164,S
2016-03-25 13:49:53,9400,4,471772,-4,9395,157,9400,163,S
2016-03-25 13:49:54,9395,30,471802,-18,9395,150,9400,158,S
2016-03-25 13:49:55,9400,34,471836,-32,9395,142,9400,152,B
2016-03-25 13:49:55.5,9395,4,471840,-2,9395,143,9400,151,S
2016-03-25 13:49:56,9395,12,471852,-10,9395,137,9400,151,S
2016-03-25 13:49:56.5,9400,10,471862,0,9395,147,9400,146,B
2016-03-25 13:49:57,9400,292,472154,200,9400,4,9405,628,B
2016-03-25 13:49:58,9400,92,472246,54,9395,182,9400,1,B
2016-03-25 13:49:58.5,9400,18,472264,16,9400,24,9405,44,B
2016-03-25 13:49:59,9400,20,472284,0,9400,80,9405,53,B
2016-03-25 13:49:59.5,9405,194,472478,-54,9400,173,9410,192,B
2016-03-25 13:50:00,9405,28,472506,-16,9405,21,9410,182,B
2016-03-25 13:50:00.3333,9410,100,472606,34,9405,7,9410,87,B
2016-03-25 13:50:00.6667,9405,150,472756,10,9405,49,9410,92,S
2016-03-25 13:50:01,9410,28,472784,-28,9405,36,9410,113,B
2016-03-25 13:50:01.5,9410,4,472788,0,9405,11,9410,113,B
2016-03-25 13:50:02,9405,2,472790,2,9405,13,9410,113,S
2016-03-25 13:50:02.5,9410,10,472800,0,9405,13,9410,108,B
2016-03-25 13:50:03,9405,2,472802,2,9405,23,9410,111,S
2016-03-25 13:50:04,9405,6,472808,2,9405,20,9410,111,S
2016-03-25 13:50:04.5,9405,4,472812,2,9405,105,9410,111,S
2016-03-25 13:50:05,9405,232,473044,142,9405,1,9410,111,S
2016-03-25 13:50:06,9405,16,473060,2,9405,14,9410,128,S
2016-03-25 13:50:06.5,9405,38,473098,-10,9405,3,9410,139,S
2016-03-25 13:50:07,9405,6,473104,6,9400,242,9405,1,S
2016-03-25 13:50:07.5,9405,14,473118,-4,9405,3,9410,276,S
2016-03-25 13:50:08,9405,2,473120,0,9405,92,9410,276,S
2016-03-25 13:50:08.5,9405,24,473144,2,9405,125,9410,272,S
2016-03-25 13:50:09,9405,2,473146,2,9405,124,9410,272,S
2016-03-25 13:50:09.5,9405,20,473166,0,9405,114,9410,320,S
2016-03-25 13:50:10,9410,6,473172,2,9405,156,9410,318,B
2016-03-25 13:50:11,9405,4,473176,4,9405,154,9410,321,S
2016-03-25 13:50:12,9410,10,473186,4,9405,153,9410,321,B
2016-03-25 13:50:13,9405,2,473188,2,9405,152,9410,322,S
2016-03-25 13:50:13.5,9405,220,473408,20,9405,41,9410,322,S
2016-03-25 13:50:14,9405,80,473488,48,9400,245,9405,19,S
2016-03-25 13:50:15,9405,48,473536,22,9400,247,9405,7,S
2016-03-25 13:50:16,9405,36,473572,-36,9405,154,9410,327,S
2016-03-25 13:50:16.5,9405,100,473672,-100,9405,106,9410,327,S
2016-03-25 13:50:18,9405,100,473772,-24,9405,90,9410,367,S
2016-03-25 13:50:19,9405,378,474150,-66,9400,245,9405,153,S
2016-03-25 13:50:19.5,9400,2,474152,-2,9400,236,9405,157,S
2016-03-25 13:50:20,9400,50,474202,-12,9400,210,9405,157,S
2016-03-25 13:50:21,9400,60,474262,-6,9400,73,9405,167,S
2016-03-25 13:50:21.5,9405,24,474286,0,9400,81,9405,57,B
2016-03-25 13:50:22,9405,2,474288,-2,9400,109,9405,77,B
2016-03-25 13:50:23,9405,210,474498,80,9405,60,9410,370,B
2016-03-25 13:50:23.5,9405,96,474594,0,9405,15,9410,370,B
2016-03-25 13:50:24,9405,30,474624,0,9400,114,9405,392,B
2016-03-25 13:50:24.5,9405,2,474626,-2,9400,78,9405,392,B
2016-03-25 13:50:25,9405,2,474628,-2,9400,79,9405,163,B
2016-03-25 13:50:25.5,9405,4,474632,-2,9400,81,9405,168,B
2016-03-25 13:50:26,9400,14,474646,-4,9400,75,9405,168,S
2016-03-25 13:50:26.5,9400,150,474796,-94,9395,130,9400,169,S
2016-03-25 13:50:27,9395,14,474810,-2,9395,107,9400,206,S
2016-03-25 13:50:28,9400,4,474814,-2,9395,107,9400,204,B
2016-03-25 13:50:28.5,9395,2,474816,0,9395,106,9400,204,S
2016-03-25 13:50:29,9395,6,474822,-4,9395,106,9400,203,S
2016-03-25 13:50:30,9395,2,474824,0,9395,112,9400,203,S
2016-03-25 13:50:31,9395,12,474836,-10,9395,110,9400,198,S
2016-03-25 13:50:31.5,9395,14,474850,-8,9395,104,9400,199,S
2016-03-25 13:50:32,9395,18,474868,-8,9395,107,9400,201,S
2016-03-25 13:50:33,9395,4,474872,-4,9395,104,9400,201,S
2016-03-25 13:50:34,9395,4,474876,0,9395,83,9400,178,S
2016-03-25 13:50:35,9395,88,474964,14,9395,79,9400,153,S
2016-03-25 13:50:36,9395,22,474986,-8,9395,75,9400,166,S
2016-03-25 13:50:36.5,9395,16,475002,-4,9395,68,9400,165,S
2016-03-25 13:50:37,9395,48,475050,18,9395,55,9400,158,S
2016-03-25 13:50:38,9395,2,475052,0,9395,54,9400,160,S
2016-03-25 13:50:38.5,9400,8,475060,0,9395,89,9400,213,B
2016-03-25 13:50:39,9395,2,475062,2,9395,93,9400,215,S
2016-03-25 13:50:40,9395,2,475064,2,9395,94,9400,217,S
2016-03-25 13:50:40.3333,9400,30,475094,0,9395,94,9400,203,B
2016-03-25 13:50:40.6667,9395,16,475110,8,9395,87,9400,193,S
2016-03-25 13:50:41,9400,10,475120,-2,9395,84,9400,228,B
2016-03-25 13:50:41.5,9395,4,475124,0,9395,83,9400,236,S
2016-03-25 13:50:42,9395,4,475128,4,9395,84,9400,240,S
2016-03-25 13:50:43,9395,172,475300,-30,9390,160,9395,57,S
2016-03-25 13:50:43.5,9395,2,475302,0,9390,163,9395,63,S
2016-03-25 13:50:44,9395,20,475322,20,9390,161,9395,63,S
2016-03-25 13:50:45,9395,20,475342,0,9390,159,9395,55,S
2016-03-25 13:50:46,9390,14,475356,-14,9390,179,9395,55,S
2016-03-25 13:50:46.5,9390,6,475362,-6,9390,181,9395,55,S
2016-03-25 13:50:47,9390,14,475376,-14,9390,174,9395,65,S
2016-03-25 13:50:47.5,9395,8,475384,0,9390,177,9395,62,B
2016-03-25 13:50:48,9390,2,475386,-2,9390,178,9395,63,S
2016-03-25 13:50:48.5,9390,2,475388,-2,9390,177,9395,63,S
2016-03-25 13:50:49,9390,482,475870,-270,9385,287,9390,73,S
2016-03-25 13:50:50,9390,4,475874,-4,9385,250,9390,71,S
2016-03-25 13:50:50.5,9385,30,475904,-20,9385,240,9390,66,S
2016-03-25 13:50:51,9390,52,475956,-36,9385,243,9390,42,B
2016-03-25 13:50:52,9385,8,475964,-4,9385,243,9390,44,S
2016-03-25 13:50:53,9390,6,475970,-2,9385,246,9390,41,B
2016-03-25 13:50:53.5,9390,10,475980,-8,9385,263,9390,39,B
2016-03-25 13:50:54,9385,16,475996,-16,9385,260,9390,34,S
2016-03-25 13:50:54.5,9390,18,476014,-18,9385,261,9390,30,B
2016-03-25 13:50:55,9390,2,476016,0,9385,261,9390,30,B
2016-03-25 13:50:56,9390,62,476078,-50,9390,175,9395,135,B
2016-03-25 13:50:57,9395,12,476090,8,9390,175,9395,110,B
2016-03-25 13:50:57.5,9390,2,476092,0,9390,174,9395,110,S
2016-03-25 13:50:58,9390,110,476202,-88,9390,121,9395,110,S
2016-03-25 13:50:59,9390,6,476208,-2,9390,124,9395,150,S
2016-03-25 13:50:59.5,9395,16,476224,-2,9390,117,9395,149,B
2016-03-25 13:51:00,9390,244,476468,-234,9385,376,9390,7,S
2016-03-25 13:51:00.5,9390,16,476484,-8,9390,7,9395,184,S
2016-03-25 13:51:01,9390,14,476498,-14,9385,377,9390,16,S
2016-03-25 13:51:01.5,9390,2,476500,0,9385,377,9390,21,S
2016-03-25 13:51:02,9390,14,476514,12,9385,377,9390,14,S
2016-03-25 13:51:02.5,9385,2,476516,0,9385,376,9390,19,S
2016-03-25 13:51:03,9390,32,476548,22,9385,384,9390,63,B
2016-03-25 13:51:04,9390,14,476562,6,9385,384,9390,61,B
2016-03-25 13:51:04.5,9390,16,476578,-2,9385,388,9390,74,B
2016-03-25 13:51:05,9390,4,476582,0,9385,388,9390,92,B
2016-03-25 13:51:07,9385,4,476586,4,9385,387,9390,95,S
2016-03-25 13:51:07.5,9390,4,476590,0,9385,388,9390,93,B
2016-03-25 13:51:08,9385,10,476600,0,9385,383,9390,93,S
2016-03-25 13:51:08.5,9390,2,476602,2,9385,386,9390,108,B
2016-03-25 13:51:09,9390,4,476606,0,9385,386,9390,109,B
2016-03-25 13:51:11,9385,10,476616,-8,9385,381,9390,110,S
2016-03-25 13:51:12,9385,8,476624,2,9385,368,9390,110,S
2016-03-25 13:51:12.5,9385,8,476632,-8,9385,213,9390,110,S
2016-03-25 13:51:13,9390,2,476634,0,9385,214,9390,141,B
2016-03-25 13:51:13.5,9385,182,476816,-82,9385,133,9390,148,S
2016-03-25 13:51:14,9385,10,476826,-2,9385,130,9390,161,S
2016-03-25 13:51:14.5,9380,280,477106,-224,9380,417,9385,47,S
2016-03-25 13:51:15,9380,94,477200,-30,9380,346,9385,44,S
2016-03-25 13:51:15.5,9380,16,477216,0,9380,336,9385,58,S
2016-03-25 13:51:16,9380,2,477218,2,9380,337,9385,61,S
2016-03-25 13:51:17,9385,26,477244,20,9380,324,9385,59,B
2016-03-25 13:51:18,9380,2,477246,2,9380,323,9385,60,S
2016-03-25 13:51:18.5,9385,6,477252,2,9380,321,9385,59,B
2016-03-25 13:51:19,9380,12,477264,0,9380,319,9385,96,S
2016-03-25 13:51:20,9385,4,477268,0,9380,320,9385,98,B
2016-03-25 13:51:21,9380,642,477910,-340,9375,571,9380,172,S
2016-03-25 13:51:21.5,9380,4,477914,-4,9375,509,9380,220,S
2016-03-25 13:51:22,9375,10,477924,-2,9375,387,9380,221,S
2016-03-25 13:51:23,9375,290,478214,-284,9375,161,9380,220,S
2016-03-25 13:51:23.5,9375,236,478450,-164,9375,107,9380,181,S
2016-03-25 13:51:24,9375,10,478460,-10,9375,101,9380,182,S
2016-03-25 13:51:24.5,9375,4,478464,0,9375,110,9380,182,S
2016-03-25 13:51:25,9380,6,478470,-2,9375,108,9380,181,B
2016-03-25 13:51:25.5,9375,16,478486,-4,9375,101,9380,171,S
2016-03-25 13:51:26,9375,14,478500,-14,9375,96,9380,171,S
2016-03-25 13:51:26.5,9375,8,478508,-8,9375,92,9380,210,S
2016-03-25 13:51:27,9375,200,478708,112,9370,314,9375,34,S
2016-03-25 13:51:27.5,9370,56,478764,-48,9370,350,9375,48,S
2016-03-25 13:51:28,9375,148,478912,-8,9370,312,9375,14,B
2016-03-25 13:51:28.5,9375,58,478970,-4,9375,2,9380,225,B
2016-03-25 13:51:29,9375,12,478982,-6,9375,170,9380,224,B
2016-03-25 13:51:29.5,9375,18,479000,-16,9375,174,9380,281,B
2016-03-25 13:51:30,9375,202,479202,-200,9375,206,9380,240,B
2016-03-25 13:51:30.5,9375,28,479230,-8,9375,202,9380,240,B
2016-03-25 13:51:31,9375,2,479232,0,9375,202,9380,267,B
2016-03-25 13:51:31.5,9375,16,479248,-4,9375,196,9380,287,B
2016-03-25 13:51:33,9380,42,479290,0,9375,149,9380,245,B
2016-03-25 13:51:33.5,9375,6,479296,-6,9375,154,9380,261,S
2016-03-25 13:51:34,9375,22,479318,-12,9375,145,9380,256,S
2016-03-25 13:51:35,9375,272,479590,-180,9375,20,9380,257,S
2016-03-25 13:51:35.5,9375,6,479596,-4,9375,23,9380,258,S
2016-03-25 13:51:36,9375,16,479612,-2,9375,26,9380,255,S
2016-03-25 13:51:36.5,9375,14,479626,-6,9375,42,9380,254,S
2016-03-25 13:51:37,9375,8,479634,0,9375,38,9380,254,S
2016-03-25 13:51:37.5,9375,2,479636,0,9375,41,9380,254,S
2016-03-25 13:51:38,9380,8,479644,0,9375,44,9380,253,B
2016-03-25 13:51:38.5,9375,164,479808,48,9370,292,9375,2,S
2016-03-25 13:51:39,9375,8,479816,-6,9370,298,9375,13,S
2016-03-25 13:51:39.5,9375,50,479866,36,9375,16,9380,256,S
2016-03-25 13:51:40,9375,6,479872,4,9375,16,9380,258,S
2016-03-25 13:51:40.5,9375,4,479876,0,9375,128,9380,267,S
2016-03-25 13:51:41,9375,10,479886,0,9375,128,9380,266,S
2016-03-25 13:51:41.5,9375,2,479888,-2,9375,132,9380,266,S
2016-03-25 13:51:42,9375,72,479960,0,9375,100,9380,266,S
2016-03-25 13:51:43,9375,4,479964,0,9375,108,9380,266,S
2016-03-25 13:51:44,9375,100,480064,0,9375,74,9380,268,S
2016-03-25 13:51:45,9375,6,480070,-2,9375,83,9380,268,S
2016-03-25 13:51:46,9380,32,480102,-32,9375,173,9380,254,B
2016-03-25 13:51:46.5,9375,8,480110,-8,9375,171,9380,254,S
2016-03-25 13:51:47,9375,14,480124,-12,9375,270,9380,256,S
2016-03-25 13:51:48,9375,102,480226,44,9375,234,9380,240,S
2016-03-25 13:51:48.5,9380,480,480706,-394,9380,147,9385,287,B
2016-03-25 13:51:49,9380,22,480728,4,9380,148,9385,288,B
2016-03-25 13:51:49.5,9380,2,480730,2,9380,156,9385,288,B
2016-03-25 13:51:50,9380,12,480742,0,9380,153,9385,288,B
2016-03-25 13:51:50.5,9380,4,480746,-2,9380,154,9385,288,B
2016-03-25 13:51:51,9385,4,480750,-2,9380,160,9385,307,B
2016-03-25 13:51:52,9380,124,480874,0,9380,128,9385,308,S
2016-03-25 13:51:52.5,9380,2,480876,0,9380,129,9385,308,S
2016-03-25 13:51:53,9380,22,480898,0,9380,118,9385,308,S
2016-03-25 13:51:54,9380,2,480900,0,9380,138,9385,310,S
2016-03-25 13:51:55,9380,100,481000,50,9380,109,9385,327,S
2016-03-25 13:51:56,9385,4,481004,-2,9380,109,9385,337,B
2016-03-25 13:51:58,9380,216,481220,-150,9375,277,9380,96,S
2016-03-25 13:51:58.5,9380,22,481242,-2,9375,279,9380,90,S
2016-03-25 13:51:59,9380,6,481248,-6,9375,280,9380,145,S
2016-03-25 13:52:01,9380,8,481256,-6,9375,281,9380,256,S
2016-03-25 13:52:01.5,9380,12,481268,-12,9375,304,9380,149,S
2016-03-25 13:52:02,9380,4,481272,-4,9375,325,9380,235,S
2016-03-25 13:52:02.5,9380,4,481276,-4,9375,325,9380,246,S
2016-03-25 13:52:03,9380,4,481280,-4,9375,326,9380,246,S
2016-03-25 13:52:04,9380,8,481288,-4,9375,326,9380,246,S
2016-03-25 13:52:04.5,9380,40,481328,0,9375,308,9380,268,S
2016-03-25 13:52:05,9375,22,481350,-18,9375,307,9380,181,S
2016-03-25 13:52:05.5,9380,2,481352,-2,9375,311,9380,180,B
2016-03-25 13:52:06,9380,4,481356,-2,9375,312,9380,179,B
2016-03-25 13:52:07,9375,4,481360,0,9375,313,9380,181,S
2016-03-25 13:52:08,9380,4,481364,-2,9375,313,9380,181,B
2016-03-25 13:52:09,9380,74,481438,-72,9375,318,9380,144,B
2016-03-25 13:52:10,9380,258,481696,-170,9375,318,9380,15,B
2016-03-25 13:52:10.5,9380,36,481732,-18,9380,98,9385,579,B
2016-03-25 13:52:11,9380,6,481738,-6,9380,100,9385,581,B
2016-03-25 13:52:12,9380,200,481938,-12,9375,344,9380,102,B
2016-03-25 13:52:12.5,9380,14,481952,-4,9375,344,9380,97,B
2016-03-25 13:52:13,9375,4,481956,0,9375,348,9380,97,S
2016-03-25 13:52:14,9380,6,481962,-6,9375,343,9380,104,B
2016-03-25 13:52:14.5,9380,2,481964,-2,9375,345,9380,103,B
2016-03-25 13:52:15,9380,60,482024,-60,9375,347,9380,73,B
2016-03-25 13:52:16,9380,244,482268,-12,9380,50,9385,579,B
2016-03-25 13:52:17,9380,140,482408,-44,9375,298,9380,264,B
2016-03-25 13:52:17.5,9375,2,482410,2,9375,297,9380,298,S
2016-03-25 13:52:18,9380,12,482422,-12,9375,319,9380,295,B
2016-03-25 13:52:19,9375,100,482522,-8,9375,275,9380,300,S
2016-03-25 13:52:20,9375,200,482722,-54,9375,166,9380,309,S
2016-03-25 13:52:20.5,9375,332,483054,64,9375,1,9380,309,S
2016-03-25 13:52:21,9375,8,483062,-4,9370,434,9375,14,S
2016-03-25 13:52:21.5,9375,84,483146,-72,9370,434,9375,17,S
2016-03-25 13:52:22,9370,302,483448,-202,9370,287,9375,39,S
2016-03-25 13:52:23,9370,100,483548,-96,9370,226,9375,98,S
2016-03-25 13:52:23.5,9370,8,483556,-2,9370,223,9375,97,S
2016-03-25 13:52:24,9375,350,483906,-226,9365,358,9375,72,B
2016-03-25 13:52:25,9370,2,483908,-2,9370,77,9375,95,S
2016-03-25 13:52:25.5,9370,274,484182,-74,9365,514,9370,13,S
2016-03-25 13:52:26,9370,44,484226,-34,9365,515,9370,5,S
2016-03-25 13:52:26.5,9370,26,484252,2,9370,88,9375,152,S
2016-03-25 13:52:27,9375,6,484258,0,9370,90,9375,133,B
2016-03-25 13:52:27.5,9370,182,484440,-4,9365,504,9370,12,S
2016-03-25 13:52:28,9370,40,484480,-24,9370,105,9375,164,S
2016-03-25 13:52:28.5,9375,6,484486,-2,9370,122,9375,164,B
2016-03-25 13:52:29,9370,210,484696,-164,9370,19,9375,147,S
2016-03-25 13:52:29.5,9370,2,484698,0,9370,18,9375,148,S
2016-03-25 13:52:30,9370,2,484700,0,9370,27,9375,148,S
2016-03-25 13:52:30.5,9370,66,484766,-14,9365,500,9370,1,S
2016-03-25 13:52:31,9370,206,484972,-88,9365,391,9370,37,S
2016-03-25 13:52:31.5,9365,18,484990,0,9365,388,9370,62,S
2016-03-25 13:52:32,9365,60,485050,-34,9365,347,9370,88,S
2016-03-25 13:52:32.5,9365,26,485076,4,9365,332,9370,110,S
2016-03-25 13:52:33,9365,50,485126,-44,9365,340,9370,97,S
2016-03-25 13:52:33.5,9370,28,485154,-2,9365,326,9370,98,B
2016-03-25 13:52:34,9370,10,485164,10,9365,330,9370,152,B
2016-03-25 13:52:34.5,9365,48,485212,2,9365,297,9370,151,S
2016-03-25 13:52:35,9365,22,485234,0,9365,268,9370,163,S
2016-03-25 13:52:35.5,9370,8,485242,0,9365,265,9370,164,B
2016-03-25 13:52:36,9370,2,485244,0,9365,267,9370,173,B
2016-03-25 13:52:37,9365,12,485256,10,9365,270,9370,173,S
2016-03-25 13:52:37.5,9365,2,485258,2,9365,269,9370,173,S
2016-03-25 13:52:38,9370,14,485272,0,9365,275,9370,170,B
2016-03-25 13:52:39,9365,4,485276,0,9365,273,9370,174,S
2016-03-25 13:52:40,9370,230,485506,130,9365,279,9370,1,B
2016-03-25 13:52:40.3333,9370,28,485534,8,9365,291,9370,10,B
2016-03-25 13:52:40.6667,9370,22,485556,-20,9370,18,9375,201,B
2016-03-25 13:52:42,9370,6,485562,-4,9370,18,9375,201,B
2016-03-25 13:52:42.3333,9370,6,485568,-4,9370,31,9375,201,B
2016-03-25 13:52:42.6667,9370,2,485570,0,9370,33,9375,201,B
2016-03-25 13:52:43,9370,122,485692,4,9365,145,9370,36,B
2016-03-25 13:52:44,9370,6,485698,-6,9365,163,9370,66,B
2016-03-25 13:52:44.5,9370,22,485720,-18,9365,152,9370,104,B
2016-03-25 13:52:45,9365,8,485728,-2,9365,146,9370,103,S
2016-03-25 13:52:45.5,9370,2,485730,-2,9365,156,9370,119,B
2016-03-25 13:52:46,9365,2,485732,0,9365,188,9370,121,S
2016-03-25 13:52:46.5,9370,6,485738,-2,9365,185,9370,123,B
2016-03-25 13:52:47,9370,24,485762,-16,9365,173,9370,113,B
2016-03-25 13:52:47.5,9370,14,485776,-2,9365,171,9370,107,B
2016-03-25 13:52:48,9370,4,485780,0,9365,172,9370,106,B
2016-03-25 13:52:48.5,9365,66,485846,-24,9365,151,9370,108,S
2016-03-25 13:52:49,9365,4,485850,0,9365,259,9370,108,S
2016-03-25 13:52:49.5,9365,62,485912,30,9365,229,9370,109,S
2016-03-25 13:52:50,9365,32,485944,22,9365,264,9370,49,S
2016-03-25 13:52:51,9370,2,485946,0,9365,285,9370,54,B
2016-03-25 13:52:51.5,9370,118,486064,-46,9365,510,9375,238,B
2016-03-25 13:52:52,9370,2,486066,0,9370,13,9375,192,B
2016-03-25 13:52:52.5,9370,2,486068,0,9370,6,9375,195,B
2016-03-25 13:52:53,9370,4,486072,-2,9370,8,9375,194,B
2016-03-25 13:52:54,9370,2,486074,-2,9370,7,9375,197,B
2016-03-25 13:52:55,9375,28,486102,26,9370,4,9375,198,B
2016-03-25 13:52:55.5,9370,2,486104,0,9370,3,9375,198,S
2016-03-25 13:52:56,9370,2,486106,2,9370,7,9375,198,S
2016-03-25 13:52:56.5,9370,14,486120,-12,9365,332,9375,415,S
2016-03-25 13:52:57,9370,10,486130,6,9365,345,9370,7,S
2016-03-25 13:52:57.5,9365,2,486132,0,9365,332,9370,24,S
2016-03-25 13:52:58,9365,4,486136,4,9365,328,9370,124,S
2016-03-25 13:52:58.5,9370,12,486148,-4,9365,317,9370,124,B
2016-03-25 13:52:59,9365,6,486154,-6,9365,315,9370,154,S
2016-03-25 13:52:59.5,9365,4,486158,-2,9365,324,9370,154,S
2016-03-25 13:53:00,9365,8,486166,-4,9365,314,9370,159,S
2016-03-25 13:53:01,9365,6,486172,0,9365,305,9370,58,S
2016-03-25 13:53:01.5,9365,4,486176,-4,9365,306,9370,89,S
2016-03-25 13:53:02,9370,6,486182,-4,9365,304,9370,88,B
2016-03-25 13:53:02.5,9365,2,486184,-2,9365,304,9370,88,S
2016-03-25 13:53:03,9365,2,486186,-2,9365,368,9370,105,S
2016-03-25 13:53:04,9370,12,486198,6,9365,370,9370,99,B
2016-03-25 13:53:04.5,9365,526,486724,80,9365,122,9370,109,S
2016-03-25 13:53:05,9365,188,486912,-2,9360,394,9370,111,S
2016-03-25 13:53:05.5,9360,152,487064,-2,9360,509,9365,70,S
2016-03-25 13:53:06,9365,110,487174,-62,9360,464,9365,91,B
2016-03-25 13:53:06.5,9365,32,487206,-6,9360,441,9365,78,B
2016-03-25 13:53:07,9360,22,487228,0,9360,429,9365,79,S
2016-03-25 13:53:07.5,9360,4,487232,-4,9360,419,9365,92,S
2016-03-25 13:53:08,9360,268,487500,40,9360,286,9365,134,S
2016-03-25 13:53:09,9360,2,487502,2,9360,269,9365,193,S
2016-03-25 13:53:09.5,9360,210,487712,182,9360,170,9365,203,S
2016-03-25 13:53:10,9360,180,487892,48,9355,160,9365,209,S
2016-03-25 13:53:10.5,9360,68,487960,28,9360,12,9365,259,S
2016-03-25 13:53:11,9360,116,488076,60,9355,288,9360,35,S
2016-03-25 13:53:11.5,9360,144,488220,-102,9360,4,9365,224,S
2016-03-25 13:53:12,9360,4,488224,-4,9360,3,9365,224,S
2016-03-25 13:53:12.5,9365,18,488242,-8,9360,10,9365,223,B
2016-03-25 13:53:13,9360,100,488342,-20,9360,28,9365,212,S
2016-03-25 13:53:13.5,9360,4,488346,-2,9360,36,9365,210,S
2016-03-25 13:53:14,9360,8,488354,-8,9360,37,9365,201,S
2016-03-25 13:53:14.5,9360,4,488358,-2,9360,37,9365,201,S
2016-03-25 13:53:15,9360,294,488652,22,9360,94,9365,75,S
2016-03-25 13:53:15.5,9360,138,488790,-6,9360,43,9365,85,S
2016-03-25 13:53:16,9365,124,488914,-88,9360,152,9365,118,B
2016-03-25 13:53:16.5,9360,8,488922,-2,9360,153,9365,97,S
2016-03-25 13:53:17,9360,2,488924,-2,9360,660,9365,104,S
2016-03-25 13:53:18,9360,2,488926,-2,9360,724,9365,105,S
2016-03-25 13:53:19,9365,24,488950,-22,9360,722,9365,101,B
2016-03-25 13:53:20,9360,2,488952,0,9360,310,9365,103,S
2016-03-25 13:53:21,9360,6,488958,-2,9360,308,9365,119,S
2016-03-25 13:53:22,9360,52,489010,-6,9360,293,9365,108,S
2016-03-25 13:53:23,9365,14,489024,-2,9360,294,9365,101,B
2016-03-25 13:53:23.5,9360,4,489028,0,9360,223,9365,145,S
2016-03-25 13:53:24,9360,2,489030,2,9360,229,9365,146,S
2016-03-25 13:53:25,9360,2,489032,0,9360,228,9365,493,S
2016-03-25 13:53:25.5,9365,8,489040,0,9360,228,9365,489,B
2016-03-25 13:53:26,9365,2,489042,2,9360,431,9365,490,B
2016-03-25 13:53:26.5,9360,18,489060,6,9360,422,9365,1070,S
2016-03-25 13:53:27,9365,6,489066,2,9360,426,9365,1068,B
2016-03-25 13:53:27.5,9360,48,489114,44,9360,404,9365,1068,S
2016-03-25 13:53:28,9365,20,489134,20,9360,403,9365,1059,B
2016-03-25 13:53:28.5,9360,20,489154,0,9360,369,9365,1060,S
2016-03-25 13:53:29,9360,2,489156,2,9360,361,9365,1095,S
2016-03-25 13:53:29.5,9360,4,489160,0,9360,481,9365,1142,S
2016-03-25 13:53:30,9360,68,489228,18,9360,449,9365,1224,S
2016-03-25 13:53:30.5,9360,32,489260,16,9360,436,9365,1230,S
2016-03-25 13:53:31,9360,46,489306,-28,9360,418,9365,1232,S
2016-03-25 13:53:31.5,9360,14,489320,0,9360,411,9365,1232,S
2016-03-25 13:53:32,9360,28,489348,-6,9360,400,9365,1230,S
2016-03-25 13:53:33,9360,10,489358,0,9360,387,9365,1238,S
2016-03-25 13:53:34,9360,2,489360,-2,9360,386,9365,1240,S
2016-03-25 13:53:34.5,9360,6,489366,0,9360,385,9365,1224,S
2016-03-25 13:53:35,9360,14,489380,-4,9360,381,9365,1270,S
2016-03-25 13:53:35.5,9360,200,489580,0,9360,281,9365,1270,S
2016-03-25 13:53:36,9360,24,489604,-2,9360,277,9365,1270,S
2016-03-25 13:53:37,9360,14,489618,0,9360,276,9365,1265,S
2016-03-25 13:53:37.5,9360,10,489628,-10,9360,271,9365,1266,S
2016-03-25 13:53:38,9360,320,489948,-176,9360,111,9365,1267,S
2016-03-25 13:53:38.5,9360,232,490180,-18,9355,410,9360,68,S
2016-03-25 13:53:39,9360,30,490210,18,9355,410,9360,117,S
2016-03-25 13:53:39.5,9355,12,490222,-2,9355,399,9360,113,S
2016-03-25 13:53:40,9355,6,490228,2,9355,397,9360,127,S
2016-03-25 13:53:40.5,9360,12,490240,-2,9355,396,9360,123,B
2016-03-25 13:53:41,9360,6,490246,2,9355,384,9360,144,B
2016-03-25 13:53:42,9355,50,490296,30,9355,360,9360,152,S
2016-03-25 13:53:42.5,9360,4,490300,-2,9355,360,9360,150,B
2016-03-25 13:53:44,9355,2,490302,2,9355,360,9360,184,S
2016-03-25 13:53:45,9355,4,490306,-2,9355,359,9360,189,S
2016-03-25 13:53:45.5,9360,6,490312,2,9355,364,9360,186,B
2016-03-25 13:53:47,9360,2,490314,0,9355,367,9360,190,B
2016-03-25 13:53:47.5,9355,2,490316,0,9355,366,9360,363,S
2016-03-25 13:53:48,9360,114,490430,24,9355,351,9360,314,B
2016-03-25 13:53:48.5,9360,2,490432,2,9355,350,9360,314,B
2016-03-25 13:53:49,9355,12,490444,-6,9355,349,9360,319,S
2016-03-25 13:53:50,9355,2,490446,-2,9355,359,9360,319,S
2016-03-25 13:53:50.5,9355,18,490464,-8,9355,358,9360,311,S
2016-03-25 13:53:51,9355,224,490688,-214,9355,247,9360,311,S
2016-03-25 13:53:51.5,9355,2,490690,-2,9355,250,9360,311,S
2016-03-25 13:53:53,9360,12,490702,8,9355,262,9360,317,B
2016-03-25 13:53:54,9355,6,490708,0,9355,261,9360,307,S
2016-03-25 13:53:55,9360,98,490806,58,9355,294,9360,259,B
2016-03-25 13:53:55.5,9355,6,490812,-6,9355,291,9360,261,S
2016-03-25 13:53:56,9355,14,490826,0,9355,290,9360,259,S
2016-03-25 13:53:56.5,9355,64,490890,18,9355,259,9360,249,S
2016-03-25 13:53:57,9360,202,491092,-160,9355,261,9360,148,B
2016-03-25 13:53:58,9355,90,491182,-84,9355,216,9360,163,S
2016-03-25 13:53:59,9360,2,491184,-2,9355,218,9360,160,B
2016-03-25 13:54:00,9360,2,491186,-2,9355,219,9360,162,B
2016-03-25 13:54:01,9355,44,491230,-40,9355,198,9360,195,S
2016-03-25 13:54:01.5,9360,10,491240,-10,9355,200,9360,273,B
2016-03-25 13:54:02,9355,4,491244,-2,9355,199,9360,277,S
2016-03-25 13:54:03,9355,10,491254,-2,9355,195,9360,284,S
2016-03-25 13:54:04,9355,62,491316,-60,9355,164,9360,284,S
2016-03-25 13:54:04.5,9355,4,491320,-2,9355,164,9360,283,S
2016-03-25 13:54:05,9355,90,491410,-52,9355,119,9360,284,S
2016-03-25 13:54:06,9355,20,491430,16,9355,109,9360,303,S
2016-03-25 13:54:06.3333,9355,8,491438,4,9355,106,9360,302,S
2016-03-25 13:54:06.6667,9355,208,491646,180,9350,541,9360,303,S
2016-03-25 13:54:07,9355,10,491656,0,9350,671,9355,31,S
2016-03-25 13:54:08,9355,4,491660,-2,9350,656,9355,56,S
2016-03-25 13:54:08.5,9350,166,491826,-108,9350,526,9355,68,S
2016-03-25 13:54:09,9350,86,491912,-68,9350,640,9355,49,S
2016-03-25 13:54:09.3333,9350,4,491916,-2,9350,625,9355,49,S
2016-03-25 13:54:09.6667,9355,14,491930,-10,9350,609,9355,47,B
2016-03-25 13:54:11,9355,114,492044,-62,9355,5,9360,343,B
2016-03-25 13:54:11.5,9355,132,492176,12,9355,38,9360,348,B
2016-03-25 13:54:12,9355,114,492290,-36,9350,565,9355,36,B
2016-03-25 13:54:12.5,9355,36,492326,-28,9350,594,9355,24,B
2016-03-25 13:54:13,9355,138,492464,-122,9355,102,9360,344,B
2016-03-25 13:54:13.5,9355,46,492510,-18,9355,101,9360,341,B
2016-03-25 13:54:14,9355,20,492530,20,9355,135,9360,356,B
2016-03-25 13:54:15,9355,24,492554,24,9355,138,9360,343,B
2016-03-25 13:54:16,9355,4,492558,4,9355,250,9360,345,B
2016-03-25 13:54:17,9355,2,492560,2,9355,277,9360,345,B
2016-03-25 13:54:17.5,9355,336,492896,-68,9355,108,9360,345,B
2016-03-25 13:54:18,9360,10,492906,0,9355,113,9360,340,B
2016-03-25 13:54:18.5,9360,262,493168,112,9355,4,9360,329,B
2016-03-25 13:54:19,9355,12,493180,4,9350,613,9355,209,S
2016-03-25 13:54:19.5,9355,4,493184,-2,9350,613,9355,263,S
2016-03-25 13:54:20,9355,4,493188,-2,9350,615,9355,281,S
2016-03-25 13:54:21,9355,20,493208,-20,9350,633,9355,274,S
2016-03-25 13:54:21.5,9355,22,493230,-22,9350,638,9355,264,S
2016-03-25 13:54:22,9355,2,493232,-2,9350,641,9355,335,S
2016-03-25 13:54:22.5,9350,8,493240,4,9350,638,9355,333,S
2016-03-25 13:54:23,9350,10,493250,-4,9350,637,9355,330,S
2016-03-25 13:54:24,9355,8,493258,0,9350,637,9355,327,B
2016-03-25 13:54:25,9355,2,493260,-2,9350,658,9355,326,B
2016-03-25 13:54:26,9355,2,493262,-2,9350,668,9355,327,B
2016-03-25 13:54:26.5,9355,4,493266,0,9350,668,9355,325,B
2016-03-25 13:54:27,9355,4,493270,0,9350,667,9355,345,B
2016-03-25 13:54:28,9350,4,493274,0,9350,668,9355,344,S
2016-03-25 13:54:30,9350,2,493276,-2,9350,706,9355,345,S
2016-03-25 13:54:31,9355,22,493298,-2,9350,681,9355,335,B
2016-03-25 13:54:31.5,9355,2,493300,0,9350,812,9355,334,B
2016-03-25 13:54:32,9355,210,493510,-102,9350,811,9355,231,B
2016-03-25 13:54:32.5,9355,122,493632,-26,9350,805,9355,173,B
2016-03-25 13:54:33,9355,8,493640,-4,9350,814,9355,271,B
2016-03-25 13:54:33.5,9350,6,493646,6,9350,820,9355,274,S
2016-03-25 13:54:34,9355,20,493666,-4,9350,820,9355,264,B
2016-03-25 13:54:34.5,9355,10,493676,-6,9350,831,9355,263,B
2016-03-25 13:54:35,9355,24,493700,0,9350,831,9355,265,B
2016-03-25 13:54:36,9355,4,493704,-2,9350,839,9355,264,B
2016-03-25 13:54:36.5,9355,2,493706,0,9350,839,9355,263,B
2016-03-25 13:54:37,9350,338,494044,-176,9350,662,9355,269,S
2016-03-25 13:54:38,9355,4,494048,-4,9350,658,9355,271,B
2016-03-25 13:54:40,9355,390,494438,-30,9350,501,9355,319,B
2016-03-25 13:54:40.5,9350,62,494500,-38,9350,484,9355,309,S
2016-03-25 13:54:41,9350,14,494514,-10,9350,423,9355,308,S
2016-03-25 13:54:41.5,9350,208,494722,-2,9350,332,9355,308,S
2016-03-25 13:54:42,9355,358,495080,-198,9350,156,9355,305,B
2016-03-25 13:54:42.5,9350,36,495116,2,9350,147,9355,316,S
2016-03-25 13:54:43,9350,114,495230,-22,9350,103,9355,316,S
2016-03-25 13:54:44,9350,112,495342,40,9350,58,9355,322,S
2016-03-25 13:54:44.3333,9350,48,495390,10,9345,346,9355,324,S
2016-03-25 13:54:44.6667,9350,10,495400,10,9345,434,9355,326,S
2016-03-25 13:54:45,9350,10,495410,0,9345,461,9355,325,S
2016-03-25 13:54:45.5,9350,94,495504,4,9350,28,9355,285,S
2016-03-25 13:54:46,9350,104,495608,2,9350,8,9355,245,S
2016-03-25 13:54:46.5,9350,90,495698,52,9350,117,9355,223,S
2016-03-25 13:54:47,9350,4,495702,2,9350,352,9355,514,S
2016-03-25 13:54:47.5,9350,210,495912,-178,9350,248,9355,516,S
2016-03-25 13:54:48,9350,4,495916,0,9350,235,9355,816,S
2016-03-25 13:54:49,9350,6,495922,-4,9350,238,9355,818,S
2016-03-25 13:54:49.5,9350,46,495968,-18,9345,459,9350,9,S
2016-03-25 13:54:50,9350,54,496022,-4,9350,20,9355,819,S
2016-03-25 13:54:50.5,9350,72,496094,20,9345,485,9350,17,S
2016-03-25 13:54:51,9350,10,496104,2,9345,524,9350,21,S
2016-03-25 13:54:51.5,9350,64,496168,56,9350,70,9355,831,S
2016-03-25 13:54:52,9350,8,496176,4,9350,74,9355,855,S
2016-03-25 13:54:52.5,9350,2,496178,0,9350,143,9355,904,S
2016-03-25 13:54:53,9350,270,496448,-44,9350,60,9355,904,S
2016-03-25 13:54:53.5,9350,12,496460,0,9350,63,9355,904,S
2016-03-25 13:54:54,9350,178,496638,-46,9350,48,9355,903,S
2016-03-25 13:54:55,9350,2,496640,0,9350,66,9355,902,S
2016-03-25 13:54:55.5,9350,44,496684,-42,9350,35,9355,896,S
2016-03-25 13:54:56,9350,36,496720,24,9345,401,9350,11,S
2016-03-25 13:54:56.5,9350,4,496724,0,9345,404,9350,33,S
2016-03-25 13:54:57,9350,194,496918,114,9350,123,9355,910,S
2016-03-25 13:54:57.5,9350,6,496924,-2,9350,127,9355,911,S
2016-03-25 13:54:58,9350,282,497206,-36,9345,298,9350,2,S
2016-03-25 13:54:58.5,9350,18,497224,6,9350,3,9355,1091,S
2016-03-25 13:54:59,9345,44,497268,-6,9345,305,9350,43,S
2016-03-25 13:54:59.5,9350,12,497280,2,9345,301,9350,102,B
2016-03-25 13:55:00,9350,4,497284,0,9345,291,9350,174,B
2016-03-25 13:55:01,9345,54,497338,-24,9345,301,9350,290,S
2016-03-25 13:55:02,9345,40,497378,20,9345,281,9350,300,S
2016-03-25 13:55:02.5,9345,22,497400,-10,9345,275,9350,406,S
2016-03-25 13:55:03,9350,24,497424,-24,9345,276,9350,399,B
2016-03-25 13:55:04,9345,64,497488,-6,9345,252,9350,405,S
2016-03-25 13:55:04.5,9350,1002,498490,466,9350,50,9355,436,B
2016-03-25 13:55:05,9345,106,498596,102,9345,85,9350,143,S
2016-03-25 13:55:05.5,9345,56,498652,-22,9345,352,9350,159,S
2016-03-25 13:55:06,9350,4,498656,0,9345,366,9350,201,B
2016-03-25 13:55:06.5,9345,8,498664,0,9345,135,9350,189,S
2016-03-25 13:55:07,9345,10,498674,0,9345,82,9350,236,S
2016-03-25 13:55:07.5,9345,138,498812,88,9345,43,9350,236,S
2016-03-25 13:55:08,9345,2,498814,2,9345,47,9350,236,S
2016-03-25 13:55:08.5,9345,34,498848,2,9345,46,9350,526,S
2016-03-25 13:55:09,9345,18,498866,-10,9345,39,9350,556,S
2016-03-25 13:55:09.5,9345,84,498950,52,9340,422,9345,20,S
2016-03-25 13:55:10,9340,16,498966,-2,9340,418,9345,31,S
2016-03-25 13:55:10.5,9345,370,499336,152,9345,147,9350,166,B
2016-03-25 13:55:11,9345,102,499438,24,9345,97,9350,140,B
2016-03-25 13:55:11.5,9345,140,499578,-36,9345,118,9350,152,B
2016-03-25 13:55:12,9345,64,499642,14,9345,372,9350,93,B
2016-03-25 13:55:12.5,9345,2,499644,2,9345,493,9350,91,B
2016-03-25 13:55:13,9345,58,499702,44,9345,465,9350,92,B
2016-03-25 13:55:13.5,9350,44,499746,-4,9345,468,9350,156,B
2016-03-25 13:55:14,9350,2,499748,2,9345,469,9350,242,B
2016-03-25 13:55:14.5,9345,2,499750,0,9345,575,9350,250,S
2016-03-25 13:55:15,9350,2,499752,0,9345,566,9350,203,B
2016-03-25 13:55:16,9345,4,499756,4,9345,563,9350,209,S
2016-03-25 13:55:16.5,9345,2,499758,2,9345,620,9350,309,S
2016-03-25 13:55:17,9345,2,499760,0,9345,623,9350,322,S
2016-03-25 13:55:18,9350,2,499762,0,9345,623,9350,341,B
2016-03-25 13:55:18.5,9345,2,499764,2,9345,622,9350,342,S
2016-03-25 13:55:19,9345,12,499776,4,9345,622,9350,339,S
2016-03-25 13:55:20,9350,40,499816,26,9345,527,9350,319,B
2016-03-25 13:55:20.5,9350,20,499836,10,9345,531,9350,309,B
2016-03-25 13:55:22,9350,46,499882,-36,9345,531,9350,270,B
2016-03-25 13:55:23,9350,4,499886,0,9345,532,9350,267,B
2016-03-25 13:55:23.5,9345,20,499906,20,9345,531,9350,266,S
2016-03-25 13:55:24,9345,146,500052,-6,9345,464,9350,264,S
2016-03-25 13:55:24.5,9345,16,500068,-12,9345,473,9350,313,S
2016-03-25 13:55:26,9345,16,500084,0,9345,472,9350,288,S
2016-03-25 13:55:26.5,9350,2,500086,-2,9345,477,9350,285,B
2016-03-25 13:55:27,9345,10,500096,0,9345,473,9350,286,S
2016-03-25 13:55:28,9350,538,500634,48,9345,551,9355,421,B
2016-03-25 13:55:29,9350,254,500888,176,9350,113,9355,470,B
2016-03-25 13:55:30,9350,14,500902,4,9350,117,9355,468,B
2016-03-25 13:55:30.5,9350,30,500932,-28,9350,14,9355,476,B
2016-03-25 13:55:31,9350,172,501104,16,9345,432,9355,450,B
2016-03-25 13:55:32,9345,68,501172,68,9345,379,9350,109,S
2016-03-25 13:55:33,9350,2,501174,0,9345,380,9350,150,B
2016-03-25 13:55:34,9345,8,501182,4,9345,399,9350,147,S
2016-03-25 13:55:35,9350,4,501186,2,9345,400,9350,171,B
2016-03-25 13:55:35.5,9350,12,501198,2,9345,399,9350,166,B
2016-03-25 13:55:36,9350,4,501202,0,9345,400,9350,184,B
2016-03-25 13:55:36.5,9350,22,501224,0,9345,400,9350,174,B
2016-03-25 13:55:38,9345,50,501274,0,9345,378,9350,159,S
2016-03-25 13:55:38.5,9350,4,501278,0,9345,390,9350,190,B
2016-03-25 13:55:39,9350,10,501288,0,9345,390,9350,186,B
2016-03-25 13:55:39.5,9350,2,501290,0,9345,413,9350,191,B
2016-03-25 13:55:40,9350,2,501292,0,9345,425,9350,191,B
2016-03-25 13:55:40.5,9350,66,501358,-8,9345,427,9350,128,B
2016-03-25 13:55:41,9350,2,501360,0,9345,427,9350,128,B
2016-03-25 13:55:41.5,9345,88,501448,0,9345,383,9350,84,S
2016-03-25 13:55:42,9350,268,501716,150,9350,105,9355,598,B
2016-03-25 13:55:42.5,9350,6,501722,2,9350,19,9355,536,B
2016-03-25 13:55:43,9350,14,501736,-2,9350,34,9355,550,B
2016-03-25 13:55:43.5,9350,12,501748,-2,9350,34,9355,698,B
2016-03-25 13:55:44,9350,70,501818,-4,9345,419,9350,244,B
2016-03-25 13:55:45,9345,104,501922,52,9345,370,9350,267,S
2016-03-25 13:55:45.5,9350,6,501928,0,9345,370,9350,290,B
2016-03-25 13:55:47,9345,106,502034,-14,9345,359,9350,229,S
2016-03-25 13:55:48,9350,2,502036,0,9345,374,9350,251,B
2016-03-25 13:55:48.5,9345,2,502038,0,9345,373,9350,251,S
2016-03-25 13:55:49,9345,4,502042,2,9345,379,9350,264,S
2016-03-25 13:55:49.5,9345,26,502068,0,9345,369,9350,262,S
2016-03-25 13:55:51,9350,428,502496,-312,9345,451,9355,655,B
2016-03-25 13:55:51.5,9350,8,502504,0,9350,27,9355,637,B
2016-03-25 13:55:52,9350,42,502546,14,9350,55,9355,646,B
2016-03-25 13:55:52.5,9350,2,502548,0,9350,183,9355,646,B
2016-03-25 13:55:54,9350,368,502916,-28,9345,461,9350,116,B
2016-03-25 13:55:54.5,9350,250,503166,-144,9350,68,9355,632,B
2016-03-25 13:55:55,9350,140,503306,8,9345,461,9350,237,B
2016-03-25 13:55:56,9350,8,503314,-8,9345,381,9350,283,B
2016-03-25 13:55:56.5,9350,2,503316,-2,9345,380,9350,343,B
2016-03-25 13:55:57,9350,10,503326,0,9345,483,9350,339,B
2016-03-25 13:55:58,9350,6,503332,-4,9345,483,9350,336,B
2016-03-25 13:55:58.5,9345,2,503334,0,9345,478,9350,346,S
2016-03-25 13:55:59,9350,6,503340,-2,9345,478,9350,387,B
2016-03-25 13:56:00,9350,2,503342,0,9345,578,9350,402,B
2016-03-25 13:56:01,9350,42,503384,0,9345,560,9350,401,B
2016-03-25 13:56:01.5,9345,10,503394,0,9345,786,9350,351,S
2016-03-25 13:56:02,9350,10,503404,-10,9345,786,9350,356,B
2016-03-25 13:56:03,9350,38,503442,-38,9345,853,9350,353,B
2016-03-25 13:56:04,9350,6,503448,-6,9345,857,9350,340,B
2016-03-25 13:56:04.5,9350,12,503460,-12,9345,860,9350,334,B
2016-03-25 13:56:05,9350,8,503468,0,9345,861,9350,331,B
2016-03-25 13:56:06,9350,4,503472,0,9345,864,9350,331,B
2016-03-25 13:56:06.5,9350,6,503478,-2,9345,865,9350,329,B
2016-03-25 13:56:07,9350,4,503482,-4,9345,865,9350,328,B
2016-03-25 13:56:07.5,9345,6,503488,-2,9345,875,9350,326,S
2016-03-25 13:56:08,9350,42,503530,-42,9345,871,9350,317,B
2016-03-25 13:56:08.5,9350,2,503532,0,9345,871,9350,330,B
2016-03-25 13:56:10,9350,2,503534,-2,9345,875,9350,300,B
2016-03-25 13:56:10.5,9350,14,503548,-12,9345,886,9350,277,B
2016-03-25 13:56:11,9350,2,503550,-2,9345,902,9350,276,B
2016-03-25 13:56:11.5,9350,24,503574,0,9345,913,9350,264,B
2016-03-25 13:56:12,9350,544,504118,-450,9350,135,9355,551,B
2016-03-25 13:56:13,9350,2,504120,0,9350,146,9355,557,B
2016-03-25 13:56:13.5,9355,2,504122,0,9350,521,9355,556,B
2016-03-25 13:56:14,9350,28,504150,0,9350,514,9355,550,S
2016-03-25 13:56:15,9350,4,504154,2,9350,834,9355,500,S
2016-03-25 13:56:15.5,9350,42,504196,0,9350,814,9355,498,S
2016-03-25 13:56:16,9355,6,504202,0,9350,852,9355,507,B
2016-03-25 13:56:16.5,9355,2,504204,2,9350,1032,9355,361,B
2016-03-25 13:56:18,9355,732,504936,-310,9355,153,9360,559,B
2016-03-25 13:56:18.5,9355,26,504962,-26,9355,140,9360,559,B
2016-03-25 13:56:19,9355,284,505246,-246,9350,817,9355,209,B
2016-03-25 13:56:19.5,9355,12,505258,-2,9350,793,9355,205,B
2016-03-25 13:56:20,9355,4,505262,-4,9350,892,9355,214,B
2016-03-25 13:56:21,9350,8,505270,-4,9350,891,9355,211,S
2016-03-25 13:56:22,9355,22,505292,-22,9350,905,9355,205,B
2016-03-25 13:56:22.5,9355,6,505298,-6,9350,906,9355,203,B
2016-03-25 13:56:23,9355,6,505304,0,9350,907,9355,200,B
2016-03-25 13:56:23.5,9355,10,505314,0,9350,931,9355,195,B
2016-03-25 13:56:24,9355,120,505434,0,9350,931,9355,138,B
2016-03-25 13:56:24.5,9355,4,505438,-4,9350,982,9355,151,B
2016-03-25 13:56:25,9355,2,505440,0,9350,1066,9355,152,B
2016-03-25 13:56:25.5,9355,120,505560,0,9350,1067,9355,90,B
2016-03-25 13:56:26,9355,202,505762,-136,9355,35,9360,727,B
2016-03-25 13:56:26.5,9355,12,505774,-10,9355,165,9360,725,B
2016-03-25 13:56:27,9355,174,505948,-116,9355,85,9360,683,B
2016-03-25 13:56:28,9355,20,505968,8,9355,77,9360,688,B
2016-03-25 13:56:29,9360,32,506000,0,9355,70,9360,692,B
2016-03-25 13:56:29.5,9360,8,506008,-4,9355,72,9360,689,B
2016-03-25 13:56:30,9360,2,506010,-2,9355,87,9360,689,B
2016-03-25 13:56:30.5,9355,10,506020,6,9355,87,9360,687,S
2016-03-25 13:56:31,9360,2,506022,0,9355,87,9360,686,B
2016-03-25 13:56:31.5,9355,4,506026,0,9355,86,9360,685,S
2016-03-25 13:56:32,9355,14,506040,4,9355,79,9360,685,S
2016-03-25 13:56:32.5,9360,4,506044,-4,9355,130,9360,684,B
2016-03-25 13:56:33,9355,26,506070,26,9355,117,9360,683,S
2016-03-25 13:56:33.5,9355,296,506366,-20,9350,538,9355,17,S
2016-03-25 13:56:34,9355,38,506404,6,9350,514,9355,106,S
2016-03-25 13:56:34.5,9355,10,506414,0,9350,519,9355,173,S
2016-03-25 13:56:35,9355,2,506416,2,9350,519,9355,214,S
2016-03-25 13:56:35.5,9355,12,506428,-10,9350,524,9355,250,S
2016-03-25 13:56:36,9355,2,506430,2,9350,497,9355,253,S
2016-03-25 13:56:36.5,9355,6,506436,4,9350,465,9355,272,S
2016-03-25 13:56:37,9355,12,506448,12,9350,464,9355,268,S
2016-03-25 13:56:37.5,9355,40,506488,28,9350,445,9355,256,S
2016-03-25 13:56:38,9355,32,506520,-30,9350,447,9355,240,S
2016-03-25 13:56:39,9355,478,506998,-380,9350,452,9360,542,S
2016-03-25 13:56:39.5,9355,64,507062,-4,9350,451,9360,530,S
2016-03-25 13:56:40,9355,18,507080,-16,9355,10,9360,530,S
2016-03-25 13:56:40.5,9360,26,507106,18,9355,4,9360,573,B
2016-03-25 13:56:41,9350,18,507124,16,9350,418,9355,498,S
2016-03-25 13:56:41.5,9350,2,507126,2,9350,416,9355,499,S
2016-03-25 13:56:42,9355,10,507136,10,9350,414,9355,497,B
2016-03-25 13:56:42.5,9350,844,507980,-84,9350,12,9355,577,S
2016-03-25 13:56:43,9350,28,508008,-16,9345,385,9350,251,S
2016-03-25 13:56:43.5,9350,58,508066,-50,9345,386,9350,223,S
2016-03-25 13:56:44,9350,22,508088,-2,9345,386,9350,41,S
2016-03-25 13:56:44.5,9345,32,508120,-18,9345,380,9350,33,S
2016-03-25 13:56:45,9350,6,508126,0,9345,430,9350,30,B
2016-03-25 13:56:45.5,9345,420,508546,-276,9345,151,9350,115,S
2016-03-25 13:56:46,9345,2,508548,2,9345,161,9350,237,S
2016-03-25 13:56:47,9350,2,508550,0,9345,161,9350,245,B
2016-03-25 13:56:47.5,9350,62,508612,6,9345,161,9350,214,B
2016-03-25 13:56:48,9350,2,508614,2,9345,161,9350,213,B
2016-03-25 13:56:49,9345,4,508618,0,9345,161,9350,261,S
2016-03-25 13:56:51,9350,6,508624,4,9345,163,9350,310,B
2016-03-25 13:56:51.5,9345,2,508626,2,9345,164,9350,311,S
2016-03-25 13:56:52,9345,328,508954,-308,9340,612,9345,80,S
2016-03-25 13:56:52.5,9345,6,508960,0,9340,599,9345,78,S
2016-03-25 13:56:53,9345,2,508962,-2,9340,579,9345,88,S
2016-03-25 13:56:53.5,9345,20,508982,0,9340,582,9345,80,S
2016-03-25 13:56:54,9345,24,509006,12,9340,561,9345,111,S
2016-03-25 13:56:56,9340,6,509012,0,9340,558,9345,119,S
2016-03-25 13:56:56.5,9345,12,509024,0,9340,564,9345,113,B
2016-03-25 13:56:57,9340,6,509030,0,9340,573,9345,118,S
2016-03-25 13:56:57.5,9345,160,509190,70,9340,533,9345,80,B
2016-03-25 13:56:58,9345,4,509194,0,9340,533,9345,77,B
2016-03-25 13:56:58.5,9340,600,509794,-90,9340,241,9345,134,S
2016-03-25 13:56:59,9340,728,510522,-14,9340,26,9345,35,S
2016-03-25 13:57:00,9340,64,510586,-30,9335,540,9340,29,S
2016-03-25 13:57:00.3333,9340,38,510624,-8,9335,504,9340,29,S
2016-03-25 13:57:00.6667,9340,2,510626,-2,9335,502,9340,90,S
2016-03-25 13:57:01,9340,8,510634,0,9335,502,9340,86,S
2016-03-25 13:57:02,9335,62,510696,-38,9335,418,9340,173,S
2016-03-25 13:57:02.5,9335,308,511004,-124,9335,107,9340,242,S
2016-03-25 13:57:03,9330,226,511230,-76,9330,661,9335,90,S
2016-03-25 13:57:03.5,9330,228,511458,-120,9330,436,9335,129,S
2016-03-25 13:57:04,9330,388,511846,-40,9330,224,9335,183,S
2016-03-25 13:57:04.5,9330,104,511950,42,9330,175,9335,220,S
2016-03-25 13:57:05,9335,8,511958,4,9330,175,9335,220,B
2016-03-25 13:57:05.5,9335,62,512020,48,9330,254,9335,219,B
2016-03-25 13:57:06,9330,40,512060,10,9330,261,9335,202,S
2016-03-25 13:57:06.3333,9330,8,512068,-2,9330,250,9335,203,S
2016-03-25 13:57:06.6667,9330,4,512072,0,9330,254,9335,203,S
2016-03-25 13:57:07,9335,4,512076,0,9330,253,9335,182,B
2016-03-25 13:57:08,9335,386,512462,120,9335,12,9340,471,B
2016-03-25 13:57:08.5,9340,14,512476,0,9335,17,9340,465,B
2016-03-25 13:57:09,9340,22,512498,2,9335,51,9340,459,B
2016-03-25 13:57:09.5,9335,6,512504,-4,9335,48,9340,650,S
2016-03-25 13:57:10,9335,10,512514,0,9335,46,9340,951,S
2016-03-25 13:57:11,9335,42,512556,0,9335,31,9340,953,S
2016-03-25 13:57:11.5,9340,8,512564,8,9335,33,9340,1002,B
2016-03-25 13:57:12,9335,4,512568,2,9335,34,9340,1002,S
2016-03-25 13:57:12.5,9335,22,512590,0,9335,41,9340,1001,S
2016-03-25 13:57:13,9335,22,512612,-20,9335,36,9340,1001,S
2016-03-25 13:57:13.5,9335,72,512684,-2,9330,343,9340,1001,S
2016-03-25 13:57:14,9335,4,512688,-2,9335,65,9340,1000,S
2016-03-25 13:57:14.5,9335,18,512706,16,9335,122,9340,951,S
2016-03-25 13:57:15,9335,186,512892,-132,9335,48,9340,1001,S
2016-03-25 13:57:15.5,9335,2,512894,0,9335,72,9340,1001,S
2016-03-25 13:57:16,9340,6,512900,0,9335,76,9340,998,B
2016-03-25 13:57:16.5,9340,2,512902,0,9335,32,9340,285,B
2016-03-25 13:57:17,9335,4,512906,-2,9335,91,9340,203,S
2016-03-25 13:57:17.5,9340,408,513314,264,9340,186,9345,322,B
2016-03-25 13:57:18,9345,18,513332,0,9340,437,9345,147,B
2016-03-25 13:57:18.5,9340,2,513334,2,9340,436,9345,77,S
2016-03-25 13:57:19,9340,2,513336,0,9340,435,9345,111,S
2016-03-25 13:57:19.5,9340,90,513426,12,9340,392,9345,110,S
2016-03-25 13:57:20,9340,68,513494,48,9340,168,9345,233,S
2016-03-25 13:57:21,9345,2,513496,-2,9340,170,9345,359,B
2016-03-25 13:57:22,9340,2,513498,0,9340,169,9345,353,S
2016-03-25 13:57:22.5,9345,2,513500,0,9340,170,9345,351,B
2016-03-25 13:57:23,9345,8,513508,0,9340,168,9345,346,B
2016-03-25 13:57:23.5,9340,18,513526,4,9340,168,9345,335,S
2016-03-25 13:57:24,9340,4,513530,4,9340,167,9345,442,S
2016-03-25 13:57:25,9345,8,513538,-4,9340,21,9345,521,B
2016-03-25 13:57:26,9345,80,513618,-30,9340,21,9345,452,B
2016-03-25 13:57:26.5,9340,2,513620,0,9340,20,9345,397,S
2016-03-25 13:57:27,9340,2,513622,0,9340,92,9345,397,S
2016-03-25 13:57:29,9345,6,513628,0,9340,108,9345,389,B
2016-03-25 13:57:29.5,9340,14,513642,-2,9340,341,9345,381,S
2016-03-25 13:57:30,9345,42,513684,2,9340,323,9345,328,B
2016-03-25 13:57:30.5,9340,204,513888,120,9340,373,9345,173,S
2016-03-25 13:57:32,9345,2,513890,-2,9340,1113,9345,171,B
2016-03-25 13:57:33,9340,8,513898,2,9340,735,9345,172,S
2016-03-25 13:57:35,9340,2,513900,0,9340,253,9345,305,S
2016-03-25 13:57:35.5,9340,202,514102,-122,9340,101,9345,356,S
2016-03-25 13:57:36,9345,4,514106,-2,9340,133,9345,355,B
2016-03-25 13:57:37,9340,20,514126,20,9340,124,9345,371,S
2016-03-25 13:57:37.5,9340,288,514414,-130,9335,300,9340,1,S
2016-03-25 13:57:38,9340,16,514430,-14,9340,341,9345,288,S
2016-03-25 13:57:38.5,9340,12,514442,-2,9340,335,9345,296,S
2016-03-25 13:57:41,9340,10,514452,0,9340,282,9345,323,S
2016-03-25 13:57:41.5,9345,4,514456,-4,9340,282,9345,322,B
2016-03-25 13:57:43,9345,40,514496,0,9340,373,9345,314,B
2016-03-25 13:57:43.5,9345,16,514512,-2,9340,377,9345,206,B
2016-03-25 13:57:44,9345,100,514612,0,9340,360,9345,154,B
2016-03-25 13:57:45,9345,20,514632,20,9340,366,9345,145,B
2016-03-25 13:57:45.3333,9345,16,514648,2,9340,372,9345,148,B
2016-03-25 13:57:45.6667,9345,2,514650,2,9340,373,9345,147,B
2016-03-25 13:57:46,9345,2,514652,0,9340,373,9345,162,B
2016-03-25 13:57:47,9345,4,514656,2,9340,373,9345,176,B
2016-03-25 13:57:47.5,9345,4,514660,0,9340,374,9345,175,B
2016-03-25 13:57:48,9345,6,514666,2,9340,374,9345,172,B
2016-03-25 13:57:48.5,9345,6,514672,6,9340,375,9345,171,B
2016-03-25 13:57:49,9345,2,514674,2,9340,387,9345,171,B
2016-03-25 13:57:50,9345,6,514680,2,9340,387,9345,169,B
2016-03-25 13:57:50.5,9345,22,514702,0,9340,403,9345,158,B
2016-03-25 13:57:52,9345,20,514722,20,9340,409,9345,150,B
2016-03-25 13:57:53,9345,4,514726,0,9340,429,9345,150,B
2016-03-25 13:57:53.5,9345,6,514732,4,9340,449,9345,146,B
2016-03-25 13:57:54,9345,66,514798,50,9340,452,9345,113,B
2016-03-25 13:57:55,9345,6,514804,-6,9340,453,9345,110,B
2016-03-25 13:57:56,9345,220,515024,44,9340,513,9345,8,B
2016-03-25 13:57:56.5,9345,16,515040,-16,9345,82,9350,821,B
2016-03-25 13:57:58,9345,2,515042,0,9345,67,9350,751,B
2016-03-25 13:58:00,9350,40,515082,40,9345,77,9350,731,B
2016-03-25 13:58:00.5,9350,20,515102,0,9345,78,9350,705,B
2016-03-25 13:58:01,9345,2,515104,2,9345,78,9350,705,S
2016-03-25 13:58:02,9345,4,515108,0,9345,130,9350,349,S
2016-03-25 13:58:03,9345,2,515110,2,9345,140,9350,339,S
2016-03-25 13:58:04,9345,64,515174,56,9345,141,9350,298,S
2016-03-25 13:58:06,9350,2,515176,2,9345,142,9350,294,B
2016-03-25 13:58:07,9345,2,515178,0,9345,535,9350,268,S
2016-03-25 13:58:07.5,9350,4,515182,2,9345,535,9350,216,B
2016-03-25 13:58:08,9350,274,515456,40,9345,564,9350,78,B
2016-03-25 13:58:08.5,9350,394,515850,-94,9345,564,9350,231,B
2016-03-25 13:58:09,9350,200,516050,-200,9345,564,9350,134,B
2016-03-25 13:58:09.5,9350,20,516070,-18,9345,565,9350,124,B
2016-03-25 13:58:10,9350,2,516072,0,9345,565,9350,123,B
2016-03-25 13:58:10.5,9350,16,516088,-2,9345,565,9350,115,B
2016-03-25 13:58:11,9350,2,516090,-2,9345,571,9350,114,B
2016-03-25 13:58:12,9350,234,516324,-230,9345,694,9350,24,B
2016-03-25 13:58:12.5,9350,92,516416,-40,9345,695,9350,6,B
2016-03-25 13:58:13,9350,12,516428,0,9345,679,9350,6,B
2016-03-25 13:58:13.5,9350,16,516444,12,9345,681,9350,6,B
2016-03-25 13:58:14,9350,12,516456,0,9350,34,9355,856,B
2016-03-25 13:58:14.5,9345,70,516526,-66,9345,579,9350,127,S
2016-03-25 13:58:16,9350,52,516578,-52,9345,194,9350,190,B
2016-03-25 13:58:18,9345,2,516580,0,9345,191,9350,217,S
2016-03-25 13:58:19,9345,2,516582,0,9345,192,9350,217,S
2016-03-25 13:58:20,9345,2,516584,0,9345,191,9350,219,S
2016-03-25 13:58:22,9350,2,516586,0,9345,192,9350,218,B
2016-03-25 13:58:22.5,9345,2,516588,2,9345,191,9350,218,S
2016-03-25 13:58:23,9345,2,516590,0,9345,191,9350,225,S
2016-03-25 13:58:24,9345,2,516592,0,9345,193,9350,225,S
2016-03-25 13:58:26,9350,4,516596,-2,9345,194,9350,234,B
2016-03-25 13:58:29,9345,16,516612,0,9345,182,9350,250,S
2016-03-25 13:58:30,9350,2,516614,-2,9345,183,9350,259,B
2016-03-25 13:58:31,9350,20,516634,0,9345,183,9350,254,B
2016-03-25 13:58:32,9350,12,516646,-12,9345,190,9350,254,B
2016-03-25 13:58:33,9350,2,516648,0,9345,190,9350,263,B
2016-03-25 13:58:34,9350,2,516650,0,9345,182,9350,262,B
2016-03-25 13:58:35,9345,2,516652,0,9345,181,9350,262,S
2016-03-25 13:58:37,9345,4,516656,0,9345,181,9350,265,S
2016-03-25 13:58:39,9345,2,516658,0,9345,241,9350,269,S
2016-03-25 13:58:40,9345,2,516660,0,9345,240,9350,279,S
2016-03-25 13:58:42,9350,2,516662,2,9345,332,9350,267,B
2016-03-25 13:58:44,9350,30,516692,30,9345,332,9350,250,B
2016-03-25 13:58:46,9350,2,516694,0,9345,333,9350,249,B
2016-03-25 13:58:50,9350,2,516696,2,9345,336,9350,251,B
2016-03-25 13:58:50.5,9350,26,516722,24,9345,335,9350,240,B
2016-03-25 13:58:51,9350,98,516820,48,9345,311,9350,215,B
2016-03-25 13:58:51.5,9350,2,516822,0,9345,311,9350,215,B
2016-03-25 13:58:53,9345,6,516828,4,9345,310,9350,213,S
2016-03-25 13:58:54,9345,2,516830,0,9345,309,9350,217,S
2016-03-25 13:58:54.5,9350,104,516934,90,9345,311,9350,186,B
2016-03-25 13:58:55,9345,2,516936,0,9345,310,9350,186,S
2016-03-25 13:58:56,9345,6,516942,0,9345,309,9350,184,S
2016-03-25 13:58:56.5,9350,100,517042,2,9345,309,9350,136,B
2016-03-25 13:58:57,9350,100,517142,34,9345,310,9350,85,B
2016-03-25 13:58:57.5,9345,22,517164,22,9345,309,9350,75,S
2016-03-25 13:58:58,9350,28,517192,6,9345,362,9350,121,B
2016-03-25 13:58:59,9350,100,517292,-32,9345,412,9350,92,B
2016-03-25 13:59:00,9350,20,517312,-2,9345,419,9350,125,B
2016-03-25 13:59:01,9350,4,517316,0,9345,417,9350,124,B
2016-03-25 13:59:02,9350,12,517328,12,9345,422,9350,128,B
2016-03-25 13:59:03,9350,60,517388,-54,9345,422,9350,98,B
2016-03-25 13:59:04,9350,196,517584,-122,9350,85,9355,946,B
2016-03-25 13:59:05,9350,10,517594,2,9350,147,9355,894,B
2016-03-25 13:59:06,9350,2,517596,0,9350,178,9355,892,B
2016-03-25 13:59:08,9350,2,517598,2,9350,177,9355,803,B
2016-03-25 13:59:08.5,9355,2,517600,2,9350,178,9355,802,B
2016-03-25 13:59:09,9350,42,517642,0,9350,177,9355,784,S
2016-03-25 13:59:10,9355,110,517752,0,9350,227,9355,730,B
2016-03-25 13:59:10.5,9350,2,517754,0,9350,227,9355,733,S
2016-03-25 13:59:12,9350,6,517760,0,9350,226,9355,736,S
2016-03-25 13:59:13,9355,2,517762,2,9350,226,9355,735,B
2016-03-25 13:59:13.5,9355,2,517764,0,9350,236,9355,734,B
2016-03-25 13:59:14,9350,160,517924,124,9350,106,9355,736,S
2016-03-25 13:59:15,9350,94,518018,62,9350,90,9355,712,S
2016-03-25 13:59:15.5,9355,220,518238,68,9345,485,9355,707,B
2016-03-25 13:59:16,9345,48,518286,18,9345,475,9355,707,S
2016-03-25 13:59:16.5,9355,64,518350,22,9345,333,9350,7,B
2016-03-25 13:59:17,9355,16,518366,2,9345,333,9350,123,B
2016-03-25 13:59:18,9350,100,518466,100,9345,334,9350,87,S
2016-03-25 13:59:20,9350,200,518666,172,9345,341,9350,8,S
2016-03-25 13:59:20.5,9350,24,518690,-16,9350,6,9355,774,S
2016-03-25 13:59:21,9350,12,518702,-10,9345,341,9350,6,S
2016-03-25 13:59:21.5,9350,2,518704,2,9345,341,9350,14,S
2016-03-25 13:59:25,9350,2,518706,0,9345,342,9350,77,S
2016-03-25 13:59:26,9350,20,518726,0,9345,343,9350,74,S
2016-03-25 13:59:26.5,9350,2,518728,0,9345,343,9350,75,S
2016-03-25 13:59:28,9350,10,518738,10,9345,344,9350,84,S
2016-03-25 13:59:30,9350,10,518748,10,9345,342,9350,113,S
2016-03-25 13:59:31,9350,4,518752,0,9345,364,9350,111,S
2016-03-25 13:59:32,9350,14,518766,-14,9345,365,9350,104,S
2016-03-25 13:59:33,9350,4,518770,-2,9345,365,9350,110,S
2016-03-25 13:59:34,9345,50,518820,-40,9345,347,9350,134,S
2016-03-25 13:59:35,9345,10,518830,-10,9345,342,9350,158,S
2016-03-25 13:59:37,9345,44,518874,-42,9345,317,9350,406,S
2016-03-25 13:59:38,9345,2,518876,-2,9345,314,9350,406,S
2016-03-25 13:59:38.5,9345,20,518896,2,9345,244,9350,406,S
2016-03-25 13:59:39,9345,26,518922,-4,9345,231,9350,407,S
2016-03-25 13:59:40,9345,6,518928,-2,9345,228,9350,408,S
2016-03-25 13:59:42,9345,6,518934,-2,9345,228,9350,408,S
2016-03-25 13:59:42.5,9345,2,518936,-2,9345,227,9350,410,S
2016-03-25 13:59:43,9345,2,518938,0,9345,225,9350,414,S
2016-03-25 13:59:43.5,9345,2,518940,-2,9345,224,9350,414,S
2016-03-25 13:59:47,9345,2,518942,0,9345,278,9350,613,S
2016-03-25 13:59:49,9345,2,518944,0,9345,279,9350,618,S
2016-03-25 13:59:50,9345,20,518964,0,9345,269,9350,618,S
2016-03-25 13:59:51,9345,6,518970,2,9345,265,9350,619,S
2016-03-25 13:59:51.5,9345,2,518972,0,9345,264,9350,720,S
2016-03-25 13:59:53,9345,2,518974,0,9345,215,9350,710,S
2016-03-25 13:59:55,9345,6,518980,0,9345,212,9350,1006,S
2016-03-25 13:59:55.5,9345,22,519002,-12,9345,202,9350,1004,S
2016-03-25 13:59:56,9345,2,519004,-2,9345,201,9350,1011,S
2016-03-25 13:59:57,9345,2,519006,0,9345,201,9350,1011,S
2016-03-25 13:59:57.5,9345,34,519040,-12,9345,184,9350,1049,S
2016-03-25 13:59:58,9345,10,519050,0,9345,179,9350,1052,S
2016-03-25 13:59:58.5,9345,6,519056,2,9345,176,9350,1052,S
2016-03-25 13:59:59,9345,2,519058,0,9345,187,9350,1047,S
2016-03-25 13:59:59.5,9345,8,519066,8,9345,186,9350,1046,S
2016-03-25 14:00:00,9345,2,519068,0,9345,181,9350,1046,S
2016-03-25 14:00:00.5,9340,626,519694,-120,9340,490,9345,93,S
2016-03-25 14:00:01,9340,24,519718,-24,9340,477,9345,95,S
2016-03-25 14:00:01.5,9340,2,519720,-2,9340,487,9345,147,S
2016-03-25 14:00:02,9340,36,519756,-36,9340,465,9345,169,S
2016-03-25 14:00:02.5,9340,74,519830,-72,9340,425,9345,179,S
2016-03-25 14:00:03,9340,4,519834,-4,9340,423,9345,183,S
2016-03-25 14:00:04,9340,44,519878,-26,9340,401,9345,183,S
2016-03-25 14:00:04.5,9340,36,519914,-36,9340,383,9345,186,S
2016-03-25 14:00:07,9340,4,519918,-4,9340,381,9345,198,S
2016-03-25 14:00:07.5,9340,6,519924,-6,9340,377,9345,195,S
2016-03-25 14:00:08,9340,4,519928,0,9340,426,9345,195,S
2016-03-25 14:00:09,9345,4,519932,0,9340,428,9345,207,B
2016-03-25 14:00:12,9340,42,519974,-16,9340,396,9345,284,S
2016-03-25 14:00:12.5,9340,6,519980,0,9340,393,9345,286,S
2016-03-25 14:00:13,9340,2,519982,2,9340,391,9345,286,S
2016-03-25 14:00:14,9340,6,519988,0,9340,390,9345,375,S
2016-03-25 14:00:15,9340,2,519990,0,9340,394,9345,377,S
2016-03-25 14:00:15.5,9340,2,519992,0,9340,393,9345,376,S
2016-03-25 14:00:16,9340,4,519996,4,9340,391,9345,375,S
2016-03-25 14:00:18,9345,4,520000,0,9340,391,9345,373,B
2016-03-25 14:00:19,9340,16,520016,0,9340,383,9345,375,S
2016-03-25 14:00:19.5,9340,4,520020,4,9340,381,9345,381,S
2016-03-25 14:00:20,9340,2,520022,0,9340,380,9345,381,S
2016-03-25 14:00:20.5,9340,8,520030,0,9340,376,9345,381,S
2016-03-25 14:00:22,9345,18,520048,-2,9340,369,9345,373,B
2016-03-25 14:00:23,9345,2,520050,0,9340,369,9345,322,B
2016-03-25 14:00:23.5,9345,2,520052,0,9340,369,9345,321,B
2016-03-25 14:00:24,9340,2,520054,-2,9340,368,9345,321,S
2016-03-25 14:00:24.5,9345,642,520696,150,9345,89,9350,232,B
2016-03-25 14:00:25,9345,124,520820,120,9345,44,9350,227,B
2016-03-25 14:00:25.5,9345,18,520838,18,9345,448,9350,218,B
2016-03-25 14:00:27,9350,308,521146,-6,9345,559,9350,1,B
2016-03-25 14:00:27.5,9350,18,521164,4,9345,559,9355,1135,B
2016-03-25 14:00:29,9345,2,521166,2,9345,560,9350,219,S
2016-03-25 14:00:30,9350,20,521186,12,9345,760,9350,275,B
2016-03-25 14:00:31,9345,2,521188,2,9345,759,9350,320,S
2016-03-25 14:00:32,9350,178,521366,-28,9345,776,9350,330,B
2016-03-25 14:00:34,9350,2,521368,2,9345,879,9350,355,B
2016-03-25 14:00:36,9345,12,521380,0,9345,903,9350,339,S
2016-03-25 14:00:37,9345,22,521402,0,9345,893,9350,328,S
2016-03-25 14:00:37.5,9345,2,521404,2,9345,893,9350,330,S
2016-03-25 14:00:38,9345,4,521408,4,9345,891,9350,328,S
2016-03-25 14:00:38.5,9345,4,521412,4,9345,890,9350,330,S
2016-03-25 14:00:40,9345,46,521458,0,9345,874,9350,364,S
2016-03-25 14:00:42,9345,4,521462,2,9345,874,9350,366,S
2016-03-25 14:00:43,9345,46,521508,0,9345,851,9350,366,S
2016-03-25 14:00:44,9350,28,521536,22,9345,851,9350,353,B
2016-03-25 14:00:45,9345,400,521936,400,9345,662,9350,353,S
2016-03-25 14:00:45.5,9350,24,521960,-24,9345,762,9350,345,B
2016-03-25 14:00:47,9350,108,522068,-4,9345,833,9350,341,B
2016-03-25 14:00:49,9345,20,522088,20,9345,838,9350,342,S
2016-03-25 14:00:51,9350,4,522092,-4,9345,848,9350,260,B
2016-03-25 14:00:52,9350,2,522094,-2,9345,848,9350,259,B
2016-03-25 14:00:54,9350,2,522096,-2,9345,849,9350,258,B
2016-03-25 14:00:55,9350,2,522098,0,9345,850,9350,258,B
2016-03-25 14:00:55.5,9350,2,522100,0,9345,851,9350,287,B
2016-03-25 14:00:56,9350,28,522128,2,9345,850,9350,275,B
2016-03-25 14:01:00,9350,2,522130,0,9345,891,9350,251,B
2016-03-25 14:01:01,9350,2,522132,0,9345,890,9350,255,B
2016-03-25 14:01:02,9350,4,522136,-4,9345,894,9350,253,B
2016-03-25 14:01:02.5,9350,48,522184,-8,9345,894,9350,229,B
2016-03-25 14:01:03,9350,2,522186,-2,9345,904,9350,232,B
2016-03-25 14:01:04,9350,8,522194,-4,9345,933,9350,228,B
2016-03-25 14:01:05,9350,2,522196,0,9345,938,9350,233,B
2016-03-25 14:01:05.5,9350,2,522198,0,9345,938,9350,232,B
2016-03-25 14:01:06,9350,2,522200,-2,9345,940,9350,232,B
2016-03-25 14:01:07,9350,6,522206,-6,9345,930,9350,248,B
2016-03-25 14:01:08,9350,72,522278,-10,9345,941,9350,212,B
2016-03-25 14:01:09,9350,40,522318,-40,9345,946,9350,193,B
2016-03-25 14:01:10,9350,22,522340,-22,9345,946,9350,183,B
2016-03-25 14:01:11,9350,76,522416,-4,9345,983,9350,146,B
2016-03-25 14:01:11.5,9350,290,522706,122,9345,1012,9350,1,B
2016-03-25 14:01:12,9350,52,522758,28,9350,46,9355,1109,B
2016-03-25 14:01:12.5,9350,2,522760,2,9350,70,9355,1109,B
2016-03-25 14:01:13,9350,140,522900,-58,9345,1015,9350,37,B
2016-03-25 14:01:14,9350,16,522916,0,9345,1020,9350,251,B
2016-03-25 14:01:14.5,9350,6,522922,-4,9345,1020,9350,248,B
2016-03-25 14:01:16,9350,2,522924,-2,9345,1021,9350,249,B
2016-03-25 14:01:18,9350,2,522926,-2,9345,1021,9350,248,B
2016-03-25 14:01:20,9345,6,522932,0,9345,1019,9350,251,S
2016-03-25 14:01:21,9350,8,522940,-8,9345,1043,9350,248,B
2016-03-25 14:01:22,9350,4,522944,0,9345,1043,9350,246,B
2016-03-25 14:01:23,9350,16,522960,0,9345,1043,9350,252,B
2016-03-25 14:01:24,9350,20,522980,-20,9345,1058,9350,242,B
2016-03-25 14:01:24.5,9350,2,522982,2,9345,1058,9350,242,B
2016-03-25 14:01:25,9350,20,523002,0,9345,1058,9350,233,B
2016-03-25 14:01:28,9350,64,523066,40,9345,1058,9350,211,B
2016-03-25 14:01:29,9350,228,523294,-212,9345,1058,9350,97,B
2016-03-25 14:01:29.5,9350,196,523490,40,9350,26,9355,1022,B
2016-03-25 14:01:31,9350,130,523620,-64,9345,1058,9350,64,B
2016-03-25 14:01:33,9350,4,523624,-2,9345,1060,9350,63,B
2016-03-25 14:01:34,9350,116,523740,-20,9345,1060,9350,230,B
2016-03-25 14:01:36,9350,8,523748,0,9345,1057,9350,230,B
2016-03-25 14:01:36.5,9350,4,523752,4,9345,1057,9350,229,B
2016-03-25 14:01:37,9350,4,523756,2,9345,1058,9350,227,B
2016-03-25 14:01:37.5,9350,24,523780,0,9345,1058,9350,215,B
2016-03-25 14:01:38,9350,2,523782,2,9345,1058,9350,217,B
2016-03-25 14:01:40,9350,4,523786,4,9345,1058,9350,217,B
2016-03-25 14:01:40.5,9350,120,523906,120,9345,1058,9350,158,B
2016-03-25 14:01:41,9350,4,523910,2,9345,1057,9350,156,B
2016-03-25 14:01:41.5,9350,2,523912,0,9345,1065,9350,156,B
2016-03-25 14:01:42,9350,266,524178,230,9345,1066,9350,22,B
2016-03-25 14:01:42.5,9350,48,524226,-14,9350,11,9355,927,B
2016-03-25 14:01:44,9350,8,524234,-8,9350,206,9355,927,B
2016-03-25 14:01:46,9350,2,524236,0,9350,211,9355,926,B
2016-03-25 14:01:49,9350,58,524294,24,9345,287,9350,92,B
2016-03-25 14:01:49.5,9350,26,524320,10,9345,247,9350,81,B
2016-03-25 14:01:50,9350,2,524322,2,9345,226,9350,182,B
2016-03-25 14:01:50.3333,9350,12,524334,12,9345,148,9350,227,B
2016-03-25 14:01:50.6667,9350,2,524336,0,9345,148,9350,226,B
2016-03-25 14:01:51,9350,4,524340,0,9345,148,9350,225,B
2016-03-25 14:01:54,9345,2,524342,-2,9345,155,9350,226,S
2016-03-25 14:01:54.5,9350,12,524354,-8,9345,156,9350,220,B
2016-03-25 14:01:55,9345,2,524356,-2,9345,155,9350,214,S
2016-03-25 14:01:56,9350,30,524386,0,9345,151,9350,196,B
2016-03-25 14:01:57,9345,2,524388,-2,9345,186,9350,238,S
2016-03-25 14:01:58,9350,42,524430,2,9345,188,9350,318,B
2016-03-25 14:01:59,9345,4,524434,0,9345,207,9350,321,S
2016-03-25 14:02:00,9345,4,524438,2,9345,210,9350,321,S
2016-03-25 14:02:03,9345,444,524882,134,9340,631,9350,702,S
2016-03-25 14:02:03.5,9345,76,524958,10,9340,627,9350,703,S
2016-03-25 14:02:04,9345,16,524974,-16,9340,629,9350,713,S
2016-03-25 14:02:04.5,9340,24,524998,-20,9340,628,9345,6,S
2016-03-25 14:02:05,9345,26,525024,-18,9340,618,9345,229,B
2016-03-25 14:02:05.5,9345,2,525026,0,9340,619,9345,230,B
2016-03-25 14:02:06,9345,62,525088,-20,9340,619,9345,200,B
2016-03-25 14:02:07,9345,4,525092,2,9340,619,9345,201,B
2016-03-25 14:02:08,9345,44,525136,0,9340,623,9345,180,B
2016-03-25 14:02:09,9345,372,525508,-14,9345,52,9350,705,B
2016-03-25 14:02:09.5,9345,104,525612,-102,9340,621,9345,95,B
2016-03-25 14:02:10,9345,2,525614,-2,9340,621,9345,95,B
2016-03-25 14:02:11,9345,4,525618,-2,9340,617,9345,95,B
2016-03-25 14:02:11.5,9340,4,525622,0,9340,595,9345,95,S
2016-03-25 14:02:13,9345,44,525666,-44,9340,595,9345,148,B
2016-03-25 14:02:14,9340,12,525678,-12,9340,595,9345,143,S
2016-03-25 14:02:14.5,9340,100,525778,4,9340,544,9345,194,S
2016-03-25 14:02:16,9340,12,525790,-8,9340,542,9345,176,S
2016-03-25 14:02:16.5,9345,20,525810,0,9340,543,9345,166,B
2016-03-25 14:02:17,9345,2,525812,0,9340,543,9345,165,B
2016-03-25 14:02:19,9340,2,525814,2,9340,541,9345,169,S
2016-03-25 14:02:20,9340,2,525816,2,9340,542,9345,169,S
2016-03-25 14:02:21,9340,4,525820,4,9340,558,9345,169,S
2016-03-25 14:02:21.5,9345,2,525822,0,9340,559,9345,168,B
2016-03-25 14:02:22,9345,8,525830,-8,9340,560,9345,164,B
2016-03-25 14:02:22.5,9340,16,525846,0,9340,551,9345,165,S
2016-03-25 14:02:25,9340,6,525852,0,9340,518,9345,156,S
2016-03-25 14:02:26,9340,1042,526894,728,9335,742,9340,68,S
2016-03-25 14:02:26.5,9345,190,527084,-158,9335,734,9345,196,B
2016-03-25 14:02:27,9340,26,527110,0,9340,3,9345,197,S
2016-03-25 14:02:27.5,9340,6,527116,-6,9335,731,9340,30,S
2016-03-25 14:02:28,9335,42,527158,-20,9335,730,9340,16,S
2016-03-25 14:02:28.5,9340,16,527174,4,9335,732,9340,46,B
2016-03-25 14:02:29,9340,2,527176,0,9335,729,9340,55,B
2016-03-25 14:02:30,9340,4,527180,0,9335,727,9340,64,B
2016-03-25 14:02:30.5,9335,2,527182,2,9335,787,9340,65,S
2016-03-25 14:02:31,9340,4,527186,2,9335,752,9340,63,B
2016-03-25 14:02:31.5,9340,4,527190,4,9335,762,9340,61,B
2016-03-25 14:02:32,9335,2,527192,0,9335,760,9340,61,S
2016-03-25 14:02:32.5,9340,2,527194,2,9335,764,9340,60,B
2016-03-25 14:02:33,9340,4,527198,4,9335,765,9340,58,B
2016-03-25 14:02:34,9335,2,527200,2,9335,660,9340,88,S
2016-03-25 14:02:34.5,9340,4,527204,0,9335,517,9340,124,B
2016-03-25 14:02:35,9335,234,527438,-134,9335,353,9340,176,S
2016-03-25 14:02:35.5,9335,716,528154,176,9330,713,9335,257,S
2016-03-25 14:02:36,9335,30,528184,20,9330,635,9335,301,S
2016-03-25 14:02:36.5,9330,110,528294,8,9330,444,9335,300,S
2016-03-25 14:02:37,9335,164,528458,94,9330,352,9335,289,B
2016-03-25 14:02:37.5,9330,220,528678,-90,9330,100,9335,287,S
2016-03-25 14:02:38,9330,196,528874,164,9325,727,9330,124,S
2016-03-25 14:02:38.5,9325,12,528886,0,9325,726,9330,142,S
2016-03-25 14:02:39,9330,936,529822,-554,9325,694,9330,5,B
2016-03-25 14:02:39.5,9330,66,529888,-10,9330,81,9335,350,B
2016-03-25 14:02:40,9330,30,529918,-22,9330,73,9335,330,B
2016-03-25 14:02:40.5,9330,30,529948,-2,9330,78,9335,370,B
2016-03-25 14:02:41,9330,156,530104,12,9325,719,9330,234,B
2016-03-25 14:02:41.5,9330,22,530126,22,9325,670,9330,233,B
2016-03-25 14:02:42,9325,4,530130,4,9325,476,9330,236,S
2016-03-25 14:02:42.5,9325,12,530142,6,9325,470,9330,240,S
2016-03-25 14:02:43,9330,306,530448,-164,9325,244,9330,321,B
2016-03-25 14:02:43.5,9325,28,530476,22,9325,266,9330,355,S
2016-03-25 14:02:44,9325,464,530940,192,9320,492,9330,368,S
2016-03-25 14:02:44.5,9325,32,530972,22,9320,635,9325,59,S
2016-03-25 14:02:45,9320,44,531016,18,9320,589,9325,51,S
2016-03-25 14:02:45.5,9320,496,531512,-284,9320,301,9325,192,S
2016-03-25 14:02:46,9320,378,531890,-6,9320,137,9325,253,S
2016-03-25 14:02:46.5,9320,6,531896,-6,9320,131,9325,254,S
2016-03-25 14:02:47,9325,24,531920,4,9320,123,9325,263,B
2016-03-25 14:02:47.5,9320,246,532166,-32,9320,38,9325,285,S
2016-03-25 14:02:48,9320,46,532212,0,9320,17,9325,269,S
2016-03-25 14:02:48.5,9320,66,532278,14,9320,79,9325,258,S
2016-03-25 14:02:49,9320,74,532352,-30,9320,95,9325,258,S
2016-03-25 14:02:49.5,9325,202,532554,116,9320,13,9325,249,B
2016-03-25 14:02:50,9320,50,532604,6,9315,375,9325,248,S
2016-03-25 14:02:50.5,9320,70,532674,10,9320,52,9325,253,S
2016-03-25 14:02:51,9320,86,532760,-34,9320,25,9325,267,S
2016-03-25 14:02:51.5,9320,14,532774,-6,9320,9,9325,463,S
2016-03-25 14:02:52,9320,48,532822,12,9315,355,9320,5,S
2016-03-25 14:02:52.5,9320,50,532872,6,9315,343,9320,71,S
2016-03-25 14:02:53,9320,96,532968,-6,9315,377,9320,25,S
2016-03-25 14:02:53.5,9320,70,533038,48,9320,71,9325,802,S
2016-03-25 14:02:54,9320,30,533068,20,9320,56,9325,848,S
2016-03-25 14:02:54.5,9320,90,533158,8,9320,39,9325,857,S
2016-03-25 14:02:55,9325,128,533286,-12,9320,10,9325,827,B
2016-03-25 14:02:55.5,9320,10,533296,10,9320,11,9325,837,S
2016-03-25 14:02:56,9325,4,533300,2,9320,23,9325,801,B
2016-03-25 14:02:56.5,9320,14,533314,2,9320,28,9325,859,S
2016-03-25 14:02:57,9320,62,533376,14,9320,8,9325,874,S
2016-03-25 14:02:57.5,9320,124,533500,-124,9315,392,9320,33,S
2016-03-25 14:02:58,9320,22,533522,-2,9315,383,9320,34,S
2016-03-25 14:02:58.5,9320,170,533692,74,9320,16,9325,364,S
2016-03-25 14:02:59,9320,48,533740,14,9320,36,9325,267,S
2016-03-25 14:02:59.5,9320,24,533764,12,9320,24,9325,284,S
2016-03-25 14:03:00,9320,6,533770,0,9320,52,9325,249,S
2016-03-25 14:03:01,9325,30,533800,-18,9320,77,9325,296,B
2016-03-25 14:03:01.5,9320,18,533818,0,9320,68,9325,228,S
2016-03-25 14:03:02,9320,144,533962,72,9315,407,9320,159,S
2016-03-25 14:03:02.5,9320,130,534092,38,9315,361,9320,97,S
2016-03-25 14:03:03,9320,216,534308,-46,9320,382,9325,267,S
2016-03-25 14:03:03.5,9320,50,534358,-48,9320,410,9325,293,S
2016-03-25 14:03:04,9320,8,534366,-6,9320,407,9325,286,S
2016-03-25 14:03:05,9320,2,534368,0,9320,451,9325,233,S
2016-03-25 14:03:05.5,9325,2,534370,-2,9320,451,9325,236,B
2016-03-25 14:03:06,9325,106,534476,-48,9320,453,9325,182,B
2016-03-25 14:03:06.5,9320,6,534482,0,9320,461,9325,182,S
2016-03-25 14:03:07,9320,90,534572,-70,9320,463,9325,144,S
2016-03-25 14:03:08,9325,330,534902,106,9325,53,9330,272,B
2016-03-25 14:03:08.5,9325,44,534946,24,9325,37,9330,274,B
2016-03-25 14:03:10,9325,8,534954,0,9325,133,9330,192,B
2016-03-25 14:03:10.5,9330,2,534956,2,9325,144,9330,189,B
2016-03-25 14:03:11,9325,2,534958,2,9325,339,9330,189,S
2016-03-25 14:03:12,9325,2,534960,0,9325,339,9330,133,S
2016-03-25 14:03:12.5,9325,10,534970,0,9325,335,9330,134,S
2016-03-25 14:03:13,9330,66,535036,-14,9325,437,9330,101,B
2016-03-25 14:03:13.5,9325,6,535042,4,9325,435,9330,98,S
2016-03-25 14:03:14,9330,162,535204,-128,9325,464,9330,31,B
2016-03-25 14:03:15,9330,62,535266,-58,9330,2,9335,224,B
2016-03-25 14:03:15.5,9330,122,535388,-122,9325,466,9330,40,B
2016-03-25 14:03:16,9330,348,535736,-238,9325,478,9330,103,B
2016-03-25 14:03:16.5,9330,204,535940,-122,9330,5,9335,241,B
2016-03-25 14:03:17,9330,18,535958,-2,9330,46,9335,171,B
2016-03-25 14:03:17.5,9330,4,535962,-4,9330,55,9335,224,B
2016-03-25 14:03:18,9330,12,535974,0,9330,281,9335,225,B
2016-03-25 14:03:18.5,9330,6,535980,0,9330,563,9335,198,B
2016-03-25 14:03:19,9335,344,536324,-78,9335,253,9340,434,B
2016-03-25 14:03:20,9335,322,536646,0,9335,72,9340,335,B
2016-03-25 14:03:20.5,9335,10,536656,0,9335,68,9340,345,B
2016-03-25 14:03:21,9335,10,536666,-6,9335,57,9340,427,B
2016-03-25 14:03:21.5,9335,2,536668,0,9335,56,9340,428,B
2016-03-25 14:03:22,9335,172,536840,-106,9330,139,9335,167,B
2016-03-25 14:03:24,9335,20,536860,-4,9330,56,9335,177,B
2016-03-25 14:03:24.5,9330,4,536864,0,9330,54,9335,178,S
2016-03-25 14:03:25,9330,76,536940,14,9330,22,9335,471,S
2016-03-25 14:03:26,9330,126,537066,-22,9325,283,9330,192,S
2016-03-25 14:03:27,9330,4,537070,0,9325,234,9330,243,S
2016-03-25 14:03:27.5,9325,2,537072,0,9325,142,9330,651,S
2016-03-25 14:03:28,9325,64,537136,-4,9325,49,9330,681,S
2016-03-25 14:03:28.5,9325,30,537166,6,9325,25,9330,692,S
2016-03-25 14:03:29,9325,50,537216,14,9320,222,9325,257,S
2016-03-25 14:03:30,9320,116,537332,-62,9320,154,9325,654,S
2016-03-25 14:03:31,9320,310,537642,-32,9315,395,9320,87,S
2016-03-25 14:03:31.5,9320,2,537644,2,9315,380,9320,97,S
2016-03-25 14:03:32,9315,1126,538770,486,9310,911,9315,40,S
2016-03-25 14:03:33,9315,306,539076,16,9310,884,9315,15,S
2016-03-25 14:03:33.5,9315,114,539190,-48,9310,810,9315,62,S
2016-03-25 14:03:34,9315,148,539338,98,9315,150,9320,226,S
2016-03-25 14:03:34.5,9315,84,539422,82,9315,159,9320,205,S
2016-03-25 14:03:35,9315,52,539474,0,9315,287,9320,321,S
2016-03-25 14:03:35.5,9320,12,539486,12,9315,369,9320,319,B
2016-03-25 14:03:36,9315,4,539490,0,9315,368,9320,553,S
2016-03-25 14:03:36.5,9315,12,539502,0,9315,363,9320,554,S
2016-03-25 14:03:37,9315,2,539504,2,9315,362,9320,567,S
2016-03-25 14:03:38,9315,22,539526,22,9315,333,9320,867,S
2016-03-25 14:03:38.5,9315,46,539572,6,9315,313,9320,882,S
2016-03-25 14:03:39,9315,680,540252,580,9310,706,9315,171,S
2016-03-25 14:03:39.5,9315,26,540278,2,9310,728,9315,159,S
2016-03-25 14:03:40,9315,14,540292,0,9310,657,9315,164,S
2016-03-25 14:03:40.5,9315,476,540768,342,9315,213,9320,65,S
2016-03-25 14:03:41,9320,126,540894,-92,9320,87,9325,71,B
2016-03-25 14:03:41.5,9320,98,540992,-70,9320,326,9325,21,B
2016-03-25 14:03:42,9320,58,541050,26,9320,314,9325,108,B
2016-03-25 14:03:42.5,9325,152,541202,-54,9320,614,9325,64,B
2016-03-25 14:03:43,9325,132,541334,-102,9325,86,9330,89,B
2016-03-25 14:03:43.5,9325,28,541362,28,9325,165,9330,5,B
2016-03-25 14:03:44,9330,232,541594,-54,9330,2,9335,387,B
2016-03-25 14:03:44.5,9330,20,541614,0,9330,44,9335,379,B
2016-03-25 14:03:45,9330,130,541744,-96,9325,169,9330,128,B
2016-03-25 14:03:45.5,9330,2,541746,-2,9325,170,9330,129,B
2016-03-25 14:03:46,9325,6,541752,-2,9325,400,9330,136,S
2016-03-25 14:03:47,9325,2,541754,2,9325,640,9330,138,S
2016-03-25 14:03:48,9325,200,541954,-122,9325,512,9330,250,S
2016-03-25 14:03:49,9325,6,541960,0,9325,626,9330,266,S
2016-03-25 14:03:50,9330,2,541962,-2,9325,626,9330,477,B
2016-03-25 14:03:50.5,9325,88,542050,-32,9320,179,9325,326,S
2016-03-25 14:03:52,9315,996,543046,330,9310,716,9315,9,S
2016-03-25 14:03:52.5,9315,34,543080,-22,9310,685,9315,5,S
2016-03-25 14:03:53,9315,8,543088,0,9315,226,9320,141,S
2016-03-25 14:03:54,9320,6,543094,4,9315,715,9320,60,B
2016-03-25 14:03:54.5,9320,52,543146,-36,9315,820,9320,24,B
2016-03-25 14:03:55,9320,46,543192,-42,9315,1123,9325,415,B
2016-03-25 14:03:56,9315,44,543236,4,9315,1112,9320,11,S
2016-03-25 14:03:56.5,9320,36,543272,-6,9320,50,9325,425,B
2016-03-25 14:03:57,9325,2,543274,-2,9320,51,9325,458,B
2016-03-25 14:03:57.3333,9320,4,543278,-2,9320,154,9325,460,S
2016-03-25 14:03:57.6667,9320,24,543302,0,9320,143,9325,461,S
2016-03-25 14:03:58,9320,6,543308,0,9320,372,9325,475,S
2016-03-25 14:03:59,9320,10,543318,-2,9320,805,9325,383,S
2016-03-25 14:04:00,9320,2,543320,-2,9320,804,9325,382,S
2016-03-25 14:04:00.3333,9325,16,543336,-14,9320,802,9325,379,B
2016-03-25 14:04:00.6667,9325,2,543338,-2,9320,803,9325,379,B
2016-03-25 14:04:01,9325,50,543388,-10,9320,808,9325,354,B
2016-03-25 14:04:02,9325,2,543390,-2,9320,818,9325,357,B
2016-03-25 14:04:02.5,9325,112,543502,-104,9320,816,9325,304,B
2016-03-25 14:04:03,9325,40,543542,0,9320,968,9325,284,B
2016-03-25 14:04:04,9325,4,543546,-4,9320,974,9325,278,B
2016-03-25 14:04:04.5,9325,42,543588,-42,9320,974,9325,263,B
2016-03-25 14:04:05,9320,642,544230,304,9320,635,9325,292,S
2016-03-25 14:04:06,9325,16,544246,8,9320,651,9325,291,B
2016-03-25 14:04:06.5,9325,120,544366,-10,9320,732,9325,232,B
2016-03-25 14:04:07,9325,6,544372,-6,9320,731,9325,230,B
2016-03-25 14:04:07.5,9325,8,544380,0,9320,798,9325,226,B
2016-03-25 14:04:08,9325,2,544382,0,9320,749,9325,225,B
2016-03-25 14:04:08.5,9325,44,544426,-4,9320,750,9325,153,B
2016-03-25 14:04:09,9325,192,544618,-4,9320,800,9325,59,B
2016-03-25 14:04:09.5,9325,114,544732,-80,9320,800,9330,392,B
2016-03-25 14:04:10,9330,76,544808,16,9325,46,9330,436,B
2016-03-25 14:04:10.5,9325,10,544818,10,9325,47,9330,433,S
2016-03-25 14:04:11,9325,94,544912,-66,9320,836,9325,148,S
2016-03-25 14:04:12,9320,20,544932,20,9320,949,9325,161,S
2016-03-25 14:04:12.5,9325,2,544934,-2,9320,949,9325,161,B
2016-03-25 14:04:13,9325,2,544936,-2,9320,949,9325,158,B
2016-03-25 14:04:15,9320,2,544938,2,9320,958,9325,198,S
2016-03-25 14:04:16,9320,248,545186,-152,9315,735,9320,31,S
2016-03-25 14:04:17,9315,4,545190,-4,9315,581,9320,142,S
2016-03-25 14:04:18,9320,104,545294,6,9315,583,9320,99,B
2016-03-25 14:04:18.5,9315,8,545302,4,9315,525,9320,108,S
2016-03-25 14:04:19,9320,4,545306,4,9315,526,9320,121,B
2016-03-25 14:04:19.5,9320,22,545328,-18,9315,528,9320,130,B
2016-03-25 14:04:20,9320,4,545332,0,9315,528,9320,129,B
2016-03-25 14:04:21,9320,16,545348,-2,9315,504,9320,122,B
2016-03-25 14:04:22,9315,170,545518,134,9315,441,9320,35,S
2016-03-25 14:04:23,9320,14,545532,0,9315,441,9320,18,B
2016-03-25 14:04:24,9325,42,545574,-8,9320,1,9325,443,B
2016-03-25 14:04:25,9325,6,545580,6,9320,207,9325,380,B
2016-03-25 14:04:25.5,9320,250,545830,-240,9320,86,9325,653,S
2016-03-25 14:04:26,9320,172,546002,-118,9315,518,9320,28,S
2016-03-25 14:04:26.5,9320,20,546022,0,9315,601,9320,7,S
2016-03-25 14:04:27,9320,16,546038,0,9320,6,9325,654,S
2016-03-25 14:04:29,9320,2,546040,-2,9320,120,9325,760,S
2016-03-25 14:04:29.5,9320,40,546080,0,9320,102,9325,760,S
2016-03-25 14:04:30,9320,22,546102,8,9320,91,9325,759,S
2016-03-25 14:04:30.5,9320,4,546106,4,9320,95,9325,759,S
2016-03-25 14:04:31,9320,2,546108,0,9320,111,9325,759,S
2016-03-25 14:04:32,9320,2,546110,2,9320,110,9325,790,S
2016-03-25 14:04:32.5,9320,4,546114,0,9320,108,9325,790,S
2016-03-25 14:04:33,9320,6,546120,4,9320,110,9325,791,S
2016-03-25 14:04:34,9320,2,546122,0,9320,119,9325,822,S
2016-03-25 14:04:36,9320,100,546222,0,9320,84,9325,822,S
2016-03-25 14:04:37,9320,206,546428,98,9315,440,9320,119,S
2016-03-25 14:04:37.5,9320,2,546430,0,9315,359,9320,123,S
2016-03-25 14:04:38,9320,20,546450,20,9315,359,9320,118,S
2016-03-25 14:04:39,9320,236,546686,-2,9320,86,9325,865,S
2016-03-25 14:04:40,9320,172,546858,-66,9315,363,9320,40,S
2016-03-25 14:04:40.5,9320,2,546860,-2,9315,385,9320,40,S
2016-03-25 14:04:42,9320,54,546914,-12,9320,312,9325,212,S
2016-03-25 14:04:42.5,9320,130,547044,-16,9320,247,9325,200,S
2016-03-25 14:04:44,9320,2,547046,0,9320,250,9325,227,S
2016-03-25 14:04:44.5,9320,2,547048,2,9320,249,9325,211,S
2016-03-25 14:04:45,9320,2,547050,0,9320,249,9325,212,S
2016-03-25 14:04:45.5,9320,18,547068,0,9320,240,9325,250,S
2016-03-25 14:04:49,9320,546,547614,24,9315,400,9320,112,S
2016-03-25 14:04:50,9320,30,547644,8,9315,327,9320,184,S
2016-03-25 14:04:52,9320,308,547952,200,9320,178,9325,281,S
2016-03-25 14:04:52.5,9320,2,547954,2,9320,179,9325,257,S
2016-03-25 14:04:53,9320,10,547964,0,9320,175,9325,257,S
2016-03-25 14:04:55,9320,4,547968,2,9320,280,9325,262,S
2016-03-25 14:04:56,9325,12,547980,2,9320,303,9325,268,B
2016-03-25 14:04:56.5,9325,4,547984,-2,9320,463,9325,269,B
2016-03-25 14:04:57,9320,30,548014,0,9320,499,9325,270,S
2016-03-25 14:04:58,9320,2,548016,0,9320,499,9325,270,S
2016-03-25 14:04:58.5,9325,6,548022,-6,9320,500,9325,276,B
2016-03-25 14:04:59,9320,50,548072,22,9320,475,9325,256,S
2016-03-25 14:05:00,9320,2,548074,0,9320,475,9325,256,S
2016-03-25 14:05:00.5,9320,4,548078,0,9320,473,9325,256,S
2016-03-25 14:05:01,9320,26,548104,8,9320,563,9325,283,S
2016-03-25 14:05:01.5,9325,6,548110,2,9320,563,9325,282,B
2016-03-25 14:05:02,9320,18,548128,0,9320,504,9325,274,S
2016-03-25 14:05:02.5,9320,74,548202,0,9320,471,9325,273,S
2016-03-25 14:05:03,9320,2,548204,0,9320,470,9325,272,S
2016-03-25 14:05:03.5,9320,68,548272,4,9320,438,9325,238,S
2016-03-25 14:05:04,9320,10,548282,0,9320,433,9325,243,S
2016-03-25 14:05:04.5,9320,4,548286,0,9320,533,9325,241,S
2016-03-25 14:05:05,9325,12,548298,12,9320,539,9325,200,B
2016-03-25 14:05:05.5,9320,2,548300,0,9320,730,9325,200,S
2016-03-25 14:05:06,9320,12,548312,10,9320,724,9325,199,S
2016-03-25 14:05:06.5,9325,244,548556,-18,9320,721,9325,77,B
2016-03-25 14:05:07,9325,182,548738,-68,9325,189,9330,485,B
2016-03-25 14:05:08,9325,402,549140,-108,9320,752,9325,107,B
2016-03-25 14:05:09,9325,2,549142,-2,9320,723,9325,287,B
2016-03-25 14:05:09.5,9325,2,549144,0,9320,722,9325,336,B
2016-03-25 14:05:10,9325,6,549150,-6,9320,722,9325,217,B
2016-03-25 14:05:11,9325,4,549154,-4,9320,831,9325,168,B
2016-03-25 14:05:12,9320,84,549238,-60,9320,825,9325,169,S
2016-03-25 14:05:13,9325,112,549350,14,9320,773,9325,178,B
2016-03-25 14:05:13.3333,9325,68,549418,4,9320,782,9325,146,B
2016-03-25 14:05:13.6667,9325,6,549424,-6,9320,883,9325,143,B
2016-03-25 14:05:15,9320,4,549428,0,9320,883,9325,227,S
2016-03-25 14:05:15.5,9325,2,549430,0,9320,884,9325,226,B
2016-03-25 14:05:16,9320,8,549438,0,9320,885,9325,185,S
2016-03-25 14:05:17,9320,6,549444,0,9320,882,9325,185,S
2016-03-25 14:05:17.5,9325,4,549448,0,9320,882,9325,184,B
2016-03-25 14:05:18,9325,150,549598,-146,9320,882,9325,109,B
2016-03-25 14:05:19,9325,216,549814,-78,9325,92,9330,580,B
2016-03-25 14:05:20,9325,298,550112,-174,9320,488,9325,13,B
2016-03-25 14:05:21,9320,16,550128,-16,9320,481,9325,24,S
2016-03-25 14:05:21.3333,9325,152,550280,110,9320,483,9325,18,B
2016-03-25 14:05:21.6667,9325,8,550288,0,9320,484,9325,94,B
2016-03-25 14:05:23,9320,46,550334,-46,9320,451,9325,96,S
2016-03-25 14:05:23.5,9325,192,550526,-136,9325,119,9330,823,B
2016-03-25 14:05:25,9325,118,550644,-2,9325,83,9330,844,B
2016-03-25 14:05:25.5,9325,4,550648,0,9325,81,9330,844,B
2016-03-25 14:05:26,9325,130,550778,-28,9325,16,9330,1175,B
2016-03-25 14:05:26.5,9325,64,550842,-14,9320,464,9325,5,B
2016-03-25 14:05:28,9325,2,550844,0,9320,466,9325,38,B
2016-03-25 14:05:29,9325,88,550932,-74,9325,159,9330,1189,B
2016-03-25 14:05:29.5,9325,2,550934,-2,9325,158,9330,1189,B
2016-03-25 14:05:30,9325,2,550936,0,9325,222,9330,1188,B
2016-03-25 14:05:32,9325,2,550938,-2,9325,225,9330,1173,B
2016-03-25 14:05:33,9325,8,550946,-8,9325,229,9330,1168,B
2016-03-25 14:05:36,9330,864,551810,268,9330,231,9335,505,B
2016-03-25 14:05:36.5,9330,2,551812,0,9330,202,9335,429,B
2016-03-25 14:05:37,9335,2,551814,0,9330,638,9335,272,B
2016-03-25 14:05:37.5,9330,104,551918,-92,9330,587,9335,243,S
2016-03-25 14:05:38,9335,30,551948,10,9330,582,9335,234,B
2016-03-25 14:05:38.5,9335,492,552440,150,9335,55,9340,665,B
2016-03-25 14:05:39,9335,20,552460,20,9335,351,9340,625,B
2016-03-25 14:05:39.5,9335,2,552462,2,9335,454,9340,625,B
2016-03-25 14:05:40,9335,2,552464,2,9335,453,9340,625,B
2016-03-25 14:05:41,9335,22,552486,-16,9330,177,9335,299,B
2016-03-25 14:05:41.5,9335,6,552492,0,9330,177,9335,372,B
2016-03-25 14:05:42,9335,2,552494,0,9330,172,9335,381,B
2016-03-25 14:05:43,9330,40,552534,0,9330,116,9335,722,S
2016-03-25 14:05:44,9330,4,552538,0,9330,117,9335,723,S
2016-03-25 14:05:44.5,9335,2,552540,0,9330,117,9335,732,B
2016-03-25 14:05:45,9330,10,552550,10,9330,122,9335,737,S
2016-03-25 14:05:46,9335,2,552552,-2,9330,122,9335,737,B
2016-03-25 14:05:46.5,9330,2,552554,0,9330,121,9335,739,S
2016-03-25 14:05:47,9335,12,552566,-4,9330,124,9335,677,B
2016-03-25 14:05:48,9330,2,552568,0,9330,123,9335,677,S
2016-03-25 14:05:49,9330,2,552570,0,9330,142,9335,674,S
2016-03-25 14:05:50,9330,2,552572,0,9330,146,9335,679,S
2016-03-25 14:05:50.5,9330,100,552672,100,9330,197,9335,681,S
2016-03-25 14:05:51,9330,4,552676,4,9330,191,9335,671,S
2016-03-25 14:05:52,9335,2,552678,-2,9330,294,9335,668,B
2016-03-25 14:05:52.5,9330,10,552688,0,9330,295,9335,668,S
2016-03-25 14:05:53,9330,6,552694,2,9330,518,9335,650,S
2016-03-25 14:05:54,9335,100,552794,-100,9330,578,9335,599,B
2016-03-25 14:05:55,9330,40,552834,40,9330,558,9335,577,S
2016-03-25 14:05:56,9335,2,552836,-2,9330,558,9335,574,B
2016-03-25 14:05:56.5,9335,20,552856,-20,9330,559,9335,531,B
2016-03-25 14:05:57,9335,360,553216,0,9330,559,9335,352,B
2016-03-25 14:05:57.5,9330,4,553220,4,9330,560,9335,301,S
2016-03-25 14:05:58,9330,10,553230,0,9330,558,9335,299,S
2016-03-25 14:05:58.3333,9335,8,553238,0,9330,558,9335,310,B
2016-03-25 14:05:58.6667,9335,4,553242,-4,9330,563,9335,319,B
2016-03-25 14:05:59,9335,2,553244,-2,9330,563,9335,320,B
2016-03-25 14:06:00,9335,8,553252,0,9330,564,9335,317,B
2016-03-25 14:06:01,9335,10,553262,-10,9330,564,9335,319,B
2016-03-25 14:06:01.3333,9335,2,553264,0,9330,564,9335,318,B
2016-03-25 14:06:01.6667,9335,2,553266,-2,9330,564,9335,317,B
2016-03-25 14:06:03,9330,548,553814,322,9330,240,9335,388,S
2016-03-25 14:06:04,9330,490,554304,460,9330,186,9335,474,S
2016-03-25 14:06:04.5,9330,98,554402,56,9330,138,9335,542,S
2016-03-25 14:06:05,9330,6,554408,0,9330,365,9335,552,S
2016-03-25 14:06:05.5,9330,2,554410,2,9330,365,9335,543,S
2016-03-25 14:06:06,9330,8,554418,6,9330,661,9335,562,S
2016-03-25 14:06:07,9330,4,554422,2,9330,659,9335,583,S
2016-03-25 14:06:08,9330,2,554424,0,9330,660,9335,587,S
2016-03-25 14:06:08.5,9330,126,554550,0,9330,607,9335,511,S
2016-03-25 14:06:09,9330,24,554574,22,9330,596,9335,514,S
2016-03-25 14:06:09.5,9330,2,554576,0,9330,595,9335,515,S
2016-03-25 14:06:10,9330,28,554604,28,9330,581,9335,523,S
2016-03-25 14:06:10.5,9330,140,554744,-2,9330,511,9335,545,S
2016-03-25 14:06:11,9330,100,554844,100,9330,461,9335,556,S
2016-03-25 14:06:11.5,9330,6,554850,6,9330,458,9335,614,S
2016-03-25 14:06:12,9330,6,554856,6,9330,455,9335,604,S
2016-03-25 14:06:12.5,9330,10,554866,10,9330,17,9335,379,S
2016-03-25 14:06:13,9330,28,554894,22,9325,308,9330,826,S
2016-03-25 14:06:13.5,9325,2,554896,-2,9325,297,9330,580,S
2016-03-25 14:06:14,9325,2,554898,-2,9325,296,9330,593,S
2016-03-25 14:06:14.5,9325,596,555494,-398,9320,567,9325,2,S
2016-03-25 14:06:15,9320,52,555546,4,9320,556,9325,5,S
2016-03-25 14:06:15.5,9325,36,555582,-14,9325,84,9330,645,B
2016-03-25 14:06:16,9325,1166,556748,246,9320,37,9325,49,B
2016-03-25 14:06:16.5,9320,6,556754,6,9320,52,9325,98,S
2016-03-25 14:06:17,9320,12,556766,0,9320,61,9325,107,S
2016-03-25 14:06:18,9320,126,556892,-64,9315,503,9320,134,S
2016-03-25 14:06:19,9320,20,556912,-20,9315,438,9320,156,S
2016-03-25 14:06:20,9315,4,556916,0,9315,450,9320,199,S
2016-03-25 14:06:20.5,9315,90,557006,-80,9315,446,9320,171,S
2016-03-25 14:06:21,9320,18,557024,-6,9315,444,9320,165,B
2016-03-25 14:06:21.5,9315,204,557228,-2,9315,268,9320,168,S
2016-03-25 14:06:22,9315,4,557232,0,9315,266,9320,172,S
2016-03-25 14:06:24,9315,6,557238,0,9315,258,9320,182,S
2016-03-25 14:06:25,9320,2,557240,0,9315,259,9320,182,B
2016-03-25 14:06:25.5,9320,2,557242,0,9315,259,9320,216,B
2016-03-25 14:06:26,9315,4,557246,0,9315,247,9320,216,S
2016-03-25 14:06:27,9315,2,557248,-2,9315,253,9320,217,S
2016-03-25 14:06:27.5,9315,8,557256,-8,9315,249,9320,218,S
2016-03-25 14:06:28,9315,580,557836,-438,9315,28,9320,299,S
2016-03-25 14:06:28.5,9315,32,557868,22,9315,15,9320,299,S
2016-03-25 14:06:29,9315,98,557966,-16,9315,186,9320,315,S
2016-03-25 14:06:30,9315,86,558052,-80,9315,194,9320,271,S
2016-03-25 14:06:31,9315,100,558152,-20,9315,110,9320,270,S
2016-03-25 14:06:32,9315,34,558186,-20,9315,285,9320,242,S
2016-03-25 14:06:33,9315,4,558190,0,9315,283,9320,251,S
2016-03-25 14:06:34,9315,400,558590,212,9315,57,9320,336,S
2016-03-25 14:06:34.5,9315,8,558598,4,9315,63,9320,335,S
2016-03-25 14:06:35,9315,12,558610,4,9315,67,9320,334,S
2016-03-25 14:06:35.5,9315,40,558650,24,9315,54,9320,333,S
2016-03-25 14:06:37,9315,64,558714,2,9315,106,9320,224,S
2016-03-25 14:06:37.5,9315,32,558746,-10,9315,103,9320,224,S
2016-03-25 14:06:39,9315,6,558752,0,9315,249,9320,204,S
2016-03-25 14:06:40,9315,6,558758,-6,9315,253,9320,203,S
2016-03-25 14:06:40.5,9320,416,559174,-190,9320,22,9325,384,B
2016-03-25 14:06:41,9320,2,559176,0,9320,31,9325,384,B
2016-03-25 14:06:41.5,9320,74,559250,-68,9315,507,9320,64,B
2016-03-25 14:06:42,9315,40,559290,16,9315,486,9320,78,S
2016-03-25 14:06:44,9315,100,559390,-18,9315,597,9320,103,S
2016-03-25 14:06:45,9320,6,559396,-2,9315,637,9320,104,B
2016-03-25 14:06:46,9315,238,559634,-136,9315,646,9320,2,S
2016-03-25 14:06:47,9320,12,559646,10,9320,288,9325,405,B
2016-03-25 14:06:47.5,9320,200,559846,-14,9320,189,9325,370,B
2016-03-25 14:06:48,9320,206,560052,6,9320,87,9325,334,B
2016-03-25 14:06:49,9320,4,560056,-4,9320,26,9325,275,B
2016-03-25 14:06:49.5,9320,114,560170,-68,9315,659,9320,44,B
2016-03-25 14:06:50,9320,60,560230,-2,9315,648,9320,323,B
2016-03-25 14:06:50.5,9320,8,560238,-8,9315,648,9320,321,B
2016-03-25 14:06:51,9320,12,560250,-12,9315,639,9320,317,B
2016-03-25 14:06:52,9315,4,560254,0,9315,635,9320,319,S
2016-03-25 14:06:53,9320,406,560660,-2,9315,616,9320,118,B
2016-03-25 14:06:54,9320,2,560662,2,9315,617,9320,122,B
2016-03-25 14:06:55,9320,246,560908,-14,9320,78,9325,323,B
2016-03-25 14:06:56,9320,20,560928,-20,9320,105,9325,325,B
2016-03-25 14:06:56.5,9320,214,561142,-150,9315,620,9320,84,B
2016-03-25 14:06:57,9320,136,561278,0,9315,621,9320,23,B
2016-03-25 14:06:57.5,9320,64,561342,-32,9320,4,9325,325,B
2016-03-25 14:06:58,9320,30,561372,4,9320,23,9325,317,B
2016-03-25 14:06:59,9325,4,561376,0,9320,56,9325,281,B
2016-03-25 14:06:59.5,9320,250,561626,-2,9320,481,9325,299,S
2016-03-25 14:07:00,9325,4,561630,-4,9320,513,9325,288,B
2016-03-25 14:07:02,9320,2,561632,2,9320,521,9325,248,S
2016-03-25 14:07:02.5,9325,114,561746,-114,9320,560,9325,191,B
2016-03-25 14:07:03,9325,282,562028,-12,9325,30,9330,347,B
2016-03-25 14:07:03.5,9325,12,562040,6,9325,68,9330,347,B
2016-03-25 14:07:04,9325,2,562042,0,9325,68,9330,347,B
2016-03-25 14:07:05,9325,126,562168,-44,9325,5,9330,348,B
2016-03-25 14:07:05.5,9325,28,562196,28,9325,20,9330,348,B
2016-03-25 14:07:06,9325,12,562208,10,9325,14,9330,347,B
2016-03-25 14:07:06.5,9325,30,562238,28,9320,559,9330,295,B
2016-03-25 14:07:07,9330,4,562242,0,9325,264,9330,268,B
2016-03-25 14:07:07.5,9325,8,562250,0,9325,279,9330,253,S
2016-03-25 14:07:08,9330,22,562272,20,9325,343,9330,243,B
2016-03-25 14:07:09,9325,10,562282,0,9325,338,9330,244,S
2016-03-25 14:07:09.5,9325,2,562284,0,9325,336,9330,244,S
2016-03-25 14:07:10,9325,4,562288,0,9325,334,9330,253,S
2016-03-25 14:07:11,9330,10,562298,10,9325,358,9330,248,B
2016-03-25 14:07:14,9330,22,562320,2,9325,424,9330,543,B
2016-03-25 14:07:19,9330,4,562324,-2,9325,442,9330,850,B
2016-03-25 14:07:21,9325,40,562364,-10,9325,270,9330,894,S
2016-03-25 14:07:21.5,9330,544,562908,302,9320,555,9325,115,B
2016-03-25 14:07:22,9320,2,562910,0,9320,555,9325,131,S
2016-03-25 14:07:22.3333,9325,12,562922,-12,9320,560,9325,188,B
2016-03-25 14:07:22.6667,9325,30,562952,-30,9320,560,9325,173,B
2016-03-25 14:07:23,9325,4,562956,-4,9320,562,9325,161,B
2016-03-25 14:07:25,9325,322,563278,16,9325,140,9330,982,B
2016-03-25 14:07:25.5,9325,42,563320,2,9325,123,9330,974,B
2016-03-25 14:07:26,9325,120,563440,88,9325,73,9330,1156,B
2016-03-25 14:07:26.3333,9325,12,563452,10,9325,88,9330,1154,B
2016-03-25 14:07:26.6667,9325,4,563456,-2,9325,87,9330,1148,B
2016-03-25 14:07:28,9330,4,563460,2,9325,77,9330,1155,B
2016-03-25 14:07:30,9325,2,563462,2,9325,86,9330,1178,S
2016-03-25 14:07:30.3333,9325,8,563470,-4,9325,93,9330,1177,S
2016-03-25 14:07:30.6667,9325,100,563570,-4,9325,43,9330,1178,S
2016-03-25 14:07:31,9325,20,563590,6,9325,33,9330,1177,S
2016-03-25 14:07:32,9325,2,563592,0,9325,52,9330,1197,S
2016-03-25 14:07:32.5,9325,2,563594,-2,9325,42,9330,1199,S
2016-03-25 14:07:33,9325,2,563596,0,9325,31,9330,1216,S
2016-03-25 14:07:33.5,9325,10,563606,0,9325,26,9330,1207,S
2016-03-25 14:07:34,9325,6,563612,0,9325,33,9330,1227,S
2016-03-25 14:07:34.5,9325,6,563618,-2,9325,34,9330,1227,S
2016-03-25 14:07:35,9325,2,563620,2,9325,32,9330,1227,S
2016-03-25 14:07:35.5,9325,2,563622,0,9325,31,9330,1227,S
2016-03-25 14:07:37,9325,40,563662,-2,9325,39,9330,1199,S
2016-03-25 14:07:37.5,9325,6,563668,-2,9325,36,9330,1201,S
2016-03-25 14:07:38,9325,60,563728,-12,9325,126,9330,1201,S
2016-03-25 14:07:39,9330,2,563730,-2,9325,128,9330,1245,B
2016-03-25 14:07:41,9330,2,563732,-2,9325,122,9330,1243,B
2016-03-25 14:07:41.5,9325,2,563734,-2,9325,121,9330,1242,S
2016-03-25 14:07:42,9330,2,563736,-2,9325,121,9330,1241,B
2016-03-25 14:07:42.5,9325,8,563744,-2,9325,130,9330,1238,S
2016-03-25 14:07:43,9325,2,563746,-2,9325,135,9330,1238,S
2016-03-25 14:07:43.5,9325,14,563760,14,9325,128,9330,1238,S
2016-03-25 14:07:45,9325,2,563762,0,9325,157,9330,1198,S
2016-03-25 14:07:45.5,9325,240,564002,-20,9325,44,9330,357,S
2016-03-25 14:07:46,9330,276,564278,-6,9325,141,9330,166,B
2016-03-25 14:07:47,9330,200,564478,128,9325,182,9330,195,B
2016-03-25 14:07:48,9325,2,564480,0,9325,181,9330,196,S
2016-03-25 14:07:48.5,9330,2,564482,-2,9325,182,9330,195,B
2016-03-25 14:07:49,9330,2,564484,-2,9325,182,9330,196,B
2016-03-25 14:07:51,9330,16,564500,-14,9325,192,9330,188,B
2016-03-25 14:07:51.5,9330,16,564516,0,9325,192,9330,180,B
2016-03-25 14:07:53,9325,6,564522,0,9325,292,9330,180,S
2016-03-25 14:07:53.3333,9330,4,564526,-2,9325,298,9330,179,B
2016-03-25 14:07:53.6667,9325,2,564528,0,9325,297,9330,179,S
2016-03-25 14:07:55,9330,2,564530,0,9325,297,9330,178,B
2016-03-25 14:07:55.5,9330,2,564532,0,9325,297,9330,177,B
2016-03-25 14:07:57,9330,20,564552,-16,9325,302,9330,167,B
2016-03-25 14:07:57.5,9330,4,564556,0,9325,323,9330,165,B
2016-03-25 14:07:58,9325,2,564558,-2,9325,322,9330,165,S
2016-03-25 14:07:58.5,9330,42,564600,-40,9325,322,9330,144,B
2016-03-25 14:08:00,9330,62,564662,-40,9330,215,9335,366,B
2016-03-25 14:08:00.5,9330,10,564672,-10,9330,218,9335,344,B
2016-03-25 14:08:01,9330,2,564674,-2,9330,218,9335,338,B
2016-03-25 14:08:02,9330,4,564678,0,9330,412,9335,338,B
2016-03-25 14:08:03,9335,4,564682,4,9330,484,9335,98,B
2016-03-25 14:08:03.5,9330,10,564692,0,9330,500,9335,213,S
2016-03-25 14:08:04,9335,6,564698,2,9330,515,9335,211,B
2016-03-25 14:08:05,9335,40,564738,-2,9330,807,9335,198,B
2016-03-25 14:08:05.5,9330,10,564748,0,9330,802,9335,196,S
2016-03-25 14:08:07,9330,542,565290,-274,9325,283,9330,31,S
2016-03-25 14:08:08,9330,10,565300,-10,9325,206,9330,77,S
2016-03-25 14:08:09,9330,2,565302,0,9325,112,9330,284,S
2016-03-25 14:08:10,9325,164,565466,-136,9320,416,9325,35,S
2016-03-25 14:08:11,9325,42,565508,0,9320,518,9325,46,S
2016-03-25 14:08:11.5,9325,92,565600,20,9325,184,9330,554,S
2016-03-25 14:08:12,9325,2,565602,0,9325,185,9330,569,S
2016-03-25 14:08:12.5,9325,208,565810,104,9325,111,9330,720,S
2016-03-25 14:08:13,9330,20,565830,0,9325,113,9330,711,B
2016-03-25 14:08:13.5,9325,2,565832,2,9325,112,9330,714,S
2016-03-25 14:08:14,9325,100,565932,0,9325,63,9330,766,S
2016-03-25 14:08:15,9325,2,565934,2,9325,63,9330,767,S
2016-03-25 14:08:17,9330,52,565986,48,9325,30,9330,1070,B
2016-03-25 14:08:18,9330,2,565988,0,9325,31,9330,1070,B
2016-03-25 14:08:19,9325,6,565994,6,9325,38,9330,1071,S
2016-03-25 14:08:21,9325,8,566002,2,9325,50,9330,1071,S
2016-03-25 14:08:22,9325,2,566004,0,9325,60,9330,1077,S
2016-03-25 14:08:22.5,9325,10,566014,10,9325,55,9330,1077,S
2016-03-25 14:08:23,9325,20,566034,12,9325,45,9330,1077,S
2016-03-25 14:08:24,9330,2,566036,-2,9325,45,9330,1077,B
2016-03-25 14:08:25,9325,92,566128,-18,9320,669,9325,56,S
2016-03-25 14:08:26,9325,124,566252,-92,9325,58,9330,1014,S
2016-03-25 14:08:26.5,9325,44,566296,18,9325,11,9330,243,S
2016-03-25 14:08:27,9325,100,566396,-34,9325,43,9330,213,S
2016-03-25 14:08:29,9325,2,566398,0,9325,314,9330,154,S
2016-03-25 14:08:30,9330,20,566418,-20,9325,337,9330,143,B
2016-03-25 14:08:31,9325,6,566424,2,9325,338,9330,153,S
2016-03-25 14:08:32,9325,4,566428,4,9325,349,9330,152,S
2016-03-25 14:08:34,9330,314,566742,-206,9330,43,9335,415,B
2016-03-25 14:08:34.5,9330,108,566850,-2,9330,23,9335,419,B
2016-03-25 14:08:35,9330,58,566908,-4,9325,448,9330,210,B
2016-03-25 14:08:38,9330,472,567380,-412,9330,63,9335,427,B
2016-03-25 14:08:39,9330,128,567508,-2,9325,565,9330,103,B
2016-03-25 14:08:40,9325,6,567514,-2,9325,567,9330,103,S
2016-03-25 14:08:42,9330,210,567724,-32,9330,132,9335,449,B
2016-03-25 14:08:42.3333,9330,20,567744,0,9330,122,9335,450,B
2016-03-25 14:08:42.6667,9330,34,567778,-34,9330,107,9335,450,B
2016-03-25 14:08:43,9330,4,567782,-4,9330,105,9335,451,B
2016-03-25 14:08:44,9330,12,567794,0,9330,99,9335,451,B
2016-03-25 14:08:44.5,9330,2,567796,0,9330,98,9335,451,B
2016-03-25 14:08:45,9335,4,567800,-4,9330,97,9335,450,B
2016-03-25 14:08:46,9335,404,568204,-398,9330,153,9335,190,B
2016-03-25 14:08:46.5,9330,12,568216,0,9330,159,9335,190,S
2016-03-25 14:08:48,9330,4,568220,-4,9330,161,9335,191,S
2016-03-25 14:08:50,9330,2,568222,-2,9330,151,9335,190,S
2016-03-25 14:08:51,9335,2,568224,-2,9330,151,9335,189,B
2016-03-25 14:08:51.5,9330,36,568260,-34,9330,65,9335,222,S
2016-03-25 14:08:52,9335,2,568262,-2,9330,57,9335,221,B
2016-03-25 14:08:55,9330,6,568268,4,9330,57,9335,251,S
2016-03-25 14:08:56,9330,14,568282,0,9330,50,9335,243,S
2016-03-25 14:08:56.5,9330,60,568342,-14,9330,20,9335,236,S
2016-03-25 14:08:57,9330,4,568346,0,9330,47,9335,265,S
2016-03-25 14:08:57.5,9335,24,568370,8,9330,37,9335,266,B
2016-03-25 14:08:58,9330,78,568448,52,9330,1,9335,265,S
2016-03-25 14:08:58.5,9335,60,568508,-50,9330,81,9335,205,B
2016-03-25 14:08:59,9330,2,568510,0,9330,91,9335,205,S
2016-03-25 14:09:01,9330,4,568514,2,9330,89,9335,205,S
2016-03-25 14:09:01.5,9335,40,568554,-40,9330,89,9335,185,B
2016-03-25 14:09:03,9335,126,568680,104,9330,10,9335,264,B
2016-03-25 14:09:04,9330,20,568700,-20,9330,52,9335,293,S
2016-03-25 14:09:05,9335,496,569196,-320,9330,153,9340,631,B
2016-03-25 14:09:06,9330,28,569224,2,9330,163,9335,5,S
2016-03-25 14:09:06.5,9335,12,569236,-10,9335,4,9340,623,B
2016-03-25 14:09:07,9335,10,569246,0,9335,9,9340,623,B
2016-03-25 14:09:07.5,9335,18,569264,0,9330,184,9335,3,B
2016-03-25 14:09:08,9335,62,569326,20,9335,47,9340,419,B
2016-03-25 14:09:08.5,9335,46,569372,18,9335,110,9340,417,B
2016-03-25 14:09:09,9335,408,569780,-302,9335,111,9340,222,B
2016-03-25 14:09:11,9340,486,570266,208,9340,249,9345,370,B
2016-03-25 14:09:11.5,9345,202,570468,-58,9340,240,9345,273,B
2016-03-25 14:09:12,9340,18,570486,0,9340,272,9345,261,S
2016-03-25 14:09:12.5,9340,8,570494,2,9340,271,9345,263,S
2016-03-25 14:09:13,9345,14,570508,4,9340,370,9345,314,B
2016-03-25 14:09:13.5,9340,2,570510,0,9340,409,9345,314,S
2016-03-25 14:09:14,9340,8,570518,-2,9340,706,9345,323,S
2016-03-25 14:09:15,9340,322,570840,-152,9335,133,9340,128,S
2016-03-25 14:09:16,9340,32,570872,0,9335,97,9340,186,S
2016-03-25 14:09:16.5,9340,10,570882,0,9335,92,9340,184,S
2016-03-25 14:09:17,9340,20,570902,0,9335,132,9340,404,S
2016-03-25 14:09:17.5,9340,2,570904,-2,9335,122,9340,404,S
2016-03-25 14:09:18,9340,8,570912,-2,9335,119,9340,403,S
2016-03-25 14:09:20,9340,4,570916,-2,9335,125,9340,634,S
2016-03-25 14:09:21,9340,2,570918,-2,9335,125,9340,623,S
2016-03-25 14:09:23,9335,98,571016,18,9335,80,9340,924,S
2016-03-25 14:09:23.5,9340,4,571020,-4,9335,80,9340,1224,B
2016-03-25 14:09:24,9335,20,571040,4,9330,244,9335,32,S
2016-03-25 14:09:24.5,9335,62,571102,-28,9330,244,9335,2,S
2016-03-25 14:09:25,9335,62,571164,6,9335,25,9340,1267,S
2016-03-25 14:09:25.5,9335,62,571226,-12,9330,243,9335,105,S
2016-03-25 14:09:27,9335,36,571262,-24,9335,361,9340,121,S
2016-03-25 14:09:28,9340,120,571382,24,9335,438,9345,369,B
2016-03-25 14:09:29,9345,6,571388,-4,9335,439,9345,362,B
2016-03-25 14:09:30,9345,6,571394,2,9335,422,9345,360,B
2016-03-25 14:09:30.5,9345,14,571408,-12,9335,422,9345,364,B
2016-03-25 14:09:32,9340,8,571416,0,9335,534,9340,3,S
2016-03-25 14:09:32.5,9340,56,571472,-28,9340,40,9345,427,S
2016-03-25 14:09:33,9340,2,571474,0,9340,39,9345,427,S
2016-03-25 14:09:33.5,9340,80,571554,-8,9335,535,9340,100,S
2016-03-25 14:09:34,9340,4,571558,-2,9335,535,9340,103,S
2016-03-25 14:09:34.5,9340,4,571562,-2,9335,535,9340,102,S
2016-03-25 14:09:37,9340,2,571564,0,9335,652,9340,107,S
2016-03-25 14:09:37.5,9335,2,571566,0,9335,651,9340,108,S
2016-03-25 14:09:38,9340,4,571570,-4,9335,642,9340,106,B
2016-03-25 14:09:39,9340,2,571572,-2,9335,642,9340,122,B
2016-03-25 14:09:41,9340,20,571592,0,9335,655,9340,108,B
2016-03-25 14:09:42,9340,22,571614,-22,9335,655,9340,105,B
2016-03-25 14:09:42.5,9340,4,571618,-4,9335,655,9340,106,B
2016-03-25 14:09:43,9340,6,571624,-6,9335,660,9340,107,B
2016-03-25 14:09:44,9340,6,571630,-6,9335,660,9340,104,B
2016-03-25 14:09:47,9340,58,571688,34,9335,637,9340,175,B
2016-03-25 14:09:48,9340,4,571692,-2,9335,590,9340,179,B
2016-03-25 14:09:50,9335,266,571958,98,9330,479,9335,56,S
2016-03-25 14:09:52,9335,2,571960,0,9330,352,9335,44,S
2016-03-25 14:09:53,9330,56,572016,-2,9330,349,9335,18,S
2016-03-25 14:09:54,9335,20,572036,-20,9330,372,9335,8,B
2016-03-25 14:09:54.3333,9335,2,572038,0,9330,372,9335,10,B
2016-03-25 14:09:54.6667,9335,20,572058,-18,9330,591,9340,377,B
2016-03-25 14:09:55,9335,12,572070,-10,9330,558,9335,4,B
2016-03-25 14:09:56,9335,6,572076,-2,9330,555,9335,9,B
2016-03-25 14:09:57,9335,2,572078,2,9330,553,9335,137,B
2016-03-25 14:09:57.5,9335,2,572080,0,9330,553,9335,136,B
2016-03-25 14:09:58,9330,2,572082,2,9330,335,9335,177,S
2016-03-25 14:10:00,9335,2,572084,0,9330,322,9335,228,B
2016-03-25 14:10:01,9330,30,572114,16,9330,308,9335,235,S
2016-03-25 14:10:03,9330,502,572616,168,9325,423,9335,297,S
2016-03-25 14:10:04,9325,2,572618,2,9325,348,9330,22,S
2016-03-25 14:10:05,9330,20,572638,0,9325,328,9330,27,B
2016-03-25 14:10:05.5,9325,4,572642,4,9325,338,9330,37,S
2016-03-25 14:10:06,9330,78,572720,-38,9330,80,9335,340,B
2016-03-25 14:10:08,9330,20,572740,0,9330,87,9335,343,B
2016-03-25 14:10:08.5,9330,2,572742,0,9330,86,9335,343,B
2016-03-25 14:10:09,9335,2,572744,0,9330,86,9335,342,B
2016-03-25 14:10:10,9330,2,572746,0,9330,95,9335,343,S
2016-03-25 14:10:11,9330,66,572812,-64,9330,56,9335,349,S
2016-03-25 14:10:11.5,9330,110,572922,18,9325,406,9330,111,S
2016-03-25 14:10:12,9325,2,572924,2,9325,375,9330,291,S
2016-03-25 14:10:12.5,9325,8,572932,2,9325,321,9330,265,S
2016-03-25 14:10:13,9325,638,573570,210,9320,512,9325,181,S
2016-03-25 14:10:13.5,9325,16,573586,16,9320,459,9325,176,S
2016-03-25 14:10:16,9320,8,573594,0,9320,375,9325,258,S
2016-03-25 14:10:17,9320,778,574372,408,9315,744,9320,162,S
2016-03-25 14:10:17.5,9320,140,574512,116,9315,724,9320,94,S
2016-03-25 14:10:18,9320,12,574524,2,9315,752,9320,88,S
2016-03-25 14:10:18.5,9320,4,574528,4,9315,752,9320,96,S
2016-03-25 14:10:19,9320,2,574530,0,9315,799,9320,97,S
2016-03-25 14:10:19.5,9320,148,574678,-6,9320,161,9325,665,S
2016-03-25 14:10:20,9320,4,574682,0,9320,162,9325,778,S
2016-03-25 14:10:21,9320,4,574686,0,9320,165,9325,774,S
2016-03-25 14:10:22,9320,2,574688,-2,9320,167,9325,775,S
2016-03-25 14:10:22.5,9320,100,574788,0,9320,120,9325,782,S
2016-03-25 14:10:23,9325,18,574806,-14,9320,120,9325,768,B
2016-03-25 14:10:24,9320,2,574808,0,9320,148,9325,813,S
2016-03-25 14:10:25,9320,2,574810,0,9320,418,9325,820,S
2016-03-25 14:10:26,9320,2,574812,0,9320,418,9325,820,S
2016-03-25 14:10:28,9320,20,574832,0,9320,611,9325,820,S
2016-03-25 14:10:29,9320,2,574834,0,9320,611,9325,804,S
2016-03-25 14:10:30,9320,6,574840,0,9320,614,9325,804,S
2016-03-25 14:10:31,9320,4,574844,0,9320,618,9325,804,S
2016-03-25 14:10:32,9320,4,574848,-2,9320,516,9325,806,S
2016-03-25 14:10:33,9325,2,574850,-2,9320,520,9325,805,B
2016-03-25 14:10:34,9320,104,574954,-102,9320,510,9325,753,S
2016-03-25 14:10:34.5,9325,436,575390,422,9320,509,9325,527,B
2016-03-25 14:10:35,9325,1056,576446,470,9325,130,9330,942,B
2016-03-25 14:10:35.5,9330,134,576580,2,9325,167,9330,876,B
2016-03-25 14:10:36,9325,20,576600,20,9325,129,9330,1326,S
2016-03-25 14:10:37,9325,2,576602,2,9325,128,9330,1315,S
2016-03-25 14:10:38,9325,4,576606,4,9325,119,9330,1595,S
2016-03-25 14:10:38.5,9325,2,576608,2,9325,133,9330,1595,S
2016-03-25 14:10:39,9330,20,576628,0,9325,133,9330,1585,B
2016-03-25 14:10:40,9325,2,576630,2,9325,117,9330,1586,S
2016-03-25 14:10:41,9330,2,576632,0,9325,168,9330,1586,B
2016-03-25 14:10:42,9325,2,576634,0,9325,167,9330,1587,S
2016-03-25 14:10:42.3333,9325,10,576644,0,9325,202,9330,1587,S
2016-03-25 14:10:42.6667,9325,10,576654,0,9325,197,9330,1587,S
2016-03-25 14:10:43,9330,2,576656,2,9325,197,9330,1586,B
2016-03-25 14:10:44,9325,2,576658,0,9325,196,9330,1586,S
2016-03-25 14:10:44.5,9325,2,576660,0,9325,195,9330,1587,S
2016-03-25 14:10:46,9325,24,576684,18,9325,201,9330,1587,S
2016-03-25 14:10:47,9330,8,576692,0,9325,201,9330,1586,B
2016-03-25 14:10:48,9325,16,576708,14,9325,193,9330,1586,S
2016-03-25 14:10:49,9325,20,576728,20,9325,255,9330,1536,S
2016-03-25 14:10:51,9330,4,576732,0,9325,256,9330,1534,B
2016-03-25 14:10:52,9330,820,577552,624,9325,337,9335,311,B
2016-03-25 14:10:53,9330,2,577554,0,9330,46,9335,289,B
2016-03-25 14:10:53.5,9330,6,577560,0,9330,43,9335,281,B
2016-03-25 14:10:54,9330,10,577570,0,9330,229,9335,283,B
2016-03-25 14:10:55,9335,20,577590,20,9330,229,9335,274,B
2016-03-25 14:10:56,9330,4,577594,2,9330,227,9335,274,S
2016-03-25 14:10:58,9335,4,577598,4,9330,470,9335,277,B
2016-03-25 14:10:59,9335,20,577618,0,9330,470,9335,300,B
2016-03-25 14:10:59.5,9330,1168,578786,588,9330,147,9335,350,S
2016-03-25 14:11:00,9330,4,578790,4,9330,146,9335,306,S
2016-03-25 14:11:00.5,9330,2,578792,2,9330,377,9335,306,S
2016-03-25 14:11:01,9330,6,578798,4,9330,375,9335,296,S
2016-03-25 14:11:02,9330,14,578812,14,9330,569,9335,255,S
2016-03-25 14:11:03,9330,22,578834,2,9330,578,9335,245,S
2016-03-25 14:11:03.5,9330,56,578890,56,9330,550,9335,213,S
2016-03-25 14:11:04,9335,10,578900,10,9330,550,9335,208,B
2016-03-25 14:11:04.5,9330,16,578916,16,9330,563,9335,209,S
2016-03-25 14:11:07,9330,2,578918,2,9330,567,9335,221,S
2016-03-25 14:11:07.5,9335,562,579480,-240,9330,567,9335,20,B
2016-03-25 14:11:08,9335,22,579502,-18,9330,568,9335,22,B
2016-03-25 14:11:08.5,9335,12,579514,10,9330,563,9335,151,B
2016-03-25 14:11:09,9335,4,579518,2,9330,563,9335,159,B
2016-03-25 14:11:09.5,9335,2,579520,0,9330,567,9335,159,B
2016-03-25 14:11:10,9330,2,579522,2,9330,566,9335,159,S
2016-03-25 14:11:11,9335,2,579524,0,9330,568,9335,159,B
2016-03-25 14:11:12,9335,320,579844,-278,9335,508,9340,266,B
2016-03-25 14:11:13,9335,4,579848,-4,9330,632,9335,63,B
2016-03-25 14:11:13.3333,9330,4,579852,4,9330,576,9335,65,S
2016-03-25 14:11:13.6667,9335,1542,581394,84,9335,332,9340,379,B
2016-03-25 14:11:14,9335,20,581414,-20,9335,322,9340,327,B
2016-03-25 14:11:15,9330,20,581434,0,9330,22,9335,38,S
2016-03-25 14:11:16,9330,6,581440,4,9325,227,9330,51,S
2016-03-25 14:11:16.5,9325,2,581442,-2,9325,142,9330,62,S
2016-03-25 14:11:17,9330,128,581570,-6,9330,259,9335,139,B
2016-03-25 14:11:19,9325,36,581606,0,9325,132,9330,445,S
2016-03-25 14:11:19.5,9325,8,581614,0,9325,118,9330,447,S
2016-03-25 14:11:20,9330,4,581618,4,9325,119,9330,417,B
2016-03-25 14:11:21,9330,14,581632,-2,9325,139,9335,335,B
2016-03-25 14:11:22,9330,20,581652,16,9325,167,9330,30,B
2016-03-25 14:11:22.5,9330,2,581654,2,9325,168,9330,30,B
2016-03-25 14:11:23,9330,20,581674,0,9325,168,9330,20,B
2016-03-25 14:11:24,9330,2,581676,2,9325,166,9330,19,B
2016-03-25 14:11:26,9330,32,581708,0,9325,178,9330,3,B
2016-03-25 14:11:27,9330,8,581716,0,9325,177,9335,437,B
2016-03-25 14:11:28,9325,360,582076,-218,9320,340,9325,130,S
2016-03-25 14:11:28.5,9325,80,582156,-48,9320,333,9325,91,S
2016-03-25 14:11:29,9325,60,582216,-60,9320,272,9325,91,S
2016-03-25 14:11:29.5,9325,44,582260,-44,9320,273,9325,69,S
2016-03-25 14:11:31,9325,2,582262,0,9320,271,9325,68,S
2016-03-25 14:11:31.5,9320,336,582598,-10,9320,203,9330,63,S
2016-03-25 14:11:32,9325,48,582646,-40,9320,208,9325,3,B
2016-03-25 14:11:32.5,9325,2,582648,-2,9320,211,9325,3,B
2016-03-25 14:11:33,9320,200,582848,50,9320,111,9325,1,S
2016-03-25 14:11:33.5,9325,4,582852,0,9320,113,9325,36,B
2016-03-25 14:11:34,9325,204,583056,102,9315,652,9325,29,B
2016-03-25 14:11:35,9320,8,583064,0,9320,11,9325,78,S
2016-03-25 14:11:35.5,9325,2,583066,0,9320,23,9325,79,B
2016-03-25 14:11:37,9320,216,583282,134,9320,68,9325,69,S
2016-03-25 14:11:37.5,9320,2,583284,-2,9320,71,9325,94,S
2016-03-25 14:11:38,9320,2,583286,0,9320,171,9325,75,S
2016-03-25 14:11:39,9325,2,583288,-2,9320,199,9325,118,B
2016-03-25 14:11:41,9320,2,583290,0,9320,211,9325,145,S
2016-03-25 14:11:42,9325,4,583294,-4,9320,192,9325,173,B
2016-03-25 14:11:43,9320,2,583296,-2,9320,243,9325,198,S
2016-03-25 14:11:43.5,9320,486,583782,-106,9315,791,9320,74,S
2016-03-25 14:11:44,9320,32,583814,-4,9315,770,9320,59,S
2016-03-25 14:11:44.5,9320,52,583866,-32,9315,770,9320,36,S
2016-03-25 14:11:45,9320,50,583916,10,9315,770,9320,72,S
2016-03-25 14:11:45.5,9320,10,583926,2,9315,769,9320,82,S
2016-03-25 14:11:46,9315,2,583928,0,9315,768,9320,82,S
2016-03-25 14:11:46.5,9320,4,583932,-4,9315,769,9320,90,B
2016-03-25 14:11:47,9320,102,584034,6,9315,768,9320,45,B
2016-03-25 14:11:48,9320,2,584036,-2,9315,768,9320,45,B
2016-03-25 14:11:48.5,9315,50,584086,0,9315,742,9320,45,S
2016-03-25 14:11:49,9320,6,584092,-4,9315,713,9320,44,B
2016-03-25 14:11:50,9320,2,584094,0,9315,714,9320,45,B
2016-03-25 14:11:51,9320,2,584096,2,9315,708,9320,44,B
2016-03-25 14:11:52,9315,24,584120,2,9315,697,9320,38,S
2016-03-25 14:11:52.3333,9320,4,584124,2,9315,697,9320,35,B
2016-03-25 14:11:52.6667,9320,28,584152,28,9315,685,9320,35,B
2016-03-25 14:11:54,9315,8,584160,0,9315,686,9320,36,S
2016-03-25 14:11:54.3333,9320,72,584232,-8,9320,223,9325,265,B
2016-03-25 14:11:54.6667,9320,2,584234,0,9320,223,9325,251,B
2016-03-25 14:11:55,9320,10,584244,-2,9320,221,9325,234,B
2016-03-25 14:11:56,9320,10,584254,-10,9320,216,9325,214,B
2016-03-25 14:11:56.5,9320,26,584280,0,9320,203,9325,216,B
2016-03-25 14:11:57,9320,20,584300,0,9320,194,9325,270,B
2016-03-25 14:11:57.5,9320,2,584302,0,9320,194,9325,270,B
2016-03-25 14:11:58,9320,2,584304,-2,9320,209,9325,254,B
2016-03-25 14:11:59,9320,2,584306,0,9320,218,9325,255,B
2016-03-25 14:12:00,9320,2,584308,0,9320,217,9325,256,B
2016-03-25 14:12:00.5,9320,4,584312,0,9320,216,9325,256,B
2016-03-25 14:12:02,9320,20,584332,0,9320,203,9325,255,B
2016-03-25 14:12:03,9320,14,584346,0,9320,181,9325,269,B
2016-03-25 14:12:04,9320,2,584348,0,9320,182,9325,269,B
2016-03-25 14:12:06,9320,8,584356,0,9320,198,9325,318,B
2016-03-25 14:12:07,9320,4,584360,-4,9320,197,9325,316,B
2016-03-25 14:12:09,9320,102,584462,-102,9320,147,9325,316,B
2016-03-25 14:12:09.5,9320,2,584464,0,9320,182,9325,299,B
2016-03-25 14:12:10,9320,126,584590,-22,9320,85,9325,782,B
2016-03-25 14:12:11,9320,174,584764,-136,9315,753,9320,95,B
2016-03-25 14:12:12,9320,10,584774,10,9315,697,9320,87,B
2016-03-25 14:12:12.5,9320,2,584776,0,9315,799,9320,86,B
2016-03-25 14:12:13,9320,2,584778,0,9315,800,9320,100,B
2016-03-25 14:12:14,9320,22,584800,20,9315,800,9320,101,B
2016-03-25 14:12:14.5,9320,8,584808,0,9315,809,9320,98,B
2016-03-25 14:12:15,9320,14,584822,2,9315,808,9320,93,B
2016-03-25 14:12:16,9320,184,585006,-4,9315,586,9325,303,B
2016-03-25 14:12:16.5,9325,44,585050,-24,9320,19,9325,296,B
2016-03-25 14:12:17,9320,10,585060,-2,9320,27,9325,296,S
2016-03-25 14:12:18,9325,4,585064,-4,9320,184,9325,299,B
2016-03-25 14:12:19,9320,2,585066,-2,9320,176,9325,311,S
2016-03-25 14:12:19.5,9320,6,585072,-2,9320,182,9325,311,S
2016-03-25 14:12:20,9320,2,585074,0,9320,73,9325,311,S
2016-03-25 14:12:20.5,9320,4,585078,0,9320,71,9325,311,S
2016-03-25 14:12:21,9325,2,585080,-2,9320,71,9325,310,B
2016-03-25 14:12:22,9325,4,585084,-4,9320,71,9325,308,B
2016-03-25 14:12:24,9320,24,585108,16,9320,46,9325,369,S
2016-03-25 14:12:25,9315,134,585242,24,9315,831,9325,359,S
2016-03-25 14:12:26,9315,6,585248,0,9315,826,9320,16,S
2016-03-25 14:12:26.3333,9320,44,585292,-32,9320,32,9325,362,B
2016-03-25 14:12:26.6667,9325,60,585352,-46,9320,8,9325,332,B
2016-03-25 14:12:28,9320,60,585412,0,9320,204,9325,342,S
2016-03-25 14:12:29,9320,2,585414,-2,9320,203,9325,342,S
2016-03-25 14:12:30,9320,4,585418,0,9320,211,9325,342,S
2016-03-25 14:12:32,9320,16,585434,-8,9320,263,9325,344,S
2016-03-25 14:12:33,9320,2,585436,-2,9320,265,9325,353,S
2016-03-25 14:12:34,9320,4,585440,-4,9320,268,9325,353,S
2016-03-25 14:12:35,9320,2,585442,0,9320,267,9325,354,S
2016-03-25 14:12:35.5,9320,2,585444,0,9320,280,9325,356,S
2016-03-25 14:12:40,9320,564,586008,-354,9320,259,9325,79,S
2016-03-25 14:12:40.5,9325,170,586178,-146,9325,185,9330,162,B
2016-03-25 14:12:41,9330,4,586182,0,9325,184,9330,151,B
2016-03-25 14:12:42,9325,2,586184,0,9325,183,9330,152,S
2016-03-25 14:12:42.5,9325,50,586234,-50,9325,158,9330,152,S
2016-03-25 14:12:45,9325,2,586236,-2,9325,172,9330,161,S
2016-03-25 14:12:50,9325,8,586244,0,9325,173,9330,177,S
2016-03-25 14:12:51,9325,4,586248,-4,9325,171,9330,177,S
2016-03-25 14:12:52,9325,12,586260,0,9325,171,9330,173,S
2016-03-25 14:12:53,9330,2,586262,0,9325,171,9330,172,B
2016-03-25 14:12:54,9325,10,586272,0,9325,166,9330,182,S
2016-03-25 14:12:54.5,9330,2,586274,0,9325,166,9330,181,B
2016-03-25 14:12:55,9330,4,586278,4,9325,167,9330,179,B
2016-03-25 14:12:59,9325,116,586394,-26,9325,119,9330,174,S
2016-03-25 14:13:00,9330,214,586608,102,9320,354,9330,234,B
2016-03-25 14:13:00.5,9330,4,586612,0,9320,355,9330,234,B
2016-03-25 14:13:01,9325,8,586620,8,9320,325,9325,46,S
2016-03-25 14:13:01.5,9325,2,586622,2,9320,320,9325,61,S
2016-03-25 14:13:03,9325,4,586626,0,9320,420,9325,72,S
2016-03-25 14:13:04,9320,2,586628,0,9320,400,9325,97,S
2016-03-25 14:13:04.5,9325,6,586634,0,9320,402,9325,94,B
2016-03-25 14:13:05,9320,6,586640,-6,9320,400,9325,157,S
2016-03-25 14:13:06,9325,4,586644,4,9320,419,9325,155,B
2016-03-25 14:13:07,9320,6,586650,0,9320,414,9325,96,S
2016-03-25 14:13:08,9320,2,586652,0,9320,415,9325,96,S
2016-03-25 14:13:12,9325,2,586654,2,9320,403,9325,115,B
2016-03-25 14:13:13,9320,8,586662,0,9320,407,9325,115,S
2016-03-25 14:13:14,9325,40,586702,0,9320,407,9325,95,B
2016-03-25 14:13:15,9325,20,586722,20,9320,405,9325,85,B
2016-03-25 14:13:17,9325,4,586726,4,9320,399,9325,90,B
2016-03-25 14:13:18,9325,44,586770,-14,9320,373,9325,70,B
2016-03-25 14:13:19,9320,2,586772,0,9320,370,9325,83,S
2016-03-25 14:13:24,9320,2,586774,0,9320,280,9325,96,S
2016-03-25 14:13:26,9325,42,586816,-22,9320,248,9325,87,B
2016-03-25 14:13:26.5,9320,836,587652,-604,9315,719,9320,1,S
2016-03-25 14:13:27,9320,22,587674,-22,9320,8,9325,140,S
2016-03-25 14:13:28,9320,20,587694,14,9320,82,9325,141,S
2016-03-25 14:13:29,9320,84,587778,-2,9320,41,9325,141,S
2016-03-25 14:13:30,9320,4,587782,4,9320,109,9325,137,S
2016-03-25 14:13:32,9320,30,587812,0,9320,353,9325,104,S
2016-03-25 14:13:33,9320,2,587814,2,9320,352,9325,104,S
2016-03-25 14:13:35,9325,16,587830,6,9320,351,9325,118,B
2016-03-25 14:13:36,9325,20,587850,0,9320,351,9325,112,B
2016-03-25 14:13:38,9320,22,587872,-18,9320,341,9325,100,S
2016-03-25 14:13:40,9320,2,587874,0,9320,341,9325,120,S
2016-03-25 14:13:41,9320,102,587976,30,9320,290,9325,120,S
2016-03-25 14:13:42,9325,2,587978,0,9320,290,9325,119,B
2016-03-25 14:13:42.5,9325,2,587980,0,9320,290,9325,118,B
2016-03-25 14:13:49,9325,234,588214,-126,9325,32,9330,490,B
2016-03-25 14:13:49.3333,9325,54,588268,-46,9320,495,9325,2,B
2016-03-25 14:13:49.6667,9325,16,588284,-16,9325,13,9330,471,B
2016-03-25 14:13:50,9325,20,588304,-20,9325,8,9330,246,B
2016-03-25 14:13:53,9325,6,588310,0,9325,195,9330,245,B
2016-03-25 14:13:54,9325,60,588370,-22,9325,165,9330,245,B
2016-03-25 14:13:57,9325,2,588372,2,9325,244,9330,245,B
2016-03-25 14:13:59,9325,10,588382,0,9325,239,9330,245,B
2016-03-25 14:14:04,9330,22,588404,-18,9325,244,9330,245,B
2016-03-25 14:14:05,9325,2,588406,2,9325,243,9330,244,S
2016-03-25 14:14:06,9330,20,588426,-14,9325,243,9330,234,B
2016-03-25 14:14:07,9330,24,588450,-4,9325,243,9330,222,B
2016-03-25 14:14:07.5,9325,4,588454,4,9325,245,9330,215,S
2016-03-25 14:14:08,9330,40,588494,-38,9325,245,9330,195,B
2016-03-25 14:14:09,9330,8,588502,-2,9325,245,9330,201,B
2016-03-25 14:14:10,9325,4,588506,0,9325,244,9330,201,S
2016-03-25 14:14:11,9330,2,588508,0,9325,244,9330,201,B
2016-03-25 14:14:12,9330,40,588548,-32,9325,244,9330,201,B
2016-03-25 14:14:13,9330,20,588568,-20,9325,244,9330,191,B
2016-03-25 14:14:17,9325,10,588578,10,9325,239,9330,203,S
2016-03-25 14:14:18,9330,10,588588,0,9325,239,9330,199,B
2016-03-25 14:14:22,9325,166,588754,-150,9325,21,9330,198,S
2016-03-25 14:14:22.5,9325,50,588804,-24,9325,23,9330,198,S
2016-03-25 14:14:23,9325,22,588826,22,9325,17,9330,198,S
2016-03-25 14:14:23.5,9325,36,588862,-12,9320,366,9325,40,S
2016-03-25 14:14:24,9325,2,588864,-2,9320,358,9325,39,S
2016-03-25 14:14:26,9325,2,588866,-2,9320,359,9325,75,S
2016-03-25 14:14:27,9325,2,588868,0,9320,368,9325,74,S
2016-03-25 14:14:28,9325,2,588870,-2,9320,368,9325,139,S
2016-03-25 14:14:30,9320,20,588890,20,9320,142,9325,149,S
2016-03-25 14:14:30.5,9320,42,588932,0,9320,127,9325,177,S
2016-03-25 14:14:33,9325,2,588934,0,9320,125,9325,178,B
2016-03-25 14:14:40,9320,100,589034,-50,9320,96,9325,154,S
2016-03-25 14:14:40.5,9320,66,589100,40,9320,64,9325,154,S
2016-03-25 14:14:41,9320,122,589222,-30,9320,4,9325,151,S
2016-03-25 14:14:41.5,9320,8,589230,6,9315,647,9320,234,S
2016-03-25 14:14:42,9315,2,589232,0,9315,644,9320,241,S
2016-03-25 14:14:43,9320,8,589240,0,9315,610,9320,238,B
2016-03-25 14:14:43.5,9320,14,589254,-8,9320,32,9325,188,B
2016-03-25 14:14:45,9320,2,589256,0,9320,31,9325,208,B
2016-03-25 14:14:45.5,9320,2,589258,2,9320,30,9325,203,B
2016-03-25 14:14:47,9320,2,589260,0,9320,31,9325,207,B
2016-03-25 14:14:47.5,9320,40,589300,-40,9320,11,9325,207,B
2016-03-25 14:14:48,9320,26,589326,2,9315,457,9325,207,B
2016-03-25 14:14:49,9320,2,589328,-2,9320,13,9325,190,B
2016-03-25 14:14:51,9325,2,589330,-2,9320,27,9325,185,B
2016-03-25 14:14:51.5,9320,6,589336,0,9320,24,9325,185,S
2016-03-25 14:14:52,9320,12,589348,-2,9320,24,9325,185,S
2016-03-25 14:14:52.5,9320,10,589358,0,9320,19,9325,194,S
2016-03-25 14:14:53,9320,38,589396,30,9315,455,9320,236,S
2016-03-25 14:14:54,9320,2,589398,0,9315,455,9320,371,S
2016-03-25 14:14:54.5,9320,20,589418,0,9315,453,9320,367,S
2016-03-25 14:14:55,9315,2,589420,-2,9315,452,9320,372,S
2016-03-25 14:14:56,9320,2,589422,0,9315,457,9320,371,B
2016-03-25 14:14:56.5,9315,610,590032,-570,9315,155,9320,368,S
2016-03-25 14:14:57,9315,300,590332,108,9310,784,9315,18,S
2016-03-25 14:14:57.5,9315,40,590372,14,9310,680,9315,563,S
2016-03-25 14:14:58,9310,4,590376,0,9310,547,9315,565,S
2016-03-25 14:14:58.5,9310,50,590426,-34,9310,427,9315,573,S
2016-03-25 14:14:59,9310,62,590488,-22,9310,398,9315,579,S
2016-03-25 14:14:59.5,9310,22,590510,-18,9310,387,9315,579,S
2016-03-25 14:15:00,9310,36,590546,-34,9310,369,9315,579,S
2016-03-25 14:15:00.5,9310,586,591132,-184,9310,75,9315,582,S
2016-03-25 14:15:01,9310,254,591386,86,9305,508,9310,5,S
2016-03-25 14:15:01.5,9310,174,591560,-30,9305,565,9310,69,S
2016-03-25 14:15:02,9305,4,591564,0,9305,456,9310,89,S
2016-03-25 14:15:02.5,9310,398,591962,-192,9305,364,9310,84,B
2016-03-25 14:15:03,9305,12,591974,12,9305,357,9310,95,S
2016-03-25 14:15:03.5,9315,660,592634,-366,9315,28,9320,434,B
2016-03-25 14:15:04,9315,470,593104,-430,9310,107,9315,5,B
2016-03-25 14:15:04.5,9315,110,593214,-88,9310,114,9315,7,B
2016-03-25 14:15:05,9310,56,593270,16,9310,96,9315,252,S
2016-03-25 14:15:06,9310,72,593342,-72,9310,62,9315,262,S
2016-03-25 14:15:06.5,9310,22,593364,0,9310,102,9315,262,S
2016-03-25 14:15:07,9310,2,593366,0,9310,102,9315,265,S
2016-03-25 14:15:07.5,9310,202,593568,92,9305,526,9315,268,S
2016-03-25 14:15:08,9305,242,593810,-210,9305,415,9310,6,S
2016-03-25 14:15:08.5,9310,2,593812,0,9305,411,9310,6,B
2016-03-25 14:15:09,9310,76,593888,2,9305,389,9310,16,B
2016-03-25 14:15:10,9305,10,593898,10,9305,383,9310,26,S
2016-03-25 14:15:10.5,9310,30,593928,30,9305,385,9310,11,B
2016-03-25 14:15:11,9310,12,593940,0,9305,384,9310,155,B
2016-03-25 14:15:11.5,9310,8,593948,0,9305,384,9310,150,B
2016-03-25 14:15:12,9305,4,593952,4,9305,390,9310,171,S
2016-03-25 14:15:12.5,9305,2,593954,0,9305,431,9310,229,S
2016-03-25 14:15:13,9305,30,593984,-12,9305,417,9310,226,S
2016-03-25 14:15:13.5,9310,18,594002,-16,9305,416,9310,236,B
2016-03-25 14:15:14,9305,824,594826,140,9300,1295,9305,558,S
2016-03-25 14:15:14.5,9305,940,595766,638,9300,866,9305,596,S
2016-03-25 14:15:15,9305,450,596216,-22,9300,830,9305,403,S
2016-03-25 14:15:15.5,9305,206,596422,200,9300,698,9305,411,S
2016-03-25 14:15:16,9305,4,596426,4,9300,684,9305,427,S
2016-03-25 14:15:16.5,9305,450,596876,4,9300,671,9305,212,S
2016-03-25 14:15:17,9300,14,596890,4,9300,668,9305,213,S
2016-03-25 14:15:17.5,9300,36,596926,0,9300,649,9305,215,S
2016-03-25 14:15:18,9305,792,597718,32,9305,725,9310,313,B
2016-03-25 14:15:18.5,9305,236,597954,56,9305,711,9310,209,B
2016-03-25 14:15:19,9305,8,597962,0,9305,709,9310,210,B
2016-03-25 14:15:19.5,9305,116,598078,-14,9305,207,9310,30,B
2016-03-25 14:15:20,9310,116,598194,-46,9310,56,9315,351,B
2016-03-25 14:15:20.5,9305,152,598346,-96,9305,194,9310,12,S
2016-03-25 14:15:21,9305,2,598348,0,9305,195,9310,27,S
2016-03-25 14:15:21.5,9305,2,598350,0,9305,204,9310,81,S
2016-03-25 14:15:22,9310,8,598358,-4,9305,217,9310,81,B
2016-03-25 14:15:23,9305,74,598432,-30,9305,220,9310,47,S
2016-03-25 14:15:23.5,9305,16,598448,-6,9305,221,9310,49,S
2016-03-25 14:15:24,9310,18,598466,-8,9305,225,9315,117,B
2016-03-25 14:15:24.5,9305,20,598486,-4,9305,227,9310,110,S
2016-03-25 14:15:25,9310,10,598496,-10,9305,227,9310,152,B
2016-03-25 14:15:25.5,9310,2,598498,0,9305,241,9310,198,B
2016-03-25 14:15:26,9310,10,598508,-2,9305,223,9310,203,B
2016-03-25 14:15:27,9305,18,598526,-14,9305,244,9310,72,S
2016-03-25 14:15:27.5,9310,8,598534,-6,9305,237,9310,195,B
2016-03-25 14:15:28,9310,2,598536,-2,9305,237,9310,194,B
2016-03-25 14:15:28.5,9305,14,598550,-14,9305,231,9310,194,S
2016-03-25 14:15:29,9310,84,598634,-84,9305,227,9310,160,B
2016-03-25 14:15:29.5,9305,6,598640,0,9305,229,9310,161,S
2016-03-25 14:15:30,9310,34,598674,-16,9305,235,9310,150,B
2016-03-25 14:15:31,9305,10,598684,-10,9305,230,9310,115,S
2016-03-25 14:15:31.5,9315,522,599206,-416,9315,422,9320,399,B
2016-03-25 14:15:32,9315,66,599272,-42,9315,399,9320,436,B
2016-03-25 14:15:32.3333,9315,12,599284,-10,9315,404,9320,436,B
2016-03-25 14:15:32.6667,9315,50,599334,-30,9315,379,9320,463,B
2016-03-25 14:15:33,9315,12,599346,-10,9315,373,9320,464,B
2016-03-25 14:15:34,9315,106,599452,0,9315,320,9320,461,B
2016-03-25 14:15:34.5,9315,12,599464,-10,9315,314,9320,462,B
2016-03-25 14:15:35,9315,4,599468,0,9315,313,9320,462,B
2016-03-25 14:15:35.3333,9315,186,599654,-118,9315,220,9320,385,B
2016-03-25 14:15:35.6667,9315,322,599976,-6,9315,70,9320,353,B
2016-03-25 14:15:36,9310,238,600214,-122,9310,22,9315,151,S
2016-03-25 14:15:37,9310,18,600232,-6,9310,50,9315,155,S
2016-03-25 14:15:37.5,9315,30,600262,-18,9310,51,9315,154,B
2016-03-25 14:15:38,9315,64,600326,0,9310,55,9315,224,B
2016-03-25 14:15:38.5,9310,20,600346,0,9310,58,9315,236,S
2016-03-25 14:15:39,9310,22,600368,0,9310,49,9315,235,S
2016-03-25 14:15:39.5,9310,26,600394,-14,9310,20,9315,267,S
2016-03-25 14:15:40,9310,124,600518,26,9310,23,9315,194,S
2016-03-25 14:15:40.5,9315,4,600522,0,9310,11,9315,204,B
2016-03-25 14:15:41,9315,6,600528,0,9310,27,9315,201,B
2016-03-25 14:15:41.5,9315,2,600530,0,9310,40,9315,265,B
2016-03-25 14:15:42,9310,2,600532,0,9310,33,9315,265,S
2016-03-25 14:15:43,9310,108,600640,-64,9305,322,9310,21,S
2016-03-25 14:15:43.5,9310,4,600644,-2,9305,321,9310,17,S
2016-03-25 14:15:44,9310,62,600706,36,9305,322,9310,6,S
2016-03-25 14:15:44.5,9310,10,600716,2,9305,323,9310,14,S
2016-03-25 14:15:45,9310,2,600718,2,9305,323,9310,13,S
2016-03-25 14:15:45.5,9305,20,600738,-20,9305,201,9310,25,S
2016-03-25 14:15:46,9310,4,600742,2,9305,201,9310,23,B
2016-03-25 14:15:47,9305,2,600744,0,9305,330,9310,80,S
2016-03-25 14:15:48,9310,2,600746,2,9305,331,9310,79,B
2016-03-25 14:15:49,9305,24,600770,-24,9305,319,9310,79,S
2016-03-25 14:15:50,9310,4,600774,2,9305,324,9310,79,B
2016-03-25 14:15:50.5,9310,32,600806,0,9305,320,9310,68,B
2016-03-25 14:15:51,9310,2,600808,0,9305,330,9310,67,B
2016-03-25 14:15:51.5,9305,16,600824,8,9305,348,9310,61,S
2016-03-25 14:15:52,9305,12,600836,-12,9305,354,9310,61,S
2016-03-25 14:15:52.5,9305,34,600870,-16,9305,344,9310,59,S
2016-03-25 14:15:53,9310,4,600874,-2,9305,346,9310,57,B
2016-03-25 14:15:53.5,9310,32,600906,-22,9305,338,9310,51,B
2016-03-25 14:15:54,9305,20,600926,0,9305,327,9310,51,S
2016-03-25 14:15:55,9310,2,600928,0,9305,326,9310,63,B
2016-03-25 14:15:55.5,9310,2,600930,-2,9305,332,9310,62,B
2016-03-25 14:15:56,9310,2,600932,-2,9305,332,9310,99,B
2016-03-25 14:15:57,9310,4,600936,0,9305,331,9310,97,B
2016-03-25 14:15:58,9310,30,600966,-26,9305,336,9310,120,B
2016-03-25 14:16:00,9305,84,601050,-78,9305,339,9310,341,S
2016-03-25 14:16:00.5,9310,12,601062,-6,9305,339,9310,337,B
2016-03-25 14:16:01,9305,2,601064,-2,9305,339,9310,568,S
2016-03-25 14:16:01.5,9310,2,601066,0,9305,339,9310,567,B
2016-03-25 14:16:02,9310,8,601074,0,9305,340,9310,563,B
2016-03-25 14:16:02.5,9305,2,601076,0,9305,339,9310,562,S
2016-03-25 14:16:03,9305,104,601180,-2,9305,285,9310,562,S
2016-03-25 14:16:03.5,9305,10,601190,8,9305,287,9310,559,S
2016-03-25 14:16:04,9305,228,601418,-30,9305,173,9310,619,S
2016-03-25 14:16:04.5,9305,6,601424,0,9305,170,9310,620,S
2016-03-25 14:16:05,9305,2,601426,2,9305,170,9310,620,S
2016-03-25 14:16:05.5,9305,2,601428,2,9305,179,9310,552,S
2016-03-25 14:16:07,9305,162,601590,58,9305,23,9310,867,S
2016-03-25 14:16:07.5,9305,10,601600,10,9305,28,9310,894,S
2016-03-25 14:16:08,9305,8,601608,6,9305,193,9310,918,S
2016-03-25 14:16:08.5,9305,450,602058,428,9305,185,9310,682,S
2016-03-25 14:16:09,9310,764,602822,280,9310,1,9315,306,B
2016-03-25 14:16:09.5,9310,40,602862,-22,9310,79,9315,296,B
2016-03-25 14:16:10,9310,8,602870,-6,9310,339,9315,293,B
2016-03-25 14:16:11,9315,612,603482,-232,9310,375,9320,370,B
2016-03-25 14:16:11.5,9315,2,603484,-2,9315,7,9320,347,B
2016-03-25 14:16:12,9315,2,603486,0,9315,207,9320,334,B
2016-03-25 14:16:12.5,9315,40,603526,-28,9315,195,9320,278,B
2016-03-25 14:16:13,9315,2,603528,-2,9315,196,9320,278,B
2016-03-25 14:16:13.5,9315,48,603576,0,9315,173,9320,277,B
2016-03-25 14:16:14,9320,50,603626,-30,9315,173,9320,295,B
2016-03-25 14:16:15,9315,2,603628,0,9315,172,9320,295,S
2016-03-25 14:16:15.5,9315,4,603632,0,9315,170,9320,285,S
2016-03-25 14:16:16,9320,4,603636,-2,9315,191,9320,284,B
2016-03-25 14:16:16.5,9315,22,603658,-12,9315,182,9320,282,S
2016-03-25 14:16:18,9320,4,603662,0,9315,173,9320,284,B
2016-03-25 14:16:18.5,9320,358,604020,40,9315,256,9320,101,B
2016-03-25 14:16:19,9320,200,604220,-130,9315,249,9320,1,B
2016-03-25 14:16:19.5,9320,2,604222,-2,9320,180,9325,231,B
2016-03-25 14:16:20,9320,76,604298,-30,9320,275,9325,195,B
2016-03-25 14:16:20.5,9320,30,604328,0,9320,267,9325,194,B
2016-03-25 14:16:21,9320,46,604374,-20,9320,251,9325,182,B
2016-03-25 14:16:22,9325,60,604434,-52,9320,301,9325,154,B
2016-03-25 14:16:24,9325,2,604436,-2,9320,300,9325,157,B
2016-03-25 14:16:24.5,9320,2,604438,2,9320,300,9325,157,S
2016-03-25 14:16:25,9325,52,604490,-14,9320,293,9325,122,B
2016-03-25 14:16:26,9320,4,604494,4,9320,271,9325,150,S
2016-03-25 14:16:27,9320,14,604508,2,9320,279,9325,153,S
2016-03-25 14:16:28,9325,14,604522,6,9320,271,9325,152,B
2016-03-25 14:16:29,9320,2,604524,2,9320,284,9325,152,S
2016-03-25 14:16:30,9320,10,604534,0,9320,310,9325,152,S
2016-03-25 14:16:30.5,9320,6,604540,2,9320,310,9325,151,S
2016-03-25 14:16:31,9320,2,604542,2,9320,318,9325,151,S
2016-03-25 14:16:31.5,9325,6,604548,-2,9320,300,9325,149,B
2016-03-25 14:16:32,9320,4,604552,0,9320,300,9325,152,S
2016-03-25 14:16:33,9325,154,604706,114,9320,284,9325,75,B
2016-03-25 14:16:33.5,9325,2,604708,0,9320,283,9325,77,B
2016-03-25 14:16:34,9320,6,604714,4,9320,282,9325,75,S
2016-03-25 14:16:34.5,9325,8,604722,6,9320,281,9325,72,B
2016-03-25 14:16:35,9325,150,604872,-32,9325,79,9330,271,B
2016-03-25 14:16:35.5,9325,44,604916,20,9325,64,9330,259,B
2016-03-25 14:16:36,9330,144,605060,-74,9325,52,9330,207,B
2016-03-25 14:16:36.5,9325,106,605166,-14,9320,217,9325,165,S
2016-03-25 14:16:37,9325,100,605266,-100,9320,219,9325,116,S
2016-03-25 14:16:37.5,9325,6,605272,-4,9320,246,9325,118,S
2016-03-25 14:16:38,9325,4,605276,0,9320,246,9325,117,S
2016-03-25 14:16:38.5,9325,26,605302,-22,9320,256,9325,105,S
2016-03-25 14:16:39,9325,210,605512,-166,9325,157,9330,213,S
2016-03-25 14:16:39.5,9325,234,605746,-50,9320,288,9325,121,S
2016-03-25 14:16:40,9325,4,605750,0,9320,135,9325,125,S
2016-03-25 14:16:41,9325,14,605764,-2,9320,169,9325,120,S
2016-03-25 14:16:41.5,9325,70,605834,-60,9320,166,9325,87,S
2016-03-25 14:16:42,9320,22,605856,0,9320,169,9325,79,S
2016-03-25 14:16:42.5,9325,4,605860,-4,9320,179,9325,78,B
2016-03-25 14:16:43,9325,8,605868,-8,9320,174,9325,74,B
2016-03-25 14:16:43.5,9325,2,605870,-2,9320,141,9325,82,B
2016-03-25 14:16:44,9325,14,605884,0,9320,144,9325,75,B
2016-03-25 14:16:44.5,9325,2,605886,-2,9320,154,9325,75,B
2016-03-25 14:16:45,9325,74,605960,-44,9320,223,9325,45,B
2016-03-25 14:16:45.5,9325,104,606064,-72,9325,99,9330,198,B
2016-03-25 14:16:46,9325,36,606100,-36,9325,92,9330,180,B
2016-03-25 14:16:46.5,9330,10,606110,0,9325,73,9330,175,B
2016-03-25 14:16:47,9325,2,606112,0,9325,266,9330,175,S
2016-03-25 14:16:47.5,9325,80,606192,36,9325,216,9330,247,S
2016-03-25 14:16:48,9330,102,606294,42,9325,199,9330,226,B
2016-03-25 14:16:48.5,9325,6,606300,2,9325,194,9330,235,S
2016-03-25 14:16:49,9325,2,606302,2,9325,191,9330,235,S
2016-03-25 14:16:50,9330,2,606304,0,9325,308,9330,235,B
2016-03-25 14:16:51,9330,2,606306,2,9325,307,9330,235,B
2016-03-25 14:16:51.5,9325,6,606312,6,9325,307,9330,234,S
2016-03-25 14:16:53,9330,76,606388,58,9325,305,9330,197,B
2016-03-25 14:16:54,9330,368,606756,-52,9325,297,9330,15,B
2016-03-25 14:16:54.5,9330,36,606792,0,9330,69,9335,176,B
2016-03-25 14:16:55,9330,6,606798,6,9330,121,9335,143,B
2016-03-25 14:16:56,9335,4,606802,-2,9330,151,9335,133,B
2016-03-25 14:16:57,9335,4,606806,-2,9330,151,9335,131,B
2016-03-25 14:16:57.5,9335,14,606820,-6,9330,149,9335,127,B
2016-03-25 14:16:58,9330,2,606822,2,9330,148,9335,127,S
2016-03-25 14:16:58.5,9335,100,606922,32,9330,148,9335,77,B
2016-03-25 14:16:59,9335,4,606926,4,9330,147,9335,106,B
2016-03-25 14:16:59.5,9335,26,606952,14,9330,173,9335,96,B
2016-03-25 14:17:00,9335,4,606956,0,9330,174,9335,140,B
2016-03-25 14:17:00.5,9335,146,607102,86,9330,174,9335,103,B
2016-03-25 14:17:01,9335,4,607106,-4,9330,190,9335,102,B
2016-03-25 14:17:02,9335,220,607326,-40,9335,28,9340,327,B
2016-03-25 14:17:02.5,9335,14,607340,-10,9335,46,9340,308,B
2016-03-25 14:17:03,9335,4,607344,-2,9335,55,9340,304,B
2016-03-25 14:17:03.5,9335,24,607368,0,9335,46,9340,304,B
2016-03-25 14:17:04,9335,54,607422,20,9335,45,9340,287,B
2016-03-25 14:17:05,9335,70,607492,-14,9330,160,9335,14,B
2016-03-25 14:17:05.5,9335,26,607518,0,9330,160,9335,9,B
2016-03-25 14:17:06,9335,10,607528,6,9330,160,9335,45,B
2016-03-25 14:17:08,9335,14,607542,-8,9330,179,9335,71,B
2016-03-25 14:17:08.5,9335,12,607554,12,9330,179,9335,76,B
2016-03-25 14:17:10,9330,398,607952,218,9325,300,9335,163,S
2016-03-25 14:17:11,9325,586,608538,392,9320,357,9325,176,S
2016-03-25 14:17:11.5,9325,144,608682,122,9325,9,9330,34,S
2016-03-25 14:17:12,9325,130,608812,26,9325,188,9330,72,S
2016-03-25 14:17:13,9325,2,608814,0,9325,188,9330,72,S
2016-03-25 14:17:15,9330,24,608838,-24,9325,192,9330,60,B
2016-03-25 14:17:16,9330,122,608960,-96,9330,295,9335,351,B
2016-03-25 14:17:17,9335,62,609022,-60,9330,266,9335,307,B
2016-03-25 14:17:18,9330,2,609024,0,9330,265,9335,270,S
2016-03-25 14:17:18.5,9330,2,609026,-2,9330,3,9335,265,S
2016-03-25 14:17:19,9330,10,609036,4,9330,28,9335,267,S
2016-03-25 14:17:21,9330,10,609046,-10,9330,28,9335,294,S
2016-03-25 14:17:22,9330,4,609050,4,9330,26,9335,303,S
2016-03-25 14:17:22.5,9330,2,609052,2,9330,25,9335,295,S
2016-03-25 14:17:23,9330,52,609104,-2,9330,4,9335,295,S
2016-03-25 14:17:24,9335,6,609110,4,9330,4,9335,315,B
2016-03-25 14:17:25,9335,6,609116,-2,9330,3,9335,314,B
2016-03-25 14:17:26,9330,2,609118,0,9330,18,9335,315,S
2016-03-25 14:17:27,9330,2,609120,2,9330,17,9335,315,S
2016-03-25 14:17:27.3333,9330,2,609122,2,9330,26,9335,315,S
2016-03-25 14:17:27.6667,9335,6,609128,4,9330,26,9335,317,B
2016-03-25 14:17:29,9330,22,609150,20,9330,34,9335,322,S
2016-03-25 14:17:29.5,9330,2,609152,0,9330,33,9335,331,S
2016-03-25 14:17:30,9335,4,609156,0,9330,41,9335,329,B
2016-03-25 14:17:31,9335,2,609158,2,9330,41,9335,331,B
2016-03-25 14:17:33,9330,2,609160,0,9330,55,9335,336,S
2016-03-25 14:17:34,9330,22,609182,-2,9330,46,9335,341,S
2016-03-25 14:17:35,9330,92,609274,-74,9325,287,9330,32,S
2016-03-25 14:17:35.5,9330,2,609276,-2,9325,287,9330,31,S
2016-03-25 14:17:36,9325,2,609278,0,9325,208,9330,29,S
2016-03-25 14:17:36.5,9330,2,609280,-2,9325,207,9330,32,B
2016-03-25 14:17:37,9330,40,609320,0,9325,207,9330,71,B
2016-03-25 14:17:37.5,9330,10,609330,-10,9325,187,9330,72,B
2016-03-25 14:17:38,9330,2,609332,0,9325,126,9330,99,B
2016-03-25 14:17:38.5,9330,12,609344,12,9325,109,9330,113,B
2016-03-25 14:17:41,9330,60,609404,0,9325,115,9330,85,B
2016-03-25 14:17:48,9330,2,609406,2,9325,130,9330,104,B
2016-03-25 14:17:49,9325,24,609430,-20,9325,118,9330,104,S
2016-03-25 14:17:51,9330,80,609510,32,9325,122,9330,102,B
2016-03-25 14:17:57,9330,230,609740,-152,9330,149,9335,517,B
2016-03-25 14:17:57.5,9330,4,609744,-4,9330,149,9335,517,B
2016-03-25 14:18:01,9330,2,609746,0,9330,252,9335,522,B
2016-03-25 14:18:01.3333,9330,6,609752,0,9330,199,9335,522,B
2016-03-25 14:18:01.6667,9330,2,609754,0,9330,56,9335,522,B
2016-03-25 14:18:02,9330,116,609870,2,9325,149,9330,59,B
2016-03-25 14:18:04,9330,52,609922,-2,9325,150,9330,6,B
2016-03-25 14:18:08,9330,44,609966,-30,9330,121,9335,523,B
2016-03-25 14:18:10,9330,2,609968,0,9330,120,9335,484,B
2016-03-25 14:18:11,9330,4,609972,-2,9330,121,9335,492,B
2016-03-25 14:18:13,9330,2,609974,0,9330,153,9335,413,B
2016-03-25 14:18:14,9330,16,609990,0,9330,145,9335,413,B
2016-03-25 14:18:15,9335,8,609998,0,9330,146,9335,410,B
2016-03-25 14:18:16,9330,12,610010,0,9330,137,9335,409,S
2016-03-25 14:18:16.5,9330,2,610012,0,9330,136,9335,409,S
2016-03-25 14:18:17,9335,2,610014,2,9330,136,9335,407,B
2016-03-25 14:18:18,9330,2,610016,-2,9330,136,9335,408,S
2016-03-25 14:18:19,9330,16,610032,-16,9330,137,9335,407,S
2016-03-25 14:18:19.5,9335,10,610042,10,9330,110,9335,412,B
2016-03-25 14:18:20,9330,8,610050,-8,9330,108,9335,410,S
2016-03-25 14:18:20.5,9335,2,610052,0,9330,108,9335,409,B
2016-03-25 14:18:21,9330,10,610062,0,9330,109,9335,409,S
2016-03-25 14:18:22,9330,84,610146,-62,9330,118,9335,368,S
2016-03-25 14:18:24,9335,20,610166,0,9330,149,9335,358,B
2016-03-25 14:18:26,9335,12,610178,-10,9330,152,9335,352,B
2016-03-25 14:18:27,9330,4,610182,-2,9330,151,9335,351,S
2016-03-25 14:18:28,9330,2,610184,0,9330,376,9335,351,S
2016-03-25 14:18:29,9330,4,610188,0,9330,375,9335,351,S
2016-03-25 14:18:36,9335,2,610190,-2,9330,169,9335,371,B
2016-03-25 14:18:36.5,9335,40,610230,-38,9330,169,9335,351,B
2016-03-25 14:18:38,9335,2,610232,-2,9330,172,9335,350,B
2016-03-25 14:18:39,9335,2,610234,-2,9330,175,9335,349,B
2016-03-25 14:18:41,9330,2,610236,-2,9330,175,9335,350,S
2016-03-25 14:18:42,9330,2,610238,0,9330,175,9335,350,S
2016-03-25 14:18:43,9330,2,610240,0,9330,174,9335,340,S
2016-03-25 14:18:44,9335,200,610440,0,9330,174,9335,240,B
2016-03-25 14:18:44.5,9335,154,610594,-112,9330,99,9335,162,B
2016-03-25 14:18:45,9335,320,610914,104,9335,70,9340,269,B
2016-03-25 14:18:45.5,9335,16,610930,0,9335,75,9340,301,B
2016-03-25 14:18:47,9335,20,610950,0,9335,39,9340,343,B
2016-03-25 14:18:47.3333,9340,2,610952,0,9335,49,9340,342,B
2016-03-25 14:18:47.6667,9340,8,610960,-8,9335,50,9340,338,B
2016-03-25 14:18:48,9340,6,610966,-4,9335,50,9340,336,B
2016-03-25 14:18:48.5,9335,44,611010,22,9335,70,9340,316,S
2016-03-25 14:18:50,9335,136,611146,-98,9335,1,9340,329,S
2016-03-25 14:18:50.5,9335,6,611152,-2,9330,169,9335,61,S
2016-03-25 14:18:51,9335,4,611156,-2,9330,162,9335,53,S
2016-03-25 14:18:52,9335,190,611346,-174,9330,215,9335,21,S
2016-03-25 14:18:52.5,9335,42,611388,-32,9335,51,9340,329,S
2016-03-25 14:18:53,9340,6,611394,0,9335,54,9340,326,B
2016-03-25 14:18:53.5,9340,2,611396,2,9335,55,9340,325,B
2016-03-25 14:18:54,9340,2,611398,0,9335,84,9340,324,B
2016-03-25 14:18:55,9335,6,611404,0,9335,93,9340,325,S
2016-03-25 14:18:56,9340,2,611406,2,9335,75,9340,324,B
2016-03-25 14:18:56.5,9340,2,611408,2,9335,82,9340,323,B
2016-03-25 14:18:57,9340,8,611416,4,9335,85,9340,320,B
2016-03-25 14:18:58,9340,6,611422,6,9335,191,9340,329,B
2016-03-25 14:18:58.5,9340,102,611524,90,9335,192,9340,257,B
2016-03-25 14:18:59,9335,6,611530,0,9335,162,9340,257,S
2016-03-25 14:18:59.5,9340,30,611560,-6,9335,165,9340,237,B
2016-03-25 14:19:00,9340,2,611562,0,9335,160,9340,246,B
2016-03-25 14:19:03,9335,6,611568,0,9335,101,9340,724,S
2016-03-25 14:19:03.5,9340,2,611570,0,9335,101,9340,724,B
2016-03-25 14:19:04,9335,40,611610,-24,9335,132,9340,715,S
2016-03-25 14:19:05,9335,2,611612,-2,9335,133,9340,717,S
2016-03-25 14:19:07,9340,4,611616,-2,9335,186,9340,715,B
2016-03-25 14:19:07.5,9340,16,611632,-14,9335,186,9340,707,B
2016-03-25 14:19:09,9335,18,611650,-4,9335,190,9340,213,S
2016-03-25 14:19:09.5,9340,42,611692,-18,9335,190,9340,192,B
2016-03-25 14:19:10,9340,104,611796,-2,9335,192,9340,139,B
2016-03-25 14:19:10.5,9340,24,611820,0,9335,192,9340,127,B
2016-03-25 14:19:11,9335,2,611822,0,9335,196,9340,127,S
2016-03-25 14:19:11.5,9340,12,611834,-8,9335,275,9340,121,B
2016-03-25 14:19:12,9340,2,611836,0,9335,284,9340,125,B
2016-03-25 14:19:12.5,9340,60,611896,-26,9335,295,9340,95,B
2016-03-25 14:19:13,9335,50,611946,-42,9335,282,9340,99,S
2016-03-25 14:19:13.5,9340,10,611956,10,9335,295,9340,94,B
2016-03-25 14:19:14,9340,70,612026,0,9335,295,9340,59,B
2016-03-25 14:19:15,9340,22,612048,0,9335,324,9340,60,B
2016-03-25 14:19:15.5,9340,2,612050,2,9335,324,9340,58,B
2016-03-25 14:19:16,9340,60,612110,14,9335,225,9340,28,B
2016-03-25 14:19:17,9340,4,612114,0,9335,224,9340,27,B
2016-03-25 14:19:17.5,9340,4,612118,-2,9335,278,9340,34,B
2016-03-25 14:19:18,9340,46,612164,34,9335,279,9340,11,B
2016-03-25 14:19:18.5,9340,22,612186,-14,9340,234,9345,294,B
2016-03-25 14:19:19,9345,20,612206,18,9340,228,9345,281,B
2016-03-25 14:19:19.5,9345,146,612352,-64,9340,241,9345,166,B
2016-03-25 14:19:20,9345,10,612362,-2,9340,240,9345,164,B
2016-03-25 14:19:21,9340,408,612770,104,9340,37,9345,164,S
2016-03-25 14:19:21.5,9340,72,612842,-10,9335,257,9340,139,S
2016-03-25 14:19:22,9340,30,612872,0,9335,167,9340,132,S
2016-03-25 14:19:22.5,9340,110,612982,-68,9335,157,9340,80,S
2016-03-25 14:19:23,9340,10,612992,-8,9335,156,9340,61,S
2016-03-25 14:19:23.5,9340,122,613114,-46,9340,39,9345,254,S
2016-03-25 14:19:24,9345,172,613286,-30,9340,2,9345,246,B
2016-03-25 14:19:24.5,9340,22,613308,-4,9335,157,9340,262,S
2016-03-25 14:19:25,9340,2,613310,2,9335,155,9340,262,S
2016-03-25 14:19:26,9340,22,613332,-20,9335,205,9345,273,S
2016-03-25 14:19:26.5,9340,8,613340,-2,9335,207,9345,297,S
2016-03-25 14:19:27,9340,202,613542,-174,9335,208,9340,6,S
2016-03-25 14:19:27.5,9335,16,613558,-12,9335,206,9340,10,S
2016-03-25 14:19:28,9340,46,613604,18,9335,208,9340,32,B
2016-03-25 14:19:28.5,9340,76,613680,0,9340,5,9345,202,B
2016-03-25 14:19:29,9340,56,613736,-6,9335,168,9340,138,B
2016-03-25 14:19:29.5,9340,22,613758,-22,9335,168,9340,128,B
2016-03-25 14:19:31,9335,10,613768,-10,9335,164,9340,130,S
2016-03-25 14:19:32,9335,10,613778,-10,9335,159,9340,131,S
2016-03-25 14:19:32.5,9335,12,613790,-12,9335,153,9340,132,S
2016-03-25 14:19:33,9340,50,613840,-8,9335,148,9340,111,B
2016-03-25 14:19:33.5,9335,8,613848,-4,9335,173,9340,112,S
2016-03-25 14:19:34,9335,74,613922,-38,9335,167,9340,83,S
2016-03-25 14:19:34.5,9335,8,613930,0,9335,165,9340,87,S
2016-03-25 14:19:35,9340,18,613948,-12,9335,158,9340,94,B
2016-03-25 14:19:35.5,9335,8,613956,-2,9335,155,9340,141,S
2016-03-25 14:19:36,9335,2,613958,0,9335,155,9340,146,S
2016-03-25 14:19:36.5,9340,18,613976,18,9335,157,9340,137,B
2016-03-25 14:19:37,9340,14,613990,-6,9335,151,9340,137,B
2016-03-25 14:19:37.5,9340,4,613994,0,9335,151,9340,136,B
2016-03-25 14:19:39,9340,20,614014,0,9335,351,9340,167,B
2016-03-25 14:19:39.5,9340,56,614070,40,9335,351,9340,139,B
2016-03-25 14:19:40,9340,8,614078,0,9335,585,9340,88,B
2016-03-25 14:19:40.5,9340,178,614256,132,9335,587,9345,223,B
2016-03-25 14:19:41,9340,10,614266,-10,9340,73,9345,173,B
2016-03-25 14:19:44,9340,6,614272,0,9340,352,9345,110,B
2016-03-25 14:19:44.5,9340,2,614274,-2,9340,352,9345,110,B
2016-03-25 14:19:45,9340,4,614278,0,9340,372,9345,112,B
2016-03-25 14:19:46,9340,44,614322,-2,9340,370,9345,90,B
2016-03-25 14:19:46.5,9345,16,614338,-4,9340,370,9345,132,B
2016-03-25 14:19:47,9340,8,614346,-8,9340,366,9345,156,S
2016-03-25 14:19:48,9340,2,614348,0,9340,365,9345,157,S
2016-03-25 14:19:48.5,9345,2,614350,0,9340,365,9345,156,B
2016-03-25 14:19:49,9340,16,614366,-4,9340,357,9345,163,S
2016-03-25 14:19:50,9345,6,614372,-4,9340,356,9345,164,B
2016-03-25 14:19:51,9345,2,614374,2,9340,356,9345,210,B
2016-03-25 14:19:53,9340,12,614386,-8,9340,358,9345,255,S
2016-03-25 14:19:54,9340,2,614388,-2,9340,357,9345,257,S
2016-03-25 14:19:54.5,9340,246,614634,-178,9335,156,9340,111,S
2016-03-25 14:19:55,9335,2,614636,-2,9335,149,9340,114,S
2016-03-25 14:19:55.5,9335,4,614640,-4,9335,138,9340,119,S
2016-03-25 14:19:56,9335,2,614642,-2,9335,136,9340,122,S
2016-03-25 14:19:57,9340,44,614686,-42,9335,136,9340,101,B
2016-03-25 14:19:58,9340,20,614706,-20,9335,136,9340,93,B
2016-03-25 14:19:59,9340,4,614710,-4,9335,161,9340,91,B
2016-03-25 14:20:01,9335,4,614714,0,9335,161,9340,136,S
2016-03-25 14:20:02,9335,4,614718,0,9335,159,9340,136,S
2016-03-25 14:20:06,9340,2,614720,0,9335,570,9340,138,B
2016-03-25 14:20:07,9335,4,614724,4,9335,568,9340,121,S
2016-03-25 14:20:08,9340,2,614726,0,9335,566,9340,133,B
2016-03-25 14:20:11,9340,10,614736,-10,9335,556,9340,134,B
2016-03-25 14:20:12,9335,2,614738,2,9335,560,9340,138,S
2016-03-25 14:20:12.5,9340,12,614750,0,9335,556,9340,136,B
2016-03-25 14:20:15,9340,2,614752,-2,9335,556,9340,178,B
2016-03-25 14:20:15.5,9340,2,614754,0,9335,556,9340,178,B
2016-03-25 14:20:16,9340,42,614796,-42,9335,556,9340,156,B
2016-03-25 14:20:19,9340,110,614906,16,9335,557,9340,62,B
2016-03-25 14:20:20,9340,120,615026,80,9340,196,9345,289,B
2016-03-25 14:20:20.5,9345,2,615028,0,9340,193,9345,287,B
2016-03-25 14:20:22,9340,34,615062,-34,9340,206,9345,288,S
2016-03-25 14:20:23,9340,2,615064,0,9340,206,9345,298,S
2016-03-25 14:20:24,9340,76,615140,0,9340,168,9345,298,S
2016-03-25 14:20:25,9340,22,615162,-22,9340,158,9345,299,S
2016-03-25 14:20:25.5,9345,2,615164,-2,9340,158,9345,298,B
2016-03-25 14:20:26,9340,4,615168,-4,9340,156,9345,298,S
2016-03-25 14:20:26.5,9340,2,615170,0,9340,154,9345,298,S
2016-03-25 14:20:27,9340,40,615210,-26,9340,134,9345,301,S
2016-03-25 14:20:29,9345,2,615212,0,9340,135,9345,314,B
2016-03-25 14:20:31,9340,2,615214,0,9340,134,9345,314,S
2016-03-25 14:20:33,9345,100,615314,-50,9340,136,9345,263,B
2016-03-25 14:20:40,9340,2,615316,2,9340,139,9345,273,S
2016-03-25 14:20:41,9340,8,615324,8,9340,142,9345,273,S
2016-03-25 14:20:44,9345,4,615328,-4,9340,145,9345,279,B
2016-03-25 14:20:45,9340,2,615330,2,9340,145,9345,280,S
2016-03-25 14:20:46,9345,2,615332,2,9340,548,9345,279,B
2016-03-25 14:20:47,9345,200,615532,142,9340,548,9345,187,B
2016-03-25 14:20:47.5,9345,74,615606,20,9340,548,9345,149,B
2016-03-25 14:20:48,9345,4,615610,4,9340,548,9345,147,B
2016-03-25 14:20:50,9345,2,615612,0,9340,578,9345,145,B
2016-03-25 14:20:50.5,9345,62,615674,0,9340,548,9345,144,B
2016-03-25 14:20:51,9345,288,615962,202,9340,145,9350,403,B
2016-03-25 14:20:51.5,9345,48,616010,2,9340,197,9350,396,B
2016-03-25 14:20:52,9350,14,616024,2,9345,72,9350,375,B
2016-03-25 14:20:52.5,9350,42,616066,0,9345,26,9350,367,B
2016-03-25 14:20:53,9350,60,616126,-28,9345,87,9350,336,B
2016-03-25 14:20:53.5,9350,12,616138,6,9345,101,9350,341,B
2016-03-25 14:20:54,9350,2,616140,2,9345,103,9350,341,B
2016-03-25 14:20:55,9350,550,616690,106,9345,85,9350,63,B
2016-03-25 14:20:55.5,9350,26,616716,22,9345,143,9350,51,B
2016-03-25 14:20:56,9345,6,616722,6,9345,199,9350,49,S
2016-03-25 14:20:56.5,9345,90,616812,50,9345,210,9350,9,S
2016-03-25 14:20:57,9350,18,616830,8,9350,31,9355,254,B
2016-03-25 14:20:57.5,9355,38,616868,18,9350,18,9355,249,B
2016-03-25 14:20:58,9350,24,616892,-14,9345,211,9350,10,S
2016-03-25 14:20:58.5,9350,10,616902,-10,9345,164,9350,14,S
2016-03-25 14:20:59,9350,4,616906,-4,9345,157,9350,513,S
2016-03-25 14:21:00,9350,4,616910,-4,9345,146,9350,1616,S
2016-03-25 14:21:00.5,9350,206,617116,64,9340,192,9350,1666,S
2016-03-25 14:21:01,9345,160,617276,-30,9340,362,9345,205,S
2016-03-25 14:21:02,9345,292,617568,136,9340,351,9345,76,S
2016-03-25 14:21:02.5,9340,146,617714,26,9340,319,9345,13,S
2016-03-25 14:21:03,9345,82,617796,20,9345,103,9350,618,B
2016-03-25 14:21:03.5,9345,2,617798,-2,9345,113,9350,618,B
2016-03-25 14:21:04,9350,10,617808,4,9345,133,9350,614,B
2016-03-25 14:21:05,9350,4,617812,-4,9345,133,9350,180,B
2016-03-25 14:21:05.5,9350,14,617826,-10,9345,143,9350,189,B
2016-03-25 14:21:06,9345,2,617828,0,9345,143,9350,242,S
2016-03-25 14:21:08,9345,20,617848,0,9345,140,9350,262,S
2016-03-25 14:21:09,9345,2,617850,0,9345,144,9350,265,S
2016-03-25 14:21:09.5,9350,4,617854,2,9345,144,9350,278,B
2016-03-25 14:21:10,9350,28,617882,-2,9345,143,9350,269,B
2016-03-25 14:21:11,9350,2,617884,-2,9345,144,9350,283,B
2016-03-25 14:21:11.5,9350,2,617886,-2,9345,146,9350,287,B
2016-03-25 14:21:13,9345,2,617888,-2,9345,151,9350,309,S
2016-03-25 14:21:14,9345,302,618190,26,9340,159,9350,360,S
2016-03-25 14:21:15,9340,4,618194,-2,9340,157,9345,15,S
2016-03-25 14:21:15.5,9340,4,618198,0,9340,158,9345,30,S
2016-03-25 14:21:16,9345,6,618204,-4,9340,164,9345,80,B
2016-03-25 14:21:16.5,9345,6,618210,0,9340,164,9345,86,B
2016-03-25 14:21:18,9345,40,618250,-40,9340,649,9345,107,B
2016-03-25 14:21:20,9340,2,618252,2,9340,208,9345,130,S
2016-03-25 14:21:22,9340,2,618254,2,9340,211,9345,137,S
2016-03-25 14:21:22.5,9340,40,618294,0,9340,189,9345,137,S
2016-03-25 14:21:24,9340,2,618296,0,9340,196,9345,138,S
2016-03-25 14:21:26,9345,2,618298,-2,9340,204,9345,150,B
2016-03-25 14:21:28,9345,20,618318,-20,9340,204,9345,143,B
2016-03-25 14:21:29,9340,2,618320,2,9340,203,9345,214,S
2016-03-25 14:21:32,9345,2,618322,-2,9340,224,9345,160,B
2016-03-25 14:21:34,9340,2,618324,2,9340,234,9345,164,S
2016-03-25 14:21:34.5,9345,2,618326,0,9340,235,9345,163,B
2016-03-25 14:21:35,9345,42,618368,36,9340,215,9345,146,B
2016-03-25 14:21:35.5,9340,6,618374,6,9340,212,9345,146,S
2016-03-25 14:21:37,9345,28,618402,28,9340,213,9345,137,B
2016-03-25 14:21:38,9340,2,618404,2,9340,212,9345,136,S
2016-03-25 14:21:40,9345,254,618658,152,9340,213,9345,192,B
2016-03-25 14:21:43,9340,8,618666,8,9340,211,9345,74,S
2016-03-25 14:21:44,9345,2,618668,2,9340,211,9345,73,B
2016-03-25 14:21:45,9345,32,618700,18,9340,207,9345,63,B
2016-03-25 14:21:46,9345,2,618702,0,9340,308,9345,66,B
2016-03-25 14:21:47,9340,60,618762,-30,9340,278,9345,66,S
2016-03-25 14:21:48,9345,6,618768,4,9340,278,9345,63,B
2016-03-25 14:21:49,9345,80,618848,4,9340,279,9350,264,B
2016-03-25 14:21:50,9340,24,618872,-16,9340,269,9345,25,S
2016-03-25 14:21:51,9345,40,618912,10,9340,270,9345,9,B
2016-03-25 14:21:53,9345,80,618992,60,9340,270,9345,48,B
2016-03-25 14:21:55,9345,80,619072,-2,9340,272,9345,9,B
2016-03-25 14:21:56,9345,4,619076,2,9340,272,9350,226,B
2016-03-25 14:21:56.5,9345,22,619098,4,9340,272,9345,4,B
2016-03-25 14:21:58,9345,20,619118,-12,9340,273,9345,3,B
2016-03-25 14:21:58.5,9345,6,619124,0,9345,37,9350,287,B
2016-03-25 14:21:59,9345,86,619210,8,9340,273,9345,12,B
2016-03-25 14:21:59.5,9350,34,619244,-20,9345,84,9350,358,B
2016-03-25 14:22:00,9350,2,619246,0,9345,84,9350,348,B
2016-03-25 14:22:01,9345,4,619250,0,9345,87,9350,297,S
2016-03-25 14:22:01.5,9350,4,619254,2,9345,88,9350,285,B
2016-03-25 14:22:02,9345,4,619258,-2,9345,87,9350,284,S
2016-03-25 14:22:02.5,9345,2,619260,0,9345,115,9350,284,S
2016-03-25 14:22:03,9345,4,619264,-4,9345,114,9350,284,S
2016-03-25 14:22:04,9350,2,619266,-2,9345,114,9350,283,B
2016-03-25 14:22:05,9345,8,619274,-6,9345,110,9350,326,S
2016-03-25 14:22:05.5,9350,2,619276,-2,9345,112,9350,323,B
2016-03-25 14:22:06,9350,12,619288,6,9345,112,9350,317,B
2016-03-25 14:22:08,9345,2,619290,0,9345,130,9350,320,S
2016-03-25 14:22:10,9350,4,619294,0,9345,136,9350,309,B
2016-03-25 14:22:11,9345,6,619300,-6,9345,134,9350,310,S
2016-03-25 14:22:12,9345,2,619302,0,9345,133,9350,310,S
2016-03-25 14:22:13,9345,40,619342,-20,9345,128,9350,311,S
2016-03-25 14:22:16,9345,4,619346,-2,9345,127,9350,310,S
2016-03-25 14:22:21,9345,6,619352,0,9345,159,9350,349,S
2016-03-25 14:22:22,9345,10,619362,0,9345,123,9350,360,S
2016-03-25 14:22:24,9350,14,619376,0,9345,157,9350,361,B
2016-03-25 14:22:25,9350,6,619382,6,9345,157,9350,358,B
2016-03-25 14:22:26,9345,16,619398,0,9345,144,9350,360,S
2016-03-25 14:22:26.5,9345,44,619442,-2,9345,142,9350,341,S
2016-03-25 14:22:27,9345,2,619444,0,9345,141,9350,341,S
2016-03-25 14:22:27.5,9345,4,619448,-4,9345,141,9350,341,S
2016-03-25 14:22:29,9345,104,619552,-68,9345,110,9350,347,S
2016-03-25 14:22:30,9345,220,619772,32,9340,539,9345,127,S
2016-03-25 14:22:30.5,9345,20,619792,-20,9340,529,9345,715,S
2016-03-25 14:22:31,9345,2,619794,0,9340,530,9345,732,S
2016-03-25 14:22:31.5,9340,10,619804,-2,9340,526,9345,240,S
2016-03-25 14:22:33,9340,2,619806,0,9340,536,9345,241,S
2016-03-25 14:22:33.5,9345,20,619826,0,9340,536,9345,231,B
2016-03-25 14:22:35,9340,2,619828,2,9340,555,9345,232,S
2016-03-25 14:22:35.5,9345,6,619834,-6,9340,555,9345,232,B
2016-03-25 14:22:36,9340,2,619836,2,9340,554,9345,232,S
2016-03-25 14:22:37,9345,2,619838,-2,9340,554,9345,237,B
2016-03-25 14:22:40,9340,8,619846,8,9340,550,9345,239,S
2016-03-25 14:22:41,9345,82,619928,-12,9340,539,9345,208,B
2016-03-25 14:22:42,9345,112,620040,-32,9340,231,9345,151,B
2016-03-25 14:22:43,9345,20,620060,20,9340,230,9345,141,B
2016-03-25 14:22:44,9340,2,620062,-2,9340,229,9345,708,S
2016-03-25 14:22:45,9340,4,620066,-4,9340,227,9345,708,S
2016-03-25 14:22:46,9340,2,620068,-2,9340,226,9345,709,S
2016-03-25 14:22:48,9340,30,620098,-28,9340,206,9345,216,S
2016-03-25 14:22:50,9340,8,620106,0,9340,198,9345,219,S
2016-03-25 14:22:52,9340,2,620108,-2,9340,223,9345,219,S
2016-03-25 14:22:52.5,9340,2,620110,0,9340,225,9345,219,S
2016-03-25 14:22:53,9340,6,620116,-4,9340,222,9345,219,S
2016-03-25 14:22:57,9345,328,620444,132,9345,72,9350,430,B
2016-03-25 14:22:58,9345,4,620448,0,9345,312,9350,430,B
2016-03-25 14:22:59,9345,2,620450,2,9345,322,9350,430,B
2016-03-25 14:23:00,9345,102,620552,38,9345,271,9350,430,B
2016-03-25 14:23:02,9345,2,620554,-2,9345,270,9350,443,B
2016-03-25 14:23:02.5,9345,2,620556,-2,9345,269,9350,443,B
2016-03-25 14:23:03,9350,16,620572,-14,9345,259,9350,432,B
2016-03-25 14:23:07,9345,12,620584,-12,9345,257,9350,433,S
2016-03-25 14:23:08,9345,2,620586,0,9345,256,9350,434,S
2016-03-25 14:23:09,9345,10,620596,-10,9345,251,9350,435,S
2016-03-25 14:23:09.5,9350,2,620598,2,9345,251,9350,434,B
2016-03-25 14:23:10,9345,2,620600,-2,9345,250,9350,435,S
2016-03-25 14:23:11,9345,6,620606,0,9345,249,9350,431,S
2016-03-25 14:23:11.5,9345,2,620608,-2,9345,247,9350,431,S
2016-03-25 14:23:12,9350,2,620610,0,9345,250,9350,430,B
2016-03-25 14:23:13,9350,10,620620,0,9345,250,9350,445,B
2016-03-25 14:23:13.5,9350,22,620642,4,9345,250,9350,434,B
2016-03-25 14:23:14,9350,20,620662,0,9345,250,9350,424,B
2016-03-25 14:23:17,9345,4,620666,0,9345,252,9350,392,S
2016-03-25 14:23:18,9345,2,620668,-2,9345,252,9350,391,S
2016-03-25 14:23:20,9345,22,620690,-2,9345,242,9350,391,S
2016-03-25 14:23:22,9345,2,620692,0,9345,241,9350,393,S
2016-03-25 14:23:24,9350,2,620694,-2,9345,242,9350,392,B
2016-03-25 14:23:27,9350,2,620696,0,9345,239,9350,387,B
2016-03-25 14:23:30,9350,2,620698,-2,9345,245,9350,386,B
2016-03-25 14:23:30.5,9350,2,620700,0,9345,245,9350,419,B
2016-03-25 14:23:32,9350,400,621100,-350,9345,245,9350,220,B
2016-03-25 14:23:38,9350,4,621104,0,9345,245,9350,223,B
2016-03-25 14:23:43,9350,2,621106,0,9345,332,9350,168,B
2016-03-25 14:23:44,9345,2,621108,0,9345,346,9350,168,S
2016-03-25 14:23:46,9350,18,621126,0,9345,347,9350,160,B
2016-03-25 14:23:47,9345,2,621128,0,9345,346,9350,161,S
2016-03-25 14:23:47.5,9350,6,621134,2,9345,346,9350,158,B
2016-03-25 14:23:48,9345,4,621138,0,9345,344,9350,158,S
2016-03-25 14:23:51,9345,8,621146,-8,9345,340,9350,161,S
2016-03-25 14:23:55,9350,2,621148,-2,9345,345,9350,220,B
2016-03-25 14:23:58,9345,278,621426,76,9340,529,9345,73,S
2016-03-25 14:23:58.5,9345,2,621428,0,9340,615,9345,83,S
2016-03-25 14:23:59,9345,2,621430,2,9340,620,9345,89,S
2016-03-25 14:24:01,9345,2,621432,2,9340,620,9345,88,S
2016-03-25 14:24:04,9340,60,621492,4,9340,606,9345,104,S
2016-03-25 14:24:05,9340,4,621496,0,9340,390,9345,104,S
2016-03-25 14:24:06,9345,212,621708,192,9345,545,9350,298,B
2016-03-25 14:24:07,9345,40,621748,0,9345,525,9350,329,B
2016-03-25 14:24:08,9345,2,621750,2,9345,525,9350,329,B
2016-03-25 14:24:09,9345,2,621752,2,9345,524,9350,331,B
2016-03-25 14:24:10,9350,78,621830,8,9345,490,9350,325,B
2016-03-25 14:24:11,9345,2,621832,2,9345,504,9350,332,S
2016-03-25 14:24:12,9345,2,621834,2,9345,503,9350,338,S
2016-03-25 14:24:14,9345,116,621950,10,9345,445,9350,271,S
2016-03-25 14:24:15,9345,2,621952,0,9345,444,9350,281,S
2016-03-25 14:24:18,9350,2,621954,0,9345,70,9350,336,B
2016-03-25 14:24:19,9345,2,621956,0,9345,74,9350,334,S
2016-03-25 14:24:20,9345,44,622000,-22,9340,709,9345,56,S
2016-03-25 14:24:21,9345,50,622050,-30,9340,709,9345,36,S
2016-03-25 14:24:21.5,9345,20,622070,14,9345,24,9350,353,S
2016-03-25 14:24:22,9350,12,622082,0,9345,35,9350,358,B
2016-03-25 14:24:23,9345,18,622100,6,9340,708,9345,50,S
2016-03-25 14:24:23.5,9345,40,622140,40,9340,708,9345,36,S
2016-03-25 14:24:24,9345,14,622154,14,9345,26,9350,358,S
2016-03-25 14:24:25,9345,2,622156,0,9345,23,9350,358,S
2016-03-25 14:24:25.5,9345,20,622176,-18,9340,708,9345,16,S
2016-03-25 14:24:27,9345,10,622186,0,9340,708,9345,11,S
2016-03-25 14:24:28,9345,6,622192,-4,9340,708,9345,13,S
2016-03-25 14:24:29,9345,2,622194,-2,9340,708,9345,12,S
2016-03-25 14:24:32,9345,20,622214,-2,9340,713,9345,2,S
2016-03-25 14:24:32.5,9345,50,622264,-26,9345,18,9350,398,S
2016-03-25 14:24:33,9345,10,622274,-2,9345,11,9350,398,S
2016-03-25 14:24:37,9345,2,622276,0,9345,34,9350,401,S
2016-03-25 14:24:38,9345,2,622278,0,9345,33,9350,401,S
2016-03-25 14:24:39,9345,2,622280,0,9345,42,9350,406,S
2016-03-25 14:24:41,9350,34,622314,0,9345,35,9350,392,B
2016-03-25 14:24:41.5,9345,20,622334,-20,9345,26,9350,392,S
2016-03-25 14:24:42,9345,2,622336,2,9345,25,9350,395,S
2016-03-25 14:24:44,9350,2,622338,0,9345,28,9350,393,B
2016-03-25 14:24:44.5,9345,4,622342,4,9345,26,9350,393,S
2016-03-25 14:24:47,9350,2,622344,2,9345,29,9350,392,B
2016-03-25 14:24:48,9345,14,622358,12,9345,27,9350,393,S
2016-03-25 14:24:49,9345,100,622458,66,9340,675,9345,6,S
2016-03-25 14:24:50,9345,16,622474,4,9345,16,9350,358,S
2016-03-25 14:24:51,9345,6,622480,0,9345,16,9350,358,S
2016-03-25 14:24:51.5,9345,2,622482,2,9345,5,9350,358,S
2016-03-25 14:24:52,9345,2,622484,0,9345,25,9350,360,S
2016-03-25 14:24:53,9345,2,622486,0,9345,26,9350,359,S
2016-03-25 14:24:54,9345,38,622524,0,9345,58,9350,340,S
2016-03-25 14:25:00,9345,2,622526,2,9345,67,9350,341,S
2016-03-25 14:25:01,9350,12,622538,2,9345,67,9350,337,B
2016-03-25 14:25:02,9350,2,622540,0,9345,81,9350,904,B
2016-03-25 14:25:03,9345,2,622542,-2,9345,80,9350,904,S
2016-03-25 14:25:05,9345,2,622544,-2,9345,96,9350,1129,S
2016-03-25 14:25:06,9345,2,622546,0,9345,108,9350,1129,S
2016-03-25 14:25:06.5,9345,40,622586,40,9345,88,9350,1128,S
2016-03-25 14:25:07,9345,26,622612,26,9345,103,9350,1128,S
2016-03-25 14:25:08,9350,1254,623866,-706,9350,101,9355,537,B
2016-03-25 14:25:09,9350,8,623874,6,9350,101,9355,536,B
2016-03-25 14:25:09.5,9355,20,623894,-8,9350,216,9355,504,B
2016-03-25 14:25:10,9350,46,623940,26,9350,238,9355,473,S
2016-03-25 14:25:10.5,9355,4,623944,0,9350,237,9355,472,B
2016-03-25 14:25:11,9355,4,623948,-4,9350,237,9355,483,B
2016-03-25 14:25:11.5,9355,4,623952,-4,9350,237,9355,491,B
2016-03-25 14:25:12,9355,4,623956,-4,9350,237,9355,399,B
2016-03-25 14:25:13,9350,6,623962,6,9350,234,9355,358,S
2016-03-25 14:25:14,9350,2,623964,2,9350,233,9355,358,S
2016-03-25 14:25:15,9350,52,624016,2,9350,207,9355,389,S
2016-03-25 14:25:15.5,9355,4,624020,0,9350,207,9355,387,B
2016-03-25 14:25:16,9355,8,624028,-8,9350,207,9355,383,B
2016-03-25 14:25:18,9355,6,624034,-6,9350,207,9355,389,B
2016-03-25 14:25:18.5,9350,6,624040,6,9350,204,9355,389,S
2016-03-25 14:25:20,9350,2,624042,0,9350,104,9355,389,S
2016-03-25 14:25:21,9355,2,624044,0,9350,105,9355,389,B
2016-03-25 14:25:22,9350,2,624046,2,9350,104,9355,389,S
2016-03-25 14:25:24,9350,44,624090,26,9350,82,9355,462,S
2016-03-25 14:25:24.5,9350,164,624254,-120,9345,176,9350,56,S
2016-03-25 14:25:25,9350,2,624256,-2,9345,177,9350,89,S
2016-03-25 14:25:25.5,9350,2,624258,0,9345,177,9350,91,S
2016-03-25 14:25:26,9350,6,624264,-6,9345,160,9350,89,S
2016-03-25 14:25:27,9350,2,624266,0,9345,143,9350,95,S
2016-03-25 14:25:29,9350,2,624268,-2,9345,143,9350,257,S
2016-03-25 14:25:31,9350,14,624282,-4,9345,146,9350,256,S
2016-03-25 14:25:34,9345,2,624284,2,9345,145,9350,257,S
2016-03-25 14:25:34.5,9350,4,624288,2,9345,155,9350,255,B
2016-03-25 14:25:35,9350,2,624290,2,9345,166,9350,254,B
2016-03-25 14:25:37,9345,2,624292,2,9345,166,9350,264,S
2016-03-25 14:25:45,9350,10,624302,-8,9345,194,9350,267,B
2016-03-25 14:25:45.5,9345,12,624314,12,9345,188,9350,270,S
2016-03-25 14:25:48,9345,4,624318,0,9345,177,9350,271,S
2016-03-25 14:25:48.5,9350,10,624328,-10,9345,177,9350,267,B
2016-03-25 14:26:07,9345,2,624330,2,9345,205,9350,438,S
2016-03-25 14:26:09,9350,110,624440,-110,9345,205,9350,384,B
2016-03-25 14:26:09.5,9345,12,624452,6,9345,199,9350,390,S
2016-03-25 14:26:10,9345,10,624462,0,9345,194,9350,391,S
2016-03-25 14:26:23,9345,2,624464,-2,9345,266,9350,396,S
2016-03-25 14:26:26,9345,84,624548,28,9345,236,9350,395,S
2016-03-25 14:26:27,9350,2,624550,-2,9345,236,9350,394,B
2016-03-25 14:26:29,9350,2,624552,-2,9345,236,9350,394,B
2016-03-25 14:26:30,9345,352,624904,108,9340,358,9345,54,S
2016-03-25 14:26:30.5,9345,66,624970,66,9340,358,9345,21,S
2016-03-25 14:26:31,9345,60,625030,4,9345,147,9350,394,S
2016-03-25 14:26:31.5,9350,18,625048,-4,9345,140,9350,392,B
2016-03-25 14:26:34,9345,2,625050,-2,9345,144,9350,398,S
2016-03-25 14:26:38,9350,2,625052,-2,9345,144,9350,407,B
2016-03-25 14:26:45,9345,2,625054,0,9345,145,9350,661,S
2016-03-25 14:26:46,9345,8,625062,-2,9345,141,9350,661,S
2016-03-25 14:26:51,9345,4,625066,0,9345,144,9350,657,S
2016-03-25 14:26:52,9345,286,625352,-6,9340,338,9345,21,S
2016-03-25 14:26:53,9340,238,625590,138,9340,232,9345,74,S
2016-03-25 14:26:53.5,9345,20,625610,0,9340,237,9345,83,B
2016-03-25 14:26:57,9345,60,625670,-60,9340,282,9345,55,B
2016-03-25 14:27:02,9340,10,625680,-8,9340,278,9345,61,S
2016-03-25 14:27:03,9345,2,625682,-2,9340,277,9345,60,B
2016-03-25 14:27:08,9340,10,625692,0,9340,212,9345,65,S
2016-03-25 14:27:10,9340,2,625694,0,9340,259,9345,77,S
2016-03-25 14:27:15,9340,2,625696,-2,9340,258,9345,89,S
2016-03-25 14:27:18,9340,2,625698,0,9340,259,9345,113,S
2016-03-25 14:27:19,9340,4,625702,4,9340,162,9345,114,S
2016-03-25 14:27:19.5,9340,20,625722,18,9340,134,9345,108,S
2016-03-25 14:27:20,9340,32,625754,-4,9340,113,9345,110,S
2016-03-25 14:27:20.5,9340,4,625758,0,9340,111,9345,110,S
2016-03-25 14:27:21,9345,40,625798,0,9340,174,9345,89,B
2016-03-25 14:27:22,9340,8,625806,8,9340,170,9345,90,S
2016-03-25 14:27:26,9340,4,625810,0,9340,179,9345,107,S
2016-03-25 14:27:32,9340,2,625812,0,9340,200,9345,195,S
2016-03-25 14:27:33,9340,2,625814,0,9340,199,9345,195,S
2016-03-25 14:27:34,9340,4,625818,0,9340,197,9345,193,S
2016-03-25 14:27:38,9345,20,625838,2,9340,202,9345,188,B
2016-03-25 14:27:44,9340,2,625840,0,9340,243,9345,262,S
2016-03-25 14:27:46,9340,6,625846,6,9340,241,9345,264,S
2016-03-25 14:27:46.5,9345,528,626374,318,9345,127,9350,868,B
2016-03-25 14:27:47,9345,256,626630,252,9340,261,9345,172,B
2016-03-25 14:27:48,9345,126,626756,-104,9345,75,9350,538,B
2016-03-25 14:27:49,9345,40,626796,0,9345,64,9350,525,B
2016-03-25 14:27:50,9345,20,626816,-20,9345,56,9350,891,B
2016-03-25 14:27:51,9345,64,626880,-32,9345,22,9350,889,B
2016-03-25 14:27:52,9345,2,626882,0,9345,23,9350,494,B
2016-03-25 14:27:52.5,9350,2,626884,0,9345,23,9350,471,B
2016-03-25 14:27:53,9345,2,626886,0,9345,35,9350,471,S
2016-03-25 14:27:54,9345,8,626894,0,9345,69,9350,471,S
2016-03-25 14:27:55,9345,4,626898,0,9345,115,9350,468,S
2016-03-25 14:27:56,9345,2,626900,-2,9345,116,9350,468,S
2016-03-25 14:28:01,9350,8,626908,6,9345,266,9350,468,B
2016-03-25 14:28:02,9350,2,626910,0,9345,273,9350,467,B
2016-03-25 14:28:03,9350,202,627112,64,9345,273,9350,366,B
2016-03-25 14:28:04,9350,722,627834,354,9350,107,9355,388,B
2016-03-25 14:28:06,9350,2,627836,2,9350,191,9355,289,B
2016-03-25 14:28:07,9355,4,627840,-4,9350,192,9355,288,B
2016-03-25 14:28:07.5,9355,4,627844,-4,9350,198,9355,281,B
2016-03-25 14:28:08,9355,6,627850,0,9350,601,9355,279,B
2016-03-25 14:28:08.5,9355,4,627854,-4,9350,603,9355,277,B
2016-03-25 14:28:09,9355,18,627872,-8,9350,604,9355,378,B
2016-03-25 14:28:10,9350,20,627892,0,9350,614,9355,378,S
2016-03-25 14:28:10.5,9350,28,627920,0,9350,600,9355,379,S
2016-03-25 14:28:11,9355,2,627922,-2,9350,622,9355,378,B
2016-03-25 14:28:12,9355,4,627926,-4,9350,622,9355,376,B
2016-03-25 14:28:13,9355,2,627928,0,9350,622,9355,378,B
2016-03-25 14:28:14,9350,40,627968,0,9350,602,9355,378,S
2016-03-25 14:28:14.5,9350,436,628404,262,9350,385,9355,378,S
2016-03-25 14:28:15,9350,130,628534,54,9345,141,9355,439,S
2016-03-25 14:28:15.5,9355,4,628538,-2,9345,144,9355,443,B
2016-03-25 14:28:16,9350,2,628540,-2,9350,6,9355,444,S
2016-03-25 14:28:16.5,9350,6,628546,0,9350,12,9355,443,S
2016-03-25 14:28:17,9355,6,628552,0,9350,16,9355,439,B
2016-03-25 14:28:17.5,9355,18,628570,-16,9350,16,9355,430,B
2016-03-25 14:28:19,9350,2,628572,0,9350,15,9355,431,S
2016-03-25 14:28:20,9350,2,628574,2,9350,16,9355,431,S
2016-03-25 14:28:21,9350,4,628578,-2,9350,15,9355,432,S
2016-03-25 14:28:22,9355,4,628582,-4,9350,17,9355,440,B
2016-03-25 14:28:24,9350,2,628584,-2,9350,178,9355,452,S
2016-03-25 14:28:25,9350,4,628588,4,9350,178,9355,559,S
2016-03-25 14:28:26,9350,28,628616,16,9350,175,9355,555,S
2016-03-25 14:28:27,9350,4,628620,0,9350,173,9355,555,S
2016-03-25 14:28:32,9355,2,628622,-2,9350,260,9355,570,B
2016-03-25 14:28:32.5,9350,2,628624,2,9350,274,9355,570,S
2016-03-25 14:28:33,9355,4,628628,-4,9350,276,9355,568,B
2016-03-25 14:28:34,9350,10,628638,-8,9350,271,9355,567,S
2016-03-25 14:28:34.5,9355,2,628640,0,9350,271,9355,464,B
2016-03-25 14:28:35,9350,1118,629758,-300,9350,91,9355,460,S
2016-03-25 14:28:36,9355,4,629762,-4,9350,130,9355,460,B
2016-03-25 14:28:37,9350,2,629764,2,9350,129,9355,459,S
2016-03-25 14:28:39,9350,4,629768,2,9350,234,9355,467,S
2016-03-25 14:28:40,9355,2,629770,2,9350,245,9355,472,B
2016-03-25 14:28:42,9355,174,629944,-44,9350,266,9355,395,B
2016-03-25 14:28:42.3333,9355,2,629946,0,9350,266,9355,395,B
2016-03-25 14:28:42.6667,9355,42,629988,-6,9350,265,9355,385,B
2016-03-25 14:28:43,9350,24,630012,-10,9350,265,9355,373,S
2016-03-25 14:28:45,9355,6,630018,-4,9350,265,9355,365,B
2016-03-25 14:28:45.5,9350,6,630024,6,9350,262,9355,365,S
2016-03-25 14:28:46,9355,4,630028,-4,9350,263,9355,364,B
2016-03-25 14:28:47,9355,4,630032,-4,9350,167,9355,373,B
2016-03-25 14:28:48,9355,2,630034,0,9350,171,9355,372,B
2016-03-25 14:28:49,9355,738,630772,84,9355,6,9360,470,B
2016-03-25 14:28:50,9355,44,630816,24,9350,159,9355,8,B
2016-03-25 14:28:50.5,9355,2,630818,0,9350,167,9355,7,B
2016-03-25 14:28:51,9355,12,630830,0,9350,180,9355,76,B
2016-03-25 14:28:52,9355,6,630836,6,9350,179,9355,75,B
2016-03-25 14:28:52.5,9355,22,630858,20,9350,230,9355,77,B
2016-03-25 14:28:53,9350,102,630960,52,9350,230,9355,27,S
2016-03-25 14:28:53.5,9355,60,631020,26,9355,2,9360,526,B
2016-03-25 14:28:54,9355,10,631030,-6,9355,5,9360,525,B
2016-03-25 14:28:55,9355,4,631034,2,9355,10,9360,539,B
2016-03-25 14:28:56,9360,72,631106,6,9355,46,9360,508,B
2016-03-25 14:28:56.5,9360,64,631170,-10,9355,57,9360,477,B
2016-03-25 14:28:57,9355,46,631216,-22,9355,65,9360,464,S
2016-03-25 14:28:57.5,9360,6,631222,-2,9355,74,9360,467,B
2016-03-25 14:28:58,9360,24,631246,-18,9355,96,9360,451,B
2016-03-25 14:28:59,9360,20,631266,-18,9355,148,9360,429,B
2016-03-25 14:29:00,9360,30,631296,14,9355,149,9360,414,B
2016-03-25 14:29:00.5,9360,2,631298,-2,9355,149,9360,405,B
2016-03-25 14:29:02,9360,10,631308,-8,9355,163,9360,399,B
2016-03-25 14:29:02.5,9360,12,631320,-10,9355,163,9360,387,B
2016-03-25 14:29:03,9360,10,631330,-10,9355,167,9360,377,B
2016-03-25 14:29:03.5,9360,4,631334,-2,9355,172,9360,365,B
2016-03-25 14:29:04,9360,120,631454,-76,9355,173,9360,304,B
2016-03-25 14:29:04.5,9360,6,631460,0,9355,174,9360,275,B
2016-03-25 14:29:05,9360,478,631938,120,9355,174,9365,238,B
2016-03-25 14:29:05.5,9360,328,632266,-126,9360,9,9365,115,B
2016-03-25 14:29:06,9360,12,632278,-8,9360,49,9365,113,B
2016-03-25 14:29:06.5,9360,22,632300,-20,9360,47,9365,343,B
2016-03-25 14:29:07,9360,40,632340,-20,9360,27,9365,343,B
2016-03-25 14:29:07.5,9360,4,632344,0,9360,28,9365,354,B
2016-03-25 14:29:08,9360,28,632372,-16,9360,6,9365,355,B
2016-03-25 14:29:08.5,9360,52,632424,-28,9355,264,9360,219,B
2016-03-25 14:29:09,9360,22,632446,0,9355,268,9360,3,B
2016-03-25 14:29:09.5,9360,46,632492,16,9360,41,9365,347,B
2016-03-25 14:29:10,9360,6,632498,2,9360,40,9365,344,B
2016-03-25 14:29:11,9360,84,632582,-20,9355,243,9360,166,B
2016-03-25 14:29:11.5,9360,14,632596,-4,9355,242,9360,160,B
2016-03-25 14:29:12,9355,30,632626,-4,9355,237,9360,160,S
2016-03-25 14:29:13,9360,4,632630,-4,9355,237,9360,158,B
2016-03-25 14:29:15,9360,72,632702,-70,9355,224,9360,378,B
2016-03-25 14:29:16,9360,14,632716,-4,9355,239,9360,393,B
2016-03-25 14:29:17,9355,2,632718,-2,9355,238,9360,394,S
2016-03-25 14:29:17.5,9360,10,632728,0,9355,218,9360,390,B
2016-03-25 14:29:18,9355,324,633052,-210,9350,309,9355,172,S
2016-03-25 14:29:19,9355,2,633054,-2,9350,313,9355,136,S
2016-03-25 14:29:19.5,9355,8,633062,-6,9350,315,9355,206,S
2016-03-25 14:29:20,9355,60,633122,-60,9350,315,9355,176,S
2016-03-25 14:29:21,9355,48,633170,-48,9350,301,9355,155,S
2016-03-25 14:29:23,9355,212,633382,-62,9350,537,9355,49,S
2016-03-25 14:29:23.5,9360,138,633520,-38,9355,10,9360,569,B
2016-03-25 14:29:24,9355,12,633532,2,9355,138,9360,570,S
2016-03-25 14:29:25,9355,4,633536,0,9355,372,9360,555,S
2016-03-25 14:29:26,9355,42,633578,-40,9355,371,9360,536,S
2016-03-25 14:29:27,9360,556,634134,494,9355,338,9360,486,B
2016-03-25 14:29:29,9355,38,634172,38,9355,387,9360,459,S
2016-03-25 14:29:29.5,9355,2,634174,2,9355,386,9360,458,S
2016-03-25 14:29:30,9360,40,634214,-40,9355,386,9360,438,B
2016-03-25 14:29:31,9360,2,634216,-2,9355,386,9360,439,B
2016-03-25 14:29:32,9360,44,634260,-42,9355,400,9360,537,B
2016-03-25 14:29:32.5,9360,42,634302,-22,9355,400,9360,517,B
2016-03-25 14:29:33,9355,12,634314,0,9355,399,9360,466,S
2016-03-25 14:29:34,9360,4,634318,2,9355,440,9360,464,B
2016-03-25 14:29:34.5,9360,48,634366,-2,9355,437,9360,443,B
2016-03-25 14:29:35,9360,2,634368,2,9355,444,9360,444,B
2016-03-25 14:29:35.5,9355,14,634382,14,9355,439,9360,442,S
2016-03-25 14:29:39,9360,2,634384,0,9355,450,9360,394,B
2016-03-25 14:29:40,9355,60,634444,0,9355,421,9360,395,S
2016-03-25 14:29:41,9355,258,634702,-62,9350,287,9355,67,S
2016-03-25 14:29:42,9355,10,634712,-10,9350,286,9355,79,S
2016-03-25 14:29:43,9355,2,634714,-2,9350,286,9355,72,S
2016-03-25 14:29:44,9355,174,634888,44,9355,13,9360,437,S
2016-03-25 14:29:44.5,9355,28,634916,28,9350,288,9355,69,S
2016-03-25 14:29:45,9355,62,634978,2,9350,302,9355,38,S
2016-03-25 14:29:45.5,9355,22,635000,4,9350,299,9355,30,S
2016-03-25 14:29:46,9355,2,635002,2,9350,300,9355,30,S
2016-03-25 14:29:46.5,9355,62,635064,-4,9355,7,9360,441,S
2016-03-25 14:29:47,9355,54,635118,-54,9350,295,9355,6,S
2016-03-25 14:29:47.5,9350,4,635122,-4,9350,293,9360,457,S
2016-03-25 14:29:48,9360,10,635132,0,9350,277,9355,2,B
2016-03-25 14:29:48.5,9355,12,635144,0,9355,34,9360,451,S
2016-03-25 14:29:49,9355,2,635146,2,9355,36,9360,453,S
2016-03-25 14:29:50,9355,2,635148,0,9355,67,9360,454,S
2016-03-25 14:29:52,9355,4,635152,0,9355,67,9360,440,S
2016-03-25 14:29:53,9355,4,635156,2,9355,68,9360,435,S
2016-03-25 14:29:54,9355,16,635172,12,9355,74,9360,431,S
2016-03-25 14:29:55,9355,22,635194,0,9355,155,9360,431,S
2016-03-25 14:29:56,9360,2,635196,2,9355,158,9360,430,B
2016-03-25 14:29:56.5,9360,68,635264,0,9355,142,9360,409,B
2016-03-25 14:29:58,9355,2,635266,0,9355,121,9360,434,S
2016-03-25 14:29:58.5,9355,2,635268,-2,9355,121,9360,434,S
2016-03-25 14:29:59,9360,2,635270,2,9355,122,9360,433,B
2016-03-25 14:29:59.5,9355,2,635272,0,9355,121,9360,433,S
2016-03-25 14:30:00,9355,2,635274,0,9355,121,9360,434,S
2016-03-25 14:30:01,9360,46,635320,-2,9355,71,9360,413,B
2016-03-25 14:30:01.5,9360,6,635326,2,9355,72,9360,412,B
2016-03-25 14:30:02,9360,66,635392,2,9355,70,9360,381,B
2016-03-25 14:30:03,9360,4,635396,4,9355,69,9360,380,B
2016-03-25 14:30:04,9360,2,635398,0,9355,116,9360,380,B
2016-03-25 14:30:05,9355,2,635400,0,9355,115,9360,380,S
2016-03-25 14:30:05.5,9360,40,635440,0,9355,116,9360,360,B
2016-03-25 14:30:07,9360,12,635452,0,9355,123,9360,359,B
2016-03-25 14:30:07.5,9355,2,635454,-2,9355,128,9360,359,S
2016-03-25 14:30:10,9355,2,635456,0,9355,91,9360,360,S
2016-03-25 14:30:11,9355,8,635464,0,9355,96,9360,359,S
2016-03-25 14:30:12,9360,2,635466,2,9355,97,9360,365,B
2016-03-25 14:30:13,9360,40,635506,0,9355,117,9360,338,B
2016-03-25 14:30:15,9355,236,635742,-194,9350,509,9360,338,S
2016-03-25 14:30:15.3333,9355,10,635752,0,9350,507,9355,35,S
2016-03-25 14:30:15.6667,9355,2,635754,-2,9350,507,9355,34,S
2016-03-25 14:30:16,9355,10,635764,-10,9350,507,9355,29,S
2016-03-25 14:30:17,9355,58,635822,10,9350,507,9355,36,S
2016-03-25 14:30:17.5,9355,40,635862,-38,9350,507,9355,22,S
2016-03-25 14:30:18,9355,2,635864,0,9350,506,9355,24,S
2016-03-25 14:30:20,9355,62,635926,-2,9350,510,9355,3,S
2016-03-25 14:30:21,9355,36,635962,-8,9350,568,9360,328,S
2016-03-25 14:30:22,9355,2,635964,-2,9350,565,9355,32,S
2016-03-25 14:30:23,9355,10,635974,0,9350,565,9355,27,S
2016-03-25 14:30:25,9355,2,635976,-2,9350,563,9355,28,S
2016-03-25 14:30:25.5,9355,6,635982,0,9350,563,9355,26,S
2016-03-25 14:30:26,9355,110,636092,46,9355,12,9360,328,S
2016-03-25 14:30:27,9355,24,636116,-12,9350,563,9360,328,S
2016-03-25 14:30:28,9355,22,636138,12,9350,372,9355,19,S
2016-03-25 14:30:29,9355,4,636142,0,9350,374,9355,12,S
2016-03-25 14:30:32,9355,56,636198,-6,9350,286,9360,320,S
2016-03-25 14:30:33,9355,6,636204,0,9355,14,9360,330,S
2016-03-25 14:30:33.5,9355,18,636222,-16,9355,5,9360,332,S
2016-03-25 14:30:34,9355,2,636224,2,9355,4,9360,334,S
2016-03-25 14:30:35,9355,8,636232,0,9350,404,9355,58,S
2016-03-25 14:30:35.5,9355,10,636242,0,9350,401,9355,53,S
2016-03-25 14:30:36,9355,2,636244,-2,9350,401,9355,52,S
2016-03-25 14:30:37,9355,8,636252,-8,9350,401,9355,48,S
2016-03-25 14:30:37.5,9355,2,636254,-2,9350,401,9355,52,S
2016-03-25 14:30:38,9355,2,636256,-2,9350,402,9355,51,S
2016-03-25 14:30:41,9355,4,636260,0,9350,402,9355,115,S
2016-03-25 14:30:44,9350,804,637064,-276,9345,91,9350,231,S
2016-03-25 14:30:47,9350,4,637068,-4,9345,271,9350,711,S
2016-03-25 14:30:47.5,9350,4,637072,0,9345,271,9350,241,S
2016-03-25 14:30:48,9345,16,637088,8,9345,266,9350,241,S
2016-03-25 14:30:48.5,9350,12,637100,-10,9345,264,9350,236,B
2016-03-25 14:30:49,9350,2,637102,-2,9345,276,9350,235,B
2016-03-25 14:30:55,9350,40,637142,-40,9345,266,9350,227,B
2016-03-25 14:30:56,9350,2,637144,-2,9345,272,9350,226,B
2016-03-25 14:30:57,9350,2,637146,-2,9345,271,9350,225,B
2016-03-25 14:30:59,9350,2,637148,-2,9345,276,9350,226,B
2016-03-25 14:30:59.3333,9350,40,637188,-40,9345,276,9350,206,B
2016-03-25 14:30:59.6667,9345,2,637190,0,9345,275,9350,206,S
2016-03-25 14:31:01,9350,2,637192,-2,9345,275,9350,207,B
2016-03-25 14:31:04,9350,2,637194,0,9345,278,9350,207,B
2016-03-25 14:31:05,9345,2,637196,-2,9345,277,9350,207,S
2016-03-25 14:31:06,9345,2,637198,0,9345,276,9350,207,S
2016-03-25 14:31:07,9350,2,637200,-2,9345,276,9350,213,B
2016-03-25 14:31:08,9345,2,637202,0,9345,275,9350,213,S
2016-03-25 14:31:10,9345,4,637206,-4,9345,104,9350,213,S
2016-03-25 14:31:11,9350,40,637246,-36,9345,106,9350,192,B
2016-03-25 14:31:13,9350,2,637248,-2,9345,108,9350,211,B
2016-03-25 14:31:16,9345,2,637250,-2,9345,109,9350,216,S
2016-03-25 14:31:17,9345,218,637468,30,9340,296,9350,217,S
2016-03-25 14:31:18,9345,14,637482,-14,9345,6,9350,217,S
2016-03-25 14:31:19,9345,40,637522,-16,9340,232,9345,7,S
2016-03-25 14:31:19.5,9345,2,637524,0,9340,252,9345,6,S
2016-03-25 14:31:20,9340,4,637528,-2,9340,278,9345,16,S
2016-03-25 14:31:20.5,9340,6,637534,-2,9340,243,9345,15,S
2016-03-25 14:31:21,9345,150,637684,-32,9340,168,9345,14,B
2016-03-25 14:31:21.5,9350,34,637718,-8,9340,178,9345,27,B
2016-03-25 14:31:23,9340,20,637738,-20,9340,169,9345,44,S
2016-03-25 14:31:24,9345,2,637740,0,9340,172,9345,144,B
2016-03-25 14:31:24.5,9345,6,637746,-2,9340,172,9345,143,B
2016-03-25 14:31:25,9345,2,637748,0,9340,175,9345,142,B
2016-03-25 14:31:26,9345,6,637754,-6,9340,175,9345,139,B
2016-03-25 14:31:26.5,9345,10,637764,-10,9340,175,9345,134,B
2016-03-25 14:31:27,9340,2,637766,0,9340,174,9345,134,S
2016-03-25 14:31:28,9340,48,637814,0,9340,150,9345,134,S
2016-03-25 14:31:30,9340,40,637854,2,9340,130,9345,135,S
2016-03-25 14:31:30.5,9340,4,637858,-4,9340,127,9345,136,S
2016-03-25 14:31:31,9340,6,637864,0,9340,124,9345,136,S
2016-03-25 14:31:31.5,9340,2,637866,0,9340,123,9345,137,S
2016-03-25 14:31:34,9340,2,637868,0,9340,154,9345,145,S
2016-03-25 14:31:35,9340,2,637870,0,9340,151,9345,145,S
2016-03-25 14:31:35.5,9340,14,637884,12,9340,144,9345,223,S
2016-03-25 14:31:37,9340,6,637890,0,9340,142,9345,230,S
2016-03-25 14:31:37.5,9345,4,637894,-4,9340,141,9345,232,B
2016-03-25 14:31:38,9340,6,637900,-2,9340,137,9345,230,S
2016-03-25 14:31:40,9340,108,638008,-78,9340,83,9345,230,S
2016-03-25 14:31:40.5,9340,168,638176,-36,9335,272,9340,208,S
2016-03-25 14:31:41,9340,366,638542,-6,9335,256,9340,3,S
2016-03-25 14:31:41.5,9340,10,638552,-8,9340,33,9345,268,S
2016-03-25 14:31:43,9340,8,638560,-4,9340,29,9345,267,S
2016-03-25 14:31:44,9345,36,638596,-34,9340,30,9345,248,B
2016-03-25 14:31:44.5,9340,12,638608,0,9340,69,9345,248,S
2016-03-25 14:31:45,9340,40,638648,-36,9340,58,9345,263,S
2016-03-25 14:31:45.5,9340,10,638658,4,9340,53,9345,263,S
2016-03-25 14:31:47,9340,2,638660,-2,9340,52,9345,263,S
2016-03-25 14:31:47.5,9340,24,638684,22,9340,40,9345,263,S
2016-03-25 14:31:48,9340,34,638718,34,9340,25,9345,263,S
2016-03-25 14:31:49,9340,52,638770,28,9335,257,9340,28,S
2016-03-25 14:31:50,9340,64,638834,32,9340,44,9345,263,S
2016-03-25 14:31:50.5,9340,12,638846,0,9340,64,9345,263,S
2016-03-25 14:31:51,9345,4,638850,-2,9340,37,9345,262,B
2016-03-25 14:31:52,9340,2,638852,0,9340,34,9345,262,S
2016-03-25 14:31:52.5,9340,18,638870,0,9340,29,9345,262,S
2016-03-25 14:31:53,9340,2,638872,-2,9340,30,9345,262,S
2016-03-25 14:31:53.5,9340,12,638884,0,9340,24,9345,263,S
2016-03-25 14:31:54,9340,118,639002,-30,9335,227,9340,36,S
2016-03-25 14:31:56,9340,46,639048,-8,9335,230,9340,25,S
2016-03-25 14:31:56.5,9335,2,639050,-2,9335,224,9340,26,S
2016-03-25 14:31:57,9335,6,639056,0,9335,222,9340,30,S
2016-03-25 14:31:58,9335,24,639080,14,9335,210,9340,28,S
2016-03-25 14:31:58.5,9335,2,639082,0,9335,209,9340,29,S
2016-03-25 14:31:59,9335,20,639102,4,9335,206,9340,29,S
2016-03-25 14:31:59.5,9340,12,639114,0,9335,224,9340,71,B
2016-03-25 14:32:00,9335,2,639116,-2,9335,223,9340,83,S
2016-03-25 14:32:02,9340,42,639158,24,9335,206,9340,116,B
2016-03-25 14:32:04,9340,46,639204,-46,9335,205,9340,94,B
2016-03-25 14:32:06,9340,4,639208,-4,9335,207,9340,117,B
2016-03-25 14:32:08,9340,20,639228,-20,9335,208,9340,96,B
2016-03-25 14:32:09,9340,192,639420,-14,9340,30,9345,188,B
2016-03-25 14:32:10,9340,60,639480,0,9340,68,9345,188,B
2016-03-25 14:32:10.5,9345,12,639492,-12,9340,69,9345,182,B
2016-03-25 14:32:11,9340,4,639496,2,9340,87,9345,182,S
2016-03-25 14:32:11.5,9340,4,639500,0,9340,135,9345,182,S
2016-03-25 14:32:12,9345,346,639846,-126,9345,107,9350,281,B
2016-03-25 14:32:13,9345,40,639886,0,9345,88,9350,228,B
2016-03-25 14:32:14,9350,40,639926,18,9345,89,9350,208,B
2016-03-25 14:32:15,9350,2,639928,2,9345,89,9350,206,B
2016-03-25 14:32:15.5,9350,2,639930,0,9345,89,9350,205,B
2016-03-25 14:32:19,9345,2,639932,-2,9345,88,9350,676,S
2016-03-25 14:32:21,9345,174,640106,-136,9340,139,9345,30,S
2016-03-25 14:32:22,9345,72,640178,-4,9345,56,9350,737,S
2016-03-25 14:32:23,9345,2,640180,0,9345,113,9350,689,S
2016-03-25 14:32:24,9345,2,640182,0,9345,112,9350,709,S
2016-03-25 14:32:26,9345,2,640184,0,9345,112,9350,712,S
2016-03-25 14:32:27,9350,40,640224,24,9345,92,9350,702,B
2016-03-25 14:32:27.5,9345,2,640226,-2,9345,122,9350,702,S
2016-03-25 14:32:29,9345,228,640454,-66,9340,117,9350,716,S
2016-03-25 14:32:33,9345,2,640456,0,9340,177,9345,96,S
2016-03-25 14:32:33.5,9345,16,640472,-10,9340,177,9345,88,S
2016-03-25 14:32:34,9345,2,640474,2,9340,177,9345,88,S
2016-03-25 14:32:35,9340,180,640654,18,9340,85,9345,97,S
2016-03-25 14:32:35.5,9340,40,640694,-36,9340,49,9345,116,S
2016-03-25 14:32:40,9340,10,640704,-6,9340,71,9345,168,S
2016-03-25 14:32:40.3333,9340,20,640724,0,9340,61,9345,165,S
2016-03-25 14:32:40.6667,9345,8,640732,0,9340,61,9345,161,B
2016-03-25 14:32:41,9340,100,640832,64,9340,40,9345,159,S
2016-03-25 14:32:44,9340,12,640844,0,9340,56,9345,165,S
2016-03-25 14:32:47,9340,12,640856,2,9340,54,9345,164,S
2016-03-25 14:32:47.5,9340,12,640868,4,9340,48,9345,165,S
2016-03-25 14:32:48,9340,20,640888,-2,9340,39,9345,175,S
2016-03-25 14:32:49,9345,14,640902,0,9340,34,9345,173,B
2016-03-25 14:32:49.5,9340,6,640908,0,9340,31,9345,173,S
2016-03-25 14:32:50,9340,14,640922,4,9340,28,9345,173,S
2016-03-25 14:32:51,9340,2,640924,2,9340,56,9345,173,S
2016-03-25 14:32:54,9340,12,640936,12,9340,77,9345,169,S
2016-03-25 14:32:57,9340,8,640944,8,9340,52,9345,262,S
2016-03-25 14:32:58,9340,104,641048,30,9335,124,9340,48,S
2016-03-25 14:33:01,9335,14,641062,0,9335,117,9340,80,S
2016-03-25 14:33:04,9335,2,641064,0,9335,143,9340,180,S
2016-03-25 14:33:04.5,9335,200,641264,54,9335,43,9340,188,S
2016-03-25 14:33:05,9335,2,641266,2,9335,42,9340,188,S
2016-03-25 14:33:05.5,9335,42,641308,8,9335,73,9340,187,S
2016-03-25 14:33:06,9335,4,641312,-4,9335,92,9340,189,S
2016-03-25 14:33:06.5,9335,2,641314,-2,9335,103,9340,189,S
2016-03-25 14:33:07,9340,58,641372,-6,9335,102,9340,168,B
2016-03-25 14:33:08,9335,2,641374,-2,9335,101,9340,168,S
2016-03-25 14:33:11,9335,8,641382,0,9335,100,9340,165,S
2016-03-25 14:33:18,9340,10,641392,10,9335,135,9340,166,B
2016-03-25 14:33:19,9335,2,641394,-2,9335,184,9340,174,S
2016-03-25 14:33:22,9335,2,641396,-2,9335,186,9340,176,S
2016-03-25 14:33:25,9335,14,641410,-12,9335,170,9340,274,S
2016-03-25 14:33:26,9335,38,641448,0,9335,151,9340,280,S
2016-03-25 14:33:26.5,9335,40,641488,-34,9335,130,9340,293,S
2016-03-25 14:33:27,9335,18,641506,-4,9335,121,9340,292,S
2016-03-25 14:33:27.5,9335,2,641508,2,9335,70,9340,292,S
2016-03-25 14:33:28,9335,4,641512,4,9335,98,9340,292,S
2016-03-25 14:33:29,9335,8,641520,8,9335,94,9340,287,S
2016-03-25 14:33:29.5,9335,2,641522,2,9335,93,9340,291,S
2016-03-25 14:33:30,9335,120,641642,20,9335,33,9340,287,S
2016-03-25 14:33:30.5,9335,6,641648,0,9335,31,9340,287,S
2016-03-25 14:33:31,9335,2,641650,0,9335,31,9340,287,S
2016-03-25 14:33:31.5,9335,48,641698,-30,9335,72,9340,279,S
2016-03-25 14:33:32,9335,92,641790,-78,9335,27,9340,234,S
2016-03-25 14:33:32.5,9335,62,641852,-52,9335,25,9340,216,S
2016-03-25 14:33:33,9335,4,641856,-2,9335,33,9340,220,S
2016-03-25 14:33:34,9335,6,641862,6,9335,58,9340,219,S
2016-03-25 14:33:36,9340,4,641866,2,9335,110,9340,219,B
2016-03-25 14:33:43,9335,52,641918,-38,9335,106,9340,199,S
2016-03-25 14:33:44,9335,12,641930,0,9335,102,9340,199,S
2016-03-25 14:33:45,9335,4,641934,0,9335,253,9340,199,S
2016-03-25 14:33:45.5,9340,2,641936,0,9335,261,9340,198,B
2016-03-25 14:33:46,9340,2,641938,0,9335,261,9340,198,B
2016-03-25 14:33:46.5,9335,12,641950,0,9335,257,9340,198,S
2016-03-25 14:33:47,9335,2,641952,0,9335,261,9340,198,S
2016-03-25 14:33:47.5,9335,12,641964,0,9335,254,9340,198,S
2016-03-25 14:33:51,9335,20,641984,-10,9335,248,9340,198,S
2016-03-25 14:33:51.5,9340,22,642006,0,9335,239,9340,196,B
2016-03-25 14:33:52,9335,8,642014,-8,9335,235,9340,196,S
2016-03-25 14:33:54,9335,12,642026,0,9335,227,9340,198,S
2016-03-25 14:33:56,9340,2,642028,0,9335,228,9340,199,B
2016-03-25 14:33:58,9335,6,642034,0,9335,225,9340,208,S
2016-03-25 14:34:03,9340,6,642040,0,9335,236,9340,206,B
2016-03-25 14:34:08,9335,2,642042,0,9335,237,9340,207,S
2016-03-25 14:34:09,9335,6,642048,0,9335,234,9340,207,S
2016-03-25 14:34:11,9335,10,642058,0,9335,234,9340,269,S
2016-03-25 14:34:12,9340,2,642060,0,9335,235,9340,276,B
2016-03-25 14:34:13,9340,4,642064,0,9335,237,9340,273,B
2016-03-25 14:34:14,9340,72,642136,-18,9335,247,9340,237,B
2016-03-25 14:34:16,9340,72,642208,72,9335,249,9340,210,B
2016-03-25 14:34:17,9335,8,642216,-6,9335,247,9340,200,S
2016-03-25 14:34:18,9340,2,642218,2,9335,247,9340,199,B
2016-03-25 14:34:18.5,9340,398,642616,176,9340,35,9345,490,B
2016-03-25 14:34:20,9340,26,642642,-26,9340,38,9345,478,B
2016-03-25 14:34:25,9340,2,642644,0,9340,111,9345,343,B
2016-03-25 14:34:26,9340,16,642660,-4,9340,161,9345,337,B
2016-03-25 14:34:29,9345,12,642672,6,9340,167,9345,331,B
2016-03-25 14:34:32,9340,72,642744,-72,9340,258,9345,314,S
2016-03-25 14:34:33,9340,72,642816,0,9340,221,9345,314,S
2016-03-25 14:34:35,9340,4,642820,0,9340,316,9345,314,S
2016-03-25 14:34:42,9345,622,643442,-348,9345,375,9350,253,B
2016-03-25 14:34:43,9350,70,643512,-44,9345,340,9350,98,B
2016-03-25 14:34:43.5,9350,2,643514,-2,9345,348,9350,97,B
2016-03-25 14:34:44,9345,48,643562,-22,9345,343,9350,78,S
2016-03-25 14:34:45,9345,116,643678,26,9345,336,9350,22,S
2016-03-25 14:34:45.5,9350,390,644068,-232,9345,336,9350,26,B
2016-03-25 14:34:47,9350,2,644070,-2,9345,296,9350,25,B
2016-03-25 14:34:47.5,9350,40,644110,-16,9345,284,9350,17,B
2016-03-25 14:34:49,9345,4,644114,-4,9345,283,9350,18,S
2016-03-25 14:34:50,9345,6,644120,0,9345,280,9350,23,S
2016-03-25 14:34:50.5,9350,14,644134,-2,9345,274,9350,22,B
2016-03-25 14:34:51,9345,6,644140,0,9345,271,9350,22,S
2016-03-25 14:34:53,9355,52,644192,-34,9345,271,9355,287,B
2016-03-25 14:34:54,9350,26,644218,4,9345,271,9355,277,S
2016-03-25 14:34:56,9350,42,644260,-2,9345,271,9350,38,S
2016-03-25 14:34:57,9345,6,644266,0,9345,283,9350,40,S
2016-03-25 14:34:57.5,9350,4,644270,4,9345,283,9350,39,B
2016-03-25 14:34:59,9350,2,644272,0,9345,284,9350,39,B
2016-03-25 14:35:00,9350,118,644390,66,9345,272,9350,16,B
2016-03-25 14:35:01,9350,82,644472,52,9350,14,9355,269,B
2016-03-25 14:35:01.5,9355,80,644552,2,9345,271,9350,11,B
2016-03-25 14:35:02,9350,8,644560,0,9345,271,9350,10,S
2016-03-25 14:35:02.5,9345,2,644562,-2,9345,270,9350,12,S
2016-03-25 14:35:03,9350,22,644584,-8,9345,270,9350,113,B
2016-03-25 14:35:06,9350,4,644588,2,9345,243,9350,403,B
2016-03-25 14:35:09,9350,52,644640,-52,9345,245,9350,614,B
2016-03-25 14:35:11,9345,2,644642,-2,9345,244,9350,126,S
2016-03-25 14:35:12,9345,2,644644,-2,9345,243,9350,124,S
2016-03-25 14:35:13,9350,8,644652,-8,9345,253,9350,191,B
2016-03-25 14:35:14,9345,4,644656,0,9345,251,9350,194,S
2016-03-25 14:35:15,9345,2,644658,0,9345,250,9350,194,S
2016-03-25 14:35:16,9345,2,644660,-2,9345,249,9350,195,S
2016-03-25 14:35:17,9350,4,644664,-4,9345,249,9350,215,B
2016-03-25 14:35:18,9345,2,644666,-2,9345,248,9350,215,S
2016-03-25 14:35:20,9345,2,644668,0,9345,247,9350,222,S
2016-03-25 14:35:24,9345,44,644712,-44,9345,225,9350,265,S
2016-03-25 14:35:25,9345,2,644714,-2,9345,224,9350,264,S
2016-03-25 14:35:26,9350,128,644842,-32,9345,1193,9350,201,B
2016-03-25 14:35:26.5,9350,448,645290,142,9350,26,9355,178,B
2016-03-25 14:35:28,9350,10,645300,0,9350,52,9355,175,B
2016-03-25 14:35:28.5,9355,56,645356,-56,9350,52,9355,146,B
2016-03-25 14:35:29,9350,22,645378,0,9350,52,9355,167,S
2016-03-25 14:35:30,9350,44,645422,-36,9350,30,9355,288,S
2016-03-25 14:35:30.5,9350,60,645482,0,9345,119,9350,23,S
2016-03-25 14:35:31,9350,6,645488,-6,9345,150,9350,20,S
2016-03-25 14:35:31.5,9350,58,645546,-52,9345,167,9350,41,S
2016-03-25 14:35:33,9350,82,645628,-22,9350,23,9355,342,S
2016-03-25 14:35:33.5,9350,40,645668,0,9350,10,9355,340,S
2016-03-25 14:35:34,9350,10,645678,6,9350,7,9355,340,S
2016-03-25 14:35:37,9350,24,645702,-14,9345,166,9355,347,S
2016-03-25 14:35:38,9350,24,645726,-6,9345,166,9350,14,S
2016-03-25 14:35:38.5,9350,2,645728,-2,9345,166,9350,3,S
2016-03-25 14:35:39,9350,40,645768,14,9350,16,9355,324,S
2016-03-25 14:35:40,9350,8,645776,8,9350,12,9355,324,S
2016-03-25 14:35:40.5,9355,4,645780,0,9350,31,9355,324,B
2016-03-25 14:35:41,9350,2,645782,2,9350,30,9355,323,S
2016-03-25 14:35:42,9350,6,645788,0,9350,31,9355,322,S
2016-03-25 14:35:43,9350,8,645796,-4,9350,27,9355,323,S
2016-03-25 14:35:43.3333,9350,8,645804,-6,9350,31,9355,342,S
2016-03-25 14:35:43.6667,9350,2,645806,0,9350,36,9355,342,S
2016-03-25 14:35:44,9350,6,645812,6,9350,33,9355,342,S
2016-03-25 14:35:45,9350,14,645826,14,9350,26,9355,343,S
2016-03-25 14:35:46,9350,52,645878,-32,9345,167,9355,346,S
2016-03-25 14:35:47,9350,12,645890,8,9345,167,9350,3,S
2016-03-25 14:35:47.5,9350,18,645908,0,9345,161,9355,351,S
2016-03-25 14:35:48,9350,2,645910,0,9345,167,9350,3,S
2016-03-25 14:35:49,9345,2,645912,0,9345,166,9350,3,S
2016-03-25 14:35:49.5,9345,6,645918,0,9345,163,9350,6,S
2016-03-25 14:35:52,9345,2,645920,0,9345,163,9350,26,S
2016-03-25 14:35:54,9345,12,645932,0,9345,157,9350,39,S
2016-03-25 14:35:56,9350,56,645988,-14,9345,157,9355,282,B
2016-03-25 14:35:56.5,9350,54,646042,-48,9350,38,9355,327,B
2016-03-25 14:35:57,9350,8,646050,-8,9350,17,9355,309,B
2016-03-25 14:36:00,9350,2,646052,0,9350,16,9355,283,B
2016-03-25 14:36:00.5,9350,12,646064,-2,9350,10,9355,307,B
2016-03-25 14:36:01,9350,122,646186,8,9345,173,9350,5,B
2016-03-25 14:36:01.5,9350,16,646202,6,9350,7,9355,283,B
2016-03-25 14:36:03,9350,2,646204,2,9350,24,9355,282,B
2016-03-25 14:36:04,9350,12,646216,12,9350,19,9355,282,B
2016-03-25 14:36:06,9350,10,646226,0,9350,21,9355,404,B
2016-03-25 14:36:07,9350,112,646338,-62,9345,178,9350,21,B
2016-03-25 14:36:07.5,9350,2,646340,0,9345,178,9350,20,B
2016-03-25 14:36:08,9350,40,646380,-40,9350,141,9355,394,B
2016-03-25 14:36:09,9355,56,646436,-4,9350,141,9355,364,B
2016-03-25 14:36:09.5,9350,100,646536,-100,9350,91,9355,314,S
2016-03-25 14:36:13,9350,10,646546,0,9350,105,9355,323,S
2016-03-25 14:36:15,9355,10,646556,6,9350,134,9355,378,B
2016-03-25 14:36:20,9355,626,647182,318,9355,1,9360,467,B
2016-03-25 14:36:20.5,9360,540,647722,198,9355,120,9360,221,B
2016-03-25 14:36:21,9365,418,648140,218,9360,6,9365,294,B
2016-03-25 14:36:21.5,9365,128,648268,-70,9360,25,9365,237,B
2016-03-25 14:36:22,9365,94,648362,-18,9360,54,9365,186,B
2016-03-25 14:36:22.5,9365,2,648364,2,9360,56,9365,183,B
2016-03-25 14:36:23,9365,334,648698,-132,9360,105,9370,333,B
2016-03-25 14:36:23.5,9365,6,648704,-2,9360,89,9365,133,B
2016-03-25 14:36:24,9365,30,648734,-30,9360,69,9365,118,B
2016-03-25 14:36:25,9365,2,648736,-2,9360,69,9365,427,B
2016-03-25 14:36:25.5,9360,140,648876,-4,9355,94,9360,509,S
2016-03-25 14:36:26,9355,182,649058,-4,9350,199,9355,23,S
2016-03-25 14:36:26.5,9360,54,649112,24,9355,88,9360,509,B
2016-03-25 14:36:27,9360,4,649116,-4,9355,104,9360,507,B
2016-03-25 14:36:29,9360,22,649138,-20,9355,147,9360,517,B
2016-03-25 14:36:30,9355,40,649178,-10,9355,128,9360,517,S
2016-03-25 14:36:31,9355,2,649180,2,9355,128,9360,204,S
2016-03-25 14:36:31.5,9360,4,649184,-4,9355,129,9360,202,B
2016-03-25 14:36:33,9355,6,649190,-2,9355,283,9360,202,S
2016-03-25 14:36:34,9355,2,649192,2,9355,283,9360,202,S
2016-03-25 14:36:35,9360,4,649196,0,9355,315,9360,201,B
2016-03-25 14:36:36,9360,4,649200,-2,9355,326,9360,199,B
2016-03-25 14:36:38,9360,4,649204,-4,9355,338,9360,198,B
2016-03-25 14:36:39,9360,2,649206,-2,9355,338,9360,197,B
2016-03-25 14:36:40,9360,14,649220,-14,9355,341,9360,191,B
2016-03-25 14:36:40.5,9355,34,649254,-10,9355,335,9360,180,S
2016-03-25 14:36:41,9360,4,649258,-4,9355,343,9360,188,B
2016-03-25 14:36:42,9355,2,649260,0,9355,342,9360,189,S
2016-03-25 14:36:42.5,9360,20,649280,0,9355,342,9360,179,B
2016-03-25 14:36:43,9360,2,649282,-2,9355,342,9360,184,B
2016-03-25 14:36:45,9355,12,649294,12,9355,338,9360,198,S
2016-03-25 14:36:45.5,9360,6,649300,-2,9355,337,9360,196,B
2016-03-25 14:36:46,9360,4,649304,-4,9355,337,9360,194,B
2016-03-25 14:36:46.5,9360,14,649318,10,9355,331,9360,193,B
2016-03-25 14:36:48,9355,12,649330,12,9355,325,9360,192,S
2016-03-25 14:36:48.5,9360,20,649350,0,9355,324,9360,182,B
2016-03-25 14:36:49,9355,2,649352,0,9355,323,9360,183,S
2016-03-25 14:36:50,9355,6,649358,6,9355,320,9360,186,S
2016-03-25 14:36:51,9360,2,649360,-2,9355,321,9360,187,B
2016-03-25 14:36:52,9360,42,649402,-42,9355,321,9360,173,B
2016-03-25 14:36:53,9360,20,649422,0,9355,321,9360,163,B
2016-03-25 14:36:53.5,9355,12,649434,12,9355,315,9360,163,S
2016-03-25 14:36:54,9355,10,649444,0,9355,310,9360,163,S
2016-03-25 14:36:55,9360,60,649504,0,9355,311,9360,135,B
2016-03-25 14:36:56,9355,2,649506,0,9355,310,9360,136,S
2016-03-25 14:36:57,9355,14,649520,0,9355,303,9360,144,S
2016-03-25 14:36:58,9360,20,649540,0,9355,545,9360,149,B
2016-03-25 14:36:59,9360,2,649542,-2,9355,593,9360,149,B
2016-03-25 14:37:00,9360,14,649556,-14,9355,587,9360,142,B
2016-03-25 14:37:04,9360,2,649558,-2,9355,590,9360,141,B
2016-03-25 14:37:07,9360,2,649560,0,9355,588,9360,140,B
2016-03-25 14:37:07.5,9360,304,649864,120,9355,588,9365,413,B
2016-03-25 14:37:10,9360,14,649878,0,9355,363,9360,12,B
2016-03-25 14:37:11,9360,26,649904,26,9355,363,9360,2,B
2016-03-25 14:37:12,9360,46,649950,-24,9360,1,9365,407,B
2016-03-25 14:37:12.5,9360,2,649952,0,9355,364,9360,72,B
2016-03-25 14:37:13,9360,52,650004,-52,9355,338,9360,47,B
2016-03-25 14:37:14,9360,4,650008,-4,9355,341,9360,136,B
2016-03-25 14:37:14.5,9360,4,650012,-2,9355,341,9360,134,B
2016-03-25 14:37:15,9360,6,650018,-6,9355,341,9360,132,B
2016-03-25 14:37:16,9360,2,650020,-2,9355,341,9360,131,B
2016-03-25 14:37:17,9360,4,650024,0,9355,341,9360,137,B
2016-03-25 14:37:17.5,9360,2,650026,-2,9355,341,9360,136,B
2016-03-25 14:37:20,9355,2,650028,2,9355,332,9360,109,S
2016-03-25 14:37:22,9355,2,650030,2,9355,331,9360,109,S
2016-03-25 14:37:22.5,9355,10,650040,10,9355,326,9360,104,S
2016-03-25 14:37:23,9355,4,650044,0,9355,325,9360,92,S
2016-03-25 14:37:24,9360,4,650048,0,9355,325,9360,90,B
2016-03-25 14:37:25,9360,6,650054,0,9355,325,9360,87,B
2016-03-25 14:37:25.5,9360,78,650132,44,9355,325,9360,48,B
2016-03-25 14:37:26,9360,156,650288,44,9360,2,9365,114,B
2016-03-25 14:37:27,9360,4,650292,-4,9360,55,9365,161,B
2016-03-25 14:37:28,9360,12,650304,8,9360,49,9365,171,B
2016-03-25 14:37:30,9360,20,650324,2,9360,46,9365,172,B
2016-03-25 14:37:31,9360,10,650334,2,9360,44,9365,169,B
2016-03-25 14:37:31.5,9365,2,650336,0,9360,44,9365,169,B
2016-03-25 14:37:33,9360,4,650340,-2,9360,43,9365,177,S
2016-03-25 14:37:33.3333,9365,2,650342,0,9360,72,9365,175,B
2016-03-25 14:37:33.6667,9365,4,650346,0,9360,79,9365,174,B
2016-03-25 14:37:34,9365,2,650348,0,9360,139,9365,174,B
2016-03-25 14:37:36,9365,40,650388,-18,9360,145,9365,146,B
2016-03-25 14:37:36.5,9360,6,650394,-2,9360,144,9365,144,S
2016-03-25 14:37:37,9365,60,650454,-56,9360,165,9365,103,B
2016-03-25 14:37:37.5,9365,18,650472,0,9360,166,9365,48,B
2016-03-25 14:37:38,9365,14,650486,-6,9360,166,9365,26,B
2016-03-25 14:37:38.5,9365,12,650498,10,9360,166,9365,324,B
2016-03-25 14:37:39,9360,44,650542,-36,9360,165,9365,309,S
2016-03-25 14:37:39.5,9365,8,650550,-4,9360,164,9365,314,B
2016-03-25 14:37:40,9365,8,650558,-4,9360,167,9365,316,B
2016-03-25 14:37:40.5,9365,2,650560,-2,9360,167,9365,317,B
2016-03-25 14:37:41,9360,2,650562,0,9360,166,9365,322,S
2016-03-25 14:37:42,9360,22,650584,-22,9360,155,9365,325,S
2016-03-25 14:37:43,9365,2,650586,0,9360,156,9365,329,B
2016-03-25 14:37:44,9365,2,650588,0,9360,155,9365,414,B
2016-03-25 14:37:45,9365,10,650598,-2,9360,157,9365,375,B
2016-03-25 14:37:45.5,9360,20,650618,0,9360,147,9365,377,S
2016-03-25 14:37:47,9365,4,650622,-4,9360,147,9365,395,B
2016-03-25 14:37:47.5,9365,100,650722,0,9360,147,9365,346,B
2016-03-25 14:37:48,9365,62,650784,0,9360,148,9365,315,B
2016-03-25 14:37:49,9365,48,650832,-46,9360,142,9365,297,B
2016-03-25 14:37:49.5,9365,12,650844,-4,9360,140,9365,294,B
2016-03-25 14:37:51,9360,4,650848,-4,9360,153,9365,294,S
2016-03-25 14:37:54,9365,6,650854,0,9360,155,9365,305,B
2016-03-25 14:37:56,9365,2,650856,-2,9360,158,9365,310,B
2016-03-25 14:38:00,9365,76,650932,-16,9360,161,9365,518,B
2016-03-25 14:38:01,9360,2,650934,0,9360,160,9365,530,S
2016-03-25 14:38:01.5,9365,16,650950,-8,9360,160,9365,523,B
2016-03-25 14:38:02,9365,6,650956,-2,9360,160,9365,521,B
2016-03-25 14:38:03,9360,134,651090,62,9360,92,9365,287,S
2016-03-25 14:38:03.5,9365,4,651094,-2,9360,92,9365,285,B
2016-03-25 14:38:04,9365,4,651098,0,9360,91,9365,284,B
2016-03-25 14:38:04.5,9360,12,651110,10,9360,86,9365,283,S
2016-03-25 14:38:05,9360,172,651282,-42,9355,306,9365,290,S
2016-03-25 14:38:06,9360,4,651286,-2,9355,306,9360,34,S
2016-03-25 14:38:06.5,9365,18,651304,-6,9355,306,9365,286,B
2016-03-25 14:38:07,9360,4,651308,0,9355,308,9365,211,S
2016-03-25 14:38:07.5,9360,2,651310,-2,9355,308,9365,211,S
2016-03-25 14:38:08,9360,8,651318,-6,9355,306,9365,212,S
2016-03-25 14:38:08.5,9355,2,651320,0,9355,306,9365,213,S
2016-03-25 14:38:12,9360,30,651350,-28,9355,315,9360,35,B
2016-03-25 14:38:12.5,9360,6,651356,0,9355,308,9360,96,B
2016-03-25 14:38:13,9360,70,651426,-54,9355,308,9360,61,B
2016-03-25 14:38:13.5,9360,10,651436,4,9355,308,9360,47,B
2016-03-25 14:38:16,9360,60,651496,0,9355,308,9360,113,B
2016-03-25 14:38:19,9355,2,651498,-2,9355,309,9360,137,S
2016-03-25 14:38:21,9355,2,651500,2,9355,306,9360,440,S
2016-03-25 14:38:22,9360,60,651560,-28,9355,306,9360,411,B
2016-03-25 14:38:23,9355,376,651936,-304,9355,116,9360,415,S
2016-03-25 14:38:23.5,9355,228,652164,-178,9350,171,9355,130,S
2016-03-25 14:38:24,9355,2,652166,0,9350,171,9355,130,S
2016-03-25 14:38:24.5,9355,16,652182,-8,9350,182,9355,122,S
2016-03-25 14:38:26,9350,62,652244,-2,9350,171,9355,94,S
2016-03-25 14:38:27,9355,60,652304,-2,9350,169,9355,66,B
2016-03-25 14:38:28,9350,6,652310,-2,9350,168,9355,71,S
2016-03-25 14:38:30,9355,2,652312,0,9350,169,9355,70,B
2016-03-25 14:38:30.5,9350,6,652318,6,9350,166,9355,70,S
2016-03-25 14:38:31,9350,140,652458,-28,9350,171,9360,105,S
2016-03-25 14:38:32,9360,22,652480,18,9350,167,9360,104,B
2016-03-25 14:38:33,9355,8,652488,6,9355,37,9360,104,S
2016-03-25 14:38:33.5,9355,18,652506,18,9355,28,9360,104,S
2016-03-25 14:38:37,9355,110,652616,-62,9355,145,9360,56,S
2016-03-25 14:38:39,9355,2,652618,-2,9355,171,9360,86,S
2016-03-25 14:38:44,9355,40,652658,-40,9355,153,9360,113,S
2016-03-25 14:38:45,9355,2,652660,-2,9355,152,9360,113,S
2016-03-25 14:38:46,9355,4,652664,0,9355,153,9360,113,S
2016-03-25 14:38:48,9360,4,652668,0,9355,153,9360,111,B
2016-03-25 14:38:50,9355,6,652674,0,9355,151,9360,111,S
2016-03-25 14:38:51,9355,22,652696,-22,9355,140,9360,111,S
2016-03-25 14:38:52,9360,4,652700,0,9355,139,9360,109,B
2016-03-25 14:38:55,9355,26,652726,-8,9355,143,9360,98,S
2016-03-25 14:38:55.5,9355,2,652728,-2,9355,142,9360,98,S
2016-03-25 14:39:02,9360,196,652924,34,9360,38,9365,119,B
2016-03-25 14:39:03,9360,10,652934,10,9360,39,9365,147,B
2016-03-25 14:39:05,9360,2,652936,0,9360,14,9365,146,B
2016-03-25 14:39:06,9360,2,652938,2,9360,13,9365,146,B
2016-03-25 14:39:07,9360,54,652992,12,9355,189,9360,6,B
2016-03-25 14:39:08,9360,28,653020,0,9360,18,9365,146,B
2016-03-25 14:39:09,9360,44,653064,-6,9360,3,9365,146,B
2016-03-25 14:39:09.5,9360,20,653084,14,9360,8,9365,146,B
2016-03-25 14:39:10,9360,2,653086,2,9360,10,9365,146,B
2016-03-25 14:39:11,9360,4,653090,2,9360,11,9365,147,B
2016-03-25 14:39:12,9360,38,653128,38,9355,189,9360,34,B
2016-03-25 14:39:13,9360,72,653200,-4,9360,28,9365,169,B
2016-03-25 14:39:14,9360,2,653202,0,9360,3,9365,170,B
2016-03-25 14:39:15,9360,16,653218,-6,9355,159,9360,10,B
2016-03-25 14:39:15.5,9360,20,653238,-12,9360,61,9365,171,B
2016-03-25 14:39:16,9365,2,653240,0,9360,63,9365,170,B
2016-03-25 14:39:19,9360,2,653242,-2,9360,66,9365,169,S
2016-03-25 14:39:19.5,9365,34,653276,-18,9360,66,9365,153,B
2016-03-25 14:39:20,9360,26,653302,0,9360,61,9365,154,S
2016-03-25 14:39:21,9365,2,653304,0,9360,69,9365,154,B
2016-03-25 14:39:26,9360,154,653458,30,9355,120,9360,56,S
2016-03-25 14:39:27,9360,8,653466,0,9355,120,9360,55,S
2016-03-25 14:39:27.5,9360,68,653534,-24,9355,120,9360,21,S
2016-03-25 14:39:29,9355,68,653602,-50,9355,50,9360,192,S
2016-03-25 14:39:30,9355,6,653608,0,9355,47,9360,192,S
2016-03-25 14:39:31,9355,56,653664,-12,9355,23,9360,192,S
2016-03-25 14:39:31.3333,9355,26,653690,-14,9350,176,9360,192,S
2016-03-25 14:39:31.6667,9355,4,653694,0,9350,186,9360,192,S
2016-03-25 14:39:34,9360,2,653696,0,9355,14,9360,192,B
2016-03-25 14:39:35,9355,18,653714,14,9355,8,9360,193,S
2016-03-25 14:39:39,9355,2,653716,0,9355,47,9360,196,S
2016-03-25 14:39:41,9355,20,653736,-14,9355,39,9360,198,S
2016-03-25 14:39:41.5,9360,42,653778,0,9355,38,9360,178,B
2016-03-25 14:39:43,9355,42,653820,-2,9355,79,9360,177,S
2016-03-25 14:39:48,9360,2,653822,-2,9355,83,9360,192,B
2016-03-25 14:39:51,9355,2,653824,0,9355,122,9360,212,S
2016-03-25 14:39:53,9355,2,653826,0,9355,123,9360,100,S
2016-03-25 14:39:57,9360,2,653828,0,9355,125,9360,107,B
2016-03-25 14:39:57.5,9355,2,653830,0,9355,124,9360,107,S
2016-03-25 14:40:05,9355,250,654080,94,9355,8,9360,109,S
2016-03-25 14:40:05.5,9355,16,654096,-4,9350,289,9360,109,S
2016-03-25 14:40:06,9355,2,654098,0,9355,4,9360,138,S
2016-03-25 14:40:07,9355,2,654100,2,9355,4,9360,140,S
2016-03-25 14:40:09,9360,4,654104,-4,9355,38,9360,139,B
2016-03-25 14:40:17,9355,2,654106,2,9355,66,9360,134,S
2016-03-25 14:40:17.5,9355,2,654108,2,9355,65,9360,134,S
2016-03-25 14:40:19,9360,12,654120,-12,9355,65,9360,128,B
2016-03-25 14:40:20,9360,10,654130,0,9355,65,9360,123,B
2016-03-25 14:40:23,9355,2,654132,0,9355,75,9360,123,S
2016-03-25 14:40:28,9355,2,654134,-2,9355,106,9360,67,S
2016-03-25 14:40:31,9355,6,654140,-6,9355,103,9360,68,S
2016-03-25 14:40:31.5,9355,6,654146,0,9355,100,9360,68,S
2016-03-25 14:40:34,9355,18,654164,0,9355,91,9360,67,S
2016-03-25 14:40:38,9355,2,654166,-2,9355,72,9360,82,S
2016-03-25 14:40:43,9355,64,654230,-64,9355,40,9360,87,S
2016-03-25 14:40:44,9355,4,654234,0,9355,38,9360,87,S
2016-03-25 14:40:46,9360,40,654274,18,9355,39,9360,83,B
2016-03-25 14:40:47,9355,4,654278,0,9355,37,9360,83,S
2016-03-25 14:40:48,9355,2,654280,-2,9355,36,9360,83,S
2016-03-25 14:40:54,9355,32,654312,14,9355,76,9360,89,S
2016-03-25 14:40:55,9360,6,654318,-2,9355,77,9360,87,B
2016-03-25 14:40:56,9355,2,654320,2,9355,76,9360,96,S
2016-03-25 14:40:59,9360,2,654322,-2,9355,103,9360,95,B
2016-03-25 14:40:59.5,9355,2,654324,2,9355,102,9360,94,S
2016-03-25 14:41:00,9355,20,654344,-20,9355,92,9360,94,S
2016-03-25 14:41:03,9355,2,654346,-2,9355,93,9360,94,S
2016-03-25 14:41:06,9360,64,654410,-62,9355,157,9360,64,B
2016-03-25 14:41:12,9360,82,654492,-72,9355,158,9365,134,B
2016-03-25 14:41:13,9360,16,654508,0,9355,219,9365,134,B
2016-03-25 14:41:13.5,9360,42,654550,-12,9360,56,9365,163,B
2016-03-25 14:41:14,9360,50,654600,2,9360,34,9365,163,B
2016-03-25 14:41:20,9360,2,654602,2,9360,37,9365,148,B
2016-03-25 14:41:21,9360,20,654622,12,9355,220,9360,6,B
2016-03-25 14:41:22,9360,2,654624,-2,9355,220,9360,8,B
2016-03-25 14:41:23,9360,6,654630,0,9355,221,9360,23,B
2016-03-25 14:41:31,9360,64,654694,-48,9355,222,9360,7,B
2016-03-25 14:41:31.5,9355,6,654700,6,9355,219,9360,10,S
2016-03-25 14:41:32,9360,2,654702,2,9355,219,9360,9,B
2016-03-25 14:41:32.5,9355,2,654704,2,9355,228,9360,12,S
2016-03-25 14:41:33,9360,24,654728,18,9355,219,9360,12,B
2016-03-25 14:41:35,9360,6,654734,0,9355,229,9360,19,B
2016-03-25 14:41:35.5,9355,6,654740,0,9355,226,9360,17,S
2016-03-25 14:41:36,9360,146,654886,8,9360,11,9365,244,B
2016-03-25 14:41:37,9360,26,654912,-26,9355,314,9360,21,B
2016-03-25 14:41:37.5,9360,2,654914,0,9355,324,9360,20,B
2016-03-25 14:41:40,9360,50,654964,-40,9360,7,9365,243,B
2016-03-25 14:41:43,9365,4,654968,0,9360,39,9365,242,B
2016-03-25 14:41:44,9360,6,654974,-6,9360,36,9365,247,S
2016-03-25 14:41:48,9360,4,654978,-4,9360,34,9365,256,S
2016-03-25 14:41:52,9360,6,654984,0,9360,36,9365,245,S
2016-03-25 14:41:53,9360,2,654986,0,9360,35,9365,245,S
2016-03-25 14:41:58,9365,468,655454,94,9360,82,9365,21,B
2016-03-25 14:41:58.5,9365,42,655496,34,9365,212,9370,645,B
2016-03-25 14:42:00,9370,2,655498,-2,9365,212,9370,643,B
2016-03-25 14:42:01,9370,192,655690,-96,9365,230,9370,551,B
2016-03-25 14:42:01.5,9370,168,655858,-60,9365,197,9370,515,B
2016-03-25 14:42:02,9370,48,655906,-32,9365,198,9370,491,B
2016-03-25 14:42:02.5,9365,366,656272,-202,9365,19,9370,459,S
2016-03-25 14:42:03,9365,38,656310,-34,9360,226,9365,109,S
2016-03-25 14:42:04,9365,2,656312,-2,9360,270,9365,110,S
2016-03-25 14:42:05,9365,20,656332,-20,9360,271,9365,105,S
2016-03-25 14:42:07,9365,22,656354,-20,9360,261,9365,94,S
2016-03-25 14:42:08,9365,6,656360,-4,9360,261,9365,96,S
2016-03-25 14:42:08.5,9365,102,656462,-78,9360,316,9365,46,S
2016-03-25 14:42:09,9370,254,656716,-104,9365,55,9370,385,B
2016-03-25 14:42:10,9370,2,656718,-2,9365,56,9370,384,B
2016-03-25 14:42:10.5,9370,38,656756,-10,9365,63,9370,364,B
2016-03-25 14:42:11,9365,2,656758,2,9365,77,9370,364,S
2016-03-25 14:42:12,9370,28,656786,-2,9365,80,9370,350,B
2016-03-25 14:42:13,9365,2,656788,0,9365,147,9370,355,S
2016-03-25 14:42:15,9370,6,656794,2,9365,218,9370,350,B
2016-03-25 14:42:17,9370,48,656842,-18,9365,229,9370,332,B
2016-03-25 14:42:17.5,9370,186,657028,-66,9365,163,9370,240,B
2016-03-25 14:42:18,9370,324,657352,-2,9365,151,9370,79,B
2016-03-25 14:42:18.5,9370,156,657508,-108,9370,131,9375,381,B
2016-03-25 14:42:19,9375,24,657532,-18,9370,132,9375,379,B
2016-03-25 14:42:19.5,9375,564,658096,-262,9370,218,9375,98,B
2016-03-25 14:42:20,9375,196,658292,-64,9375,56,9380,331,B
2016-03-25 14:42:20.5,9380,18,658310,-4,9375,254,9380,324,B
2016-03-25 14:42:21,9380,36,658346,-4,9375,299,9380,297,B
2016-03-25 14:42:21.5,9380,98,658444,-86,9375,319,9380,252,B
2016-03-25 14:42:22,9380,40,658484,0,9375,329,9380,238,B
2016-03-25 14:42:22.5,9375,4,658488,0,9375,327,9380,238,S
2016-03-25 14:42:23,9380,12,658500,-12,9375,327,9380,232,B
2016-03-25 14:42:23.5,9375,8,658508,0,9375,332,9380,232,S
2016-03-25 14:42:24,9380,26,658534,-22,9375,343,9380,218,B
2016-03-25 14:42:24.5,9380,2,658536,-2,9375,353,9380,227,B
2016-03-25 14:42:25,9380,160,658696,-124,9375,359,9380,148,B
2016-03-25 14:42:25.3333,9380,90,658786,-10,9375,366,9380,113,B
2016-03-25 14:42:25.6667,9380,6,658792,-6,9375,166,9380,110,B
2016-03-25 14:42:26,9380,4,658796,-4,9375,193,9380,118,B
2016-03-25 14:42:27,9375,20,658816,0,9375,192,9380,111,S
2016-03-25 14:42:27.5,9380,142,658958,-72,9375,157,9380,82,B
2016-03-25 14:42:28,9375,162,659120,48,9370,112,9380,81,S
2016-03-25 14:42:28.5,9380,14,659134,0,9370,124,9380,193,B
2016-03-25 14:42:29,9380,6,659140,0,9375,81,9380,194,B
2016-03-25 14:42:29.5,9375,8,659148,2,9375,80,9380,362,S
2016-03-25 14:42:30,9380,30,659178,10,9375,130,9380,328,B
2016-03-25 14:42:31,9375,6,659184,6,9375,109,9380,329,S
2016-03-25 14:42:31.5,9380,20,659204,-6,9375,128,9380,318,B
2016-03-25 14:42:32,9375,4,659208,2,9375,81,9380,317,S
2016-03-25 14:42:32.5,9375,10,659218,-4,9375,78,9380,316,S
2016-03-25 14:42:33,9375,96,659314,38,9370,126,9380,316,S
2016-03-25 14:42:33.5,9375,72,659386,12,9375,41,9380,315,S
2016-03-25 14:42:34,9375,26,659412,20,9375,32,9380,329,S
2016-03-25 14:42:35,9375,92,659504,0,9370,116,9375,3,S
2016-03-25 14:42:36,9375,4,659508,2,9375,9,9380,337,S
2016-03-25 14:42:36.5,9375,24,659532,22,9375,1,9380,341,S
2016-03-25 14:42:37,9375,66,659598,-2,9370,132,9375,4,S
2016-03-25 14:42:37.5,9375,8,659606,0,9370,236,9380,353,S
2016-03-25 14:42:38,9375,10,659616,-10,9375,16,9380,353,S
2016-03-25 14:42:38.5,9375,2,659618,0,9375,18,9380,353,S
2016-03-25 14:42:39,9375,6,659624,-2,9375,132,9380,357,S
2016-03-25 14:42:40,9380,2,659626,0,9375,137,9380,343,B
2016-03-25 14:42:41,9380,58,659684,-36,9375,137,9380,324,B
2016-03-25 14:42:41.5,9375,38,659722,-16,9375,121,9380,335,S
2016-03-25 14:42:43,9375,8,659730,0,9375,296,9380,344,S
2016-03-25 14:42:43.5,9380,8,659738,8,9375,180,9380,340,B
2016-03-25 14:42:44,9380,16,659754,-2,9375,170,9380,332,B
2016-03-25 14:42:44.5,9380,4,659758,-2,9375,166,9380,333,B
2016-03-25 14:42:45,9380,2,659760,-2,9375,183,9380,332,B
2016-03-25 14:42:45.5,9380,638,660398,-290,9375,207,9380,14,B
2016-03-25 14:42:46,9380,68,660466,-26,9380,314,9385,308,B
2016-03-25 14:42:46.5,9380,2,660468,-2,9380,318,9385,308,B
2016-03-25 14:42:47,9380,10,660478,2,9380,116,9385,290,B
2016-03-25 14:42:48,9385,8,660486,-4,9380,123,9385,286,B
2016-03-25 14:42:49,9385,22,660508,-20,9380,124,9385,275,B
2016-03-25 14:42:49.5,9385,44,660552,6,9380,112,9385,265,B
2016-03-25 14:42:50,9380,20,660572,16,9380,111,9385,257,S
2016-03-25 14:42:50.5,9385,6,660578,-2,9380,111,9385,256,B
2016-03-25 14:42:51,9385,70,660648,34,9380,126,9385,221,B
2016-03-25 14:42:51.5,9385,52,660700,-38,9380,134,9385,195,B
2016-03-25 14:42:52,9385,28,660728,18,9380,122,9385,193,B
2016-03-25 14:42:52.5,9385,6,660734,-6,9380,122,9385,190,B
2016-03-25 14:42:53,9385,60,660794,-60,9380,122,9385,163,B
2016-03-25 14:42:54,9380,10,660804,10,9380,118,9385,163,S
2016-03-25 14:42:54.5,9385,48,660852,-6,9380,100,9385,150,B
2016-03-25 14:42:55,9385,10,660862,8,9380,99,9385,146,B
2016-03-25 14:42:55.5,9385,12,660874,12,9380,147,9385,142,B
2016-03-25 14:42:57,9385,48,660922,4,9380,167,9385,122,B
2016-03-25 14:42:57.5,9380,364,661286,212,9375,407,9380,320,S
2016-03-25 14:42:58,9380,50,661336,0,9375,398,9380,304,S
2016-03-25 14:42:59,9380,2,661338,2,9375,398,9380,333,S
2016-03-25 14:42:59.5,9380,4,661342,4,9375,398,9380,334,S
2016-03-25 14:43:00,9380,10,661352,0,9375,387,9380,332,S
2016-03-25 14:43:00.5,9380,2,661354,0,9375,310,9380,331,S
2016-03-25 14:43:01,9380,8,661362,0,9375,297,9380,327,S
2016-03-25 14:43:02,9375,100,661462,-80,9375,247,9380,368,S
2016-03-25 14:43:02.5,9375,4,661466,-4,9375,247,9380,367,S
2016-03-25 14:43:03,9380,2,661468,2,9375,249,9380,396,B
2016-03-25 14:43:04,9375,2,661470,0,9375,251,9380,396,S
2016-03-25 14:43:06,9380,40,661510,0,9375,263,9380,376,B
2016-03-25 14:43:09,9375,6,661516,0,9375,308,9380,578,S
2016-03-25 14:43:10,9375,20,661536,-20,9375,303,9380,587,S
2016-03-25 14:43:11,9380,20,661556,0,9375,300,9380,563,B
2016-03-25 14:43:11.5,9380,4,661560,0,9375,302,9380,563,B
2016-03-25 14:43:12,9375,2,661562,0,9375,302,9380,563,S
2016-03-25 14:43:12.5,9375,112,661674,-82,9375,265,9380,644,S
2016-03-25 14:43:13,9375,12,661686,-12,9375,259,9380,666,S
2016-03-25 14:43:13.5,9375,22,661708,18,9375,248,9380,656,S
2016-03-25 14:43:14,9375,6,661714,-2,9375,245,9380,657,S
2016-03-25 14:43:14.5,9380,2,661716,0,9375,244,9380,660,B
2016-03-25 14:43:15,9380,938,662654,852,9375,243,9380,197,B
2016-03-25 14:43:15.5,9380,206,662860,136,9375,244,9380,122,B
2016-03-25 14:43:16,9380,42,662902,-24,9375,224,9380,102,B
2016-03-25 14:43:16.5,9380,52,662954,52,9375,224,9380,76,B
2016-03-25 14:43:17,9380,22,662976,20,9375,224,9380,67,B
2016-03-25 14:43:18,9380,8,662984,0,9375,250,9380,68,B
2016-03-25 14:43:18.5,9380,6,662990,2,9375,503,9380,70,B
2016-03-25 14:43:19,9375,124,663114,36,9375,503,9380,9,S
2016-03-25 14:43:19.5,9380,14,663128,4,9375,507,9380,5,B
2016-03-25 14:43:20,9380,4,663132,0,9380,3,9385,249,B
2016-03-25 14:43:20.5,9380,20,663152,-2,9375,512,9380,67,B
2016-03-25 14:43:21,9380,2,663154,0,9375,517,9380,69,B
2016-03-25 14:43:21.5,9380,2,663156,-2,9375,517,9380,68,B
2016-03-25 14:43:22,9380,2,663158,0,9375,515,9380,94,B
2016-03-25 14:43:23,9380,10,663168,0,9375,516,9380,110,B
2016-03-25 14:43:25,9380,10,663178,0,9375,515,9380,224,B
2016-03-25 14:43:26,9380,8,663186,-8,9375,515,9380,221,B
2016-03-25 14:43:26.5,9380,10,663196,0,9375,515,9380,220,B
2016-03-25 14:43:27,9375,20,663216,-16,9375,505,9380,185,S
2016-03-25 14:43:28,9380,210,663426,-64,9375,505,9380,80,B
2016-03-25 14:43:28.5,9375,4,663430,-2,9375,502,9380,83,S
2016-03-25 14:43:29,9375,2,663432,0,9375,503,9380,83,S
2016-03-25 14:43:29.5,9375,2,663434,-2,9375,502,9380,76,S
2016-03-25 14:43:30,9380,6,663440,-4,9375,504,9380,86,B
2016-03-25 14:43:31,9380,4,663444,0,9375,504,9380,85,B
2016-03-25 14:43:31.5,9375,6,663450,2,9375,503,9380,90,S
2016-03-25 14:43:32,9380,28,663478,-10,9375,519,9380,80,B
2016-03-25 14:43:33,9380,160,663638,-24,9380,3,9385,229,B
2016-03-25 14:43:33.5,9380,38,663676,14,9380,10,9385,235,B
2016-03-25 14:43:34,9380,32,663708,-10,9375,514,9380,19,B
2016-03-25 14:43:34.5,9380,98,663806,-46,9375,526,9380,29,B
2016-03-25 14:43:35,9375,1050,664856,-206,9370,271,9375,81,S
2016-03-25 14:43:36,9375,104,664960,24,9370,264,9375,38,S
2016-03-25 14:43:36.5,9375,8,664968,0,9370,264,9375,34,S
2016-03-25 14:43:41,9370,6,664974,6,9370,268,9375,88,S
2016-03-25 14:43:42,9375,2,664976,0,9370,271,9375,90,B
2016-03-25 14:43:44,9370,2,664978,0,9370,269,9375,107,S
2016-03-25 14:43:44.5,9370,544,665522,-498,9365,187,9370,197,S
2016-03-25 14:43:45,9365,42,665564,42,9365,135,9370,198,S
2016-03-25 14:43:45.5,9370,10,665574,-8,9365,134,9370,200,B
2016-03-25 14:43:46,9365,6,665580,0,9365,130,9370,200,S
2016-03-25 14:43:47,9370,6,665586,0,9365,149,9370,202,B
2016-03-25 14:43:48,9370,24,665610,20,9365,149,9375,114,B
2016-03-25 14:43:49,9365,2,665612,2,9365,163,9375,178,S
2016-03-25 14:43:51,9375,36,665648,30,9370,108,9375,176,B
2016-03-25 14:43:55,9375,2,665650,-2,9370,136,9375,192,B
2016-03-25 14:43:56,9370,4,665654,-2,9370,135,9375,184,S
2016-03-25 14:43:56.5,9370,4,665658,0,9370,133,9375,187,S
2016-03-25 14:43:57,9375,6,665664,0,9370,133,9375,144,B
2016-03-25 14:43:59,9370,2,665666,0,9370,217,9375,144,S
2016-03-25 14:43:59.5,9370,16,665682,2,9370,212,9375,141,S
2016-03-25 14:44:01,9370,2,665684,-2,9370,327,9375,150,S
2016-03-25 14:44:02,9370,4,665688,-4,9370,352,9375,145,S
2016-03-25 14:44:04,9370,2,665690,-2,9370,350,9375,135,S
2016-03-25 14:44:05,9375,32,665722,32,9370,435,9375,119,B
2016-03-25 14:44:06,9370,870,666592,308,9365,149,9370,65,S
2016-03-25 14:44:06.5,9370,52,666644,12,9365,148,9370,39,S
2016-03-25 14:44:07,9370,2,666646,0,9365,148,9370,38,S
2016-03-25 14:44:08,9365,6,666652,0,9365,146,9370,38,S
2016-03-25 14:44:08.5,9370,2,666654,0,9365,147,9370,73,B
2016-03-25 14:44:09,9365,2,666656,0,9365,145,9370,74,S
2016-03-25 14:44:10,9370,8,666664,8,9365,145,9370,70,B
2016-03-25 14:44:11,9365,20,666684,20,9365,135,9370,70,S
2016-03-25 14:44:11.5,9365,6,666690,2,9365,132,9370,70,S
2016-03-25 14:44:12,9370,6,666696,4,9365,128,9370,74,B
2016-03-25 14:44:13,9370,2,666698,0,9365,83,9370,86,B
2016-03-25 14:44:14,9365,14,666712,4,9365,75,9370,174,S
2016-03-25 14:44:15,9370,4,666716,4,9365,75,9370,183,B
2016-03-25 14:44:17,9365,6,666722,0,9365,102,9370,196,S
2016-03-25 14:44:17.5,9365,2,666724,0,9365,107,9370,196,S
2016-03-25 14:44:19,9365,8,666732,0,9365,106,9370,166,S
2016-03-25 14:44:20,9370,2,666734,0,9365,118,9370,115,B
2016-03-25 14:44:21,9370,124,666858,-66,9370,8,9375,189,B
2016-03-25 14:44:22,9370,30,666888,-16,9365,188,9370,21,B
2016-03-25 14:44:23,9370,4,666892,0,9365,209,9370,25,B
2016-03-25 14:44:24,9370,50,666942,-40,9370,109,9375,180,B
2016-03-25 14:44:24.5,9370,22,666964,0,9370,98,9375,180,B
2016-03-25 14:44:28,9370,26,666990,-20,9370,91,9375,191,B
2016-03-25 14:44:28.5,9370,2,666992,-2,9370,90,9375,191,B
2016-03-25 14:44:29,9375,102,667094,-100,9370,40,9375,192,B
2016-03-25 14:44:31,9370,2,667096,2,9370,82,9375,198,S
2016-03-25 14:44:33,9370,10,667106,10,9370,196,9375,193,S
2016-03-25 14:44:36,9370,128,667234,-18,9365,246,9370,126,S
2016-03-25 14:44:41,9370,10,667244,0,9365,209,9370,186,S
2016-03-25 14:44:43,9370,110,667354,-110,9365,204,9370,104,S
2016-03-25 14:44:44,9370,210,667564,-206,9365,258,9375,257,S
2016-03-25 14:44:46,9370,4,667568,-4,9370,6,9375,266,S
2016-03-25 14:44:47,9370,2,667570,2,9370,32,9375,266,S
2016-03-25 14:44:49,9370,68,667638,-2,9365,295,9370,34,S
2016-03-25 14:44:49.5,9370,4,667642,-4,9365,296,9370,32,S
2016-03-25 14:44:50,9370,4,667646,-4,9365,296,9370,31,S
2016-03-25 14:44:52,9370,102,667748,6,9370,2,9375,233,S
2016-03-25 14:44:53,9370,28,667776,-14,9365,295,9370,47,S
2016-03-25 14:44:54,9365,4,667780,0,9365,294,9370,45,S
2016-03-25 14:44:57,9370,2,667782,0,9365,295,9370,9,B
2016-03-25 14:44:58,9370,2,667784,0,9365,263,9370,99,B
2016-03-25 14:44:59,9370,198,667982,-26,9370,104,9375,248,B
2016-03-25 14:45:00,9370,10,667992,-10,9370,100,9375,218,B
2016-03-25 14:45:01,9375,2,667994,2,9370,100,9375,217,B
2016-03-25 14:45:01.5,9370,6,668000,-6,9370,99,9375,217,S
2016-03-25 14:45:02,9370,12,668012,-6,9370,95,9375,230,S
2016-03-25 14:45:02.5,9375,2,668014,2,9370,115,9375,229,B
2016-03-25 14:45:03,9375,10,668024,0,9370,116,9375,226,B
2016-03-25 14:45:08,9375,4,668028,4,9370,129,9375,243,B
2016-03-25 14:45:11,9375,4,668032,4,9370,118,9375,242,B
2016-03-25 14:45:16,9375,14,668046,14,9370,121,9375,255,B
2016-03-25 14:45:18,9370,6,668052,-6,9370,118,9375,249,S
2016-03-25 14:45:18.5,9370,104,668156,-104,9370,66,9375,249,S
2016-03-25 14:45:19,9370,132,668288,50,9365,259,9370,304,S
2016-03-25 14:45:19.5,9370,10,668298,10,9365,259,9370,312,S
2016-03-25 14:45:20,9365,148,668446,-100,9365,157,9370,313,S
2016-03-25 14:45:21,9370,42,668488,2,9365,141,9370,310,B
2016-03-25 14:45:21.5,9365,278,668766,112,9360,295,9365,54,S
2016-03-25 14:45:24,9360,8,668774,-6,9360,293,9365,67,S
2016-03-25 14:45:25,9360,46,668820,-46,9360,269,9365,69,S
2016-03-25 14:45:25.5,9365,4,668824,-4,9360,268,9365,199,B
2016-03-25 14:45:27,9365,14,668838,0,9360,245,9365,193,B
2016-03-25 14:45:29,9365,100,668938,-20,9360,240,9365,143,B
2016-03-25 14:45:31,9360,12,668950,8,9360,218,9365,130,S
2016-03-25 14:45:32,9365,12,668962,0,9360,218,9365,134,B
2016-03-25 14:45:33,9365,2,668964,2,9360,220,9365,153,B
2016-03-25 14:45:37,9365,124,669088,4,9360,219,9365,102,B
2016-03-25 14:45:38,9360,16,669104,0,9360,207,9365,102,S
2016-03-25 14:45:39,9365,4,669108,0,9360,217,9365,102,B
2016-03-25 14:45:43,9365,2,669110,-2,9360,160,9365,109,B
2016-03-25 14:45:43.5,9360,2,669112,0,9360,159,9365,109,S
2016-03-25 14:45:44,9360,40,669152,0,9360,170,9365,109,S
2016-03-25 14:45:44.5,9360,6,669158,-2,9360,167,9365,109,S
2016-03-25 14:45:47,9365,4,669162,-4,9360,189,9365,119,B
2016-03-25 14:45:47.5,9365,238,669400,-170,9365,82,9370,298,B
2016-03-25 14:45:49,9365,4,669404,0,9365,107,9370,300,B
2016-03-25 14:45:51,9365,2,669406,0,9365,107,9370,290,B
2016-03-25 14:45:52,9365,8,669414,-8,9365,104,9370,288,B
2016-03-25 14:45:53,9370,40,669454,40,9365,105,9370,309,B
2016-03-25 14:45:58,9365,4,669458,-4,9365,108,9370,311,S
2016-03-25 14:45:59,9370,200,669658,-160,9365,108,9370,212,B
2016-03-25 14:46:00,9365,2,669660,-2,9365,112,9370,223,S
2016-03-25 14:46:01,9370,200,669860,-64,9365,139,9370,115,B
2016-03-25 14:46:02,9370,4,669864,0,9365,140,9370,114,B
2016-03-25 14:46:02.5,9370,228,670092,-196,9365,190,9375,168,B
2016-03-25 14:46:03,9370,10,670102,-10,9365,203,9375,180,B
2016-03-25 14:46:05,9370,98,670200,-96,9370,57,9375,188,B
2016-03-25 14:46:07,9370,2,670202,-2,9370,69,9375,168,B
2016-03-25 14:46:09,9370,4,670206,-4,9370,67,9375,168,B
2016-03-25 14:46:10,9370,4,670210,-4,9370,65,9375,178,B
2016-03-25 14:46:11,9370,22,670232,18,9370,66,9375,168,B
2016-03-25 14:46:16,9370,2,670234,-2,9370,166,9375,201,B
2016-03-25 14:46:16.5,9370,10,670244,0,9370,161,9375,198,B
2016-03-25 14:46:17,9370,208,670452,-182,9370,56,9375,197,B
2016-03-25 14:46:17.5,9370,4,670456,-2,9370,54,9375,212,B
2016-03-25 14:46:18,9370,2,670458,-2,9370,153,9375,199,B
2016-03-25 14:46:20,9370,4,670462,-4,9370,152,9375,197,B
2016-03-25 14:46:25,9370,2,670464,0,9370,201,9375,190,B
2016-03-25 14:46:27,9375,8,670472,0,9370,201,9375,186,B
2016-03-25 14:46:28,9370,4,670476,-4,9370,199,9375,186,S
2016-03-25 14:46:29,9370,2,670478,-2,9370,199,9375,186,S
2016-03-25 14:46:32,9370,12,670490,0,9370,204,9375,189,S
2016-03-25 14:46:37,9370,2,670492,0,9370,205,9375,204,S
2016-03-25 14:46:42,9370,10,670502,-10,9370,204,9375,213,S
2016-03-25 14:46:45,9370,14,670516,-10,9370,197,9375,213,S
2016-03-25 14:46:48,9375,2,670518,2,9370,217,9375,243,B
2016-03-25 14:46:55,9370,210,670728,-210,9370,115,9375,242,S
2016-03-25 14:46:56,9370,2,670730,-2,9370,114,9375,241,S
2016-03-25 14:46:58,9375,6,670736,-4,9370,115,9375,240,B
2016-03-25 14:47:01,9375,6,670742,0,9370,115,9375,239,B
2016-03-25 14:47:03,9375,10,670752,-4,9370,115,9375,234,B
2016-03-25 14:47:12,9370,312,671064,30,9365,221,9370,74,S
2016-03-25 14:47:13,9370,206,671270,-8,9365,206,9370,36,S
2016-03-25 14:47:15,9370,2,671272,2,9365,173,9370,44,S
2016-03-25 14:47:17,9370,4,671276,4,9365,145,9370,43,S
2016-03-25 14:47:20,9365,4,671280,-2,9365,143,9370,174,S
2016-03-25 14:47:21,9360,292,671572,-274,9365,27,9370,174,S
2016-03-25 14:47:21.5,9365,12,671584,-12,9365,27,9370,175,B
2016-03-25 14:47:22,9365,40,671624,0,9365,10,9370,185,B
2016-03-25 14:47:24,9365,6,671630,-6,9365,237,9370,189,B
2016-03-25 14:47:24.5,9370,2,671632,2,9365,238,9370,188,B
2016-03-25 14:47:25,9370,20,671652,0,9365,238,9370,179,B
2016-03-25 14:47:25.5,9365,20,671672,18,9365,228,9370,179,S
2016-03-25 14:47:27,9365,2,671674,0,9365,227,9370,181,S
2016-03-25 14:47:28,9370,2,671676,0,9365,227,9370,180,B
2016-03-25 14:47:32,9370,6,671682,6,9365,233,9370,178,B
2016-03-25 14:47:32.5,9365,12,671694,12,9365,227,9370,180,S
2016-03-25 14:47:37,9370,28,671722,-16,9365,113,9370,254,B
2016-03-25 14:47:39,9365,10,671732,0,9365,128,9370,274,S
2016-03-25 14:47:41,9365,2,671734,2,9365,127,9370,274,S
2016-03-25 14:47:46,9365,20,671754,20,9365,117,9370,282,S
2016-03-25 14:47:48,9365,2,671756,2,9365,165,9370,281,S
2016-03-25 14:47:48.5,9365,2,671758,2,9365,164,9370,281,S
2016-03-25 14:47:51,9370,218,671976,-132,9370,123,9375,345,B
2016-03-25 14:47:54,9370,2,671978,-2,9370,137,9375,335,B
2016-03-25 14:47:55,9370,12,671990,-12,9370,151,9375,319,B
2016-03-25 14:47:57,9375,40,672030,4,9370,131,9375,251,B
2016-03-25 14:47:58,9375,12,672042,-10,9370,131,9375,246,B
2016-03-25 14:47:58.5,9370,2,672044,0,9370,130,9375,246,S
2016-03-25 14:47:59,9370,4,672048,0,9370,128,9375,249,S
2016-03-25 14:48:00,9370,2,672050,0,9370,127,9375,248,S
2016-03-25 14:48:01,9370,2,672052,-2,9370,126,9375,249,S
2016-03-25 14:48:02,9375,2,672054,0,9370,126,9375,233,B
2016-03-25 14:48:02.5,9375,2,672056,-2,9370,126,9375,232,B
2016-03-25 14:48:06,9370,2,672058,-2,9370,139,9375,255,S
2016-03-25 14:48:11,9375,18,672076,4,9370,157,9375,257,B
2016-03-25 14:48:11.5,9375,20,672096,0,9370,157,9375,247,B
2016-03-25 14:48:12,9375,20,672116,6,9370,157,9375,227,B
2016-03-25 14:48:18,9375,8,672124,-8,9370,158,9375,233,B
2016-03-25 14:48:23,9370,4,672128,-4,9370,150,9375,322,S
2016-03-25 14:48:24,9375,2,672130,0,9370,150,9375,321,B
2016-03-25 14:48:28,9370,2,672132,0,9370,150,9375,320,S
2016-03-25 14:48:29,9375,6,672138,-6,9370,149,9375,327,B
2016-03-25 14:48:30,9370,200,672338,0,9370,49,9375,327,S
2016-03-25 14:48:30.5,9370,96,672434,-86,9365,142,9370,238,S
2016-03-25 14:48:31,9365,12,672446,12,9365,136,9370,235,S
2016-03-25 14:48:32,9370,2,672448,-2,9365,135,9370,117,B
2016-03-25 14:48:33,9370,110,672558,90,9365,86,9370,112,B
2016-03-25 14:48:34,9370,332,672890,-126,9370,47,9375,383,B
2016-03-25 14:48:34.5,9370,8,672898,0,9370,43,9375,378,B
2016-03-25 14:48:35,9370,86,672984,0,9365,85,9370,191,B
2016-03-25 14:48:35.5,9370,20,673004,0,9365,85,9370,1,B
2016-03-25 14:48:36,9370,6,673010,-4,9365,128,9375,369,B
2016-03-25 14:48:36.5,9370,16,673026,0,9365,134,9370,6,B
2016-03-25 14:48:39,9370,56,673082,-32,9370,77,9375,365,B
2016-03-25 14:48:39.5,9375,42,673124,-2,9370,59,9375,359,B
2016-03-25 14:48:41,9370,2,673126,0,9370,213,9375,356,S
2016-03-25 14:48:43,9370,2,673128,0,9370,215,9375,343,S
2016-03-25 14:48:48,9370,20,673148,0,9370,215,9375,314,S
2016-03-25 14:48:49,9370,2,673150,-2,9370,160,9375,321,S
2016-03-25 14:48:50,9370,40,673190,0,9370,140,9375,321,S
2016-03-25 14:48:50.5,9370,2,673192,-2,9370,140,9375,321,S
2016-03-25 14:48:51,9370,2,673194,0,9370,139,9375,321,S
2016-03-25 14:48:51.5,9370,8,673202,0,9370,135,9375,321,S
2016-03-25 14:48:53,9375,16,673218,-10,9370,135,9375,332,B
2016-03-25 14:48:54,9370,2,673220,-2,9370,134,9375,334,S
2016-03-25 14:48:55,9370,2,673222,0,9370,133,9375,431,S
2016-03-25 14:48:56,9370,12,673234,-2,9370,132,9375,427,S
2016-03-25 14:48:56.5,9370,4,673238,-4,9370,130,9375,426,S
2016-03-25 14:48:57,9370,40,673278,-24,9370,110,9375,426,S
2016-03-25 14:48:58,9370,4,673282,4,9370,108,9375,426,S
2016-03-25 14:49:00,9375,6,673288,0,9370,108,9375,423,B
2016-03-25 14:49:01,9370,40,673328,40,9370,88,9375,424,S
2016-03-25 14:49:02,9370,42,673370,40,9370,67,9375,425,S
2016-03-25 14:49:02.5,9370,2,673372,0,9370,65,9375,426,S
2016-03-25 14:49:04,9370,6,673378,0,9370,62,9375,473,S
2016-03-25 14:49:08,9370,6,673384,6,9370,60,9375,508,S
2016-03-25 14:49:09,9370,16,673400,16,9370,57,9375,519,S
2016-03-25 14:49:10,9370,2,673402,2,9370,56,9375,521,S
2016-03-25 14:49:12,9370,2,673404,2,9370,66,9375,516,S
2016-03-25 14:49:13,9370,30,673434,0,9370,51,9375,501,S
2016-03-25 14:49:14,9370,40,673474,26,9370,31,9375,477,S
2016-03-25 14:49:15,9370,48,673522,2,9370,7,9375,477,S
2016-03-25 14:49:15.5,9370,48,673570,0,9370,36,9375,476,S
2016-03-25 14:49:16,9370,2,673572,0,9370,36,9375,476,S
2016-03-25 14:49:16.5,9370,8,673580,-8,9370,32,9375,478,S
2016-03-25 14:49:17,9370,4,673584,-2,9370,30,9375,478,S
2016-03-25 14:49:18,9370,10,673594,-10,9370,25,9375,478,S
2016-03-25 14:49:20,9370,60,673654,-60,9365,254,9370,3,S
2016-03-25 14:49:22,9370,2,673656,2,9365,254,9370,123,S
2016-03-25 14:49:29,9370,54,673710,0,9365,253,9370,68,S
2016-03-25 14:49:29.5,9370,90,673800,-22,9365,253,9375,348,S
2016-03-25 14:49:30,9370,10,673810,-10,9365,253,9370,19,S
2016-03-25 14:49:30.5,9370,50,673860,4,9370,2,9375,362,S
2016-03-25 14:49:31,9370,10,673870,-6,9370,21,9375,389,S
2016-03-25 14:49:31.5,9370,12,673882,0,9370,30,9375,347,S
2016-03-25 14:49:32,9370,2,673884,0,9370,29,9375,342,S
2016-03-25 14:49:33,9370,2,673886,-2,9370,71,9375,337,S
2016-03-25 14:49:37,9370,2,673888,0,9370,309,9375,340,S
2016-03-25 14:49:43,9370,2,673890,0,9370,337,9375,392,S
2016-03-25 14:49:47,9370,2,673892,0,9370,340,9375,400,S
2016-03-25 14:49:48,9370,52,673944,-44,9370,314,9375,400,S
2016-03-25 14:49:49,9370,2,673946,2,9370,312,9375,404,S
2016-03-25 14:49:51,9375,40,673986,-38,9370,334,9375,385,B
2016-03-25 14:49:51.5,9370,40,674026,0,9370,314,9375,385,S
2016-03-25 14:49:52,9370,2,674028,2,9370,314,9375,385,S
2016-03-25 14:49:56,9370,42,674070,-14,9370,317,9375,777,S
2016-03-25 14:49:58,9370,2,674072,2,9370,315,9375,792,S
2016-03-25 14:50:00,9370,2,674074,0,9370,324,9375,793,S
2016-03-25 14:50:01,9375,774,674848,166,9375,44,9380,540,B
2016-03-25 14:50:02,9380,28,674876,-4,9375,240,9380,502,B
2016-03-25 14:50:02.5,9375,10,674886,0,9375,887,9380,502,S
2016-03-25 14:50:03,9380,2,674888,0,9375,887,9380,454,B
2016-03-25 14:50:03.5,9380,400,675288,-94,9375,887,9385,199,B
2016-03-25 14:50:04,9380,420,675708,-108,9380,277,9385,262,B
2016-03-25 14:50:04.5,9380,568,676276,-242,9375,252,9380,113,B
2016-03-25 14:50:05,9380,6,676282,-2,9375,18,9380,130,B
2016-03-25 14:50:06,9380,4,676286,-4,9375,49,9380,138,B
2016-03-25 14:50:06.5,9380,4,676290,0,9375,54,9380,138,B
2016-03-25 14:50:07,9380,4,676294,-2,9375,58,9380,137,B
2016-03-25 14:50:08,9375,2,676296,2,9375,323,9380,141,S
2016-03-25 14:50:08.5,9380,4,676300,-4,9375,554,9380,140,B
2016-03-25 14:50:10,9380,6,676306,-6,9375,758,9380,140,B
2016-03-25 14:50:10.5,9380,90,676396,-86,9375,737,9380,96,B
2016-03-25 14:50:11,9380,208,676604,-30,9380,17,9385,189,B
2016-03-25 14:50:12,9380,94,676698,48,9380,208,9385,207,B
2016-03-25 14:50:12.5,9385,284,676982,146,9380,199,9385,62,B
2016-03-25 14:50:13,9385,4,676986,-4,9380,210,9385,87,B
2016-03-25 14:50:13.5,9385,2,676988,0,9380,210,9385,86,B
2016-03-25 14:50:14,9385,32,677020,-26,9380,213,9385,113,B
2016-03-25 14:50:15,9385,2,677022,2,9380,215,9385,112,B
2016-03-25 14:50:16,9385,80,677102,-30,9380,217,9385,72,B
2016-03-25 14:50:17,9385,10,677112,-10,9380,218,9385,183,B
2016-03-25 14:50:18,9385,14,677126,-14,9380,209,9385,177,B
2016-03-25 14:50:20,9385,2,677128,-2,9380,211,9385,181,B
2016-03-25 14:50:20.5,9385,204,677332,8,9380,211,9385,81,B
2016-03-25 14:50:21,9385,6,677338,0,9380,210,9385,80,B
2016-03-25 14:50:22,9385,8,677346,-8,9380,226,9385,177,B
2016-03-25 14:50:22.5,9385,12,677358,-12,9380,226,9385,172,B
2016-03-25 14:50:23,9385,4,677362,0,9380,226,9385,181,B
2016-03-25 14:50:23.5,9385,4,677366,-4,9380,226,9385,184,B
2016-03-25 14:50:24,9380,4,677370,-2,9380,52,9385,189,S
2016-03-25 14:50:25,9385,42,677412,0,9380,34,9385,169,B
2016-03-25 14:50:27,9385,2,677414,-2,9380,102,9385,204,B
2016-03-25 14:50:28,9385,48,677462,-8,9380,82,9385,181,B
2016-03-25 14:50:29,9385,154,677616,96,9380,160,9390,103,B
2016-03-25 14:50:31,9385,22,677638,-14,9380,95,9385,14,B
2016-03-25 14:50:31.5,9380,44,677682,-20,9380,96,9385,53,S
2016-03-25 14:50:32,9385,26,677708,-6,9380,97,9385,27,B
2016-03-25 14:50:32.5,9385,4,677712,0,9380,102,9385,53,B
2016-03-25 14:50:33,9385,50,677762,-34,9380,92,9385,71,B
2016-03-25 14:50:33.5,9380,16,677778,8,9380,85,9385,81,S
2016-03-25 14:50:34,9380,20,677798,0,9380,75,9385,81,S
2016-03-25 14:50:34.5,9380,2,677800,2,9380,75,9385,81,S
2016-03-25 14:50:35,9385,6,677806,-6,9380,85,9385,122,B
2016-03-25 14:50:35.5,9385,2,677808,-2,9380,85,9385,114,B
2016-03-25 14:50:36,9385,2,677810,0,9380,85,9385,120,B
2016-03-25 14:50:38,9380,4,677814,0,9380,86,9385,117,S
2016-03-25 14:50:39,9380,4,677818,0,9380,85,9385,118,S
2016-03-25 14:50:41,9385,4,677822,-4,9380,86,9385,138,B
2016-03-25 14:50:42,9380,2,677824,0,9380,85,9385,134,S
2016-03-25 14:50:44,9380,2,677826,2,9380,94,9385,154,S
2016-03-25 14:50:45,9385,2,677828,0,9380,404,9385,140,B
2016-03-25 14:50:46,9385,2,677830,-2,9380,404,9385,142,B
2016-03-25 14:50:46.5,9380,2,677832,2,9380,403,9385,142,S
2016-03-25 14:50:47,9380,24,677856,4,9380,391,9385,142,S
2016-03-25 14:50:47.5,9380,10,677866,10,9380,385,9385,142,S
2016-03-25 14:50:48,9385,180,678046,-98,9380,384,9390,128,B
2016-03-25 14:50:49,9385,4,678050,0,9380,383,9385,58,B
2016-03-25 14:50:50,9385,4,678054,0,9380,383,9385,56,B
2016-03-25 14:50:51,9385,12,678066,2,9380,385,9390,119,B
2016-03-25 14:50:52,9385,4,678070,-2,9380,385,9390,123,B
2016-03-25 14:50:55,9385,32,678102,-6,9380,385,9385,76,B
2016-03-25 14:50:55.5,9385,204,678306,36,9385,98,9390,179,B
2016-03-25 14:50:56,9385,118,678424,20,9385,44,9390,167,B
2016-03-25 14:50:56.5,9385,8,678432,8,9385,41,9390,184,B
2016-03-25 14:50:57,9385,2,678434,2,9385,51,9390,188,B
2016-03-25 14:50:58,9390,4,678438,-2,9385,51,9390,188,B
2016-03-25 14:50:58.5,9390,26,678464,-6,9385,61,9390,177,B
2016-03-25 14:50:59,9390,6,678470,-6,9385,64,9390,174,B
2016-03-25 14:50:59.5,9385,24,678494,-6,9385,107,9390,163,S
2016-03-25 14:51:00,9385,6,678500,6,9385,104,9390,147,S
2016-03-25 14:51:01,9385,2,678502,2,9385,104,9390,123,S
2016-03-25 14:51:01.5,9385,2,678504,2,9385,103,9390,113,S
2016-03-25 14:51:03,9385,20,678524,12,9385,351,9390,112,S
2016-03-25 14:51:04,9390,2,678526,0,9385,351,9390,121,B
2016-03-25 14:51:06,9390,154,678680,-36,9385,667,9390,36,B
2016-03-25 14:51:06.5,9390,82,678762,26,9390,231,9395,683,B
2016-03-25 14:51:07,9390,2,678764,0,9390,246,9395,701,B
2016-03-25 14:51:07.5,9390,186,678950,-146,9390,154,9395,824,B
2016-03-25 14:51:08,9390,198,679148,-18,9385,96,9390,333,B
2016-03-25 14:51:08.3333,9390,82,679230,0,9385,95,9390,261,B
2016-03-25 14:51:08.6667,9390,6,679236,0,9385,85,9390,258,B
2016-03-25 14:51:09,9385,20,679256,20,9385,85,9390,259,S
2016-03-25 14:51:10,9385,6,679262,0,9385,73,9390,280,S
2016-03-25 14:51:11,9390,20,679282,0,9385,77,9390,262,B
2016-03-25 14:51:11.5,9385,2,679284,2,9385,109,9390,262,S
2016-03-25 14:51:12,9390,2,679286,2,9385,111,9390,261,B
2016-03-25 14:51:13,9385,2,679288,2,9385,110,9390,261,S
2016-03-25 14:51:15,9385,8,679296,8,9385,109,9390,281,S
2016-03-25 14:51:15.5,9390,2,679298,0,9385,109,9390,285,B
2016-03-25 14:51:16,9385,212,679510,-126,9385,7,9390,282,S
2016-03-25 14:51:16.5,9390,72,679582,-38,9385,134,9390,271,B
2016-03-25 14:51:17,9385,4,679586,-4,9385,134,9390,322,S
2016-03-25 14:51:18,9385,2,679588,0,9385,141,9390,321,S
2016-03-25 14:51:20,9385,2,679590,0,9385,140,9390,332,S
2016-03-25 14:51:21,9385,2,679592,0,9385,140,9390,332,S
2016-03-25 14:51:22,9385,4,679596,0,9385,139,9390,453,S
2016-03-25 14:51:24,9385,12,679608,-2,9385,188,9390,453,S
2016-03-25 14:51:27,9385,2,679610,0,9385,276,9390,478,S
2016-03-25 14:51:29,9390,30,679640,-18,9385,186,9390,490,B
2016-03-25 14:51:30,9385,2,679642,0,9385,185,9390,500,S
2016-03-25 14:51:32,9385,2,679644,0,9385,202,9390,502,S
2016-03-25 14:51:32.5,9385,2,679646,-2,9385,201,9390,502,S
2016-03-25 14:51:33,9385,6,679652,-2,9385,198,9390,502,S
2016-03-25 14:51:33.5,9385,6,679658,-6,9385,195,9390,502,S
2016-03-25 14:51:34,9390,4,679662,0,9385,196,9390,503,B
2016-03-25 14:51:35,9385,20,679682,-18,9385,236,9390,534,S
2016-03-25 14:51:35.5,9385,6,679688,2,9385,233,9390,534,S
2016-03-25 14:51:36,9385,56,679744,0,9385,205,9390,534,S
2016-03-25 14:51:36.5,9390,42,679786,0,9385,234,9390,514,B
2016-03-25 14:51:37,9385,2,679788,0,9385,233,9390,514,S
2016-03-25 14:51:38,9385,80,679868,-30,9385,192,9390,474,S
2016-03-25 14:51:39,9385,2,679870,2,9385,191,9390,479,S
2016-03-25 14:51:39.5,9385,12,679882,0,9385,185,9390,481,S
2016-03-25 14:51:40,9385,2,679884,0,9385,184,9390,486,S
2016-03-25 14:51:41,9385,8,679892,8,9385,132,9390,512,S
2016-03-25 14:51:42,9385,4,679896,0,9385,133,9390,507,S
2016-03-25 14:51:42.5,9385,30,679926,2,9385,128,9390,497,S
2016-03-25 14:51:44,9390,20,679946,0,9385,133,9390,489,B
2016-03-25 14:51:48,9385,2,679948,2,9385,135,9390,501,S
2016-03-25 14:51:49,9390,4,679952,4,9385,135,9390,482,B
2016-03-25 14:51:51,9385,10,679962,10,9385,130,9390,482,S
2016-03-25 14:51:53,9390,2,679964,0,9385,130,9390,478,B
2016-03-25 14:51:54,9390,2,679966,2,9385,140,9390,477,B
2016-03-25 14:51:55,9385,10,679976,10,9385,136,9390,478,S
2016-03-25 14:51:56,9385,6,679982,0,9385,135,9390,481,S
2016-03-25 14:52:06,9385,2,679984,2,9385,206,9390,508,S
2016-03-25 14:52:09,9385,4,679988,4,9385,143,9390,508,S
2016-03-25 14:52:10,9390,4,679992,2,9385,142,9390,535,B
2016-03-25 14:52:11,9385,6,679998,6,9385,139,9390,557,S
2016-03-25 14:52:12,9385,2,680000,2,9385,186,9390,557,S
2016-03-25 14:52:12.5,9390,14,680014,10,9385,181,9390,555,B
2016-03-25 14:52:13,9385,2,680016,0,9385,180,9390,557,S
2016-03-25 14:52:15,9385,2,680018,2,9385,179,9390,559,S
2016-03-25 14:52:15.5,9390,2,680020,2,9385,178,9390,558,B
2016-03-25 14:52:19,9385,6,680026,0,9385,178,9390,540,S
2016-03-25 14:52:21,9390,12,680038,0,9385,189,9390,502,B
2016-03-25 14:52:22,9385,2,680040,0,9385,188,9390,502,S
2016-03-25 14:52:23,9390,20,680060,20,9385,193,9390,492,B
2016-03-25 14:52:24,9385,10,680070,0,9385,188,9390,492,S
2016-03-25 14:52:25,9385,2,680072,2,9385,191,9390,492,S
2016-03-25 14:52:25.5,9390,102,680174,100,9385,190,9390,442,B
2016-03-25 14:52:26,9390,12,680186,4,9385,189,9390,437,B
2016-03-25 14:52:27,9390,880,681066,764,9390,221,9395,929,B
2016-03-25 14:52:28,9395,1648,682714,414,9390,323,9400,378,B
2016-03-25 14:52:28.5,9395,96,682810,-30,9390,327,9400,374,B
2016-03-25 14:52:29,9400,28,682838,-6,9390,337,9400,422,B
2016-03-25 14:52:29.5,9405,896,683734,276,9395,92,9405,247,B
2016-03-25 14:52:30,9405,374,684108,-192,9400,41,9410,272,B
2016-03-25 14:52:30.5,9405,166,684274,-38,9400,78,9405,75,B
2016-03-25 14:52:31,9405,350,684624,-218,9405,1,9410,243,B
2016-03-25 14:52:31.5,9405,18,684642,-18,9400,32,9405,114,B
2016-03-25 14:52:32,9405,44,684686,-40,9400,33,9405,93,B
2016-03-25 14:52:32.5,9400,84,684770,-36,9395,140,9400,508,S
2016-03-25 14:52:33,9400,122,684892,-82,9395,45,9400,453,S
2016-03-25 14:52:34,9400,42,684934,-22,9395,163,9400,427,S
2016-03-25 14:52:34.5,9400,2,684936,-2,9395,164,9400,426,S
2016-03-25 14:52:35,9400,60,684996,-60,9395,164,9400,401,S
2016-03-25 14:52:36,9400,42,685038,-2,9395,174,9400,6,S
2016-03-25 14:52:36.5,9400,24,685062,10,9400,18,9405,175,S
2016-03-25 14:52:37,9400,10,685072,0,9400,15,9405,170,S
2016-03-25 14:52:37.5,9400,30,685102,-12,9395,182,9400,359,S
2016-03-25 14:52:38,9400,362,685464,-122,9395,161,9400,181,S
2016-03-25 14:52:38.5,9400,12,685476,-10,9395,168,9400,177,S
2016-03-25 14:52:39,9400,24,685500,-24,9395,240,9400,185,S
2016-03-25 14:52:39.5,9400,64,685564,-2,9395,206,9400,173,S
2016-03-25 14:52:40,9400,62,685626,-18,9395,162,9400,187,S
2016-03-25 14:52:40.5,9400,22,685648,-22,9395,161,9400,176,S
2016-03-25 14:52:41,9400,30,685678,-26,9395,161,9400,163,S
2016-03-25 14:52:42,9395,10,685688,-8,9395,162,9400,162,S
2016-03-25 14:52:42.5,9400,2,685690,-2,9395,171,9400,163,B
2016-03-25 14:52:43,9400,52,685742,-52,9395,166,9400,138,B
2016-03-25 14:52:43.5,9400,4,685746,-2,9395,173,9400,139,B
2016-03-25 14:52:44,9395,22,685768,2,9395,173,9400,135,S
2016-03-25 14:52:44.5,9400,32,685800,-30,9395,171,9400,120,B
2016-03-25 14:52:45,9400,6,685806,4,9395,168,9400,132,B
2016-03-25 14:52:45.5,9400,26,685832,-6,9395,157,9400,156,B
2016-03-25 14:52:47,9400,6,685838,0,9395,184,9400,153,B
2016-03-25 14:52:48,9400,40,685878,-20,9395,201,9400,134,B
2016-03-25 14:52:49,9400,22,685900,-16,9395,200,9400,134,B
2016-03-25 14:52:49.5,9395,4,685904,0,9395,198,9400,138,S
2016-03-25 14:52:50,9400,2,685906,2,9395,193,9400,137,B
2016-03-25 14:52:50.5,9400,10,685916,0,9395,204,9400,132,B
2016-03-25 14:52:51,9400,2,685918,0,9395,207,9400,143,B
2016-03-25 14:52:52,9400,26,685944,0,9395,203,9400,130,B
2016-03-25 14:52:52.5,9400,2,685946,2,9395,196,9400,129,B
2016-03-25 14:52:54,9400,258,686204,170,9400,35,9405,124,B
2016-03-25 14:52:54.5,9405,2,686206,0,9400,42,9405,151,B
2016-03-25 14:52:55,9400,30,686236,4,9400,30,9405,152,S
2016-03-25 14:52:56,9400,4,686240,2,9400,63,9405,152,S
2016-03-25 14:52:57,9405,6,686246,0,9400,109,9405,150,B
2016-03-25 14:52:57.5,9400,6,686252,6,9400,155,9405,132,S
2016-03-25 14:52:58,9400,4,686256,4,9400,153,9405,132,S
2016-03-25 14:52:58.5,9400,4,686260,4,9400,151,9405,131,S
2016-03-25 14:52:59,9405,10,686270,0,9400,151,9405,126,B
2016-03-25 14:52:59.5,9405,8,686278,4,9400,153,9405,124,B
2016-03-25 14:53:00,9405,2,686280,2,9400,155,9405,173,B
2016-03-25 14:53:00.5,9405,22,686302,8,9400,155,9405,220,B
2016-03-25 14:53:01,9405,2,686304,2,9400,155,9405,219,B
2016-03-25 14:53:02,9405,110,686414,-96,9400,154,9405,169,B
2016-03-25 14:53:03,9405,6,686420,0,9400,162,9405,174,B
2016-03-25 14:53:03.5,9405,106,686526,32,9400,161,9405,121,B
2016-03-25 14:53:04,9405,6,686532,0,9400,161,9405,118,B
2016-03-25 14:53:04.5,9405,14,686546,10,9400,155,9405,144,B
2016-03-25 14:53:05,9400,12,686558,6,9400,132,9405,150,S
2016-03-25 14:53:06,9405,2,686560,-2,9400,137,9405,193,B
2016-03-25 14:53:07,9405,80,686640,4,9400,141,9405,172,B
2016-03-25 14:53:07.5,9405,20,686660,10,9400,142,9405,162,B
2016-03-25 14:53:08,9405,10,686670,2,9400,138,9405,162,B
2016-03-25 14:53:09,9400,22,686692,12,9400,127,9405,162,S
2016-03-25 14:53:09.5,9405,482,687174,82,9400,84,9405,54,B
2016-03-25 14:53:10,9400,2,687176,0,9400,141,9405,73,S
2016-03-25 14:53:10.5,9405,340,687516,126,9405,110,9410,304,B
2016-03-25 14:53:11,9405,44,687560,44,9405,89,9410,297,B
2016-03-25 14:53:11.5,9405,188,687748,8,9405,185,9410,761,B
2016-03-25 14:53:12,9410,2,687750,0,9405,191,9410,740,B
2016-03-25 14:53:12.5,9410,358,688108,128,9405,198,9410,560,B
2016-03-25 14:53:13,9410,110,688218,4,9405,377,9410,35,B
2016-03-25 14:53:13.5,9405,34,688252,8,9405,368,9410,151,S
2016-03-25 14:53:14,9405,18,688270,-10,9405,367,9410,143,S
2016-03-25 14:53:14.5,9405,2,688272,2,9405,376,9410,144,S
2016-03-25 14:53:15,9405,108,688380,6,9405,322,9410,145,S
2016-03-25 14:53:16,9405,22,688402,-14,9405,311,9410,146,S
2016-03-25 14:53:16.5,9405,2,688404,-2,9405,310,9410,152,S
2016-03-25 14:53:17,9405,122,688526,0,9405,248,9410,157,S
2016-03-25 14:53:17.5,9405,4,688530,4,9405,280,9410,159,S
2016-03-25 14:53:18,9405,100,688630,-90,9400,228,9405,300,S
2016-03-25 14:53:18.5,9400,122,688752,-48,9400,162,9405,298,S
2016-03-25 14:53:19,9405,6,688758,-6,9400,159,9405,302,B
2016-03-25 14:53:20,9405,12,688770,-12,9400,158,9405,296,B
2016-03-25 14:53:21,9405,14,688784,-12,9400,454,9405,307,B
2016-03-25 14:53:22,9405,52,688836,-32,9405,36,9410,185,B
2016-03-25 14:53:22.5,9405,2,688838,2,9405,5,9410,193,B
2016-03-25 14:53:23,9405,60,688898,-54,9405,3,9410,203,B
2016-03-25 14:53:23.5,9410,118,689016,-48,9405,21,9410,179,B
2016-03-25 14:53:24,9405,2,689018,-2,9405,5,9410,181,S
2016-03-25 14:53:24.5,9405,8,689026,-2,9405,34,9410,180,S
2016-03-25 14:53:26,9405,8,689034,-2,9405,91,9410,531,S
2016-03-25 14:53:26.5,9405,4,689038,-4,9405,389,9410,536,S
2016-03-25 14:53:27,9410,2,689040,0,9405,588,9410,567,B
2016-03-25 14:53:28,9405,200,689240,-64,9405,489,9410,595,S
2016-03-25 14:53:28.5,9405,2,689242,2,9405,508,9410,596,S
2016-03-25 14:53:29,9405,4,689246,4,9405,547,9410,597,S
2016-03-25 14:53:29.5,9405,26,689272,4,9405,536,9410,596,S
2016-03-25 14:53:30,9405,40,689312,0,9405,516,9410,577,S
2016-03-25 14:53:30.5,9405,4,689316,2,9405,516,9410,576,S
2016-03-25 14:53:31,9405,72,689388,0,9405,480,9410,589,S
2016-03-25 14:53:32,9405,6,689394,0,9405,488,9410,590,S
2016-03-25 14:53:32.5,9405,200,689594,0,9405,388,9410,590,S
2016-03-25 14:53:34,9405,4,689598,4,9405,407,9410,590,S
2016-03-25 14:53:34.5,9405,10,689608,10,9405,403,9410,600,S
2016-03-25 14:53:35,9405,8,689616,8,9405,405,9410,600,S
2016-03-25 14:53:35.5,9405,204,689820,2,9405,302,9410,801,S
2016-03-25 14:53:36,9405,4,689824,2,9405,300,9410,802,S
2016-03-25 14:53:37,9410,2,689826,2,9405,301,9410,802,B
2016-03-25 14:53:37.5,9405,240,690066,-2,9405,191,9410,792,S
2016-03-25 14:53:38,9405,20,690086,20,9405,248,9410,790,S
2016-03-25 14:53:39,9405,302,690388,-12,9405,97,9410,790,S
2016-03-25 14:53:39.5,9405,6,690394,-6,9405,95,9410,805,S
2016-03-25 14:53:40,9405,186,690580,-110,9400,675,9405,10,S
2016-03-25 14:53:40.3333,9405,28,690608,-6,9405,63,9410,530,S
2016-03-25 14:53:40.6667,9405,6,690614,2,9405,61,9410,532,S
2016-03-25 14:53:42,9405,20,690634,0,9405,52,9410,537,S
2016-03-25 14:53:43,9405,12,690646,12,9405,54,9410,540,S
2016-03-25 14:53:43.5,9405,4,690650,2,9405,52,9410,540,S
2016-03-25 14:53:44,9405,106,690756,0,9400,680,9405,58,S
2016-03-25 14:53:44.5,9405,130,690886,14,9405,6,9410,539,S
2016-03-25 14:53:45,9405,12,690898,-12,9400,676,9405,295,S
2016-03-25 14:53:46,9405,22,690920,-2,9400,676,9405,292,S
2016-03-25 14:53:46.5,9405,2,690922,0,9400,676,9405,300,S
2016-03-25 14:53:47,9410,1000,691922,-636,9405,2,9410,364,B
2016-03-25 14:53:48,9405,14,691936,10,9405,2,9410,365,S
2016-03-25 14:53:48.5,9410,4,691940,2,9405,1,9410,364,B
2016-03-25 14:53:49,9405,8,691948,0,9400,678,9405,100,S
2016-03-25 14:53:49.5,9405,10,691958,2,9400,667,9405,98,S
2016-03-25 14:53:50,9405,22,691980,-2,9400,667,9405,90,S
2016-03-25 14:53:50.5,9405,100,692080,-100,9400,666,9405,41,S
2016-03-25 14:53:51,9405,100,692180,-16,9400,666,9405,1,S
2016-03-25 14:53:51.5,9405,8,692188,8,9405,1,9410,385,S
2016-03-25 14:53:52,9405,30,692218,-22,9405,4,9410,385,S
2016-03-25 14:53:53,9405,20,692238,-8,9400,675,9405,403,S
2016-03-25 14:53:53.5,9405,2,692240,0,9400,681,9405,404,S
2016-03-25 14:53:54,9400,6,692246,2,9400,731,9405,416,S
2016-03-25 14:53:56,9405,362,692608,-244,9400,572,9405,282,B
2016-03-25 14:53:57,9405,40,692648,-40,9400,572,9405,262,B
2016-03-25 14:53:57.5,9405,30,692678,-10,9400,572,9405,249,B
2016-03-25 14:53:58,9405,4,692682,0,9400,572,9405,250,B
2016-03-25 14:53:59,9405,2,692684,0,9400,572,9405,249,B
2016-03-25 14:53:59.5,9405,10,692694,0,9400,572,9405,244,B
2016-03-25 14:54:00,9405,96,692790,-62,9400,552,9405,196,B
2016-03-25 14:54:00.5,9405,2,692792,0,9400,552,9405,195,B
2016-03-25 14:54:01,9400,24,692816,2,9400,631,9405,190,S
2016-03-25 14:54:02,9405,30,692846,-30,9400,632,9405,176,B
2016-03-25 14:54:02.5,9400,32,692878,-32,9400,650,9405,176,S
2016-03-25 14:54:03,9405,86,692964,-86,9400,650,9405,135,B
2016-03-25 14:54:04,9405,4,692968,0,9400,650,9405,135,B
2016-03-25 14:54:05,9405,22,692990,-2,9400,649,9405,125,B
2016-03-25 14:54:05.5,9400,6,692996,-6,9400,696,9405,125,S
2016-03-25 14:54:06,9405,6,693002,0,9400,694,9405,122,B
2016-03-25 14:54:06.5,9405,186,693188,46,9400,692,9405,30,B
2016-03-25 14:54:07,9405,22,693210,22,9400,686,9405,25,B
2016-03-25 14:54:07.5,9405,98,693308,8,9400,651,9405,80,B
2016-03-25 14:54:08,9405,8,693316,-8,9400,707,9405,179,B
2016-03-25 14:54:08.5,9405,114,693430,-110,9400,805,9405,125,B
2016-03-25 14:54:10,9400,2,693432,0,9400,865,9405,131,S
2016-03-25 14:54:11,9405,2,693434,-2,9400,867,9405,131,B
2016-03-25 14:54:11.5,9400,462,693896,-30,9405,2,9410,423,S
2016-03-25 14:54:12,9410,48,693944,-30,9405,20,9410,415,B
2016-03-25 14:54:12.5,9405,2,693946,-2,9405,48,9410,416,S
2016-03-25 14:54:13,9405,2,693948,0,9405,57,9410,418,S
2016-03-25 14:54:14,9410,10,693958,0,9405,91,9410,475,B
2016-03-25 14:54:15,9405,12,693970,8,9405,100,9410,485,S
2016-03-25 14:54:16,9405,20,693990,-20,9405,436,9410,449,S
2016-03-25 14:54:17,9405,2,693992,0,9405,437,9410,450,S
2016-03-25 14:54:17.5,9405,10,694002,0,9405,473,9410,450,S
2016-03-25 14:54:18,9410,22,694024,16,9405,489,9410,411,B
2016-03-25 14:54:19,9405,4,694028,0,9405,501,9410,415,S
2016-03-25 14:54:19.5,9410,108,694136,28,9405,482,9410,361,B
2016-03-25 14:54:20,9410,122,694258,122,9405,550,9410,300,B
2016-03-25 14:54:20.5,9410,110,694368,2,9405,550,9410,244,B
2016-03-25 14:54:21,9410,10,694378,10,9405,550,9410,240,B
2016-03-25 14:54:21.5,9415,658,695036,378,9410,782,9415,466,B
2016-03-25 14:54:22,9410,136,695172,8,9410,719,9415,465,S
2016-03-25 14:54:22.5,9415,6,695178,-2,9410,719,9415,463,B
2016-03-25 14:54:23,9415,8,695186,-6,9410,729,9415,461,B
2016-03-25 14:54:23.5,9415,8,695194,0,9410,726,9415,459,B
2016-03-25 14:54:24,9415,38,695232,-26,9410,726,9415,440,B
2016-03-25 14:54:24.5,9415,132,695364,8,9410,676,9415,424,B
2016-03-25 14:54:25,9415,120,695484,-40,9410,740,9415,364,B
2016-03-25 14:54:25.5,9415,62,695546,-20,9410,220,9415,353,B
2016-03-25 14:54:26,9410,354,695900,74,9405,564,9415,372,S
2016-03-25 14:54:26.5,9410,14,695914,-2,9405,564,9415,373,S
2016-03-25 14:54:27,9410,16,695930,12,9410,48,9415,373,S
2016-03-25 14:54:27.5,9415,746,696676,40,9415,155,9420,631,B
2016-03-25 14:54:28,9415,16,696692,10,9415,153,9420,631,B
2016-03-25 14:54:28.5,9415,4,696696,2,9415,151,9420,631,B
2016-03-25 14:54:29,9415,330,697026,6,9410,152,9415,699,B
2016-03-25 14:54:29.5,9415,14,697040,-4,9410,92,9415,693,B
2016-03-25 14:54:30,9415,80,697120,0,9410,122,9415,655,B
2016-03-25 14:54:30.5,9415,44,697164,-8,9410,124,9415,116,B
2016-03-25 14:54:31,9415,94,697258,-92,9410,79,9415,117,B
2016-03-25 14:54:31.5,9415,6,697264,-4,9410,90,9415,143,B
2016-03-25 14:54:33,9415,6,697270,-4,9410,91,9415,145,B
2016-03-25 14:54:33.5,9415,20,697290,0,9410,91,9415,135,B
2016-03-25 14:54:34,9415,10,697300,-10,9410,91,9415,182,B
2016-03-25 14:54:35,9415,20,697320,0,9410,142,9415,172,B
2016-03-25 14:54:35.5,9415,46,697366,-46,9410,143,9415,149,B
2016-03-25 14:54:36,9410,20,697386,-4,9410,133,9415,161,S
2016-03-25 14:54:36.5,9415,98,697484,0,9410,134,9415,142,B
2016-03-25 14:54:37,9415,2,697486,-2,9410,135,9415,114,B
2016-03-25 14:54:38,9415,22,697508,-12,9410,133,9415,114,B
2016-03-25 14:54:38.5,9415,134,697642,28,9410,136,9420,531,B
2016-03-25 14:54:39,9415,94,697736,-94,9415,17,9420,629,B
2016-03-25 14:54:39.5,9420,88,697824,42,9415,4,9420,598,B
2016-03-25 14:54:40,9410,56,697880,-12,9410,152,9415,48,S
2016-03-25 14:54:40.5,9410,10,697890,0,9410,144,9415,48,S
2016-03-25 14:54:41,9415,8,697898,-4,9410,144,9415,46,B
2016-03-25 14:54:42,9410,4,697902,4,9410,143,9415,48,S
2016-03-25 14:54:42.5,9415,8,697910,-8,9410,143,9415,180,B
2016-03-25 14:54:43,9415,90,698000,-20,9410,143,9415,147,B
2016-03-25 14:54:44,9415,12,698012,-2,9410,198,9415,124,B
2016-03-25 14:54:44.5,9415,8,698020,4,9410,208,9415,29,B
2016-03-25 14:54:45,9415,10,698030,-8,9410,213,9415,24,B
2016-03-25 14:54:45.5,9415,94,698124,2,9415,5,9420,534,B
2016-03-25 14:54:47,9420,20,698144,14,9415,13,9420,1044,B
2016-03-25 14:54:47.5,9415,32,698176,-4,9410,269,9415,32,S
2016-03-25 14:54:48,9415,38,698214,0,9410,268,9415,19,S
2016-03-25 14:54:48.5,9415,2,698216,0,9410,210,9415,17,S
2016-03-25 14:54:49,9415,270,698486,8,9415,386,9420,1270,S
2016-03-25 14:54:49.5,9420,24,698510,2,9415,375,9420,1269,B
2016-03-25 14:54:50,9420,4,698514,4,9415,396,9420,1268,B
2016-03-25 14:54:50.5,9415,76,698590,30,9415,389,9420,1237,S
2016-03-25 14:54:51,9415,12,698602,10,9415,383,9420,1226,S
2016-03-25 14:54:51.5,9420,8,698610,0,9415,387,9420,1222,B
2016-03-25 14:54:52,9415,2,698612,2,9415,386,9420,1222,S
2016-03-25 14:54:52.5,9420,136,698748,-14,9415,904,9420,1156,B
2016-03-25 14:54:53,9420,8,698756,-6,9415,937,9420,1145,B
2016-03-25 14:54:54,9415,10,698766,0,9415,933,9420,1145,S
2016-03-25 14:54:54.5,9415,10,698776,2,9415,933,9420,1144,S
2016-03-25 14:54:55,9420,6,698782,4,9415,933,9420,627,B
2016-03-25 14:54:56,9420,128,698910,54,9415,932,9420,562,B
2016-03-25 14:54:56.5,9420,54,698964,0,9415,945,9420,546,B
2016-03-25 14:54:57,9420,22,698986,-14,9415,948,9420,553,B
2016-03-25 14:54:57.5,9420,114,699100,-92,9415,945,9420,499,B
2016-03-25 14:54:58,9420,170,699270,-66,9415,895,9420,464,B
2016-03-25 14:54:58.5,9420,48,699318,-48,9415,945,9420,450,B
2016-03-25 14:54:59,9420,116,699434,-80,9415,945,9420,394,B
2016-03-25 14:54:59.5,9420,12,699446,0,9415,945,9420,390,B
2016-03-25 14:55:00,9420,8,699454,-4,9415,945,9420,289,B
2016-03-25 14:55:00.5,9420,64,699518,-8,9415,932,9420,271,B
2016-03-25 14:55:01,9420,38,699556,18,9415,932,9420,253,B
2016-03-25 14:55:01.5,9415,12,699568,0,9415,930,9420,248,S
2016-03-25 14:55:02,9415,24,699592,20,9415,889,9420,236,S
2016-03-25 14:55:02.5,9415,92,699684,72,9415,843,9420,313,S
2016-03-25 14:55:03,9415,30,699714,30,9415,829,9420,338,S
2016-03-25 14:55:03.5,9415,242,699956,-182,9410,262,9415,517,S
2016-03-25 14:55:04,9415,2,699958,0,9410,294,9415,460,S
2016-03-25 14:55:04.5,9415,106,700064,-2,9410,254,9415,431,S
2016-03-25 14:55:05,9415,4,700068,2,9410,273,9415,66,S
2016-03-25 14:55:06,9415,8,700076,6,9410,272,9415,66,S
2016-03-25 14:55:06.5,9410,18,700094,16,9410,286,9415,66,S
2016-03-25 14:55:08,9410,4,700098,0,9410,292,9415,110,S
2016-03-25 14:55:08.5,9410,50,700148,-40,9410,269,9415,110,S
2016-03-25 14:55:10,9415,14,700162,10,9410,271,9415,126,B
2016-03-25 14:55:10.5,9410,12,700174,0,9410,264,9415,127,S
2016-03-25 14:55:11,9410,22,700196,0,9410,255,9415,362,S
2016-03-25 14:55:11.5,9410,2,700198,-2,9410,254,9415,363,S
2016-03-25 14:55:12,9410,412,700610,-318,9405,808,9410,315,S
2016-03-25 14:55:12.5,9405,40,700650,-18,9405,787,9410,317,S
2016-03-25 14:55:13,9410,6,700656,2,9405,784,9410,318,B
2016-03-25 14:55:14,9410,26,700682,-22,9405,787,9410,306,B
2016-03-25 14:55:14.3333,9410,6,700688,0,9405,785,9410,303,B
2016-03-25 14:55:14.6667,9410,8,700696,0,9405,785,9410,303,B
2016-03-25 14:55:15,9410,4,700700,0,9405,785,9410,301,B
2016-03-25 14:55:15.5,9410,16,700716,0,9405,775,9410,293,B
2016-03-25 14:55:16,9410,4,700720,0,9405,775,9410,291,B
2016-03-25 14:55:16.5,9410,42,700762,-40,9405,775,9410,270,B
2016-03-25 14:55:17,9410,20,700782,0,9405,776,9410,260,B
2016-03-25 14:55:18,9410,2,700784,0,9405,776,9410,270,B
2016-03-25 14:55:20,9405,6,700790,0,9405,775,9410,274,S
2016-03-25 14:55:20.5,9410,4,700794,2,9405,774,9410,274,B
2016-03-25 14:55:22,9405,34,700828,-6,9405,781,9410,339,S
2016-03-25 14:55:22.5,9405,6,700834,6,9405,788,9410,339,S
2016-03-25 14:55:25,9410,12,700846,-6,9405,788,9410,132,B
2016-03-25 14:55:26,9405,16,700862,-8,9405,786,9410,129,S
2016-03-25 14:55:26.3333,9410,200,701062,196,9405,786,9410,29,B
2016-03-25 14:55:26.6667,9410,4,701066,2,9405,786,9410,27,B
2016-03-25 14:55:27,9410,2,701068,2,9405,789,9410,29,B
2016-03-25 14:55:28,9405,10,701078,-10,9405,784,9410,38,S
2016-03-25 14:55:30,9410,150,701228,6,9410,466,9415,193,B
2016-03-25 14:55:30.5,9405,2,701230,-2,9405,781,9415,164,S
2016-03-25 14:55:31,9405,4,701234,0,9405,779,9410,3,S
2016-03-25 14:55:32,9410,10,701244,2,9405,801,9410,6,B
2016-03-25 14:55:33,9405,2,701246,-2,9405,800,9410,6,S
2016-03-25 14:55:33.5,9410,10,701256,-4,9410,45,9415,162,B
2016-03-25 14:55:34,9410,14,701270,12,9410,38,9415,163,B
2016-03-25 14:55:35,9410,80,701350,0,9405,799,9410,3,B
2016-03-25 14:55:35.5,9410,20,701370,-18,9405,790,9415,164,B
2016-03-25 14:55:36,9405,2,701372,-2,9405,790,9410,10,S
2016-03-25 14:55:36.5,9410,24,701396,-2,9410,61,9415,164,B
2016-03-25 14:55:37,9410,6,701402,-4,9410,136,9415,79,B
2016-03-25 14:55:37.5,9410,4,701406,-4,9410,155,9415,105,B
2016-03-25 14:55:39,9410,20,701426,-20,9410,73,9415,154,B
2016-03-25 14:55:40,9410,2,701428,-2,9410,72,9415,162,B
2016-03-25 14:55:40.5,9415,6,701434,-6,9410,42,9415,231,B
2016-03-25 14:55:41,9410,84,701518,-32,9405,789,9410,18,S
2016-03-25 14:55:41.5,9410,4,701522,-2,9405,789,9410,79,S
2016-03-25 14:55:42,9405,20,701542,-20,9405,779,9410,81,S
2016-03-25 14:55:42.5,9405,50,701592,-40,9405,764,9410,71,S
2016-03-25 14:55:43,9405,640,702232,-550,9405,381,9410,122,S
2016-03-25 14:55:44,9410,2,702234,0,9405,376,9410,132,B
2016-03-25 14:55:44.5,9410,96,702330,-6,9405,375,9410,197,B
2016-03-25 14:55:45,9405,744,703074,-316,9400,720,9410,254,S
2016-03-25 14:55:46,9410,2,703076,-2,9400,736,9410,246,B
2016-03-25 14:55:46.5,9400,18,703094,-12,9400,728,9405,19,S
2016-03-25 14:55:47,9405,18,703112,-16,9400,727,9405,10,B
2016-03-25 14:55:47.5,9405,12,703124,-2,9400,722,9405,59,B
2016-03-25 14:55:48,9400,8,703132,-2,9400,719,9405,60,S
2016-03-25 14:55:49,9400,6,703138,-2,9400,716,9405,56,S
2016-03-25 14:55:50,9405,240,703378,54,9400,632,9405,28,B
2016-03-25 14:55:51,9410,88,703466,-24,9405,258,9410,267,B
2016-03-25 14:55:51.5,9405,2,703468,0,9405,308,9410,288,S
2016-03-25 14:55:52,9405,622,704090,-618,9400,580,9405,160,S
2016-03-25 14:55:52.5,9405,2,704092,0,9400,580,9405,160,S
2016-03-25 14:55:53,9405,16,704108,-10,9400,577,9405,155,S
2016-03-25 14:55:53.5,9405,310,704418,-310,9405,145,9410,310,S
2016-03-25 14:55:55,9405,20,704438,0,9405,179,9410,236,S
2016-03-25 14:55:56,9405,4,704442,0,9405,193,9410,233,S
2016-03-25 14:55:57,9410,80,704522,72,9405,207,9410,167,B
2016-03-25 14:55:57.5,9405,4,704526,0,9405,205,9410,187,S
2016-03-25 14:55:58,9410,10,704536,2,9405,205,9410,188,B
2016-03-25 14:55:59,9410,10,704546,8,9405,235,9410,77,B
2016-03-25 14:56:00,9405,40,704586,-40,9405,227,9410,57,S
2016-03-25 14:56:01,9410,10,704596,0,9405,233,9410,54,B
2016-03-25 14:56:02,9405,2,704598,0,9405,239,9410,50,S
2016-03-25 14:56:02.5,9410,2,704600,2,9405,243,9410,49,B
2016-03-25 14:56:04,9410,4,704604,0,9405,241,9410,52,B
2016-03-25 14:56:04.5,9405,10,704614,0,9405,237,9410,52,S
2016-03-25 14:56:05,9405,2,704616,0,9405,239,9410,57,S
2016-03-25 14:56:06,9410,4,704620,0,9405,242,9410,115,B
2016-03-25 14:56:06.5,9405,4,704624,0,9405,250,9410,129,S
2016-03-25 14:56:07,9410,6,704630,0,9405,250,9410,156,B
2016-03-25 14:56:08,9410,202,704832,-198,9405,150,9410,156,B
2016-03-25 14:56:08.3333,9405,4,704836,-2,9405,70,9410,207,S
2016-03-25 14:56:08.6667,9405,144,704980,-60,9400,990,9405,93,S
2016-03-25 14:56:11,9405,4,704984,-4,9400,936,9405,497,S
2016-03-25 14:56:11.5,9405,4,704988,0,9400,935,9405,498,S
2016-03-25 14:56:12,9405,10,704998,0,9400,935,9405,493,S
2016-03-25 14:56:12.3333,9400,2,705000,2,9400,934,9405,493,S
2016-03-25 14:56:12.6667,9405,2,705002,0,9400,940,9405,492,B
2016-03-25 14:56:15,9405,2,705004,0,9400,945,9405,513,B
2016-03-25 14:56:15.5,9405,2,705006,0,9400,945,9405,513,B
2016-03-25 14:56:17,9400,40,705046,0,9400,924,9405,493,S
2016-03-25 14:56:18,9405,10,705056,0,9400,924,9405,494,B
2016-03-25 14:56:20,9400,2,705058,0,9400,826,9405,493,S
2016-03-25 14:56:21,9405,200,705258,-56,9400,714,9405,393,B
2016-03-25 14:56:21.5,9400,6,705264,0,9400,711,9405,393,S
2016-03-25 14:56:22,9400,12,705276,0,9400,706,9405,392,S
2016-03-25 14:56:22.5,9400,204,705480,-4,9400,617,9405,391,S
2016-03-25 14:56:23,9400,460,705940,-206,9400,333,9405,471,S
2016-03-25 14:56:23.5,9400,32,705972,-16,9400,318,9405,471,S
2016-03-25 14:56:24,9400,34,706006,-26,9400,301,9405,471,S
2016-03-25 14:56:25,9400,4,706010,0,9400,322,9405,470,S
2016-03-25 14:56:25.5,9400,4,706014,-2,9400,330,9405,470,S
2016-03-25 14:56:27,9400,8,706022,-8,9400,296,9405,498,S
2016-03-25 14:56:29,9400,2,706024,-2,9400,316,9405,489,S
2016-03-25 14:56:30,9400,8,706032,-8,9400,314,9405,494,S
2016-03-25 14:56:31,9400,48,706080,-46,9400,305,9405,461,S
2016-03-25 14:56:32,9400,2,706082,-2,9400,304,9405,468,S
2016-03-25 14:56:32.5,9400,4,706086,-4,9400,302,9405,462,S
2016-03-25 14:56:34,9405,34,706120,-32,9400,306,9405,458,B
2016-03-25 14:56:35,9405,10,706130,-10,9400,310,9405,453,B
2016-03-25 14:56:36,9400,2,706132,0,9400,309,9405,532,S
2016-03-25 14:56:38,9405,4,706136,-4,9400,310,9405,531,B
2016-03-25 14:56:39,9400,2,706138,0,9400,309,9405,531,S
2016-03-25 14:56:39.5,9405,20,706158,0,9400,299,9405,521,B
2016-03-25 14:56:41,9405,12,706170,-12,9400,363,9405,408,B
2016-03-25 14:56:42,9400,4,706174,-4,9400,357,9405,357,S
2016-03-25 14:56:42.5,9405,70,706244,0,9400,600,9405,322,B
2016-03-25 14:56:45,9400,60,706304,-60,9400,567,9405,323,S
2016-03-25 14:56:45.5,9400,2,706306,0,9400,566,9405,323,S
2016-03-25 14:56:46,9405,2,706308,-2,9400,566,9405,323,B
2016-03-25 14:56:47,9400,16,706324,-16,9400,565,9405,317,S
2016-03-25 14:56:47.5,9400,2,706326,0,9400,564,9405,322,S
2016-03-25 14:56:48,9400,46,706372,-4,9400,540,9405,322,S
2016-03-25 14:56:50,9400,6,706378,0,9400,539,9405,322,S
2016-03-25 14:56:53,9400,2,706380,0,9400,545,9405,323,S
2016-03-25 14:56:54,9405,6,706386,-6,9400,575,9405,350,B
2016-03-25 14:56:55,9405,12,706398,0,9400,575,9405,351,B
2016-03-25 14:56:56,9405,4,706402,-2,9400,576,9405,349,B
2016-03-25 14:56:57,9400,2,706404,0,9400,580,9405,351,S
2016-03-25 14:56:58,9400,20,706424,-2,9400,570,9405,371,S
2016-03-25 14:56:58.3333,9405,2,706426,-2,9400,570,9405,370,B
2016-03-25 14:56:58.6667,9400,2,706428,-2,9400,569,9405,370,S
2016-03-25 14:56:59,9400,2,706430,-2,9400,568,9405,374,S
2016-03-25 14:56:59.5,9400,12,706442,-12,9400,567,9405,374,S
2016-03-25 14:57:00,9405,22,706464,-22,9400,567,9405,363,B
2016-03-25 14:57:00.5,9405,10,706474,-10,9400,567,9405,358,B
2016-03-25 14:57:01,9405,2,706476,0,9400,567,9405,357,B
2016-03-25 14:57:02,9405,30,706506,0,9400,580,9405,342,B
2016-03-25 14:57:03,9405,8,706514,0,9400,581,9405,338,B
2016-03-25 14:57:04,9405,468,706982,0,9400,587,9405,115,B
2016-03-25 14:57:05,9405,244,707226,-108,9405,153,9410,265,B
2016-03-25 14:57:05.5,9405,22,707248,22,9405,158,9410,275,B
2016-03-25 14:57:06,9410,224,707472,-176,9405,161,9410,144,B
2016-03-25 14:57:07,9405,2,707474,0,9405,160,9410,143,S
2016-03-25 14:57:08,9405,6,707480,2,9405,162,9410,142,S
2016-03-25 14:57:08.5,9405,44,707524,4,9405,151,9410,152,S
2016-03-25 14:57:09,9405,10,707534,10,9405,227,9410,152,S
2016-03-25 14:57:10,9410,8,707542,-2,9405,227,9410,148,B
2016-03-25 14:57:10.5,9405,2,707544,2,9405,232,9410,148,S
2016-03-25 14:57:12,9405,200,707744,-32,9405,138,9410,233,S
2016-03-25 14:57:13,9405,2,707746,2,9405,152,9410,233,S
2016-03-25 14:57:13.5,9410,466,708212,-328,9410,168,9415,379,B
2016-03-25 14:57:14,9410,200,708412,-200,9410,92,9415,379,B
2016-03-25 14:57:15,9415,2,708414,0,9410,108,9415,378,B
2016-03-25 14:57:16,9410,2,708416,0,9410,107,9415,295,S
2016-03-25 14:57:17,9410,218,708634,-154,9405,269,9415,293,S
2016-03-25 14:57:17.5,9410,294,708928,-66,9410,31,9415,293,S
2016-03-25 14:57:18,9410,46,708974,-46,9410,15,9415,293,S
2016-03-25 14:57:19,9405,220,709194,-76,9405,46,9415,283,S
2016-03-25 14:57:19.5,9415,26,709220,0,9405,61,9415,264,B
2016-03-25 14:57:20,9410,10,709230,-4,9405,62,9410,7,S
2016-03-25 14:57:20.5,9410,34,709264,-2,9405,67,9410,50,S
2016-03-25 14:57:21,9405,10,709274,0,9405,62,9410,96,S
2016-03-25 14:57:21.5,9410,10,709284,-8,9405,63,9410,138,B
2016-03-25 14:57:23,9405,32,709316,0,9405,273,9410,220,S
2016-03-25 14:57:23.5,9410,2,709318,-2,9405,274,9410,219,B
2016-03-25 14:57:25,9410,2,709320,-2,9405,295,9410,173,B
2016-03-25 14:57:26,9410,24,709344,-24,9405,297,9410,160,B
2016-03-25 14:57:28,9410,20,709364,-20,9405,317,9410,154,B
2016-03-25 14:57:29,9405,8,709372,2,9405,318,9410,154,S
2016-03-25 14:57:30,9410,40,709412,8,9405,331,9410,135,B
2016-03-25 14:57:31,9410,4,709416,0,9405,332,9410,138,B
2016-03-25 14:57:32,9410,2,709418,0,9405,333,9410,138,B
2016-03-25 14:57:32.5,9410,12,709430,0,9405,333,9410,132,B
2016-03-25 14:57:33,9410,10,709440,0,9405,332,9410,134,B
2016-03-25 14:57:37,9405,34,709474,2,9405,349,9410,142,S
2016-03-25 14:57:37.5,9405,10,709484,-6,9405,356,9410,139,S
2016-03-25 14:57:38,9405,10,709494,-4,9405,351,9410,141,S
2016-03-25 14:57:39,9410,2,709496,0,9405,347,9410,140,B
2016-03-25 14:57:39.5,9410,42,709538,-30,9405,348,9410,141,B
2016-03-25 14:57:41,9410,2,709540,-2,9405,349,9410,112,B
2016-03-25 14:57:42,9410,2,709542,0,9405,349,9410,112,B
2016-03-25 14:57:43,9410,10,709552,-10,9405,351,9410,107,B
2016-03-25 14:57:44,9405,82,709634,-58,9405,316,9410,87,S
2016-03-25 14:57:45,9410,6,709640,-6,9405,318,9410,84,B
2016-03-25 14:57:46,9410,10,709650,-10,9405,318,9410,79,B
2016-03-25 14:57:46.5,9405,2,709652,0,9405,319,9410,80,S
2016-03-25 14:57:47,9405,160,709812,-138,9405,347,9415,455,S
2016-03-25 14:57:48,9410,2,709814,0,9410,73,9415,312,B
2016-03-25 14:57:48.5,9410,2,709816,0,9410,119,9415,312,B
2016-03-25 14:57:49,9410,2,709818,2,9410,122,9415,313,B
2016-03-25 14:57:49.5,9410,6,709824,0,9410,122,9415,313,B
2016-03-25 14:57:50,9415,2,709826,0,9410,147,9415,312,B
2016-03-25 14:57:50.5,9415,4,709830,2,9410,148,9415,310,B
2016-03-25 14:57:52,9415,20,709850,20,9410,160,9415,300,B
2016-03-25 14:57:53,9410,2,709852,2,9410,159,9415,300,S
2016-03-25 14:57:53.5,9410,6,709858,4,9410,156,9415,302,S
2016-03-25 14:57:54,9415,18,709876,0,9410,148,9415,301,B
2016-03-25 14:57:55,9415,4,709880,4,9410,107,9415,299,B
2016-03-25 14:57:56,9415,2,709882,0,9410,148,9415,323,B
2016-03-25 14:57:59,9415,2,709884,2,9410,162,9415,329,B
2016-03-25 14:57:59.5,9410,18,709902,0,9410,116,9415,327,S
2016-03-25 14:58:00,9410,2,709904,2,9410,115,9415,327,S
2016-03-25 14:58:00.5,9410,8,709912,0,9410,114,9415,326,S
2016-03-25 14:58:01,9415,816,710728,-560,9415,93,9420,574,B
2016-03-25 14:58:02,9415,218,710946,-126,9410,171,9415,158,B
2016-03-25 14:58:03,9410,68,711014,-18,9410,155,9415,171,S
2016-03-25 14:58:04,9410,4,711018,0,9410,163,9415,221,S
2016-03-25 14:58:04.5,9415,20,711038,0,9410,163,9415,214,B
2016-03-25 14:58:05,9415,28,711066,-8,9410,164,9415,201,B
2016-03-25 14:58:05.5,9415,4,711070,-4,9410,166,9415,199,B
2016-03-25 14:58:06,9415,10,711080,-10,9410,227,9415,195,B
2016-03-25 14:58:07,9415,248,711328,-238,9410,215,9415,85,B
2016-03-25 14:58:08,9415,4,711332,-2,9410,215,9415,133,B
2016-03-25 14:58:08.5,9415,8,711340,0,9410,215,9415,180,B
2016-03-25 14:58:09,9415,6,711346,-2,9410,214,9415,178,B
2016-03-25 14:58:09.5,9410,198,711544,-170,9410,295,9415,135,S
2016-03-25 14:58:10,9415,2,711546,-2,9410,295,9415,134,B
2016-03-25 14:58:10.5,9415,10,711556,-10,9410,295,9415,129,B
2016-03-25 14:58:11,9415,46,711602,-6,9410,295,9415,109,B
2016-03-25 14:58:11.5,9410,12,711614,-12,9410,290,9415,114,S
2016-03-25 14:58:12,9415,68,711682,-66,9410,323,9415,31,B
2016-03-25 14:58:12.5,9410,62,711744,0,9410,322,9420,484,S
2016-03-25 14:58:13,9415,104,711848,10,9415,52,9420,389,B
2016-03-25 14:58:13.5,9415,46,711894,4,9415,84,9420,388,B
2016-03-25 14:58:14,9420,20,711914,-20,9415,57,9420,378,B
2016-03-25 14:58:15,9415,2,711916,-2,9415,58,9420,377,S
2016-03-25 14:58:16,9415,62,711978,40,9415,160,9420,349,S
2016-03-25 14:58:17,9415,2,711980,2,9415,191,9420,348,S
2016-03-25 14:58:17.5,9415,28,712008,0,9415,193,9420,348,S
2016-03-25 14:58:18,9420,42,712050,20,9415,222,9420,331,B
2016-03-25 14:58:19,9420,56,712106,20,9415,272,9420,287,B
2016-03-25 14:58:19.5,9415,6,712112,2,9415,270,9420,288,S
2016-03-25 14:58:20,9420,4,712116,0,9415,284,9420,288,B
2016-03-25 14:58:21,9415,146,712262,0,9415,235,9420,268,S
2016-03-25 14:58:22,9415,6,712268,4,9415,191,9420,319,S
2016-03-25 14:58:22.5,9420,84,712352,-14,9415,276,9420,277,B
2016-03-25 14:58:23,9420,4,712356,-4,9415,279,9420,275,B
2016-03-25 14:58:23.5,9420,4,712360,-4,9415,271,9420,273,B
2016-03-25 14:58:24,9420,10,712370,0,9415,270,9420,269,B
2016-03-25 14:58:25,9415,42,712412,2,9415,283,9420,250,S
2016-03-25 14:58:26,9420,2,712414,-2,9415,283,9420,249,B
2016-03-25 14:58:27,9420,14,712428,-14,9415,289,9420,244,B
2016-03-25 14:58:27.5,9415,4,712432,0,9415,287,9420,243,S
2016-03-25 14:58:28,9420,300,712732,-264,9415,316,9420,93,B
2016-03-25 14:58:29,9415,16,712748,-10,9415,313,9420,90,S
2016-03-25 14:58:29.3333,9420,184,712932,32,9420,109,9425,482,B
2016-03-25 14:58:29.6667,9420,10,712942,0,9420,107,9425,483,B
2016-03-25 14:58:30,9420,18,712960,0,9420,129,9425,483,B
2016-03-25 14:58:31,9420,4,712964,0,9420,127,9425,483,B
2016-03-25 14:58:31.5,9420,2,712966,0,9420,126,9425,483,B
2016-03-25 14:58:32,9420,22,712988,0,9420,116,9425,486,B
2016-03-25 14:58:32.5,9425,34,713022,18,9420,104,9425,482,B
2016-03-25 14:58:33,9425,12,713034,-4,9420,104,9425,478,B
2016-03-25 14:58:33.3333,9425,332,713366,34,9420,149,9425,286,B
2016-03-25 14:58:33.6667,9425,16,713382,-8,9420,148,9425,280,B
2016-03-25 14:58:34,9420,6,713388,-2,9420,147,9425,279,S
2016-03-25 14:58:35,9425,110,713498,0,9420,157,9425,229,B
2016-03-25 14:58:35.5,9425,4,713502,-4,9420,194,9425,183,B
2016-03-25 14:58:36,9420,438,713940,-212,9415,330,9420,332,S
2016-03-25 14:58:36.5,9420,158,714098,-158,9415,331,9420,255,S
2016-03-25 14:58:37,9420,12,714110,-12,9415,331,9420,200,S
2016-03-25 14:58:38,9420,10,714120,-10,9415,385,9420,226,S
2016-03-25 14:58:39,9420,10,714130,-10,9415,376,9420,221,S
2016-03-25 14:58:39.5,9420,20,714150,-20,9415,376,9420,221,S
2016-03-25 14:58:40,9420,4,714154,-4,9415,377,9420,220,S
2016-03-25 14:58:40.5,9420,26,714180,-26,9415,378,9420,214,S
2016-03-25 14:58:41,9420,4,714184,-4,9415,378,9420,212,S
2016-03-25 14:58:42,9420,2,714186,-2,9415,378,9420,214,S
2016-03-25 14:58:42.5,9415,42,714228,0,9415,358,9420,215,S
2016-03-25 14:58:43,9420,10,714238,-10,9415,353,9420,263,B
2016-03-25 14:58:44,9415,4,714242,0,9415,352,9420,268,S
2016-03-25 14:58:45,9420,4,714246,-4,9415,348,9420,267,B
2016-03-25 14:58:46,9415,6,714252,0,9415,345,9420,271,S
2016-03-25 14:58:46.5,9415,40,714292,-30,9415,340,9420,271,S
2016-03-25 14:58:47,9415,4,714296,-4,9415,289,9420,220,S
2016-03-25 14:58:47.5,9415,578,714874,-276,9410,291,9415,214,S
2016-03-25 14:58:48,9410,42,714916,-40,9410,248,9415,195,S
2016-03-25 14:58:48.5,9410,28,714944,-28,9410,228,9415,202,S
2016-03-25 14:58:49,9415,40,714984,-40,9410,229,9415,182,B
2016-03-25 14:58:49.5,9415,108,715092,-108,9410,229,9415,128,B
2016-03-25 14:58:50,9415,284,715376,14,9415,361,9420,273,B
2016-03-25 14:58:51,9415,10,715386,2,9415,359,9420,273,B
2016-03-25 14:58:51.5,9415,4,715390,-2,9415,358,9420,273,B
2016-03-25 14:58:52,9415,120,715510,0,9415,340,9420,273,B
2016-03-25 14:58:53,9415,52,715562,-44,9415,342,9420,281,B
2016-03-25 14:58:55,9420,570,716132,106,9420,226,9425,170,B
2016-03-25 14:58:55.5,9420,116,716248,14,9420,168,9425,167,B
2016-03-25 14:58:56,9420,40,716288,2,9420,148,9425,168,B
2016-03-25 14:58:56.5,9420,6,716294,4,9420,271,9425,168,B
2016-03-25 14:58:57,9420,8,716302,0,9420,274,9425,220,B
2016-03-25 14:58:58,9420,42,716344,22,9420,273,9425,200,B
2016-03-25 14:58:59,9420,4,716348,0,9420,272,9425,212,B
2016-03-25 14:58:59.5,9420,16,716364,14,9420,264,9425,212,B
2016-03-25 14:59:00,9425,4,716368,4,9420,279,9425,212,B
2016-03-25 14:59:01,9420,66,716434,28,9420,746,9425,269,S
2016-03-25 14:59:01.5,9420,120,716554,-36,9420,718,9425,225,S
2016-03-25 14:59:02,9425,24,716578,0,9420,707,9425,281,B
2016-03-25 14:59:02.5,9425,36,716614,-28,9420,733,9425,268,B
2016-03-25 14:59:03,9420,2,716616,0,9420,732,9425,272,S
2016-03-25 14:59:03.5,9420,8,716624,0,9420,728,9425,273,S
2016-03-25 14:59:04,9420,4,716628,0,9420,726,9425,273,S
2016-03-25 14:59:04.5,9425,6,716634,0,9420,727,9425,284,B
2016-03-25 14:59:05,9425,54,716688,-52,9420,728,9425,260,B
2016-03-25 14:59:06,9425,46,716734,-18,9420,737,9425,243,B
2016-03-25 14:59:06.5,9425,6,716740,-6,9420,737,9425,240,B
2016-03-25 14:59:07,9425,34,716774,-4,9420,726,9425,236,B
2016-03-25 14:59:07.5,9420,62,716836,-44,9420,730,9425,206,S
2016-03-25 14:59:08,9425,88,716924,-48,9420,730,9425,164,B
2016-03-25 14:59:08.5,9425,2,716926,0,9420,745,9425,172,B
2016-03-25 14:59:09,9420,4,716930,4,9420,743,9425,173,S
2016-03-25 14:59:10,9420,48,716978,36,9420,730,9425,169,S
2016-03-25 14:59:10.3333,9420,10,716988,4,9420,726,9425,168,S
2016-03-25 14:59:10.6667,9425,6,716994,-2,9420,770,9425,166,B
2016-03-25 14:59:11,9425,6,717000,0,9420,770,9425,204,B
2016-03-25 14:59:11.5,9420,4,717004,4,9420,768,9425,204,S
2016-03-25 14:59:12,9425,24,717028,-14,9420,765,9425,196,B
2016-03-25 14:59:12.5,9425,44,717072,-36,9420,770,9425,174,B
2016-03-25 14:59:13,9425,8,717080,-6,9420,786,9425,173,B
2016-03-25 14:59:13.5,9425,2,717082,-2,9420,776,9425,172,B
2016-03-25 14:59:14,9430,358,717440,-174,9425,328,9430,456,B
2016-03-25 14:59:15,9430,374,717814,-106,9425,278,9430,320,B
2016-03-25 14:59:15.5,9430,156,717970,-60,9425,285,9430,245,B
2016-03-25 14:59:16,9425,14,717984,-14,9425,294,9430,246,S
2016-03-25 14:59:17,9425,14,717998,-14,9425,294,9430,245,S
2016-03-25 14:59:17.5,9430,34,718032,-12,9425,290,9430,233,B
2016-03-25 14:59:18,9425,4,718036,-4,9425,290,9430,228,S
2016-03-25 14:59:18.5,9430,12,718048,-10,9425,286,9430,227,B
2016-03-25 14:59:19,9430,4,718052,-4,9425,286,9430,225,B
2016-03-25 14:59:19.5,9425,42,718094,-40,9425,309,9430,218,S
2016-03-25 14:59:20,9425,10,718104,0,9425,294,9430,217,S
2016-03-25 14:59:20.5,9425,12,718116,-2,9425,331,9430,218,S
2016-03-25 14:59:21,9425,12,718128,0,9425,335,9430,218,S
2016-03-25 14:59:21.5,9430,10,718138,10,9425,333,9430,216,B
2016-03-25 14:59:22,9430,88,718226,-40,9425,329,9430,178,B
2016-03-25 14:59:22.5,9430,90,718316,-84,9425,300,9430,162,B
2016-03-25 14:59:23,9430,10,718326,-6,9425,302,9430,157,B
2016-03-25 14:59:23.5,9425,38,718364,-38,9425,310,9430,154,S
2016-03-25 14:59:24,9430,4,718368,0,9425,316,9430,154,B
2016-03-25 14:59:24.5,9430,42,718410,-42,9425,316,9430,134,B
2016-03-25 14:59:25,9430,22,718432,-4,9425,324,9430,123,B
2016-03-25 14:59:25.5,9425,12,718444,-8,9425,319,9430,474,S
2016-03-25 14:59:26,9430,28,718472,-12,9425,322,9430,462,B
2016-03-25 14:59:26.5,9425,2,718474,0,9425,332,9430,462,S
2016-03-25 14:59:27,9425,24,718498,-18,9425,327,9430,459,S
2016-03-25 14:59:28,9430,112,718610,-106,9425,361,9430,406,B
2016-03-25 14:59:28.5,9425,4,718614,-4,9425,360,9430,406,S
2016-03-25 14:59:29,9425,10,718624,0,9425,362,9430,406,S
2016-03-25 14:59:29.5,9425,6,718630,-4,9425,359,9430,408,S
2016-03-25 14:59:31,9430,42,718672,-30,9425,350,9430,423,B
2016-03-25 14:59:32,9425,42,718714,-40,9425,333,9430,421,S
2016-03-25 14:59:32.5,9425,10,718724,-8,9425,331,9430,418,S
2016-03-25 14:59:33,9430,32,718756,-30,9425,332,9430,420,B
2016-03-25 14:59:33.5,9425,22,718778,-22,9425,314,9430,420,S
2016-03-25 14:59:34,9425,102,718880,-98,9425,294,9430,410,S
2016-03-25 14:59:34.5,9425,38,718918,-34,9425,281,9430,380,S
2016-03-25 14:59:35,9430,80,718998,-80,9425,250,9430,395,B
2016-03-25 14:59:35.5,9430,26,719024,-26,9425,227,9430,411,B
2016-03-25 14:59:36,9430,12,719036,-12,9425,226,9430,407,B
2016-03-25 14:59:37,9430,164,719200,-152,9425,162,9430,381,B
2016-03-25 14:59:37.5,9425,26,719226,-16,9425,149,9430,372,S
2016-03-25 14:59:38,9430,94,719320,-2,9425,134,9430,373,B
2016-03-25 14:59:38.5,9425,60,719380,-42,9425,138,9430,372,S
2016-03-25 14:59:39,9430,68,719448,0,9425,136,9430,378,B
2016-03-25 14:59:39.5,9430,88,719536,-82,9425,96,9430,475,B
2016-03-25 14:59:40,9430,6,719542,-6,9425,97,9430,472,B
2016-03-25 14:59:40.5,9430,32,719574,-32,9425,110,9430,456,B
2016-03-25 14:59:41,9430,36,719610,-36,9425,112,9430,442,B
2016-03-25 14:59:41.5,9425,30,719640,0,9425,108,9430,432,S
2016-03-25 14:59:42,9425,18,719658,-14,9425,105,9430,427,S
2016-03-25 14:59:42.5,9425,4,719662,-2,9425,106,9430,426,S
2016-03-25 14:59:43,9425,256,719918,-168,9425,85,9430,337,S
2016-03-25 14:59:43.5,9425,92,720010,-16,9425,571,9430,312,S
2016-03-25 14:59:44,9430,62,720072,-60,9425,564,9430,306,B
2016-03-25 14:59:44.5,9425,22,720094,-20,9425,565,9430,307,S
2016-03-25 14:59:45,9430,2,720096,0,9425,582,9430,321,B
2016-03-25 14:59:46,9425,12,720108,2,9425,579,9430,324,S
2016-03-25 14:59:46.5,9425,10,720118,-6,9425,619,9430,324,S
2016-03-25 14:59:47,9430,8,720126,-6,9425,622,9430,320,B
2016-03-25 14:59:47.5,9430,12,720138,-6,9425,622,9430,316,B
2016-03-25 14:59:48,9425,2,720140,-2,9425,621,9430,316,S
2016-03-25 14:59:48.5,9425,138,720278,-22,9425,623,9430,250,S
2016-03-25 14:59:49,9430,16,720294,-10,9425,612,9430,244,B
2016-03-25 14:59:49.5,9430,2,720296,0,9425,612,9430,245,B
2016-03-25 14:59:50,9430,4,720300,-4,9425,612,9430,244,B
2016-03-25 14:59:50.5,9430,108,720408,-86,9425,642,9430,190,B
2016-03-25 14:59:51,9430,118,720526,-66,9425,605,9430,169,B
2016-03-25 14:59:51.5,9430,22,720548,-20,9425,597,9430,162,B
2016-03-25 14:59:52,9430,20,720568,-10,9425,592,9430,158,B
2016-03-25 14:59:52.5,9430,46,720614,-46,9425,590,9430,138,B
2016-03-25 14:59:53,9430,4,720618,-4,9425,595,9430,171,B
2016-03-25 14:59:53.5,9430,6,720624,-6,9425,600,9430,169,B
2016-03-25 14:59:54,9430,40,720664,-38,9425,601,9430,156,B
2016-03-25 14:59:54.5,9430,42,720706,4,9425,601,9430,135,B
2016-03-25 14:59:55,9430,230,720936,56,9425,599,9435,215,B
2016-03-25 14:59:56,9430,28,720964,-6,9425,594,9435,213,B
2016-03-25 14:59:56.3333,9430,12,720976,-12,9425,598,9435,213,B
2016-03-25 14:59:56.6667,9425,26,721002,-26,9425,585,9435,213,S
2016-03-25 14:59:57,9430,6,721008,0,9425,567,9435,213,B
2016-03-25 14:59:57.5,9425,412,721420,-124,9425,377,9430,2,S
2016-03-25 14:59:58,9430,62,721482,-18,9430,4,9435,196,B
2016-03-25 14:59:59,9430,40,721522,-26,9430,4,9435,196,B
2016-03-25 14:59:59.3333,9425,22,721544,4,9425,356,9430,58,S
2016-03-25 14:59:59.6667,9430,20,721564,2,9425,354,9430,49,B
2016-03-25 15:00:00,9430,14,721578,10,9425,361,9430,43,B
2016-03-25 15:00:00.5,9430,14,721592,14,9425,354,9430,37,B
