datetime,price,quantity,totalq,position,b1price,b1size,s1price,s1size,bors
2018-03-30 21:00:06,13700.0,8,8,50742,0.0,0,0.0,0,B
2018-03-30 21:00:07,13680.0,2,10,-2,13665.0,1,13695.0,16,S
2018-03-30 21:00:09,13660.0,6,16,-2,13635.0,2,13675.0,17,S
2018-03-30 21:00:10,13650.0,2,18,-2,13635.0,2,13665.0,6,S
2018-03-30 21:00:10,13645.0,4,22,-4,13635.0,2,13660.0,4,S
2018-03-30 21:00:12,13660.0,2,24,2,13640.0,1,13665.0,4,B
2018-03-30 21:00:15,13665.0,4,28,4,13640.0,1,13670.0,1,B
2018-03-30 21:00:19,13645.0,4,32,0,13640.0,1,13665.0,4,S
2018-03-30 21:00:19,13640.0,2,34,0,13640.0,1,13660.0,1,S
2018-03-30 21:00:20,13650.0,2,36,-2,13640.0,1,13660.0,1,B
2018-03-30 21:00:22,13660.0,2,38,0,13665.0,1,13675.0,63,B
2018-03-30 21:00:23,13665.0,2,40,-2,13645.0,1,13675.0,63,B
2018-03-30 21:00:30,13650.0,4,44,0,13650.0,1,13670.0,1,S
2018-03-30 21:00:38,13660.0,2,46,2,13650.0,6,13665.0,51,B
2018-03-30 21:00:39,13650.0,12,58,4,13645.0,6,13650.0,45,S
2018-03-30 21:00:40,13650.0,4,62,0,13645.0,6,13650.0,43,S
2018-03-30 21:00:40,13650.0,6,68,6,13645.0,8,13650.0,40,S
2018-03-30 21:00:41,13650.0,80,148,24,13650.0,3,13670.0,5,S
2018-03-30 21:00:45,13650.0,4,152,4,13655.0,2,13670.0,1,S
2018-03-30 21:00:48,13670.0,2,154,-2,13655.0,3,13680.0,24,B
2018-03-30 21:00:57,13685.0,4,158,2,13655.0,36,13695.0,12,B
2018-03-30 21:01:01,13695.0,4,162,2,13695.0,2,13710.0,9,B
2018-03-30 21:01:02,13695.0,8,170,2,13690.0,8,13735.0,1,B
2018-03-30 21:01:02,13720.0,2,172,0,13700.0,1,13735.0,1,B
2018-03-30 21:01:10,13710.0,2,174,0,13710.0,4,13715.0,1,S
2018-03-30 21:01:11,13710.0,2,176,2,13710.0,3,13715.0,1,S
2018-03-30 21:01:14,13710.0,6,182,0,13705.0,3,13715.0,1,S
2018-03-30 21:01:37,13710.0,2,184,0,13690.0,1,13710.0,7,S
2018-03-30 21:01:55,13705.0,2,186,2,13695.0,1,13705.0,1,S
2018-03-30 21:02:05,13695.0,2,188,0,13690.0,4,13700.0,1,S
2018-03-30 21:02:07,13700.0,2,190,0,13690.0,2,13700.0,3,B
2018-03-30 21:02:09,13700.0,2,192,2,13690.0,2,13700.0,14,B
2018-03-30 21:02:18,13690.0,4,196,-2,13685.0,1,13690.0,1,S
2018-03-30 21:02:18,13690.0,2,198,-2,13685.0,1,13695.0,15,S
2018-03-30 21:02:39,13690.0,2,200,2,13690.0,1,13695.0,5,S
2018-03-30 21:02:42,13690.0,2,202,0,13685.0,4,13690.0,1,S
2018-03-30 21:02:46,13690.0,2,204,0,13685.0,1,13695.0,5,S
2018-03-30 21:03:00,13690.0,4,208,0,13685.0,1,13695.0,32,S
2018-03-30 21:03:01,13680.0,2,210,0,13675.0,3,13695.0,8,S
2018-03-30 21:03:05,13680.0,2,212,-2,13675.0,4,13685.0,2,S
2018-03-30 21:03:12,13685.0,2,214,2,13680.0,2,13685.0,1,B
2018-03-30 21:03:13,13685.0,2,216,-2,13680.0,2,13690.0,2,B
2018-03-30 21:03:19,13685.0,6,222,4,13675.0,4,13690.0,2,B
2018-03-30 21:03:22,13660.0,2,224,-2,13655.0,3,13670.0,1,S
2018-03-30 21:03:24,13675.0,2,226,2,13665.0,2,13680.0,1,B
2018-03-30 21:03:38,13680.0,2,228,2,13675.0,1,13685.0,1,B
2018-03-30 21:03:52,13675.0,2,230,0,13675.0,2,13685.0,1,S
2018-03-30 21:03:53,13685.0,8,238,2,13685.0,13,13690.0,4,B
2018-03-30 21:03:56,13685.0,2,240,2,13685.0,12,13690.0,6,B
2018-03-30 21:04:07,13685.0,2,242,0,13685.0,11,13690.0,6,B
2018-03-30 21:04:13,13685.0,4,246,2,13685.0,9,13690.0,7,B
2018-03-30 21:04:13,13685.0,4,250,4,13685.0,7,13690.0,7,B
2018-03-30 21:04:14,13685.0,4,254,0,13685.0,5,13690.0,6,B
2018-03-30 21:04:15,13685.0,10,264,0,13680.0,2,13690.0,7,B
2018-03-30 21:04:52,13685.0,4,268,0,13675.0,2,13685.0,31,B
2018-03-30 21:04:59,13680.0,2,270,0,13675.0,3,13685.0,3,S
2018-03-30 21:05:01,13675.0,2,272,2,13675.0,3,13685.0,16,S
2018-03-30 21:05:22,13680.0,8,280,8,13670.0,6,13680.0,1,B
2018-03-30 21:05:22,13680.0,2,282,2,13680.0,9,13685.0,4,B
2018-03-30 21:05:32,13685.0,6,288,4,13680.0,9,13690.0,5,B
2018-03-30 21:05:41,13690.0,2,290,0,13685.0,1,13690.0,2,B
2018-03-30 21:05:49,13690.0,2,292,2,13685.0,1,13695.0,6,B
2018-03-30 21:05:50,13695.0,2,294,2,13685.0,1,13695.0,5,B
2018-03-30 21:06:06,13695.0,4,298,2,13695.0,1,13700.0,4,B
2018-03-30 21:06:07,13695.0,2,300,-2,13685.0,5,13695.0,2,B
2018-03-30 21:06:07,13695.0,2,302,0,13690.0,3,13695.0,1,B
2018-03-30 21:06:15,13685.0,10,312,8,13685.0,1,13695.0,1,S
2018-03-30 21:06:19,13685.0,2,314,-2,13680.0,10,13690.0,1,S
2018-03-30 21:06:38,13680.0,4,318,4,13680.0,6,13685.0,5,S
2018-03-30 21:06:43,13680.0,8,326,0,13680.0,2,13685.0,5,S
2018-03-30 21:06:44,13680.0,4,330,4,13675.0,4,13680.0,3,S
2018-03-30 21:06:57,13680.0,2,332,0,13675.0,3,13680.0,1,S
2018-03-30 21:07:06,13675.0,2,334,2,13675.0,2,13685.0,29,S
2018-03-30 21:07:15,13675.0,4,338,2,13670.0,3,13675.0,18,S
2018-03-30 21:07:22,13670.0,2,340,0,13665.0,6,13675.0,20,S
2018-03-30 21:07:24,13670.0,2,342,-2,13665.0,7,13675.0,18,S
2018-03-30 21:07:27,13670.0,2,344,0,13665.0,4,13675.0,21,S
2018-03-30 21:07:29,13675.0,2,346,0,13665.0,4,13675.0,20,B
2018-03-30 21:07:31,13670.0,2,348,0,13665.0,4,13670.0,5,S
2018-03-30 21:07:39,13665.0,2,350,0,13665.0,3,13670.0,1,S
2018-03-30 21:07:57,13670.0,2,352,-2,13665.0,3,13675.0,20,B
2018-03-30 21:08:04,13675.0,2,354,2,13665.0,7,13675.0,16,B
2018-03-30 21:09:01,13665.0,12,366,8,13665.0,3,13675.0,2,S
2018-03-30 21:09:32,13675.0,18,384,0,13675.0,1,13680.0,18,B
2018-03-30 21:09:33,13675.0,2,386,0,13670.0,2,13680.0,4,B
2018-03-30 21:09:49,13670.0,2,388,2,13665.0,4,13675.0,5,S
2018-03-30 21:10:45,13670.0,4,392,-2,13665.0,4,13675.0,14,S
2018-03-30 21:11:12,13670.0,20,412,-4,13665.0,3,13675.0,15,S
2018-03-30 21:11:52,13665.0,20,432,-20,13665.0,1,13670.0,2,S
2018-03-30 21:12:06,13665.0,2,434,0,13660.0,12,13665.0,1,S
2018-03-30 21:12:06,13665.0,2,436,0,13665.0,7,13670.0,2,S
2018-03-30 21:12:07,13670.0,4,440,0,13665.0,7,13675.0,16,B
2018-03-30 21:12:37,13665.0,6,446,2,13665.0,3,13675.0,14,S
2018-03-30 21:12:44,13665.0,2,448,0,13665.0,3,13675.0,14,S
2018-03-30 21:13:01,13675.0,2,450,0,13665.0,4,13675.0,13,B
2018-03-30 21:13:12,13675.0,2,452,0,13665.0,105,13675.0,11,B
2018-03-30 21:13:15,13675.0,2,454,2,13665.0,105,13675.0,10,B
2018-03-30 21:13:36,13670.0,20,474,0,13665.0,105,13675.0,10,S
2018-03-30 21:13:42,13675.0,2,476,0,13665.0,103,13675.0,23,B
2018-03-30 21:13:45,13675.0,4,480,0,13665.0,103,13675.0,9,B
2018-03-30 21:13:47,13675.0,2,482,2,13665.0,103,13675.0,8,B
2018-03-30 21:14:09,13675.0,4,486,2,13665.0,103,13675.0,7,B
2018-03-30 21:14:16,13670.0,4,490,0,13665.0,103,13675.0,6,S
2018-03-30 21:14:17,13670.0,2,492,0,13665.0,103,13675.0,6,S
2018-03-30 21:14:21,13670.0,4,496,0,13665.0,102,13675.0,8,S
2018-03-30 21:14:40,13670.0,2,498,2,13665.0,107,13675.0,5,S
2018-03-30 21:14:56,13665.0,4,502,2,13665.0,105,13675.0,7,S
2018-03-30 21:14:58,13670.0,2,504,-2,13670.0,3,13675.0,7,B
2018-03-30 21:15:02,13675.0,2,506,2,13665.0,105,13675.0,5,B
2018-03-30 21:15:21,13675.0,2,508,2,13665.0,105,13675.0,5,B
2018-03-30 21:15:36,13670.0,2,510,-2,13665.0,102,13675.0,21,S
2018-03-30 21:15:47,13670.0,2,512,-2,13665.0,102,13670.0,1,S
2018-03-30 21:15:47,13670.0,4,516,0,13665.0,102,13670.0,11,S
2018-03-30 21:15:50,13670.0,2,518,0,13670.0,2,13675.0,8,S
2018-03-30 21:15:51,13670.0,8,526,0,13665.0,102,13675.0,15,S
2018-03-30 21:16:06,13665.0,2,528,2,13665.0,101,13670.0,3,S
2018-03-30 21:16:08,13665.0,2,530,2,13665.0,100,13670.0,4,S
2018-03-30 21:16:09,13665.0,6,536,6,13665.0,97,13670.0,5,S
2018-03-30 21:16:14,13665.0,2,538,2,13665.0,96,13670.0,5,S
2018-03-30 21:16:16,13665.0,2,540,2,13665.0,98,13670.0,5,S
2018-03-30 21:16:24,13670.0,10,550,10,13665.0,98,13675.0,17,B
2018-03-30 21:16:25,13670.0,4,554,2,13665.0,98,13670.0,1,B
2018-03-30 21:16:39,13670.0,2,556,2,13670.0,2,13675.0,13,B
2018-03-30 21:17:19,13670.0,2,558,0,13670.0,2,13675.0,3,B
2018-03-30 21:17:35,13675.0,4,562,4,13670.0,5,13680.0,5,B
2018-03-30 21:17:36,13680.0,4,566,0,13675.0,4,13685.0,3,B
2018-03-30 21:18:04,13680.0,6,572,0,13675.0,3,13680.0,4,B
2018-03-30 21:18:08,13680.0,8,580,0,13675.0,4,13685.0,2,B
2018-03-30 21:18:55,13685.0,2,582,2,13675.0,6,13690.0,3,B
2018-03-30 21:18:55,13690.0,2,584,-2,13675.0,6,13690.0,2,B
2018-03-30 21:19:22,13690.0,2,586,0,13680.0,1,13690.0,3,B
2018-03-30 21:19:52,13690.0,2,588,-2,13675.0,5,13690.0,30,B
2018-03-30 21:20:07,13690.0,2,590,0,13675.0,4,13690.0,130,B
2018-03-30 21:20:09,13680.0,2,592,0,13675.0,4,13690.0,131,S
2018-03-30 21:20:11,13685.0,2,594,-2,13675.0,4,13690.0,129,B
2018-03-30 21:20:15,13680.0,2,596,2,13675.0,4,13680.0,3,S
2018-03-30 21:20:16,13680.0,6,602,6,13675.0,4,13690.0,129,S
2018-03-30 21:20:28,13675.0,2,604,-2,13675.0,3,13685.0,1,S
2018-03-30 21:21:25,13680.0,2,606,-2,13670.0,5,13685.0,6,B
2018-03-30 21:22:03,13680.0,2,608,0,13675.0,5,13685.0,1,B
2018-03-30 21:22:05,13675.0,2,610,0,13670.0,4,13680.0,3,S
2018-03-30 21:23:26,13680.0,2,612,0,13670.0,5,13680.0,1,B
2018-03-30 21:23:32,13675.0,2,614,2,13675.0,1,13680.0,1,S
2018-03-30 21:23:49,13675.0,2,616,0,13670.0,5,13680.0,2,S
2018-03-30 21:24:36,13670.0,2,618,0,13670.0,1,13680.0,6,S
2018-03-30 21:24:36,13670.0,2,620,0,13665.0,8,13680.0,6,S
2018-03-30 21:24:40,13670.0,4,624,0,13670.0,3,13680.0,6,S
2018-03-30 21:25:03,13665.0,2,626,0,13665.0,4,13670.0,3,S
2018-03-30 21:25:27,13680.0,6,632,0,13670.0,150,13680.0,2,B
2018-03-30 21:25:27,13680.0,4,636,0,13670.0,153,13680.0,5,B
2018-03-30 21:25:37,13680.0,2,638,0,13670.0,153,13680.0,4,B
2018-03-30 21:25:38,13675.0,2,640,2,13670.0,153,13680.0,3,S
2018-03-30 21:26:05,13680.0,2,642,0,13675.0,2,13680.0,8,B
2018-03-30 21:26:26,13675.0,2,644,2,13670.0,155,13680.0,2,S
2018-03-30 21:26:39,13675.0,2,646,2,13675.0,9,13680.0,3,S
2018-03-30 21:27:30,13675.0,2,648,0,13675.0,7,13680.0,5,S
2018-03-30 21:27:31,13675.0,2,650,2,13675.0,6,13680.0,5,S
2018-03-30 21:27:32,13675.0,6,656,6,13675.0,3,13680.0,5,S
2018-03-30 21:27:33,13675.0,4,660,0,13675.0,1,13680.0,4,S
2018-03-30 21:27:40,13675.0,2,662,2,13670.0,155,13680.0,3,S
2018-03-30 21:27:49,13675.0,2,664,0,13675.0,1,13680.0,5,S
2018-03-30 21:27:58,13675.0,2,666,2,13670.0,155,13680.0,5,S
2018-03-30 21:29:05,13670.0,2,668,0,13670.0,151,13675.0,14,S
2018-03-30 21:29:08,13670.0,4,672,0,13670.0,149,13675.0,14,S
2018-03-30 21:29:10,13670.0,2,674,2,13670.0,148,13675.0,14,S
2018-03-30 21:29:15,13670.0,4,678,4,13670.0,146,13675.0,14,S
2018-03-30 21:29:17,13670.0,50,728,36,13670.0,121,13675.0,25,S
2018-03-30 21:29:19,13670.0,20,748,2,13670.0,111,13675.0,25,S
2018-03-30 21:29:20,13670.0,90,838,0,13670.0,66,13675.0,25,S
2018-03-30 21:29:20,13670.0,24,862,0,13670.0,54,13675.0,14,S
2018-03-30 21:29:22,13670.0,2,864,0,13670.0,53,13675.0,15,S
2018-03-30 21:29:22,13670.0,6,870,0,13670.0,50,13675.0,27,S
2018-03-30 21:29:23,13670.0,16,886,10,13670.0,42,13675.0,27,S
2018-03-30 21:29:43,13670.0,2,888,0,13665.0,8,13675.0,13,S
2018-03-30 21:29:51,13670.0,2,890,0,13665.0,8,13675.0,11,S
2018-03-30 21:30:22,13670.0,2,892,0,13670.0,2,13675.0,11,S
2018-03-30 21:30:25,13675.0,2,894,-2,13670.0,2,13675.0,11,B
2018-03-30 21:30:37,13670.0,2,896,-2,13665.0,9,13675.0,10,S
2018-03-30 21:31:06,13670.0,2,898,0,13665.0,8,13675.0,10,S
2018-03-30 21:31:57,13670.0,2,900,2,13665.0,8,13670.0,1,S
2018-03-30 21:31:57,13670.0,2,902,0,13665.0,9,13675.0,10,S
2018-03-30 21:32:39,13670.0,2,904,0,13665.0,8,13670.0,9,S
2018-03-30 21:32:49,13665.0,2,906,0,13665.0,5,13670.0,12,S
2018-03-30 21:32:51,13670.0,20,926,0,13665.0,4,13670.0,2,B
2018-03-30 21:33:41,13670.0,2,928,-2,13670.0,4,13675.0,11,B
2018-03-30 21:34:15,13670.0,2,930,-2,13670.0,2,13675.0,11,B
2018-03-30 21:34:17,13670.0,2,932,-2,13670.0,1,13675.0,11,B
2018-03-30 21:34:34,13670.0,2,934,0,13665.0,9,13675.0,10,B
2018-03-30 21:35:29,13670.0,2,936,0,13665.0,9,13675.0,10,B
2018-03-30 21:35:36,13670.0,4,940,-4,13665.0,9,13675.0,10,B
2018-03-30 21:35:57,13675.0,2,942,2,13665.0,10,13680.0,70,B
2018-03-30 21:36:11,13680.0,2,944,0,13665.0,10,13680.0,69,B
2018-03-30 21:37:54,13670.0,2,946,2,13665.0,10,13675.0,5,S
2018-03-30 21:39:46,13675.0,2,948,0,13670.0,10,13675.0,4,B
2018-03-30 21:39:48,13675.0,6,954,6,13670.0,13,13675.0,1,B
2018-03-30 21:39:49,13675.0,2,956,0,13670.0,13,13680.0,61,B
2018-03-30 21:40:15,13670.0,4,960,0,13670.0,11,13680.0,60,S
2018-03-30 21:40:41,13675.0,12,972,12,13670.0,12,13680.0,60,B
2018-03-30 21:40:58,13675.0,4,976,0,13675.0,6,13680.0,63,B
2018-03-30 21:41:00,13675.0,6,982,-6,13675.0,3,13680.0,63,B
2018-03-30 21:41:01,13675.0,2,984,-2,13675.0,2,13680.0,63,B
2018-03-30 21:41:14,13675.0,4,988,-4,13670.0,1,13680.0,63,B
2018-03-30 21:41:24,13670.0,2,990,0,13665.0,11,13675.0,1,S
2018-03-30 21:41:44,13670.0,2,992,0,13670.0,1,13675.0,1,S
2018-03-30 21:42:14,13670.0,4,996,-2,13665.0,10,13675.0,1,S
2018-03-30 21:42:15,13675.0,2,998,0,13665.0,10,13680.0,63,B
2018-03-30 21:42:49,13675.0,2,1000,0,13670.0,1,13675.0,1,B
2018-03-30 21:43:47,13670.0,2,1002,2,13670.0,1,13675.0,9,S
2018-03-30 21:44:00,13670.0,2,1004,0,13665.0,10,13675.0,9,S
2018-03-30 21:44:50,13670.0,4,1008,2,13665.0,10,13675.0,5,S
2018-03-30 21:45:43,13665.0,2,1010,0,13665.0,6,13670.0,1,S
2018-03-30 21:46:07,13670.0,2,1012,0,13665.0,7,13675.0,6,B
2018-03-30 21:46:15,13670.0,2,1014,0,13670.0,5,13675.0,3,B
2018-03-30 21:46:17,13675.0,6,1020,6,13675.0,8,13680.0,53,B
2018-03-30 21:46:18,13675.0,2,1022,2,13675.0,3,13680.0,50,B
2018-03-30 21:46:30,13680.0,2,1024,2,13675.0,1,13680.0,49,B
2018-03-30 21:46:31,13680.0,2,1026,2,13675.0,3,13680.0,48,B
2018-03-30 21:46:32,13680.0,2,1028,2,13675.0,17,13680.0,47,B
2018-03-30 21:46:33,13680.0,2,1030,2,13675.0,17,13680.0,46,B
2018-03-30 21:46:40,13680.0,2,1032,2,13675.0,16,13680.0,45,B
2018-03-30 21:46:41,13675.0,2,1034,2,13675.0,15,13680.0,45,S
2018-03-30 21:47:01,13680.0,4,1038,4,13675.0,16,13680.0,43,B
2018-03-30 21:47:24,13675.0,2,1040,-2,13670.0,31,13680.0,44,S
2018-03-30 21:47:34,13675.0,10,1050,0,13670.0,7,13680.0,47,S
2018-03-30 21:47:46,13670.0,2,1052,2,13670.0,6,13680.0,47,S
2018-03-30 21:47:59,13680.0,2,1054,0,13670.0,46,13680.0,43,B
2018-03-30 21:48:00,13680.0,2,1056,2,13675.0,12,13680.0,42,B
2018-03-30 21:48:17,13675.0,2,1058,-2,13670.0,20,13680.0,45,S
2018-03-30 21:48:31,13675.0,4,1062,2,13675.0,3,13680.0,45,S
2018-03-30 21:48:31,13675.0,2,1064,0,13675.0,2,13680.0,45,S
2018-03-30 21:48:32,13670.0,6,1070,4,13670.0,1,13680.0,45,S
2018-03-30 21:49:21,13675.0,4,1074,-2,13670.0,4,13680.0,41,B
2018-03-30 21:50:29,13675.0,2,1076,2,13670.0,8,13680.0,42,B
2018-03-30 21:50:50,13675.0,2,1078,-2,13670.0,7,13680.0,43,B
2018-03-30 21:51:14,13670.0,2,1080,-2,13670.0,3,13680.0,45,S
2018-03-30 21:51:15,13675.0,2,1082,0,13670.0,3,13675.0,1,B
2018-03-30 21:51:24,13670.0,2,1084,-2,13670.0,1,13675.0,3,S
2018-03-30 21:52:14,13670.0,2,1086,2,13670.0,1,13675.0,16,S
2018-03-30 21:52:26,13670.0,2,1088,2,13665.0,11,13675.0,2,S
2018-03-30 21:52:38,13670.0,4,1092,-4,13665.0,11,13675.0,18,S
2018-03-30 21:53:08,13665.0,2,1094,0,13665.0,9,13675.0,3,S
2018-03-30 21:53:31,13665.0,2,1096,0,13665.0,8,13675.0,5,S
2018-03-30 21:54:35,13675.0,2,1098,0,13670.0,3,13680.0,43,B
2018-03-30 21:54:36,13670.0,2,1100,-2,13670.0,2,13680.0,41,S
2018-03-30 21:55:20,13675.0,2,1102,2,13670.0,3,13675.0,1,B
2018-03-30 21:55:45,13675.0,2,1104,0,13670.0,2,13680.0,44,B
2018-03-30 21:55:49,13670.0,2,1106,0,13670.0,1,13680.0,59,S
2018-03-30 21:56:06,13675.0,2,1108,2,13675.0,9,13680.0,48,B
2018-03-30 21:56:20,13675.0,4,1112,0,13675.0,10,13680.0,47,B
2018-03-30 21:56:23,13670.0,22,1134,22,13670.0,10,13675.0,13,S
2018-03-30 21:56:23,13670.0,6,1140,2,13670.0,7,13675.0,16,S
2018-03-30 21:56:24,13670.0,2,1142,2,13665.0,19,13675.0,16,S
2018-03-30 21:56:24,13665.0,2,1144,2,13665.0,15,13670.0,1,S
2018-03-30 21:56:28,13665.0,4,1148,0,13665.0,3,13670.0,6,S
2018-03-30 21:56:28,13665.0,2,1150,0,13665.0,2,13670.0,5,S
2018-03-30 21:56:29,13665.0,4,1154,2,13660.0,10,13665.0,4,S
2018-03-30 21:56:30,13660.0,2,1156,0,13660.0,6,13665.0,5,S
2018-03-30 21:56:30,13660.0,8,1164,2,13660.0,2,13665.0,5,S
2018-03-30 21:56:32,13660.0,4,1168,2,13655.0,13,13665.0,3,S
2018-03-30 21:56:33,13655.0,2,1170,2,13655.0,2,13665.0,12,S
2018-03-30 21:56:41,13660.0,2,1172,0,13660.0,1,13670.0,42,B
2018-03-30 21:56:55,13660.0,8,1180,0,13660.0,2,13670.0,15,B
2018-03-30 21:56:55,13660.0,2,1182,0,13660.0,1,13670.0,17,B
2018-03-30 21:57:11,13660.0,2,1184,0,13660.0,2,13670.0,5,B
2018-03-30 21:57:12,13655.0,8,1192,0,13655.0,16,13670.0,5,S
2018-03-30 21:57:13,13655.0,2,1194,0,13655.0,17,13670.0,5,S
2018-03-30 21:57:20,13655.0,2,1196,0,13660.0,3,13670.0,4,S
2018-03-30 21:57:46,13665.0,2,1198,-2,13665.0,2,13670.0,4,B
2018-03-30 21:57:49,13665.0,2,1200,0,13665.0,1,13670.0,4,B
2018-03-30 21:57:52,13665.0,2,1202,0,13660.0,14,13670.0,4,B
2018-03-30 21:57:53,13660.0,2,1204,0,13660.0,14,13670.0,4,S
2018-03-30 21:57:59,13660.0,2,1206,2,13660.0,14,13670.0,4,S
2018-03-30 21:57:59,13660.0,2,1208,2,13660.0,13,13670.0,3,S
2018-03-30 21:58:07,13660.0,2,1210,0,13660.0,13,13670.0,4,S
2018-03-30 21:58:12,13660.0,2,1212,0,13660.0,11,13670.0,4,S
2018-03-30 21:58:30,13660.0,2,1214,2,13660.0,9,13670.0,5,S
2018-03-30 21:58:43,13665.0,2,1216,0,13660.0,10,13670.0,4,B
2018-03-30 21:58:55,13660.0,2,1218,2,13660.0,10,13670.0,4,S
2018-03-30 21:58:59,13655.0,4,1222,2,13655.0,17,13665.0,2,S
2018-03-30 21:58:59,13655.0,2,1224,2,13655.0,16,13665.0,2,S
2018-03-30 21:59:08,13655.0,2,1226,2,13655.0,14,13665.0,2,S
2018-03-30 21:59:09,13655.0,2,1228,2,13655.0,13,13665.0,2,S
2018-03-30 21:59:10,13655.0,8,1236,4,13655.0,11,13670.0,16,S
2018-03-30 21:59:12,13655.0,4,1240,2,13655.0,9,13670.0,19,S
2018-03-30 21:59:26,13665.0,4,1244,2,13655.0,11,13665.0,1,B
2018-03-30 21:59:30,13655.0,2,1246,2,13655.0,13,13670.0,19,S
2018-03-30 21:59:32,13670.0,2,1248,0,13655.0,14,13670.0,18,B
2018-03-30 21:59:37,13665.0,2,1250,0,13660.0,10,13670.0,3,S
2018-03-30 22:00:08,13665.0,4,1254,4,13660.0,14,13670.0,11,S
2018-03-30 22:00:08,13660.0,2,1256,0,13660.0,10,13665.0,1,S
2018-03-30 22:00:25,13660.0,4,1260,4,13655.0,14,13665.0,2,S
2018-03-30 22:00:25,13655.0,2,1262,0,13655.0,13,13665.0,2,S
2018-03-30 22:00:30,13655.0,2,1264,2,13660.0,4,13665.0,2,S
2018-03-30 22:00:46,13660.0,8,1272,0,13655.0,13,13660.0,14,B
2018-03-30 22:00:47,13660.0,24,1296,6,13655.0,7,13660.0,12,B
2018-03-30 22:00:57,13660.0,2,1298,-2,13655.0,12,13660.0,12,B
2018-03-30 22:01:09,13655.0,2,1300,2,13655.0,1,13660.0,15,S
2018-03-30 22:01:20,13655.0,2,1302,2,13650.0,21,13660.0,17,S
2018-03-30 22:01:21,13650.0,2,1304,0,13650.0,17,13660.0,17,S
2018-03-30 22:01:22,13650.0,2,1306,0,13650.0,16,13655.0,2,S
2018-03-30 22:01:30,13650.0,10,1316,2,13650.0,1,13655.0,28,S
2018-03-30 22:01:31,13650.0,2,1318,0,13645.0,13,13655.0,28,S
2018-03-30 22:02:13,13650.0,2,1320,0,13645.0,13,13655.0,27,S
2018-03-30 22:02:13,13645.0,2,1322,0,13645.0,12,13655.0,27,S
2018-03-30 22:02:23,13655.0,2,1324,0,13645.0,13,13655.0,26,B
2018-03-30 22:02:27,13650.0,2,1326,0,13650.0,10,13655.0,26,S
2018-03-30 22:02:27,13650.0,4,1330,0,13650.0,8,13655.0,26,S
2018-03-30 22:02:28,13650.0,4,1334,0,13650.0,6,13655.0,26,S
2018-03-30 22:02:28,13650.0,6,1340,0,13650.0,3,13655.0,26,S
2018-03-30 22:02:29,13650.0,2,1342,0,13650.0,2,13655.0,26,S
2018-03-30 22:02:32,13650.0,4,1346,-4,13645.0,13,13650.0,3,S
2018-03-30 22:02:58,13645.0,2,1348,0,13640.0,17,13650.0,3,S
2018-03-30 22:03:05,13640.0,2,1350,-2,13640.0,16,13650.0,3,S
2018-03-30 22:03:05,13640.0,2,1352,-2,13640.0,15,13645.0,2,S
2018-03-30 22:03:10,13640.0,4,1356,0,13640.0,13,13650.0,4,S
2018-03-30 22:03:18,13645.0,2,1358,0,13645.0,10,13650.0,4,B
2018-03-30 22:03:19,13645.0,2,1360,2,13645.0,9,13650.0,4,B
2018-03-30 22:03:38,13645.0,2,1362,0,13645.0,11,13650.0,4,B
2018-03-30 22:03:54,13650.0,8,1370,2,13650.0,36,13655.0,29,B
2018-03-30 22:03:58,13650.0,2,1372,2,13650.0,35,13655.0,29,B
2018-03-30 22:04:01,13650.0,2,1374,2,13650.0,34,13655.0,29,B
2018-03-30 22:04:03,13650.0,10,1384,0,13650.0,29,13655.0,29,B
2018-03-30 22:04:07,13650.0,2,1386,2,13650.0,28,13655.0,29,B
2018-03-30 22:04:11,13650.0,10,1396,0,13650.0,23,13655.0,29,B
2018-03-30 22:04:22,13650.0,2,1398,2,13650.0,22,13655.0,31,B
2018-03-30 22:04:22,13650.0,4,1402,4,13650.0,20,13655.0,31,B
2018-03-30 22:04:23,13650.0,4,1406,4,13650.0,18,13655.0,31,B
2018-03-30 22:04:38,13650.0,6,1412,0,13650.0,15,13655.0,26,B
2018-03-30 22:04:40,13650.0,4,1416,0,13650.0,13,13655.0,26,B
2018-03-30 22:04:42,13650.0,2,1418,2,13650.0,12,13655.0,26,B
2018-03-30 22:04:45,13650.0,4,1422,4,13650.0,10,13655.0,26,B
2018-03-30 22:05:54,13650.0,4,1426,0,13650.0,18,13655.0,28,B
2018-03-30 22:06:30,13655.0,2,1428,2,13650.0,19,13655.0,27,B
2018-03-30 22:07:13,13650.0,6,1434,0,13650.0,17,13655.0,29,S
2018-03-30 22:07:21,13655.0,14,1448,10,13650.0,4,13655.0,24,B
2018-03-30 22:07:25,13655.0,4,1452,4,13650.0,4,13655.0,21,B
2018-03-30 22:07:26,13655.0,8,1460,8,13650.0,4,13655.0,17,B
2018-03-30 22:07:27,13655.0,28,1488,6,13650.0,16,13655.0,3,B
2018-03-30 22:07:27,13655.0,6,1494,2,13650.0,18,13660.0,5,B
2018-03-30 22:07:28,13650.0,8,1502,0,13650.0,2,13660.0,17,S
2018-03-30 22:07:34,13655.0,2,1504,-2,13650.0,3,13660.0,3,B
2018-03-30 22:07:49,13660.0,2,1506,2,13655.0,2,13665.0,6,B
2018-03-30 22:08:51,13665.0,4,1510,-4,13660.0,6,13665.0,1,B
2018-03-30 22:09:19,13665.0,2,1512,-2,13660.0,5,13665.0,2,B
2018-03-30 22:09:22,13665.0,4,1516,2,13660.0,6,13670.0,9,B
2018-03-30 22:09:32,13670.0,2,1518,0,13665.0,3,13670.0,6,B
2018-03-30 22:09:33,13670.0,2,1520,-2,13665.0,3,13670.0,5,B
2018-03-30 22:09:40,13670.0,2,1522,0,13665.0,3,13670.0,4,B
2018-03-30 22:10:02,13665.0,2,1524,2,13665.0,10,13670.0,4,S
2018-03-30 22:10:06,13670.0,2,1526,0,13665.0,10,13670.0,3,B
2018-03-30 22:10:07,13670.0,6,1532,6,13665.0,12,13675.0,21,B
2018-03-30 22:10:37,13675.0,2,1534,-2,13670.0,24,13675.0,13,B
2018-03-30 22:10:47,13675.0,2,1536,-2,13670.0,26,13675.0,13,B
2018-03-30 22:10:53,13675.0,20,1556,-14,13670.0,26,13675.0,3,B
2018-03-30 22:10:54,13675.0,6,1562,6,13670.0,26,13680.0,4,B
2018-03-30 22:11:43,13670.0,2,1564,0,13670.0,13,13675.0,2,S
2018-03-30 22:12:26,13675.0,2,1566,2,13670.0,14,13680.0,17,B
2018-03-30 22:13:36,13670.0,2,1568,0,13670.0,13,13680.0,45,S
2018-03-30 22:13:38,13670.0,2,1570,0,13670.0,12,13680.0,45,S
2018-03-30 22:15:55,13670.0,2,1572,2,13670.0,11,13675.0,3,S
2018-03-30 22:17:25,13675.0,12,1584,-4,13670.0,11,13675.0,2,B
2018-03-30 22:17:56,13675.0,10,1594,10,13670.0,11,13675.0,2,B
2018-03-30 22:18:11,13670.0,6,1600,0,13670.0,8,13675.0,7,S
2018-03-30 22:18:23,13670.0,2,1602,2,13670.0,17,13675.0,7,S
2018-03-30 22:18:29,13670.0,2,1604,0,13670.0,16,13675.0,12,S
2018-03-30 22:18:39,13675.0,10,1614,10,13670.0,16,13675.0,7,B
2018-03-30 22:18:51,13670.0,2,1616,0,13670.0,15,13675.0,7,S
2018-03-30 22:18:57,13670.0,8,1624,4,13670.0,11,13675.0,20,S
2018-03-30 22:18:58,13670.0,20,1644,8,13665.0,12,13675.0,32,S
2018-03-30 22:19:46,13670.0,2,1646,2,13665.0,10,13670.0,1,S
2018-03-30 22:20:15,13670.0,30,1676,30,13670.0,5,13675.0,7,S
2018-03-30 22:21:15,13675.0,2,1678,2,13670.0,11,13680.0,49,B
2018-03-30 22:21:23,13670.0,2,1680,0,13670.0,11,13680.0,50,S
2018-03-30 22:21:32,13675.0,2,1682,2,13670.0,11,13680.0,50,B
2018-03-30 22:21:56,13680.0,2,1684,0,13675.0,10,13680.0,48,B
2018-03-30 22:22:07,13675.0,4,1688,0,13670.0,12,13680.0,46,S
2018-03-30 22:22:55,13680.0,2,1690,0,13670.0,11,13680.0,46,B
2018-03-30 22:24:44,13675.0,4,1694,0,13670.0,13,13675.0,14,S
2018-03-30 22:24:44,13675.0,28,1722,28,13675.0,6,13680.0,49,S
2018-03-30 22:25:39,13675.0,4,1726,0,13675.0,9,13680.0,49,S
2018-03-30 22:25:39,13675.0,6,1732,6,13670.0,9,13680.0,47,S
2018-03-30 22:26:00,13670.0,8,1740,6,13670.0,4,13675.0,8,S
2018-03-30 22:26:01,13675.0,8,1748,0,13670.0,4,13675.0,1,B
2018-03-30 22:26:41,13670.0,2,1750,2,13665.0,7,13680.0,64,S
2018-03-30 22:27:58,13665.0,2,1752,0,13665.0,2,13675.0,24,S
2018-03-30 22:27:58,13665.0,4,1756,0,13660.0,8,13675.0,26,S
2018-03-30 22:27:59,13660.0,2,1758,2,13660.0,7,13675.0,27,S
2018-03-30 22:28:05,13670.0,10,1768,0,13670.0,15,13675.0,27,B
2018-03-30 22:28:05,13670.0,26,1794,0,13670.0,2,13675.0,27,B
2018-03-30 22:28:06,13670.0,4,1798,0,13665.0,2,13670.0,2,B
2018-03-30 22:28:13,13665.0,4,1802,0,13660.0,7,13675.0,15,S
2018-03-30 22:29:16,13665.0,2,1804,0,13660.0,7,13665.0,6,S
2018-03-30 22:29:34,13665.0,8,1812,0,13665.0,1,13670.0,41,S
2018-03-30 22:29:37,13665.0,2,1814,0,13660.0,4,13670.0,54,S
2018-03-30 22:29:41,13660.0,8,1822,0,13655.0,8,13660.0,3,S
2018-03-30 22:29:41,13660.0,6,1828,0,13655.0,8,13670.0,66,S
2018-03-30 22:29:58,13660.0,2,1830,-2,13655.0,4,13665.0,17,S
2018-03-30 22:30:11,13655.0,6,1836,6,13650.0,10,13655.0,2,S
2018-03-30 22:30:11,13655.0,2,1838,0,13650.0,10,13655.0,1,S
2018-03-30 22:30:12,13655.0,2,1840,0,13650.0,10,13660.0,6,S
2018-03-30 22:30:12,13650.0,2,1842,0,13650.0,9,13660.0,6,S
2018-03-30 22:30:13,13650.0,4,1846,2,13650.0,7,13660.0,6,S
2018-03-30 22:30:14,13660.0,2,1848,0,13655.0,1,13660.0,5,B
2018-03-30 22:30:15,13660.0,2,1850,0,13655.0,6,13660.0,4,B
2018-03-30 22:30:16,13660.0,8,1858,0,13660.0,6,13665.0,5,B
2018-03-30 22:30:19,13670.0,20,1878,0,13660.0,4,13670.0,33,B
2018-03-30 22:30:31,13670.0,64,1942,2,13660.0,4,13670.0,2,B
2018-03-30 22:30:41,13670.0,10,1952,-6,13660.0,1,13670.0,12,B
2018-03-30 22:30:48,13660.0,4,1956,2,13655.0,8,13660.0,3,S
2018-03-30 22:30:51,13660.0,2,1958,0,13655.0,8,13660.0,2,S
2018-03-30 22:30:51,13660.0,4,1962,4,13660.0,5,13670.0,15,S
2018-03-30 22:31:14,13660.0,2,1964,0,13660.0,1,13670.0,16,S
2018-03-30 22:31:19,13660.0,2,1966,2,13655.0,3,13665.0,13,S
2018-03-30 22:32:00,13655.0,10,1976,0,13650.0,22,13665.0,14,S
2018-03-30 22:32:18,13650.0,2,1978,0,13650.0,5,13660.0,15,S
2018-03-30 22:32:29,13650.0,2,1980,2,13650.0,4,13660.0,17,S
2018-03-30 22:32:39,13655.0,2,1982,0,13650.0,4,13660.0,18,B
2018-03-30 22:33:04,13655.0,2,1984,0,13655.0,3,13660.0,3,B
2018-03-30 22:33:45,13655.0,4,1988,0,13655.0,6,13660.0,2,B
2018-03-30 22:33:59,13660.0,2,1990,2,13655.0,6,13660.0,1,B
2018-03-30 22:34:17,13660.0,2,1992,0,13660.0,4,13665.0,4,B
2018-03-30 22:34:17,13660.0,8,2000,8,13655.0,3,13665.0,4,B
2018-03-30 22:34:24,13665.0,2,2002,-2,13650.0,5,13665.0,3,B
2018-03-30 22:34:32,13650.0,2,2004,2,13640.0,2,13655.0,3,S
2018-03-30 22:34:51,13655.0,4,2008,-2,13640.0,18,13655.0,1,B
2018-03-30 22:35:12,13650.0,2,2010,-2,13640.0,2,13650.0,2,S
2018-03-30 22:35:42,13645.0,2,2012,0,13645.0,2,13655.0,4,S
2018-03-30 22:35:52,13645.0,2,2014,2,13645.0,3,13655.0,4,S
2018-03-30 22:36:34,13665.0,14,2028,0,13665.0,3,13670.0,39,B
2018-03-30 22:36:34,13665.0,6,2034,-4,13650.0,8,13660.0,1,B
2018-03-30 22:36:35,13660.0,2,2036,2,13655.0,3,13665.0,11,S
2018-03-30 22:37:56,13655.0,2,2038,0,13650.0,8,13665.0,13,S
2018-03-30 22:38:31,13655.0,2,2040,2,13650.0,13,13660.0,1,S
2018-03-30 22:38:35,13650.0,20,2060,6,13650.0,3,13660.0,1,S
2018-03-30 22:39:16,13660.0,4,2064,-2,13650.0,16,13660.0,2,B
2018-03-30 22:39:34,13655.0,2,2066,0,13650.0,15,13660.0,2,S
2018-03-30 22:40:17,13655.0,2,2068,0,13650.0,19,13660.0,1,S
2018-03-30 22:41:09,13660.0,2,2070,0,13650.0,19,13665.0,5,B
2018-03-30 22:41:37,13660.0,2,2072,0,13660.0,2,13665.0,1,B
2018-03-30 22:44:24,13660.0,2,2074,2,13655.0,11,13665.0,5,B
2018-03-30 22:44:28,13655.0,20,2094,0,13655.0,1,13665.0,5,S
2018-03-30 22:45:12,13665.0,2,2096,0,13655.0,5,13665.0,1,B
2018-03-30 22:45:33,13665.0,4,2100,0,13655.0,11,13665.0,4,B
2018-03-30 22:45:54,13670.0,6,2106,6,13670.0,1,13675.0,19,B
2018-03-30 22:45:54,13675.0,6,2112,0,13670.0,13,13680.0,5,B
2018-03-30 22:45:55,13680.0,2,2114,0,13675.0,3,13680.0,13,B
2018-03-30 22:45:56,13680.0,2,2116,0,13675.0,13,13685.0,14,B
2018-03-30 22:45:57,13680.0,6,2122,6,13680.0,3,13685.0,14,B
2018-03-30 22:45:58,13685.0,4,2126,-4,13675.0,13,13685.0,13,B
2018-03-30 22:46:07,13680.0,2,2128,0,13675.0,16,13685.0,6,S
2018-03-30 22:46:13,13675.0,2,2130,2,13675.0,5,13685.0,18,S
2018-03-30 22:46:13,13675.0,2,2132,2,13675.0,4,13685.0,30,S
2018-03-30 22:47:04,13680.0,2,2134,0,13675.0,17,13685.0,4,B
2018-03-30 22:47:13,13680.0,2,2136,0,13680.0,3,13685.0,4,B
2018-03-30 22:47:14,13680.0,6,2142,2,13675.0,17,13680.0,1,B
2018-03-30 22:47:15,13680.0,2,2144,2,13675.0,17,13685.0,4,B
2018-03-30 22:47:18,13675.0,12,2156,6,13675.0,11,13685.0,5,S
2018-03-30 22:47:58,13675.0,2,2158,0,13670.0,12,13675.0,2,S
2018-03-30 22:47:59,13675.0,4,2162,-2,13670.0,12,13680.0,3,S
2018-03-30 22:48:00,13675.0,2,2164,2,13670.0,11,13680.0,3,S
2018-03-30 22:48:16,13675.0,4,2168,0,13675.0,10,13680.0,4,S
2018-03-30 22:48:16,13675.0,2,2170,2,13670.0,11,13680.0,4,S
2018-03-30 22:49:14,13675.0,2,2172,2,13675.0,10,13680.0,2,S
2018-03-30 22:49:52,13680.0,2,2174,0,13670.0,11,13680.0,4,B
2018-03-30 22:50:57,13680.0,2,2176,0,13675.0,10,13685.0,19,B
2018-03-30 22:51:12,13680.0,2,2178,2,13680.0,9,13685.0,5,B
2018-03-30 22:51:17,13685.0,2,2180,0,13680.0,13,13685.0,3,B
2018-03-30 22:51:18,13685.0,6,2186,6,13685.0,1,13690.0,2,B
2018-03-30 22:51:44,13695.0,2,2188,2,13685.0,10,13695.0,6,B
2018-03-30 22:51:52,13685.0,2,2190,2,13685.0,9,13695.0,6,S
2018-03-30 22:52:34,13690.0,4,2194,2,13680.0,10,13690.0,2,B
2018-03-30 22:52:38,13690.0,2,2196,0,13680.0,11,13690.0,2,B
2018-03-30 22:52:49,13695.0,2,2198,2,13690.0,6,13695.0,1,B
2018-03-30 22:52:49,13695.0,4,2202,0,13690.0,11,13700.0,25,B
2018-03-30 22:52:54,13695.0,2,2204,-2,13690.0,13,13700.0,25,B
2018-03-30 22:53:06,13695.0,2,2206,2,13690.0,15,13700.0,25,B
2018-03-30 22:53:18,13700.0,2,2208,2,13690.0,15,13700.0,24,B
2018-03-30 22:53:21,13700.0,2,2210,2,13690.0,15,13700.0,23,B
2018-03-30 22:53:24,13700.0,2,2212,2,13690.0,15,13700.0,22,B
2018-03-30 22:53:44,13695.0,2,2214,2,13690.0,15,13700.0,36,S
2018-03-30 22:54:06,13690.0,2,2216,2,13690.0,4,13695.0,13,S
2018-03-30 22:54:07,13690.0,2,2218,2,13690.0,3,13695.0,1,S
2018-03-30 22:54:12,13690.0,6,2224,2,13685.0,14,13695.0,1,S
2018-03-30 22:54:15,13690.0,2,2226,0,13690.0,1,13695.0,1,S
2018-03-30 22:54:17,13690.0,2,2228,2,13685.0,15,13700.0,49,S
2018-03-30 22:54:25,13695.0,2,2230,0,13685.0,11,13695.0,2,B
2018-03-30 22:54:28,13695.0,2,2232,0,13685.0,11,13695.0,2,B
2018-03-30 22:54:31,13695.0,6,2238,-6,13685.0,11,13700.0,50,B
2018-03-30 22:54:31,13695.0,2,2240,0,13685.0,4,13695.0,2,B
2018-03-30 22:54:34,13695.0,4,2244,-4,13685.0,14,13700.0,57,B
2018-03-30 22:54:35,13695.0,2,2246,2,13685.0,14,13700.0,57,B
2018-03-30 22:54:42,13690.0,2,2248,2,13685.0,4,13695.0,12,S
2018-03-30 22:54:43,13690.0,2,2250,0,13685.0,10,13700.0,45,S
2018-03-30 22:55:16,13690.0,2,2252,2,13685.0,14,13695.0,2,S
2018-03-30 22:55:27,13690.0,2,2254,-2,13685.0,14,13695.0,3,S
2018-03-30 22:55:35,13685.0,10,2264,-2,13685.0,9,13695.0,2,S
2018-03-30 22:55:46,13690.0,10,2274,10,13690.0,5,13695.0,1,B
2018-03-30 22:56:07,13685.0,2,2276,2,13680.0,14,13695.0,16,S
2018-03-30 22:56:22,13690.0,2,2278,0,13685.0,10,13690.0,1,B
2018-03-30 22:56:53,13690.0,2,2280,0,13685.0,10,13695.0,6,B
2018-03-30 22:57:20,13695.0,8,2288,6,13695.0,8,13700.0,32,B
2018-03-30 22:57:20,13695.0,4,2292,4,13695.0,10,13700.0,22,B
2018-03-30 22:57:34,13695.0,2,2294,0,13695.0,9,13700.0,21,B
2018-03-30 22:57:35,13695.0,2,2296,0,13695.0,9,13700.0,22,B
2018-03-30 22:58:02,13700.0,2,2298,0,13690.0,11,13700.0,22,B
2018-03-30 22:58:06,13700.0,2,2300,0,13690.0,11,13700.0,26,B
2018-03-30 22:58:06,13700.0,10,2310,10,13690.0,11,13700.0,21,B
2018-03-30 22:58:22,13690.0,2,2312,-2,13685.0,10,13695.0,3,S
2018-03-30 22:58:30,13695.0,2,2314,0,13685.0,10,13695.0,2,B
2018-03-30 22:59:04,13685.0,2,2316,0,13685.0,8,13695.0,4,S
2018-03-30 22:59:07,13685.0,2,2318,0,13685.0,1,13690.0,7,S
2018-03-30 22:59:15,13690.0,2,2320,2,13680.0,16,13690.0,1,B
2018-03-30 22:59:27,13690.0,2,2322,2,13680.0,6,13690.0,1,B
2018-03-30 22:59:40,13690.0,4,2326,0,13680.0,6,13690.0,3,B
2018-03-30 22:59:41,13680.0,4,2330,0,13680.0,4,13690.0,3,S
2018-04-02 09:00:00,13700.0,24,2354,22,13680.0,4,13700.0,2,B
2018-04-02 09:00:01,13700.0,4,2358,0,13695.0,3,13710.0,2,B
2018-04-02 09:00:01,13700.0,2,2360,2,13695.0,13,13710.0,2,B
2018-04-02 09:00:02,13700.0,8,2368,2,13700.0,2,13710.0,1,B
2018-04-02 09:00:02,13715.0,4,2372,2,13705.0,2,13720.0,9,B
2018-04-02 09:00:03,13735.0,22,2394,6,13720.0,1,13750.0,12,B
2018-04-02 09:00:07,13745.0,2,2396,-2,13725.0,8,13745.0,30,B
2018-04-02 09:00:07,13740.0,4,2400,2,13725.0,6,13740.0,12,S
2018-04-02 09:00:08,13735.0,4,2404,0,13730.0,2,13735.0,5,S
2018-04-02 09:00:09,13735.0,2,2406,-2,13725.0,4,13730.0,2,S
2018-04-02 09:00:10,13735.0,4,2410,-4,13720.0,12,13725.0,5,S
2018-04-02 09:00:10,13725.0,2,2412,-2,13710.0,12,13725.0,4,S
2018-04-02 09:00:12,13725.0,2,2414,0,13715.0,12,13725.0,5,S
2018-04-02 09:00:16,13715.0,4,2418,0,13715.0,10,13725.0,6,S
2018-04-02 09:00:17,13705.0,4,2422,0,13705.0,4,13720.0,2,S
2018-04-02 09:00:20,13720.0,20,2442,2,13695.0,24,13725.0,6,B
2018-04-02 09:00:26,13700.0,10,2452,0,13700.0,6,13710.0,5,S
2018-04-02 09:00:30,13710.0,6,2458,0,13705.0,7,13710.0,2,B
2018-04-02 09:00:32,13705.0,10,2468,-2,13700.0,5,13705.0,2,S
2018-04-02 09:00:37,13710.0,4,2472,2,13700.0,9,13710.0,3,B
2018-04-02 09:00:39,13710.0,2,2474,-2,13705.0,1,13710.0,4,B
2018-04-02 09:00:39,13705.0,2,2476,2,13700.0,9,13710.0,4,S
2018-04-02 09:00:41,13700.0,2,2478,2,13700.0,8,13705.0,3,S
2018-04-02 09:00:46,13700.0,2,2480,0,13700.0,8,13705.0,3,S
2018-04-02 09:00:49,13700.0,2,2482,2,13700.0,7,13705.0,8,S
2018-04-02 09:00:55,13700.0,2,2484,0,13700.0,6,13705.0,6,S
2018-04-02 09:00:59,13705.0,12,2496,-2,13705.0,4,13710.0,1,B
2018-04-02 09:01:01,13705.0,6,2502,-4,13705.0,1,13710.0,3,B
2018-04-02 09:01:02,13705.0,2,2504,-2,13700.0,16,13705.0,3,B
2018-04-02 09:01:03,13700.0,12,2516,8,13700.0,12,13720.0,1,S
2018-04-02 09:01:04,13705.0,2,2518,-2,13700.0,2,13705.0,2,B
2018-04-02 09:01:05,13700.0,2,2520,0,13700.0,1,13705.0,1,S
2018-04-02 09:01:05,13700.0,2,2522,0,13695.0,13,13700.0,1,S
2018-04-02 09:01:06,13700.0,2,2524,0,13695.0,12,13705.0,1,S
2018-04-02 09:01:15,13700.0,2,2526,2,13695.0,12,13705.0,1,S
2018-04-02 09:01:16,13695.0,4,2530,0,13695.0,10,13700.0,1,S
2018-04-02 09:01:16,13700.0,4,2534,2,13695.0,10,13705.0,1,B
2018-04-02 09:01:17,13700.0,4,2538,0,13700.0,1,13705.0,1,B
2018-04-02 09:01:21,13700.0,2,2540,0,13695.0,10,13705.0,1,B
2018-04-02 09:01:22,13695.0,2,2542,0,13695.0,9,13700.0,4,S
2018-04-02 09:01:28,13700.0,2,2544,0,13695.0,10,13700.0,4,B
2018-04-02 09:01:29,13695.0,2,2546,2,13695.0,9,13700.0,4,S
2018-04-02 09:01:33,13700.0,6,2552,0,13695.0,13,13700.0,1,B
2018-04-02 09:01:33,13695.0,2,2554,0,13695.0,12,13700.0,1,S
2018-04-02 09:01:36,13700.0,2,2556,0,13695.0,12,13705.0,1,B
2018-04-02 09:01:49,13700.0,4,2560,2,13700.0,9,13705.0,4,B
2018-04-02 09:01:52,13700.0,18,2578,0,13695.0,13,13705.0,4,B
2018-04-02 09:01:55,13700.0,2,2580,0,13695.0,11,13700.0,5,B
2018-04-02 09:01:56,13695.0,18,2598,14,13695.0,2,13700.0,5,S
2018-04-02 09:01:57,13695.0,4,2602,4,13690.0,1,13695.0,1,S
2018-04-02 09:02:02,13695.0,2,2604,0,13695.0,4,13700.0,8,S
2018-04-02 09:02:03,13695.0,8,2612,4,13690.0,2,13695.0,1,S
2018-04-02 09:02:09,13690.0,4,2616,-4,13685.0,2,13695.0,6,S
2018-04-02 09:02:12,13685.0,4,2620,-4,13685.0,1,13690.0,2,S
2018-04-02 09:02:12,13680.0,12,2632,-10,13675.0,2,13685.0,2,S
2018-04-02 09:02:18,13680.0,2,2634,-2,13680.0,3,13690.0,1,S
2018-04-02 09:02:26,13685.0,10,2644,10,13685.0,2,13690.0,1,B
2018-04-02 09:02:34,13690.0,4,2648,0,13685.0,2,13690.0,2,B
2018-04-02 09:02:36,13690.0,4,2652,0,13685.0,5,13690.0,1,B
2018-04-02 09:02:36,13690.0,2,2654,2,13680.0,2,13695.0,1,B
2018-04-02 09:02:49,13690.0,2,2656,2,13680.0,13,13690.0,3,B
2018-04-02 09:02:50,13680.0,26,2682,0,13675.0,3,13680.0,487,S
2018-04-02 09:02:52,13675.0,2,2684,2,13675.0,5,13680.0,487,S
2018-04-02 09:02:55,13680.0,2,2686,0,13675.0,5,13680.0,486,B
2018-04-02 09:02:56,13675.0,4,2690,2,13675.0,3,13680.0,486,S
2018-04-02 09:02:56,13675.0,10,2700,0,13670.0,2,13675.0,1,S
2018-04-02 09:02:57,13670.0,2,2702,2,13670.0,1,13675.0,2,S
2018-04-02 09:02:58,13670.0,2,2704,2,13665.0,11,13670.0,4,S
2018-04-02 09:03:02,13665.0,6,2710,0,13665.0,11,13675.0,3,S
2018-04-02 09:03:06,13670.0,2,2712,-2,13665.0,11,13675.0,3,B
2018-04-02 09:03:11,13670.0,2,2714,0,13665.0,12,13675.0,7,B
2018-04-02 09:03:12,13665.0,20,2734,20,13660.0,1,13675.0,9,S
2018-04-02 09:03:15,13660.0,2,2736,-2,13655.0,7,13670.0,9,S
2018-04-02 09:03:15,13680.0,120,2856,110,13660.0,5,13670.0,1,B
2018-04-02 09:03:17,13670.0,2,2858,0,13665.0,8,13675.0,3,S
2018-04-02 09:03:21,13680.0,12,2870,2,13675.0,3,13680.0,444,B
2018-04-02 09:03:22,13675.0,8,2878,2,13670.0,3,13680.0,443,S
2018-04-02 09:03:27,13665.0,28,2906,-14,13660.0,15,13665.0,46,S
2018-04-02 09:03:28,13665.0,20,2926,-18,13660.0,3,13665.0,36,S
2018-04-02 09:03:35,13665.0,24,2950,-20,13655.0,7,13665.0,28,S
2018-04-02 09:03:35,13665.0,10,2960,-10,13655.0,7,13665.0,23,S
2018-04-02 09:03:36,13665.0,20,2980,0,13660.0,1,13665.0,13,S
2018-04-02 09:03:38,13660.0,2,2982,0,13660.0,3,13665.0,13,S
2018-04-02 09:03:44,13660.0,2,2984,2,13660.0,3,13665.0,13,S
2018-04-02 09:03:47,13660.0,6,2990,4,13655.0,7,13660.0,7,S
2018-04-02 09:03:58,13660.0,2,2992,2,13655.0,9,13660.0,10,S
2018-04-02 09:04:00,13655.0,18,3010,-14,13650.0,9,13655.0,2,S
2018-04-02 09:04:01,13650.0,6,3016,0,13655.0,1,13660.0,7,S
2018-04-02 09:04:01,13650.0,2,3018,-2,13650.0,10,13660.0,7,S
2018-04-02 09:04:05,13660.0,4,3022,0,13650.0,37,13660.0,4,B
2018-04-02 09:04:06,13650.0,110,3132,-28,13645.0,26,13650.0,5,S
2018-04-02 09:04:06,13650.0,10,3142,0,13650.0,2,13660.0,15,S
2018-04-02 09:04:08,13655.0,2,3144,0,13650.0,1,13655.0,5,B
2018-04-02 09:04:09,13655.0,10,3154,0,13650.0,1,13660.0,15,B
2018-04-02 09:04:13,13660.0,20,3174,20,13650.0,1,13660.0,5,B
2018-04-02 09:04:19,13650.0,2,3176,0,13650.0,1,13660.0,9,S
2018-04-02 09:04:21,13650.0,4,3180,0,13655.0,2,13660.0,5,S
2018-04-02 09:04:22,13660.0,10,3190,8,13660.0,10,13665.0,2,B
2018-04-02 09:04:23,13660.0,2,3192,0,13660.0,9,13665.0,2,B
2018-04-02 09:04:23,13660.0,2,3194,2,13660.0,8,13665.0,2,B
2018-04-02 09:04:26,13665.0,2,3196,2,13665.0,1,13670.0,1,B
2018-04-02 09:04:27,13665.0,2,3198,2,13660.0,8,13675.0,2,B
2018-04-02 09:04:28,13665.0,4,3202,0,13660.0,8,13670.0,9,B
2018-04-02 09:04:31,13670.0,4,3206,0,13660.0,8,13670.0,3,B
2018-04-02 09:04:32,13660.0,14,3220,0,13660.0,1,13665.0,3,S
2018-04-02 09:04:32,13660.0,2,3222,2,13650.0,12,13665.0,3,S
2018-04-02 09:04:44,13660.0,2,3224,0,13655.0,10,13665.0,4,S
2018-04-02 09:04:46,13655.0,16,3240,0,13655.0,3,13665.0,4,S
2018-04-02 09:04:48,13665.0,8,3248,-8,13665.0,6,13670.0,11,B
2018-04-02 09:04:48,13665.0,2,3250,-2,13665.0,5,13670.0,13,B
2018-04-02 09:04:49,13665.0,2,3252,0,13665.0,4,13670.0,18,B
2018-04-02 09:04:49,13665.0,4,3256,-4,13665.0,2,13670.0,18,B
2018-04-02 09:04:50,13665.0,4,3260,-4,13660.0,11,13670.0,18,B
2018-04-02 09:04:54,13665.0,2,3262,0,13660.0,12,13665.0,9,B
2018-04-02 09:05:02,13665.0,2,3264,2,13660.0,12,13665.0,8,B
2018-04-02 09:05:09,13665.0,2,3266,2,13660.0,11,13665.0,9,B
2018-04-02 09:05:12,13660.0,12,3278,0,13660.0,5,13665.0,10,S
2018-04-02 09:05:15,13665.0,2,3280,2,13660.0,5,13665.0,12,B
2018-04-02 09:05:16,13660.0,4,3284,-4,13660.0,3,13665.0,12,S
2018-04-02 09:05:16,13660.0,4,3288,-4,13660.0,1,13665.0,12,S
2018-04-02 09:05:17,13660.0,2,3290,-2,13655.0,4,13660.0,3,S
2018-04-02 09:05:18,13660.0,6,3296,0,13655.0,4,13665.0,9,S
2018-04-02 09:05:22,13665.0,2,3298,0,13655.0,5,13665.0,9,B
2018-04-02 09:05:25,13655.0,4,3302,2,13650.0,13,13660.0,13,S
2018-04-02 09:05:25,13660.0,2,3304,0,13650.0,2,13660.0,13,B
2018-04-02 09:05:27,13660.0,2,3306,0,13650.0,2,13660.0,12,B
2018-04-02 09:05:34,13650.0,2,3308,2,13650.0,1,13655.0,11,S
2018-04-02 09:05:34,13650.0,2,3310,-2,13645.0,6,13655.0,13,S
2018-04-02 09:05:40,13650.0,16,3326,-16,13650.0,2,13655.0,7,S
2018-04-02 09:05:41,13650.0,4,3330,0,13645.0,3,13650.0,3,S
2018-04-02 09:05:42,13645.0,6,3336,6,13640.0,2,13650.0,8,S
2018-04-02 09:05:46,13640.0,4,3340,0,13635.0,4,13645.0,10,S
2018-04-02 09:05:47,13635.0,2,3342,-2,13635.0,2,13640.0,11,S
2018-04-02 09:05:47,13640.0,20,3362,0,13635.0,2,13640.0,2,B
2018-04-02 09:05:49,13630.0,6,3368,-6,13630.0,3,13640.0,2,S
2018-04-02 09:05:49,13630.0,2,3370,0,13630.0,2,13640.0,4,S
2018-04-02 09:05:53,13630.0,2,3372,0,13625.0,1,13635.0,10,S
2018-04-02 09:05:55,13620.0,4,3376,2,13620.0,5,13630.0,4,S
2018-04-02 09:05:57,13620.0,2,3378,-2,13620.0,1,13625.0,11,S
2018-04-02 09:05:57,13620.0,2,3380,0,13615.0,3,13620.0,9,S
2018-04-02 09:05:58,13615.0,6,3386,0,13610.0,1,13615.0,6,S
2018-04-02 09:05:58,13610.0,2,3388,0,13605.0,5,13610.0,2,S
2018-04-02 09:05:59,13610.0,4,3392,0,13610.0,3,13615.0,4,S
2018-04-02 09:05:59,13605.0,16,3408,4,13600.0,24,13610.0,2,S
2018-04-02 09:06:01,13605.0,6,3414,-4,13600.0,23,13605.0,1,S
2018-04-02 09:06:02,13610.0,2,3416,-2,13600.0,21,13610.0,2,B
2018-04-02 09:06:06,13615.0,2,3418,0,13605.0,7,13615.0,15,B
2018-04-02 09:06:06,13610.0,4,3422,0,13610.0,8,13615.0,14,S
2018-04-02 09:06:07,13610.0,4,3426,-2,13610.0,6,13615.0,2,S
2018-04-02 09:06:07,13610.0,2,3428,0,13610.0,5,13615.0,2,S
2018-04-02 09:06:08,13610.0,10,3438,-2,13605.0,1,13610.0,2,S
2018-04-02 09:06:08,13605.0,2,3440,2,13600.0,22,13605.0,2,S
2018-04-02 09:06:09,13605.0,4,3444,-2,13605.0,2,13610.0,3,S
2018-04-02 09:06:10,13605.0,2,3446,-2,13605.0,1,13610.0,3,S
2018-04-02 09:06:11,13610.0,20,3466,-6,13600.0,21,13615.0,6,B
2018-04-02 09:06:14,13610.0,2,3468,0,13600.0,23,13610.0,4,B
2018-04-02 09:06:14,13610.0,2,3470,0,13600.0,23,13610.0,3,B
2018-04-02 09:06:15,13610.0,2,3472,2,13605.0,1,13610.0,2,B
2018-04-02 09:06:15,13605.0,2,3474,2,13600.0,23,13610.0,2,S
2018-04-02 09:06:16,13605.0,12,3486,0,13600.0,17,13605.0,2,S
2018-04-02 09:06:16,13600.0,2,3488,-2,13600.0,16,13605.0,2,S
2018-04-02 09:06:17,13605.0,4,3492,-2,13600.0,15,13605.0,1,B
2018-04-02 09:06:17,13605.0,2,3494,2,13600.0,15,13610.0,5,B
2018-04-02 09:06:18,13600.0,2,3496,-2,13600.0,13,13610.0,28,S
2018-04-02 09:06:18,13600.0,6,3502,-2,13600.0,4,13610.0,51,S
2018-04-02 09:06:19,13605.0,4,3506,2,13600.0,3,13605.0,22,B
2018-04-02 09:06:19,13600.0,2,3508,-2,13600.0,2,13610.0,27,S
2018-04-02 09:06:20,13600.0,4,3512,0,13600.0,1,13605.0,22,S
2018-04-02 09:06:21,13600.0,2,3514,-2,13595.0,3,13610.0,30,S
2018-04-02 09:06:21,13595.0,2,3516,-2,13595.0,2,13610.0,30,S
2018-04-02 09:06:22,13595.0,2,3518,-2,13595.0,1,13600.0,1,S
2018-04-02 09:06:23,13595.0,2,3520,0,13595.0,1,13600.0,1,S
2018-04-02 09:06:24,13590.0,2,3522,0,13590.0,3,13595.0,2,S
2018-04-02 09:06:25,13590.0,2,3524,2,13590.0,1,13595.0,2,S
2018-04-02 09:06:26,13595.0,4,3528,2,13585.0,12,13595.0,1,B
2018-04-02 09:06:26,13595.0,4,3532,-4,13585.0,11,13600.0,25,B
2018-04-02 09:06:27,13585.0,4,3536,-2,13585.0,9,13590.0,1,S
2018-04-02 09:06:27,13585.0,6,3542,-4,13585.0,7,13595.0,1,S
2018-04-02 09:06:28,13595.0,2,3544,-2,13585.0,7,13600.0,27,B
2018-04-02 09:06:28,13585.0,2,3546,-2,13585.0,5,13595.0,8,S
2018-04-02 09:06:29,13585.0,2,3548,-2,13585.0,4,13595.0,8,S
2018-04-02 09:06:31,13590.0,16,3564,16,13585.0,4,13595.0,41,B
2018-04-02 09:06:32,13585.0,8,3572,-8,13580.0,5,13585.0,21,S
2018-04-02 09:06:32,13580.0,10,3582,4,13575.0,2,13585.0,21,S
2018-04-02 09:06:33,13580.0,4,3586,-4,13575.0,2,13585.0,19,S
2018-04-02 09:06:34,13575.0,4,3590,-2,13570.0,8,13580.0,3,S
2018-04-02 09:06:35,13570.0,6,3596,-2,13570.0,5,13575.0,37,S
2018-04-02 09:06:35,13575.0,10,3606,0,13565.0,2,13570.0,1,B
2018-04-02 09:06:36,13570.0,2,3608,-2,13570.0,1,13575.0,1,S
2018-04-02 09:06:38,13565.0,4,3612,0,13560.0,8,13575.0,30,S
2018-04-02 09:06:38,13575.0,4,3616,2,13560.0,8,13575.0,29,B
2018-04-02 09:06:39,13570.0,2,3618,-2,13565.0,3,13570.0,1,S
2018-04-02 09:06:40,13570.0,4,3622,-2,13565.0,3,13575.0,2,S
2018-04-02 09:06:40,13565.0,2,3624,0,13565.0,4,13575.0,2,S
2018-04-02 09:06:41,13570.0,4,3628,-2,13570.0,7,13580.0,1,B
2018-04-02 09:06:43,13570.0,2,3630,0,13575.0,4,13580.0,5,B
2018-04-02 09:06:43,13575.0,8,3638,8,13570.0,1,13575.0,3,B
2018-04-02 09:06:46,13580.0,4,3642,2,13575.0,1,13580.0,1,B
2018-04-02 09:06:47,13585.0,4,3646,2,13575.0,4,13585.0,15,B
2018-04-02 09:06:48,13575.0,10,3656,2,13575.0,1,13585.0,17,S
2018-04-02 09:06:50,13585.0,30,3686,30,13580.0,5,13590.0,3,B
2018-04-02 09:06:51,13580.0,2,3688,2,13580.0,3,13590.0,3,S
2018-04-02 09:06:52,13575.0,18,3706,14,13570.0,3,13575.0,1,S
2018-04-02 09:06:53,13585.0,4,3710,-2,13575.0,11,13585.0,1,B
2018-04-02 09:06:53,13585.0,2,3712,0,13580.0,2,13590.0,4,B
2018-04-02 09:06:57,13590.0,2,3714,0,13590.0,2,13595.0,5,B
2018-04-02 09:06:59,13590.0,4,3718,0,13585.0,2,13590.0,4,B
2018-04-02 09:07:01,13580.0,6,3724,-6,13575.0,3,13590.0,8,S
2018-04-02 09:07:04,13580.0,2,3726,-2,13575.0,4,13585.0,1,S
2018-04-02 09:07:05,13580.0,2,3728,0,13575.0,4,13580.0,3,S
2018-04-02 09:07:06,13580.0,6,3734,6,13580.0,1,13585.0,1,S
2018-04-02 09:07:06,13580.0,6,3740,0,13575.0,9,13590.0,5,S
2018-04-02 09:07:07,13585.0,4,3744,0,13585.0,1,13590.0,4,B
2018-04-02 09:07:08,13580.0,2,3746,2,13575.0,8,13580.0,9,S
2018-04-02 09:07:08,13580.0,18,3764,10,13575.0,8,13585.0,4,S
2018-04-02 09:07:09,13580.0,4,3768,-4,13575.0,5,13585.0,4,S
2018-04-02 09:07:12,13580.0,12,3780,8,13575.0,1,13585.0,11,S
2018-04-02 09:07:14,13585.0,2,3782,0,13575.0,1,13585.0,7,B
2018-04-02 09:07:16,13585.0,2,3784,2,13575.0,1,13585.0,4,B
2018-04-02 09:07:17,13580.0,2,3786,0,13580.0,1,13585.0,4,S
2018-04-02 09:07:20,13580.0,6,3792,-4,13575.0,2,13580.0,2,S
2018-04-02 09:07:26,13575.0,2,3794,2,13575.0,6,13580.0,2,S
2018-04-02 09:07:26,13580.0,2,3796,0,13575.0,6,13580.0,5,B
2018-04-02 09:07:27,13580.0,10,3806,-10,13580.0,3,13585.0,5,B
2018-04-02 09:07:27,13580.0,6,3812,0,13575.0,4,13580.0,3,B
2018-04-02 09:07:28,13575.0,2,3814,0,13575.0,4,13580.0,5,S
2018-04-02 09:07:34,13575.0,2,3816,-2,13575.0,5,13580.0,4,S
2018-04-02 09:07:35,13575.0,6,3822,4,13575.0,2,13580.0,4,S
2018-04-02 09:07:35,13575.0,2,3824,-2,13575.0,1,13580.0,4,S
2018-04-02 09:07:36,13575.0,2,3826,0,13570.0,9,13580.0,4,S
2018-04-02 09:07:37,13575.0,6,3832,-6,13570.0,2,13580.0,8,S
2018-04-02 09:07:40,13580.0,2,3834,2,13570.0,4,13580.0,4,B
2018-04-02 09:07:41,13575.0,2,3836,0,13570.0,9,13580.0,4,S
2018-04-02 09:07:44,13575.0,2,3838,0,13570.0,4,13580.0,7,S
2018-04-02 09:07:45,13575.0,2,3840,0,13570.0,5,13575.0,2,S
2018-04-02 09:07:46,13575.0,4,3844,-4,13570.0,4,13580.0,2,S
2018-04-02 09:07:47,13580.0,2,3846,2,13575.0,1,13580.0,3,B
2018-04-02 09:07:48,13575.0,2,3848,0,13570.0,7,13580.0,7,S
2018-04-02 09:07:50,13580.0,4,3852,4,13570.0,5,13580.0,2,B
2018-04-02 09:07:56,13580.0,4,3856,-4,13575.0,8,13580.0,8,B
2018-04-02 09:07:56,13580.0,16,3872,-12,13575.0,8,13585.0,4,B
2018-04-02 09:07:58,13580.0,4,3876,4,13575.0,6,13585.0,2,B
2018-04-02 09:08:05,13580.0,2,3878,0,13575.0,17,13580.0,2,B
2018-04-02 09:08:05,13580.0,4,3882,-4,13580.0,3,13585.0,3,B
2018-04-02 09:08:07,13585.0,2,3884,2,13580.0,11,13590.0,3,B
2018-04-02 09:08:08,13595.0,20,3904,-16,13580.0,11,13595.0,6,B
2018-04-02 09:08:11,13595.0,2,3906,0,13585.0,11,13595.0,7,B
2018-04-02 09:08:17,13585.0,48,3954,-24,13585.0,1,13600.0,7,S
2018-04-02 09:08:19,13595.0,2,3956,0,13585.0,2,13595.0,7,B
2018-04-02 09:08:23,13590.0,2,3958,-2,13585.0,18,13595.0,7,S
2018-04-02 09:08:24,13595.0,2,3960,0,13585.0,18,13595.0,7,B
2018-04-02 09:08:25,13590.0,6,3966,0,13585.0,18,13595.0,1,S
2018-04-02 09:08:26,13585.0,2,3968,-2,13585.0,22,13595.0,1,S
2018-04-02 09:08:32,13590.0,6,3974,-4,13590.0,5,13600.0,1,B
2018-04-02 09:08:35,13595.0,2,3976,-2,13595.0,4,13600.0,1,B
2018-04-02 09:08:42,13600.0,2,3978,0,13600.0,4,13605.0,5,B
2018-04-02 09:08:42,13605.0,2,3980,-2,13600.0,4,13605.0,2,B
2018-04-02 09:08:46,13605.0,4,3984,-2,13600.0,6,13605.0,3,B
2018-04-02 09:08:48,13600.0,2,3986,0,13600.0,5,13610.0,5,S
2018-04-02 09:08:54,13600.0,2,3988,0,13600.0,1,13605.0,2,S
2018-04-02 09:08:55,13600.0,2,3990,0,13595.0,8,13605.0,2,S
2018-04-02 09:09:02,13600.0,8,3998,2,13595.0,5,13605.0,19,S
2018-04-02 09:09:05,13600.0,2,4000,-2,13595.0,5,13605.0,10,S
2018-04-02 09:09:15,13605.0,10,4010,-2,13600.0,1,13605.0,8,B
2018-04-02 09:09:16,13600.0,2,4012,0,13595.0,3,13600.0,2,S
2018-04-02 09:09:24,13600.0,4,4016,0,13600.0,2,13605.0,6,S
2018-04-02 09:09:26,13605.0,6,4022,-4,13600.0,5,13605.0,1,B
2018-04-02 09:09:27,13605.0,2,4024,0,13600.0,5,13610.0,4,B
2018-04-02 09:09:37,13605.0,2,4026,0,13600.0,4,13610.0,4,B
2018-04-02 09:09:41,13610.0,2,4028,0,13605.0,3,13610.0,2,B
2018-04-02 09:09:42,13610.0,4,4032,-2,13605.0,1,13615.0,2,B
2018-04-02 09:09:44,13620.0,2,4034,-2,13610.0,2,13620.0,1,B
2018-04-02 09:09:45,13620.0,2,4036,2,13620.0,3,13625.0,3,B
2018-04-02 09:09:46,13625.0,4,4040,0,13620.0,6,13625.0,1,B
2018-04-02 09:09:46,13625.0,2,4042,0,13625.0,1,13630.0,3,B
2018-04-02 09:09:48,13625.0,2,4044,0,13625.0,8,13630.0,3,B
2018-04-02 09:09:59,13620.0,2,4046,0,13620.0,3,13625.0,4,S
2018-04-02 09:09:59,13620.0,6,4052,-4,13615.0,3,13620.0,1,S
2018-04-02 09:10:00,13625.0,4,4056,4,13615.0,1,13625.0,5,B
2018-04-02 09:10:03,13615.0,2,4058,-2,13610.0,13,13625.0,7,S
2018-04-02 09:10:08,13610.0,2,4060,-2,13610.0,10,13625.0,7,S
2018-04-02 09:10:10,13615.0,6,4066,2,13610.0,10,13615.0,1,B
2018-04-02 09:10:10,13615.0,2,4068,2,13615.0,11,13625.0,4,B
2018-04-02 09:10:33,13620.0,4,4072,-4,13620.0,2,13625.0,12,B
2018-04-02 09:10:34,13625.0,16,4088,12,13620.0,3,13625.0,4,B
2018-04-02 09:10:34,13625.0,8,4096,0,13620.0,3,13625.0,1,B
2018-04-02 09:10:35,13625.0,2,4098,0,13625.0,3,13630.0,5,B
2018-04-02 09:10:35,13625.0,4,4102,0,13625.0,3,13630.0,4,B
2018-04-02 09:10:36,13630.0,4,4106,-2,13625.0,2,13630.0,2,B
2018-04-02 09:10:38,13625.0,2,4108,0,13625.0,5,13630.0,2,S
2018-04-02 09:10:40,13630.0,4,4112,-2,13625.0,4,13635.0,2,B
2018-04-02 09:10:40,13635.0,2,4114,0,13630.0,2,13635.0,1,B
2018-04-02 09:10:47,13645.0,4,4118,4,13630.0,1,13650.0,2,B
2018-04-02 09:10:50,13645.0,2,4120,0,13640.0,3,13650.0,5,B
2018-04-02 09:10:50,13650.0,10,4130,2,13650.0,1,13655.0,1,B
2018-04-02 09:10:51,13655.0,2,4132,0,13655.0,12,13660.0,2,B
2018-04-02 09:10:52,13660.0,4,4136,-2,13655.0,6,13665.0,5,B
2018-04-02 09:10:53,13660.0,2,4138,0,13655.0,4,13665.0,6,B
2018-04-02 09:10:54,13665.0,4,4142,0,13660.0,1,13665.0,4,B
2018-04-02 09:10:56,13655.0,2,4144,-2,13650.0,3,13660.0,2,S
2018-04-02 09:10:58,13650.0,4,4148,2,13645.0,1,13655.0,1,S
2018-04-02 09:10:58,13645.0,2,4150,2,13640.0,2,13650.0,3,S
2018-04-02 09:10:59,13645.0,4,4154,-2,13640.0,1,13650.0,4,S
2018-04-02 09:11:00,13655.0,4,4158,0,13645.0,3,13655.0,1,B
2018-04-02 09:11:03,13655.0,2,4160,2,13650.0,2,13660.0,3,B
2018-04-02 09:11:04,13650.0,2,4162,2,13650.0,1,13660.0,3,S
2018-04-02 09:11:06,13650.0,2,4164,2,13650.0,1,13660.0,2,S
2018-04-02 09:11:07,13650.0,2,4166,-2,13650.0,1,13660.0,5,S
2018-04-02 09:11:19,13645.0,2,4168,2,13645.0,2,13655.0,4,S
2018-04-02 09:11:23,13645.0,2,4170,0,13640.0,1,13650.0,5,S
2018-04-02 09:11:34,13635.0,2,4172,-2,13635.0,2,13645.0,3,S
2018-04-02 09:11:37,13630.0,2,4174,2,13625.0,21,13645.0,3,S
2018-04-02 09:11:37,13630.0,2,4176,0,13630.0,3,13640.0,8,S
2018-04-02 09:11:41,13640.0,12,4188,0,13635.0,3,13645.0,4,B
2018-04-02 09:11:45,13645.0,2,4190,2,13635.0,4,13645.0,1,B
2018-04-02 09:11:47,13635.0,4,4194,0,13635.0,11,13640.0,10,S
2018-04-02 09:11:49,13635.0,6,4200,-4,13635.0,7,13640.0,10,S
2018-04-02 09:11:51,13635.0,14,4214,0,13630.0,3,13635.0,5,S
2018-04-02 09:11:53,13635.0,10,4224,0,13625.0,11,13640.0,6,S
2018-04-02 09:11:55,13630.0,2,4226,-2,13625.0,2,13635.0,7,S
2018-04-02 09:11:56,13635.0,2,4228,-2,13625.0,2,13635.0,6,B
2018-04-02 09:11:57,13635.0,4,4232,-4,13625.0,3,13635.0,3,B
2018-04-02 09:11:58,13630.0,2,4234,-2,13630.0,2,13635.0,2,S
2018-04-02 09:12:00,13630.0,2,4236,-2,13625.0,11,13635.0,6,S
2018-04-02 09:12:01,13625.0,2,4238,0,13625.0,10,13630.0,2,S
2018-04-02 09:12:02,13625.0,2,4240,0,13625.0,9,13630.0,5,S
2018-04-02 09:12:03,13625.0,8,4248,-8,13625.0,5,13630.0,5,S
2018-04-02 09:12:04,13625.0,10,4258,-8,13620.0,3,13625.0,7,S
2018-04-02 09:12:05,13625.0,14,4272,-4,13625.0,2,13630.0,5,S
2018-04-02 09:12:06,13625.0,2,4274,-2,13625.0,1,13630.0,1,S
2018-04-02 09:12:11,13630.0,2,4276,0,13625.0,6,13635.0,3,B
2018-04-02 09:12:12,13635.0,2,4278,0,13635.0,5,13640.0,9,B
2018-04-02 09:12:16,13640.0,2,4280,-2,13635.0,4,13640.0,6,B
2018-04-02 09:12:19,13635.0,2,4282,2,13630.0,1,13640.0,6,S
2018-04-02 09:12:29,13635.0,10,4292,0,13630.0,4,13640.0,8,S
2018-04-02 09:12:35,13640.0,4,4296,-2,13635.0,4,13640.0,4,B
2018-04-02 09:12:35,13640.0,8,4304,4,13640.0,8,13645.0,3,B
2018-04-02 09:12:49,13650.0,8,4312,2,13645.0,8,13650.0,2,B
2018-04-02 09:12:50,13650.0,4,4316,-4,13650.0,5,13655.0,3,B
2018-04-02 09:12:50,13655.0,6,4322,4,13655.0,3,13660.0,2,B
2018-04-02 09:12:51,13660.0,4,4326,2,13655.0,3,13660.0,1,B
2018-04-02 09:12:57,13660.0,2,4328,2,13655.0,5,13665.0,4,B
2018-04-02 09:13:00,13660.0,2,4330,-2,13650.0,8,13665.0,8,B
2018-04-02 09:13:13,13660.0,2,4332,0,13650.0,4,13655.0,1,B
2018-04-02 09:13:17,13655.0,2,4334,-2,13645.0,7,13655.0,4,S
2018-04-02 09:13:18,13655.0,4,4338,2,13645.0,8,13655.0,2,S
2018-04-02 09:13:24,13650.0,2,4340,0,13650.0,9,13655.0,3,S
2018-04-02 09:13:27,13650.0,2,4342,-2,13650.0,8,13655.0,2,S
2018-04-02 09:13:30,13650.0,2,4344,0,13650.0,9,13655.0,2,S
2018-04-02 09:13:59,13650.0,2,4346,0,13650.0,1,13655.0,5,S
2018-04-02 09:14:00,13650.0,2,4348,-2,13645.0,6,13650.0,2,S
2018-04-02 09:14:04,13645.0,2,4350,-2,13645.0,5,13655.0,5,S
2018-04-02 09:14:05,13645.0,10,4360,-8,13640.0,9,13650.0,6,S
2018-04-02 09:14:08,13640.0,2,4362,2,13640.0,8,13650.0,3,S
2018-04-02 09:14:09,13640.0,4,4366,2,13640.0,6,13650.0,3,S
2018-04-02 09:14:16,13645.0,2,4368,0,13640.0,5,13650.0,2,B
2018-04-02 09:14:18,13640.0,4,4372,4,13640.0,3,13650.0,2,S
2018-04-02 09:14:38,13640.0,4,4376,4,13640.0,1,13645.0,5,S
2018-04-02 09:14:54,13640.0,2,4378,0,13635.0,3,13645.0,19,S
2018-04-02 09:15:21,13645.0,4,4382,0,13645.0,4,13650.0,9,B
2018-04-02 09:15:37,13650.0,12,4394,0,13650.0,4,13655.0,5,B
2018-04-02 09:16:09,13650.0,2,4396,0,13650.0,2,13655.0,3,B
2018-04-02 09:16:22,13650.0,2,4398,0,13650.0,1,13655.0,4,B
2018-04-02 09:16:45,13655.0,8,4406,0,13655.0,4,13660.0,5,B
2018-04-02 09:16:48,13660.0,2,4408,0,13655.0,4,13660.0,1,B
2018-04-02 09:16:49,13660.0,2,4410,-2,13655.0,4,13665.0,9,B
2018-04-02 09:16:52,13665.0,2,4412,0,13655.0,4,13665.0,7,B
2018-04-02 09:16:58,13655.0,4,4416,0,13655.0,2,13660.0,5,S
2018-04-02 09:16:59,13655.0,4,4420,-2,13650.0,5,13660.0,19,S
2018-04-02 09:17:07,13655.0,8,4428,4,13650.0,4,13660.0,6,S
2018-04-02 09:17:15,13655.0,2,4430,2,13650.0,6,13660.0,4,S
2018-04-02 09:17:23,13650.0,2,4432,0,13650.0,6,13655.0,1,S
2018-04-02 09:17:29,13650.0,2,4434,2,13645.0,3,13655.0,2,S
2018-04-02 09:17:29,13645.0,2,4436,2,13640.0,7,13655.0,3,S
2018-04-02 09:17:52,13650.0,2,4438,0,13650.0,3,13655.0,3,B
2018-04-02 09:18:05,13650.0,6,4444,0,13645.0,4,13650.0,2,B
2018-04-02 09:18:08,13650.0,2,4446,0,13645.0,3,13650.0,1,B
2018-04-02 09:18:10,13650.0,2,4448,0,13645.0,3,13655.0,3,B
2018-04-02 09:18:24,13645.0,2,4450,0,13645.0,1,13655.0,3,S
2018-04-02 09:18:31,13655.0,2,4452,0,13645.0,2,13655.0,2,B
2018-04-02 09:18:39,13655.0,2,4454,0,13650.0,4,13660.0,5,B
2018-04-02 09:18:50,13655.0,2,4456,0,13650.0,6,13660.0,3,B
2018-04-02 09:18:58,13655.0,2,4458,2,13655.0,3,13660.0,2,B
2018-04-02 09:19:02,13655.0,2,4460,-2,13655.0,2,13660.0,3,B
2018-04-02 09:20:13,13655.0,4,4464,0,13645.0,3,13655.0,2,B
2018-04-02 09:20:17,13655.0,2,4466,0,13645.0,2,13655.0,2,B
2018-04-02 09:20:48,13640.0,2,4468,2,13640.0,1,13645.0,7,S
2018-04-02 09:20:52,13640.0,2,4470,0,13635.0,8,13645.0,7,S
2018-04-02 09:21:31,13640.0,2,4472,0,13635.0,5,13640.0,1,S
2018-04-02 09:21:36,13635.0,2,4474,0,13635.0,4,13645.0,3,S
2018-04-02 09:21:39,13635.0,4,4478,0,13635.0,13,13645.0,3,S
2018-04-02 09:21:41,13635.0,2,4480,-2,13635.0,12,13645.0,3,S
2018-04-02 09:22:01,13640.0,4,4484,0,13635.0,13,13645.0,1,B
2018-04-02 09:22:03,13635.0,20,4504,18,13635.0,1,13645.0,3,S
2018-04-02 09:22:03,13635.0,2,4506,2,13630.0,9,13645.0,16,S
2018-04-02 09:22:16,13630.0,2,4508,2,13630.0,7,13635.0,1,S
2018-04-02 09:22:17,13630.0,14,4522,0,13625.0,4,13635.0,1,S
2018-04-02 09:22:19,13635.0,2,4524,0,13635.0,1,13640.0,2,B
2018-04-02 09:22:20,13635.0,6,4530,-4,13630.0,2,13640.0,447,B
2018-04-02 09:22:21,13630.0,2,4532,0,13630.0,2,13635.0,4,S
2018-04-02 09:22:22,13630.0,12,4544,4,13630.0,2,13635.0,3,S
2018-04-02 09:22:22,13630.0,4,4548,0,13625.0,2,13635.0,3,S
2018-04-02 09:22:25,13630.0,4,4552,-4,13625.0,4,13635.0,3,S
2018-04-02 09:22:30,13625.0,6,4558,2,13620.0,4,13630.0,1,S
2018-04-02 09:22:34,13630.0,2,4560,2,13620.0,3,13630.0,1,B
2018-04-02 09:22:45,13620.0,2,4562,0,13620.0,4,13630.0,7,S
2018-04-02 09:22:49,13630.0,2,4564,-2,13620.0,4,13630.0,7,B
2018-04-02 09:22:53,13625.0,2,4566,0,13620.0,6,13625.0,9,S
2018-04-02 09:22:59,13620.0,2,4568,-2,13620.0,4,13625.0,14,S
2018-04-02 09:23:00,13620.0,8,4576,-4,13615.0,2,13620.0,4,S
2018-04-02 09:23:00,13615.0,4,4580,-4,13615.0,1,13620.0,2,S
2018-04-02 09:23:01,13610.0,2,4582,0,13610.0,2,13620.0,1,S
2018-04-02 09:23:07,13610.0,8,4590,4,13610.0,1,13620.0,2,S
2018-04-02 09:23:12,13610.0,2,4592,-2,13605.0,1,13610.0,1,S
2018-04-02 09:23:12,13610.0,2,4594,0,13600.0,6,13615.0,4,S
2018-04-02 09:23:16,13600.0,6,4600,2,13600.0,3,13610.0,5,S
2018-04-02 09:23:17,13600.0,2,4602,0,13600.0,2,13610.0,5,S
2018-04-02 09:23:19,13605.0,2,4604,-2,13600.0,2,13610.0,5,B
2018-04-02 09:23:44,13605.0,12,4616,10,13600.0,5,13605.0,14,B
2018-04-02 09:23:45,13605.0,4,4620,2,13600.0,5,13605.0,12,B
2018-04-02 09:23:46,13605.0,24,4644,20,13600.0,4,13610.0,11,B
2018-04-02 09:23:47,13605.0,2,4646,2,13600.0,4,13610.0,11,B
2018-04-02 09:23:51,13610.0,2,4648,2,13600.0,4,13610.0,10,B
2018-04-02 09:24:02,13605.0,2,4650,0,13600.0,5,13610.0,10,S
2018-04-02 09:24:06,13605.0,2,4652,-2,13600.0,5,13610.0,14,S
2018-04-02 09:24:33,13600.0,2,4654,0,13600.0,6,13610.0,13,S
2018-04-02 09:24:39,13610.0,2,4656,0,13605.0,4,13610.0,6,B
2018-04-02 09:24:41,13610.0,12,4668,0,13605.0,4,13615.0,3,B
2018-04-02 09:24:42,13605.0,4,4672,0,13605.0,2,13615.0,2,S
2018-04-02 09:24:47,13610.0,2,4674,-2,13600.0,6,13615.0,4,B
2018-04-02 09:25:06,13605.0,8,4682,-4,13605.0,1,13610.0,6,S
2018-04-02 09:25:07,13605.0,2,4684,0,13600.0,6,13610.0,6,S
2018-04-02 09:25:12,13610.0,2,4686,0,13605.0,2,13610.0,10,B
2018-04-02 09:25:14,13610.0,2,4688,0,13605.0,2,13610.0,9,B
2018-04-02 09:25:14,13610.0,18,4706,16,13610.0,6,13615.0,2,B
2018-04-02 09:25:59,13615.0,2,4708,0,13610.0,2,13615.0,3,B
2018-04-02 09:26:08,13620.0,2,4710,-2,13610.0,3,13620.0,11,B
2018-04-02 09:26:14,13620.0,2,4712,-2,13610.0,3,13620.0,9,B
2018-04-02 09:26:15,13610.0,6,4718,4,13605.0,3,13610.0,7,S
2018-04-02 09:26:16,13610.0,14,4732,8,13610.0,1,13620.0,9,S
2018-04-02 09:26:35,13610.0,2,4734,0,13605.0,1,13610.0,2,S
2018-04-02 09:26:38,13605.0,6,4740,0,13600.0,25,13605.0,7,S
2018-04-02 09:26:39,13605.0,2,4742,2,13600.0,25,13605.0,6,S
2018-04-02 09:26:39,13605.0,2,4744,0,13600.0,25,13605.0,5,S
2018-04-02 09:26:41,13605.0,6,4750,4,13600.0,25,13605.0,2,S
2018-04-02 09:26:41,13605.0,4,4754,0,13600.0,25,13610.0,4,S
2018-04-02 09:26:45,13600.0,20,4774,10,13600.0,15,13610.0,4,S
2018-04-02 09:26:55,13600.0,30,4804,10,13595.0,4,13605.0,4,S
2018-04-02 09:26:57,13595.0,4,4808,2,13580.0,9,13595.0,8,S
2018-04-02 09:26:57,13595.0,10,4818,0,13590.0,12,13595.0,3,S
2018-04-02 09:26:58,13595.0,6,4824,6,13585.0,30,13600.0,1,S
2018-04-02 09:27:04,13600.0,18,4842,-6,13600.0,6,13605.0,3,B
2018-04-02 09:27:05,13600.0,12,4854,0,13590.0,1,13600.0,4,B
2018-04-02 09:27:05,13590.0,2,4856,0,13585.0,9,13590.0,9,S
2018-04-02 09:27:06,13590.0,18,4874,18,13585.0,9,13600.0,5,S
2018-04-02 09:27:06,13600.0,2,4876,0,13585.0,9,13600.0,4,B
2018-04-02 09:27:10,13600.0,2,4878,0,13585.0,9,13600.0,3,B
2018-04-02 09:27:14,13600.0,2,4880,0,13590.0,4,13600.0,2,B
2018-04-02 09:27:15,13600.0,2,4882,-2,13590.0,4,13600.0,1,B
2018-04-02 09:27:18,13600.0,2,4884,2,13590.0,5,13605.0,4,B
2018-04-02 09:27:19,13600.0,6,4890,2,13590.0,5,13600.0,1,B
2018-04-02 09:27:21,13590.0,12,4902,6,13590.0,1,13600.0,1,S
2018-04-02 09:27:26,13590.0,2,4904,-2,13585.0,4,13600.0,7,S
2018-04-02 09:27:34,13590.0,4,4908,0,13585.0,12,13590.0,3,S
2018-04-02 09:27:34,13590.0,6,4914,6,13590.0,2,13600.0,2,S
2018-04-02 09:27:50,13600.0,6,4920,-4,13590.0,4,13605.0,6,B
2018-04-02 09:27:52,13600.0,2,4922,-2,13590.0,4,13600.0,1,B
2018-04-02 09:27:56,13600.0,2,4924,0,13600.0,4,13605.0,3,B
2018-04-02 09:27:56,13600.0,2,4926,0,13600.0,3,13610.0,4,B
2018-04-02 09:28:01,13600.0,8,4934,-2,13595.0,3,13600.0,2,B
2018-04-02 09:28:08,13600.0,2,4936,2,13590.0,4,13600.0,1,B
2018-04-02 09:28:22,13595.0,2,4938,0,13590.0,4,13600.0,6,S
2018-04-02 09:28:28,13590.0,8,4946,4,13585.0,11,13590.0,1,S
2018-04-02 09:28:28,13590.0,2,4948,0,13590.0,1,13600.0,6,S
2018-04-02 09:28:37,13595.0,8,4956,-2,13595.0,1,13600.0,8,B
2018-04-02 09:28:37,13595.0,2,4958,0,13585.0,1,13595.0,6,B
2018-04-02 09:28:41,13590.0,2,4960,0,13585.0,1,13595.0,3,S
2018-04-02 09:28:54,13590.0,2,4962,0,13585.0,4,13595.0,4,S
2018-04-02 09:29:04,13590.0,2,4964,0,13585.0,1,13590.0,3,S
2018-04-02 09:29:06,13585.0,2,4966,-2,13580.0,10,13590.0,3,S
2018-04-02 09:29:16,13580.0,20,4986,20,13575.0,5,13590.0,3,S
2018-04-02 09:29:19,13585.0,4,4990,-4,13575.0,5,13590.0,3,B
2018-04-02 09:29:23,13580.0,12,5002,-10,13575.0,5,13580.0,2,S
2018-04-02 09:29:24,13580.0,4,5006,0,13580.0,1,13590.0,3,S
2018-04-02 09:29:24,13580.0,2,5008,2,13575.0,5,13590.0,3,S
2018-04-02 09:29:27,13585.0,2,5010,0,13580.0,5,13590.0,1,B
2018-04-02 09:29:36,13590.0,2,5012,2,13590.0,1,13595.0,3,B
2018-04-02 09:29:37,13595.0,2,5014,0,13585.0,1,13595.0,2,B
2018-04-02 09:29:40,13585.0,2,5016,0,13585.0,5,13595.0,1,S
2018-04-02 09:29:45,13585.0,2,5018,2,13585.0,9,13595.0,1,S
2018-04-02 09:30:01,13590.0,2,5020,2,13590.0,1,13600.0,6,B
2018-04-02 09:30:04,13600.0,4,5024,-2,13595.0,2,13605.0,3,B
2018-04-02 09:30:07,13605.0,2,5026,0,13600.0,19,13610.0,4,B
2018-04-02 09:30:11,13605.0,4,5030,-4,13600.0,9,13610.0,4,B
2018-04-02 09:30:22,13610.0,6,5036,2,13605.0,3,13615.0,3,B
2018-04-02 09:30:28,13610.0,2,5038,0,13610.0,1,13615.0,18,B
2018-04-02 09:30:28,13610.0,2,5040,0,13605.0,1,13610.0,2,B
2018-04-02 09:30:34,13610.0,2,5042,-2,13605.0,1,13610.0,3,B
2018-04-02 09:30:36,13605.0,2,5044,-2,13600.0,10,13610.0,4,S
2018-04-02 09:30:37,13605.0,2,5046,0,13595.0,8,13610.0,3,S
2018-04-02 09:30:41,13605.0,2,5048,0,13605.0,5,13610.0,3,S
2018-04-02 09:30:42,13605.0,10,5058,4,13595.0,1,13605.0,4,S
2018-04-02 09:30:46,13605.0,6,5064,2,13605.0,2,13610.0,8,S
2018-04-02 09:30:47,13610.0,12,5076,-8,13605.0,1,13610.0,3,B
2018-04-02 09:30:48,13605.0,2,5078,2,13600.0,1,13610.0,5,S
2018-04-02 09:30:52,13610.0,10,5088,-6,13600.0,4,13615.0,5,B
2018-04-02 09:31:02,13610.0,4,5092,-2,13605.0,4,13615.0,3,B
2018-04-02 09:31:19,13610.0,6,5098,6,13605.0,4,13610.0,2,B
2018-04-02 09:31:27,13600.0,10,5108,0,13600.0,4,13610.0,2,S
2018-04-02 09:31:29,13600.0,12,5120,-8,13595.0,2,13600.0,1,S
2018-04-02 09:31:30,13600.0,2,5122,-2,13600.0,7,13610.0,4,S
2018-04-02 09:31:35,13600.0,2,5124,2,13600.0,9,13610.0,3,S
2018-04-02 09:31:36,13610.0,2,5126,0,13605.0,1,13610.0,2,B
2018-04-02 09:31:37,13610.0,2,5128,0,13605.0,1,13610.0,3,B
2018-04-02 09:31:38,13605.0,2,5130,-2,13600.0,7,13605.0,1,S
2018-04-02 09:31:43,13610.0,10,5140,-6,13595.0,13,13610.0,1,B
2018-04-02 09:31:46,13610.0,6,5146,0,13610.0,2,13615.0,18,B
2018-04-02 09:31:46,13600.0,10,5156,-8,13595.0,16,13600.0,3,S
2018-04-02 09:31:47,13600.0,6,5162,0,13600.0,9,13610.0,3,S
2018-04-02 09:31:49,13600.0,2,5164,-2,13600.0,1,13610.0,4,S
2018-04-02 09:32:03,13600.0,2,5166,2,13595.0,9,13605.0,4,S
2018-04-02 09:32:04,13605.0,2,5168,-2,13600.0,3,13605.0,3,B
2018-04-02 09:32:16,13610.0,2,5170,-2,13600.0,4,13610.0,3,B
2018-04-02 09:32:19,13610.0,4,5174,0,13600.0,4,13610.0,1,B
2018-04-02 09:32:30,13610.0,2,5176,0,13595.0,7,13605.0,7,B
2018-04-02 09:32:31,13605.0,2,5178,2,13595.0,7,13605.0,7,S
2018-04-02 09:32:47,13595.0,2,5180,0,13595.0,5,13600.0,3,S
2018-04-02 09:32:53,13595.0,12,5192,-2,13590.0,1,13595.0,1,S
2018-04-02 09:32:53,13595.0,2,5194,-2,13595.0,1,13605.0,5,S
2018-04-02 09:33:06,13595.0,6,5200,4,13595.0,2,13600.0,1,S
2018-04-02 09:33:07,13595.0,4,5204,-4,13595.0,1,13600.0,2,S
2018-04-02 09:33:11,13595.0,2,5206,-2,13590.0,4,13600.0,5,S
2018-04-02 09:33:12,13590.0,4,5210,0,13585.0,5,13595.0,4,S
2018-04-02 09:33:13,13585.0,2,5212,-2,13585.0,2,13590.0,2,S
2018-04-02 09:33:19,13585.0,2,5214,2,13580.0,10,13590.0,3,S
2018-04-02 09:33:24,13590.0,2,5216,0,13580.0,9,13590.0,4,B
2018-04-02 09:33:41,13585.0,4,5220,-4,13585.0,2,13595.0,4,S
2018-04-02 09:33:57,13595.0,2,5222,-2,13595.0,1,13600.0,7,B
2018-04-02 09:34:10,13595.0,2,5224,2,13590.0,5,13600.0,3,B
2018-04-02 09:34:26,13600.0,2,5226,2,13590.0,5,13600.0,8,B
2018-04-02 09:34:34,13600.0,2,5228,2,13590.0,5,13600.0,7,B
2018-04-02 09:34:45,13595.0,2,5230,-2,13590.0,6,13595.0,1,S
2018-04-02 09:34:51,13600.0,4,5234,2,13595.0,2,13605.0,2,B
2018-04-02 09:35:09,13600.0,2,5236,0,13600.0,4,13605.0,2,B
2018-04-02 09:35:16,13600.0,2,5238,2,13600.0,3,13605.0,2,B
2018-04-02 09:35:35,13600.0,4,5242,4,13600.0,1,13605.0,2,B
2018-04-02 09:35:40,13600.0,2,5244,2,13595.0,1,13605.0,2,B
2018-04-02 09:36:05,13600.0,2,5246,0,13595.0,2,13600.0,4,B
2018-04-02 09:36:08,13600.0,2,5248,0,13595.0,2,13600.0,3,B
2018-04-02 09:36:51,13595.0,4,5252,2,13585.0,17,13595.0,3,S
2018-04-02 09:38:06,13600.0,2,5254,0,13595.0,5,13600.0,7,B
2018-04-02 09:38:24,13595.0,4,5258,-2,13590.0,10,13600.0,10,S
2018-04-02 09:39:03,13595.0,2,5260,2,13590.0,11,13595.0,2,S
2018-04-02 09:39:03,13595.0,2,5262,2,13590.0,12,13595.0,1,S
2018-04-02 09:39:04,13595.0,2,5264,2,13595.0,1,13600.0,8,S
2018-04-02 09:39:10,13600.0,2,5266,-2,13595.0,1,13600.0,6,B
2018-04-02 09:39:32,13595.0,6,5272,-2,13595.0,6,13600.0,22,S
2018-04-02 09:39:34,13600.0,2,5274,0,13595.0,6,13600.0,10,B
2018-04-02 09:39:50,13595.0,2,5276,-2,13595.0,5,13600.0,15,S
2018-04-02 09:39:50,13595.0,4,5280,-4,13595.0,3,13600.0,15,S
2018-04-02 09:39:51,13595.0,6,5286,-2,13590.0,4,13595.0,2,S
2018-04-02 09:39:58,13595.0,2,5288,0,13590.0,3,13600.0,16,S
2018-04-02 09:40:07,13595.0,2,5290,-2,13590.0,5,13600.0,15,S
2018-04-02 09:40:11,13600.0,22,5312,18,13595.0,2,13605.0,3,B
2018-04-02 09:40:25,13600.0,4,5316,4,13600.0,3,13605.0,3,B
2018-04-02 09:40:26,13600.0,2,5318,2,13600.0,2,13605.0,3,B
2018-04-02 09:40:51,13605.0,4,5322,4,13605.0,3,13610.0,3,B
2018-04-02 09:40:57,13610.0,6,5328,4,13610.0,7,13615.0,18,B
2018-04-02 09:40:58,13610.0,8,5336,6,13610.0,4,13615.0,18,B
2018-04-02 09:41:03,13610.0,6,5342,0,13610.0,1,13615.0,3,B
2018-04-02 09:41:04,13610.0,2,5344,0,13605.0,5,13615.0,5,B
2018-04-02 09:41:54,13615.0,2,5346,0,13610.0,2,13615.0,2,B
2018-04-02 09:42:04,13615.0,2,5348,-2,13610.0,1,13615.0,3,B
2018-04-02 09:42:06,13615.0,2,5350,0,13610.0,1,13615.0,2,B
2018-04-02 09:42:22,13615.0,2,5352,2,13610.0,4,13615.0,1,B
2018-04-02 09:42:48,13615.0,2,5354,0,13610.0,4,13620.0,20,B
2018-04-02 09:42:58,13615.0,2,5356,-2,13610.0,6,13620.0,8,B
2018-04-02 09:43:29,13615.0,2,5358,0,13610.0,5,13615.0,1,B
2018-04-02 09:43:49,13615.0,6,5364,0,13610.0,5,13620.0,11,B
2018-04-02 09:44:04,13620.0,2,5366,-2,13610.0,6,13620.0,7,B
2018-04-02 09:44:35,13615.0,4,5370,4,13610.0,4,13615.0,2,S
2018-04-02 09:44:54,13610.0,4,5374,4,13610.0,2,13615.0,3,S
2018-04-02 09:44:57,13610.0,4,5378,4,13610.0,1,13615.0,3,S
2018-04-02 09:45:00,13615.0,2,5380,0,13615.0,1,13620.0,7,B
2018-04-02 09:45:09,13615.0,2,5382,2,13610.0,6,13620.0,7,B
2018-04-02 09:45:22,13620.0,10,5392,0,13615.0,2,13620.0,1,B
2018-04-02 09:45:25,13620.0,2,5394,0,13615.0,4,13620.0,342,B
2018-04-02 09:45:25,13615.0,8,5402,-8,13615.0,1,13620.0,342,S
2018-04-02 09:45:26,13615.0,2,5404,0,13615.0,2,13620.0,342,S
2018-04-02 09:45:26,13615.0,4,5408,0,13610.0,5,13620.0,342,S
2018-04-02 09:45:32,13615.0,2,5410,0,13610.0,3,13620.0,343,S
2018-04-02 09:45:39,13615.0,2,5412,2,13615.0,2,13620.0,343,S
2018-04-02 09:45:39,13615.0,4,5416,0,13610.0,6,13620.0,343,S
2018-04-02 09:46:09,13620.0,2,5418,0,13615.0,1,13620.0,3,B
2018-04-02 09:46:15,13615.0,2,5420,2,13610.0,6,13615.0,17,S
2018-04-02 09:46:16,13615.0,2,5422,0,13610.0,6,13615.0,16,S
2018-04-02 09:46:27,13615.0,2,5424,0,13610.0,3,13615.0,15,S
2018-04-02 09:46:34,13615.0,4,5428,0,13610.0,3,13615.0,13,S
2018-04-02 09:46:44,13610.0,2,5430,0,13610.0,1,13615.0,13,S
2018-04-02 09:46:56,13610.0,2,5432,0,13605.0,2,13615.0,13,S
2018-04-02 09:48:49,13610.0,10,5442,8,13605.0,7,13610.0,337,S
2018-04-02 09:48:49,13610.0,16,5458,-4,13600.0,29,13610.0,336,S
2018-04-02 09:48:50,13605.0,4,5462,4,13600.0,34,13610.0,336,S
2018-04-02 09:48:53,13605.0,10,5472,0,13600.0,34,13610.0,336,S
2018-04-02 09:48:56,13605.0,10,5482,-10,13600.0,10,13610.0,337,S
2018-04-02 09:48:57,13600.0,20,5502,10,13595.0,36,13600.0,3,S
2018-04-02 09:48:57,13600.0,6,5508,6,13605.0,2,13610.0,337,S
2018-04-02 09:48:58,13605.0,4,5512,4,13600.0,6,13610.0,337,B
2018-04-02 09:49:02,13605.0,2,5514,-2,13600.0,5,13610.0,339,B
2018-04-02 09:49:06,13605.0,2,5516,0,13600.0,6,13610.0,339,B
2018-04-02 09:49:26,13605.0,14,5530,14,13605.0,3,13610.0,341,B
2018-04-02 09:49:27,13605.0,6,5536,2,13600.0,8,13605.0,3,B
2018-04-02 09:49:28,13605.0,2,5538,2,13600.0,8,13605.0,2,B
2018-04-02 09:49:33,13600.0,4,5542,0,13600.0,7,13605.0,8,S
2018-04-02 09:49:33,13600.0,10,5552,-2,13600.0,2,13605.0,8,S
2018-04-02 09:49:34,13600.0,4,5556,4,13590.0,1,13605.0,10,S
2018-04-02 09:49:59,13600.0,10,5566,2,13590.0,3,13600.0,1,S
2018-04-02 09:50:25,13600.0,2,5568,0,13595.0,7,13600.0,1,S
2018-04-02 09:51:01,13605.0,10,5578,4,13595.0,9,13605.0,2,B
2018-04-02 09:51:08,13600.0,2,5580,0,13595.0,8,13605.0,17,S
2018-04-02 09:51:33,13605.0,2,5582,2,13605.0,9,13610.0,351,B
2018-04-02 09:51:33,13605.0,18,5600,18,13595.0,7,13605.0,3,B
2018-04-02 09:51:47,13605.0,2,5602,2,13600.0,11,13610.0,337,B
2018-04-02 09:51:56,13610.0,2,5604,0,13600.0,9,13610.0,335,B
2018-04-02 09:52:04,13610.0,2,5606,0,13600.0,11,13610.0,334,B
2018-04-02 09:52:09,13610.0,2,5608,0,13600.0,8,13610.0,333,B
2018-04-02 09:52:16,13610.0,2,5610,2,13605.0,5,13610.0,332,B
2018-04-02 09:52:19,13605.0,10,5620,6,13605.0,2,13610.0,332,S
2018-04-02 09:52:23,13605.0,2,5622,2,13605.0,1,13610.0,332,S
2018-04-02 09:52:25,13605.0,2,5624,0,13600.0,7,13610.0,332,S
2018-04-02 09:52:27,13610.0,4,5628,0,13600.0,5,13610.0,330,B
2018-04-02 09:52:29,13610.0,8,5636,4,13605.0,2,13610.0,326,B
2018-04-02 09:52:30,13610.0,10,5646,10,13605.0,3,13610.0,321,B
2018-04-02 09:52:30,13610.0,16,5662,0,13605.0,1,13610.0,313,B
2018-04-02 09:52:31,13610.0,4,5666,0,13605.0,1,13610.0,311,B
2018-04-02 09:52:57,13605.0,2,5668,0,13605.0,1,13610.0,312,S
2018-04-02 09:52:57,13605.0,2,5670,-2,13600.0,3,13610.0,313,S
2018-04-02 09:53:00,13605.0,2,5672,0,13605.0,1,13610.0,313,S
2018-04-02 09:53:00,13605.0,2,5674,0,13600.0,4,13610.0,313,S
2018-04-02 09:53:59,13605.0,2,5676,-2,13600.0,3,13605.0,1,S
2018-04-02 09:54:04,13600.0,2,5678,2,13600.0,2,13605.0,5,S
2018-04-02 09:54:05,13600.0,4,5682,-2,13595.0,4,13605.0,6,S
2018-04-02 09:54:14,13605.0,2,5684,0,13600.0,7,13610.0,315,B
2018-04-02 09:54:23,13600.0,2,5686,0,13595.0,3,13605.0,5,S
2018-04-02 09:54:38,13605.0,10,5696,6,13595.0,2,13605.0,2,B
2018-04-02 09:54:41,13600.0,2,5698,0,13595.0,7,13600.0,1,S
2018-04-02 09:54:44,13600.0,2,5700,0,13595.0,5,13605.0,3,S
2018-04-02 09:54:53,13605.0,2,5702,2,13605.0,3,13610.0,314,B
2018-04-02 09:55:00,13610.0,20,5722,20,13600.0,4,13610.0,305,B
2018-04-02 09:55:08,13610.0,4,5726,4,13600.0,3,13610.0,304,B
2018-04-02 09:55:25,13605.0,4,5730,0,13600.0,2,13610.0,304,S
2018-04-02 09:55:26,13610.0,2,5732,2,13600.0,2,13610.0,301,B
2018-04-02 09:55:40,13610.0,10,5742,10,13600.0,4,13610.0,296,B
2018-04-02 09:55:43,13610.0,4,5746,0,13600.0,4,13610.0,294,B
2018-04-02 09:56:57,13610.0,4,5750,0,13605.0,1,13610.0,290,B
2018-04-02 09:57:16,13610.0,8,5758,0,13605.0,2,13610.0,285,B
2018-04-02 09:57:23,13605.0,2,5760,0,13600.0,8,13610.0,287,S
2018-04-02 09:57:37,13605.0,2,5762,0,13600.0,8,13610.0,287,S
2018-04-02 09:58:50,13605.0,2,5764,0,13605.0,2,13610.0,288,S
2018-04-02 09:59:03,13605.0,2,5766,0,13605.0,1,13610.0,289,S
2018-04-02 09:59:03,13605.0,2,5768,0,13600.0,5,13605.0,4,S
2018-04-02 09:59:04,13605.0,8,5776,-8,13605.0,1,13610.0,288,S
2018-04-02 10:00:07,13610.0,40,5816,0,13605.0,1,13610.0,270,B
2018-04-02 10:00:11,13610.0,20,5836,20,13605.0,1,13610.0,260,B
2018-04-02 10:00:15,13610.0,2,5838,0,13600.0,8,13610.0,259,B
2018-04-02 10:00:16,13610.0,2,5840,2,13600.0,8,13610.0,258,B
2018-04-02 10:01:19,13610.0,2,5842,0,13605.0,1,13610.0,258,B
2018-04-02 10:01:29,13605.0,2,5844,2,13600.0,10,13605.0,1,S
2018-04-02 10:01:29,13605.0,2,5846,-2,13605.0,1,13610.0,269,S
2018-04-02 10:01:30,13605.0,2,5848,0,13600.0,8,13610.0,256,S
2018-04-02 10:01:57,13605.0,4,5852,2,13600.0,7,13605.0,2,S
2018-04-02 10:03:25,13605.0,2,5854,2,13600.0,6,13605.0,1,S
2018-04-02 10:03:46,13605.0,2,5856,2,13600.0,6,13610.0,256,S
2018-04-02 10:03:57,13605.0,2,5858,0,13600.0,6,13605.0,1,S
2018-04-02 10:05:13,13600.0,4,5862,-4,13600.0,3,13605.0,7,S
2018-04-02 10:05:14,13600.0,4,5866,-4,13600.0,1,13605.0,7,S
2018-04-02 10:05:20,13600.0,2,5868,2,13595.0,3,13605.0,7,S
2018-04-02 10:05:29,13595.0,2,5870,0,13590.0,6,13600.0,5,S
2018-04-02 10:07:23,13590.0,4,5874,-2,13590.0,2,13595.0,2,S
2018-04-02 10:07:37,13595.0,4,5878,-4,13590.0,2,13600.0,12,B
2018-04-02 10:07:47,13590.0,2,5880,2,13590.0,1,13600.0,22,S
2018-04-02 10:07:58,13590.0,6,5886,0,13590.0,1,13595.0,18,S
2018-04-02 10:07:59,13590.0,2,5888,0,13585.0,2,13595.0,20,S
2018-04-02 10:08:01,13590.0,2,5890,0,13585.0,16,13595.0,6,S
2018-04-02 10:08:06,13590.0,2,5892,-2,13585.0,2,13590.0,1,S
2018-04-02 10:08:07,13590.0,2,5894,0,13585.0,3,13595.0,5,S
2018-04-02 10:08:21,13590.0,2,5896,0,13580.0,9,13590.0,6,S
2018-04-02 10:08:25,13590.0,2,5898,0,13580.0,9,13590.0,15,S
2018-04-02 10:08:27,13590.0,2,5900,0,13580.0,9,13590.0,14,S
2018-04-02 10:08:28,13590.0,2,5902,0,13580.0,9,13590.0,13,S
2018-04-02 10:08:29,13590.0,2,5904,-2,13580.0,9,13590.0,13,S
2018-04-02 10:08:30,13590.0,20,5924,16,13580.0,9,13590.0,3,S
2018-04-02 10:08:36,13590.0,2,5926,2,13580.0,9,13590.0,2,S
2018-04-02 10:08:57,13590.0,8,5934,-4,13585.0,4,13595.0,4,S
2018-04-02 10:09:05,13595.0,2,5936,-2,13595.0,1,13600.0,9,B
2018-04-02 10:09:16,13600.0,2,5938,0,13590.0,5,13600.0,5,B
2018-04-02 10:09:52,13600.0,2,5940,0,13595.0,4,13600.0,4,B
2018-04-02 10:10:03,13600.0,2,5942,0,13595.0,4,13600.0,4,B
2018-04-02 10:10:14,13600.0,2,5944,0,13595.0,6,13600.0,3,B
2018-04-02 10:10:15,13600.0,6,5950,6,13595.0,9,13605.0,4,B
2018-04-02 10:10:42,13595.0,6,5956,-6,13595.0,6,13605.0,4,S
2018-04-02 10:11:20,13600.0,2,5958,0,13595.0,3,13605.0,4,B
2018-04-02 10:12:51,13595.0,2,5960,0,13590.0,5,13600.0,3,S
2018-04-02 10:14:01,13600.0,2,5962,0,13590.0,6,13600.0,1,B
2018-04-02 10:14:29,13595.0,2,5964,-2,13595.0,1,13600.0,352,S
2018-04-02 10:14:33,13600.0,12,5976,4,13595.0,2,13600.0,346,B
2018-04-02 10:14:33,13600.0,2,5978,0,13595.0,16,13600.0,345,B
2018-04-02 10:14:41,13600.0,2,5980,0,13595.0,5,13600.0,344,B
2018-04-02 10:14:42,13595.0,8,5988,2,13595.0,1,13600.0,344,S
2018-04-02 10:30:01,13595.0,2,5990,2,13590.0,4,13595.0,1,S
2018-04-02 10:30:01,13590.0,8,5998,2,13590.0,4,13600.0,346,S
2018-04-02 10:30:02,13595.0,6,6004,0,13585.0,1,13595.0,2,B
2018-04-02 10:30:02,13595.0,2,6006,2,13585.0,2,13600.0,346,B
2018-04-02 10:30:03,13600.0,2,6008,2,13585.0,3,13600.0,345,B
2018-04-02 10:30:04,13600.0,2,6010,2,13585.0,2,13595.0,3,B
2018-04-02 10:30:05,13600.0,4,6014,4,13585.0,1,13595.0,1,B
2018-04-02 10:30:05,13600.0,4,6018,4,13585.0,3,13600.0,346,B
2018-04-02 10:30:06,13600.0,2,6020,2,13585.0,4,13600.0,343,B
2018-04-02 10:30:07,13590.0,2,6022,0,13585.0,2,13590.0,4,S
2018-04-02 10:30:07,13590.0,2,6024,2,13585.0,2,13590.0,3,S
2018-04-02 10:30:08,13590.0,4,6028,4,13585.0,4,13590.0,1,S
2018-04-02 10:30:08,13595.0,4,6032,2,13585.0,4,13600.0,343,B
2018-04-02 10:30:09,13585.0,4,6036,-4,13595.0,1,13600.0,347,S
2018-04-02 10:30:09,13595.0,2,6038,2,13590.0,1,13595.0,10,B
2018-04-02 10:30:10,13600.0,2,6040,2,13590.0,1,13600.0,372,B
2018-04-02 10:30:10,13600.0,2,6042,0,13590.0,1,13595.0,1,B
2018-04-02 10:30:11,13600.0,2,6044,2,13590.0,1,13600.0,372,B
2018-04-02 10:30:11,13600.0,2,6046,2,13590.0,1,13595.0,1,B
2018-04-02 10:30:12,13600.0,2,6048,2,13590.0,1,13600.0,343,B
2018-04-02 10:30:12,13600.0,2,6050,2,13590.0,1,13600.0,357,B
2018-04-02 10:30:13,13600.0,4,6054,4,13590.0,2,13600.0,341,B
2018-04-02 10:30:14,13600.0,4,6058,4,13590.0,2,13600.0,339,B
2018-04-02 10:30:14,13600.0,4,6062,4,13590.0,5,13600.0,337,B
2018-04-02 10:30:15,13600.0,4,6066,4,13590.0,6,13600.0,335,B
2018-04-02 10:30:15,13600.0,4,6070,4,13590.0,6,13600.0,333,B
2018-04-02 10:30:16,13600.0,4,6074,4,13590.0,6,13600.0,331,B
2018-04-02 10:30:16,13600.0,4,6078,4,13590.0,6,13600.0,329,B
2018-04-02 10:30:17,13600.0,2,6080,2,13590.0,6,13600.0,328,B
2018-04-02 10:30:32,13600.0,20,6100,20,13590.0,6,13600.0,318,B
2018-04-02 10:30:39,13595.0,2,6102,0,13590.0,5,13600.0,316,S
2018-04-02 10:30:46,13595.0,2,6104,0,13590.0,7,13600.0,316,S
2018-04-02 10:31:29,13595.0,2,6106,-2,13595.0,1,13600.0,316,S
2018-04-02 10:31:48,13600.0,16,6122,10,13590.0,22,13600.0,312,B
2018-04-02 10:32:05,13600.0,22,6144,20,13590.0,9,13600.0,303,B
2018-04-02 10:32:13,13590.0,10,6154,6,13590.0,2,13600.0,316,S
2018-04-02 10:32:32,13590.0,2,6156,2,13590.0,2,13600.0,305,S
2018-04-02 10:32:50,13600.0,20,6176,20,13590.0,5,13600.0,296,B
2018-04-02 10:33:12,13590.0,10,6186,-2,13585.0,1,13600.0,297,S
2018-04-02 10:33:40,13595.0,10,6196,10,13590.0,3,13600.0,294,B
2018-04-02 10:33:50,13595.0,2,6198,2,13590.0,1,13600.0,294,B
2018-04-02 10:34:03,13595.0,2,6200,2,13590.0,3,13600.0,294,B
2018-04-02 10:34:12,13600.0,2,6202,2,13595.0,8,13600.0,292,B
2018-04-02 10:34:14,13600.0,14,6216,14,13595.0,5,13600.0,285,B
2018-04-02 10:34:15,13600.0,6,6222,6,13595.0,4,13600.0,282,B
2018-04-02 10:34:18,13595.0,2,6224,0,13595.0,3,13600.0,282,S
2018-04-02 10:34:38,13590.0,2,6226,0,13590.0,11,13600.0,285,S
2018-04-02 10:34:43,13595.0,2,6228,2,13595.0,3,13600.0,285,B
2018-04-02 10:34:57,13600.0,40,6268,40,13590.0,12,13600.0,266,B
2018-04-02 10:35:03,13600.0,2,6270,2,13595.0,5,13600.0,263,B
2018-04-02 10:35:17,13600.0,2,6272,0,13595.0,11,13600.0,261,B
2018-04-02 10:35:20,13600.0,6,6278,4,13595.0,10,13600.0,259,B
2018-04-02 10:35:23,13595.0,8,6286,0,13595.0,6,13600.0,259,S
2018-04-02 10:35:23,13600.0,20,6306,20,13595.0,1,13600.0,249,B
2018-04-02 10:35:26,13595.0,2,6308,2,13590.0,4,13600.0,249,S
2018-04-02 10:35:29,13595.0,2,6310,0,13590.0,2,13600.0,262,S
2018-04-02 10:35:57,13595.0,4,6314,-2,13595.0,5,13600.0,249,S
2018-04-02 10:36:42,13595.0,2,6316,-2,13590.0,6,13600.0,268,S
2018-04-02 10:37:25,13595.0,2,6318,2,13590.0,7,13600.0,268,S
2018-04-02 10:37:29,13595.0,2,6320,0,13590.0,6,13600.0,268,S
2018-04-02 10:37:44,13600.0,20,6340,20,13590.0,21,13600.0,258,B
2018-04-02 10:38:08,13600.0,20,6360,20,13595.0,6,13600.0,247,B
2018-04-02 10:38:32,13600.0,2,6362,2,13595.0,6,13600.0,246,B
2018-04-02 10:38:32,13600.0,2,6364,2,13595.0,6,13600.0,245,B
2018-04-02 10:38:53,13595.0,2,6366,2,13595.0,6,13600.0,245,S
2018-04-02 10:39:02,13600.0,10,6376,10,13595.0,6,13600.0,240,B
2018-04-02 10:39:02,13600.0,8,6384,4,13595.0,6,13600.0,236,B
2018-04-02 10:39:59,13600.0,2,6386,0,13595.0,17,13600.0,235,B
2018-04-02 10:40:08,13600.0,2,6388,2,13595.0,17,13600.0,234,B
2018-04-02 10:40:31,13595.0,8,6396,-4,13595.0,5,13600.0,246,S
2018-04-02 10:40:33,13600.0,2,6398,2,13595.0,6,13600.0,233,B
2018-04-02 10:41:09,13595.0,10,6408,6,13595.0,1,13600.0,243,S
2018-04-02 10:42:02,13595.0,2,6410,2,13595.0,4,13600.0,243,S
2018-04-02 10:42:02,13595.0,4,6414,2,13595.0,2,13600.0,243,S
2018-04-02 10:42:04,13600.0,2,6416,0,13595.0,2,13600.0,242,B
2018-04-02 10:43:39,13595.0,2,6418,0,13595.0,3,13600.0,242,S
2018-04-02 10:44:49,13600.0,2,6420,2,13595.0,4,13600.0,242,B
2018-04-02 10:45:54,13595.0,6,6426,2,13595.0,5,13600.0,243,S
2018-04-02 10:46:02,13595.0,6,6432,-2,13595.0,2,13600.0,243,S
2018-04-02 10:46:03,13595.0,4,6436,4,13590.0,5,13600.0,243,S
2018-04-02 10:46:23,13595.0,2,6438,0,13595.0,2,13600.0,244,S
2018-04-02 10:47:17,13600.0,16,6454,8,13595.0,12,13600.0,234,B
2018-04-02 10:47:35,13600.0,16,6470,2,13595.0,16,13600.0,226,B
2018-04-02 10:47:35,13600.0,4,6474,4,13595.0,15,13600.0,224,B
2018-04-02 10:47:40,13595.0,2,6476,-2,13595.0,12,13600.0,224,S
2018-04-02 10:47:40,13600.0,4,6480,4,13595.0,12,13600.0,222,B
2018-04-02 10:47:43,13600.0,4,6484,4,13595.0,12,13600.0,220,B
2018-04-02 10:48:09,13600.0,14,6498,0,13595.0,15,13600.0,213,B
2018-04-02 10:48:23,13600.0,2,6500,2,13595.0,13,13600.0,212,B
2018-04-02 10:48:30,13600.0,20,6520,20,13595.0,15,13600.0,202,B
2018-04-02 10:48:43,13595.0,20,6540,8,13590.0,7,13595.0,2,S
2018-04-02 10:48:45,13595.0,2,6542,-2,13590.0,4,13595.0,1,S
2018-04-02 10:48:56,13595.0,2,6544,0,13595.0,9,13600.0,203,S
2018-04-02 10:49:03,13595.0,4,6548,0,13595.0,7,13600.0,215,S
2018-04-02 10:49:16,13600.0,14,6562,14,13590.0,8,13600.0,196,B
2018-04-02 10:49:30,13595.0,2,6564,0,13590.0,7,13595.0,1,S
2018-04-02 10:49:31,13595.0,2,6566,0,13595.0,5,13600.0,197,S
2018-04-02 10:49:58,13600.0,20,6586,20,13595.0,7,13600.0,185,B
2018-04-02 10:50:03,13595.0,2,6588,-2,13595.0,4,13600.0,186,S
2018-04-02 10:50:08,13600.0,2,6590,0,13595.0,2,13600.0,185,B
2018-04-02 10:50:10,13600.0,40,6630,40,13595.0,2,13600.0,164,B
2018-04-02 10:50:30,13600.0,2,6632,0,13595.0,1,13600.0,164,B
2018-04-02 10:51:24,13595.0,4,6636,2,13590.0,9,13595.0,3,S
2018-04-02 10:51:36,13595.0,2,6638,-2,13595.0,1,13600.0,165,S
2018-04-02 10:52:25,13600.0,20,6658,20,13590.0,6,13600.0,155,B
2018-04-02 10:52:46,13600.0,40,6698,40,13595.0,1,13600.0,135,B
2018-04-02 10:53:07,13595.0,2,6700,0,13590.0,6,13595.0,1,S
2018-04-02 10:53:07,13595.0,4,6704,-4,13595.0,1,13600.0,135,S
2018-04-02 10:53:08,13595.0,2,6706,-2,13590.0,6,13595.0,1,S
2018-04-02 10:53:19,13595.0,2,6708,0,13595.0,1,13600.0,135,S
2018-04-02 10:53:23,13595.0,2,6710,0,13590.0,6,13595.0,2,S
2018-04-02 10:54:34,13595.0,2,6712,0,13590.0,7,13595.0,1,S
2018-04-02 10:54:42,13595.0,2,6714,2,13595.0,9,13600.0,135,S
2018-04-02 10:55:04,13595.0,2,6716,2,13595.0,9,13600.0,133,S
2018-04-02 10:55:06,13600.0,8,6724,0,13595.0,14,13600.0,128,B
2018-04-02 10:55:19,13600.0,2,6726,0,13595.0,11,13600.0,127,B
2018-04-02 10:55:31,13600.0,16,6742,16,13595.0,1,13600.0,119,B
2018-04-02 10:55:51,13600.0,20,6762,20,13595.0,1,13600.0,109,B
2018-04-02 10:57:32,13600.0,4,6766,4,13595.0,1,13600.0,109,B
2018-04-02 10:57:32,13600.0,92,6858,46,13595.0,1,13600.0,63,B
2018-04-02 10:58:03,13600.0,12,6870,0,13595.0,11,13600.0,56,B
2018-04-02 10:58:03,13600.0,14,6884,8,13595.0,11,13600.0,49,B
2018-04-02 10:58:04,13600.0,2,6886,2,13595.0,11,13600.0,48,B
2018-04-02 10:58:10,13600.0,26,6912,0,13595.0,24,13600.0,35,B
2018-04-02 10:58:10,13600.0,18,6930,8,13595.0,26,13600.0,26,B
2018-04-02 10:58:11,13600.0,24,6954,12,13595.0,13,13600.0,14,B
2018-04-02 10:58:11,13600.0,22,6976,2,13595.0,12,13600.0,3,B
2018-04-02 10:58:12,13600.0,6,6982,6,13600.0,1,13605.0,4,B
2018-04-02 10:58:16,13600.0,2,6984,0,13595.0,10,13605.0,5,B
2018-04-02 10:58:20,13600.0,2,6986,0,13600.0,2,13605.0,4,B
2018-04-02 10:58:37,13605.0,2,6988,0,13600.0,3,13605.0,1,B
2018-04-02 10:58:48,13605.0,2,6990,0,13600.0,2,13610.0,14,B
2018-04-02 10:58:58,13605.0,2,6992,-2,13600.0,2,13610.0,13,B
2018-04-02 10:59:04,13610.0,2,6994,0,13600.0,2,13610.0,12,B
2018-04-02 10:59:10,13610.0,2,6996,2,13600.0,3,13610.0,12,B
2018-04-02 10:59:18,13610.0,2,6998,2,13605.0,1,13610.0,8,B
2018-04-02 10:59:20,13610.0,4,7002,2,13605.0,3,13610.0,6,B
2018-04-02 10:59:22,13605.0,10,7012,10,13605.0,2,13610.0,2,S
2018-04-02 10:59:24,13615.0,8,7020,2,13610.0,28,13620.0,5,B
2018-04-02 10:59:24,13620.0,4,7024,0,13615.0,4,13620.0,3,B
2018-04-02 10:59:25,13620.0,6,7030,-4,13615.0,19,13625.0,1,B
2018-04-02 10:59:28,13625.0,8,7038,-6,13615.0,1,13625.0,1,B
2018-04-02 10:59:36,13625.0,2,7040,0,13620.0,1,13625.0,2,B
2018-04-02 10:59:38,13625.0,2,7042,-2,13620.0,1,13630.0,18,B
2018-04-02 10:59:39,13625.0,2,7044,0,13620.0,1,13625.0,11,B
2018-04-02 10:59:43,13625.0,4,7048,0,13620.0,5,13630.0,19,B
2018-04-02 10:59:48,13630.0,2,7050,0,13620.0,2,13630.0,20,B
2018-04-02 10:59:52,13620.0,2,7052,2,13620.0,2,13625.0,1,S
2018-04-02 11:00:18,13625.0,2,7054,0,13620.0,4,13625.0,2,B
2018-04-02 11:00:18,13625.0,4,7058,4,13620.0,5,13630.0,20,B
2018-04-02 11:00:30,13625.0,2,7060,2,13620.0,13,13630.0,19,B
2018-04-02 11:00:32,13630.0,20,7080,0,13620.0,13,13630.0,9,B
2018-04-02 11:00:35,13630.0,10,7090,0,13625.0,5,13630.0,4,B
2018-04-02 11:00:36,13630.0,2,7092,2,13625.0,1,13630.0,3,B
2018-04-02 11:00:45,13630.0,2,7094,2,13625.0,6,13630.0,3,B
2018-04-02 11:00:48,13630.0,6,7100,2,13630.0,2,13635.0,3,B
2018-04-02 11:00:50,13635.0,4,7104,2,13630.0,14,13640.0,1,B
2018-04-02 11:00:51,13635.0,2,7106,-2,13635.0,2,13645.0,2,B
2018-04-02 11:00:52,13635.0,4,7110,0,13635.0,5,13645.0,8,B
2018-04-02 11:00:53,13640.0,2,7112,2,13635.0,6,13640.0,2,B
2018-04-02 11:00:54,13640.0,2,7114,0,13635.0,6,13640.0,1,B
2018-04-02 11:01:05,13645.0,2,7116,2,13640.0,8,13645.0,3,B
2018-04-02 11:01:06,13645.0,2,7118,0,13640.0,8,13645.0,3,B
2018-04-02 11:01:08,13645.0,6,7124,2,13645.0,2,13650.0,16,B
2018-04-02 11:01:19,13650.0,20,7144,20,13645.0,7,13650.0,8,B
2018-04-02 11:01:19,13645.0,2,7146,-2,13645.0,6,13650.0,7,S
2018-04-02 11:01:23,13650.0,2,7148,2,13645.0,6,13650.0,5,B
2018-04-02 11:01:23,13650.0,2,7150,0,13645.0,6,13650.0,4,B
2018-04-02 11:01:25,13645.0,4,7154,-4,13645.0,4,13650.0,7,S
2018-04-02 11:01:25,13645.0,4,7158,-4,13645.0,2,13650.0,7,S
2018-04-02 11:01:26,13645.0,4,7162,-4,13640.0,9,13650.0,7,S
2018-04-02 11:01:28,13640.0,2,7164,2,13640.0,7,13645.0,3,S
2018-04-02 11:01:30,13640.0,2,7166,0,13640.0,7,13650.0,9,S
2018-04-02 11:01:34,13645.0,2,7168,0,13640.0,7,13645.0,2,B
2018-04-02 11:01:46,13645.0,2,7170,0,13640.0,4,13645.0,1,B
2018-04-02 11:02:06,13645.0,2,7172,2,13640.0,6,13645.0,1,B
2018-04-02 11:02:09,13645.0,2,7174,-2,13640.0,8,13650.0,10,B
2018-04-02 11:02:19,13650.0,12,7186,10,13650.0,4,13655.0,5,B
2018-04-02 11:02:30,13650.0,2,7188,2,13650.0,3,13655.0,3,B
2018-04-02 11:02:34,13655.0,2,7190,2,13650.0,4,13655.0,1,B
2018-04-02 11:02:35,13655.0,4,7194,2,13650.0,3,13660.0,10,B
2018-04-02 11:02:37,13660.0,2,7196,2,13650.0,3,13660.0,12,B
2018-04-02 11:02:41,13660.0,6,7202,4,13645.0,2,13655.0,4,B
2018-04-02 11:02:48,13645.0,2,7204,2,13640.0,8,13650.0,4,S
2018-04-02 11:02:56,13645.0,2,7206,0,13645.0,1,13650.0,2,S
2018-04-02 11:02:57,13645.0,2,7208,0,13640.0,11,13650.0,2,S
2018-04-02 11:03:33,13640.0,4,7212,4,13640.0,6,13645.0,1,S
2018-04-02 11:03:38,13640.0,6,7218,2,13640.0,3,13645.0,1,S
2018-04-02 11:03:42,13640.0,4,7222,2,13640.0,1,13645.0,1,S
2018-04-02 11:03:43,13645.0,4,7226,0,13645.0,1,13650.0,3,B
2018-04-02 11:03:43,13645.0,2,7228,2,13640.0,1,13645.0,4,B
2018-04-02 11:03:45,13640.0,2,7230,-2,13635.0,10,13640.0,5,S
2018-04-02 11:03:46,13640.0,6,7236,-2,13635.0,10,13640.0,2,S
2018-04-02 11:03:46,13640.0,2,7238,-2,13635.0,10,13640.0,1,S
2018-04-02 11:03:47,13640.0,2,7240,0,13640.0,3,13645.0,3,S
2018-04-02 11:03:50,13640.0,2,7242,0,13640.0,1,13645.0,1,S
2018-04-02 11:03:54,13640.0,2,7244,2,13635.0,11,13650.0,5,S
2018-04-02 11:04:01,13650.0,14,7258,-8,13635.0,9,13650.0,3,B
2018-04-02 11:04:09,13640.0,2,7260,0,13640.0,5,13650.0,3,S
2018-04-02 11:04:28,13650.0,12,7272,12,13650.0,4,13655.0,4,B
2018-04-02 11:04:29,13650.0,8,7280,0,13640.0,3,13650.0,8,B
2018-04-02 11:04:40,13650.0,16,7296,-8,13650.0,2,13655.0,13,B
2018-04-02 11:04:52,13650.0,2,7298,0,13650.0,2,13655.0,1,B
2018-04-02 11:05:04,13655.0,2,7300,0,13655.0,4,13660.0,15,B
2018-04-02 11:05:58,13655.0,2,7302,0,13650.0,5,13660.0,16,B
2018-04-02 11:06:11,13650.0,2,7304,-2,13650.0,1,13655.0,2,S
2018-04-02 11:06:22,13645.0,2,7306,-2,13645.0,1,13655.0,6,S
2018-04-02 11:06:38,13645.0,2,7308,0,13640.0,6,13650.0,2,S
2018-04-02 11:06:59,13650.0,4,7312,4,13650.0,3,13655.0,6,B
2018-04-02 11:07:00,13650.0,6,7318,4,13645.0,4,13650.0,2,B
2018-04-02 11:07:54,13645.0,2,7320,0,13645.0,4,13650.0,15,S
2018-04-02 11:07:54,13645.0,4,7324,0,13645.0,2,13650.0,15,S
2018-04-02 11:07:58,13645.0,4,7328,4,13640.0,2,13645.0,3,S
2018-04-02 11:08:05,13645.0,6,7334,0,13640.0,6,13650.0,16,S
2018-04-02 11:08:07,13645.0,2,7336,0,13645.0,3,13650.0,10,S
2018-04-02 11:08:13,13645.0,2,7338,-2,13640.0,6,13650.0,10,S
2018-04-02 11:08:39,13645.0,2,7340,-2,13640.0,5,13645.0,4,S
2018-04-02 11:08:48,13645.0,2,7342,0,13640.0,5,13645.0,3,S
2018-04-02 11:09:05,13645.0,2,7344,0,13640.0,4,13645.0,2,S
2018-04-02 11:09:12,13645.0,4,7348,0,13645.0,8,13650.0,21,S
2018-04-02 11:09:22,13650.0,4,7352,0,13645.0,8,13650.0,7,B
2018-04-02 11:09:27,13650.0,16,7368,8,13640.0,2,13645.0,1,B
2018-04-02 11:09:28,13645.0,4,7372,-2,13640.0,2,13645.0,1,S
2018-04-02 11:09:28,13645.0,2,7374,0,13640.0,2,13650.0,2,S
2018-04-02 11:09:54,13650.0,2,7376,0,13645.0,1,13655.0,5,B
2018-04-02 11:11:18,13640.0,2,7378,0,13640.0,4,13650.0,5,S
2018-04-02 11:11:31,13640.0,2,7380,0,13640.0,5,13650.0,5,S
2018-04-02 11:11:51,13645.0,2,7382,2,13640.0,5,13650.0,3,B
2018-04-02 11:12:11,13645.0,2,7384,0,13640.0,7,13650.0,2,B
2018-04-02 11:13:05,13650.0,4,7388,0,13650.0,19,13660.0,24,B
2018-04-02 11:13:21,13660.0,16,7404,10,13655.0,12,13660.0,13,B
2018-04-02 11:13:22,13660.0,10,7414,10,13655.0,16,13660.0,8,B
2018-04-02 11:13:24,13660.0,2,7416,0,13655.0,6,13660.0,7,B
2018-04-02 11:13:25,13660.0,10,7426,6,13655.0,6,13660.0,2,B
2018-04-02 11:13:25,13660.0,2,7428,0,13655.0,5,13660.0,1,B
2018-04-02 11:13:26,13660.0,2,7430,0,13655.0,5,13665.0,9,B
2018-04-02 11:13:29,13660.0,2,7432,0,13660.0,3,13665.0,8,B
2018-04-02 11:13:30,13665.0,4,7436,0,13660.0,3,13665.0,6,B
2018-04-02 11:13:31,13665.0,4,7440,4,13660.0,3,13665.0,5,B
2018-04-02 11:13:32,13660.0,4,7444,0,13655.0,7,13665.0,5,S
2018-04-02 11:13:33,13660.0,2,7446,0,13655.0,7,13665.0,5,S
2018-04-02 11:13:37,13660.0,2,7448,-2,13655.0,4,13660.0,2,S
2018-04-02 11:13:40,13665.0,4,7452,2,13655.0,5,13665.0,3,B
2018-04-02 11:13:42,13675.0,32,7484,-2,13665.0,1,13680.0,2,B
2018-04-02 11:13:43,13665.0,26,7510,0,13660.0,1,13680.0,1,S
2018-04-02 11:13:44,13675.0,2,7512,-2,13675.0,4,13680.0,2,B
2018-04-02 11:13:45,13675.0,14,7526,-8,13665.0,2,13675.0,2,B
2018-04-02 11:13:46,13675.0,2,7528,-2,13670.0,3,13680.0,3,B
2018-04-02 11:13:47,13670.0,6,7534,0,13665.0,4,13680.0,4,S
2018-04-02 11:13:48,13675.0,2,7536,0,13675.0,2,13680.0,3,B
2018-04-02 11:13:48,13675.0,4,7540,-4,13675.0,1,13680.0,2,B
2018-04-02 11:13:49,13675.0,2,7542,-2,13670.0,3,13680.0,2,B
2018-04-02 11:13:51,13700.0,44,7586,-8,13670.0,4,13700.0,30,B
2018-04-02 11:13:53,13675.0,6,7592,-4,13675.0,7,13685.0,1,S
2018-04-02 11:13:56,13685.0,2,7594,0,13675.0,6,13690.0,15,B
2018-04-02 11:13:59,13695.0,36,7630,-2,13675.0,6,13695.0,3,B
2018-04-02 11:14:01,13680.0,2,7632,0,13675.0,2,13680.0,1,S
2018-04-02 11:14:02,13680.0,2,7634,-2,13675.0,2,13685.0,1,S
2018-04-02 11:14:03,13680.0,4,7638,2,13675.0,2,13690.0,6,S
2018-04-02 11:14:08,13685.0,4,7642,-2,13675.0,2,13690.0,4,B
2018-04-02 11:14:13,13675.0,2,7644,0,13675.0,3,13685.0,5,S
2018-04-02 11:14:13,13685.0,8,7652,-2,13675.0,3,13685.0,1,B
2018-04-02 11:14:14,13675.0,2,7654,2,13675.0,2,13690.0,5,S
2018-04-02 11:14:21,13685.0,2,7656,0,13685.0,3,13690.0,1,B
2018-04-02 11:14:22,13685.0,6,7662,-6,13680.0,2,13690.0,1,B
2018-04-02 11:14:38,13685.0,2,7664,2,13680.0,6,13690.0,2,B
2018-04-02 11:14:40,13685.0,2,7666,-2,13680.0,6,13690.0,1,B
2018-04-02 11:14:42,13690.0,2,7668,0,13680.0,7,13695.0,2,B
2018-04-02 11:14:47,13685.0,2,7670,2,13685.0,2,13695.0,4,S
2018-04-02 11:14:57,13690.0,4,7674,0,13685.0,2,13695.0,4,B
2018-04-02 11:15:04,13685.0,2,7676,2,13685.0,2,13695.0,2,S
2018-04-02 11:15:12,13680.0,4,7680,-2,13675.0,3,13685.0,2,S
2018-04-02 11:15:38,13675.0,2,7682,0,13670.0,2,13680.0,2,S
2018-04-02 11:15:51,13680.0,10,7692,-4,13680.0,15,13685.0,1,B
2018-04-02 11:15:51,13680.0,30,7722,-18,13670.0,5,13685.0,1,B
2018-04-02 11:15:53,13670.0,4,7726,-4,13670.0,2,13680.0,4,S
2018-04-02 11:15:55,13670.0,2,7728,0,13670.0,1,13680.0,4,S
2018-04-02 11:16:03,13670.0,2,7730,0,13670.0,1,13680.0,16,S
2018-04-02 11:16:43,13680.0,22,7752,0,13680.0,9,13685.0,2,B
2018-04-02 11:16:43,13680.0,18,7770,0,13670.0,4,13685.0,2,B
2018-04-02 11:17:40,13670.0,6,7776,-2,13665.0,3,13675.0,16,S
2018-04-02 11:17:46,13665.0,2,7778,-2,13660.0,2,13665.0,2,S
2018-04-02 11:17:48,13660.0,2,7780,0,13660.0,1,13665.0,5,S
2018-04-02 11:17:49,13665.0,10,7790,0,13660.0,1,13670.0,3,B
2018-04-02 11:18:01,13660.0,2,7792,0,13660.0,2,13670.0,13,S
2018-04-02 11:18:20,13660.0,4,7796,0,13660.0,3,13670.0,13,S
2018-04-02 11:18:20,13660.0,2,7798,-2,13660.0,4,13670.0,13,S
2018-04-02 11:18:26,13670.0,2,7800,0,13665.0,6,13670.0,11,B
2018-04-02 11:18:41,13670.0,2,7802,-2,13665.0,2,13670.0,11,B
2018-04-02 11:18:41,13665.0,4,7806,0,13660.0,5,13670.0,11,S
2018-04-02 11:18:49,13670.0,16,7822,0,13665.0,1,13670.0,3,B
2018-04-02 11:18:51,13665.0,2,7824,2,13660.0,5,13670.0,3,S
2018-04-02 11:19:16,13660.0,4,7828,0,13655.0,3,13665.0,1,S
2018-04-02 11:19:17,13665.0,2,7830,-2,13655.0,5,13670.0,9,B
2018-04-02 11:19:41,13665.0,2,7832,0,13660.0,2,13670.0,9,B
2018-04-02 11:19:48,13660.0,2,7834,0,13660.0,1,13665.0,1,S
2018-04-02 11:19:50,13665.0,2,7836,0,13660.0,3,13665.0,5,B
2018-04-02 11:19:52,13665.0,10,7846,0,13665.0,3,13670.0,9,B
2018-04-02 11:19:53,13665.0,6,7852,0,13660.0,1,13670.0,9,B
2018-04-02 11:20:12,13665.0,2,7854,-2,13660.0,1,13665.0,2,B
2018-04-02 11:20:15,13665.0,2,7856,0,13660.0,1,13665.0,1,B
2018-04-02 11:20:24,13665.0,2,7858,2,13660.0,1,13665.0,2,B
2018-04-02 11:20:45,13670.0,12,7870,-4,13670.0,4,13675.0,16,B
2018-04-02 11:20:46,13670.0,8,7878,-2,13660.0,2,13670.0,6,B
2018-04-02 11:21:02,13670.0,2,7880,2,13660.0,6,13670.0,4,B
2018-04-02 11:21:46,13665.0,2,7882,0,13660.0,1,13665.0,1,S
2018-04-02 11:22:05,13665.0,2,7884,-2,13665.0,1,13670.0,8,S
2018-04-02 11:22:06,13665.0,2,7886,-2,13660.0,2,13670.0,8,S
2018-04-02 11:22:39,13660.0,2,7888,0,13655.0,2,13660.0,2,S
2018-04-02 11:22:39,13655.0,2,7890,0,13655.0,3,13660.0,2,S
2018-04-02 11:23:03,13655.0,2,7892,0,13655.0,1,13660.0,1,S
2018-04-02 11:23:04,13660.0,2,7894,-2,13660.0,1,13665.0,4,B
2018-04-02 11:23:15,13665.0,2,7896,0,13655.0,2,13660.0,2,B
2018-04-02 11:23:45,13665.0,2,7898,-2,13660.0,2,13665.0,1,B
2018-04-02 11:23:45,13665.0,2,7900,0,13665.0,2,13670.0,3,B
2018-04-02 11:24:09,13665.0,2,7902,-2,13660.0,1,13670.0,3,B
2018-04-02 11:24:14,13670.0,6,7908,-2,13660.0,1,13670.0,3,B
2018-04-02 11:25:05,13660.0,2,7910,0,13655.0,2,13665.0,12,S
2018-04-02 11:25:54,13655.0,2,7912,-2,13650.0,3,13660.0,16,S
2018-04-02 11:26:17,13655.0,2,7914,0,13655.0,1,13660.0,4,S
2018-04-02 11:26:56,13660.0,2,7916,0,13655.0,2,13660.0,1,B
2018-04-02 11:27:00,13660.0,2,7918,0,13655.0,2,13665.0,3,B
2018-04-02 11:28:01,13670.0,2,7920,-2,13660.0,1,13670.0,3,B
2018-04-02 11:28:11,13670.0,2,7922,-2,13660.0,1,13670.0,2,B
2018-04-02 11:28:12,13670.0,2,7924,-2,13660.0,1,13670.0,1,B
2018-04-02 11:28:14,13670.0,2,7926,0,13660.0,1,13675.0,26,B
2018-04-02 11:28:19,13670.0,4,7930,0,13660.0,1,13670.0,7,B
2018-04-02 11:28:21,13670.0,2,7932,0,13660.0,1,13670.0,6,B
2018-04-02 11:28:21,13670.0,2,7934,0,13660.0,1,13670.0,5,B
2018-04-02 11:28:22,13670.0,2,7936,0,13660.0,1,13670.0,4,B
2018-04-02 11:28:23,13670.0,4,7940,0,13660.0,1,13670.0,2,B
2018-04-02 11:29:11,13670.0,4,7944,-4,13665.0,7,13675.0,12,B
2018-04-02 11:29:18,13675.0,2,7946,0,13665.0,5,13675.0,9,B
2018-04-02 11:29:20,13675.0,2,7948,0,13665.0,5,13675.0,8,B
2018-04-02 11:29:26,13675.0,2,7950,0,13665.0,1,13675.0,7,B
2018-04-02 11:29:30,13675.0,2,7952,0,13665.0,1,13675.0,8,B
2018-04-02 11:29:46,13670.0,2,7954,0,13665.0,7,13670.0,1,S
2018-04-02 11:29:59,13675.0,2,7956,0,13665.0,2,13675.0,5,B
2018-04-02 13:30:11,13675.0,10,7966,-2,13665.0,3,13675.0,2,B
2018-04-02 13:30:12,13680.0,10,7976,0,13665.0,3,13680.0,28,B
2018-04-02 13:30:40,13670.0,2,7978,0,13670.0,1,13675.0,3,S
2018-04-02 13:30:51,13665.0,2,7980,0,13665.0,1,13670.0,4,S
2018-04-02 13:30:55,13665.0,2,7982,0,13660.0,2,13665.0,1,S
2018-04-02 13:31:03,13655.0,2,7984,0,13655.0,2,13660.0,2,S
2018-04-02 13:31:05,13655.0,6,7990,0,13650.0,2,13660.0,2,S
2018-04-02 13:31:06,13645.0,4,7994,4,13645.0,3,13655.0,3,S
2018-04-02 13:31:06,13655.0,4,7998,0,13645.0,3,13660.0,3,B
2018-04-02 13:31:07,13660.0,4,8002,0,13650.0,6,13665.0,3,B
2018-04-02 13:31:08,13665.0,2,8004,0,13655.0,3,13665.0,6,B
2018-04-02 13:31:15,13660.0,2,8006,0,13660.0,4,13665.0,3,S
2018-04-02 13:31:26,13670.0,2,8008,0,13665.0,1,13670.0,1,B
2018-04-02 13:31:26,13670.0,2,8010,0,13665.0,1,13675.0,2,B
2018-04-02 13:31:32,13665.0,6,8016,-6,13660.0,1,13670.0,3,S
2018-04-02 13:31:34,13660.0,2,8018,0,13655.0,3,13660.0,1,S
2018-04-02 13:31:34,13660.0,2,8020,0,13655.0,2,13670.0,33,S
2018-04-02 13:32:17,13660.0,4,8024,-2,13655.0,4,13665.0,8,S
2018-04-02 13:32:18,13655.0,2,8026,0,13650.0,3,13665.0,8,S
2018-04-02 13:33:00,13655.0,2,8028,0,13655.0,1,13660.0,1,S
2018-04-02 13:33:02,13660.0,2,8030,0,13655.0,1,13665.0,7,B
2018-04-02 13:33:41,13665.0,2,8032,2,13655.0,3,13665.0,7,B
2018-04-02 13:34:04,13655.0,4,8036,-2,13655.0,1,13665.0,7,S
2018-04-02 13:34:41,13665.0,2,8038,0,13660.0,4,13665.0,4,B
2018-04-02 13:34:41,13665.0,8,8046,0,13660.0,4,13670.0,8,B
2018-04-02 13:34:43,13670.0,4,8050,-2,13670.0,2,13675.0,9,B
2018-04-02 13:34:48,13670.0,4,8054,0,13665.0,3,13670.0,1,B
2018-04-02 13:35:26,13660.0,2,8056,0,13655.0,4,13660.0,2,S
2018-04-02 13:35:26,13660.0,4,8060,4,13655.0,3,13665.0,3,S
2018-04-02 13:35:34,13665.0,2,8062,0,13655.0,2,13665.0,2,B
2018-04-02 13:36:08,13655.0,2,8064,0,13650.0,4,13660.0,20,S
2018-04-02 13:36:19,13655.0,2,8066,-2,13655.0,1,13660.0,7,S
2018-04-02 13:36:22,13650.0,4,8070,2,13650.0,1,13660.0,6,S
2018-04-02 13:36:29,13645.0,4,8074,2,13640.0,29,13655.0,3,S
2018-04-02 13:36:32,13645.0,2,8076,2,13645.0,5,13655.0,4,S
2018-04-02 13:36:35,13640.0,2,8078,0,13640.0,3,13650.0,3,S
2018-04-02 13:36:38,13640.0,2,8080,2,13640.0,2,13650.0,3,S
2018-04-02 13:36:41,13650.0,2,8082,0,13640.0,2,13655.0,4,B
2018-04-02 13:36:42,13640.0,2,8084,0,13640.0,1,13650.0,3,S
2018-04-02 13:37:11,13650.0,2,8086,-2,13650.0,1,13655.0,3,B
2018-04-02 13:37:12,13655.0,6,8092,-2,13645.0,2,13660.0,8,B
2018-04-02 13:37:24,13650.0,4,8096,-4,13645.0,2,13655.0,2,S
2018-04-02 13:37:41,13655.0,2,8098,-2,13645.0,7,13660.0,20,B
2018-04-02 13:37:51,13655.0,2,8100,0,13650.0,2,13660.0,19,B
2018-04-02 13:37:55,13650.0,2,8102,0,13650.0,1,13660.0,6,S
2018-04-02 13:38:03,13655.0,10,8112,10,13650.0,3,13660.0,4,B
2018-04-02 13:38:29,13660.0,4,8116,4,13655.0,5,13660.0,3,B
2018-04-02 13:39:19,13655.0,2,8118,2,13655.0,4,13660.0,13,S
2018-04-02 13:39:28,13655.0,8,8126,8,13650.0,2,13660.0,15,S
2018-04-02 13:39:51,13655.0,2,8128,2,13655.0,4,13660.0,27,S
2018-04-02 13:39:54,13655.0,2,8130,0,13655.0,3,13660.0,15,S
2018-04-02 13:40:02,13655.0,2,8132,0,13655.0,2,13660.0,15,S
2018-04-02 13:40:35,13660.0,8,8140,4,13655.0,7,13660.0,6,B
2018-04-02 13:40:36,13660.0,12,8152,12,13655.0,7,13665.0,3,B
2018-04-02 13:42:06,13665.0,2,8154,0,13660.0,1,13665.0,4,B
2018-04-02 13:42:09,13660.0,2,8156,-2,13655.0,9,13660.0,2,S
2018-04-02 13:42:10,13660.0,4,8160,0,13655.0,9,13665.0,4,S
2018-04-02 13:42:35,13660.0,10,8170,-4,13655.0,7,13665.0,12,S
2018-04-02 13:43:02,13655.0,4,8174,-4,13655.0,6,13665.0,14,S
2018-04-02 13:43:29,13655.0,4,8178,0,13655.0,5,13660.0,1,S
2018-04-02 13:43:42,13655.0,10,8188,6,13650.0,11,13655.0,2,S
2018-04-02 13:44:01,13655.0,2,8190,0,13650.0,11,13660.0,2,S
2018-04-02 13:44:07,13650.0,4,8194,0,13650.0,2,13655.0,2,S
2018-04-02 13:44:07,13650.0,4,8198,-4,13645.0,2,13655.0,3,S
2018-04-02 13:44:15,13655.0,4,8202,0,13645.0,4,13660.0,4,B
2018-04-02 13:44:25,13645.0,6,8208,-4,13640.0,12,13645.0,12,S
2018-04-02 13:44:26,13645.0,6,8214,-6,13640.0,13,13645.0,9,S
2018-04-02 13:44:26,13645.0,2,8216,-2,13640.0,13,13645.0,8,S
2018-04-02 13:44:44,13640.0,20,8236,0,13640.0,2,13645.0,8,S
2018-04-02 13:44:47,13640.0,4,8240,-4,13635.0,6,13645.0,10,S
2018-04-02 13:44:55,13635.0,10,8250,2,13630.0,3,13635.0,3,S
2018-04-02 13:44:56,13630.0,2,8252,2,13630.0,3,13635.0,4,S
2018-04-02 13:44:59,13630.0,6,8258,4,13625.0,2,13635.0,2,S
2018-04-02 13:45:04,13625.0,4,8262,4,13625.0,1,13630.0,1,S
2018-04-02 13:45:05,13625.0,2,8264,0,13620.0,4,13630.0,1,S
2018-04-02 13:45:10,13635.0,6,8270,-2,13620.0,3,13635.0,3,B
2018-04-02 13:45:11,13630.0,4,8274,0,13620.0,3,13635.0,3,S
2018-04-02 13:45:24,13630.0,2,8276,0,13620.0,3,13635.0,3,S
2018-04-02 13:45:30,13630.0,2,8278,-2,13630.0,1,13640.0,3,S
2018-04-02 13:45:32,13630.0,2,8280,0,13625.0,5,13630.0,1,S
2018-04-02 13:45:32,13630.0,2,8282,0,13620.0,3,13635.0,5,S
2018-04-02 13:45:34,13620.0,10,8292,-6,13615.0,2,13620.0,2,S
2018-04-02 13:45:35,13620.0,4,8296,-4,13620.0,10,13630.0,1,S
2018-04-02 13:45:41,13620.0,12,8308,6,13620.0,2,13630.0,4,S
2018-04-02 13:45:58,13630.0,2,8310,-2,13630.0,1,13635.0,3,B
2018-04-02 13:45:58,13630.0,2,8312,0,13625.0,3,13635.0,3,B
2018-04-02 13:46:05,13625.0,6,8318,0,13620.0,4,13635.0,2,S
2018-04-02 13:46:18,13635.0,2,8320,0,13625.0,6,13635.0,4,B
2018-04-02 13:46:30,13630.0,8,8328,4,13620.0,15,13630.0,1,S
2018-04-02 13:46:30,13630.0,2,8330,0,13630.0,1,13635.0,2,S
2018-04-02 13:46:31,13630.0,4,8334,0,13625.0,4,13635.0,2,S
2018-04-02 13:46:35,13630.0,2,8336,-2,13630.0,1,13635.0,3,S
2018-04-02 13:46:45,13625.0,2,8338,0,13620.0,4,13630.0,3,S
2018-04-02 13:46:46,13630.0,2,8340,0,13620.0,3,13630.0,2,B
2018-04-02 13:46:55,13625.0,2,8342,0,13620.0,3,13630.0,3,S
2018-04-02 13:46:57,13630.0,2,8344,-2,13620.0,6,13630.0,3,B
2018-04-02 13:47:57,13630.0,4,8348,4,13625.0,4,13630.0,4,B
2018-04-02 13:48:02,13625.0,2,8350,2,13625.0,3,13630.0,5,S
2018-04-02 13:48:28,13625.0,2,8352,2,13625.0,2,13630.0,7,S
2018-04-02 13:49:58,13630.0,2,8354,0,13625.0,7,13630.0,6,B
2018-04-02 13:50:30,13630.0,2,8356,0,13625.0,9,13630.0,4,B
2018-04-02 13:50:36,13630.0,2,8358,2,13625.0,9,13630.0,3,B
2018-04-02 13:50:57,13635.0,2,8360,0,13630.0,5,13640.0,2,B
2018-04-02 13:51:26,13640.0,2,8362,-2,13635.0,4,13645.0,22,B
2018-04-02 13:51:52,13640.0,2,8364,-2,13635.0,3,13640.0,9,B
2018-04-02 13:51:52,13640.0,8,8372,-4,13635.0,3,13640.0,5,B
2018-04-02 13:51:56,13640.0,4,8376,0,13635.0,3,13640.0,3,B
2018-04-02 13:52:35,13640.0,2,8378,0,13635.0,3,13640.0,2,B
2018-04-02 13:52:42,13640.0,4,8382,-4,13635.0,3,13645.0,10,B
2018-04-02 13:52:43,13640.0,2,8384,0,13640.0,1,13645.0,10,B
2018-04-02 13:52:43,13640.0,2,8386,0,13635.0,4,13645.0,10,B
2018-04-02 13:52:44,13645.0,12,8398,-12,13635.0,4,13645.0,4,B
2018-04-02 13:52:44,13635.0,2,8400,2,13635.0,3,13645.0,4,S
2018-04-02 13:52:47,13645.0,8,8408,2,13645.0,2,13650.0,2,B
2018-04-02 13:52:47,13645.0,4,8412,0,13635.0,3,13650.0,3,B
2018-04-02 13:53:20,13640.0,2,8414,0,13635.0,5,13645.0,11,S
2018-04-02 13:53:22,13635.0,14,8428,-8,13630.0,5,13635.0,3,S
2018-04-02 13:53:22,13635.0,6,8434,-2,13635.0,3,13645.0,2,S
2018-04-02 13:54:26,13635.0,6,8440,4,13635.0,5,13645.0,6,S
2018-04-02 13:54:47,13635.0,2,8442,0,13635.0,4,13645.0,6,S
2018-04-02 13:54:52,13640.0,2,8444,2,13635.0,4,13645.0,15,B
2018-04-02 13:55:19,13640.0,4,8448,-4,13635.0,1,13640.0,1,B
2018-04-02 13:55:21,13635.0,2,8450,0,13630.0,4,13635.0,5,S
2018-04-02 13:55:22,13635.0,2,8452,0,13630.0,4,13635.0,4,S
2018-04-02 13:55:41,13630.0,8,8460,-2,13630.0,1,13635.0,1,S
2018-04-02 13:56:53,13640.0,2,8462,0,13635.0,3,13640.0,1,B
2018-04-02 13:57:32,13640.0,2,8464,2,13635.0,2,13640.0,4,B
2018-04-02 13:58:23,13635.0,2,8466,0,13630.0,4,13635.0,5,S
2018-04-02 13:58:41,13635.0,2,8468,-2,13630.0,4,13635.0,1,S
2018-04-02 13:58:43,13630.0,8,8476,2,13620.0,5,13630.0,1,S
2018-04-02 13:58:45,13630.0,2,8478,2,13625.0,6,13635.0,1,S
2018-04-02 13:58:55,13635.0,2,8480,-2,13630.0,2,13640.0,2,B
2018-04-02 13:59:01,13630.0,2,8482,-2,13630.0,1,13635.0,1,S
2018-04-02 13:59:01,13635.0,2,8484,-2,13635.0,1,13640.0,14,B
2018-04-02 13:59:02,13635.0,2,8486,-2,13630.0,2,13635.0,3,B
2018-04-02 13:59:13,13630.0,4,8490,2,13625.0,1,13635.0,1,S
2018-04-02 13:59:27,13630.0,2,8492,-2,13620.0,7,13630.0,6,S
2018-04-02 13:59:28,13630.0,4,8496,-2,13620.0,7,13630.0,2,S
2018-04-02 13:59:28,13630.0,4,8500,0,13620.0,7,13635.0,3,S
2018-04-02 13:59:29,13635.0,2,8502,0,13620.0,7,13635.0,2,B
2018-04-02 13:59:47,13635.0,4,8506,0,13625.0,1,13635.0,1,B
2018-04-02 13:59:47,13640.0,4,8510,0,13625.0,2,13640.0,1,B
2018-04-02 14:00:12,13640.0,2,8512,0,13630.0,2,13635.0,1,B
2018-04-02 14:00:12,13640.0,4,8516,0,13630.0,2,13640.0,2,B
2018-04-02 14:00:13,13640.0,2,8518,-2,13630.0,2,13640.0,1,B
2018-04-02 14:00:56,13640.0,2,8520,0,13635.0,1,13640.0,4,B
2018-04-02 14:00:56,13640.0,4,8524,0,13635.0,1,13640.0,2,B
2018-04-02 14:00:57,13640.0,4,8528,0,13635.0,1,13645.0,5,B
2018-04-02 14:00:57,13645.0,2,8530,-2,13635.0,1,13645.0,4,B
2018-04-02 14:00:58,13635.0,2,8532,-2,13630.0,2,13635.0,2,S
2018-04-02 14:00:59,13635.0,4,8536,0,13630.0,2,13645.0,5,S
2018-04-02 14:01:52,13645.0,2,8538,0,13635.0,8,13645.0,2,B
2018-04-02 14:01:53,13645.0,4,8542,0,13635.0,8,13650.0,14,B
2018-04-02 14:01:53,13645.0,2,8544,0,13635.0,8,13645.0,2,B
2018-04-02 14:01:54,13650.0,2,8546,-2,13635.0,9,13650.0,13,B
2018-04-02 14:01:54,13650.0,2,8548,0,13645.0,1,13650.0,12,B
2018-04-02 14:01:55,13645.0,4,8552,-2,13640.0,2,13650.0,12,S
2018-04-02 14:02:08,13650.0,4,8556,0,13640.0,4,13650.0,5,B
2018-04-02 14:02:26,13650.0,4,8560,-4,13645.0,2,13650.0,1,B
2018-04-02 14:02:26,13650.0,2,8562,0,13655.0,1,13660.0,16,B
2018-04-02 14:02:27,13655.0,2,8564,0,13645.0,1,13655.0,12,B
2018-04-02 14:03:10,13655.0,20,8584,14,13650.0,6,13660.0,26,B
2018-04-02 14:03:26,13655.0,2,8586,0,13650.0,7,13655.0,1,B
2018-04-02 14:03:26,13655.0,2,8588,0,13650.0,7,13660.0,2,B
2018-04-02 14:03:28,13655.0,2,8590,0,13655.0,2,13660.0,3,B
2018-04-02 14:03:29,13655.0,4,8594,0,13650.0,5,13660.0,3,B
2018-04-02 14:03:33,13660.0,4,8598,-2,13650.0,5,13660.0,5,B
2018-04-02 14:03:39,13650.0,2,8600,-2,13650.0,5,13660.0,5,S
2018-04-02 14:04:16,13650.0,2,8602,2,13650.0,4,13655.0,2,S
2018-04-02 14:04:18,13655.0,2,8604,2,13650.0,3,13660.0,20,B
2018-04-02 14:04:25,13660.0,2,8606,0,13650.0,4,13660.0,7,B
2018-04-02 14:04:26,13650.0,2,8608,2,13650.0,2,13655.0,4,S
2018-04-02 14:04:27,13645.0,4,8612,4,13645.0,2,13650.0,3,S
2018-04-02 14:04:28,13645.0,4,8616,2,13640.0,3,13650.0,4,S
2018-04-02 14:04:32,13650.0,2,8618,0,13645.0,4,13655.0,2,B
2018-04-02 14:05:22,13655.0,2,8620,0,13645.0,2,13655.0,5,B
2018-04-02 14:05:22,13655.0,2,8622,2,13645.0,2,13655.0,4,B
2018-04-02 14:05:38,13655.0,4,8626,0,13645.0,2,13655.0,2,B
2018-04-02 14:07:04,13660.0,20,8646,12,13645.0,5,13665.0,15,B
2018-04-02 14:07:33,13655.0,2,8648,0,13655.0,4,13660.0,4,S
2018-04-02 14:07:37,13660.0,4,8652,0,13655.0,8,13665.0,14,B
2018-04-02 14:07:38,13665.0,4,8656,0,13655.0,7,13665.0,2,B
2018-04-02 14:07:44,13665.0,4,8660,0,13665.0,4,13670.0,18,B
2018-04-02 14:07:44,13665.0,8,8668,-6,13655.0,7,13670.0,28,B
2018-04-02 14:07:48,13665.0,2,8670,2,13665.0,4,13670.0,28,B
2018-04-02 14:07:49,13665.0,8,8678,0,13660.0,3,13670.0,28,B
2018-04-02 14:08:29,13665.0,2,8680,0,13660.0,1,13665.0,4,B
2018-04-02 14:08:38,13660.0,2,8682,0,13655.0,7,13660.0,1,S
2018-04-02 14:08:45,13655.0,2,8684,2,13655.0,5,13660.0,2,S
2018-04-02 14:08:48,13660.0,4,8688,0,13655.0,7,13665.0,3,B
2018-04-02 14:08:50,13665.0,4,8692,2,13660.0,1,13665.0,2,B
2018-04-02 14:08:50,13665.0,2,8694,0,13660.0,1,13665.0,1,B
2018-04-02 14:08:55,13665.0,4,8698,4,13660.0,1,13670.0,29,B
2018-04-02 14:09:22,13665.0,2,8700,-2,13660.0,5,13665.0,1,B
2018-04-02 14:09:43,13660.0,10,8710,2,13655.0,7,13660.0,15,S
2018-04-02 14:09:43,13660.0,2,8712,0,13655.0,7,13660.0,14,S
2018-04-02 14:09:46,13660.0,2,8714,0,13655.0,6,13660.0,13,S
2018-04-02 14:09:47,13660.0,2,8716,0,13655.0,6,13660.0,12,S
2018-04-02 14:10:17,13655.0,10,8726,4,13650.0,6,13655.0,7,S
2018-04-02 14:10:17,13655.0,8,8734,6,13650.0,6,13655.0,3,S
2018-04-02 14:10:18,13650.0,6,8740,-4,13650.0,2,13655.0,3,S
2018-04-02 14:10:23,13655.0,2,8742,0,13650.0,2,13655.0,2,B
2018-04-02 14:10:24,13655.0,4,8746,0,13650.0,2,13660.0,2,B
2018-04-02 14:11:07,13660.0,4,8750,0,13650.0,2,13660.0,6,B
2018-04-02 14:11:08,13660.0,2,8752,0,13650.0,2,13660.0,5,B
2018-04-02 14:11:08,13660.0,6,8758,4,13650.0,2,13660.0,2,B
2018-04-02 14:11:10,13650.0,4,8762,-2,13645.0,2,13650.0,3,S
2018-04-02 14:11:11,13650.0,6,8768,0,13655.0,1,13660.0,4,S
2018-04-02 14:11:11,13655.0,4,8772,-4,13645.0,3,13655.0,3,B
2018-04-02 14:11:12,13660.0,2,8774,0,13645.0,3,13660.0,3,B
2018-04-02 14:11:12,13660.0,2,8776,0,13645.0,5,13660.0,2,B
2018-04-02 14:11:27,13660.0,2,8778,0,13650.0,9,13670.0,19,B
2018-04-02 14:11:32,13650.0,2,8780,2,13650.0,8,13665.0,7,S
2018-04-02 14:11:36,13650.0,10,8790,10,13650.0,3,13660.0,1,S
2018-04-02 14:11:44,13660.0,2,8792,0,13650.0,6,13660.0,1,B
2018-04-02 14:11:44,13660.0,2,8794,0,13650.0,6,13665.0,4,B
2018-04-02 14:11:47,13655.0,2,8796,-2,13650.0,6,13655.0,1,S
2018-04-02 14:11:47,13660.0,2,8798,-2,13650.0,6,13660.0,1,B
2018-04-02 14:11:57,13660.0,2,8800,2,13650.0,7,13660.0,2,B
2018-04-02 14:14:18,13660.0,4,8804,-4,13650.0,8,13660.0,3,B
2018-04-02 14:14:19,13660.0,4,8808,-4,13650.0,8,13660.0,1,B
2018-04-02 14:14:42,13660.0,2,8810,-2,13655.0,1,13665.0,12,B
2018-04-02 14:14:43,13665.0,2,8812,-2,13655.0,1,13665.0,11,B
2018-04-02 14:15:22,13665.0,6,8818,0,13655.0,3,13665.0,15,B
2018-04-02 14:15:55,13660.0,2,8820,2,13655.0,9,13660.0,1,S
2018-04-02 14:16:41,13650.0,4,8824,-2,13650.0,7,13660.0,4,S
2018-04-02 14:16:47,13660.0,6,8830,2,13650.0,8,13660.0,1,B
2018-04-02 14:18:09,13660.0,2,8832,2,13650.0,8,13660.0,1,B
2018-04-02 14:18:45,13650.0,2,8834,2,13650.0,7,13660.0,2,S
2018-04-02 14:18:51,13650.0,2,8836,2,13650.0,6,13660.0,3,S
2018-04-02 14:18:55,13650.0,2,8838,0,13650.0,5,13660.0,3,S
2018-04-02 14:19:43,13650.0,2,8840,-2,13650.0,5,13660.0,3,S
2018-04-02 14:20:27,13650.0,2,8842,0,13650.0,4,13655.0,2,S
2018-04-02 14:20:47,13650.0,2,8844,0,13650.0,3,13655.0,2,S
2018-04-02 14:21:59,13650.0,8,8852,-4,13645.0,5,13650.0,14,S
2018-04-02 14:21:59,13650.0,4,8856,0,13645.0,5,13650.0,12,S
2018-04-02 14:22:01,13650.0,4,8860,-4,13645.0,5,13650.0,10,S
2018-04-02 14:22:03,13650.0,6,8866,-6,13645.0,5,13650.0,7,S
2018-04-02 14:22:05,13650.0,2,8868,0,13645.0,5,13650.0,6,S
2018-04-02 14:22:23,13650.0,2,8870,-2,13645.0,5,13650.0,5,S
2018-04-02 14:22:24,13650.0,6,8876,-4,13645.0,5,13650.0,2,S
2018-04-02 14:22:24,13650.0,2,8878,-2,13645.0,5,13650.0,1,S
2018-04-02 14:22:26,13650.0,2,8880,-2,13645.0,5,13655.0,1,S
2018-04-02 14:22:38,13655.0,2,8882,0,13655.0,4,13660.0,5,B
2018-04-02 14:22:38,13655.0,8,8890,0,13645.0,5,13660.0,5,B
2018-04-02 14:23:16,13655.0,2,8892,2,13650.0,3,13660.0,5,B
2018-04-02 14:23:28,13660.0,2,8894,0,13650.0,3,13660.0,4,B
2018-04-02 14:25:05,13660.0,2,8896,0,13655.0,2,13660.0,4,B
2018-04-02 14:25:11,13660.0,8,8904,0,13660.0,6,13665.0,8,B
2018-04-02 14:25:12,13660.0,4,8908,4,13660.0,4,13665.0,8,B
2018-04-02 14:25:53,13665.0,4,8912,2,13660.0,5,13665.0,5,B
2018-04-02 14:25:53,13665.0,10,8922,-8,13660.0,5,13670.0,18,B
2018-04-02 14:26:29,13665.0,2,8924,0,13665.0,30,13670.0,7,B
2018-04-02 14:26:57,13670.0,2,8926,2,13665.0,30,13670.0,6,B
2018-04-02 14:26:58,13665.0,4,8930,4,13665.0,28,13670.0,6,S
2018-04-02 14:26:59,13665.0,8,8938,6,13665.0,24,13670.0,6,S
2018-04-02 14:26:59,13665.0,16,8954,12,13665.0,16,13670.0,6,S
2018-04-02 14:27:00,13670.0,34,8988,18,13670.0,6,13675.0,2,B
2018-04-02 14:27:00,13665.0,22,9010,22,13660.0,7,13665.0,1,S
2018-04-02 14:27:01,13665.0,2,9012,0,13660.0,6,13670.0,1,S
2018-04-02 14:28:00,13670.0,4,9016,0,13665.0,1,13670.0,1,B
2018-04-02 14:28:14,13670.0,4,9020,-2,13665.0,5,13675.0,5,B
2018-04-02 14:28:33,13670.0,2,9022,0,13665.0,5,13675.0,2,B
2018-04-02 14:28:35,13675.0,2,9024,-2,13665.0,5,13675.0,1,B
2018-04-02 14:29:23,13670.0,6,9030,-2,13665.0,6,13670.0,1,S
2018-04-02 14:29:24,13670.0,2,9032,-2,13670.0,2,13680.0,10,S
2018-04-02 14:29:28,13675.0,2,9034,2,13670.0,1,13680.0,10,B
2018-04-02 14:29:52,13680.0,10,9044,-2,13670.0,4,13680.0,7,B
2018-04-02 14:30:08,13680.0,2,9046,0,13670.0,4,13680.0,6,B
2018-04-02 14:30:09,13680.0,2,9048,0,13675.0,3,13680.0,3,B
2018-04-02 14:30:10,13680.0,6,9054,2,13675.0,3,13685.0,3,B
2018-04-02 14:30:28,13685.0,2,9056,0,13685.0,1,13690.0,5,B
2018-04-02 14:30:29,13685.0,4,9060,2,13685.0,1,13690.0,5,B
2018-04-02 14:30:31,13685.0,2,9062,0,13680.0,2,13690.0,5,B
2018-04-02 14:30:58,13680.0,2,9064,2,13680.0,2,13685.0,4,S
2018-04-02 14:30:59,13680.0,4,9068,2,13675.0,5,13680.0,1,S
2018-04-02 14:31:12,13675.0,2,9070,0,13670.0,4,13675.0,1,S
2018-04-02 14:31:12,13675.0,2,9072,0,13670.0,3,13685.0,14,S
2018-04-02 14:31:13,13670.0,2,9074,-2,13670.0,2,13680.0,3,S
2018-04-02 14:32:03,13680.0,2,9076,-2,13675.0,7,13685.0,15,B
2018-04-02 14:32:10,13685.0,2,9078,0,13675.0,5,13685.0,2,B
2018-04-02 14:32:11,13685.0,4,9082,0,13675.0,5,13690.0,5,B
2018-04-02 14:32:11,13690.0,2,9084,-2,13675.0,5,13690.0,11,B
2018-04-02 14:32:23,13690.0,4,9088,4,13680.0,6,13695.0,6,B
2018-04-02 14:32:51,13685.0,8,9096,-8,13680.0,1,13690.0,2,S
2018-04-02 14:33:37,13680.0,4,9100,2,13680.0,1,13690.0,3,S
2018-04-02 14:33:39,13680.0,2,9102,2,13675.0,5,13690.0,3,S
2018-04-02 14:35:07,13680.0,2,9104,0,13675.0,2,13685.0,4,S
2018-04-02 14:36:19,13685.0,2,9106,2,13675.0,3,13685.0,3,B
2018-04-02 14:36:20,13680.0,2,9108,-2,13675.0,3,13685.0,3,S
2018-04-02 14:37:16,13685.0,2,9110,-2,13675.0,3,13680.0,1,B
2018-04-02 14:37:17,13685.0,2,9112,-2,13675.0,3,13685.0,4,B
2018-04-02 14:37:17,13685.0,2,9114,0,13675.0,3,13685.0,3,B
2018-04-02 14:38:07,13680.0,2,9116,2,13675.0,2,13685.0,7,S
2018-04-02 14:38:40,13685.0,6,9122,-4,13675.0,3,13685.0,5,B
2018-04-02 14:39:05,13685.0,10,9132,10,13675.0,3,13685.0,2,B
2018-04-02 14:39:20,13685.0,4,9136,4,13675.0,4,13685.0,8,B
2018-04-02 14:39:21,13675.0,4,9140,-4,13675.0,3,13685.0,8,S
2018-04-02 14:39:48,13685.0,20,9160,16,13675.0,4,13685.0,1,B
2018-04-02 14:39:50,13675.0,2,9162,0,13675.0,4,13685.0,1,S
2018-04-02 14:40:04,13680.0,2,9164,0,13675.0,3,13685.0,6,B
2018-04-02 14:40:21,13680.0,2,9166,0,13675.0,7,13680.0,5,B
2018-04-02 14:40:22,13680.0,10,9176,0,13680.0,2,13685.0,4,B
2018-04-02 14:40:22,13680.0,4,9180,-4,13675.0,7,13685.0,4,B
2018-04-02 14:40:30,13685.0,8,9188,8,13685.0,6,13690.0,3,B
2018-04-02 14:40:30,13680.0,14,9202,12,13675.0,7,13685.0,2,S
2018-04-02 14:40:42,13680.0,2,9204,0,13675.0,7,13680.0,2,S
2018-04-02 14:40:50,13680.0,6,9210,6,13680.0,7,13685.0,3,S
2018-04-02 14:41:00,13680.0,6,9216,0,13680.0,4,13685.0,1,S
2018-04-02 14:41:01,13685.0,2,9218,0,13685.0,3,13690.0,5,B
2018-04-02 14:41:01,13685.0,6,9224,0,13680.0,1,13690.0,3,B
2018-04-02 14:41:20,13685.0,2,9226,0,13680.0,3,13685.0,2,B
2018-04-02 14:41:22,13685.0,4,9230,-4,13680.0,3,13690.0,1,B
2018-04-02 14:41:23,13685.0,2,9232,2,13680.0,3,13690.0,1,B
2018-04-02 14:41:37,13695.0,2,9234,-2,13685.0,4,13695.0,19,B
2018-04-02 14:41:45,13695.0,6,9240,-2,13685.0,1,13695.0,14,B
2018-04-02 14:41:49,13690.0,4,9244,4,13690.0,8,13695.0,16,S
2018-04-02 14:41:50,13690.0,2,9246,0,13690.0,7,13695.0,11,S
2018-04-02 14:41:50,13690.0,2,9248,2,13690.0,6,13695.0,19,S
2018-04-02 14:41:57,13690.0,14,9262,10,13685.0,2,13690.0,5,S
2018-04-02 14:41:58,13690.0,2,9264,2,13685.0,2,13690.0,11,S
2018-04-02 14:42:07,13690.0,2,9266,0,13685.0,2,13695.0,11,S
2018-04-02 14:42:10,13690.0,4,9270,4,13685.0,4,13690.0,5,S
2018-04-02 14:42:21,13690.0,10,9280,10,13690.0,5,13695.0,18,S
2018-04-02 14:42:28,13695.0,12,9292,0,13690.0,5,13700.0,48,B
2018-04-02 14:42:37,13700.0,10,9302,10,13690.0,1,13700.0,44,B
2018-04-02 14:42:37,13695.0,2,9304,2,13690.0,1,13700.0,50,S
2018-04-02 14:43:02,13700.0,40,9344,36,13690.0,6,13700.0,20,B
2018-04-02 14:43:13,13700.0,40,9384,40,13690.0,14,13700.0,1,B
2018-04-02 14:43:13,13700.0,2,9386,-2,13690.0,14,13700.0,1,B
2018-04-02 14:43:28,13695.0,2,9388,0,13695.0,10,13700.0,5,S
2018-04-02 14:43:31,13695.0,4,9392,-4,13695.0,8,13700.0,13,S
2018-04-02 14:43:56,13695.0,16,9408,0,13695.0,1,13700.0,13,S
2018-04-02 14:43:56,13695.0,2,9410,0,13690.0,2,13700.0,12,S
2018-04-02 14:44:19,13700.0,2,9412,0,13690.0,7,13700.0,2,B
2018-04-02 14:44:22,13700.0,4,9416,4,13700.0,8,13705.0,3,B
2018-04-02 14:44:28,13705.0,2,9418,2,13700.0,8,13705.0,6,B
2018-04-02 14:44:28,13710.0,14,9432,12,13700.0,2,13710.0,4,B
2018-04-02 14:44:33,13700.0,2,9434,2,13700.0,1,13705.0,2,S
2018-04-02 14:44:37,13705.0,2,9436,2,13700.0,1,13710.0,6,B
2018-04-02 14:44:38,13700.0,6,9442,4,13695.0,1,13700.0,2,S
2018-04-02 14:44:39,13700.0,4,9446,4,13695.0,2,13710.0,7,S
2018-04-02 14:44:52,13700.0,2,9448,-2,13700.0,1,13710.0,3,S
2018-04-02 14:44:55,13710.0,2,9450,2,13700.0,4,13710.0,2,B
2018-04-02 14:45:15,13710.0,4,9454,4,13705.0,6,13710.0,2,B
2018-04-02 14:45:16,13710.0,2,9456,0,13705.0,6,13710.0,1,B
2018-04-02 14:45:18,13705.0,2,9458,2,13705.0,5,13710.0,4,S
2018-04-02 14:45:19,13705.0,6,9464,0,13705.0,2,13710.0,6,S
2018-04-02 14:45:19,13705.0,2,9466,0,13705.0,1,13710.0,6,S
2018-04-02 14:45:20,13705.0,2,9468,2,13700.0,3,13710.0,6,S
2018-04-02 14:45:26,13705.0,2,9470,0,13700.0,2,13705.0,10,S
2018-04-02 14:45:28,13705.0,8,9478,0,13700.0,2,13705.0,6,S
2018-04-02 14:45:29,13700.0,2,9480,2,13700.0,1,13705.0,6,S
2018-04-02 14:45:37,13700.0,2,9482,2,13700.0,2,13705.0,6,S
2018-04-02 14:45:48,13700.0,2,9484,2,13700.0,1,13705.0,6,S
2018-04-02 14:46:20,13700.0,2,9486,2,13700.0,1,13705.0,7,S
2018-04-02 14:46:24,13700.0,2,9488,0,13695.0,3,13705.0,7,S
2018-04-02 14:46:29,13705.0,14,9502,14,13705.0,3,13710.0,5,B
2018-04-02 14:46:48,13710.0,4,9506,4,13710.0,1,13715.0,7,B
2018-04-02 14:46:49,13710.0,2,9508,2,13700.0,4,13715.0,8,B
2018-04-02 14:47:05,13700.0,2,9510,0,13695.0,7,13705.0,2,S
2018-04-02 14:47:06,13705.0,2,9512,2,13695.0,6,13705.0,4,B
2018-04-02 14:47:09,13695.0,2,9514,2,13695.0,3,13705.0,5,S
2018-04-02 14:47:11,13705.0,2,9516,0,13695.0,3,13705.0,4,B
2018-04-02 14:47:11,13705.0,4,9520,0,13695.0,3,13705.0,2,B
2018-04-02 14:47:18,13695.0,2,9522,0,13695.0,2,13700.0,1,S
2018-04-02 14:47:19,13695.0,2,9524,-2,13695.0,1,13700.0,2,S
2018-04-02 14:47:20,13695.0,2,9526,-2,13690.0,5,13700.0,2,S
2018-04-02 14:47:22,13690.0,2,9528,0,13690.0,3,13700.0,3,S
2018-04-02 14:47:27,13690.0,4,9532,2,13690.0,2,13700.0,3,S
2018-04-02 14:47:28,13690.0,2,9534,0,13690.0,1,13700.0,2,S
2018-04-02 14:47:28,13690.0,2,9536,-2,13685.0,6,13700.0,2,S
2018-04-02 14:47:31,13690.0,2,9538,-2,13685.0,5,13695.0,1,S
2018-04-02 14:47:37,13695.0,2,9540,0,13685.0,5,13695.0,1,B
2018-04-02 14:47:40,13690.0,2,9542,0,13690.0,2,13695.0,1,S
2018-04-02 14:47:41,13695.0,2,9544,0,13690.0,2,13695.0,1,B
2018-04-02 14:47:42,13700.0,2,9546,0,13690.0,2,13700.0,5,B
2018-04-02 14:47:42,13700.0,2,9548,0,13690.0,2,13700.0,5,B
2018-04-02 14:47:43,13690.0,2,9550,0,13690.0,1,13700.0,5,S
2018-04-02 14:47:55,13690.0,2,9552,-2,13690.0,2,13700.0,3,S
2018-04-02 14:48:01,13695.0,2,9554,2,13695.0,9,13700.0,7,B
2018-04-02 14:48:02,13695.0,6,9560,4,13695.0,7,13700.0,6,B
2018-04-02 14:48:02,13695.0,2,9562,0,13695.0,6,13700.0,4,B
2018-04-02 14:48:03,13695.0,2,9564,0,13695.0,5,13705.0,4,B
2018-04-02 14:48:04,13695.0,2,9566,0,13695.0,4,13705.0,6,B
2018-04-02 14:48:05,13695.0,2,9568,0,13695.0,4,13705.0,6,B
2018-04-02 14:48:06,13695.0,2,9570,0,13695.0,3,13705.0,6,B
2018-04-02 14:48:06,13695.0,2,9572,0,13695.0,2,13705.0,4,B
2018-04-02 14:48:07,13695.0,2,9574,0,13695.0,1,13705.0,4,B
2018-04-02 14:48:08,13695.0,2,9576,-2,13690.0,1,13705.0,4,B
2018-04-02 14:48:10,13700.0,2,9578,-2,13690.0,2,13700.0,6,B
2018-04-02 14:48:28,13690.0,2,9580,-2,13690.0,1,13695.0,6,S
2018-04-02 14:48:34,13690.0,2,9582,0,13685.0,3,13690.0,8,S
2018-04-02 14:48:40,13685.0,2,9584,-2,13685.0,2,13690.0,2,S
2018-04-02 14:48:43,13680.0,10,9594,2,13680.0,3,13690.0,3,S
2018-04-02 14:48:48,13690.0,18,9612,8,13690.0,1,13695.0,9,B
2018-04-02 14:48:49,13690.0,2,9614,2,13680.0,5,13690.0,8,B
2018-04-02 14:48:53,13685.0,2,9616,-2,13680.0,5,13690.0,1,S
2018-04-02 14:49:05,13695.0,4,9620,0,13685.0,2,13695.0,10,B
2018-04-02 14:49:22,13685.0,6,9626,-4,13680.0,5,13685.0,9,S
2018-04-02 14:49:22,13685.0,12,9638,-4,13680.0,5,13685.0,3,S
2018-04-02 14:49:24,13685.0,6,9644,0,13685.0,7,13695.0,9,S
2018-04-02 14:49:27,13685.0,2,9646,0,13685.0,6,13695.0,12,S
2018-04-02 14:49:35,13695.0,12,9658,12,13685.0,1,13695.0,4,B
2018-04-02 14:49:51,13690.0,2,9660,2,13690.0,9,13695.0,3,S
2018-04-02 14:50:01,13695.0,2,9662,-2,13695.0,9,13700.0,9,B
2018-04-02 14:50:01,13695.0,2,9664,2,13695.0,10,13700.0,7,B
2018-04-02 14:50:11,13700.0,10,9674,6,13700.0,3,13705.0,4,B
2018-04-02 14:50:11,13700.0,6,9680,4,13690.0,3,13700.0,4,B
2018-04-02 14:50:18,13695.0,4,9684,0,13690.0,3,13700.0,2,S
2018-04-02 14:50:37,13700.0,14,9698,12,13700.0,3,13705.0,6,B
2018-04-02 14:50:37,13700.0,6,9704,2,13690.0,5,13700.0,3,B
2018-04-02 14:50:40,13695.0,2,9706,0,13690.0,5,13695.0,1,S
2018-04-02 14:50:40,13695.0,2,9708,0,13690.0,5,13700.0,2,S
2018-04-02 14:50:46,13695.0,2,9710,0,13690.0,5,13700.0,3,S
2018-04-02 14:50:50,13690.0,2,9712,2,13690.0,4,13700.0,3,S
2018-04-02 14:50:54,13700.0,16,9728,16,13700.0,2,13705.0,6,B
2018-04-02 14:50:54,13700.0,4,9732,4,13690.0,4,13700.0,5,B
2018-04-02 14:51:03,13695.0,2,9734,-2,13690.0,4,13695.0,1,S
2018-04-02 14:51:06,13695.0,2,9736,0,13695.0,14,13700.0,13,S
2018-04-02 14:51:11,13695.0,8,9744,8,13695.0,10,13700.0,13,S
2018-04-02 14:51:15,13695.0,20,9764,20,13690.0,6,13700.0,13,S
2018-04-02 14:51:23,13690.0,2,9766,2,13690.0,5,13700.0,15,S
2018-04-02 14:51:27,13700.0,30,9796,30,13690.0,5,13700.0,3,B
2018-04-02 14:51:35,13695.0,4,9800,-4,13690.0,5,13700.0,2,S
2018-04-02 14:52:01,13690.0,2,9802,0,13690.0,5,13700.0,17,S
2018-04-02 14:52:20,13700.0,2,9804,0,13695.0,1,13700.0,16,B
2018-04-02 14:52:21,13700.0,4,9808,-2,13695.0,2,13700.0,14,B
2018-04-02 14:52:21,13700.0,4,9812,-4,13695.0,3,13700.0,12,B
2018-04-02 14:52:22,13700.0,4,9816,0,13695.0,4,13700.0,10,B
2018-04-02 14:52:22,13700.0,4,9820,0,13695.0,4,13700.0,8,B
2018-04-02 14:52:24,13695.0,2,9822,0,13695.0,1,13700.0,8,S
2018-04-02 14:52:50,13700.0,8,9830,4,13695.0,4,13700.0,4,B
2018-04-02 14:52:50,13695.0,6,9836,-2,13695.0,1,13700.0,4,S
2018-04-02 14:52:57,13700.0,2,9838,0,13695.0,2,13700.0,3,B
2018-04-02 14:53:12,13700.0,2,9840,0,13690.0,6,13700.0,2,B
2018-04-02 14:54:36,13700.0,2,9842,2,13690.0,12,13700.0,2,B
2018-04-02 14:54:37,13695.0,2,9844,0,13695.0,2,13700.0,2,S
2018-04-02 14:54:41,13695.0,2,9846,0,13695.0,3,13700.0,3,S
2018-04-02 14:54:57,13700.0,4,9850,2,13695.0,3,13700.0,2,B
2018-04-02 14:55:08,13695.0,2,9852,0,13695.0,6,13700.0,2,S
2018-04-02 14:55:10,13695.0,4,9856,0,13695.0,4,13700.0,2,S
2018-04-02 14:55:23,13695.0,4,9860,0,13695.0,1,13700.0,2,S
2018-04-02 14:55:24,13695.0,2,9862,0,13690.0,12,13700.0,2,S
2018-04-02 14:55:52,13700.0,6,9868,0,13690.0,11,13705.0,7,B
2018-04-02 14:55:53,13705.0,2,9870,2,13695.0,1,13705.0,4,B
2018-04-02 14:55:54,13705.0,2,9872,0,13695.0,4,13705.0,2,B
2018-04-02 14:55:57,13700.0,2,9874,0,13695.0,4,13705.0,2,S
2018-04-02 14:56:36,13695.0,2,9876,0,13695.0,2,13700.0,3,S
2018-04-02 14:56:51,13695.0,2,9878,-2,13695.0,2,13700.0,3,S
2018-04-02 14:57:05,13695.0,2,9880,0,13695.0,5,13700.0,3,S
2018-04-02 14:57:07,13700.0,2,9882,2,13695.0,5,13700.0,2,B
2018-04-02 14:57:11,13695.0,10,9892,0,13690.0,31,13695.0,5,S
2018-04-02 14:57:12,13695.0,4,9896,4,13690.0,31,13695.0,3,S
2018-04-02 14:57:16,13690.0,20,9916,2,13690.0,20,13695.0,3,S
2018-04-02 14:57:16,13690.0,2,9918,2,13690.0,19,13695.0,3,S
2018-04-02 14:57:17,13690.0,20,9938,20,13690.0,9,13695.0,3,S
2018-04-02 14:57:21,13690.0,18,9956,18,13685.0,8,13690.0,1,S
2018-04-02 14:57:24,13690.0,2,9958,0,13690.0,4,13695.0,4,S
2018-04-02 14:57:47,13690.0,8,9966,0,13685.0,7,13690.0,6,S
2018-04-02 14:58:00,13705.0,40,10006,-6,13685.0,7,13705.0,2,B
2018-04-02 14:58:04,13685.0,16,10022,-16,13680.0,2,13685.0,2,S
2018-04-02 14:58:04,13685.0,4,10026,0,13680.0,2,13700.0,2,S
2018-04-02 14:58:07,13690.0,2,10028,-2,13680.0,2,13695.0,1,B
2018-04-02 14:58:22,13695.0,2,10030,0,13685.0,2,13700.0,7,B
2018-04-02 14:58:33,13700.0,4,10034,0,13690.0,1,13700.0,6,B
2018-04-02 14:58:46,13690.0,2,10036,-2,13690.0,2,13695.0,3,S
2018-04-02 14:58:56,13695.0,4,10040,0,13690.0,2,13695.0,1,B
2018-04-02 14:59:02,13695.0,2,10042,0,13690.0,3,13700.0,9,B
2018-04-02 14:59:08,13690.0,2,10044,-2,13685.0,2,13700.0,9,S
2018-04-02 14:59:09,13685.0,2,10046,-2,13685.0,1,13700.0,11,S
2018-04-02 14:59:17,13695.0,22,10068,0,13695.0,7,13700.0,12,B
2018-04-02 14:59:18,13695.0,14,10082,-6,13685.0,4,13695.0,1,B
2018-04-02 14:59:30,13695.0,2,10084,0,13685.0,4,13695.0,22,B
2018-04-02 14:59:39,13685.0,4,10088,0,13680.0,2,13685.0,1,S
2018-04-02 14:59:40,13685.0,2,10090,2,13680.0,2,13695.0,24,S
2018-04-02 14:59:44,13685.0,2,10092,-2,13685.0,3,13695.0,23,S
2018-04-02 14:59:46,13695.0,2,10094,0,13685.0,3,13695.0,22,B
2018-04-02 14:59:49,13695.0,2,10096,0,13685.0,3,13695.0,21,B
2018-04-02 21:00:00,13695.0,4,4,52630,0.0,0,0.0,0,B
2018-04-02 21:00:01,13695.0,6,10,6,13675.0,1,13695.0,2,B
2018-04-02 21:00:01,13675.0,2,12,0,13670.0,2,13690.0,2,S
2018-04-02 21:00:02,13670.0,14,26,6,13665.0,4,13670.0,4,S
2018-04-02 21:00:02,13670.0,8,34,6,13670.0,1,13685.0,22,S
2018-04-02 21:00:04,13665.0,4,38,0,13660.0,4,13665.0,8,S
2018-04-02 21:00:05,13665.0,2,40,0,13660.0,2,13665.0,7,S
2018-04-02 21:00:06,13665.0,18,58,-4,13655.0,6,13685.0,46,S
2018-04-02 21:00:13,13670.0,2,60,2,13665.0,3,13690.0,28,B
2018-04-02 21:00:21,13675.0,14,74,14,13670.0,1,13675.0,3,B
2018-04-02 21:00:22,13675.0,6,80,6,13675.0,4,13690.0,1,B
2018-04-02 21:00:29,13675.0,4,84,0,13675.0,4,13690.0,6,B
2018-04-02 21:00:34,13670.0,4,88,2,13665.0,1,13670.0,8,S
2018-04-02 21:00:34,13670.0,8,96,8,13665.0,1,13670.0,4,S
2018-04-02 21:00:35,13670.0,8,104,4,13675.0,1,13685.0,2,S
2018-04-02 21:00:37,13675.0,2,106,0,13670.0,6,13685.0,2,B
2018-04-02 21:00:41,13685.0,2,108,2,13675.0,1,13685.0,1,B
2018-04-02 21:00:42,13675.0,2,110,-2,13670.0,6,13685.0,1,S
2018-04-02 21:00:43,13670.0,12,122,6,13665.0,1,13670.0,4,S
2018-04-02 21:00:44,13670.0,8,130,0,13670.0,7,13685.0,1,S
2018-04-02 21:00:44,13685.0,2,132,0,13665.0,5,13690.0,6,B
2018-04-02 21:00:48,13685.0,2,134,-2,13675.0,2,13685.0,5,B
2018-04-02 21:00:55,13690.0,2,136,0,13675.0,3,13690.0,7,B
2018-04-02 21:01:03,13690.0,16,152,6,13690.0,12,13695.0,3,B
2018-04-02 21:01:04,13690.0,24,176,20,13675.0,12,13690.0,1,B
2018-04-02 21:01:06,13685.0,2,178,2,13680.0,2,13690.0,2,S
2018-04-02 21:01:10,13685.0,2,180,2,13680.0,1,13685.0,1,S
2018-04-02 21:01:12,13690.0,38,218,24,13690.0,1,13695.0,15,B
2018-04-02 21:01:13,13690.0,4,222,2,13685.0,1,13690.0,3,B
2018-04-02 21:01:19,13680.0,4,226,-2,13680.0,1,13685.0,1,S
2018-04-02 21:01:20,13680.0,2,228,0,13675.0,12,13680.0,1,S
2018-04-02 21:01:21,13680.0,4,232,-2,13675.0,12,13685.0,8,S
2018-04-02 21:01:28,13680.0,20,252,20,13680.0,2,13685.0,14,S
2018-04-02 21:01:30,13680.0,4,256,2,13675.0,11,13685.0,14,S
2018-04-02 21:01:39,13675.0,2,258,0,13675.0,10,13680.0,13,S
2018-04-02 21:01:40,13680.0,2,260,0,13675.0,11,13680.0,13,B
2018-04-02 21:01:43,13680.0,22,282,16,13675.0,11,13680.0,2,B
2018-04-02 21:01:47,13680.0,42,324,-2,13675.0,10,13680.0,2,B
2018-04-02 21:01:47,13675.0,16,340,0,13675.0,3,13685.0,12,S
2018-04-02 21:01:49,13675.0,2,342,0,13675.0,2,13680.0,4,S
2018-04-02 21:01:53,13675.0,2,344,0,13675.0,1,13680.0,4,S
2018-04-02 21:01:53,13675.0,2,346,0,13670.0,3,13675.0,1,S
2018-04-02 21:01:54,13675.0,2,348,2,13670.0,3,13680.0,5,S
2018-04-02 21:02:00,13680.0,20,368,20,13670.0,3,13680.0,1,B
2018-04-02 21:02:03,13670.0,2,370,-2,13670.0,2,13680.0,1,S
2018-04-02 21:02:03,13670.0,4,374,0,13665.0,7,13670.0,8,S
2018-04-02 21:02:04,13670.0,16,390,16,13665.0,5,13680.0,2,S
2018-04-02 21:02:05,13670.0,2,392,0,13670.0,9,13675.0,5,S
2018-04-02 21:02:05,13675.0,10,402,10,13670.0,9,13680.0,3,B
2018-04-02 21:02:08,13670.0,2,404,0,13670.0,8,13680.0,3,S
2018-04-02 21:02:12,13670.0,2,406,0,13670.0,10,13680.0,3,S
2018-04-02 21:02:14,13680.0,6,412,6,13680.0,7,13685.0,12,B
2018-04-02 21:02:15,13680.0,10,422,8,13680.0,3,13685.0,10,B
2018-04-02 21:02:16,13680.0,4,426,4,13680.0,1,13685.0,9,B
2018-04-02 21:02:17,13680.0,2,428,0,13670.0,10,13685.0,9,B
2018-04-02 21:02:18,13680.0,2,430,2,13670.0,10,13680.0,3,B
2018-04-02 21:02:25,13680.0,20,450,18,13675.0,3,13680.0,6,B
2018-04-02 21:02:26,13680.0,2,452,0,13675.0,3,13680.0,5,B
2018-04-02 21:02:28,13675.0,2,454,0,13675.0,2,13680.0,5,S
2018-04-02 21:02:35,13680.0,10,464,10,13680.0,5,13685.0,9,B
2018-04-02 21:02:38,13685.0,4,468,4,13680.0,7,13685.0,7,B
2018-04-02 21:02:42,13680.0,2,470,0,13680.0,6,13685.0,7,S
2018-04-02 21:02:49,13680.0,4,474,0,13680.0,2,13685.0,7,S
2018-04-02 21:02:51,13680.0,2,476,2,13680.0,1,13685.0,7,S
2018-04-02 21:03:00,13680.0,2,478,2,13680.0,1,13685.0,8,S
2018-04-02 21:03:02,13680.0,2,480,2,13680.0,3,13685.0,8,S
2018-04-02 21:03:17,13685.0,14,494,0,13680.0,1,13685.0,1,B
2018-04-02 21:03:24,13685.0,2,496,2,13680.0,3,13690.0,17,B
2018-04-02 21:03:26,13690.0,4,500,2,13690.0,3,13695.0,2,B
2018-04-02 21:03:32,13690.0,2,502,0,13690.0,1,13695.0,2,B
2018-04-02 21:03:35,13690.0,8,510,2,13690.0,1,13700.0,3,B
2018-04-02 21:03:38,13700.0,6,516,6,13700.0,5,13705.0,2,B
2018-04-02 21:03:38,13700.0,4,520,2,13700.0,3,13705.0,2,B
2018-04-02 21:03:40,13705.0,4,524,4,13700.0,3,13710.0,15,B
2018-04-02 21:03:42,13700.0,6,530,0,13700.0,1,13710.0,3,S
2018-04-02 21:03:43,13710.0,6,536,4,13710.0,3,13715.0,14,B
2018-04-02 21:03:44,13710.0,10,546,-2,13700.0,2,13710.0,1,B
2018-04-02 21:03:47,13700.0,4,550,-2,13690.0,5,13700.0,3,S
2018-04-02 21:03:47,13700.0,6,556,-2,13695.0,6,13710.0,3,S
2018-04-02 21:03:48,13700.0,4,560,-2,13700.0,2,13710.0,3,S
2018-04-02 21:03:49,13710.0,4,564,2,13700.0,2,13710.0,1,B
2018-04-02 21:03:50,13705.0,2,566,2,13705.0,1,13710.0,3,S
2018-04-02 21:03:51,13705.0,2,568,0,13700.0,4,13710.0,3,S
2018-04-02 21:03:54,13710.0,4,572,-2,13700.0,8,13710.0,3,B
2018-04-02 21:03:57,13710.0,6,578,6,13705.0,4,13715.0,3,B
2018-04-02 21:03:58,13715.0,4,582,2,13710.0,1,13715.0,1,B
2018-04-02 21:03:59,13720.0,6,588,4,13710.0,1,13725.0,1,B
2018-04-02 21:04:00,13715.0,2,590,0,13710.0,3,13720.0,1,S
2018-04-02 21:04:02,13715.0,4,594,0,13705.0,1,13720.0,1,S
2018-04-02 21:04:04,13715.0,2,596,0,13710.0,9,13720.0,2,S
2018-04-02 21:04:06,13720.0,2,598,0,13720.0,8,13725.0,3,B
2018-04-02 21:04:06,13725.0,4,602,-2,13720.0,9,13730.0,2,B
2018-04-02 21:04:07,13730.0,2,604,0,13725.0,2,13735.0,2,B
2018-04-02 21:04:08,13735.0,2,606,2,13730.0,6,13735.0,1,B
2018-04-02 21:04:08,13735.0,2,608,0,13730.0,1,13740.0,2,B
2018-04-02 21:04:09,13735.0,2,610,0,13730.0,2,13735.0,1,B
2018-04-02 21:04:09,13730.0,4,614,0,13725.0,8,13735.0,1,S
2018-04-02 21:04:11,13735.0,2,616,0,13725.0,6,13735.0,2,B
2018-04-02 21:04:12,13730.0,2,618,-2,13725.0,2,13735.0,2,S
2018-04-02 21:04:13,13730.0,2,620,-2,13730.0,1,13735.0,2,S
2018-04-02 21:04:17,13730.0,4,624,0,13725.0,1,13735.0,9,S
2018-04-02 21:04:18,13725.0,2,626,2,13715.0,24,13730.0,1,S
2018-04-02 21:04:20,13725.0,2,628,0,13720.0,3,13730.0,1,S
2018-04-02 21:04:36,13715.0,4,632,0,13710.0,8,13720.0,1,S
2018-04-02 21:04:37,13715.0,2,634,-2,13715.0,1,13720.0,2,S
2018-04-02 21:04:39,13715.0,2,636,2,13715.0,2,13720.0,2,S
2018-04-02 21:04:40,13715.0,2,638,-2,13710.0,3,13720.0,2,S
2018-04-02 21:04:41,13710.0,4,642,0,13710.0,1,13715.0,1,S
2018-04-02 21:04:46,13710.0,4,646,-2,13705.0,10,13710.0,3,S
2018-04-02 21:04:46,13710.0,2,648,-2,13705.0,10,13710.0,2,S
2018-04-02 21:04:47,13710.0,4,652,0,13705.0,10,13715.0,1,S
2018-04-02 21:04:51,13710.0,2,654,0,13705.0,10,13710.0,1,S
2018-04-02 21:05:01,13710.0,2,656,0,13705.0,18,13715.0,1,S
2018-04-02 21:05:02,13710.0,4,660,0,13705.0,18,13715.0,1,S
2018-04-02 21:05:10,13715.0,2,662,2,13705.0,21,13720.0,4,B
2018-04-02 21:05:13,13715.0,2,664,2,13715.0,6,13720.0,2,B
2018-04-02 21:05:13,13720.0,2,666,0,13715.0,6,13720.0,1,B
2018-04-02 21:05:14,13720.0,4,670,0,13715.0,6,13725.0,4,B
2018-04-02 21:05:22,13725.0,4,674,0,13725.0,8,13730.0,5,B
2018-04-02 21:05:27,13730.0,6,680,0,13725.0,6,13735.0,11,B
2018-04-02 21:05:28,13735.0,6,686,-4,13730.0,6,13735.0,8,B
2018-04-02 21:05:29,13735.0,16,702,2,13730.0,6,13740.0,5,B
2018-04-02 21:05:30,13740.0,4,706,0,13735.0,4,13740.0,2,B
2018-04-02 21:05:30,13740.0,4,710,-4,13740.0,1,13745.0,2,B
2018-04-02 21:05:31,13740.0,2,712,-2,13735.0,4,13745.0,4,B
2018-04-02 21:05:32,13740.0,2,714,2,13740.0,5,13745.0,4,B
2018-04-02 21:05:33,13745.0,4,718,0,13740.0,5,13750.0,10,B
2018-04-02 21:05:34,13750.0,2,720,0,13740.0,5,13750.0,9,B
2018-04-02 21:05:35,13740.0,2,722,0,13740.0,4,13745.0,1,S
2018-04-02 21:05:35,13740.0,8,730,6,13735.0,4,13745.0,4,S
2018-04-02 21:05:45,13735.0,2,732,2,13735.0,3,13740.0,5,S
2018-04-02 21:05:46,13735.0,6,738,4,13730.0,2,13735.0,2,S
2018-04-02 21:05:47,13730.0,2,740,2,13725.0,4,13735.0,4,S
2018-04-02 21:05:48,13725.0,2,742,0,13725.0,1,13730.0,1,S
2018-04-02 21:05:49,13725.0,2,744,2,13715.0,6,13730.0,1,S
2018-04-02 21:05:56,13730.0,2,746,0,13720.0,4,13730.0,1,B
2018-04-02 21:05:57,13725.0,2,748,0,13725.0,1,13730.0,1,S
2018-04-02 21:06:00,13730.0,2,750,0,13725.0,1,13730.0,1,B
2018-04-02 21:06:01,13730.0,2,752,2,13720.0,4,13730.0,1,B
2018-04-02 21:06:04,13730.0,2,754,2,13725.0,2,13730.0,1,B
2018-04-02 21:06:06,13730.0,2,756,2,13725.0,2,13735.0,9,B
2018-04-02 21:06:17,13725.0,2,758,2,13720.0,1,13725.0,6,S
2018-04-02 21:06:23,13715.0,2,760,0,13715.0,5,13725.0,3,S
2018-04-02 21:06:28,13730.0,4,764,4,13720.0,2,13730.0,4,B
2018-04-02 21:06:35,13720.0,4,768,4,13715.0,5,13730.0,4,S
2018-04-02 21:06:38,13730.0,4,772,4,13720.0,1,13730.0,2,B
2018-04-02 21:06:39,13730.0,2,774,0,13720.0,1,13730.0,1,B
2018-04-02 21:07:01,13725.0,2,776,2,13720.0,1,13725.0,2,S
2018-04-02 21:07:23,13715.0,2,778,-2,13715.0,4,13720.0,3,S
2018-04-02 21:07:26,13715.0,6,784,-6,13710.0,7,13715.0,2,S
2018-04-02 21:07:40,13710.0,4,788,0,13705.0,6,13715.0,2,S
2018-04-02 21:07:55,13715.0,4,792,0,13710.0,5,13720.0,3,B
2018-04-02 21:08:21,13710.0,2,794,0,13705.0,11,13715.0,15,S
2018-04-02 21:08:24,13715.0,4,798,4,13705.0,9,13710.0,2,B
2018-04-02 21:08:32,13705.0,18,816,-18,13700.0,11,13705.0,2,S
2018-04-02 21:08:32,13705.0,4,820,0,13705.0,1,13710.0,2,S
2018-04-02 21:08:41,13705.0,4,824,0,13700.0,15,13710.0,4,S
2018-04-02 21:08:43,13705.0,2,826,0,13705.0,1,13710.0,4,S
2018-04-02 21:08:48,13705.0,4,830,-4,13700.0,15,13705.0,3,S
2018-04-02 21:08:49,13705.0,2,832,-2,13700.0,14,13705.0,2,S
2018-04-02 21:08:49,13705.0,4,836,-4,13700.0,14,13710.0,4,S
2018-04-02 21:08:50,13710.0,2,838,0,13700.0,14,13710.0,3,B
2018-04-02 21:09:07,13700.0,14,852,-12,13700.0,2,13705.0,2,S
2018-04-02 21:09:09,13705.0,2,854,-2,13700.0,2,13705.0,1,B
2018-04-02 21:09:12,13700.0,2,856,0,13700.0,1,13705.0,2,S
2018-04-02 21:09:18,13700.0,2,858,-2,13695.0,2,13705.0,2,S
2018-04-02 21:09:36,13700.0,2,860,0,13695.0,7,13705.0,4,S
2018-04-02 21:09:36,13705.0,2,862,-2,13695.0,8,13705.0,3,B
2018-04-02 21:09:40,13700.0,2,864,2,13695.0,8,13705.0,3,S
2018-04-02 21:09:41,13705.0,2,866,2,13695.0,8,13705.0,3,B
2018-04-02 21:10:07,13705.0,2,868,0,13700.0,1,13705.0,3,B
2018-04-02 21:10:07,13705.0,4,872,-2,13700.0,6,13705.0,1,B
2018-04-02 21:10:08,13710.0,6,878,-4,13700.0,7,13710.0,2,B
2018-04-02 21:10:21,13710.0,2,880,-2,13705.0,7,13715.0,2,B
2018-04-02 21:10:30,13710.0,2,882,2,13705.0,1,13710.0,1,B
2018-04-02 21:10:48,13705.0,2,884,0,13705.0,1,13710.0,1,S
2018-04-02 21:11:24,13700.0,14,898,12,13695.0,4,13705.0,1,S
2018-04-02 21:11:26,13695.0,6,904,2,13690.0,3,13700.0,8,S
2018-04-02 21:11:26,13690.0,2,906,-2,13690.0,4,13700.0,8,S
2018-04-02 21:11:29,13695.0,2,908,2,13690.0,1,13695.0,1,B
2018-04-02 21:11:41,13690.0,2,910,-2,13690.0,3,13695.0,1,S
2018-04-02 21:11:42,13695.0,2,912,-2,13690.0,5,13700.0,9,B
2018-04-02 21:11:57,13695.0,2,914,-2,13695.0,2,13700.0,9,B
2018-04-02 21:11:58,13700.0,2,916,0,13695.0,3,13700.0,8,B
2018-04-02 21:12:10,13690.0,16,932,-14,13685.0,6,13690.0,2,S
2018-04-02 21:12:11,13690.0,4,936,0,13695.0,1,13700.0,9,S
2018-04-02 21:12:11,13695.0,4,940,0,13690.0,1,13700.0,9,B
2018-04-02 21:12:23,13695.0,4,944,0,13690.0,6,13695.0,1,B
2018-04-02 21:12:34,13695.0,2,946,0,13695.0,1,13700.0,11,B
2018-04-02 21:12:35,13700.0,8,954,0,13695.0,6,13700.0,7,B
2018-04-02 21:12:35,13700.0,2,956,2,13695.0,6,13700.0,6,B
2018-04-02 21:12:37,13700.0,6,962,0,13695.0,6,13700.0,3,B
2018-04-02 21:12:38,13700.0,6,968,0,13695.0,16,13700.0,1,B
2018-04-02 21:12:38,13705.0,4,972,0,13695.0,16,13705.0,2,B
2018-04-02 21:12:45,13700.0,2,974,0,13700.0,1,13705.0,2,S
2018-04-02 21:13:40,13705.0,2,976,0,13700.0,2,13705.0,1,B
2018-04-02 21:14:13,13700.0,2,978,0,13700.0,1,13705.0,1,S
2018-04-02 21:14:19,13705.0,2,980,0,13700.0,17,13710.0,6,B
2018-04-02 21:14:43,13710.0,10,990,-4,13700.0,2,13710.0,3,B
2018-04-02 21:14:56,13710.0,2,992,2,13700.0,4,13710.0,1,B
2018-04-02 21:15:12,13705.0,2,994,-2,13700.0,2,13705.0,1,S
2018-04-02 21:15:18,13700.0,2,996,2,13700.0,1,13705.0,2,S
2018-04-02 21:15:21,13700.0,2,998,-2,13695.0,2,13705.0,2,S
2018-04-02 21:15:42,13700.0,2,1000,0,13700.0,3,13710.0,1,S
2018-04-02 21:16:16,13710.0,6,1006,2,13710.0,12,13715.0,28,B
2018-04-02 21:16:17,13710.0,24,1030,20,13700.0,4,13710.0,2,B
2018-04-02 21:16:19,13710.0,2,1032,2,13700.0,6,13710.0,2,B
2018-04-02 21:16:33,13710.0,2,1034,0,13700.0,6,13710.0,1,B
2018-04-02 21:16:44,13710.0,4,1038,2,13710.0,1,13715.0,29,B
2018-04-02 21:16:44,13710.0,2,1040,0,13700.0,7,13710.0,2,B
2018-04-02 21:16:54,13710.0,2,1042,2,13700.0,7,13710.0,1,B
2018-04-02 21:17:02,13710.0,2,1044,2,13700.0,7,13715.0,28,B
2018-04-02 21:18:02,13705.0,4,1048,4,13700.0,1,13705.0,3,S
2018-04-02 21:18:09,13700.0,4,1052,2,13695.0,5,13700.0,6,S
2018-04-02 21:18:10,13700.0,8,1060,8,13695.0,5,13700.0,2,S
2018-04-02 21:18:16,13695.0,2,1062,2,13695.0,5,13700.0,2,S
2018-04-02 21:18:26,13695.0,2,1064,2,13695.0,4,13700.0,3,S
2018-04-02 21:18:26,13695.0,2,1066,-2,13695.0,3,13700.0,4,S
2018-04-02 21:18:27,13700.0,2,1068,2,13695.0,3,13700.0,3,B
2018-04-02 21:18:29,13695.0,4,1072,2,13695.0,1,13700.0,5,S
2018-04-02 21:18:40,13695.0,2,1074,0,13695.0,1,13700.0,5,S
2018-04-02 21:18:45,13695.0,2,1076,2,13695.0,1,13700.0,6,S
2018-04-02 21:18:48,13700.0,4,1080,-2,13695.0,1,13700.0,4,B
2018-04-02 21:18:52,13695.0,2,1082,2,13695.0,1,13700.0,4,S
2018-04-02 21:18:53,13695.0,2,1084,-2,13695.0,1,13700.0,4,S
2018-04-02 21:18:56,13695.0,2,1086,2,13690.0,4,13700.0,6,S
2018-04-02 21:18:58,13690.0,2,1088,0,13690.0,2,13695.0,6,S
2018-04-02 21:18:59,13690.0,4,1092,4,13685.0,7,13690.0,1,S
2018-04-02 21:19:00,13685.0,4,1096,-4,13685.0,3,13690.0,4,S
2018-04-02 21:19:02,13680.0,8,1104,-2,13680.0,6,13685.0,3,S
2018-04-02 21:19:02,13680.0,12,1116,0,13670.0,1,13675.0,2,S
2018-04-02 21:19:03,13675.0,4,1120,-4,13675.0,1,13680.0,2,S
2018-04-02 21:19:03,13670.0,2,1122,-2,13665.0,17,13670.0,1,S
2018-04-02 21:19:04,13670.0,2,1124,0,13675.0,2,13685.0,1,S
2018-04-02 21:19:06,13675.0,2,1126,2,13675.0,17,13690.0,5,B
2018-04-02 21:19:08,13675.0,2,1128,-2,13675.0,16,13690.0,5,B
2018-04-02 21:19:27,13680.0,2,1130,-2,13680.0,17,13695.0,6,B
2018-04-02 21:19:27,13680.0,2,1132,0,13680.0,16,13695.0,6,B
2018-04-02 21:19:33,13680.0,2,1134,0,13680.0,15,13695.0,6,B
2018-04-02 21:19:35,13680.0,2,1136,0,13680.0,14,13695.0,6,B
2018-04-02 21:19:45,13685.0,2,1138,0,13680.0,6,13690.0,1,B
2018-04-02 21:19:50,13680.0,2,1140,0,13680.0,2,13685.0,1,S
2018-04-02 21:19:52,13685.0,2,1142,0,13680.0,2,13690.0,6,B
2018-04-02 21:19:55,13680.0,2,1144,-2,13680.0,1,13690.0,5,S
2018-04-02 21:19:56,13680.0,2,1146,0,13680.0,1,13690.0,5,S
2018-04-02 21:19:57,13680.0,2,1148,0,13680.0,1,13690.0,5,S
2018-04-02 21:19:59,13680.0,2,1150,-2,13675.0,5,13690.0,5,S
2018-04-02 21:20:06,13685.0,2,1152,0,13675.0,5,13690.0,5,B
2018-04-02 21:20:12,13690.0,2,1154,0,13675.0,6,13690.0,6,B
2018-04-02 21:20:19,13690.0,4,1158,0,13680.0,2,13690.0,6,B
2018-04-02 21:20:27,13680.0,2,1160,0,13680.0,1,13690.0,6,S
2018-04-02 21:20:37,13680.0,2,1162,0,13675.0,8,13690.0,7,S
2018-04-02 21:20:42,13685.0,2,1164,2,13685.0,2,13690.0,4,B
2018-04-02 21:20:57,13685.0,2,1166,2,13680.0,2,13685.0,1,B
2018-04-02 21:21:04,13685.0,2,1168,2,13680.0,3,13690.0,9,B
2018-04-02 21:21:38,13680.0,2,1170,2,13680.0,1,13685.0,2,S
2018-04-02 21:21:45,13680.0,2,1172,0,13680.0,1,13685.0,2,S
2018-04-02 21:21:46,13680.0,2,1174,-2,13675.0,3,13685.0,2,S
2018-04-02 21:21:48,13675.0,4,1178,0,13670.0,7,13680.0,1,S
2018-04-02 21:21:50,13685.0,20,1198,8,13675.0,1,13680.0,1,B
2018-04-02 21:22:00,13675.0,2,1200,2,13675.0,1,13685.0,2,S
2018-04-02 21:22:16,13675.0,2,1202,2,13670.0,10,13680.0,1,S
2018-04-02 21:22:16,13680.0,2,1204,0,13670.0,11,13685.0,2,B
2018-04-02 21:22:22,13675.0,2,1206,2,13670.0,11,13680.0,1,S
2018-04-02 21:22:31,13670.0,2,1208,0,13665.0,10,13675.0,4,S
2018-04-02 21:22:34,13670.0,2,1210,0,13665.0,9,13670.0,1,S
2018-04-02 21:22:34,13670.0,2,1212,0,13665.0,9,13675.0,5,S
2018-04-02 21:22:37,13665.0,2,1214,-2,13665.0,8,13670.0,1,S
2018-04-02 21:22:37,13665.0,2,1216,-2,13665.0,7,13670.0,1,S
2018-04-02 21:22:39,13670.0,2,1218,0,13670.0,1,13675.0,3,B
2018-04-02 21:22:45,13670.0,2,1220,0,13670.0,1,13675.0,4,B
2018-04-02 21:22:45,13670.0,2,1222,0,13665.0,12,13675.0,5,B
2018-04-02 21:22:47,13665.0,2,1224,-2,13665.0,8,13670.0,1,S
2018-04-02 21:22:47,13665.0,2,1226,0,13665.0,7,13670.0,1,S
2018-04-02 21:22:48,13665.0,2,1228,-2,13665.0,5,13670.0,1,S
2018-04-02 21:22:53,13665.0,10,1238,0,13660.0,2,13665.0,3,S
2018-04-02 21:22:54,13665.0,2,1240,0,13660.0,4,13665.0,2,S
2018-04-02 21:22:55,13665.0,2,1242,-2,13660.0,8,13670.0,1,S
2018-04-02 21:22:58,13660.0,16,1258,-8,13655.0,39,13660.0,4,S
2018-04-02 21:22:59,13660.0,8,1266,-8,13660.0,7,13670.0,1,S
2018-04-02 21:23:08,13660.0,22,1288,-4,13655.0,42,13660.0,11,S
2018-04-02 21:23:09,13660.0,22,1310,-22,13660.0,6,13670.0,2,S
2018-04-02 21:23:19,13665.0,2,1312,-2,13660.0,2,13670.0,3,B
2018-04-02 21:23:29,13665.0,2,1314,0,13660.0,4,13665.0,1,B
2018-04-02 21:23:35,13660.0,2,1316,2,13660.0,3,13670.0,3,S
2018-04-02 21:23:51,13660.0,2,1318,2,13660.0,3,13670.0,3,S
2018-04-02 21:24:00,13660.0,2,1320,-2,13660.0,2,13670.0,5,S
2018-04-02 21:24:34,13670.0,2,1322,-2,13665.0,1,13670.0,1,B
2018-04-02 21:24:38,13665.0,2,1324,0,13665.0,1,13670.0,4,S
2018-04-02 21:26:04,13675.0,2,1326,0,13670.0,4,13675.0,4,B
2018-04-02 21:26:17,13670.0,2,1328,2,13670.0,3,13675.0,2,S
2018-04-02 21:26:17,13670.0,4,1332,2,13670.0,1,13675.0,2,S
2018-04-02 21:26:18,13670.0,2,1334,0,13660.0,33,13670.0,1,S
2018-04-02 21:27:03,13670.0,2,1336,0,13670.0,2,13675.0,5,S
2018-04-02 21:27:12,13675.0,2,1338,0,13670.0,4,13680.0,4,B
2018-04-02 21:27:25,13680.0,4,1342,2,13670.0,4,13680.0,2,B
2018-04-02 21:28:02,13680.0,2,1344,-2,13670.0,4,13680.0,3,B
2018-04-02 21:29:25,13675.0,2,1346,-2,13670.0,3,13675.0,2,S
2018-04-02 21:29:46,13675.0,2,1348,0,13670.0,4,13675.0,1,S
2018-04-02 21:29:51,13670.0,2,1350,0,13670.0,2,13675.0,2,S
2018-04-02 21:29:51,13670.0,2,1352,2,13670.0,1,13675.0,18,S
2018-04-02 21:29:52,13670.0,2,1354,0,13665.0,4,13670.0,1,S
2018-04-02 21:29:58,13665.0,2,1356,0,13665.0,1,13670.0,1,S
2018-04-02 21:30:10,13665.0,6,1362,0,13665.0,1,13675.0,6,S
2018-04-02 21:30:35,13670.0,2,1364,2,13665.0,1,13670.0,1,B
2018-04-02 21:31:22,13670.0,2,1366,2,13665.0,2,13675.0,3,B
2018-04-02 21:31:34,13670.0,2,1368,0,13670.0,1,13675.0,2,B
2018-04-02 21:31:57,13670.0,2,1370,-2,13670.0,1,13675.0,1,B
2018-04-02 21:32:41,13675.0,2,1372,0,13670.0,3,13675.0,1,B
2018-04-02 21:33:37,13675.0,2,1374,2,13670.0,3,13680.0,6,B
2018-04-02 21:33:52,13680.0,4,1378,-2,13675.0,1,13680.0,2,B
2018-04-02 21:35:23,13680.0,2,1380,0,13675.0,1,13685.0,17,B
2018-04-02 21:35:58,13680.0,2,1382,0,13675.0,1,13685.0,6,B
2018-04-02 21:36:09,13685.0,2,1384,-2,13675.0,1,13685.0,5,B
2018-04-02 21:37:10,13685.0,2,1386,2,13680.0,1,13690.0,3,B
2018-04-02 21:38:36,13680.0,4,1390,-4,13670.0,7,13680.0,3,S
2018-04-02 21:38:59,13680.0,2,1392,0,13675.0,33,13685.0,31,S
2018-04-02 21:39:50,13680.0,2,1394,2,13680.0,1,13685.0,5,S
2018-04-02 21:39:51,13680.0,4,1398,2,13675.0,34,13680.0,10,S
2018-04-02 21:39:52,13680.0,2,1400,-2,13675.0,34,13680.0,9,S
2018-04-02 21:39:58,13680.0,2,1402,0,13675.0,34,13680.0,7,S
2018-04-02 21:40:28,13680.0,2,1404,0,13675.0,34,13680.0,8,S
2018-04-02 21:40:29,13675.0,2,1406,0,13675.0,33,13680.0,8,S
2018-04-02 21:40:45,13680.0,2,1408,-2,13675.0,34,13680.0,5,B
2018-04-02 21:40:46,13680.0,4,1412,-4,13675.0,34,13680.0,3,B
2018-04-02 21:41:01,13680.0,2,1414,0,13675.0,34,13680.0,2,B
2018-04-02 21:41:05,13675.0,6,1420,0,13675.0,30,13680.0,3,S
2018-04-02 21:41:22,13675.0,6,1426,6,13675.0,27,13680.0,3,S
2018-04-02 21:41:34,13675.0,4,1430,4,13675.0,25,13680.0,3,S
2018-04-02 21:41:40,13675.0,2,1432,0,13675.0,24,13680.0,4,S
2018-04-02 21:42:16,13680.0,2,1434,0,13675.0,24,13680.0,4,B
2018-04-02 21:42:40,13675.0,38,1472,38,13675.0,5,13680.0,20,S
2018-04-02 21:42:40,13675.0,10,1482,2,13670.0,5,13680.0,20,S
2018-04-02 21:43:23,13680.0,2,1484,0,13670.0,6,13680.0,20,B
2018-04-02 21:43:30,13675.0,2,1486,0,13670.0,6,13680.0,21,S
2018-04-02 21:43:53,13670.0,2,1488,2,13670.0,5,13675.0,1,S
2018-04-02 21:44:08,13670.0,2,1490,0,13670.0,4,13675.0,1,S
2018-04-02 21:45:04,13670.0,2,1492,0,13670.0,3,13675.0,1,S
2018-04-02 21:45:25,13670.0,2,1494,0,13670.0,3,13675.0,1,S
2018-04-02 21:45:50,13675.0,2,1496,-2,13670.0,3,13680.0,19,B
2018-04-02 21:46:06,13675.0,2,1498,0,13670.0,3,13675.0,1,B
2018-04-02 21:46:07,13675.0,2,1500,-2,13670.0,3,13680.0,31,B
2018-04-02 21:47:10,13680.0,4,1504,-4,13675.0,4,13685.0,3,B
2018-04-02 21:49:00,13680.0,2,1506,0,13675.0,9,13685.0,3,B
2018-04-02 21:50:12,13685.0,2,1508,-2,13680.0,2,13690.0,3,B
2018-04-02 21:51:11,13690.0,2,1510,2,13690.0,2,13695.0,5,B
2018-04-02 21:51:50,13690.0,2,1512,2,13690.0,5,13695.0,3,B
2018-04-02 21:51:54,13695.0,2,1514,-2,13690.0,5,13695.0,3,B
2018-04-02 21:51:57,13695.0,4,1518,-2,13690.0,5,13695.0,1,B
2018-04-02 21:52:08,13695.0,2,1520,0,13690.0,5,13695.0,3,B
2018-04-02 21:52:09,13700.0,10,1530,0,13695.0,1,13700.0,3,B
2018-04-02 21:52:10,13700.0,2,1532,-2,13690.0,6,13700.0,2,B
2018-04-02 21:52:20,13690.0,2,1534,2,13690.0,5,13700.0,4,S
2018-04-02 21:53:14,13690.0,2,1536,-2,13685.0,1,13695.0,16,S
2018-04-02 21:53:39,13685.0,2,1538,0,13685.0,1,13695.0,4,S
2018-04-02 21:54:20,13690.0,2,1540,0,13685.0,2,13695.0,4,B
2018-04-02 21:54:32,13695.0,2,1542,-2,13685.0,4,13695.0,4,B
2018-04-02 21:55:54,13695.0,2,1544,-2,13685.0,5,13695.0,5,B
2018-04-02 21:56:14,13695.0,2,1546,-2,13690.0,1,13695.0,2,B
2018-04-02 21:56:22,13695.0,2,1548,0,13685.0,3,13695.0,4,B
2018-04-02 21:56:25,13695.0,2,1550,0,13690.0,1,13695.0,3,B
2018-04-02 21:57:17,13690.0,2,1552,0,13690.0,2,13695.0,3,S
2018-04-02 21:57:22,13690.0,2,1554,2,13690.0,1,13695.0,3,S
2018-04-02 21:57:23,13690.0,2,1556,0,13685.0,3,13695.0,3,S
2018-04-02 21:57:26,13685.0,2,1558,0,13680.0,2,13690.0,4,S
2018-04-02 21:58:14,13680.0,2,1560,0,13675.0,4,13680.0,1,S
2018-04-02 21:58:15,13675.0,2,1562,-2,13675.0,3,13680.0,1,S
2018-04-02 21:58:24,13675.0,2,1564,2,13675.0,1,13680.0,4,S
2018-04-02 21:58:35,13675.0,2,1566,2,13675.0,2,13680.0,3,S
2018-04-02 21:59:01,13680.0,2,1568,0,13675.0,2,13685.0,5,B
2018-04-02 21:59:43,13685.0,2,1570,-2,13675.0,2,13685.0,4,B
2018-04-02 22:01:11,13675.0,2,1572,0,13670.0,6,13680.0,5,S
2018-04-02 22:01:23,13670.0,2,1574,0,13670.0,2,13675.0,4,S
2018-04-02 22:01:39,13670.0,2,1576,0,13670.0,1,13675.0,4,S
2018-04-02 22:01:46,13670.0,2,1578,2,13665.0,3,13675.0,5,S
2018-04-02 22:02:09,13670.0,2,1580,0,13665.0,2,13675.0,27,S
2018-04-02 22:02:36,13670.0,2,1582,-2,13665.0,2,13675.0,17,S
2018-04-02 22:03:27,13665.0,2,1584,0,13665.0,2,13675.0,4,S
2018-04-02 22:03:33,13670.0,2,1586,-2,13670.0,2,13675.0,3,B
2018-04-02 22:03:34,13670.0,4,1590,0,13665.0,2,13675.0,3,B
2018-04-02 22:03:41,13675.0,4,1594,0,13675.0,1,13680.0,28,B
2018-04-02 22:03:41,13675.0,4,1598,0,13670.0,3,13680.0,4,B
2018-04-02 22:04:07,13680.0,2,1600,0,13670.0,4,13680.0,4,B
2018-04-02 22:05:41,13680.0,2,1602,2,13670.0,3,13680.0,5,B
2018-04-02 22:07:19,13680.0,2,1604,0,13670.0,7,13680.0,5,B
2018-04-02 22:07:53,13680.0,4,1608,0,13675.0,1,13685.0,2,B
2018-04-02 22:07:54,13685.0,2,1610,0,13675.0,1,13685.0,3,B
2018-04-02 22:10:32,13675.0,2,1612,-2,13670.0,3,13680.0,2,S
2018-04-02 22:10:36,13675.0,2,1614,-2,13670.0,4,13675.0,1,S
2018-04-02 22:10:37,13675.0,2,1616,0,13675.0,1,13680.0,2,S
2018-04-02 22:12:50,13680.0,2,1618,-2,13675.0,15,13680.0,1,B
2018-04-02 22:12:50,13680.0,2,1620,-2,13680.0,2,13685.0,3,B
2018-04-02 22:15:16,13685.0,4,1624,0,13685.0,1,13690.0,2,B
2018-04-02 22:15:21,13690.0,2,1626,-2,13690.0,1,13695.0,3,B
2018-04-02 22:15:29,13695.0,4,1630,2,13690.0,15,13700.0,14,B
2018-04-02 22:15:31,13700.0,2,1632,0,13695.0,14,13700.0,10,B
2018-04-02 22:15:32,13700.0,20,1652,16,13695.0,2,13705.0,1,B
2018-04-02 22:15:32,13695.0,2,1654,2,13695.0,1,13705.0,2,S
2018-04-02 22:15:45,13685.0,2,1656,-2,13685.0,3,13695.0,1,S
2018-04-02 22:16:00,13695.0,4,1660,2,13690.0,2,13700.0,18,B
2018-04-02 22:16:35,13695.0,2,1662,0,13690.0,4,13700.0,18,B
2018-04-02 22:17:14,13695.0,2,1664,-2,13690.0,2,13700.0,19,B
2018-04-02 22:17:30,13695.0,2,1666,0,13690.0,5,13695.0,1,B
2018-04-02 22:17:39,13695.0,2,1668,2,13690.0,6,13700.0,18,B
2018-04-02 22:17:51,13690.0,2,1670,2,13690.0,5,13695.0,1,S
2018-04-02 22:18:15,13690.0,2,1672,-2,13690.0,4,13695.0,18,S
2018-04-02 22:18:27,13690.0,2,1674,2,13690.0,3,13695.0,23,S
2018-04-02 22:18:34,13690.0,2,1676,2,13690.0,2,13695.0,10,S
2018-04-02 22:18:37,13690.0,2,1678,2,13690.0,1,13695.0,10,S
2018-04-02 22:18:41,13690.0,2,1680,2,13685.0,2,13695.0,10,S
2018-04-02 22:18:57,13690.0,2,1682,0,13685.0,2,13695.0,10,S
2018-04-02 22:19:48,13690.0,4,1686,0,13685.0,15,13690.0,7,S
2018-04-02 22:20:06,13685.0,2,1688,2,13685.0,1,13690.0,7,S
2018-04-02 22:20:18,13685.0,2,1690,-2,13680.0,5,13690.0,7,S
2018-04-02 22:20:48,13685.0,2,1692,0,13680.0,6,13685.0,2,S
2018-04-02 22:20:56,13690.0,8,1700,0,13685.0,7,13690.0,5,B
2018-04-02 22:20:57,13685.0,4,1704,2,13680.0,10,13690.0,6,S
2018-04-02 22:21:11,13690.0,2,1706,2,13685.0,2,13690.0,4,B
2018-04-02 22:21:11,13690.0,6,1712,2,13685.0,17,13690.0,1,B
2018-04-02 22:21:12,13695.0,4,1716,-2,13695.0,1,13700.0,38,B
2018-04-02 22:21:12,13695.0,4,1720,-4,13685.0,7,13695.0,1,B
2018-04-02 22:21:56,13695.0,4,1724,0,13690.0,6,13695.0,4,B
2018-04-02 22:23:35,13695.0,2,1726,-2,13690.0,6,13700.0,5,B
2018-04-02 22:24:09,13695.0,2,1728,0,13690.0,5,13695.0,1,B
2018-04-02 22:24:33,13690.0,10,1738,0,13685.0,1,13690.0,2,S
2018-04-02 22:24:48,13685.0,2,1740,-2,13685.0,1,13690.0,4,S
2018-04-02 22:25:38,13685.0,2,1742,-2,13680.0,7,13685.0,2,S
2018-04-02 22:26:14,13685.0,4,1746,0,13680.0,5,13690.0,3,S
2018-04-02 22:26:14,13690.0,2,1748,-2,13685.0,4,13690.0,1,B
2018-04-02 22:26:15,13690.0,2,1750,0,13685.0,4,13695.0,5,B
2018-04-02 22:29:16,13700.0,10,1760,0,13695.0,2,13700.0,1,B
2018-04-02 22:29:16,13700.0,2,1762,-2,13695.0,2,13705.0,3,B
2018-04-02 22:29:25,13700.0,2,1764,0,13690.0,2,13700.0,1,B
2018-04-02 22:29:40,13700.0,2,1766,0,13695.0,1,13705.0,5,B
2018-04-02 22:29:49,13705.0,4,1770,-2,13695.0,3,13705.0,4,B
2018-04-02 22:30:10,13700.0,2,1772,2,13685.0,2,13695.0,1,S
2018-04-02 22:30:14,13695.0,2,1774,2,13695.0,4,13700.0,30,S
2018-04-02 22:30:15,13695.0,8,1782,8,13685.0,5,13695.0,2,S
2018-04-02 22:30:16,13700.0,2,1784,0,13685.0,5,13700.0,28,B
2018-04-02 22:30:18,13690.0,2,1786,2,13685.0,2,13690.0,4,S
2018-04-02 22:30:24,13680.0,10,1796,-6,13680.0,3,13690.0,4,S
2018-04-02 22:30:25,13690.0,8,1804,2,13680.0,3,13695.0,15,B
2018-04-02 22:30:42,13690.0,2,1806,-2,13685.0,4,13695.0,1,B
2018-04-02 22:31:08,13680.0,4,1810,0,13675.0,3,13685.0,1,S
2018-04-02 22:31:25,13675.0,4,1814,4,13670.0,10,13675.0,4,S
2018-04-02 22:31:26,13670.0,6,1820,4,13670.0,5,13675.0,2,S
2018-04-02 22:31:26,13670.0,4,1824,-2,13670.0,3,13675.0,2,S
2018-04-02 22:31:27,13670.0,6,1830,0,13665.0,6,13675.0,2,S
2018-04-02 22:31:34,13665.0,10,1840,-10,13660.0,11,13665.0,3,S
2018-04-02 22:31:35,13665.0,10,1850,-2,13660.0,10,13670.0,1,S
2018-04-02 22:31:36,13660.0,12,1862,6,13660.0,4,13665.0,5,S
2018-04-02 22:31:36,13660.0,8,1870,2,13655.0,4,13665.0,5,S
2018-04-02 22:31:53,13665.0,4,1874,4,13655.0,8,13675.0,12,B
2018-04-02 22:32:08,13665.0,2,1876,0,13660.0,1,13670.0,3,B
2018-04-02 22:32:19,13660.0,2,1878,-2,13655.0,4,13665.0,15,S
2018-04-02 22:32:20,13650.0,12,1890,-4,13650.0,17,13655.0,7,S
2018-04-02 22:32:21,13640.0,34,1924,8,13630.0,7,13655.0,7,S
2018-04-02 22:32:21,13640.0,4,1928,-4,13635.0,8,13650.0,24,S
2018-04-02 22:32:22,13640.0,2,1930,0,13640.0,1,13650.0,4,S
2018-04-02 22:32:34,13645.0,2,1932,0,13640.0,2,13650.0,2,B
2018-04-02 22:32:41,13645.0,2,1934,0,13640.0,1,13650.0,4,B
2018-04-02 22:32:48,13645.0,2,1936,0,13640.0,3,13650.0,3,B
2018-04-02 22:32:48,13650.0,2,1938,-2,13640.0,4,13650.0,1,B
2018-04-02 22:32:54,13645.0,2,1940,2,13640.0,4,13650.0,3,S
2018-04-02 22:32:56,13650.0,4,1944,0,13645.0,5,13655.0,4,B
2018-04-02 22:33:03,13650.0,4,1948,4,13645.0,4,13650.0,3,B
2018-04-02 22:33:06,13650.0,2,1950,2,13645.0,4,13650.0,2,B
2018-04-02 22:33:08,13655.0,6,1956,0,13650.0,4,13655.0,2,B
2018-04-02 22:33:08,13655.0,2,1958,-2,13650.0,2,13655.0,1,B
2018-04-02 22:33:13,13655.0,2,1960,-2,13650.0,2,13660.0,1,B
2018-04-02 22:33:42,13660.0,10,1970,-10,13660.0,5,13665.0,2,B
2018-04-02 22:33:49,13665.0,2,1972,0,13665.0,1,13670.0,1,B
2018-04-02 22:34:05,13675.0,2,1974,0,13675.0,2,13680.0,7,B
2018-04-02 22:34:06,13680.0,10,1984,2,13675.0,1,13685.0,6,B
2018-04-02 22:34:06,13685.0,4,1988,-4,13680.0,2,13690.0,8,B
2018-04-02 22:34:07,13680.0,2,1990,0,13680.0,1,13690.0,4,S
2018-04-02 22:34:27,13690.0,4,1994,-2,13690.0,1,13695.0,3,B
2018-04-02 22:34:30,13690.0,2,1996,-2,13690.0,1,13695.0,2,B
2018-04-02 22:34:31,13695.0,4,2000,-2,13690.0,2,13700.0,2,B
2018-04-02 22:34:32,13695.0,4,2004,0,13690.0,2,13700.0,3,B
2018-04-02 22:34:37,13700.0,4,2008,2,13695.0,3,13705.0,1,B
2018-04-02 22:34:38,13705.0,2,2010,-2,13700.0,2,13710.0,5,B
2018-04-02 22:34:40,13705.0,2,2012,0,13705.0,1,13710.0,5,B
2018-04-02 22:34:43,13710.0,2,2014,0,13705.0,3,13710.0,2,B
2018-04-02 22:34:43,13710.0,4,2018,0,13705.0,3,13715.0,5,B
2018-04-02 22:34:45,13710.0,4,2022,-2,13705.0,2,13715.0,7,B
2018-04-02 22:34:48,13710.0,2,2024,0,13705.0,5,13715.0,2,B
2018-04-02 22:34:49,13710.0,2,2026,2,13710.0,2,13715.0,2,B
2018-04-02 22:34:49,13715.0,6,2032,0,13710.0,2,13720.0,5,B
2018-04-02 22:34:51,13710.0,2,2034,0,13705.0,9,13715.0,1,S
2018-04-02 22:35:00,13705.0,4,2038,2,13700.0,3,13710.0,4,S
2018-04-02 22:35:03,13710.0,6,2044,0,13705.0,2,13715.0,5,B
2018-04-02 22:35:05,13710.0,2,2046,0,13705.0,1,13710.0,1,B
2018-04-02 22:35:15,13700.0,2,2048,0,13700.0,1,13705.0,2,S
2018-04-02 22:35:19,13705.0,2,2050,0,13700.0,2,13705.0,1,B
2018-04-02 22:35:20,13700.0,2,2052,-2,13695.0,2,13705.0,2,S
2018-04-02 22:35:21,13700.0,2,2054,0,13695.0,3,13700.0,3,S
2018-04-02 22:35:21,13695.0,2,2056,0,13690.0,5,13700.0,2,S
2018-04-02 22:35:23,13700.0,4,2060,0,13695.0,1,13705.0,5,B
2018-04-02 22:35:24,13700.0,2,2062,0,13695.0,1,13700.0,1,B
2018-04-02 22:35:28,13690.0,4,2066,0,13695.0,1,13700.0,1,S
2018-04-02 22:35:28,13695.0,2,2068,0,13690.0,1,13695.0,5,B
2018-04-02 22:35:30,13695.0,6,2074,-2,13695.0,4,13700.0,31,B
2018-04-02 22:35:31,13695.0,8,2082,0,13690.0,1,13695.0,2,B
2018-04-02 22:35:37,13690.0,2,2084,-2,13690.0,1,13700.0,7,S
2018-04-02 22:35:38,13695.0,2,2086,0,13690.0,1,13700.0,8,B
2018-04-02 22:35:39,13700.0,8,2094,8,13695.0,4,13705.0,3,B
2018-04-02 22:35:42,13700.0,2,2096,-2,13700.0,1,13705.0,3,B
2018-04-02 22:35:50,13700.0,2,2098,0,13695.0,9,13705.0,3,B
2018-04-02 22:35:50,13700.0,2,2100,-2,13695.0,9,13705.0,3,B
2018-04-02 22:36:00,13700.0,2,2102,0,13695.0,7,13705.0,3,B
2018-04-02 22:36:10,13700.0,2,2104,0,13700.0,1,13705.0,2,B
2018-04-02 22:36:15,13705.0,4,2108,-4,13700.0,7,13710.0,10,B
2018-04-02 22:36:16,13705.0,2,2110,2,13700.0,6,13710.0,8,B
2018-04-02 22:36:20,13705.0,2,2112,2,13705.0,6,13710.0,7,B
2018-04-02 22:36:22,13710.0,2,2114,0,13705.0,6,13710.0,8,B
2018-04-02 22:36:28,13710.0,2,2116,2,13705.0,6,13710.0,6,B
2018-04-02 22:36:29,13710.0,4,2120,2,13705.0,6,13710.0,4,B
2018-04-02 22:36:45,13710.0,4,2124,2,13700.0,6,13710.0,2,B
2018-04-02 22:36:47,13710.0,4,2128,-4,13705.0,2,13715.0,5,B
2018-04-02 22:36:56,13710.0,2,2130,0,13705.0,3,13715.0,4,B
2018-04-02 22:37:02,13710.0,2,2132,0,13700.0,5,13710.0,3,B
2018-04-02 22:37:20,13715.0,4,2136,0,13710.0,6,13720.0,5,B
2018-04-02 22:37:21,13720.0,6,2142,0,13720.0,1,13725.0,1,B
2018-04-02 22:37:22,13720.0,2,2144,0,13715.0,12,13725.0,1,B
2018-04-02 22:37:28,13725.0,8,2152,-6,13725.0,2,13730.0,2,B
2018-04-02 22:37:28,13725.0,4,2156,-4,13720.0,2,13725.0,3,B
2018-04-02 22:37:41,13725.0,2,2158,0,13720.0,6,13725.0,1,B
2018-04-02 22:37:42,13720.0,2,2160,-2,13720.0,2,13725.0,2,S
2018-04-02 22:37:43,13720.0,4,2164,0,13715.0,6,13725.0,2,S
2018-04-02 22:37:53,13715.0,2,2166,2,13715.0,5,13720.0,2,S
2018-04-02 22:37:56,13715.0,6,2172,2,13715.0,2,13720.0,2,S
2018-04-02 22:38:01,13715.0,2,2174,0,13715.0,2,13720.0,2,S
2018-04-02 22:38:02,13715.0,2,2176,0,13715.0,1,13720.0,2,S
2018-04-02 22:38:03,13715.0,2,2178,0,13710.0,1,13715.0,2,S
2018-04-02 22:38:07,13710.0,2,2180,0,13705.0,2,13710.0,1,S
2018-04-02 22:38:14,13705.0,8,2188,2,13700.0,5,13705.0,2,S
2018-04-02 22:38:20,13705.0,4,2192,0,13700.0,9,13710.0,4,S
2018-04-02 22:38:23,13705.0,2,2194,0,13700.0,9,13705.0,1,S
2018-04-02 22:38:24,13705.0,2,2196,-2,13700.0,9,13710.0,5,S
2018-04-02 22:38:26,13705.0,4,2200,4,13700.0,9,13710.0,6,S
2018-04-02 22:38:29,13710.0,6,2206,6,13705.0,7,13715.0,4,B
2018-04-02 22:38:32,13705.0,4,2210,2,13705.0,5,13715.0,2,S
2018-04-02 22:38:45,13715.0,2,2212,2,13705.0,7,13715.0,1,B
2018-04-02 22:38:46,13715.0,4,2216,4,13710.0,2,13720.0,1,B
2018-04-02 22:39:07,13710.0,2,2218,2,13705.0,11,13715.0,1,S
2018-04-02 22:39:11,13705.0,10,2228,2,13705.0,1,13710.0,3,S
2018-04-02 22:39:12,13705.0,2,2230,0,13700.0,6,13705.0,1,S
2018-04-02 22:39:17,13705.0,2,2232,0,13700.0,5,13710.0,5,S
2018-04-02 22:39:35,13710.0,4,2236,-2,13705.0,1,13715.0,16,B
2018-04-02 22:39:36,13705.0,2,2238,0,13705.0,3,13715.0,1,S
2018-04-02 22:39:58,13705.0,2,2240,0,13705.0,1,13710.0,1,S
2018-04-02 22:40:00,13710.0,4,2244,-4,13710.0,13,13715.0,29,B
2018-04-02 22:40:00,13710.0,20,2264,-10,13710.0,3,13715.0,29,B
2018-04-02 22:40:01,13710.0,6,2270,0,13705.0,2,13710.0,4,B
2018-04-02 22:40:05,13710.0,6,2276,4,13710.0,12,13715.0,20,B
2018-04-02 22:40:05,13710.0,2,2278,2,13710.0,11,13715.0,20,B
2018-04-02 22:40:10,13715.0,8,2286,8,13710.0,11,13715.0,1,B
2018-04-02 22:40:23,13715.0,4,2290,0,13710.0,12,13715.0,2,B
2018-04-02 22:40:52,13710.0,8,2298,0,13710.0,8,13715.0,15,S
2018-04-02 22:41:02,13710.0,6,2304,0,13710.0,5,13715.0,16,S
2018-04-02 22:41:10,13710.0,2,2306,2,13710.0,4,13715.0,16,S
2018-04-02 22:41:11,13705.0,12,2318,4,13705.0,1,13710.0,18,S
2018-04-02 22:41:24,13700.0,2,2320,0,13700.0,3,13705.0,2,S
2018-04-02 22:41:30,13700.0,2,2322,2,13700.0,2,13705.0,4,S
2018-04-02 22:41:34,13700.0,2,2324,0,13700.0,1,13705.0,5,S
2018-04-02 22:41:35,13700.0,2,2326,2,13695.0,3,13705.0,5,S
2018-04-02 22:42:03,13705.0,2,2328,2,13705.0,3,13710.0,4,B
2018-04-02 22:42:04,13710.0,4,2332,4,13705.0,4,13715.0,3,B
2018-04-02 22:42:13,13705.0,2,2334,2,13700.0,3,13705.0,2,S
2018-04-02 22:42:14,13705.0,2,2336,0,13700.0,2,13710.0,2,S
2018-04-02 22:42:26,13700.0,2,2338,0,13700.0,2,13705.0,1,S
2018-04-02 22:42:47,13705.0,4,2342,0,13700.0,7,13710.0,3,B
2018-04-02 22:42:56,13705.0,2,2344,0,13700.0,6,13710.0,4,B
2018-04-02 22:43:14,13705.0,2,2346,2,13700.0,13,13705.0,3,B
2018-04-02 22:43:18,13700.0,2,2348,0,13700.0,11,13705.0,2,S
2018-04-02 22:43:25,13705.0,2,2350,0,13700.0,26,13710.0,4,B
2018-04-02 22:43:41,13700.0,2,2352,0,13700.0,11,13705.0,2,S
2018-04-02 22:43:42,13700.0,2,2354,2,13700.0,10,13705.0,3,S
2018-04-02 22:43:42,13700.0,2,2356,2,13700.0,9,13705.0,3,S
2018-04-02 22:43:43,13700.0,2,2358,2,13700.0,8,13705.0,3,S
2018-04-02 22:43:45,13700.0,2,2360,2,13700.0,7,13705.0,3,S
2018-04-02 22:43:54,13700.0,14,2374,12,13695.0,5,13700.0,14,S
2018-04-02 22:43:55,13695.0,2,2376,-2,13690.0,4,13700.0,15,S
2018-04-02 22:44:09,13700.0,2,2378,2,13695.0,5,13705.0,3,B
2018-04-02 22:44:25,13700.0,2,2380,-2,13695.0,4,13705.0,4,B
2018-04-02 22:45:06,13700.0,2,2382,0,13695.0,3,13700.0,2,B
2018-04-02 22:45:35,13700.0,6,2388,-4,13700.0,3,13705.0,4,B
2018-04-02 22:45:35,13705.0,2,2390,-2,13700.0,3,13705.0,3,B
2018-04-02 22:46:18,13695.0,2,2392,2,13695.0,1,13700.0,2,S
2018-04-02 22:46:41,13700.0,2,2394,-2,13695.0,5,13705.0,6,B
2018-04-02 22:47:15,13705.0,6,2400,0,13700.0,5,13710.0,5,B
2018-04-02 22:47:24,13705.0,2,2402,0,13700.0,6,13710.0,2,B
2018-04-02 22:47:44,13700.0,2,2404,-2,13695.0,7,13705.0,3,S
2018-04-02 22:48:17,13700.0,2,2406,0,13695.0,9,13700.0,1,S
2018-04-02 22:48:21,13700.0,2,2408,2,13700.0,1,13705.0,4,S
2018-04-02 22:48:48,13705.0,4,2412,-4,13705.0,2,13710.0,4,B
2018-04-02 22:49:29,13705.0,4,2416,-4,13700.0,2,13705.0,2,B
2018-04-02 22:49:30,13705.0,4,2420,0,13700.0,5,13710.0,4,B
2018-04-02 22:49:56,13705.0,4,2424,0,13700.0,5,13710.0,4,B
2018-04-02 22:50:35,13700.0,2,2426,0,13695.0,9,13705.0,2,S
2018-04-02 22:51:32,13705.0,2,2428,-2,13700.0,3,13710.0,5,B
2018-04-02 22:51:32,13705.0,2,2430,2,13700.0,3,13710.0,5,B
2018-04-02 22:51:33,13710.0,2,2432,-2,13700.0,4,13710.0,4,B
2018-04-02 22:52:18,13705.0,2,2434,0,13700.0,3,13710.0,4,S
2018-04-02 22:52:31,13705.0,4,2438,-4,13700.0,1,13710.0,5,S
2018-04-02 22:54:30,13700.0,4,2442,0,13695.0,5,13705.0,3,S
2018-04-02 22:54:56,13700.0,2,2444,0,13695.0,5,13700.0,4,S
2018-04-02 22:55:03,13695.0,2,2446,0,13695.0,5,13700.0,4,S
2018-04-02 22:55:03,13690.0,12,2458,0,13690.0,3,13695.0,1,S
2018-04-02 22:55:04,13690.0,4,2462,2,13685.0,2,13695.0,4,S
2018-04-02 22:55:05,13690.0,2,2464,0,13685.0,1,13690.0,2,S
2018-04-02 22:55:10,13685.0,2,2466,0,13680.0,4,13690.0,2,S
2018-04-02 22:55:22,13685.0,2,2468,0,13685.0,1,13690.0,2,S
2018-04-02 22:55:23,13685.0,2,2470,0,13680.0,4,13685.0,3,S
2018-04-02 22:55:34,13680.0,4,2474,-2,13680.0,2,13685.0,3,S
2018-04-02 22:55:34,13675.0,8,2482,-8,13670.0,2,13685.0,3,S
2018-04-02 22:55:49,13675.0,2,2484,0,13670.0,2,13680.0,2,S
2018-04-02 22:55:52,13680.0,2,2486,0,13670.0,2,13680.0,5,B
2018-04-02 22:56:05,13670.0,6,2492,-2,13665.0,2,13670.0,10,S
2018-04-02 22:56:06,13670.0,20,2512,-8,13675.0,1,13680.0,1,S
2018-04-02 22:56:15,13680.0,2,2514,0,13675.0,4,13685.0,3,B
2018-04-02 22:56:16,13685.0,2,2516,0,13680.0,1,13685.0,2,B
2018-04-02 22:56:25,13680.0,2,2518,0,13680.0,1,13685.0,2,S
2018-04-02 22:56:35,13690.0,2,2520,0,13680.0,2,13690.0,5,B
2018-04-02 22:56:51,13690.0,2,2522,0,13685.0,1,13690.0,3,B
2018-04-02 22:56:57,13690.0,6,2528,6,13690.0,8,13695.0,16,B
2018-04-02 22:57:03,13695.0,4,2532,0,13690.0,9,13695.0,13,B
2018-04-02 22:57:22,13690.0,2,2534,2,13690.0,8,13695.0,13,S
2018-04-02 22:57:22,13690.0,4,2538,0,13690.0,6,13695.0,12,S
2018-04-02 22:57:23,13690.0,2,2540,2,13690.0,5,13695.0,12,S
2018-04-02 22:57:23,13690.0,2,2542,2,13690.0,4,13695.0,12,S
2018-04-02 22:57:48,13695.0,2,2544,0,13690.0,4,13695.0,12,B
2018-04-02 22:57:58,13690.0,2,2546,2,13690.0,3,13695.0,12,S
2018-04-02 22:58:00,13690.0,2,2548,2,13690.0,2,13695.0,15,S
2018-04-02 22:58:00,13690.0,22,2570,-2,13685.0,1,13690.0,1,S
2018-04-02 22:58:02,13690.0,2,2572,-2,13680.0,1,13690.0,1,S
2018-04-02 22:58:29,13695.0,2,2574,0,13685.0,2,13695.0,4,B
2018-04-02 22:58:40,13695.0,2,2576,0,13685.0,1,13695.0,7,B
2018-04-02 22:58:59,13690.0,2,2578,2,13685.0,1,13695.0,3,S
2018-04-02 22:59:00,13695.0,2,2580,0,13685.0,1,13695.0,2,B
2018-04-02 22:59:04,13685.0,2,2582,0,13685.0,2,13695.0,1,S
2018-04-02 22:59:16,13695.0,2,2584,-2,13685.0,3,13695.0,1,B
2018-04-02 22:59:21,13695.0,2,2586,0,13685.0,1,13700.0,3,B
2018-04-03 09:00:00,13675.0,18,2604,0,13655.0,3,13670.0,1,S
2018-04-03 09:00:01,13655.0,2,2606,-2,13655.0,2,13665.0,2,S
2018-04-03 09:00:01,13665.0,6,2612,2,13655.0,2,13670.0,20,B
2018-04-03 09:00:02,13655.0,4,2616,2,13650.0,1,13660.0,14,S
2018-04-03 09:00:02,13640.0,28,2644,0,13635.0,5,13655.0,16,S
2018-04-03 09:00:04,13640.0,6,2650,-4,13635.0,5,13640.0,3,S
2018-04-03 09:00:05,13635.0,10,2660,2,13635.0,3,13645.0,14,S
2018-04-03 09:00:06,13645.0,4,2664,0,13640.0,1,13650.0,12,B
2018-04-03 09:00:08,13640.0,2,2666,0,13635.0,3,13650.0,1,S
2018-04-03 09:00:10,13645.0,2,2668,2,13640.0,3,13650.0,4,B
2018-04-03 09:00:11,13640.0,2,2670,2,13640.0,2,13650.0,4,S
2018-04-03 09:00:11,13635.0,8,2678,0,13635.0,4,13650.0,4,S
2018-04-03 09:00:12,13645.0,2,2680,0,13635.0,1,13650.0,1,B
2018-04-03 09:00:13,13635.0,2,2682,-2,13630.0,5,13635.0,1,S
2018-04-03 09:00:14,13635.0,2,2684,-2,13630.0,5,13640.0,1,S
2018-04-03 09:00:15,13640.0,4,2688,-2,13635.0,1,13640.0,3,B
2018-04-03 09:00:16,13630.0,10,2698,6,13630.0,5,13645.0,6,S
2018-04-03 09:00:18,13635.0,10,2708,0,13630.0,7,13650.0,5,B
2018-04-03 09:00:20,13635.0,8,2716,8,13630.0,7,13635.0,1,B
2018-04-03 09:00:21,13635.0,2,2718,2,13630.0,7,13650.0,4,B
2018-04-03 09:00:23,13640.0,2,2720,0,13635.0,1,13645.0,4,B
2018-04-03 09:00:24,13635.0,2,2722,0,13635.0,1,13645.0,4,S
2018-04-03 09:00:25,13645.0,2,2724,-2,13635.0,1,13645.0,3,B
2018-04-03 09:00:30,13640.0,2,2726,0,13635.0,2,13645.0,9,S
2018-04-03 09:00:33,13635.0,4,2730,-2,13630.0,7,13635.0,1,S
2018-04-03 09:00:33,13635.0,2,2732,0,13635.0,4,13645.0,2,S
2018-04-03 09:00:35,13640.0,4,2736,-4,13635.0,3,13640.0,4,B
2018-04-03 09:00:40,13630.0,20,2756,-10,13630.0,1,13635.0,3,S
2018-04-03 09:00:42,13630.0,2,2758,-2,13620.0,4,13640.0,4,S
2018-04-03 09:00:45,13630.0,2,2760,0,13630.0,1,13640.0,4,S
2018-04-03 09:00:46,13630.0,2,2762,-2,13620.0,4,13635.0,3,S
2018-04-03 09:00:52,13635.0,2,2764,-2,13630.0,5,13635.0,5,B
2018-04-03 09:00:54,13630.0,2,2766,0,13630.0,1,13635.0,4,S
2018-04-03 09:00:57,13630.0,2,2768,0,13630.0,1,13635.0,4,S
2018-04-03 09:00:58,13630.0,2,2770,-2,13620.0,4,13635.0,4,S
2018-04-03 09:01:01,13630.0,10,2780,-2,13620.0,7,13635.0,6,S
2018-04-03 09:01:05,13620.0,4,2784,2,13620.0,6,13630.0,4,S
2018-04-03 09:01:06,13625.0,2,2786,2,13625.0,1,13640.0,7,B
2018-04-03 09:01:09,13630.0,4,2790,0,13630.0,1,13640.0,7,B
2018-04-03 09:01:10,13635.0,4,2794,0,13630.0,1,13635.0,4,B
2018-04-03 09:01:11,13635.0,8,2802,0,13625.0,1,13640.0,3,B
2018-04-03 09:01:12,13635.0,2,2804,2,13630.0,2,13640.0,3,B
2018-04-03 09:01:13,13625.0,10,2814,8,13630.0,2,13640.0,3,S
2018-04-03 09:01:13,13630.0,2,2816,0,13630.0,2,13640.0,3,B
2018-04-03 09:01:14,13630.0,2,2818,0,13630.0,1,13640.0,3,B
2018-04-03 09:01:15,13630.0,2,2820,2,13625.0,1,13640.0,3,B
2018-04-03 09:01:18,13630.0,2,2822,2,13630.0,10,13640.0,3,B
2018-04-03 09:01:20,13630.0,2,2824,2,13630.0,10,13640.0,3,B
2018-04-03 09:01:24,13640.0,2,2826,2,13635.0,4,13640.0,4,B
2018-04-03 09:01:25,13630.0,16,2842,-16,13630.0,5,13640.0,4,S
2018-04-03 09:01:28,13630.0,12,2854,-8,13620.0,5,13635.0,4,S
2018-04-03 09:01:31,13635.0,2,2856,-2,13630.0,1,13635.0,1,B
2018-04-03 09:01:34,13635.0,2,2858,0,13635.0,3,13640.0,2,B
2018-04-03 09:01:35,13635.0,6,2864,0,13630.0,4,13640.0,2,B
2018-04-03 09:01:37,13640.0,2,2866,0,13630.0,4,13640.0,1,B
2018-04-03 09:01:41,13635.0,2,2868,0,13635.0,1,13640.0,4,S
2018-04-03 09:01:42,13635.0,2,2870,2,13630.0,4,13635.0,3,S
2018-04-03 09:01:42,13630.0,8,2878,0,13630.0,4,13640.0,4,S
2018-04-03 09:01:57,13635.0,2,2880,0,13630.0,6,13635.0,1,B
2018-04-03 09:01:57,13635.0,2,2882,0,13635.0,6,13640.0,3,B
2018-04-03 09:01:58,13640.0,6,2888,6,13635.0,2,13650.0,15,B
2018-04-03 09:01:59,13630.0,14,2902,8,13630.0,6,13645.0,15,S
2018-04-03 09:02:00,13635.0,6,2908,2,13630.0,7,13645.0,9,B
2018-04-03 09:02:02,13640.0,2,2910,2,13630.0,7,13645.0,9,B
2018-04-03 09:02:04,13645.0,22,2932,10,13640.0,3,13650.0,14,B
2018-04-03 09:02:06,13645.0,2,2934,0,13640.0,3,13645.0,2,B
2018-04-03 09:02:08,13645.0,4,2938,-4,13640.0,3,13645.0,1,B
2018-04-03 09:02:08,13645.0,2,2940,-2,13640.0,3,13645.0,2,B
2018-04-03 09:02:10,13640.0,2,2942,2,13640.0,2,13650.0,14,S
2018-04-03 09:02:11,13645.0,6,2948,-2,13640.0,2,13650.0,20,B
2018-04-03 09:02:12,13640.0,8,2956,4,13635.0,4,13650.0,20,S
2018-04-03 09:02:13,13650.0,2,2958,2,13640.0,3,13650.0,16,B
2018-04-03 09:02:14,13650.0,4,2962,0,13640.0,3,13650.0,14,B
2018-04-03 09:02:25,13650.0,2,2964,0,13635.0,6,13645.0,3,B
2018-04-03 09:02:33,13640.0,4,2968,2,13640.0,2,13650.0,17,S
2018-04-03 09:02:48,13635.0,2,2970,-2,13630.0,2,13640.0,2,S
2018-04-03 09:02:51,13635.0,2,2972,2,13630.0,2,13635.0,5,S
2018-04-03 09:02:51,13635.0,2,2974,-2,13630.0,2,13635.0,5,S
2018-04-03 09:02:54,13630.0,2,2976,2,13620.0,8,13635.0,2,S
2018-04-03 09:02:55,13625.0,2,2978,2,13625.0,9,13635.0,2,S
2018-04-03 09:02:57,13630.0,2,2980,-2,13625.0,12,13630.0,1,B
2018-04-03 09:03:00,13630.0,2,2982,-2,13625.0,7,13635.0,2,B
2018-04-03 09:03:01,13635.0,2,2984,-2,13625.0,7,13635.0,1,B
2018-04-03 09:03:07,13620.0,10,2994,0,13620.0,7,13630.0,5,S
2018-04-03 09:03:10,13630.0,10,3004,8,13625.0,6,13635.0,3,B
2018-04-03 09:03:11,13625.0,2,3006,-2,13625.0,5,13635.0,3,S
2018-04-03 09:03:13,13625.0,8,3014,0,13625.0,1,13635.0,3,S
2018-04-03 09:03:18,13625.0,2,3016,-2,13625.0,2,13635.0,4,S
2018-04-03 09:03:25,13640.0,2,3018,0,13630.0,3,13640.0,6,B
2018-04-03 09:03:30,13635.0,2,3020,2,13630.0,3,13640.0,6,S
2018-04-03 09:03:34,13630.0,2,3022,0,13630.0,4,13640.0,6,S
2018-04-03 09:03:50,13640.0,2,3024,-2,13640.0,1,13645.0,1,B
2018-04-03 09:03:55,13650.0,26,3050,24,13645.0,7,13655.0,11,B
2018-04-03 09:03:58,13655.0,2,3052,2,13650.0,2,13655.0,10,B
2018-04-03 09:03:58,13655.0,2,3054,2,13645.0,10,13655.0,9,B
2018-04-03 09:03:59,13650.0,4,3058,0,13645.0,6,13655.0,13,S
2018-04-03 09:04:07,13655.0,2,3060,2,13645.0,5,13655.0,13,B
2018-04-03 09:04:12,13650.0,2,3062,0,13645.0,4,13655.0,13,S
2018-04-03 09:04:13,13650.0,6,3068,-4,13645.0,4,13650.0,4,S
2018-04-03 09:04:15,13650.0,2,3070,-2,13645.0,7,13650.0,3,S
2018-04-03 09:04:16,13650.0,2,3072,0,13645.0,7,13650.0,3,S
2018-04-03 09:04:21,13645.0,2,3074,0,13645.0,6,13650.0,3,S
2018-04-03 09:04:28,13645.0,2,3076,2,13645.0,5,13650.0,2,S
2018-04-03 09:04:39,13645.0,2,3078,2,13645.0,4,13650.0,3,S
2018-04-03 09:04:43,13645.0,4,3082,0,13645.0,3,13650.0,7,S
2018-04-03 09:04:44,13645.0,6,3088,6,13640.0,2,13650.0,7,S
2018-04-03 09:04:44,13640.0,4,3092,2,13635.0,2,13645.0,8,S
2018-04-03 09:04:45,13640.0,4,3096,-2,13635.0,3,13640.0,1,S
2018-04-03 09:04:54,13635.0,2,3098,0,13635.0,1,13640.0,1,S
2018-04-03 09:04:55,13635.0,2,3100,0,13630.0,3,13640.0,1,S
2018-04-03 09:05:02,13630.0,2,3102,0,13625.0,3,13635.0,2,S
2018-04-03 09:05:03,13630.0,2,3104,-2,13625.0,5,13635.0,5,S
2018-04-03 09:05:05,13630.0,2,3106,-2,13625.0,7,13635.0,4,S
2018-04-03 09:05:08,13625.0,6,3112,-4,13620.0,5,13625.0,1,S
2018-04-03 09:05:08,13625.0,2,3114,-2,13620.0,8,13630.0,1,S
2018-04-03 09:05:09,13630.0,2,3116,0,13625.0,1,13635.0,3,B
2018-04-03 09:05:16,13630.0,6,3122,-6,13635.0,1,13645.0,6,B
2018-04-03 09:05:17,13635.0,2,3124,2,13630.0,3,13640.0,2,B
2018-04-03 09:05:25,13625.0,8,3132,4,13630.0,2,13640.0,2,S
2018-04-03 09:05:27,13630.0,4,3136,2,13625.0,1,13630.0,1,B
2018-04-03 09:05:30,13630.0,2,3138,-2,13625.0,2,13630.0,1,B
2018-04-03 09:05:33,13630.0,2,3140,2,13625.0,2,13630.0,1,B
2018-04-03 09:05:35,13625.0,2,3142,2,13620.0,6,13630.0,6,S
2018-04-03 09:05:37,13615.0,12,3154,2,13610.0,4,13615.0,1,S
2018-04-03 09:05:37,13615.0,4,3158,2,13610.0,7,13615.0,1,S
2018-04-03 09:05:38,13610.0,6,3164,0,13610.0,1,13615.0,2,S
2018-04-03 09:05:39,13610.0,2,3166,0,13605.0,1,13615.0,2,S
2018-04-03 09:05:40,13610.0,6,3172,6,13605.0,2,13615.0,4,S
2018-04-03 09:05:41,13610.0,2,3174,0,13610.0,4,13615.0,2,S
2018-04-03 09:05:42,13610.0,2,3176,2,13605.0,2,13615.0,4,S
2018-04-03 09:05:44,13610.0,2,3178,0,13605.0,2,13615.0,4,S
2018-04-03 09:05:45,13610.0,2,3180,2,13605.0,2,13610.0,9,S
2018-04-03 09:05:47,13605.0,4,3184,4,13605.0,2,13610.0,9,S
2018-04-03 09:05:48,13605.0,4,3188,-2,13600.0,40,13610.0,9,S
2018-04-03 09:05:49,13610.0,18,3206,0,13605.0,2,13615.0,4,B
2018-04-03 09:05:50,13605.0,2,3208,0,13605.0,1,13615.0,3,S
2018-04-03 09:05:55,13610.0,2,3210,0,13610.0,2,13615.0,7,B
2018-04-03 09:05:56,13610.0,2,3212,-2,13610.0,1,13615.0,7,B
2018-04-03 09:06:22,13625.0,2,3214,0,13620.0,6,13630.0,5,B
2018-04-03 09:06:22,13620.0,12,3226,6,13615.0,8,13620.0,4,S
2018-04-03 09:06:23,13630.0,10,3236,8,13620.0,1,13630.0,7,B
2018-04-03 09:06:24,13620.0,4,3240,-4,13620.0,3,13630.0,7,S
2018-04-03 09:06:28,13615.0,2,3242,-2,13610.0,5,13620.0,6,S
2018-04-03 09:06:29,13615.0,2,3244,2,13610.0,2,13620.0,5,S
2018-04-03 09:06:34,13625.0,2,3246,-2,13620.0,1,13625.0,6,B
2018-04-03 09:06:38,13625.0,6,3252,4,13615.0,1,13625.0,1,B
2018-04-03 09:06:41,13625.0,2,3254,0,13620.0,1,13625.0,3,B
2018-04-03 09:06:46,13620.0,2,3256,0,13615.0,2,13620.0,3,S
2018-04-03 09:06:56,13615.0,2,3258,0,13615.0,2,13625.0,4,S
2018-04-03 09:07:01,13615.0,2,3260,0,13615.0,1,13620.0,1,S
2018-04-03 09:07:03,13615.0,2,3262,0,13615.0,3,13620.0,2,S
2018-04-03 09:07:26,13610.0,2,3264,-2,13610.0,3,13620.0,5,S
2018-04-03 09:07:29,13610.0,6,3270,-4,13610.0,1,13620.0,10,S
2018-04-03 09:07:30,13610.0,2,3272,-2,13605.0,4,13615.0,4,S
2018-04-03 09:07:36,13610.0,2,3274,-2,13605.0,5,13615.0,5,S
2018-04-03 09:07:43,13605.0,10,3284,-8,13600.0,42,13615.0,3,S
2018-04-03 09:07:51,13610.0,2,3286,0,13605.0,6,13615.0,6,B
2018-04-03 09:07:57,13610.0,2,3288,-2,13610.0,2,13620.0,7,B
2018-04-03 09:07:57,13620.0,2,3290,-2,13610.0,2,13620.0,6,B
2018-04-03 09:07:58,13610.0,2,3292,2,13610.0,1,13620.0,7,S
2018-04-03 09:08:09,13620.0,8,3300,-4,13610.0,4,13620.0,1,B
2018-04-03 09:08:16,13620.0,10,3310,-2,13615.0,1,13620.0,4,B
2018-04-03 09:08:19,13620.0,2,3312,0,13615.0,1,13620.0,1,B
2018-04-03 09:08:28,13620.0,2,3314,0,13615.0,7,13625.0,4,B
2018-04-03 09:08:55,13625.0,2,3316,2,13625.0,4,13630.0,3,B
2018-04-03 09:09:01,13625.0,8,3324,8,13620.0,3,13630.0,19,B
2018-04-03 09:09:11,13625.0,2,3326,0,13620.0,6,13630.0,6,B
2018-04-03 09:09:12,13630.0,2,3328,0,13620.0,4,13630.0,5,B
2018-04-03 09:09:16,13630.0,2,3330,0,13620.0,8,13630.0,3,B
2018-04-03 09:09:39,13625.0,2,3332,0,13620.0,3,13630.0,5,S
2018-04-03 09:09:55,13630.0,2,3334,2,13625.0,2,13635.0,5,B
2018-04-03 09:10:00,13630.0,2,3336,0,13625.0,2,13630.0,2,B
2018-04-03 09:10:06,13630.0,2,3338,0,13625.0,3,13630.0,1,B
2018-04-03 09:10:15,13630.0,2,3340,0,13625.0,3,13630.0,1,B
2018-04-03 09:10:21,13630.0,2,3342,2,13625.0,3,13635.0,6,B
2018-04-03 09:10:25,13635.0,4,3346,2,13630.0,6,13640.0,2,B
2018-04-03 09:10:34,13640.0,2,3348,-2,13635.0,3,13645.0,2,B
2018-04-03 09:10:39,13645.0,4,3352,2,13640.0,8,13650.0,8,B
2018-04-03 09:10:41,13640.0,10,3362,0,13640.0,3,13650.0,5,S
2018-04-03 09:10:44,13645.0,2,3364,0,13645.0,1,13650.0,11,B
2018-04-03 09:10:50,13645.0,2,3366,0,13640.0,3,13650.0,10,B
2018-04-03 09:11:01,13645.0,2,3368,-2,13645.0,2,13650.0,27,B
2018-04-03 09:11:02,13645.0,2,3370,-2,13645.0,1,13650.0,28,B
2018-04-03 09:11:03,13645.0,2,3372,-2,13640.0,1,13650.0,14,B
2018-04-03 09:11:06,13640.0,2,3374,0,13635.0,9,13645.0,2,S
2018-04-03 09:11:15,13635.0,8,3382,0,13635.0,4,13645.0,2,S
2018-04-03 09:11:26,13645.0,4,3386,0,13645.0,1,13650.0,18,B
2018-04-03 09:11:26,13645.0,2,3388,0,13635.0,4,13645.0,6,B
2018-04-03 09:11:31,13635.0,2,3390,-2,13635.0,2,13640.0,3,S
2018-04-03 09:11:32,13635.0,4,3394,0,13630.0,11,13640.0,3,S
2018-04-03 09:11:54,13635.0,2,3396,0,13635.0,1,13640.0,1,S
2018-04-03 09:12:13,13635.0,2,3398,0,13635.0,1,13640.0,2,S
2018-04-03 09:12:40,13640.0,2,3400,-2,13640.0,3,13645.0,8,B
2018-04-03 09:12:46,13645.0,2,3402,2,13645.0,4,13650.0,13,B
2018-04-03 09:12:51,13650.0,8,3410,0,13645.0,6,13650.0,6,B
2018-04-03 09:12:54,13650.0,14,3424,-12,13650.0,3,13655.0,30,B
2018-04-03 09:12:54,13650.0,8,3432,-8,13645.0,1,13655.0,32,B
2018-04-03 09:13:05,13650.0,2,3434,-2,13640.0,3,13650.0,3,B
2018-04-03 09:13:09,13640.0,2,3436,0,13640.0,2,13650.0,2,S
2018-04-03 09:13:16,13645.0,2,3438,0,13640.0,3,13650.0,2,B
2018-04-03 09:13:25,13640.0,6,3444,-6,13635.0,6,13645.0,1,S
2018-04-03 09:13:43,13645.0,4,3448,0,13635.0,5,13650.0,29,B
2018-04-03 09:13:57,13640.0,2,3450,2,13635.0,2,13640.0,3,S
2018-04-03 09:14:15,13635.0,2,3452,0,13635.0,1,13640.0,1,S
2018-04-03 09:14:26,13645.0,2,3454,0,13635.0,7,13645.0,4,B
2018-04-03 09:14:33,13635.0,2,3456,2,13630.0,17,13645.0,35,S
2018-04-03 09:14:56,13630.0,2,3458,-2,13630.0,21,13640.0,1,S
2018-04-03 09:15:00,13630.0,2,3460,0,13630.0,19,13640.0,1,S
2018-04-03 09:15:08,13640.0,2,3462,0,13630.0,19,13645.0,37,B
2018-04-03 09:15:15,13630.0,2,3464,2,13630.0,18,13640.0,4,S
2018-04-03 09:15:33,13630.0,2,3466,2,13630.0,15,13640.0,31,S
2018-04-03 09:15:59,13635.0,2,3468,0,13630.0,17,13640.0,4,B
2018-04-03 09:16:12,13630.0,6,3474,6,13630.0,12,13640.0,32,S
2018-04-03 09:16:13,13630.0,24,3498,18,13625.0,7,13635.0,13,S
2018-04-03 09:16:26,13625.0,8,3506,0,13625.0,4,13630.0,17,S
2018-04-03 09:16:26,13625.0,8,3514,6,13620.0,8,13625.0,6,S
2018-04-03 09:16:27,13620.0,8,3522,4,13620.0,4,13625.0,14,S
2018-04-03 09:16:28,13620.0,8,3530,8,13615.0,1,13625.0,14,S
2018-04-03 09:16:29,13615.0,2,3532,-2,13610.0,3,13620.0,1,S
2018-04-03 09:16:40,13615.0,2,3534,2,13610.0,4,13620.0,1,S
2018-04-03 09:16:44,13610.0,2,3536,-2,13610.0,9,13615.0,2,S
2018-04-03 09:16:44,13615.0,4,3540,0,13610.0,9,13620.0,2,B
2018-04-03 09:16:51,13610.0,14,3554,8,13605.0,9,13610.0,3,S
2018-04-03 09:16:56,13605.0,22,3576,18,13600.0,40,13605.0,8,S
2018-04-03 09:16:57,13605.0,16,3592,8,13600.0,40,13615.0,6,S
2018-04-03 09:16:58,13605.0,2,3594,-2,13600.0,42,13610.0,3,S
2018-04-03 09:17:00,13610.0,2,3596,0,13605.0,1,13610.0,2,B
2018-04-03 09:17:06,13600.0,2,3598,0,13600.0,38,13605.0,1,S
2018-04-03 09:17:06,13600.0,2,3600,-2,13600.0,37,13605.0,1,S
2018-04-03 09:17:07,13600.0,6,3606,-4,13600.0,35,13610.0,17,S
2018-04-03 09:17:08,13600.0,10,3616,6,13600.0,31,13605.0,4,S
2018-04-03 09:17:10,13600.0,6,3622,0,13600.0,28,13605.0,2,S
2018-04-03 09:17:10,13600.0,2,3624,0,13600.0,27,13610.0,22,S
2018-04-03 09:17:13,13600.0,20,3644,0,13600.0,17,13605.0,4,S
2018-04-03 09:17:13,13600.0,20,3664,0,13600.0,7,13605.0,6,S
2018-04-03 09:17:14,13605.0,6,3670,-2,13600.0,5,13605.0,17,B
2018-04-03 09:17:14,13600.0,10,3680,2,13595.0,1,13600.0,2,S
2018-04-03 09:17:18,13595.0,2,3682,0,13590.0,9,13600.0,17,S
2018-04-03 09:17:19,13590.0,14,3696,-2,13590.0,2,13595.0,20,S
2018-04-03 09:17:20,13580.0,24,3720,-8,13580.0,5,13590.0,6,S
2018-04-03 09:17:20,13580.0,2,3722,-2,13585.0,1,13590.0,3,S
2018-04-03 09:17:21,13590.0,8,3730,4,13585.0,2,13595.0,17,B
2018-04-03 09:17:21,13590.0,2,3732,0,13585.0,5,13595.0,1,B
2018-04-03 09:17:23,13585.0,2,3734,-2,13580.0,8,13585.0,2,S
2018-04-03 09:17:23,13585.0,4,3738,-4,13585.0,2,13595.0,3,S
2018-04-03 09:17:29,13580.0,10,3748,2,13575.0,4,13580.0,1,S
2018-04-03 09:17:29,13575.0,6,3754,2,13570.0,2,13580.0,5,S
2018-04-03 09:17:31,13570.0,4,3758,0,13565.0,3,13570.0,1,S
2018-04-03 09:17:31,13570.0,8,3766,0,13570.0,1,13580.0,4,S
2018-04-03 09:17:32,13570.0,4,3770,-2,13565.0,4,13570.0,1,S
2018-04-03 09:17:33,13570.0,2,3772,0,13565.0,5,13575.0,3,S
2018-04-03 09:17:34,13565.0,10,3782,4,13560.0,4,13565.0,1,S
2018-04-03 09:17:35,13565.0,6,3788,-4,13560.0,3,13565.0,33,S
2018-04-03 09:17:42,13560.0,4,3792,0,13560.0,2,13565.0,18,S
2018-04-03 09:17:43,13565.0,6,3798,0,13555.0,5,13565.0,17,B
2018-04-03 09:17:44,13565.0,2,3800,-2,13555.0,6,13565.0,5,B
2018-04-03 09:17:46,13560.0,2,3802,0,13555.0,6,13560.0,2,S
2018-04-03 09:17:46,13560.0,4,3806,-4,13560.0,1,13565.0,5,S
2018-04-03 09:17:48,13565.0,2,3808,2,13560.0,3,13565.0,1,B
2018-04-03 09:17:48,13565.0,2,3810,0,13560.0,3,13570.0,5,B
2018-04-03 09:17:50,13560.0,6,3816,-4,13555.0,6,13570.0,7,S
2018-04-03 09:17:54,13560.0,12,3828,8,13555.0,11,13560.0,4,S
2018-04-03 09:17:55,13560.0,8,3836,0,13560.0,1,13570.0,8,S
2018-04-03 09:17:55,13570.0,18,3854,10,13570.0,1,13575.0,4,B
2018-04-03 09:17:56,13570.0,4,3858,-2,13555.0,9,13570.0,4,B
2018-04-03 09:17:57,13560.0,6,3864,-6,13555.0,9,13570.0,4,S
2018-04-03 09:17:59,13560.0,2,3866,0,13555.0,8,13565.0,1,S
2018-04-03 09:18:01,13555.0,10,3876,4,13555.0,3,13560.0,10,S
2018-04-03 09:18:01,13555.0,2,3878,2,13555.0,2,13560.0,10,S
2018-04-03 09:18:02,13555.0,4,3882,-4,13550.0,31,13555.0,2,S
2018-04-03 09:18:02,13555.0,6,3888,-2,13555.0,1,13560.0,11,S
2018-04-03 09:18:03,13555.0,4,3892,2,13550.0,33,13560.0,10,S
2018-04-03 09:18:04,13555.0,4,3896,-4,13550.0,31,13560.0,12,S
2018-04-03 09:18:06,13550.0,62,3958,30,13545.0,2,13555.0,2,S
2018-04-03 09:18:07,13555.0,4,3962,0,13545.0,1,13555.0,5,B
2018-04-03 09:18:08,13545.0,2,3964,-2,13530.0,3,13545.0,2,S
2018-04-03 09:18:08,13545.0,4,3968,-4,13545.0,4,13555.0,5,S
2018-04-03 09:18:09,13545.0,8,3976,-2,13535.0,5,13545.0,4,S
2018-04-03 09:18:11,13540.0,6,3982,0,13540.0,2,13545.0,5,S
2018-04-03 09:18:12,13545.0,8,3990,-4,13530.0,9,13545.0,3,B
2018-04-03 09:18:12,13535.0,2,3992,-2,13535.0,1,13545.0,3,S
2018-04-03 09:18:14,13535.0,8,4000,-6,13530.0,9,13535.0,11,S
2018-04-03 09:18:14,13535.0,22,4022,-6,13530.0,9,13545.0,4,S
2018-04-03 09:18:15,13530.0,4,4026,-4,13530.0,8,13545.0,4,S
2018-04-03 09:18:15,13530.0,4,4030,-2,13530.0,7,13545.0,3,S
2018-04-03 09:18:16,13530.0,2,4032,0,13535.0,10,13545.0,1,S
2018-04-03 09:18:18,13540.0,2,4034,-2,13540.0,1,13545.0,1,B
2018-04-03 09:18:19,13540.0,2,4036,0,13535.0,6,13545.0,3,B
2018-04-03 09:18:20,13535.0,8,4044,-4,13535.0,3,13545.0,4,S
2018-04-03 09:18:20,13545.0,2,4046,2,13535.0,2,13545.0,3,B
2018-04-03 09:18:21,13545.0,2,4048,-2,13535.0,1,13540.0,3,B
2018-04-03 09:18:22,13535.0,2,4050,0,13530.0,4,13540.0,3,S
2018-04-03 09:18:24,13535.0,2,4052,2,13540.0,2,13550.0,11,S
2018-04-03 09:18:31,13550.0,10,4062,-4,13545.0,4,13555.0,5,B
2018-04-03 09:18:32,13550.0,2,4064,0,13545.0,4,13555.0,2,B
2018-04-03 09:18:32,13555.0,2,4066,-2,13550.0,3,13555.0,2,B
2018-04-03 09:18:34,13555.0,4,4070,0,13555.0,2,13560.0,4,B
2018-04-03 09:18:35,13555.0,2,4072,2,13555.0,1,13560.0,1,B
2018-04-03 09:18:36,13555.0,6,4078,6,13550.0,5,13560.0,2,B
2018-04-03 09:18:38,13555.0,2,4080,2,13550.0,6,13560.0,2,B
2018-04-03 09:18:41,13560.0,2,4082,-2,13555.0,3,13560.0,6,B
2018-04-03 09:18:41,13560.0,2,4084,0,13555.0,3,13560.0,5,B
2018-04-03 09:18:42,13560.0,10,4094,-8,13555.0,6,13560.0,17,B
2018-04-03 09:18:43,13555.0,2,4096,2,13555.0,5,13560.0,17,S
2018-04-03 09:18:44,13550.0,4,4100,0,13550.0,3,13560.0,17,S
2018-04-03 09:18:47,13555.0,4,4104,0,13550.0,2,13560.0,17,B
2018-04-03 09:18:49,13555.0,4,4108,2,13550.0,8,13560.0,17,B
2018-04-03 09:18:52,13560.0,10,4118,6,13555.0,3,13560.0,12,B
2018-04-03 09:18:53,13560.0,24,4142,2,13555.0,3,13565.0,3,B
2018-04-03 09:18:59,13570.0,6,4148,-4,13560.0,3,13575.0,6,B
2018-04-03 09:19:00,13570.0,4,4152,2,13565.0,3,13570.0,2,B
2018-04-03 09:19:01,13565.0,4,4156,-4,13555.0,1,13565.0,1,S
2018-04-03 09:19:02,13565.0,2,4158,-2,13555.0,5,13565.0,1,S
2018-04-03 09:19:03,13565.0,2,4160,-2,13560.0,1,13565.0,1,S
2018-04-03 09:19:06,13555.0,2,4162,-2,13550.0,3,13555.0,1,S
2018-04-03 09:19:07,13555.0,2,4164,-2,13550.0,6,13560.0,1,S
2018-04-03 09:19:13,13560.0,6,4170,-6,13555.0,3,13565.0,9,B
2018-04-03 09:19:14,13555.0,2,4172,0,13555.0,2,13565.0,3,S
2018-04-03 09:19:19,13565.0,2,4174,0,13560.0,1,13565.0,2,B
2018-04-03 09:19:19,13565.0,2,4176,2,13560.0,1,13565.0,2,B
2018-04-03 09:19:30,13565.0,2,4178,-2,13560.0,6,13565.0,1,B
2018-04-03 09:19:30,13565.0,2,4180,2,13560.0,6,13570.0,8,B
2018-04-03 09:19:33,13565.0,2,4182,0,13565.0,5,13570.0,4,B
2018-04-03 09:19:35,13570.0,2,4184,0,13565.0,5,13570.0,3,B
2018-04-03 09:19:35,13570.0,6,4190,4,13565.0,9,13575.0,4,B
2018-04-03 09:19:36,13565.0,6,4196,0,13565.0,3,13570.0,1,S
2018-04-03 09:19:37,13570.0,2,4198,2,13565.0,3,13575.0,6,B
2018-04-03 09:19:39,13565.0,6,4204,2,13560.0,4,13570.0,2,S
2018-04-03 09:19:42,13570.0,2,4206,0,13560.0,7,13575.0,14,B
2018-04-03 09:19:42,13570.0,2,4208,0,13560.0,7,13570.0,1,B
2018-04-03 09:19:43,13575.0,2,4210,-2,13560.0,7,13575.0,12,B
2018-04-03 09:19:43,13575.0,2,4212,-2,13560.0,7,13575.0,11,B
2018-04-03 09:19:44,13570.0,4,4216,4,13560.0,7,13575.0,11,S
2018-04-03 09:19:45,13575.0,6,4222,0,13565.0,5,13575.0,8,B
2018-04-03 09:19:59,13575.0,4,4226,0,13565.0,5,13570.0,1,B
2018-04-03 09:20:00,13575.0,6,4232,0,13565.0,5,13575.0,26,B
2018-04-03 09:20:01,13575.0,2,4234,0,13565.0,5,13575.0,25,B
2018-04-03 09:20:01,13565.0,4,4238,-4,13565.0,3,13570.0,5,S
2018-04-03 09:20:02,13570.0,2,4240,0,13565.0,2,13570.0,4,B
2018-04-03 09:20:03,13570.0,6,4246,0,13565.0,4,13570.0,1,B
2018-04-03 09:20:03,13570.0,2,4248,0,13565.0,4,13575.0,20,B
2018-04-03 09:20:07,13570.0,2,4250,-2,13565.0,1,13570.0,5,B
2018-04-03 09:20:09,13570.0,2,4252,2,13565.0,2,13570.0,1,B
2018-04-03 09:20:20,13570.0,2,4254,0,13565.0,2,13570.0,1,B
2018-04-03 09:20:22,13570.0,2,4256,2,13565.0,1,13575.0,19,B
2018-04-03 09:20:26,13570.0,2,4258,0,13570.0,4,13575.0,4,B
2018-04-03 09:20:34,13575.0,8,4266,2,13570.0,6,13580.0,4,B
2018-04-03 09:20:38,13585.0,4,4270,-2,13575.0,4,13585.0,14,B
2018-04-03 09:20:39,13585.0,2,4272,0,13570.0,9,13585.0,6,B
2018-04-03 09:20:40,13575.0,2,4274,0,13575.0,7,13585.0,4,S
2018-04-03 09:20:42,13585.0,8,4282,0,13585.0,11,13590.0,4,B
2018-04-03 09:20:42,13585.0,28,4310,-20,13570.0,4,13590.0,5,B
2018-04-03 09:20:48,13590.0,2,4312,-2,13580.0,1,13590.0,7,B
2018-04-03 09:21:00,13575.0,12,4324,-4,13570.0,1,13580.0,1,S
2018-04-03 09:21:03,13575.0,4,4328,-4,13575.0,3,13580.0,3,S
2018-04-03 09:21:05,13580.0,6,4334,-4,13580.0,2,13585.0,6,B
2018-04-03 09:21:05,13580.0,4,4338,-4,13570.0,3,13585.0,7,B
2018-04-03 09:21:08,13570.0,2,4340,2,13570.0,4,13580.0,2,S
2018-04-03 09:21:18,13580.0,4,4344,0,13570.0,4,13580.0,4,B
2018-04-03 09:21:23,13580.0,4,4348,-4,13570.0,5,13580.0,1,B
2018-04-03 09:21:24,13585.0,4,4352,0,13570.0,6,13585.0,18,B
2018-04-03 09:21:24,13585.0,2,4354,0,13570.0,6,13580.0,1,B
2018-04-03 09:21:25,13585.0,2,4356,0,13570.0,6,13585.0,20,B
2018-04-03 09:21:25,13585.0,2,4358,0,13570.0,6,13585.0,21,B
2018-04-03 09:21:30,13570.0,2,4360,0,13565.0,6,13575.0,1,S
2018-04-03 09:21:40,13565.0,4,4364,0,13560.0,3,13570.0,2,S
2018-04-03 09:21:46,13560.0,28,4392,6,13555.0,4,13565.0,2,S
2018-04-03 09:21:47,13565.0,2,4394,-2,13555.0,5,13565.0,2,B
2018-04-03 09:21:47,13565.0,4,4398,0,13555.0,4,13570.0,13,B
2018-04-03 09:21:48,13565.0,2,4400,0,13555.0,4,13565.0,2,B
2018-04-03 09:21:49,13570.0,6,4406,-4,13560.0,6,13570.0,12,B
2018-04-03 09:21:49,13560.0,4,4410,-4,13560.0,3,13570.0,12,S
2018-04-03 09:21:50,13560.0,4,4414,-4,13560.0,1,13570.0,12,S
2018-04-03 09:21:52,13570.0,4,4418,0,13560.0,5,13575.0,13,B
2018-04-03 09:21:55,13560.0,2,4420,-2,13560.0,5,13575.0,14,S
2018-04-03 09:21:58,13560.0,2,4422,-2,13555.0,3,13570.0,8,S
2018-04-03 09:21:59,13565.0,4,4426,0,13555.0,2,13565.0,18,B
2018-04-03 09:22:01,13555.0,2,4428,0,13555.0,1,13565.0,12,S
2018-04-03 09:22:03,13555.0,2,4430,0,13550.0,4,13565.0,13,S
2018-04-03 09:22:05,13555.0,2,4432,0,13550.0,4,13555.0,2,S
2018-04-03 09:22:06,13550.0,2,4434,0,13550.0,2,13555.0,2,S
2018-04-03 09:22:07,13555.0,4,4438,0,13555.0,1,13560.0,7,B
2018-04-03 09:22:07,13550.0,6,4444,0,13545.0,6,13555.0,1,S
2018-04-03 09:22:15,13545.0,2,4446,2,13545.0,7,13555.0,3,S
2018-04-03 09:22:18,13550.0,2,4448,-2,13545.0,7,13560.0,11,B
2018-04-03 09:22:19,13555.0,4,4452,0,13545.0,7,13555.0,1,B
2018-04-03 09:22:20,13560.0,4,4456,-2,13545.0,7,13560.0,11,B
2018-04-03 09:22:21,13560.0,2,4458,0,13545.0,8,13560.0,9,B
2018-04-03 09:22:21,13560.0,4,4462,-2,13550.0,7,13560.0,3,B
2018-04-03 09:22:22,13565.0,4,4466,0,13550.0,16,13565.0,5,B
2018-04-03 09:22:22,13565.0,2,4468,0,13550.0,19,13565.0,7,B
2018-04-03 09:22:26,13565.0,2,4470,0,13550.0,18,13565.0,6,B
2018-04-03 09:22:28,13565.0,2,4472,2,13550.0,19,13565.0,5,B
2018-04-03 09:22:33,13565.0,4,4476,0,13560.0,1,13565.0,1,B
2018-04-03 09:22:34,13565.0,2,4478,2,13560.0,2,13570.0,4,B
2018-04-03 09:22:34,13560.0,2,4480,0,13555.0,11,13570.0,4,S
2018-04-03 09:22:40,13560.0,6,4486,-6,13560.0,7,13570.0,3,S
2018-04-03 09:23:08,13570.0,4,4490,0,13560.0,8,13570.0,1,B
2018-04-03 09:23:10,13560.0,2,4492,-2,13560.0,2,13565.0,9,S
2018-04-03 09:23:22,13560.0,4,4496,4,13555.0,3,13560.0,8,S
2018-04-03 09:23:23,13555.0,2,4498,0,13550.0,7,13560.0,11,S
2018-04-03 09:23:25,13560.0,20,4518,20,13550.0,3,13560.0,17,B
2018-04-03 09:23:26,13555.0,2,4520,0,13550.0,6,13560.0,4,S
2018-04-03 09:23:27,13560.0,2,4522,0,13555.0,2,13565.0,16,B
2018-04-03 09:23:34,13550.0,12,4534,2,13550.0,1,13555.0,2,S
2018-04-03 09:23:52,13555.0,2,4536,0,13545.0,8,13560.0,20,B
2018-04-03 09:24:01,13545.0,24,4560,6,13545.0,1,13550.0,2,S
2018-04-03 09:24:06,13535.0,2,4562,2,13530.0,1,13535.0,2,S
2018-04-03 09:24:07,13540.0,10,4572,0,13530.0,7,13540.0,3,B
2018-04-03 09:24:08,13540.0,4,4576,-4,13535.0,1,13540.0,2,B
2018-04-03 09:24:08,13540.0,4,4580,0,13535.0,1,13540.0,1,B
2018-04-03 09:24:09,13545.0,6,4586,-2,13540.0,1,13545.0,17,B
2018-04-03 09:24:10,13545.0,2,4588,-2,13540.0,1,13545.0,15,B
2018-04-03 09:24:13,13545.0,2,4590,2,13535.0,11,13545.0,15,B
2018-04-03 09:24:14,13545.0,8,4598,2,13535.0,10,13550.0,1,B
2018-04-03 09:24:15,13540.0,2,4600,-2,13540.0,7,13550.0,4,S
2018-04-03 09:24:18,13540.0,4,4604,0,13540.0,4,13550.0,4,S
2018-04-03 09:24:23,13545.0,2,4606,0,13535.0,3,13545.0,5,B
2018-04-03 09:24:23,13540.0,6,4612,0,13535.0,2,13540.0,1,S
2018-04-03 09:24:25,13540.0,4,4616,0,13535.0,2,13545.0,2,S
2018-04-03 09:24:30,13540.0,2,4618,2,13540.0,3,13550.0,3,S
2018-04-03 09:24:34,13545.0,2,4620,-2,13540.0,7,13550.0,3,B
2018-04-03 09:24:42,13545.0,26,4646,12,13540.0,6,13545.0,4,B
2018-04-03 09:24:42,13545.0,8,4654,6,13545.0,4,13555.0,5,B
2018-04-03 09:24:43,13545.0,2,4656,2,13545.0,3,13555.0,3,B
2018-04-03 09:24:44,13550.0,4,4660,4,13540.0,5,13550.0,1,B
2018-04-03 09:24:45,13550.0,2,4662,0,13545.0,5,13550.0,3,B
2018-04-03 09:24:46,13555.0,2,4664,-2,13545.0,12,13555.0,2,B
2018-04-03 09:24:46,13555.0,2,4666,0,13545.0,9,13555.0,1,B
2018-04-03 09:24:55,13550.0,6,4672,-4,13550.0,3,13555.0,1,S
2018-04-03 09:25:01,13550.0,2,4674,-2,13545.0,3,13550.0,6,S
2018-04-03 09:25:07,13545.0,2,4676,2,13545.0,4,13550.0,12,S
2018-04-03 09:25:08,13545.0,8,4684,2,13540.0,2,13550.0,8,S
2018-04-03 09:25:12,13540.0,2,4686,2,13540.0,1,13545.0,7,S
2018-04-03 09:25:13,13540.0,2,4688,0,13535.0,7,13540.0,11,S
2018-04-03 09:25:14,13535.0,4,4692,0,13535.0,3,13540.0,11,S
2018-04-03 09:25:15,13535.0,4,4696,0,13530.0,16,13535.0,2,S
2018-04-03 09:25:20,13530.0,2,4698,2,13530.0,13,13540.0,18,S
2018-04-03 09:25:20,13540.0,2,4700,0,13530.0,13,13540.0,15,B
2018-04-03 09:25:24,13535.0,2,4702,-2,13530.0,15,13540.0,12,S
2018-04-03 09:25:26,13540.0,2,4704,0,13535.0,3,13540.0,9,B
2018-04-03 09:25:27,13540.0,4,4708,0,13535.0,5,13540.0,8,B
2018-04-03 09:25:27,13540.0,4,4712,0,13535.0,5,13540.0,5,B
2018-04-03 09:25:28,13540.0,4,4716,0,13535.0,5,13540.0,3,B
2018-04-03 09:25:28,13540.0,4,4720,0,13535.0,5,13540.0,1,B
2018-04-03 09:25:29,13540.0,2,4722,-2,13535.0,5,13545.0,6,B
2018-04-03 09:25:36,13545.0,2,4724,2,13540.0,8,13550.0,15,B
2018-04-03 09:25:37,13540.0,2,4726,0,13540.0,7,13550.0,13,S
2018-04-03 09:25:37,13540.0,2,4728,0,13540.0,6,13550.0,14,S
2018-04-03 09:25:41,13540.0,12,4740,6,13535.0,5,13540.0,4,S
2018-04-03 09:25:41,13540.0,8,4748,8,13540.0,1,13550.0,12,S
2018-04-03 09:25:45,13550.0,2,4750,0,13540.0,1,13550.0,13,B
2018-04-03 09:25:47,13550.0,4,4754,4,13540.0,1,13550.0,11,B
2018-04-03 09:25:49,13550.0,2,4756,0,13540.0,1,13550.0,11,B
2018-04-03 09:25:49,13550.0,2,4758,0,13540.0,1,13550.0,10,B
2018-04-03 09:25:52,13550.0,4,4762,4,13540.0,1,13550.0,10,B
2018-04-03 09:26:01,13535.0,10,4772,-8,13535.0,5,13540.0,4,S
2018-04-03 09:26:02,13535.0,6,4778,2,13530.0,15,13535.0,3,S
2018-04-03 09:26:02,13540.0,20,4798,16,13530.0,15,13540.0,7,B
2018-04-03 09:26:05,13530.0,2,4800,0,13530.0,14,13535.0,5,S
2018-04-03 09:26:06,13535.0,2,4802,0,13530.0,14,13535.0,2,B
2018-04-03 09:26:07,13530.0,20,4822,0,13530.0,4,13535.0,2,S
2018-04-03 09:26:08,13530.0,2,4824,2,13530.0,3,13535.0,2,S
2018-04-03 09:26:08,13530.0,6,4830,-4,13525.0,6,13535.0,4,S
2018-04-03 09:26:09,13525.0,4,4834,0,13525.0,2,13535.0,5,S
2018-04-03 09:26:10,13530.0,2,4836,0,13525.0,2,13535.0,19,B
2018-04-03 09:26:11,13525.0,4,4840,0,13520.0,14,13525.0,8,S
2018-04-03 09:26:11,13520.0,6,4846,-4,13520.0,10,13525.0,21,S
2018-04-03 09:26:12,13520.0,20,4866,-6,13515.0,7,13525.0,10,S
2018-04-03 09:26:13,13520.0,4,4870,4,13520.0,1,13525.0,7,S
2018-04-03 09:26:17,13515.0,4,4874,0,13515.0,4,13525.0,1,S
2018-04-03 09:26:22,13525.0,2,4876,-2,13525.0,2,13530.0,3,B
2018-04-03 09:26:22,13525.0,4,4880,-2,13515.0,8,13525.0,1,B
2018-04-03 09:26:29,13520.0,2,4882,2,13520.0,5,13530.0,9,S
2018-04-03 09:26:29,13530.0,2,4884,0,13515.0,19,13530.0,9,B
2018-04-03 09:26:30,13520.0,4,4888,-2,13520.0,4,13530.0,3,S
2018-04-03 09:26:36,13520.0,2,4890,2,13515.0,17,13525.0,2,S
2018-04-03 09:26:40,13515.0,2,4892,0,13515.0,22,13525.0,3,S
2018-04-03 09:26:42,13515.0,30,4922,-4,13515.0,6,13520.0,2,S
2018-04-03 09:26:42,13515.0,4,4926,0,13515.0,4,13520.0,3,S
2018-04-03 09:26:48,13520.0,2,4928,2,13520.0,2,13525.0,4,B
2018-04-03 09:26:48,13520.0,2,4930,2,13520.0,1,13525.0,2,B
2018-04-03 09:26:50,13525.0,2,4932,2,13520.0,1,13525.0,3,B
2018-04-03 09:26:57,13530.0,2,4934,0,13525.0,3,13530.0,5,B
2018-04-03 09:26:57,13525.0,4,4938,0,13520.0,8,13530.0,4,S
2018-04-03 09:27:00,13530.0,2,4940,0,13520.0,6,13530.0,4,B
2018-04-03 09:27:04,13530.0,2,4942,0,13520.0,5,13530.0,10,B
2018-04-03 09:27:04,13530.0,2,4944,-2,13520.0,6,13530.0,22,B
2018-04-03 09:27:05,13525.0,8,4952,8,13525.0,4,13530.0,41,S
2018-04-03 09:27:06,13520.0,10,4962,-2,13515.0,7,13525.0,19,S
2018-04-03 09:27:06,13525.0,2,4964,0,13515.0,7,13525.0,4,B
2018-04-03 09:27:07,13525.0,4,4968,0,13515.0,9,13525.0,1,B
2018-04-03 09:27:12,13525.0,2,4970,0,13515.0,6,13520.0,5,B
2018-04-03 09:27:12,13525.0,6,4976,0,13515.0,5,13520.0,2,B
2018-04-03 09:27:13,13520.0,2,4978,2,13515.0,5,13520.0,3,S
2018-04-03 09:27:16,13520.0,2,4980,-2,13515.0,5,13525.0,20,S
2018-04-03 09:27:18,13515.0,2,4982,-2,13515.0,5,13520.0,1,S
2018-04-03 09:27:20,13520.0,2,4984,0,13515.0,5,13525.0,17,B
2018-04-03 09:27:21,13515.0,2,4986,0,13515.0,3,13520.0,3,S
2018-04-03 09:27:21,13525.0,2,4988,0,13515.0,3,13525.0,15,B
2018-04-03 09:27:22,13525.0,2,4990,0,13520.0,1,13525.0,3,B
2018-04-03 09:27:23,13520.0,2,4992,-2,13520.0,1,13525.0,1,S
2018-04-03 09:27:24,13520.0,2,4994,0,13515.0,4,13525.0,8,S
2018-04-03 09:27:25,13525.0,2,4996,0,13520.0,2,13530.0,9,B
2018-04-03 09:27:25,13525.0,2,4998,0,13520.0,3,13530.0,11,B
2018-04-03 09:27:27,13520.0,10,5008,4,13515.0,5,13530.0,7,S
2018-04-03 09:27:31,13520.0,2,5010,0,13520.0,4,13530.0,10,S
2018-04-03 09:27:32,13530.0,2,5012,0,13515.0,5,13530.0,9,B
2018-04-03 09:27:33,13530.0,4,5016,-2,13515.0,5,13525.0,1,B
2018-04-03 09:27:34,13530.0,6,5022,-2,13520.0,1,13530.0,5,B
2018-04-03 09:27:39,13520.0,4,5026,0,13515.0,8,13520.0,8,S
2018-04-03 09:27:39,13520.0,2,5028,2,13515.0,6,13520.0,7,S
2018-04-03 09:27:40,13520.0,6,5034,0,13515.0,7,13520.0,4,S
2018-04-03 09:27:41,13520.0,8,5042,0,13515.0,8,13525.0,1,S
2018-04-03 09:27:43,13520.0,2,5044,2,13515.0,5,13525.0,9,S
2018-04-03 09:27:44,13525.0,2,5046,2,13515.0,4,13520.0,4,B
2018-04-03 09:27:45,13515.0,8,5054,0,13510.0,8,13520.0,4,S
2018-04-03 09:27:53,13515.0,2,5056,0,13515.0,4,13520.0,11,S
2018-04-03 09:27:54,13515.0,2,5058,0,13515.0,3,13520.0,11,S
2018-04-03 09:27:58,13520.0,2,5060,0,13510.0,11,13520.0,9,B
2018-04-03 09:28:02,13510.0,10,5070,-2,13505.0,18,13510.0,5,S
2018-04-03 09:28:02,13510.0,2,5072,0,13505.0,18,13510.0,7,S
2018-04-03 09:28:03,13510.0,2,5074,0,13505.0,17,13515.0,4,S
2018-04-03 09:28:04,13520.0,4,5078,0,13510.0,3,13520.0,9,B
2018-04-03 09:28:05,13520.0,4,5082,0,13510.0,3,13520.0,10,B
2018-04-03 09:28:07,13515.0,2,5084,0,13510.0,1,13515.0,6,S
2018-04-03 09:28:10,13505.0,16,5100,4,13505.0,9,13510.0,3,S
2018-04-03 09:28:10,13510.0,6,5106,4,13510.0,1,13515.0,18,B
2018-04-03 09:28:11,13510.0,2,5108,2,13505.0,9,13510.0,20,B
2018-04-03 09:28:11,13505.0,6,5114,6,13505.0,6,13510.0,37,S
2018-04-03 09:28:12,13505.0,8,5122,6,13505.0,2,13510.0,21,S
2018-04-03 09:28:14,13505.0,2,5124,2,13505.0,1,13510.0,22,S
2018-04-03 09:28:15,13510.0,4,5128,0,13505.0,5,13510.0,16,B
2018-04-03 09:28:15,13505.0,2,5130,0,13505.0,4,13510.0,14,S
2018-04-03 09:28:19,13505.0,2,5132,2,13500.0,82,13510.0,15,S
2018-04-03 09:28:21,13505.0,2,5134,2,13500.0,84,13510.0,16,S
2018-04-03 09:28:22,13510.0,20,5154,0,13500.0,84,13510.0,5,B
2018-04-03 09:28:26,13505.0,2,5156,2,13500.0,82,13510.0,7,S
2018-04-03 09:28:27,13505.0,4,5160,0,13505.0,1,13510.0,11,S
2018-04-03 09:28:28,13510.0,24,5184,0,13505.0,2,13510.0,6,B
2018-04-03 09:28:30,13500.0,10,5194,0,13500.0,76,13505.0,1,S
2018-04-03 09:28:30,13500.0,4,5198,-4,13500.0,74,13510.0,11,S
2018-04-03 09:28:35,13505.0,2,5200,0,13500.0,74,13505.0,4,B
2018-04-03 09:28:37,13505.0,2,5202,2,13500.0,74,13505.0,3,B
2018-04-03 09:28:38,13505.0,6,5208,0,13505.0,1,13510.0,10,B
2018-04-03 09:28:40,13505.0,2,5210,2,13500.0,75,13510.0,7,B
2018-04-03 09:28:41,13505.0,2,5212,0,13500.0,75,13510.0,7,B
2018-04-03 09:28:43,13510.0,2,5214,0,13505.0,7,13510.0,6,B
2018-04-03 09:28:43,13510.0,12,5226,2,13505.0,8,13515.0,4,B
2018-04-03 09:28:44,13515.0,2,5228,2,13515.0,4,13520.0,10,B
2018-04-03 09:28:47,13510.0,2,5230,0,13510.0,2,13520.0,7,S
2018-04-03 09:28:48,13510.0,2,5232,0,13505.0,7,13520.0,12,S
2018-04-03 09:28:50,13515.0,2,5234,0,13510.0,4,13520.0,13,B
2018-04-03 09:28:57,13520.0,16,5250,0,13520.0,2,13525.0,5,B
2018-04-03 09:28:58,13515.0,6,5256,-2,13515.0,14,13520.0,8,S
2018-04-03 09:28:59,13520.0,10,5266,0,13515.0,14,13520.0,1,B
2018-04-03 09:29:00,13520.0,2,5268,0,13520.0,4,13525.0,5,B
2018-04-03 09:29:00,13520.0,8,5276,0,13515.0,15,13525.0,2,B
2018-04-03 09:29:01,13520.0,4,5280,0,13515.0,15,13525.0,4,B
2018-04-03 09:29:02,13515.0,8,5288,0,13515.0,11,13525.0,18,S
2018-04-03 09:29:03,13515.0,12,5300,-4,13515.0,4,13520.0,12,S
2018-04-03 09:29:04,13525.0,10,5310,0,13510.0,8,13525.0,19,B
2018-04-03 09:29:08,13515.0,2,5312,2,13510.0,8,13515.0,1,S
2018-04-03 09:29:09,13510.0,2,5314,0,13510.0,7,13515.0,2,S
2018-04-03 09:29:09,13510.0,6,5320,-2,13510.0,6,13520.0,10,S
2018-04-03 09:29:10,13510.0,4,5324,0,13510.0,5,13520.0,10,S
2018-04-03 09:29:11,13510.0,2,5326,0,13510.0,5,13520.0,10,S
2018-04-03 09:29:11,13505.0,18,5344,-12,13505.0,1,13510.0,4,S
2018-04-03 09:29:12,13510.0,2,5346,-2,13505.0,1,13510.0,5,B
2018-04-03 09:29:12,13510.0,4,5350,-2,13505.0,1,13510.0,1,B
2018-04-03 09:29:13,13505.0,2,5352,2,13500.0,76,13505.0,7,S
2018-04-03 09:29:13,13505.0,16,5368,12,13500.0,76,13505.0,4,S
2018-04-03 09:29:14,13505.0,8,5376,4,13500.0,76,13510.0,4,S
2018-04-03 09:29:15,13500.0,20,5396,2,13500.0,67,13510.0,1,S
2018-04-03 09:29:16,13500.0,22,5418,-2,13500.0,57,13515.0,1,S
2018-04-03 09:29:20,13500.0,4,5422,-4,13500.0,54,13505.0,1,S
2018-04-03 09:29:21,13500.0,30,5452,-14,13500.0,39,13505.0,2,S
2018-04-03 09:29:21,13500.0,2,5454,0,13500.0,38,13505.0,2,S
2018-04-03 09:29:22,13500.0,4,5458,-4,13500.0,36,13505.0,14,S
2018-04-03 09:29:23,13500.0,2,5460,0,13500.0,35,13505.0,14,S
2018-04-03 09:29:24,13505.0,2,5462,2,13500.0,35,13510.0,15,B
2018-04-03 09:29:24,13500.0,20,5482,0,13500.0,25,13510.0,15,S
2018-04-03 09:29:25,13500.0,20,5502,2,13500.0,20,13510.0,14,S
2018-04-03 09:29:26,13500.0,2,5504,-2,13500.0,19,13505.0,12,S
2018-04-03 09:29:27,13500.0,4,5508,-4,13500.0,16,13505.0,12,S
2018-04-03 09:29:28,13500.0,2,5510,2,13500.0,15,13505.0,12,S
2018-04-03 09:29:28,13495.0,42,5552,20,13495.0,1,13500.0,3,S
2018-04-03 09:29:29,13500.0,2,5554,2,13490.0,3,13495.0,1,B
2018-04-03 09:29:30,13500.0,2,5556,0,13490.0,7,13500.0,6,B
2018-04-03 09:29:31,13490.0,14,5570,2,13485.0,4,13490.0,2,S
2018-04-03 09:29:31,13480.0,24,5594,-14,13480.0,8,13490.0,6,S
2018-04-03 09:29:32,13480.0,4,5598,0,13480.0,5,13485.0,1,S
2018-04-03 09:29:32,13485.0,10,5608,-4,13480.0,3,13490.0,4,B
2018-04-03 09:29:33,13480.0,8,5616,-2,13470.0,1,13490.0,5,S
2018-04-03 09:29:35,13485.0,6,5622,6,13480.0,3,13485.0,4,B
2018-04-03 09:29:36,13485.0,6,5628,2,13475.0,1,13485.0,2,B
2018-04-03 09:29:36,13485.0,4,5632,0,13475.0,5,13485.0,1,B
2018-04-03 09:29:37,13490.0,4,5636,-4,13475.0,5,13490.0,2,B
2018-04-03 09:29:38,13490.0,2,5638,0,13475.0,5,13490.0,1,B
2018-04-03 09:29:39,13490.0,2,5640,-2,13475.0,1,13485.0,3,B
2018-04-03 09:29:39,13490.0,4,5644,0,13475.0,3,13495.0,4,B
2018-04-03 09:29:40,13495.0,2,5646,-2,13490.0,1,13495.0,5,B
2018-04-03 09:29:40,13490.0,2,5648,0,13480.0,1,13490.0,3,S
2018-04-03 09:29:41,13490.0,2,5650,0,13485.0,4,13490.0,3,S
2018-04-03 09:29:41,13490.0,4,5654,0,13485.0,1,13490.0,1,S
2018-04-03 09:29:43,13495.0,10,5664,6,13485.0,2,13495.0,2,B
2018-04-03 09:29:45,13495.0,2,5666,0,13485.0,3,13495.0,2,B
2018-04-03 09:29:50,13485.0,6,5672,-2,13480.0,2,13485.0,8,S
2018-04-03 09:29:51,13480.0,4,5676,-4,13475.0,1,13480.0,18,S
2018-04-03 09:29:52,13470.0,14,5690,-10,13465.0,51,13470.0,2,S
2018-04-03 09:29:52,13470.0,6,5696,0,13470.0,2,13475.0,1,S
2018-04-03 09:29:53,13475.0,2,5698,-2,13475.0,1,13480.0,1,B
2018-04-03 09:29:53,13480.0,2,5700,0,13475.0,4,13485.0,3,B
2018-04-03 09:29:54,13475.0,2,5702,-2,13475.0,3,13485.0,2,S
2018-04-03 09:29:58,13485.0,4,5706,0,13475.0,3,13480.0,7,B
2018-04-03 09:29:59,13475.0,2,5708,-2,13475.0,2,13480.0,7,S
2018-04-03 09:29:59,13480.0,14,5722,-10,13480.0,2,13485.0,2,B
2018-04-03 09:30:01,13480.0,4,5726,0,13475.0,2,13480.0,13,B
2018-04-03 09:30:01,13465.0,22,5748,4,13465.0,50,13480.0,18,S
2018-04-03 09:30:02,13475.0,22,5770,-4,13470.0,3,13475.0,1,B
2018-04-03 09:30:02,13475.0,2,5772,-2,13475.0,10,13480.0,3,B
2018-04-03 09:30:04,13480.0,4,5776,2,13480.0,1,13485.0,5,B
2018-04-03 09:30:05,13485.0,6,5782,0,13480.0,8,13485.0,1,B
2018-04-03 09:30:07,13485.0,2,5784,0,13480.0,8,13490.0,5,B
2018-04-03 09:30:08,13485.0,6,5790,4,13485.0,2,13490.0,2,B
2018-04-03 09:30:08,13490.0,6,5796,0,13485.0,4,13495.0,4,B
2018-04-03 09:30:09,13495.0,2,5798,2,13490.0,6,13495.0,1,B
2018-04-03 09:30:09,13495.0,2,5800,2,13495.0,3,13500.0,8,B
2018-04-03 09:30:10,13500.0,12,5812,8,13500.0,6,13505.0,1,B
2018-04-03 09:30:10,13500.0,10,5822,-2,13500.0,7,13505.0,1,B
2018-04-03 09:30:11,13510.0,4,5826,-4,13510.0,1,13515.0,2,B
2018-04-03 09:30:11,13510.0,4,5830,-2,13500.0,8,13510.0,4,B
2018-04-03 09:30:12,13500.0,2,5832,-2,13500.0,7,13510.0,3,S
2018-04-03 09:30:13,13510.0,2,5834,0,13505.0,6,13510.0,1,B
2018-04-03 09:30:14,13515.0,8,5842,-4,13510.0,1,13515.0,2,B
2018-04-03 09:30:14,13510.0,6,5848,-2,13505.0,3,13520.0,11,S
2018-04-03 09:30:17,13520.0,20,5868,0,13520.0,2,13525.0,3,B
2018-04-03 09:30:18,13520.0,6,5874,4,13520.0,1,13525.0,3,B
2018-04-03 09:30:18,13520.0,2,5876,-2,13515.0,4,13520.0,1,B
2018-04-03 09:30:19,13520.0,2,5878,0,13520.0,2,13525.0,2,B
2018-04-03 09:30:19,13525.0,2,5880,-2,13515.0,4,13520.0,1,B
2018-04-03 09:30:20,13520.0,2,5882,2,13520.0,5,13525.0,1,S
2018-04-03 09:30:20,13525.0,2,5884,0,13520.0,4,13530.0,1,B
2018-04-03 09:30:21,13520.0,2,5886,0,13520.0,4,13530.0,1,S
2018-04-03 09:30:22,13525.0,4,5890,-2,13525.0,5,13540.0,2,B
2018-04-03 09:30:23,13525.0,2,5892,2,13525.0,4,13535.0,6,B
2018-04-03 09:30:23,13525.0,2,5894,0,13525.0,4,13540.0,8,B
2018-04-03 09:30:24,13525.0,2,5896,-2,13525.0,3,13540.0,9,B
2018-04-03 09:30:24,13525.0,2,5898,0,13525.0,1,13535.0,3,B
2018-04-03 09:30:25,13525.0,2,5900,0,13525.0,1,13535.0,4,B
2018-04-03 09:30:26,13520.0,4,5904,2,13520.0,1,13525.0,4,S
2018-04-03 09:30:26,13520.0,8,5912,4,13510.0,3,13520.0,6,S
2018-04-03 09:30:27,13520.0,10,5922,0,13515.0,7,13520.0,1,S
2018-04-03 09:30:28,13515.0,2,5924,-2,13515.0,6,13520.0,1,S
2018-04-03 09:30:29,13515.0,2,5926,2,13515.0,5,13520.0,4,S
2018-04-03 09:30:30,13515.0,2,5928,0,13515.0,1,13520.0,2,S
2018-04-03 09:30:33,13520.0,4,5932,0,13515.0,5,13525.0,1,B
2018-04-03 09:30:35,13525.0,2,5934,0,13525.0,1,13530.0,1,B
2018-04-03 09:30:40,13530.0,8,5942,-6,13520.0,8,13530.0,1,B
2018-04-03 09:30:41,13530.0,2,5944,0,13520.0,8,13535.0,6,B
2018-04-03 09:30:42,13525.0,6,5950,2,13520.0,7,13525.0,37,S
2018-04-03 09:30:43,13525.0,8,5958,4,13520.0,7,13525.0,33,S
2018-04-03 09:30:43,13525.0,18,5976,18,13520.0,7,13525.0,24,S
2018-04-03 09:30:44,13525.0,48,6024,30,13525.0,3,13530.0,1,S
2018-04-03 09:30:45,13530.0,2,6026,-2,13530.0,4,13535.0,6,B
2018-04-03 09:30:45,13530.0,6,6032,0,13530.0,1,13535.0,4,B
2018-04-03 09:30:46,13535.0,2,6034,0,13530.0,8,13535.0,2,B
2018-04-03 09:30:47,13535.0,2,6036,0,13530.0,8,13540.0,7,B
2018-04-03 09:30:48,13530.0,2,6038,0,13530.0,2,13535.0,1,S
2018-04-03 09:30:49,13530.0,2,6040,2,13530.0,1,13535.0,5,S
2018-04-03 09:30:50,13535.0,2,6042,0,13525.0,7,13535.0,3,B
2018-04-03 09:30:51,13530.0,4,6046,2,13525.0,7,13530.0,1,S
2018-04-03 09:30:52,13535.0,6,6052,2,13530.0,2,13540.0,8,B
2018-04-03 09:30:53,13535.0,2,6054,-2,13530.0,2,13535.0,3,B
2018-04-03 09:30:53,13535.0,2,6056,0,13530.0,3,13540.0,7,B
2018-04-03 09:30:54,13540.0,2,6058,-2,13530.0,3,13540.0,6,B
2018-04-03 09:30:55,13530.0,20,6078,-16,13525.0,7,13540.0,3,S
2018-04-03 09:30:56,13535.0,4,6082,2,13530.0,7,13535.0,3,B
2018-04-03 09:30:56,13540.0,4,6086,-2,13530.0,7,13540.0,4,B
2018-04-03 09:30:57,13540.0,2,6088,-2,13530.0,7,13540.0,3,B
2018-04-03 09:31:00,13535.0,2,6090,-2,13525.0,5,13535.0,8,S
2018-04-03 09:31:03,13535.0,10,6100,8,13525.0,2,13535.0,3,S
2018-04-03 09:31:03,13525.0,4,6104,2,13520.0,5,13525.0,1,S
2018-04-03 09:31:04,13525.0,2,6106,0,13520.0,3,13530.0,16,S
2018-04-03 09:31:05,13520.0,26,6132,-20,13515.0,1,13520.0,7,S
2018-04-03 09:31:06,13530.0,20,6152,-6,13520.0,2,13525.0,2,B
2018-04-03 09:31:06,13525.0,4,6156,0,13520.0,2,13530.0,8,S
2018-04-03 09:31:14,13520.0,2,6158,0,13515.0,1,13525.0,6,S
2018-04-03 09:31:22,13520.0,4,6162,2,13515.0,4,13525.0,4,S
2018-04-03 09:31:23,13525.0,2,6164,2,13515.0,5,13525.0,1,B
2018-04-03 09:31:24,13515.0,10,6174,-6,13520.0,1,13525.0,1,S
2018-04-03 09:31:25,13525.0,2,6176,-2,13525.0,10,13530.0,15,B
2018-04-03 09:31:28,13530.0,26,6202,6,13525.0,10,13535.0,5,B
2018-04-03 09:31:28,13535.0,2,6204,-2,13525.0,10,13535.0,4,B
2018-04-03 09:31:29,13525.0,20,6224,0,13520.0,2,13535.0,4,S
2018-04-03 09:31:35,13540.0,6,6230,-4,13530.0,1,13535.0,1,B
2018-04-03 09:31:36,13540.0,4,6234,-2,13530.0,2,13540.0,6,B
2018-04-03 09:31:37,13540.0,2,6236,-2,13530.0,3,13540.0,5,B
2018-04-03 09:31:45,13535.0,14,6250,8,13535.0,3,13540.0,9,S
2018-04-03 09:31:45,13535.0,6,6256,0,13525.0,2,13535.0,1,S
2018-04-03 09:31:46,13540.0,8,6264,4,13530.0,4,13540.0,6,B
2018-04-03 09:31:49,13530.0,2,6266,0,13525.0,1,13530.0,9,S
2018-04-03 09:31:55,13530.0,6,6272,0,13520.0,4,13530.0,8,S
2018-04-03 09:31:58,13525.0,4,6276,0,13525.0,2,13530.0,6,S
2018-04-03 09:31:59,13525.0,2,6278,0,13525.0,2,13530.0,6,S
2018-04-03 09:32:02,13525.0,4,6282,4,13520.0,2,13530.0,15,S
2018-04-03 09:32:08,13525.0,2,6284,-2,13520.0,1,13530.0,16,S
2018-04-03 09:32:09,13525.0,2,6286,2,13520.0,6,13530.0,16,S
2018-04-03 09:32:09,13510.0,16,6302,6,13500.0,19,13510.0,2,S
2018-04-03 09:32:10,13510.0,4,6306,0,13510.0,2,13520.0,1,S
2018-04-03 09:32:13,13520.0,2,6308,0,13515.0,5,13525.0,3,B
2018-04-03 09:32:16,13520.0,2,6310,0,13515.0,3,13525.0,5,B
2018-04-03 09:32:26,13515.0,2,6312,0,13515.0,1,13520.0,1,S
2018-04-03 09:32:34,13520.0,2,6314,0,13515.0,1,13520.0,1,B
2018-04-03 09:32:35,13520.0,2,6316,2,13515.0,1,13525.0,4,B
2018-04-03 09:32:53,13525.0,20,6336,-2,13515.0,1,13525.0,5,B
2018-04-03 09:32:53,13515.0,2,6338,0,13510.0,6,13525.0,5,S
2018-04-03 09:32:55,13515.0,2,6340,0,13515.0,1,13525.0,5,S
2018-04-03 09:32:56,13515.0,2,6342,0,13510.0,6,13515.0,4,S
2018-04-03 09:32:56,13515.0,8,6350,8,13515.0,2,13525.0,5,S
2018-04-03 09:33:00,13525.0,2,6352,0,13520.0,5,13525.0,4,B
2018-04-03 09:33:00,13520.0,6,6358,0,13520.0,4,13525.0,1,S
2018-04-03 09:33:01,13530.0,4,6362,0,13520.0,1,13530.0,18,B
2018-04-03 09:33:01,13520.0,2,6364,0,13515.0,5,13525.0,6,S
2018-04-03 09:33:04,13525.0,2,6366,-2,13515.0,3,13525.0,6,B
2018-04-03 09:33:04,13525.0,2,6368,-2,13515.0,3,13525.0,2,B
2018-04-03 09:33:08,13520.0,2,6370,-2,13515.0,2,13525.0,6,S
2018-04-03 09:33:09,13515.0,2,6372,0,13510.0,3,13520.0,8,S
2018-04-03 09:33:21,13510.0,2,6374,-2,13510.0,16,13520.0,8,S
2018-04-03 09:33:22,13510.0,20,6394,0,13510.0,6,13520.0,8,S
2018-04-03 09:33:26,13520.0,10,6404,-4,13510.0,9,13520.0,4,B
2018-04-03 09:33:28,13520.0,2,6406,0,13510.0,9,13520.0,4,B
2018-04-03 09:33:41,13515.0,8,6414,2,13510.0,13,13515.0,1,S
2018-04-03 09:33:41,13515.0,2,6416,0,13510.0,13,13520.0,11,S
2018-04-03 09:33:51,13520.0,2,6418,0,13510.0,12,13520.0,12,B
2018-04-03 09:33:52,13520.0,4,6422,0,13510.0,12,13520.0,10,B
2018-04-03 09:33:53,13520.0,16,6438,0,13510.0,12,13520.0,2,B
2018-04-03 09:34:01,13515.0,2,6440,0,13510.0,11,13520.0,17,S
2018-04-03 09:34:01,13520.0,2,6442,0,13510.0,11,13520.0,16,B
2018-04-03 09:34:37,13520.0,4,6446,-2,13510.0,15,13520.0,16,B
2018-04-03 09:34:47,13520.0,2,6448,-2,13510.0,13,13515.0,2,B
2018-04-03 09:34:49,13515.0,2,6450,0,13510.0,13,13515.0,1,S
2018-04-03 09:34:54,13510.0,4,6454,-4,13510.0,11,13515.0,3,S
2018-04-03 09:35:07,13520.0,10,6464,0,13515.0,1,13520.0,14,B
2018-04-03 09:35:11,13520.0,2,6466,2,13515.0,1,13520.0,13,B
2018-04-03 09:35:13,13520.0,2,6468,0,13515.0,4,13520.0,12,B
2018-04-03 09:35:22,13515.0,24,6492,14,13510.0,14,13515.0,8,S
2018-04-03 09:35:23,13515.0,14,6506,10,13510.0,14,13515.0,1,S
2018-04-03 09:35:23,13515.0,2,6508,2,13515.0,5,13520.0,12,S
2018-04-03 09:35:24,13520.0,14,6522,0,13515.0,10,13520.0,5,B
2018-04-03 09:35:24,13520.0,6,6528,2,13515.0,11,13520.0,2,B
2018-04-03 09:35:25,13525.0,8,6536,0,13515.0,11,13525.0,4,B
2018-04-03 09:35:25,13525.0,2,6538,0,13520.0,1,13525.0,1,B
2018-04-03 09:35:30,13520.0,4,6542,-2,13515.0,4,13520.0,1,S
2018-04-03 09:35:31,13525.0,4,6546,2,13515.0,2,13525.0,5,B
2018-04-03 09:35:39,13530.0,10,6556,0,13525.0,1,13530.0,19,B
2018-04-03 09:35:41,13525.0,2,6558,0,13525.0,7,13530.0,19,S
2018-04-03 09:35:42,13530.0,10,6568,0,13525.0,1,13530.0,14,B
2018-04-03 09:35:46,13530.0,28,6596,26,13530.0,2,13535.0,7,B
2018-04-03 09:35:47,13535.0,2,6598,0,13535.0,2,13540.0,8,B
2018-04-03 09:35:47,13540.0,10,6608,-2,13535.0,12,13540.0,1,B
2018-04-03 09:35:48,13545.0,6,6614,4,13540.0,5,13545.0,3,B
2018-04-03 09:35:48,13540.0,6,6620,0,13540.0,5,13545.0,3,S
2018-04-03 09:35:49,13540.0,14,6634,4,13535.0,5,13540.0,2,S
2018-04-03 09:35:51,13540.0,2,6636,0,13535.0,3,13545.0,9,S
2018-04-03 09:35:51,13535.0,8,6644,-4,13535.0,5,13545.0,4,S
2018-04-03 09:35:53,13540.0,2,6646,0,13535.0,6,13540.0,1,B
2018-04-03 09:35:53,13535.0,4,6650,-2,13535.0,5,13545.0,5,S
2018-04-03 09:35:55,13540.0,2,6652,-2,13540.0,2,13545.0,5,B
2018-04-03 09:35:58,13540.0,8,6660,4,13535.0,3,13545.0,6,B
2018-04-03 09:36:04,13530.0,2,6662,0,13530.0,2,13540.0,5,S
2018-04-03 09:36:09,13540.0,10,6672,-6,13530.0,5,13540.0,1,B
2018-04-03 09:36:14,13530.0,2,6674,-2,13530.0,1,13535.0,2,S
2018-04-03 09:36:15,13530.0,2,6676,2,13525.0,6,13540.0,8,S
2018-04-03 09:36:16,13530.0,2,6678,0,13525.0,5,13540.0,10,S
2018-04-03 09:36:21,13535.0,2,6680,-2,13535.0,4,13540.0,7,B
2018-04-03 09:36:21,13535.0,6,6686,0,13535.0,1,13540.0,3,B
2018-04-03 09:36:27,13540.0,2,6688,0,13540.0,4,13545.0,10,B
2018-04-03 09:36:30,13540.0,2,6690,0,13540.0,3,13545.0,5,B
2018-04-03 09:36:31,13540.0,6,6696,-6,13535.0,5,13545.0,5,B
2018-04-03 09:36:32,13535.0,2,6698,0,13535.0,1,13540.0,1,S
2018-04-03 09:37:08,13530.0,12,6710,-8,13525.0,6,13535.0,19,S
2018-04-03 09:37:09,13525.0,4,6714,2,13520.0,8,13530.0,8,S
2018-04-03 09:37:14,13530.0,2,6716,-2,13525.0,1,13530.0,9,B
2018-04-03 09:37:20,13530.0,2,6718,-2,13525.0,5,13530.0,3,B
2018-04-03 09:37:29,13530.0,2,6720,0,13525.0,6,13530.0,2,B
2018-04-03 09:37:33,13530.0,4,6724,0,13530.0,3,13535.0,8,B
2018-04-03 09:37:37,13530.0,6,6730,0,13525.0,7,13535.0,3,B
2018-04-03 09:37:42,13525.0,14,6744,6,13525.0,1,13535.0,3,S
2018-04-03 09:37:43,13535.0,6,6750,-2,13535.0,2,13540.0,21,B
2018-04-03 09:37:44,13520.0,10,6760,4,13520.0,1,13535.0,8,S
2018-04-03 09:37:45,13535.0,8,6768,-6,13535.0,1,13540.0,24,B
2018-04-03 09:37:45,13520.0,8,6776,4,13520.0,3,13535.0,1,S
2018-04-03 09:37:53,13520.0,4,6780,2,13520.0,4,13535.0,3,S
2018-04-03 09:37:54,13535.0,4,6784,-4,13525.0,1,13535.0,2,B
2018-04-03 09:37:55,13525.0,6,6790,-2,13520.0,5,13535.0,4,S
2018-04-03 09:37:55,13535.0,4,6794,-4,13525.0,2,13535.0,3,B
2018-04-03 09:37:56,13535.0,4,6798,-2,13525.0,2,13535.0,2,B
2018-04-03 09:37:56,13535.0,6,6804,4,13525.0,1,13535.0,2,B
2018-04-03 09:37:57,13535.0,2,6806,0,13525.0,3,13535.0,2,B
2018-04-03 09:37:58,13525.0,6,6812,4,13525.0,1,13535.0,2,S
2018-04-03 09:37:59,13525.0,2,6814,0,13520.0,6,13535.0,6,S
2018-04-03 09:38:00,13520.0,2,6816,2,13515.0,6,13530.0,1,S
2018-04-03 09:38:01,13520.0,2,6818,0,13520.0,5,13530.0,5,S
2018-04-03 09:38:12,13530.0,2,6820,0,13520.0,8,13530.0,1,B
2018-04-03 09:38:13,13520.0,16,6836,14,13515.0,6,13530.0,1,S
2018-04-03 09:38:15,13520.0,4,6840,4,13520.0,1,13530.0,2,S
2018-04-03 09:38:32,13520.0,4,6844,2,13515.0,8,13525.0,2,S
2018-04-03 09:38:32,13525.0,6,6850,-6,13515.0,7,13530.0,11,B
2018-04-03 09:38:33,13525.0,14,6864,-14,13525.0,7,13530.0,12,B
2018-04-03 09:38:33,13510.0,34,6898,6,13515.0,1,13525.0,3,S
2018-04-03 09:38:34,13525.0,6,6904,0,13525.0,2,13530.0,11,B
2018-04-03 09:38:35,13515.0,6,6910,2,13515.0,6,13525.0,2,S
2018-04-03 09:38:39,13515.0,8,6918,6,13515.0,2,13525.0,2,S
2018-04-03 09:38:43,13515.0,4,6922,0,13510.0,9,13525.0,5,S
2018-04-03 09:38:46,13525.0,2,6924,0,13515.0,12,13525.0,1,B
2018-04-03 09:38:47,13525.0,2,6926,-2,13525.0,3,13530.0,5,B
2018-04-03 09:38:47,13525.0,6,6932,0,13515.0,6,13530.0,1,B
2018-04-03 09:38:48,13530.0,4,6936,0,13520.0,8,13535.0,6,B
2018-04-03 09:38:48,13535.0,2,6938,-2,13520.0,8,13535.0,4,B
2018-04-03 09:38:54,13520.0,16,6954,0,13520.0,3,13530.0,6,S
2018-04-03 09:39:02,13510.0,6,6960,2,13515.0,1,13525.0,3,S
2018-04-03 09:39:04,13520.0,2,6962,-2,13515.0,3,13520.0,3,B
2018-04-03 09:39:04,13520.0,4,6966,-4,13515.0,4,13525.0,4,B
2018-04-03 09:39:05,13525.0,2,6968,0,13515.0,4,13525.0,3,B
2018-04-03 09:39:05,13515.0,2,6970,0,13515.0,3,13525.0,3,S
2018-04-03 09:39:07,13525.0,4,6974,-4,13515.0,4,13530.0,11,B
2018-04-03 09:39:08,13525.0,2,6976,-2,13515.0,4,13525.0,7,B
2018-04-03 09:39:14,13525.0,4,6980,-4,13515.0,6,13525.0,5,B
2018-04-03 09:39:15,13515.0,2,6982,-2,13515.0,5,13525.0,5,S
2018-04-03 09:39:17,13525.0,10,6992,-2,13515.0,5,13530.0,12,B
2018-04-03 09:39:26,13520.0,4,6996,0,13515.0,5,13525.0,1,S
2018-04-03 09:39:34,13525.0,2,6998,0,13525.0,1,13530.0,12,B
2018-04-03 09:39:34,13515.0,6,7004,2,13515.0,15,13530.0,10,S
2018-04-03 09:39:36,13515.0,8,7012,0,13515.0,15,13530.0,12,S
2018-04-03 09:39:38,13515.0,6,7018,2,13515.0,12,13525.0,6,S
2018-04-03 09:39:47,13515.0,4,7022,0,13515.0,13,13525.0,5,S
2018-04-03 09:39:53,13525.0,2,7024,0,13515.0,17,13525.0,1,B
2018-04-03 09:39:55,13520.0,2,7026,0,13520.0,1,13525.0,5,S
2018-04-03 09:40:04,13515.0,2,7028,0,13515.0,10,13520.0,3,S
2018-04-03 09:40:05,13520.0,2,7030,2,13515.0,9,13520.0,2,B
2018-04-03 09:40:10,13515.0,18,7048,0,13510.0,8,13520.0,1,S
2018-04-03 09:40:16,13520.0,2,7050,0,13510.0,11,13520.0,1,B
2018-04-03 09:40:17,13520.0,2,7052,0,13510.0,11,13525.0,21,B
2018-04-03 09:40:26,13525.0,2,7054,0,13520.0,1,13525.0,4,B
2018-04-03 09:40:26,13520.0,4,7058,0,13520.0,3,13525.0,1,S
2018-04-03 09:40:27,13530.0,4,7062,-2,13520.0,4,13530.0,12,B
2018-04-03 09:40:27,13530.0,2,7064,0,13520.0,5,13530.0,9,B
2018-04-03 09:40:35,13530.0,6,7070,-6,13520.0,1,13530.0,9,B
2018-04-03 09:40:41,13530.0,2,7072,-2,13520.0,19,13530.0,8,B
2018-04-03 09:40:48,13520.0,18,7090,0,13520.0,9,13525.0,8,S
2018-04-03 09:41:12,13520.0,22,7112,2,13520.0,1,13530.0,12,S
2018-04-03 09:41:18,13520.0,6,7118,0,13515.0,3,13520.0,7,S
2018-04-03 09:41:18,13520.0,14,7132,4,13525.0,1,13530.0,12,S
2018-04-03 09:41:19,13525.0,2,7134,0,13515.0,3,13525.0,1,B
2018-04-03 09:41:19,13515.0,4,7138,2,13515.0,2,13530.0,12,S
2018-04-03 09:41:27,13515.0,10,7148,2,13510.0,11,13515.0,5,S
2018-04-03 09:41:27,13515.0,10,7158,6,13520.0,1,13525.0,6,S
2018-04-03 09:41:28,13520.0,2,7160,0,13520.0,1,13525.0,6,B
2018-04-03 09:41:30,13520.0,2,7162,0,13515.0,4,13525.0,6,B
2018-04-03 09:41:31,13515.0,8,7170,4,13510.0,12,13515.0,6,S
2018-04-03 09:41:32,13515.0,10,7180,0,13510.0,12,13515.0,1,S
2018-04-03 09:41:32,13515.0,2,7182,0,13510.0,12,13520.0,2,S
2018-04-03 09:41:36,13515.0,2,7184,0,13510.0,12,13515.0,9,S
2018-04-03 09:41:44,13510.0,20,7204,10,13510.0,4,13515.0,10,S
2018-04-03 09:41:45,13515.0,2,7206,0,13510.0,4,13515.0,9,B
2018-04-03 09:41:48,13515.0,2,7208,0,13510.0,4,13515.0,8,B
2018-04-03 09:41:52,13510.0,6,7214,2,13505.0,6,13510.0,10,S
2018-04-03 09:41:53,13510.0,2,7216,0,13505.0,6,13510.0,9,S
2018-04-03 09:41:57,13510.0,2,7218,0,13505.0,5,13510.0,9,S
2018-04-03 09:41:58,13505.0,10,7228,8,13500.0,19,13505.0,5,S
2018-04-03 09:41:59,13515.0,40,7268,-4,13500.0,19,13510.0,1,B
2018-04-03 09:42:01,13500.0,2,7270,-2,13500.0,19,13510.0,4,S
2018-04-03 09:42:03,13505.0,2,7272,-2,13500.0,20,13510.0,4,B
2018-04-03 09:42:10,13505.0,2,7274,2,13500.0,24,13505.0,9,B
2018-04-03 09:42:12,13500.0,2,7276,0,13500.0,23,13505.0,9,S
2018-04-03 09:42:13,13505.0,2,7278,2,13500.0,23,13505.0,8,B
2018-04-03 09:42:13,13505.0,10,7288,0,13500.0,23,13505.0,3,B
2018-04-03 09:42:14,13505.0,2,7290,2,13500.0,23,13505.0,2,B
2018-04-03 09:42:15,13505.0,2,7292,2,13500.0,23,13505.0,1,B
2018-04-03 09:42:18,13505.0,2,7294,2,13505.0,2,13510.0,1,B
2018-04-03 09:42:19,13505.0,2,7296,0,13505.0,1,13510.0,1,B
2018-04-03 09:42:31,13505.0,4,7300,2,13505.0,4,13520.0,7,B
2018-04-03 09:42:40,13515.0,2,7302,0,13510.0,2,13520.0,6,B
2018-04-03 09:43:00,13515.0,2,7304,2,13515.0,3,13520.0,6,B
2018-04-03 09:43:04,13515.0,6,7310,4,13510.0,4,13515.0,6,B
2018-04-03 09:43:05,13515.0,6,7316,2,13510.0,3,13520.0,7,B
2018-04-03 09:43:11,13520.0,2,7318,0,13515.0,5,13520.0,6,B
2018-04-03 09:43:16,13520.0,2,7320,-2,13515.0,5,13520.0,5,B
2018-04-03 09:43:22,13520.0,2,7322,-2,13515.0,6,13520.0,4,B
2018-04-03 09:43:24,13520.0,8,7330,-6,13520.0,1,13525.0,5,B
2018-04-03 09:43:25,13520.0,2,7332,-2,13520.0,3,13525.0,2,B
2018-04-03 09:43:26,13525.0,2,7334,2,13525.0,2,13530.0,8,B
2018-04-03 09:43:27,13525.0,8,7342,-4,13520.0,5,13530.0,4,B
2018-04-03 09:43:42,13530.0,10,7352,4,13530.0,3,13535.0,7,B
2018-04-03 09:43:42,13530.0,6,7358,2,13520.0,4,13530.0,1,B
2018-04-03 09:43:44,13525.0,2,7360,2,13525.0,4,13535.0,9,S
2018-04-03 09:43:46,13535.0,10,7370,-4,13525.0,5,13535.0,1,B
2018-04-03 09:43:56,13530.0,4,7374,4,13525.0,2,13530.0,8,S
2018-04-03 09:43:56,13530.0,2,7376,0,13525.0,2,13530.0,9,S
2018-04-03 09:44:04,13525.0,4,7380,0,13525.0,1,13530.0,7,S
2018-04-03 09:44:05,13530.0,4,7384,4,13525.0,1,13530.0,5,B
2018-04-03 09:44:06,13530.0,10,7394,0,13530.0,5,13535.0,6,B
2018-04-03 09:44:09,13540.0,10,7404,-4,13535.0,6,13540.0,5,B
2018-04-03 09:44:18,13540.0,2,7406,0,13535.0,4,13540.0,4,B
2018-04-03 09:44:28,13535.0,6,7412,0,13535.0,1,13540.0,5,S
2018-04-03 09:44:44,13540.0,2,7414,0,13530.0,23,13540.0,5,B
2018-04-03 09:44:51,13535.0,2,7416,2,13530.0,23,13540.0,4,S
2018-04-03 09:44:53,13545.0,12,7428,2,13540.0,5,13545.0,10,B
2018-04-03 09:44:56,13550.0,12,7440,8,13545.0,4,13550.0,12,B
2018-04-03 09:44:56,13550.0,20,7460,12,13545.0,7,13550.0,1,B
2018-04-03 09:44:57,13550.0,2,7462,2,13555.0,3,13560.0,8,B
2018-04-03 09:44:57,13555.0,8,7470,-8,13550.0,4,13555.0,2,B
2018-04-03 09:44:58,13555.0,10,7480,-6,13545.0,1,13555.0,4,B
2018-04-03 09:45:11,13545.0,4,7484,2,13540.0,10,13545.0,4,S
2018-04-03 09:45:13,13545.0,2,7486,0,13545.0,3,13550.0,1,S
2018-04-03 09:45:15,13545.0,6,7492,0,13540.0,11,13545.0,7,S
2018-04-03 09:45:16,13545.0,6,7498,0,13540.0,11,13545.0,4,S
2018-04-03 09:45:16,13545.0,2,7500,0,13540.0,12,13545.0,3,S
2018-04-03 09:45:17,13545.0,2,7502,0,13540.0,12,13545.0,2,S
2018-04-03 09:45:25,13545.0,2,7504,0,13540.0,11,13545.0,2,S
2018-04-03 09:45:36,13545.0,6,7510,4,13545.0,7,13550.0,2,S
2018-04-03 09:45:38,13545.0,14,7524,0,13540.0,2,13550.0,1,S
2018-04-03 09:45:53,13535.0,4,7528,-4,13535.0,3,13545.0,4,S
2018-04-03 09:46:08,13535.0,2,7530,0,13535.0,7,13545.0,6,S
2018-04-03 09:46:24,13545.0,8,7538,2,13535.0,8,13545.0,4,B
2018-04-03 09:46:27,13545.0,6,7544,6,13535.0,10,13545.0,1,B
2018-04-03 09:46:31,13545.0,4,7548,4,13540.0,1,13545.0,1,B
2018-04-03 09:46:36,13545.0,2,7550,0,13535.0,11,13545.0,2,B
2018-04-03 09:46:39,13545.0,2,7552,0,13540.0,1,13545.0,3,B
2018-04-03 09:46:40,13540.0,4,7556,2,13535.0,11,13540.0,9,S
2018-04-03 09:46:41,13540.0,18,7574,18,13535.0,10,13540.0,10,S
2018-04-03 09:46:41,13540.0,2,7576,2,13535.0,10,13540.0,9,S
2018-04-03 09:46:42,13540.0,18,7594,18,13535.0,10,13545.0,3,S
2018-04-03 09:46:43,13545.0,2,7596,0,13535.0,11,13545.0,2,B
2018-04-03 09:46:44,13545.0,2,7598,0,13535.0,11,13545.0,3,B
2018-04-03 09:46:45,13545.0,2,7600,-2,13535.0,12,13545.0,2,B
2018-04-03 09:46:46,13545.0,2,7602,-2,13535.0,13,13545.0,2,B
2018-04-03 09:46:48,13545.0,2,7604,0,13535.0,13,13545.0,2,B
2018-04-03 09:46:48,13545.0,2,7606,0,13535.0,13,13545.0,1,B
2018-04-03 09:46:52,13535.0,30,7636,-24,13530.0,11,13535.0,15,S
2018-04-03 09:46:53,13545.0,38,7674,-2,13530.0,12,13545.0,1,B
2018-04-03 09:46:53,13540.0,2,7676,-2,13535.0,2,13545.0,1,S
2018-04-03 09:46:54,13545.0,2,7678,0,13535.0,3,13545.0,5,B
2018-04-03 09:47:00,13540.0,2,7680,-2,13535.0,1,13540.0,19,S
2018-04-03 09:47:02,13540.0,2,7682,-2,13530.0,10,13540.0,18,S
2018-04-03 09:47:02,13540.0,20,7702,0,13535.0,1,13540.0,8,S
2018-04-03 09:47:03,13535.0,2,7704,0,13530.0,12,13540.0,8,S
2018-04-03 09:47:04,13535.0,2,7706,-2,13530.0,9,13540.0,8,S
2018-04-03 09:47:04,13540.0,2,7708,-2,13530.0,9,13540.0,7,B
2018-04-03 09:47:07,13540.0,2,7710,-2,13530.0,9,13540.0,7,B
2018-04-03 09:47:08,13540.0,2,7712,-2,13530.0,9,13540.0,9,B
2018-04-03 09:47:09,13540.0,2,7714,-2,13530.0,9,13540.0,8,B
2018-04-03 09:47:16,13540.0,2,7716,-2,13530.0,9,13540.0,7,B
2018-04-03 09:47:20,13540.0,2,7718,0,13530.0,9,13540.0,6,B
2018-04-03 09:47:24,13540.0,2,7720,0,13530.0,9,13540.0,5,B
2018-04-03 09:47:36,13530.0,2,7722,0,13530.0,8,13540.0,5,S
2018-04-03 09:47:53,13540.0,6,7728,0,13530.0,9,13540.0,11,B
2018-04-03 09:47:59,13540.0,2,7730,2,13530.0,12,13540.0,10,B
2018-04-03 09:48:13,13540.0,10,7740,-6,13535.0,8,13540.0,5,B
2018-04-03 09:48:20,13540.0,2,7742,-2,13535.0,8,13540.0,4,B
2018-04-03 09:48:28,13535.0,10,7752,-10,13530.0,8,13540.0,4,S
2018-04-03 09:48:29,13540.0,2,7754,-2,13530.0,8,13535.0,3,B
2018-04-03 09:48:56,13535.0,2,7756,0,13530.0,11,13540.0,4,S
2018-04-03 09:48:58,13540.0,4,7760,0,13530.0,11,13540.0,3,B
2018-04-03 09:49:01,13535.0,4,7764,0,13530.0,10,13540.0,18,S
2018-04-03 09:49:15,13530.0,20,7784,-18,13525.0,4,13535.0,10,S
2018-04-03 09:49:53,13525.0,2,7786,0,13525.0,3,13530.0,2,S
2018-04-03 09:49:57,13530.0,2,7788,0,13525.0,4,13535.0,12,B
2018-04-03 09:50:11,13535.0,2,7790,0,13530.0,1,13535.0,13,B
2018-04-03 09:50:29,13530.0,2,7792,-2,13525.0,3,13535.0,14,S
2018-04-03 09:50:43,13535.0,2,7794,0,13525.0,3,13535.0,13,B
2018-04-03 09:50:50,13535.0,2,7796,0,13530.0,2,13535.0,13,B
2018-04-03 09:50:51,13530.0,4,7800,-2,13525.0,3,13535.0,13,S
2018-04-03 09:50:52,13535.0,2,7802,0,13525.0,3,13535.0,12,B
2018-04-03 09:50:53,13535.0,2,7804,0,13525.0,3,13535.0,12,B
2018-04-03 09:51:13,13525.0,8,7812,2,13525.0,1,13535.0,10,S
2018-04-03 09:51:14,13535.0,2,7814,0,13525.0,1,13535.0,9,B
2018-04-03 09:52:06,13525.0,2,7816,0,13520.0,6,13530.0,11,S
2018-04-03 09:52:23,13525.0,2,7818,0,13520.0,6,13525.0,1,S
2018-04-03 09:52:23,13525.0,2,7820,0,13520.0,6,13530.0,11,S
2018-04-03 09:52:29,13530.0,2,7822,0,13520.0,1,13530.0,11,B
2018-04-03 09:52:36,13530.0,2,7824,2,13520.0,1,13530.0,11,B
2018-04-03 09:52:49,13530.0,20,7844,2,13520.0,7,13535.0,13,B
2018-04-03 09:52:52,13535.0,4,7848,-4,13525.0,1,13535.0,6,B
2018-04-03 09:52:55,13540.0,12,7860,4,13525.0,2,13540.0,5,B
2018-04-03 09:52:57,13540.0,4,7864,2,13530.0,5,13540.0,1,B
2018-04-03 09:53:00,13540.0,2,7866,0,13530.0,7,13540.0,1,B
2018-04-03 09:53:01,13540.0,4,7870,4,13530.0,7,13540.0,1,B
2018-04-03 09:53:03,13545.0,2,7872,0,13535.0,2,13545.0,23,B
2018-04-03 09:53:04,13545.0,6,7878,-4,13540.0,1,13545.0,17,B
2018-04-03 09:53:05,13555.0,54,7932,-4,13545.0,4,13555.0,3,B
2018-04-03 09:53:06,13550.0,2,7934,0,13550.0,3,13555.0,10,S
2018-04-03 09:53:07,13560.0,12,7946,0,13545.0,4,13560.0,16,B
2018-04-03 09:53:09,13560.0,20,7966,12,13550.0,2,13560.0,4,B
2018-04-03 09:53:10,13550.0,4,7970,0,13545.0,3,13560.0,5,S
2018-04-03 09:53:11,13560.0,2,7972,2,13550.0,3,13560.0,5,B
2018-04-03 09:53:12,13560.0,2,7974,2,13550.0,3,13560.0,12,B
2018-04-03 09:53:13,13550.0,2,7976,2,13550.0,2,13560.0,12,S
2018-04-03 09:53:17,13550.0,2,7978,-2,13550.0,1,13555.0,5,S
2018-04-03 09:53:17,13550.0,2,7980,-2,13545.0,5,13555.0,6,S
2018-04-03 09:53:19,13545.0,4,7984,-4,13540.0,3,13550.0,7,S
2018-04-03 09:53:20,13550.0,6,7990,0,13545.0,4,13555.0,6,B
2018-04-03 09:53:33,13555.0,4,7994,2,13545.0,8,13555.0,6,B
2018-04-03 09:53:50,13550.0,2,7996,0,13545.0,7,13555.0,5,S
2018-04-03 09:53:54,13555.0,4,8000,0,13555.0,2,13560.0,11,B
2018-04-03 09:53:55,13555.0,4,8004,0,13555.0,1,13560.0,11,B
2018-04-03 09:53:55,13555.0,2,8006,0,13550.0,2,13555.0,7,B
2018-04-03 09:54:00,13555.0,2,8008,-2,13545.0,17,13560.0,15,B
2018-04-03 09:54:06,13560.0,22,8030,6,13560.0,1,13565.0,4,B
2018-04-03 09:54:08,13565.0,2,8032,2,13560.0,4,13565.0,1,B
2018-04-03 09:54:09,13565.0,2,8034,2,13565.0,2,13570.0,5,B
2018-04-03 09:54:10,13565.0,2,8036,2,13570.0,2,13575.0,5,B
2018-04-03 09:54:11,13575.0,4,8040,0,13570.0,19,13575.0,3,B
2018-04-03 09:54:12,13580.0,32,8072,-26,13575.0,3,13585.0,3,B
2018-04-03 09:54:12,13580.0,2,8074,2,13580.0,1,13585.0,3,B
2018-04-03 09:54:13,13585.0,2,8076,-2,13580.0,1,13585.0,2,B
2018-04-03 09:54:13,13590.0,4,8080,0,13585.0,1,13590.0,6,B
2018-04-03 09:54:14,13590.0,2,8082,2,13590.0,1,13595.0,5,B
2018-04-03 09:54:15,13590.0,2,8084,0,13585.0,2,13590.0,1,B
2018-04-03 09:54:15,13585.0,2,8086,0,13585.0,1,13590.0,2,S
2018-04-03 09:54:16,13585.0,2,8088,0,13585.0,2,13590.0,2,S
2018-04-03 09:54:18,13580.0,12,8100,-2,13575.0,3,13585.0,7,S
2018-04-03 09:54:19,13585.0,2,8102,0,13575.0,5,13585.0,9,B
2018-04-03 09:54:20,13575.0,2,8104,-2,13570.0,1,13585.0,10,S
2018-04-03 09:54:25,13575.0,2,8106,0,13570.0,3,13575.0,1,S
2018-04-03 09:54:36,13575.0,2,8108,2,13575.0,1,13580.0,5,S
2018-04-03 09:54:36,13575.0,2,8110,0,13570.0,14,13580.0,5,S
2018-04-03 09:54:38,13575.0,4,8114,4,13570.0,11,13580.0,5,S
2018-04-03 09:54:39,13575.0,2,8116,-2,13570.0,14,13580.0,5,S
2018-04-03 09:54:43,13575.0,2,8118,-2,13570.0,11,13575.0,2,S
2018-04-03 09:54:45,13570.0,6,8124,-2,13570.0,6,13575.0,3,S
2018-04-03 09:54:49,13570.0,2,8126,-2,13570.0,9,13575.0,1,S
2018-04-03 09:54:59,13570.0,18,8144,0,13570.0,2,13575.0,3,S
2018-04-03 09:55:00,13570.0,4,8148,-4,13565.0,4,13575.0,6,S
2018-04-03 09:55:05,13565.0,6,8154,0,13565.0,4,13575.0,2,S
2018-04-03 09:55:06,13565.0,4,8158,-4,13565.0,5,13570.0,2,S
2018-04-03 09:55:07,13565.0,2,8160,-2,13565.0,5,13570.0,2,S
2018-04-03 09:55:08,13570.0,2,8162,0,13565.0,9,13570.0,1,B
2018-04-03 09:55:08,13565.0,4,8166,-4,13565.0,7,13570.0,1,S
2018-04-03 09:55:11,13570.0,6,8172,-2,13570.0,5,13575.0,2,B
2018-04-03 09:55:11,13570.0,2,8174,-2,13570.0,7,13575.0,2,B
2018-04-03 09:55:13,13575.0,2,8176,-2,13575.0,4,13580.0,6,B
2018-04-03 09:55:13,13575.0,6,8182,-4,13575.0,8,13580.0,2,B
2018-04-03 09:55:14,13570.0,10,8192,4,13565.0,6,13570.0,1,S
2018-04-03 09:55:14,13580.0,4,8196,-2,13570.0,14,13580.0,1,B
2018-04-03 09:55:15,13580.0,2,8198,-2,13575.0,5,13585.0,11,B
2018-04-03 09:55:16,13575.0,2,8200,-2,13575.0,2,13580.0,4,S
2018-04-03 09:55:17,13580.0,2,8202,0,13580.0,6,13585.0,9,B
2018-04-03 09:55:17,13585.0,12,8214,-2,13580.0,9,13590.0,1,B
2018-04-03 09:55:19,13590.0,2,8216,-2,13585.0,2,13590.0,2,B
2018-04-03 09:55:22,13585.0,6,8222,-4,13580.0,5,13590.0,5,S
2018-04-03 09:55:30,13585.0,2,8224,0,13580.0,4,13590.0,7,S
2018-04-03 09:55:35,13585.0,2,8226,0,13580.0,4,13585.0,3,S
2018-04-03 09:55:36,13585.0,4,8230,-4,13580.0,4,13585.0,1,S
2018-04-03 09:55:44,13580.0,8,8238,-4,13575.0,4,13580.0,3,S
2018-04-03 09:55:45,13580.0,6,8244,-4,13575.0,6,13585.0,3,S
2018-04-03 09:55:48,13585.0,2,8246,0,13580.0,5,13585.0,2,B
2018-04-03 09:55:48,13585.0,2,8248,0,13580.0,5,13585.0,1,B
2018-04-03 09:55:50,13585.0,2,8250,0,13585.0,3,13590.0,18,B
2018-04-03 09:55:51,13585.0,2,8252,0,13580.0,6,13590.0,15,B
2018-04-03 09:55:55,13585.0,2,8254,-2,13580.0,6,13590.0,14,B
2018-04-03 09:55:56,13590.0,28,8282,-2,13590.0,3,13595.0,20,B
2018-04-03 09:55:57,13595.0,2,8284,2,13590.0,13,13595.0,16,B
2018-04-03 09:55:58,13595.0,4,8288,4,13590.0,10,13595.0,14,B
2018-04-03 09:55:58,13590.0,14,8302,6,13585.0,2,13595.0,11,S
2018-04-03 09:55:59,13595.0,8,8310,0,13590.0,1,13595.0,7,B
2018-04-03 09:56:00,13590.0,2,8312,-2,13585.0,4,13595.0,7,S
2018-04-03 09:56:02,13595.0,10,8322,10,13590.0,2,13595.0,2,B
2018-04-03 09:56:02,13595.0,4,8326,0,13595.0,5,13600.0,7,B
2018-04-03 09:56:03,13600.0,4,8330,-2,13595.0,13,13600.0,2,B
2018-04-03 09:56:03,13595.0,6,8336,0,13595.0,10,13600.0,2,S
2018-04-03 09:56:04,13610.0,14,8350,6,13610.0,2,13615.0,4,B
2018-04-03 09:56:04,13625.0,22,8372,-2,13615.0,2,13625.0,2,B
2018-04-03 09:56:05,13620.0,40,8412,12,13605.0,4,13615.0,1,S
2018-04-03 09:56:05,13615.0,4,8416,-4,13615.0,2,13620.0,3,S
2018-04-03 09:56:06,13615.0,20,8436,-16,13600.0,14,13620.0,3,S
2018-04-03 09:56:06,13605.0,4,8440,2,13600.0,30,13620.0,1,S
2018-04-03 09:56:07,13615.0,4,8444,-2,13615.0,4,13620.0,4,B
2018-04-03 09:56:08,13615.0,6,8450,0,13605.0,1,13620.0,4,B
2018-04-03 09:56:09,13615.0,14,8464,-2,13615.0,8,13620.0,1,B
2018-04-03 09:56:09,13615.0,16,8480,-4,13610.0,1,13620.0,1,B
2018-04-03 09:56:11,13610.0,8,8488,-2,13605.0,1,13610.0,2,S
2018-04-03 09:56:12,13615.0,6,8494,-6,13610.0,18,13620.0,1,B
2018-04-03 09:56:14,13610.0,2,8496,-2,13610.0,12,13620.0,5,S
2018-04-03 09:56:17,13620.0,12,8508,-10,13610.0,9,13625.0,7,B
2018-04-03 09:56:18,13610.0,2,8510,0,13605.0,2,13620.0,8,S
2018-04-03 09:56:22,13610.0,4,8514,0,13605.0,1,13615.0,4,S
2018-04-03 09:56:27,13610.0,2,8516,0,13600.0,6,13605.0,2,S
2018-04-03 09:56:32,13610.0,4,8520,0,13600.0,3,13610.0,5,S
2018-04-03 09:56:43,13605.0,2,8522,0,13600.0,4,13610.0,6,S
2018-04-03 09:56:44,13600.0,2,8524,0,13600.0,3,13605.0,1,S
2018-04-03 09:56:47,13605.0,2,8526,2,13605.0,3,13610.0,6,B
2018-04-03 09:56:47,13605.0,6,8532,0,13605.0,1,13610.0,5,B
2018-04-03 09:56:48,13610.0,6,8538,-4,13605.0,1,13610.0,1,B
2018-04-03 09:56:48,13610.0,2,8540,-2,13605.0,1,13615.0,5,B
2018-04-03 09:56:49,13615.0,4,8544,2,13615.0,1,13620.0,7,B
2018-04-03 09:56:51,13615.0,2,8546,-2,13610.0,3,13615.0,2,B
2018-04-03 09:56:52,13610.0,2,8548,0,13605.0,1,13615.0,4,S
2018-04-03 09:56:54,13610.0,2,8550,0,13605.0,1,13615.0,4,S
2018-04-03 09:57:01,13615.0,4,8554,-4,13615.0,4,13620.0,15,B
2018-04-03 09:57:02,13615.0,10,8564,-6,13615.0,9,13620.0,9,B
2018-04-03 09:57:02,13620.0,6,8570,6,13615.0,7,13620.0,6,B
2018-04-03 09:57:03,13620.0,12,8582,10,13620.0,10,13625.0,2,B
2018-04-03 09:57:06,13620.0,6,8588,-2,13615.0,1,13620.0,3,B
2018-04-03 09:57:09,13620.0,2,8590,0,13620.0,18,13625.0,4,B
2018-04-03 09:57:10,13620.0,20,8610,-8,13615.0,4,13620.0,2,B
2018-04-03 09:57:12,13620.0,2,8612,0,13620.0,1,13625.0,2,B
2018-04-03 09:57:13,13625.0,4,8616,2,13625.0,2,13630.0,6,B
2018-04-03 09:57:13,13625.0,4,8620,0,13620.0,2,13625.0,5,B
2018-04-03 09:57:14,13620.0,2,8622,0,13615.0,4,13620.0,1,S
2018-04-03 09:57:15,13615.0,8,8630,-4,13610.0,3,13615.0,6,S
2018-04-03 09:57:18,13610.0,2,8632,-2,13600.0,3,13615.0,7,S
2018-04-03 09:57:19,13615.0,2,8634,2,13605.0,2,13615.0,6,B
2018-04-03 09:57:32,13615.0,10,8644,0,13615.0,12,13620.0,6,B
2018-04-03 09:57:32,13610.0,10,8654,-2,13615.0,2,13620.0,6,S
2018-04-03 09:57:33,13615.0,4,8658,4,13610.0,1,13615.0,1,B
2018-04-03 09:57:38,13605.0,4,8662,4,13600.0,3,13610.0,4,S
2018-04-03 09:57:42,13600.0,6,8668,-4,13600.0,6,13605.0,1,S
2018-04-03 09:57:42,13600.0,6,8674,0,13600.0,3,13605.0,3,S
2018-04-03 09:57:47,13605.0,2,8676,0,13600.0,4,13610.0,4,B
2018-04-03 09:57:48,13600.0,10,8686,-8,13600.0,4,13610.0,2,S
2018-04-03 09:57:55,13605.0,2,8688,-2,13600.0,7,13610.0,8,B
2018-04-03 09:58:03,13610.0,6,8694,-4,13600.0,6,13610.0,6,B
2018-04-03 09:58:16,13605.0,2,8696,2,13605.0,1,13610.0,6,S
2018-04-03 09:58:18,13605.0,2,8698,2,13600.0,6,13605.0,1,S
2018-04-03 09:58:27,13600.0,2,8700,2,13600.0,2,13605.0,9,S
2018-04-03 09:58:36,13600.0,2,8702,0,13595.0,4,13600.0,2,S
2018-04-03 09:58:40,13600.0,2,8704,-2,13595.0,3,13600.0,1,S
2018-04-03 09:58:41,13600.0,6,8710,-6,13600.0,11,13605.0,2,S
2018-04-03 09:58:41,13600.0,2,8712,2,13600.0,10,13605.0,2,S
2018-04-03 09:58:44,13600.0,10,8722,-8,13600.0,10,13605.0,2,S
2018-04-03 09:58:47,13605.0,2,8724,0,13605.0,10,13610.0,11,B
2018-04-03 09:59:04,13605.0,2,8726,0,13600.0,3,13605.0,4,B
2018-04-03 09:59:07,13600.0,6,8732,-6,13595.0,5,13600.0,17,S
2018-04-03 09:59:07,13600.0,26,8758,-6,13595.0,5,13600.0,4,S
2018-04-03 09:59:08,13600.0,8,8766,-2,13595.0,5,13605.0,6,S
2018-04-03 09:59:09,13605.0,2,8768,-2,13600.0,4,13605.0,5,B
2018-04-03 09:59:10,13605.0,4,8772,-4,13600.0,4,13605.0,2,B
2018-04-03 09:59:10,13605.0,4,8776,-4,13600.0,4,13610.0,24,B
2018-04-03 09:59:11,13610.0,6,8782,0,13605.0,2,13610.0,21,B
2018-04-03 09:59:11,13605.0,2,8784,0,13605.0,2,13610.0,20,S
2018-04-03 09:59:12,13610.0,2,8786,2,13605.0,1,13610.0,19,B
2018-04-03 09:59:13,13605.0,2,8788,0,13600.0,5,13610.0,20,S
2018-04-03 09:59:17,13610.0,2,8790,2,13600.0,6,13610.0,19,B
2018-04-03 09:59:19,13610.0,2,8792,0,13605.0,1,13610.0,18,B
2018-04-03 09:59:23,13605.0,2,8794,-2,13600.0,2,13610.0,18,S
2018-04-03 09:59:24,13610.0,4,8798,0,13605.0,6,13610.0,15,B
2018-04-03 09:59:24,13610.0,4,8802,4,13605.0,1,13610.0,13,B
2018-04-03 09:59:25,13610.0,12,8814,12,13605.0,1,13610.0,7,B
2018-04-03 09:59:25,13605.0,2,8816,2,13600.0,3,13610.0,7,S
2018-04-03 09:59:33,13610.0,2,8818,0,13605.0,4,13610.0,6,B
2018-04-03 09:59:37,13610.0,2,8820,2,13605.0,4,13610.0,5,B
2018-04-03 09:59:37,13610.0,10,8830,4,13610.0,10,13615.0,1,B
2018-04-03 09:59:38,13615.0,2,8832,2,13610.0,11,13620.0,6,B
2018-04-03 09:59:38,13620.0,4,8836,0,13615.0,8,13625.0,2,B
2018-04-03 09:59:39,13625.0,2,8838,2,13625.0,4,13630.0,4,B
2018-04-03 09:59:39,13630.0,6,8844,2,13630.0,4,13635.0,3,B
2018-04-03 09:59:40,13635.0,6,8850,4,13630.0,1,13640.0,5,B
2018-04-03 09:59:40,13630.0,14,8864,8,13635.0,3,13640.0,6,S
2018-04-03 09:59:41,13630.0,8,8872,-6,13630.0,1,13640.0,7,S
2018-04-03 09:59:41,13630.0,2,8874,0,13635.0,2,13640.0,7,S
2018-04-03 09:59:42,13635.0,4,8878,4,13630.0,2,13640.0,5,B
2018-04-03 09:59:44,13635.0,4,8882,-2,13625.0,2,13635.0,4,B
2018-04-03 09:59:47,13630.0,2,8884,-2,13620.0,2,13635.0,8,S
2018-04-03 09:59:48,13630.0,4,8888,0,13620.0,3,13630.0,2,S
2018-04-03 09:59:50,13635.0,2,8890,0,13620.0,3,13635.0,6,B
2018-04-03 09:59:52,13635.0,2,8892,0,13625.0,1,13635.0,3,B
2018-04-03 09:59:52,13635.0,4,8896,-2,13625.0,1,13640.0,10,B
2018-04-03 09:59:53,13635.0,6,8902,0,13625.0,3,13635.0,2,B
2018-04-03 09:59:57,13630.0,2,8904,2,13625.0,2,13635.0,4,S
2018-04-03 09:59:58,13625.0,2,8906,0,13620.0,2,13625.0,4,S
2018-04-03 09:59:59,13620.0,4,8910,2,13615.0,2,13620.0,4,S
2018-04-03 10:00:02,13620.0,6,8916,0,13615.0,2,13625.0,3,S
2018-04-03 10:00:03,13620.0,12,8928,-2,13610.0,3,13620.0,1,S
2018-04-03 10:00:08,13625.0,4,8932,-2,13620.0,6,13625.0,1,B
2018-04-03 10:00:10,13630.0,2,8934,0,13620.0,3,13630.0,7,B
2018-04-03 10:00:14,13630.0,2,8936,2,13620.0,4,13630.0,6,B
2018-04-03 10:00:15,13620.0,2,8938,0,13620.0,3,13630.0,7,S
2018-04-03 10:00:16,13620.0,2,8940,0,13620.0,2,13630.0,3,S
2018-04-03 10:00:22,13620.0,6,8946,0,13615.0,4,13625.0,1,S
2018-04-03 10:00:32,13625.0,2,8948,0,13620.0,1,13630.0,6,B
2018-04-03 10:00:33,13620.0,2,8950,2,13615.0,5,13625.0,6,S
2018-04-03 10:00:37,13620.0,2,8952,0,13615.0,4,13620.0,2,S
2018-04-03 10:00:39,13615.0,4,8956,-2,13610.0,11,13615.0,6,S
2018-04-03 10:00:40,13610.0,2,8958,2,13610.0,2,13615.0,7,S
2018-04-03 10:00:40,13610.0,4,8962,2,13605.0,3,13615.0,7,S
2018-04-03 10:00:45,13605.0,4,8966,-4,13600.0,4,13605.0,4,S
2018-04-03 10:00:45,13605.0,8,8974,-4,13600.0,4,13615.0,2,S
2018-04-03 10:00:47,13600.0,10,8984,8,13600.0,4,13615.0,5,S
2018-04-03 10:00:50,13605.0,2,8986,2,13600.0,3,13605.0,3,B
2018-04-03 10:00:50,13600.0,4,8990,4,13595.0,6,13600.0,1,S
2018-04-03 10:00:51,13600.0,6,8996,0,13595.0,6,13600.0,1,S
2018-04-03 10:00:51,13600.0,2,8998,0,13595.0,6,13605.0,3,S
2018-04-03 10:00:53,13600.0,2,9000,2,13595.0,5,13600.0,1,S
2018-04-03 10:00:54,13600.0,2,9002,0,13595.0,5,13605.0,4,S
2018-04-03 10:00:56,13600.0,2,9004,0,13595.0,6,13605.0,4,S
2018-04-03 10:01:06,13605.0,2,9006,0,13595.0,6,13605.0,4,B
2018-04-03 10:01:09,13600.0,4,9010,4,13595.0,5,13600.0,4,S
2018-04-03 10:01:11,13600.0,2,9012,0,13595.0,5,13600.0,3,S
2018-04-03 10:01:14,13600.0,2,9014,2,13595.0,6,13600.0,2,S
2018-04-03 10:01:14,13600.0,4,9018,0,13595.0,6,13605.0,4,S
2018-04-03 10:01:22,13595.0,14,9032,8,13595.0,1,13605.0,4,S
2018-04-03 10:01:22,13595.0,2,9034,2,13590.0,7,13595.0,7,S
2018-04-03 10:01:27,13595.0,4,9038,4,13590.0,2,13595.0,6,S
2018-04-03 10:01:30,13595.0,2,9040,2,13590.0,2,13595.0,5,S
2018-04-03 10:01:30,13590.0,2,9042,2,13590.0,1,13595.0,5,S
2018-04-03 10:01:39,13590.0,12,9054,12,13585.0,4,13595.0,7,S
2018-04-03 10:01:50,13590.0,2,9056,-2,13585.0,2,13590.0,4,S
2018-04-03 10:01:55,13590.0,8,9064,-4,13585.0,2,13595.0,8,S
2018-04-03 10:01:57,13585.0,2,9066,2,13585.0,1,13595.0,10,S
2018-04-03 10:02:12,13585.0,16,9082,0,13580.0,4,13585.0,1,S
2018-04-03 10:02:12,13585.0,8,9090,4,13580.0,5,13585.0,6,S
2018-04-03 10:02:13,13585.0,8,9098,8,13580.0,5,13585.0,2,S
2018-04-03 10:02:14,13585.0,4,9102,4,13580.0,5,13590.0,2,S
2018-04-03 10:02:16,13585.0,2,9104,2,13585.0,1,13590.0,2,S
2018-04-03 10:02:16,13585.0,2,9106,2,13580.0,8,13590.0,3,S
2018-04-03 10:02:17,13585.0,2,9108,2,13580.0,6,13590.0,3,S
2018-04-03 10:02:20,13590.0,2,9110,2,13580.0,8,13590.0,2,B
2018-04-03 10:02:22,13590.0,6,9116,2,13580.0,8,13595.0,7,B
2018-04-03 10:02:23,13595.0,4,9120,0,13585.0,1,13595.0,7,B
2018-04-03 10:02:24,13585.0,2,9122,2,13580.0,7,13590.0,8,S
2018-04-03 10:02:25,13585.0,2,9124,2,13580.0,8,13590.0,5,S
2018-04-03 10:02:29,13580.0,6,9130,-4,13580.0,7,13590.0,7,S
2018-04-03 10:02:30,13590.0,6,9136,0,13580.0,5,13590.0,4,B
2018-04-03 10:02:31,13580.0,10,9146,6,13580.0,1,13590.0,4,S
2018-04-03 10:02:32,13580.0,2,9148,0,13575.0,14,13580.0,6,S
2018-04-03 10:02:32,13580.0,12,9160,12,13575.0,15,13580.0,1,S
2018-04-03 10:02:34,13585.0,4,9164,2,13575.0,13,13590.0,5,B
2018-04-03 10:02:35,13590.0,14,9178,12,13580.0,4,13590.0,3,B
2018-04-03 10:02:37,13580.0,2,9180,2,13580.0,4,13585.0,1,S
2018-04-03 10:02:37,13590.0,4,9184,2,13580.0,4,13590.0,1,B
2018-04-03 10:02:38,13590.0,2,9186,0,13580.0,4,13595.0,6,B
2018-04-03 10:02:40,13595.0,4,9190,2,13590.0,1,13595.0,4,B
2018-04-03 10:02:40,13590.0,2,9192,2,13585.0,4,13595.0,4,S
2018-04-03 10:02:41,13595.0,4,9196,4,13585.0,5,13600.0,6,B
2018-04-03 10:02:42,13590.0,4,9200,4,13585.0,5,13600.0,6,S
2018-04-03 10:02:43,13590.0,4,9204,0,13590.0,4,13600.0,6,S
2018-04-03 10:02:43,13590.0,8,9212,0,13585.0,5,13600.0,7,S
2018-04-03 10:02:44,13560.0,90,9302,22,13585.0,1,13590.0,4,S
2018-04-03 10:02:44,13570.0,16,9318,6,13570.0,1,13595.0,1,B
2018-04-03 10:02:45,13590.0,4,9322,0,13575.0,17,13590.0,3,B
2018-04-03 10:02:45,13590.0,2,9324,2,13575.0,18,13590.0,1,B
2018-04-03 10:02:46,13595.0,6,9330,0,13580.0,1,13590.0,1,B
2018-04-03 10:02:47,13595.0,4,9334,2,13580.0,2,13595.0,9,B
2018-04-03 10:02:49,13595.0,6,9340,6,13580.0,2,13590.0,1,B
2018-04-03 10:02:50,13590.0,2,9342,2,13580.0,2,13585.0,30,S
2018-04-03 10:02:50,13585.0,24,9366,24,13580.0,2,13585.0,18,S
2018-04-03 10:02:52,13585.0,6,9372,6,13580.0,2,13585.0,15,S
2018-04-03 10:02:54,13580.0,4,9376,2,13575.0,15,13585.0,15,S
2018-04-03 10:03:00,13580.0,2,9378,2,13580.0,4,13585.0,17,S
2018-04-03 10:03:00,13580.0,4,9382,2,13580.0,2,13585.0,15,S
2018-04-03 10:03:05,13585.0,4,9386,4,13580.0,4,13585.0,13,B
2018-04-03 10:03:07,13585.0,2,9388,0,13580.0,4,13585.0,12,B
2018-04-03 10:03:07,13590.0,26,9414,14,13585.0,16,13590.0,5,B
2018-04-03 10:03:08,13585.0,2,9416,0,13585.0,17,13590.0,1,S
2018-04-03 10:03:08,13590.0,2,9418,0,13585.0,16,13595.0,15,B
2018-04-03 10:03:10,13585.0,2,9420,0,13585.0,2,13590.0,1,S
2018-04-03 10:03:14,13590.0,2,9422,0,13585.0,3,13595.0,14,B
2018-04-03 10:03:15,13590.0,2,9424,0,13585.0,6,13595.0,5,B
2018-04-03 10:03:20,13590.0,14,9438,-8,13585.0,4,13595.0,5,B
2018-04-03 10:03:22,13595.0,2,9440,0,13585.0,3,13595.0,5,B
2018-04-03 10:03:24,13590.0,2,9442,2,13585.0,3,13590.0,29,S
2018-04-03 10:03:25,13585.0,6,9448,2,13580.0,8,13590.0,34,S
2018-04-03 10:03:25,13590.0,2,9450,0,13580.0,5,13590.0,33,B
2018-04-03 10:03:29,13585.0,2,9452,2,13580.0,4,13590.0,34,S
2018-04-03 10:03:30,13585.0,2,9454,0,13580.0,5,13590.0,29,S
2018-04-03 10:03:40,13590.0,58,9512,0,13590.0,14,13595.0,10,B
2018-04-03 10:03:43,13585.0,4,9516,2,13585.0,1,13595.0,10,S
2018-04-03 10:03:43,13585.0,2,9518,2,13580.0,12,13585.0,1,S
2018-04-03 10:03:44,13585.0,4,9522,2,13585.0,4,13595.0,11,S
2018-04-03 10:03:44,13585.0,8,9530,4,13585.0,1,13595.0,11,S
2018-04-03 10:03:45,13585.0,2,9532,0,13580.0,11,13585.0,3,S
2018-04-03 10:03:45,13585.0,8,9540,2,13585.0,4,13595.0,10,S
2018-04-03 10:03:46,13585.0,4,9544,0,13585.0,2,13595.0,10,S
2018-04-03 10:03:49,13585.0,2,9546,-2,13585.0,4,13595.0,5,S
2018-04-03 10:03:55,13590.0,2,9548,2,13590.0,3,13595.0,6,B
2018-04-03 10:03:56,13590.0,2,9550,0,13585.0,2,13595.0,7,B
2018-04-03 10:03:59,13590.0,2,9552,0,13585.0,4,13595.0,7,B
2018-04-03 10:04:03,13585.0,2,9554,2,13580.0,13,13590.0,1,S
2018-04-03 10:04:05,13590.0,2,9556,-2,13580.0,12,13590.0,1,B
2018-04-03 10:04:09,13590.0,2,9558,-2,13585.0,1,13590.0,1,B
2018-04-03 10:04:18,13590.0,2,9560,0,13585.0,2,13595.0,12,B
2018-04-03 10:04:22,13585.0,2,9562,0,13585.0,2,13590.0,6,S
2018-04-03 10:04:23,13585.0,4,9566,2,13580.0,9,13590.0,6,S
2018-04-03 10:04:24,13590.0,2,9568,-2,13580.0,6,13590.0,6,B
2018-04-03 10:04:31,13585.0,2,9570,-2,13580.0,6,13585.0,6,S
2018-04-03 10:04:37,13585.0,2,9572,0,13580.0,6,13590.0,4,S
2018-04-03 10:04:56,13585.0,2,9574,-2,13580.0,5,13585.0,2,S
2018-04-03 10:05:12,13580.0,2,9576,0,13580.0,4,13585.0,7,S
2018-04-03 10:05:16,13580.0,2,9578,2,13580.0,3,13585.0,7,S
2018-04-03 10:05:16,13580.0,2,9580,-2,13580.0,2,13585.0,7,S
2018-04-03 10:05:22,13580.0,2,9582,2,13580.0,2,13585.0,3,S
2018-04-03 10:05:22,13585.0,4,9586,0,13580.0,3,13590.0,10,B
2018-04-03 10:05:23,13585.0,2,9588,2,13585.0,1,13590.0,5,B
2018-04-03 10:05:23,13585.0,2,9590,2,13580.0,3,13590.0,5,B
2018-04-03 10:05:25,13585.0,2,9592,2,13580.0,3,13590.0,5,B
2018-04-03 10:05:34,13585.0,2,9594,0,13580.0,4,13590.0,4,B
2018-04-03 10:05:41,13580.0,2,9596,0,13580.0,1,13585.0,5,S
2018-04-03 10:05:53,13590.0,12,9608,4,13585.0,1,13590.0,5,B
2018-04-03 10:05:57,13580.0,2,9610,2,13580.0,3,13590.0,17,S
2018-04-03 10:06:17,13585.0,2,9612,0,13580.0,1,13590.0,17,B
2018-04-03 10:06:18,13585.0,6,9618,6,13580.0,1,13590.0,17,B
2018-04-03 10:06:26,13590.0,8,9626,2,13575.0,4,13590.0,1,B
2018-04-03 10:06:40,13590.0,10,9636,-10,13580.0,1,13590.0,5,B
2018-04-03 10:06:45,13580.0,2,9638,-2,13580.0,2,13590.0,5,S
2018-04-03 10:06:59,13585.0,2,9640,0,13580.0,1,13590.0,7,B
2018-04-03 10:07:00,13580.0,2,9642,-2,13575.0,5,13590.0,7,S
2018-04-03 10:07:13,13595.0,22,9664,-2,13585.0,7,13595.0,2,B
2018-04-03 10:07:14,13595.0,2,9666,2,13590.0,3,13600.0,9,B
2018-04-03 10:07:28,13590.0,4,9670,0,13585.0,2,13595.0,1,S
2018-04-03 10:07:30,13600.0,56,9726,30,13600.0,2,13605.0,16,B
2018-04-03 10:07:30,13600.0,4,9730,4,13590.0,1,13600.0,9,B
2018-04-03 10:07:31,13595.0,2,9732,-2,13590.0,1,13600.0,7,S
2018-04-03 10:07:38,13590.0,2,9734,0,13590.0,1,13595.0,2,S
2018-04-03 10:07:44,13595.0,4,9738,0,13590.0,1,13600.0,13,B
2018-04-03 10:07:46,13590.0,2,9740,-2,13590.0,1,13600.0,13,S
2018-04-03 10:07:56,13590.0,2,9742,2,13590.0,1,13600.0,13,S
2018-04-03 10:08:00,13590.0,6,9748,0,13585.0,3,13595.0,1,S
2018-04-03 10:08:06,13595.0,2,9750,-2,13585.0,3,13600.0,13,B
2018-04-03 10:08:25,13600.0,2,9752,0,13590.0,2,13600.0,10,B
2018-04-03 10:08:29,13600.0,20,9772,8,13595.0,7,13605.0,12,B
2018-04-03 10:08:35,13605.0,8,9780,4,13595.0,6,13605.0,7,B
2018-04-03 10:08:37,13605.0,4,9784,0,13600.0,3,13605.0,1,B
2018-04-03 10:08:39,13600.0,2,9786,0,13595.0,3,13605.0,9,S
2018-04-03 10:08:54,13595.0,2,9788,-2,13590.0,3,13600.0,1,S
2018-04-03 10:09:14,13600.0,2,9790,0,13595.0,1,13605.0,7,B
2018-04-03 10:09:32,13610.0,10,9800,4,13600.0,2,13610.0,7,B
2018-04-03 10:09:34,13600.0,2,9802,2,13600.0,7,13610.0,4,S
2018-04-03 10:09:41,13605.0,2,9804,0,13605.0,3,13610.0,7,B
2018-04-03 10:09:42,13605.0,2,9806,0,13600.0,4,13610.0,10,B
2018-04-03 10:09:45,13605.0,2,9808,2,13600.0,4,13605.0,1,B
2018-04-03 10:09:50,13600.0,2,9810,-2,13600.0,2,13605.0,2,S
2018-04-03 10:09:57,13605.0,6,9816,-2,13600.0,32,13605.0,1,B
2018-04-03 10:10:01,13605.0,2,9818,-2,13600.0,33,13610.0,10,B
2018-04-03 10:10:01,13610.0,4,9822,-2,13605.0,1,13610.0,2,B
2018-04-03 10:10:02,13610.0,2,9824,-2,13605.0,5,13615.0,4,B
2018-04-03 10:10:20,13615.0,24,9848,16,13605.0,7,13615.0,2,B
2018-04-03 10:10:21,13610.0,4,9852,0,13605.0,7,13615.0,3,S
2018-04-03 10:10:28,13610.0,2,9854,-2,13610.0,1,13615.0,4,S
2018-04-03 10:10:58,13610.0,2,9856,0,13610.0,4,13615.0,2,S
2018-04-03 10:11:16,13615.0,4,9860,-4,13610.0,7,13620.0,4,B
2018-04-03 10:11:18,13620.0,6,9866,-2,13610.0,8,13620.0,2,B
2018-04-03 10:11:25,13615.0,6,9872,2,13615.0,1,13620.0,2,S
2018-04-03 10:11:31,13615.0,2,9874,0,13615.0,4,13620.0,3,S
2018-04-03 10:11:34,13620.0,6,9880,-2,13620.0,2,13625.0,1,B
2018-04-03 10:11:34,13620.0,2,9882,-2,13620.0,1,13625.0,4,B
2018-04-03 10:11:39,13620.0,2,9884,0,13620.0,4,13625.0,4,B
2018-04-03 10:11:41,13620.0,2,9886,-2,13620.0,3,13625.0,4,B
2018-04-03 10:11:46,13625.0,4,9890,0,13620.0,1,13625.0,3,B
2018-04-03 10:11:59,13625.0,4,9894,2,13620.0,2,13630.0,6,B
2018-04-03 10:12:01,13625.0,2,9896,0,13620.0,1,13625.0,2,B
2018-04-03 10:12:01,13625.0,4,9900,4,13620.0,1,13630.0,8,B
2018-04-03 10:12:04,13625.0,2,9902,2,13620.0,1,13630.0,10,B
2018-04-03 10:12:04,13620.0,2,9904,2,13615.0,6,13630.0,11,S
2018-04-03 10:12:26,13620.0,4,9908,0,13620.0,3,13625.0,1,S
2018-04-03 10:12:28,13620.0,2,9910,0,13620.0,2,13625.0,1,S
2018-04-03 10:12:46,13625.0,8,9918,-2,13625.0,3,13630.0,7,B
2018-04-03 10:12:47,13630.0,6,9924,-2,13625.0,3,13630.0,2,B
2018-04-03 10:12:48,13630.0,4,9928,0,13630.0,2,13635.0,5,B
2018-04-03 10:12:48,13630.0,4,9932,-4,13625.0,4,13635.0,5,B
2018-04-03 10:13:11,13630.0,2,9934,0,13620.0,8,13630.0,1,B
2018-04-03 10:13:26,13625.0,2,9936,2,13620.0,22,13630.0,1,S
2018-04-03 10:13:29,13630.0,2,9938,2,13625.0,7,13635.0,6,B
2018-04-03 10:13:31,13625.0,2,9940,-2,13620.0,9,13630.0,1,S
2018-04-03 10:13:38,13625.0,2,9942,-2,13625.0,2,13630.0,1,S
2018-04-03 10:13:40,13630.0,4,9946,2,13630.0,8,13635.0,6,B
2018-04-03 10:13:40,13630.0,4,9950,2,13630.0,6,13635.0,6,B
2018-04-03 10:13:41,13630.0,2,9952,0,13630.0,5,13635.0,6,B
2018-04-03 10:13:42,13630.0,2,9954,2,13630.0,4,13635.0,6,B
2018-04-03 10:13:44,13635.0,12,9966,8,13630.0,4,13640.0,8,B
2018-04-03 10:13:50,13630.0,6,9972,4,13630.0,1,13635.0,5,S
2018-04-03 10:13:51,13630.0,2,9974,0,13625.0,2,13635.0,5,S
2018-04-03 10:14:07,13620.0,6,9980,-2,13620.0,9,13630.0,3,S
2018-04-03 10:14:23,13620.0,2,9982,2,13615.0,8,13625.0,3,S
2018-04-03 10:14:34,13615.0,2,9984,0,13610.0,5,13620.0,2,S
2018-04-03 10:14:39,13610.0,2,9986,0,13610.0,1,13615.0,2,S
2018-04-03 10:14:59,13620.0,2,9988,-2,13620.0,1,13625.0,63,B
2018-04-03 10:30:00,13625.0,2,9990,2,13620.0,1,13625.0,62,B
2018-04-03 10:30:05,13620.0,2,9992,0,13615.0,8,13625.0,32,S
2018-04-03 10:30:24,13615.0,2,9994,2,13610.0,4,13620.0,6,S
2018-04-03 10:31:09,13615.0,4,9998,-4,13610.0,9,13615.0,2,S
2018-04-03 10:31:10,13610.0,2,10000,0,13610.0,7,13615.0,1,S
2018-04-03 10:31:44,13610.0,18,10018,-10,13605.0,6,13615.0,1,S
2018-04-03 10:32:06,13615.0,8,10026,2,13615.0,1,13620.0,3,B
2018-04-03 10:32:20,13615.0,2,10028,2,13615.0,1,13620.0,7,B
2018-04-03 10:32:20,13615.0,2,10030,0,13610.0,3,13615.0,4,B
2018-04-03 10:32:29,13615.0,2,10032,0,13610.0,2,13615.0,2,B
2018-04-03 10:32:31,13615.0,2,10034,0,13610.0,2,13615.0,1,B
2018-04-03 10:32:37,13615.0,2,10036,2,13610.0,2,13615.0,1,B
2018-04-03 10:33:01,13615.0,2,10038,0,13615.0,3,13620.0,36,B
2018-04-03 10:33:26,13615.0,2,10040,0,13610.0,5,13620.0,35,B
2018-04-03 10:33:39,13620.0,2,10042,-2,13610.0,8,13620.0,36,B
2018-04-03 10:33:58,13615.0,2,10044,-2,13610.0,8,13620.0,34,S
2018-04-03 10:34:04,13620.0,4,10048,2,13610.0,9,13620.0,33,B
2018-04-03 10:34:18,13615.0,2,10050,0,13610.0,9,13615.0,2,S
2018-04-03 10:34:25,13615.0,2,10052,2,13610.0,8,13615.0,3,S
2018-04-03 10:34:55,13620.0,4,10056,4,13615.0,1,13620.0,30,B
2018-04-03 10:34:58,13615.0,2,10058,2,13610.0,8,13615.0,1,S
2018-04-03 10:34:59,13620.0,4,10062,4,13610.0,8,13620.0,31,B
2018-04-03 10:35:34,13620.0,2,10064,2,13610.0,8,13620.0,29,B
2018-04-03 10:35:50,13620.0,12,10076,12,13615.0,7,13620.0,19,B
2018-04-03 10:35:57,13620.0,4,10080,4,13615.0,7,13620.0,17,B
2018-04-03 10:35:59,13620.0,6,10086,4,13615.0,7,13620.0,14,B
2018-04-03 10:36:00,13620.0,12,10098,12,13615.0,21,13620.0,8,B
2018-04-03 10:36:00,13620.0,8,10106,6,13615.0,21,13620.0,4,B
2018-04-03 10:36:01,13620.0,8,10114,8,13620.0,1,13625.0,38,B
2018-04-03 10:36:01,13625.0,6,10120,6,13615.0,8,13625.0,34,B
2018-04-03 10:36:03,13625.0,4,10124,0,13620.0,4,13625.0,30,B
2018-04-03 10:36:04,13625.0,18,10142,18,13620.0,4,13625.0,21,B
2018-04-03 10:36:05,13625.0,4,10146,0,13620.0,6,13625.0,19,B
2018-04-03 10:36:05,13625.0,2,10148,2,13620.0,6,13625.0,17,B
2018-04-03 10:36:07,13625.0,2,10150,2,13620.0,4,13625.0,16,B
2018-04-03 10:36:16,13625.0,4,10154,4,13620.0,4,13625.0,14,B
2018-04-03 10:36:20,13625.0,2,10156,2,13620.0,5,13625.0,14,B
2018-04-03 10:36:20,13625.0,2,10158,2,13620.0,5,13625.0,13,B
2018-04-03 10:36:25,13625.0,2,10160,2,13620.0,5,13625.0,12,B
2018-04-03 10:36:28,13620.0,4,10164,-2,13620.0,3,13625.0,13,S
2018-04-03 10:36:28,13620.0,8,10172,-2,13615.0,3,13620.0,3,S
2018-04-03 10:36:33,13610.0,2,10174,0,13605.0,6,13615.0,3,S
2018-04-03 10:36:34,13610.0,4,10178,-2,13610.0,1,13615.0,5,S
2018-04-03 10:36:37,13615.0,6,10184,4,13610.0,1,13620.0,10,B
2018-04-03 10:36:40,13620.0,2,10186,-2,13615.0,2,13620.0,3,B
2018-04-03 10:36:44,13610.0,12,10198,-4,13605.0,1,13610.0,15,S
2018-04-03 10:36:45,13610.0,6,10204,-2,13605.0,1,13610.0,12,S
2018-04-03 10:36:45,13610.0,4,10208,0,13605.0,2,13610.0,10,S
2018-04-03 10:36:50,13605.0,2,10210,2,13605.0,1,13610.0,10,S
2018-04-03 10:36:53,13610.0,6,10216,0,13605.0,1,13610.0,8,B
2018-04-03 10:36:54,13610.0,6,10222,0,13605.0,1,13610.0,4,B
2018-04-03 10:36:54,13610.0,2,10224,0,13605.0,1,13610.0,3,B
2018-04-03 10:37:00,13610.0,2,10226,2,13610.0,1,13615.0,7,B
2018-04-03 10:37:04,13610.0,2,10228,0,13600.0,37,13615.0,7,B
2018-04-03 10:37:07,13610.0,8,10236,4,13610.0,1,13615.0,9,B
2018-04-03 10:37:08,13610.0,2,10238,0,13600.0,36,13615.0,9,B
2018-04-03 10:37:25,13605.0,2,10240,0,13605.0,5,13610.0,4,S
2018-04-03 10:37:25,13605.0,10,10250,0,13600.0,34,13610.0,5,S
2018-04-03 10:37:58,13605.0,6,10256,2,13600.0,34,13610.0,4,S
2018-04-03 10:38:12,13605.0,4,10260,0,13600.0,34,13605.0,1,S
2018-04-03 10:38:21,13605.0,2,10262,-2,13600.0,35,13605.0,1,S
2018-04-03 10:38:23,13605.0,2,10264,2,13600.0,35,13605.0,1,S
2018-04-03 10:38:32,13605.0,4,10268,4,13600.0,35,13610.0,4,S
2018-04-03 10:38:46,13605.0,2,10270,-2,13600.0,35,13610.0,6,S
2018-04-03 10:39:04,13605.0,2,10272,0,13600.0,35,13610.0,11,S
2018-04-03 10:39:12,13600.0,2,10274,2,13600.0,34,13610.0,9,S
2018-04-03 10:39:39,13605.0,6,10280,-4,13600.0,49,13610.0,5,B
2018-04-03 10:40:10,13605.0,2,10282,-2,13600.0,38,13610.0,6,B
2018-04-03 10:40:33,13605.0,2,10284,0,13600.0,36,13605.0,7,B
2018-04-03 10:40:56,13605.0,4,10288,0,13600.0,37,13610.0,8,B
2018-04-03 10:41:14,13605.0,2,10290,0,13605.0,2,13610.0,11,B
2018-04-03 10:41:23,13605.0,2,10292,0,13600.0,38,13610.0,11,B
2018-04-03 10:42:32,13600.0,2,10294,2,13600.0,37,13605.0,3,S
2018-04-03 10:42:49,13605.0,2,10296,-2,13600.0,37,13605.0,2,B
2018-04-03 10:43:04,13605.0,4,10300,4,13600.0,37,13610.0,10,B
2018-04-03 10:43:07,13610.0,4,10304,0,13605.0,5,13615.0,4,B
2018-04-03 10:43:47,13615.0,2,10306,-2,13605.0,6,13615.0,3,B
2018-04-03 10:43:54,13605.0,2,10308,2,13600.0,39,13610.0,9,S
2018-04-03 10:44:11,13610.0,4,10312,0,13605.0,4,13615.0,8,B
2018-04-03 10:44:46,13610.0,2,10314,0,13605.0,6,13615.0,8,B
2018-04-03 10:44:47,13610.0,2,10316,0,13605.0,6,13615.0,6,B
2018-04-03 10:45:34,13610.0,2,10318,2,13610.0,1,13615.0,4,B
2018-04-03 10:45:58,13610.0,2,10320,0,13610.0,1,13615.0,5,B
2018-04-03 10:46:17,13620.0,2,10322,0,13615.0,5,13625.0,18,B
2018-04-03 10:46:26,13620.0,2,10324,0,13615.0,4,13625.0,12,B
2018-04-03 10:46:41,13625.0,6,10330,4,13620.0,16,13625.0,9,B
2018-04-03 10:46:42,13625.0,12,10342,12,13620.0,16,13625.0,3,B
2018-04-03 10:46:54,13625.0,2,10344,2,13620.0,2,13625.0,2,B
2018-04-03 10:46:55,13625.0,2,10346,2,13620.0,3,13625.0,1,B
2018-04-03 10:46:58,13625.0,2,10348,0,13620.0,1,13625.0,2,B
2018-04-03 10:47:05,13625.0,2,10350,2,13620.0,2,13625.0,2,B
2018-04-03 10:47:22,13615.0,2,10352,2,13615.0,1,13620.0,1,S
2018-04-03 10:47:34,13610.0,2,10354,0,13605.0,29,13620.0,3,S
2018-04-03 10:48:30,13610.0,4,10358,4,13610.0,2,13620.0,3,S
2018-04-03 10:49:09,13610.0,2,10360,0,13610.0,1,13620.0,6,S
2018-04-03 10:49:15,13610.0,2,10362,-2,13605.0,4,13615.0,2,S
2018-04-03 10:49:20,13610.0,4,10366,0,13605.0,3,13615.0,7,S
2018-04-03 10:49:48,13615.0,4,10370,4,13605.0,3,13615.0,5,B
2018-04-03 10:50:50,13610.0,2,10372,0,13605.0,5,13615.0,5,S
2018-04-03 10:50:56,13610.0,2,10374,0,13605.0,4,13610.0,2,S
2018-04-03 10:51:35,13610.0,2,10376,2,13605.0,33,13615.0,3,S
2018-04-03 10:51:41,13610.0,4,10380,4,13610.0,1,13615.0,1,S
2018-04-03 10:51:45,13610.0,2,10382,0,13605.0,48,13615.0,1,S
2018-04-03 10:52:07,13605.0,4,10386,-4,13605.0,47,13615.0,1,S
2018-04-03 10:52:19,13615.0,2,10388,0,13615.0,1,13625.0,10,B
2018-04-03 10:52:33,13615.0,2,10390,0,13610.0,36,13620.0,1,B
2018-04-03 10:53:04,13620.0,2,10392,-2,13615.0,2,13625.0,17,B
2018-04-03 10:53:24,13615.0,4,10396,-2,13610.0,28,13625.0,14,S
2018-04-03 10:53:49,13615.0,20,10416,0,13610.0,1,13620.0,15,S
2018-04-03 10:56:00,13615.0,4,10420,2,13610.0,18,13620.0,11,S
2018-04-03 10:56:09,13620.0,2,10422,0,13610.0,3,13620.0,6,B
2018-04-03 10:56:10,13620.0,2,10424,0,13610.0,2,13615.0,2,B
2018-04-03 10:56:22,13615.0,2,10426,2,13610.0,7,13620.0,4,S
2018-04-03 10:56:50,13620.0,4,10430,0,13620.0,8,13625.0,15,B
2018-04-03 10:56:51,13625.0,4,10434,2,13620.0,4,13625.0,7,B
2018-04-03 10:56:53,13630.0,22,10456,4,13620.0,16,13630.0,16,B
2018-04-03 10:56:54,13625.0,4,10460,4,13620.0,2,13630.0,13,S
2018-04-03 10:57:35,13620.0,4,10464,-4,13615.0,3,13625.0,7,S
2018-04-03 10:57:56,13615.0,2,10466,0,13610.0,5,13620.0,7,S
2018-04-03 10:58:22,13610.0,6,10472,2,13610.0,3,13620.0,2,S
2018-04-03 10:58:23,13620.0,10,10482,-8,13610.0,3,13625.0,10,B
2018-04-03 10:58:24,13610.0,2,10484,0,13610.0,4,13620.0,3,S
2018-04-03 10:58:32,13615.0,2,10486,0,13610.0,4,13620.0,3,B
2018-04-03 10:58:42,13615.0,2,10488,0,13610.0,1,13615.0,1,B
2018-04-03 10:58:48,13610.0,2,10490,0,13605.0,83,13615.0,2,S
2018-04-03 10:59:24,13615.0,2,10492,2,13610.0,2,13615.0,1,B
2018-04-03 11:01:27,13615.0,2,10494,0,13610.0,5,13615.0,1,B
2018-04-03 11:02:13,13610.0,6,10500,-4,13605.0,84,13610.0,1,S
2018-04-03 11:02:33,13605.0,2,10502,0,13605.0,82,13610.0,4,S
2018-04-03 11:02:33,13605.0,100,10602,60,13605.0,32,13610.0,4,S
2018-04-03 11:02:34,13610.0,8,10610,2,13605.0,32,13615.0,19,B
2018-04-03 11:02:44,13605.0,16,10626,-4,13605.0,24,13610.0,18,S
2018-04-03 11:02:44,13600.0,116,10742,2,13595.0,1,13605.0,5,S
2018-04-03 11:03:30,13600.0,2,10744,2,13595.0,2,13600.0,4,S
2018-04-03 11:03:34,13595.0,4,10748,0,13590.0,4,13600.0,2,S
2018-04-03 11:03:35,13590.0,2,10750,-2,13590.0,5,13595.0,7,S
2018-04-03 11:03:37,13595.0,18,10768,6,13590.0,4,13595.0,1,B
2018-04-03 11:03:49,13590.0,2,10770,0,13590.0,3,13595.0,2,S
2018-04-03 11:03:51,13590.0,2,10772,-2,13590.0,3,13595.0,2,S
2018-04-03 11:03:59,13595.0,2,10774,0,13595.0,2,13600.0,7,B
2018-04-03 11:04:00,13600.0,2,10776,0,13595.0,7,13600.0,1,B
2018-04-03 11:04:01,13605.0,4,10780,4,13595.0,1,13605.0,3,B
2018-04-03 11:04:04,13595.0,2,10782,-2,13590.0,4,13600.0,9,S
2018-04-03 11:04:08,13605.0,12,10794,10,13595.0,5,13605.0,4,B
2018-04-03 11:04:12,13595.0,2,10796,0,13590.0,5,13595.0,1,S
2018-04-03 11:04:28,13590.0,4,10800,0,13585.0,4,13590.0,1,S
2018-04-03 11:04:40,13585.0,2,10802,0,13585.0,1,13590.0,2,S
2018-04-03 11:04:40,13585.0,2,10804,2,13580.0,6,13590.0,2,S
2018-04-03 11:04:43,13580.0,10,10814,-8,13575.0,12,13585.0,2,S
2018-04-03 11:04:44,13580.0,2,10816,-2,13575.0,11,13585.0,3,S
2018-04-03 11:04:45,13580.0,2,10818,-2,13575.0,11,13585.0,5,S
2018-04-03 11:04:54,13585.0,2,10820,2,13580.0,5,13585.0,9,B
2018-04-03 11:04:54,13585.0,4,10824,-2,13580.0,7,13585.0,3,B
2018-04-03 11:04:55,13585.0,6,10830,-2,13575.0,13,13585.0,4,B
2018-04-03 11:05:19,13580.0,2,10832,0,13580.0,1,13585.0,1,S
2018-04-03 11:05:21,13580.0,2,10834,2,13575.0,13,13580.0,1,S
2018-04-03 11:05:25,13585.0,2,10836,0,13575.0,11,13585.0,5,B
2018-04-03 11:05:27,13585.0,2,10838,0,13575.0,11,13585.0,4,B
2018-04-03 11:05:28,13575.0,2,10840,-2,13575.0,11,13585.0,4,S
2018-04-03 11:05:33,13575.0,18,10858,-18,13570.0,5,13580.0,4,S
2018-04-03 11:05:34,13570.0,2,10860,0,13570.0,4,13580.0,4,S
2018-04-03 11:05:36,13570.0,4,10864,2,13570.0,5,13580.0,4,S
2018-04-03 11:05:39,13570.0,2,10866,0,13570.0,3,13580.0,6,S
2018-04-03 11:05:56,13570.0,6,10872,-2,13565.0,2,13570.0,7,S
2018-04-03 11:05:56,13565.0,4,10876,-2,13560.0,5,13565.0,1,S
2018-04-03 11:05:57,13565.0,2,10878,0,13560.0,5,13570.0,7,S
2018-04-03 11:05:57,13570.0,2,10880,2,13560.0,5,13570.0,5,B
2018-04-03 11:06:01,13570.0,2,10882,0,13565.0,2,13570.0,1,B
2018-04-03 11:06:03,13570.0,2,10884,2,13565.0,2,13575.0,3,B
2018-04-03 11:06:26,13575.0,2,10886,0,13570.0,2,13575.0,3,B
2018-04-03 11:06:30,13575.0,6,10892,2,13570.0,4,13580.0,6,B
2018-04-03 11:06:31,13575.0,2,10894,-2,13570.0,3,13575.0,1,B
2018-04-03 11:06:34,13575.0,2,10896,0,13570.0,3,13580.0,4,B
2018-04-03 11:06:38,13575.0,2,10898,0,13570.0,3,13580.0,1,B
2018-04-03 11:06:39,13575.0,4,10902,4,13570.0,5,13580.0,1,B
2018-04-03 11:07:05,13575.0,6,10908,-2,13575.0,1,13580.0,4,B
2018-04-03 11:07:10,13575.0,2,10910,-2,13570.0,4,13580.0,4,B
2018-04-03 11:07:16,13575.0,6,10916,0,13570.0,2,13580.0,21,B
2018-04-03 11:07:17,13570.0,4,10920,-2,13565.0,4,13575.0,1,S
2018-04-03 11:07:19,13565.0,2,10922,-2,13565.0,2,13575.0,5,S
2018-04-03 11:07:20,13565.0,4,10926,-2,13565.0,1,13580.0,21,S
2018-04-03 11:08:08,13570.0,2,10928,0,13565.0,6,13570.0,1,B
2018-04-03 11:08:10,13565.0,2,10930,2,13560.0,34,13570.0,3,S
2018-04-03 11:08:13,13565.0,2,10932,-2,13560.0,33,13570.0,7,S
2018-04-03 11:08:16,13565.0,4,10936,4,13565.0,1,13570.0,3,S
2018-04-03 11:08:34,13575.0,4,10940,-4,13565.0,3,13575.0,2,B
2018-04-03 11:08:37,13565.0,6,10946,4,13560.0,34,13565.0,7,S
2018-04-03 11:08:37,13565.0,14,10960,10,13565.0,3,13575.0,5,S
2018-04-03 11:09:00,13570.0,2,10962,-2,13565.0,2,13575.0,6,B
2018-04-03 11:09:02,13565.0,2,10964,0,13560.0,34,13570.0,3,S
2018-04-03 11:09:15,13565.0,2,10966,0,13560.0,31,13570.0,6,S
2018-04-03 11:09:20,13565.0,2,10968,-2,13560.0,31,13565.0,1,S
2018-04-03 11:09:24,13565.0,2,10970,0,13560.0,31,13570.0,6,S
2018-04-03 11:09:28,13560.0,2,10972,0,13560.0,30,13565.0,4,S
2018-04-03 11:09:29,13560.0,4,10976,-2,13560.0,28,13565.0,4,S
2018-04-03 11:09:29,13560.0,4,10980,-4,13560.0,26,13565.0,3,S
2018-04-03 11:09:35,13560.0,2,10982,0,13560.0,25,13565.0,2,S
2018-04-03 11:09:35,13560.0,6,10988,-2,13560.0,24,13570.0,10,S
2018-04-03 11:09:40,13560.0,4,10992,-4,13560.0,22,13565.0,1,S
2018-04-03 11:09:59,13570.0,4,10996,0,13565.0,4,13575.0,7,B
2018-04-03 11:10:00,13575.0,2,10998,2,13570.0,4,13575.0,1,B
2018-04-03 11:10:26,13580.0,2,11000,-2,13575.0,2,13585.0,6,B
2018-04-03 11:11:06,13580.0,2,11002,-2,13575.0,3,13580.0,1,B
2018-04-03 11:11:06,13580.0,2,11004,0,13575.0,5,13585.0,6,B
2018-04-03 11:12:16,13575.0,4,11008,0,13575.0,1,13580.0,4,S
2018-04-03 11:12:17,13575.0,2,11010,0,13570.0,5,13580.0,5,S
2018-04-03 11:12:38,13575.0,8,11018,6,13565.0,17,13575.0,31,S
2018-04-03 11:13:09,13570.0,2,11020,-2,13565.0,7,13575.0,32,S
2018-04-03 11:13:13,13575.0,4,11024,0,13570.0,2,13575.0,29,B
2018-04-03 11:13:33,13570.0,10,11034,-8,13570.0,1,13575.0,29,S
2018-04-03 11:13:34,13570.0,2,11036,2,13565.0,3,13570.0,1,S
2018-04-03 11:13:34,13570.0,2,11038,-2,13565.0,3,13575.0,34,S
2018-04-03 11:13:37,13570.0,2,11040,0,13565.0,3,13570.0,1,S
2018-04-03 11:13:57,13575.0,2,11042,0,13570.0,3,13575.0,28,B
2018-04-03 11:13:57,13575.0,2,11044,2,13570.0,3,13575.0,27,B
2018-04-03 11:14:16,13575.0,4,11048,0,13570.0,3,13575.0,25,B
2018-04-03 11:14:26,13570.0,2,11050,0,13570.0,2,13575.0,25,S
2018-04-03 11:14:40,13570.0,4,11054,0,13565.0,18,13575.0,25,S
2018-04-03 11:14:41,13570.0,2,11056,-2,13565.0,17,13575.0,25,S
2018-04-03 11:14:53,13565.0,2,11058,-2,13560.0,78,13570.0,4,S
2018-04-03 11:15:20,13565.0,6,11064,-2,13565.0,1,13570.0,11,S
2018-04-03 11:15:42,13570.0,2,11066,2,13565.0,1,13575.0,31,B
2018-04-03 11:15:53,13565.0,2,11068,0,13560.0,78,13570.0,9,S
2018-04-03 11:16:00,13560.0,40,11108,-20,13560.0,58,13565.0,2,S
2018-04-03 11:16:01,13555.0,126,11234,-6,13550.0,22,13555.0,20,S
2018-04-03 11:16:02,13550.0,14,11248,8,13550.0,15,13555.0,20,S
2018-04-03 11:16:03,13550.0,6,11254,-2,13550.0,12,13555.0,21,S
2018-04-03 11:16:03,13550.0,2,11256,-2,13550.0,11,13555.0,21,S
2018-04-03 11:16:04,13550.0,4,11260,0,13550.0,9,13555.0,22,S
2018-04-03 11:16:04,13550.0,2,11262,-2,13550.0,8,13555.0,22,S
2018-04-03 11:16:05,13555.0,2,11264,0,13550.0,8,13555.0,21,B
2018-04-03 11:16:07,13550.0,6,11270,-6,13550.0,6,13555.0,19,S
2018-04-03 11:16:17,13550.0,2,11272,-2,13550.0,4,13555.0,21,S
2018-04-03 11:16:18,13550.0,6,11278,-4,13550.0,1,13555.0,23,S
2018-04-03 11:16:19,13550.0,2,11280,2,13545.0,2,13550.0,1,S
2018-04-03 11:16:36,13550.0,12,11292,-10,13545.0,3,13550.0,1,S
2018-04-03 11:16:38,13545.0,6,11298,-4,13540.0,5,13545.0,27,S
2018-04-03 11:16:38,13545.0,36,11334,-4,13540.0,8,13545.0,9,S
2018-04-03 11:16:39,13545.0,12,11346,-12,13540.0,9,13545.0,3,S
2018-04-03 11:16:39,13545.0,6,11352,0,13545.0,1,13550.0,3,S
2018-04-03 11:16:43,13545.0,2,11354,2,13545.0,5,13555.0,20,S
2018-04-03 11:16:46,13555.0,2,11356,0,13550.0,3,13555.0,18,B
2018-04-03 11:16:47,13555.0,4,11360,0,13550.0,3,13555.0,16,B
2018-04-03 11:16:49,13555.0,4,11364,2,13550.0,4,13555.0,14,B
2018-04-03 11:16:49,13555.0,8,11372,8,13550.0,4,13555.0,10,B
2018-04-03 11:16:52,13555.0,2,11374,2,13545.0,3,13555.0,9,B
2018-04-03 11:17:23,13545.0,2,11376,-2,13540.0,8,13550.0,5,S
2018-04-03 11:17:40,13545.0,2,11378,0,13540.0,5,13545.0,2,S
2018-04-03 11:17:41,13540.0,2,11380,0,13540.0,4,13545.0,2,S
2018-04-03 11:17:46,13545.0,2,11382,0,13540.0,4,13545.0,1,B
2018-04-03 11:17:47,13540.0,2,11384,0,13540.0,3,13545.0,1,S
2018-04-03 11:17:57,13545.0,4,11388,2,13540.0,16,13545.0,3,B
2018-04-03 11:17:58,13545.0,6,11394,0,13545.0,2,13550.0,5,B
2018-04-03 11:18:05,13545.0,4,11398,-4,13540.0,16,13550.0,4,B
2018-04-03 11:18:08,13545.0,2,11400,0,13540.0,13,13545.0,1,B
2018-04-03 11:18:11,13540.0,4,11404,0,13540.0,13,13550.0,5,S
2018-04-03 11:18:19,13550.0,2,11406,2,13545.0,4,13555.0,15,B
2018-04-03 11:18:33,13550.0,4,11410,-2,13550.0,1,13555.0,9,B
2018-04-03 11:18:40,13555.0,4,11414,4,13550.0,1,13555.0,7,B
2018-04-03 11:18:41,13555.0,2,11416,0,13550.0,1,13555.0,6,B
2018-04-03 11:18:43,13555.0,2,11418,2,13550.0,1,13555.0,5,B
2018-04-03 11:18:46,13555.0,6,11424,6,13550.0,1,13555.0,2,B
2018-04-03 11:18:46,13555.0,4,11428,0,13550.0,4,13560.0,6,B
2018-04-03 11:19:32,13560.0,2,11430,0,13555.0,5,13565.0,5,B
2018-04-03 11:20:05,13560.0,6,11436,-2,13555.0,4,13565.0,1,B
2018-04-03 11:20:10,13555.0,2,11438,-2,13550.0,5,13560.0,5,S
2018-04-03 11:20:35,13550.0,2,11440,2,13550.0,2,13555.0,5,S
2018-04-03 11:20:35,13550.0,4,11444,2,13545.0,5,13555.0,5,S
2018-04-03 11:21:13,13555.0,2,11446,0,13550.0,3,13555.0,2,B
2018-04-03 11:21:17,13550.0,10,11456,-4,13550.0,2,13555.0,2,S
2018-04-03 11:22:02,13555.0,2,11458,0,13550.0,4,13560.0,7,B
2018-04-03 11:22:22,13560.0,4,11462,2,13555.0,9,13560.0,1,B
2018-04-03 11:22:23,13560.0,4,11466,-2,13560.0,4,13565.0,7,B
2018-04-03 11:22:23,13565.0,2,11468,0,13555.0,4,13565.0,6,B
2018-04-03 11:22:27,13555.0,6,11474,-6,13555.0,1,13565.0,10,S
2018-04-03 11:23:16,13560.0,2,11476,0,13550.0,5,13560.0,3,B
2018-04-03 11:23:28,13560.0,2,11478,-2,13555.0,1,13565.0,8,B
2018-04-03 11:23:28,13565.0,2,11480,0,13560.0,1,13565.0,6,B
2018-04-03 11:23:29,13560.0,2,11482,-2,13555.0,2,13565.0,6,S
2018-04-03 11:24:07,13565.0,4,11486,0,13560.0,1,13570.0,30,B
2018-04-03 11:24:08,13565.0,4,11490,-4,13560.0,4,13570.0,25,B
2018-04-03 11:24:09,13570.0,4,11494,4,13560.0,5,13565.0,4,B
2018-04-03 11:24:09,13565.0,8,11502,-8,13560.0,5,13570.0,23,S
2018-04-03 11:24:23,13565.0,10,11512,0,13560.0,5,13570.0,23,S
2018-04-03 11:24:30,13570.0,20,11532,10,13565.0,1,13570.0,21,B
2018-04-03 11:24:31,13570.0,18,11550,18,13565.0,1,13570.0,11,B
2018-04-03 11:24:45,13565.0,4,11554,0,13560.0,6,13565.0,2,S
2018-04-03 11:24:46,13565.0,4,11558,0,13560.0,6,13570.0,8,S
2018-04-03 11:24:51,13570.0,6,11564,6,13560.0,18,13570.0,5,B
2018-04-03 11:25:01,13565.0,2,11566,0,13565.0,3,13570.0,4,S
2018-04-03 11:25:02,13570.0,8,11574,0,13570.0,1,13575.0,8,B
2018-04-03 11:25:02,13570.0,2,11576,-2,13565.0,3,13575.0,10,B
2018-04-03 11:25:33,13575.0,2,11578,2,13570.0,2,13575.0,12,B
2018-04-03 11:25:40,13575.0,4,11582,4,13570.0,5,13575.0,11,B
2018-04-03 11:25:47,13575.0,8,11590,6,13570.0,5,13575.0,7,B
2018-04-03 11:25:47,13575.0,14,11604,-4,13575.0,1,13580.0,8,B
2018-04-03 11:25:51,13575.0,2,11606,0,13570.0,6,13580.0,6,B
2018-04-03 11:26:05,13575.0,2,11608,0,13570.0,4,13580.0,6,B
2018-04-03 11:26:06,13575.0,10,11618,10,13570.0,4,13575.0,1,B
2018-04-03 11:26:56,13580.0,2,11620,2,13575.0,3,13580.0,2,B
2018-04-03 11:27:04,13580.0,4,11624,4,13580.0,48,13585.0,7,B
2018-04-03 11:27:16,13585.0,4,11628,-2,13580.0,48,13590.0,7,B
2018-04-03 11:27:17,13580.0,2,11630,2,13580.0,47,13585.0,5,S
2018-04-03 11:27:19,13580.0,10,11640,10,13580.0,42,13590.0,6,S
2018-04-03 11:27:23,13585.0,2,11642,-2,13580.0,44,13590.0,6,B
2018-04-03 11:27:37,13580.0,4,11646,4,13580.0,42,13585.0,5,S
2018-04-03 11:27:46,13585.0,2,11648,0,13580.0,41,13585.0,4,B
2018-04-03 11:27:46,13580.0,6,11654,6,13580.0,38,13585.0,4,S
2018-04-03 11:27:57,13580.0,4,11658,4,13580.0,37,13585.0,7,S
2018-04-03 11:27:58,13585.0,18,11676,6,13580.0,28,13585.0,10,B
2018-04-03 11:27:59,13580.0,4,11680,2,13580.0,26,13585.0,10,S
2018-04-03 11:27:59,13580.0,12,11692,0,13580.0,20,13585.0,10,S
2018-04-03 11:28:00,13580.0,22,11714,20,13580.0,9,13585.0,6,S
2018-04-03 11:28:00,13580.0,18,11732,10,13575.0,1,13585.0,6,S
2018-04-03 11:28:10,13580.0,4,11736,4,13580.0,1,13585.0,6,S
2018-04-03 11:28:11,13580.0,2,11738,0,13575.0,2,13585.0,9,S
2018-04-03 11:28:11,13575.0,2,11740,0,13575.0,1,13580.0,6,S
2018-04-03 11:28:12,13575.0,2,11742,0,13570.0,2,13575.0,1,S
2018-04-03 11:28:14,13580.0,14,11756,12,13580.0,93,13585.0,9,B
2018-04-03 11:28:14,13580.0,2,11758,0,13580.0,92,13585.0,9,B
2018-04-03 11:28:20,13580.0,32,11790,22,13580.0,76,13585.0,6,B
2018-04-03 11:28:21,13580.0,4,11794,4,13580.0,74,13585.0,3,B
2018-04-03 11:28:28,13580.0,8,11802,0,13580.0,70,13585.0,5,B
2018-04-03 11:28:29,13580.0,4,11806,4,13580.0,68,13585.0,5,B
2018-04-03 11:28:29,13580.0,2,11808,0,13580.0,67,13585.0,5,B
2018-04-03 11:28:30,13580.0,28,11836,28,13580.0,53,13585.0,16,B
2018-04-03 11:28:31,13580.0,8,11844,8,13580.0,49,13585.0,29,B
2018-04-03 11:28:31,13580.0,4,11848,0,13580.0,47,13585.0,17,B
2018-04-03 11:28:33,13580.0,4,11852,0,13580.0,45,13585.0,17,B
2018-04-03 11:28:38,13580.0,2,11854,0,13580.0,44,13585.0,3,B
2018-04-03 11:28:38,13585.0,6,11860,2,13580.0,44,13590.0,25,B
2018-04-03 11:28:39,13580.0,2,11862,2,13580.0,44,13590.0,21,S
2018-04-03 11:28:40,13580.0,40,11902,40,13580.0,24,13590.0,21,S
2018-04-03 11:28:45,13580.0,2,11904,0,13580.0,23,13585.0,1,S
2018-04-03 11:29:00,13585.0,8,11912,-4,13580.0,23,13590.0,8,B
2018-04-03 11:29:05,13585.0,2,11914,0,13580.0,23,13590.0,9,B
2018-04-03 11:29:22,13590.0,4,11918,-2,13580.0,25,13590.0,7,B
2018-04-03 11:29:30,13590.0,2,11920,-2,13580.0,25,13590.0,6,B
2018-04-03 11:29:58,13580.0,6,11926,6,13580.0,20,13590.0,6,S
2018-04-03 11:29:59,13580.0,10,11936,10,13580.0,14,13590.0,5,S
2018-04-03 13:30:01,13580.0,22,11958,2,13580.0,3,13590.0,7,S
2018-04-03 13:30:01,13580.0,6,11964,0,13575.0,1,13580.0,2,S
2018-04-03 13:30:02,13580.0,8,11972,-2,13560.0,11,13575.0,3,S
2018-04-03 13:30:03,13575.0,6,11978,0,13570.0,5,13580.0,2,S
2018-04-03 13:30:09,13570.0,2,11980,-2,13570.0,3,13580.0,3,S
2018-04-03 13:30:12,13570.0,6,11986,2,13565.0,1,13580.0,3,S
2018-04-03 13:30:14,13560.0,6,11992,0,13560.0,10,13575.0,1,S
2018-04-03 13:30:15,13565.0,2,11994,0,13565.0,4,13570.0,2,B
2018-04-03 13:30:16,13560.0,10,12004,4,13560.0,7,13570.0,2,S
2018-04-03 13:30:22,13555.0,16,12020,0,13550.0,3,13565.0,2,S
2018-04-03 13:30:25,13540.0,28,12048,4,13535.0,33,13560.0,6,S
2018-04-03 13:30:30,13550.0,2,12050,-2,13545.0,6,13555.0,3,B
2018-04-03 13:30:32,13550.0,2,12052,0,13545.0,109,13555.0,3,B
2018-04-03 13:30:33,13555.0,6,12058,-2,13545.0,109,13560.0,4,B
2018-04-03 13:30:37,13550.0,6,12064,6,13550.0,1,13565.0,9,S
2018-04-03 13:30:44,13545.0,12,12076,10,13545.0,109,13560.0,9,S
2018-04-03 13:30:45,13545.0,4,12080,0,13545.0,107,13555.0,1,S
2018-04-03 13:30:48,13545.0,20,12100,14,13545.0,96,13555.0,2,S
2018-04-03 13:30:50,13545.0,90,12190,90,13545.0,51,13555.0,7,S
2018-04-03 13:30:54,13545.0,16,12206,16,13545.0,43,13555.0,5,S
2018-04-03 13:30:56,13550.0,2,12208,-2,13550.0,1,13555.0,4,B
2018-04-03 13:30:57,13550.0,2,12210,-2,13545.0,43,13555.0,6,B
2018-04-03 13:31:05,13545.0,84,12294,84,13540.0,4,13555.0,7,S
2018-04-03 13:31:07,13550.0,8,12302,-8,13545.0,1,13555.0,3,B
2018-04-03 13:31:18,13545.0,8,12310,4,13545.0,1,13555.0,2,S
2018-04-03 13:31:20,13545.0,2,12312,2,13545.0,1,13555.0,2,S
2018-04-03 13:31:21,13545.0,2,12314,2,13540.0,23,13555.0,3,S
2018-04-03 13:31:27,13545.0,2,12316,0,13545.0,6,13555.0,4,S
2018-04-03 13:31:34,13550.0,2,12318,-2,13540.0,20,13550.0,1,B
2018-04-03 13:31:35,13550.0,2,12320,0,13540.0,21,13555.0,6,B
2018-04-03 13:31:36,13545.0,6,12326,6,13540.0,21,13545.0,1,S
2018-04-03 13:31:37,13545.0,2,12328,2,13545.0,1,13555.0,7,S
2018-04-03 13:31:39,13545.0,4,12332,2,13540.0,9,13545.0,2,S
2018-04-03 13:31:39,13545.0,4,12336,4,13545.0,2,13550.0,1,S
2018-04-03 13:31:42,13545.0,2,12338,2,13545.0,1,13550.0,4,S
2018-04-03 13:31:42,13545.0,2,12340,2,13540.0,7,13550.0,4,S
2018-04-03 13:31:43,13540.0,8,12348,2,13535.0,33,13540.0,6,S
2018-04-03 13:31:44,13540.0,18,12366,6,13535.0,35,13540.0,2,S
2018-04-03 13:31:44,13540.0,4,12370,0,13540.0,3,13550.0,4,S
2018-04-03 13:31:48,13540.0,2,12372,0,13535.0,35,13540.0,1,S
2018-04-03 13:31:49,13540.0,2,12374,0,13535.0,34,13545.0,1,S
2018-04-03 13:31:54,13545.0,2,12376,-2,13535.0,37,13550.0,5,B
2018-04-03 13:32:03,13540.0,2,12378,2,13540.0,20,13550.0,15,S
2018-04-03 13:32:06,13550.0,4,12382,-4,13540.0,20,13550.0,14,B
2018-04-03 13:32:07,13540.0,40,12422,20,13540.0,1,13550.0,14,S
2018-04-03 13:32:08,13540.0,6,12428,0,13540.0,6,13550.0,10,S
2018-04-03 13:32:09,13540.0,2,12430,0,13540.0,6,13550.0,10,S
2018-04-03 13:32:17,13545.0,2,12432,0,13545.0,2,13550.0,11,B
2018-04-03 13:32:17,13545.0,2,12434,0,13545.0,6,13550.0,11,B
2018-04-03 13:32:24,13550.0,2,12436,0,13545.0,12,13550.0,9,B
2018-04-03 13:32:25,13550.0,2,12438,2,13545.0,12,13550.0,8,B
2018-04-03 13:32:51,13545.0,4,12442,0,13545.0,5,13550.0,12,S
2018-04-03 13:32:59,13545.0,2,12444,0,13540.0,7,13545.0,3,S
2018-04-03 13:33:00,13550.0,2,12446,0,13540.0,7,13550.0,11,B
2018-04-03 13:33:01,13550.0,2,12448,-2,13540.0,7,13550.0,11,B
2018-04-03 13:33:18,13545.0,4,12452,4,13540.0,6,13550.0,10,S
2018-04-03 13:33:28,13540.0,4,12456,0,13540.0,6,13550.0,12,S
2018-04-03 13:33:36,13540.0,2,12458,2,13540.0,5,13550.0,12,S
2018-04-03 13:33:45,13545.0,2,12460,-2,13540.0,15,13550.0,12,B
2018-04-03 13:33:55,13545.0,4,12464,0,13545.0,1,13550.0,10,B
2018-04-03 13:34:09,13550.0,18,12482,4,13550.0,1,13555.0,4,B
2018-04-03 13:34:18,13550.0,2,12484,0,13550.0,4,13555.0,4,B
2018-04-03 13:34:22,13555.0,10,12494,-6,13545.0,3,13555.0,1,B
2018-04-03 13:34:22,13550.0,6,12500,0,13550.0,3,13560.0,4,S
2018-04-03 13:34:23,13555.0,2,12502,0,13550.0,3,13555.0,3,B
2018-04-03 13:34:32,13545.0,4,12506,2,13545.0,2,13555.0,5,S
2018-04-03 13:34:39,13540.0,4,12510,4,13540.0,8,13550.0,9,S
2018-04-03 13:34:41,13540.0,14,12524,14,13540.0,1,13545.0,2,S
2018-04-03 13:34:41,13540.0,2,12526,2,13535.0,36,13545.0,2,S
2018-04-03 13:34:44,13535.0,36,12562,-2,13535.0,15,13540.0,4,S
2018-04-03 13:34:45,13535.0,8,12570,-4,13535.0,11,13540.0,3,S
2018-04-03 13:34:45,13535.0,22,12592,-8,13530.0,6,13535.0,4,S
2018-04-03 13:34:46,13535.0,4,12596,2,13530.0,5,13535.0,2,S
2018-04-03 13:34:46,13535.0,4,12600,-2,13535.0,1,13540.0,7,S
2018-04-03 13:34:58,13535.0,2,12602,0,13535.0,49,13540.0,2,S
2018-04-03 13:34:59,13540.0,4,12606,0,13540.0,4,13545.0,5,B
2018-04-03 13:34:59,13540.0,8,12614,0,13535.0,49,13545.0,5,B
2018-04-03 13:35:06,13540.0,2,12616,0,13540.0,2,13545.0,3,B
2018-04-03 13:35:09,13540.0,6,12622,6,13535.0,50,13545.0,7,B
2018-04-03 13:35:14,13540.0,2,12624,2,13540.0,1,13545.0,6,B
2018-04-03 13:35:15,13540.0,2,12626,2,13535.0,53,13545.0,7,B
2018-04-03 13:35:20,13535.0,4,12630,-4,13535.0,51,13545.0,7,S
2018-04-03 13:35:22,13535.0,92,12722,0,13535.0,5,13545.0,7,S
2018-04-03 13:35:25,13530.0,26,12748,14,13525.0,9,13530.0,37,S
2018-04-03 13:35:25,13530.0,74,12822,36,13530.0,3,13540.0,1,S
2018-04-03 13:35:26,13530.0,2,12824,0,13530.0,6,13540.0,1,S
2018-04-03 13:35:37,13535.0,10,12834,10,13530.0,6,13540.0,1,B
2018-04-03 13:35:47,13530.0,14,12848,-2,13525.0,12,13530.0,43,S
2018-04-03 13:35:48,13530.0,6,12854,-2,13525.0,12,13530.0,40,S
2018-04-03 13:35:51,13530.0,2,12856,0,13525.0,11,13530.0,39,S
2018-04-03 13:35:54,13530.0,14,12870,-14,13525.0,11,13530.0,32,S
2018-04-03 13:36:07,13530.0,2,12872,-2,13525.0,16,13530.0,31,S
2018-04-03 13:36:17,13530.0,2,12874,0,13525.0,16,13530.0,31,S
2018-04-03 13:36:26,13525.0,10,12884,0,13525.0,13,13530.0,31,S
2018-04-03 13:36:27,13525.0,6,12890,-6,13525.0,10,13530.0,31,S
2018-04-03 13:36:27,13525.0,4,12894,4,13525.0,8,13530.0,31,S
2018-04-03 13:36:40,13530.0,4,12898,0,13525.0,17,13530.0,29,B
2018-04-03 13:36:46,13530.0,4,12902,-4,13525.0,18,13530.0,27,B
2018-04-03 13:36:55,13525.0,2,12904,0,13525.0,16,13530.0,30,S
2018-04-03 13:36:56,13525.0,8,12912,-4,13525.0,10,13530.0,30,S
2018-04-03 13:36:58,13525.0,2,12914,0,13525.0,6,13530.0,30,S
2018-04-03 13:36:59,13525.0,10,12924,-10,13525.0,1,13530.0,30,S
2018-04-03 13:36:59,13525.0,2,12926,0,13520.0,6,13530.0,30,S
2018-04-03 13:37:02,13520.0,10,12936,4,13520.0,4,13530.0,30,S
2018-04-03 13:37:20,13520.0,12,12948,-4,13515.0,7,13520.0,1,S
2018-04-03 13:37:20,13510.0,26,12974,22,13510.0,4,13520.0,3,S
2018-04-03 13:37:21,13520.0,6,12980,6,13510.0,4,13520.0,5,B
2018-04-03 13:37:21,13510.0,8,12988,8,13505.0,4,13515.0,2,S
2018-04-03 13:37:22,13510.0,6,12994,6,13505.0,4,13515.0,2,S
2018-04-03 13:37:23,13505.0,6,13000,4,13505.0,1,13515.0,4,S
2018-04-03 13:37:26,13515.0,2,13002,0,13510.0,1,13515.0,1,B
2018-04-03 13:37:26,13515.0,2,13004,0,13510.0,1,13520.0,3,B
2018-04-03 13:37:28,13510.0,2,13006,2,13505.0,17,13520.0,6,S
2018-04-03 13:37:30,13510.0,10,13016,2,13510.0,2,13520.0,6,S
2018-04-03 13:37:31,13510.0,4,13020,4,13505.0,16,13520.0,7,S
2018-04-03 13:37:33,13510.0,4,13024,4,13510.0,1,13520.0,7,S
2018-04-03 13:37:41,13515.0,2,13026,-2,13510.0,3,13515.0,2,B
2018-04-03 13:37:41,13515.0,2,13028,0,13515.0,5,13520.0,5,B
2018-04-03 13:37:44,13515.0,6,13034,0,13515.0,2,13520.0,8,B
2018-04-03 13:37:45,13515.0,4,13038,0,13510.0,1,13520.0,9,B
2018-04-03 13:38:02,13510.0,8,13046,0,13505.0,17,13520.0,42,S
2018-04-03 13:38:03,13510.0,2,13048,2,13505.0,17,13515.0,4,S
2018-04-03 13:38:13,13505.0,8,13056,2,13500.0,37,13515.0,7,S
2018-04-03 13:38:19,13505.0,2,13058,0,13505.0,3,13515.0,4,S
2018-04-03 13:38:20,13515.0,10,13068,-8,13505.0,3,13520.0,42,B
2018-04-03 13:38:22,13505.0,8,13076,6,13505.0,2,13515.0,6,S
2018-04-03 13:38:23,13505.0,4,13080,0,13505.0,8,13515.0,6,S
2018-04-03 13:38:23,13505.0,4,13084,4,13505.0,6,13515.0,6,S
2018-04-03 13:38:24,13515.0,4,13088,2,13505.0,6,13515.0,4,B
2018-04-03 13:38:25,13505.0,8,13096,0,13505.0,2,13515.0,4,S
2018-04-03 13:38:29,13505.0,6,13102,4,13505.0,1,13515.0,4,S
2018-04-03 13:38:33,13505.0,2,13104,0,13500.0,48,13515.0,4,S
2018-04-03 13:38:35,13500.0,8,13112,6,13500.0,46,13515.0,5,S
2018-04-03 13:38:35,13515.0,10,13122,-2,13505.0,5,13515.0,1,B
2018-04-03 13:38:36,13505.0,10,13132,10,13500.0,47,13515.0,1,S
2018-04-03 13:38:40,13505.0,10,13142,0,13505.0,1,13515.0,1,S
2018-04-03 13:38:42,13505.0,2,13144,0,13500.0,47,13510.0,2,S
2018-04-03 13:38:42,13510.0,4,13148,0,13510.0,4,13515.0,18,B
2018-04-03 13:38:43,13505.0,8,13156,6,13500.0,46,13515.0,19,S
2018-04-03 13:38:45,13510.0,2,13158,-2,13505.0,1,13510.0,3,B
2018-04-03 13:38:51,13510.0,2,13160,0,13505.0,2,13515.0,20,B
2018-04-03 13:38:53,13505.0,4,13164,2,13505.0,1,13515.0,20,S
2018-04-03 13:39:00,13515.0,4,13168,-2,13505.0,5,13515.0,18,B
2018-04-03 13:39:09,13505.0,18,13186,14,13500.0,57,13505.0,5,S
2018-04-03 13:39:10,13510.0,14,13200,10,13505.0,5,13515.0,18,B
2018-04-03 13:39:11,13510.0,2,13202,-2,13505.0,2,13515.0,18,B
2018-04-03 13:39:15,13505.0,2,13204,0,13500.0,41,13510.0,7,S
2018-04-03 13:39:17,13505.0,2,13206,2,13505.0,1,13510.0,8,S
2018-04-03 13:39:18,13505.0,2,13208,0,13500.0,40,13510.0,8,S
2018-04-03 13:39:21,13505.0,4,13212,4,13500.0,41,13510.0,8,S
2018-04-03 13:39:24,13510.0,2,13214,0,13505.0,2,13510.0,4,B
2018-04-03 13:39:25,13510.0,2,13216,2,13505.0,2,13510.0,3,B
2018-04-03 13:39:30,13510.0,6,13222,0,13505.0,5,13515.0,21,B
2018-04-03 13:39:31,13510.0,6,13228,0,13505.0,4,13515.0,21,B
2018-04-03 13:39:33,13510.0,4,13232,0,13510.0,2,13515.0,19,B
2018-04-03 13:39:36,13515.0,2,13234,2,13510.0,3,13515.0,23,B
2018-04-03 13:39:39,13510.0,6,13240,0,13505.0,15,13515.0,22,S
2018-04-03 13:39:45,13510.0,2,13242,2,13505.0,23,13510.0,4,S
2018-04-03 13:39:48,13510.0,2,13244,2,13505.0,24,13510.0,3,S
2018-04-03 13:39:49,13510.0,4,13248,4,13505.0,24,13510.0,1,S
2018-04-03 13:39:50,13510.0,2,13250,2,13505.0,24,13515.0,22,S
2018-04-03 13:40:01,13505.0,12,13262,10,13505.0,18,13515.0,24,S
2018-04-03 13:40:02,13510.0,2,13264,-2,13505.0,18,13515.0,23,B
2018-04-03 13:40:08,13510.0,2,13266,-2,13505.0,18,13510.0,2,B
2018-04-03 13:40:09,13510.0,2,13268,2,13505.0,18,13510.0,1,B
2018-04-03 13:40:19,13510.0,2,13270,0,13505.0,13,13510.0,14,B
2018-04-03 13:40:25,13510.0,2,13272,0,13505.0,13,13510.0,13,B
2018-04-03 13:40:25,13510.0,22,13294,16,13505.0,27,13510.0,2,B
2018-04-03 13:40:26,13510.0,4,13298,4,13510.0,1,13515.0,6,B
2018-04-03 13:40:28,13510.0,2,13300,-2,13510.0,2,13515.0,6,B
2018-04-03 13:40:33,13510.0,4,13304,2,13505.0,27,13510.0,3,B
2018-04-03 13:40:33,13510.0,6,13310,6,13510.0,1,13515.0,1,B
2018-04-03 13:40:36,13515.0,2,13312,-2,13510.0,2,13520.0,11,B
2018-04-03 13:40:44,13515.0,2,13314,-2,13510.0,5,13520.0,8,B
2018-04-03 13:41:06,13520.0,2,13316,0,13515.0,2,13520.0,2,B
2018-04-03 13:41:07,13520.0,4,13320,0,13515.0,2,13525.0,8,B
2018-04-03 13:41:26,13520.0,2,13322,0,13520.0,2,13525.0,2,B
2018-04-03 13:41:28,13520.0,4,13326,-2,13515.0,14,13525.0,2,B
2018-04-03 13:41:29,13520.0,2,13328,-2,13520.0,1,13525.0,4,B
2018-04-03 13:41:31,13520.0,4,13332,-2,13515.0,2,13520.0,1,B
2018-04-03 13:41:41,13520.0,2,13334,2,13520.0,1,13525.0,8,B
2018-04-03 13:41:57,13525.0,2,13336,0,13515.0,5,13525.0,7,B
2018-04-03 13:42:03,13525.0,2,13338,0,13515.0,6,13525.0,8,B
2018-04-03 13:42:40,13520.0,4,13342,2,13515.0,27,13525.0,3,S
2018-04-03 13:42:42,13510.0,32,13374,24,13510.0,17,13525.0,7,S
2018-04-03 13:42:43,13520.0,6,13380,2,13515.0,2,13525.0,7,B
2018-04-03 13:42:59,13520.0,2,13382,-2,13515.0,1,13525.0,9,B
2018-04-03 13:43:09,13520.0,2,13384,2,13515.0,2,13525.0,9,B
2018-04-03 13:43:18,13515.0,4,13388,-4,13510.0,18,13520.0,2,S
2018-04-03 13:43:31,13520.0,2,13390,2,13520.0,1,13525.0,8,B
2018-04-03 13:43:31,13520.0,2,13392,0,13510.0,19,13525.0,8,B
2018-04-03 13:44:21,13520.0,2,13394,0,13515.0,5,13520.0,1,B
2018-04-03 13:44:24,13520.0,2,13396,-2,13515.0,6,13525.0,10,B
2018-04-03 13:44:30,13520.0,2,13398,2,13520.0,1,13525.0,9,B
2018-04-03 13:44:36,13520.0,2,13400,0,13520.0,2,13525.0,3,B
2018-04-03 13:44:45,13520.0,2,13402,-2,13515.0,6,13525.0,6,B
2018-04-03 13:44:46,13520.0,2,13404,-2,13515.0,7,13525.0,6,B
2018-04-03 13:45:02,13520.0,2,13406,0,13515.0,16,13525.0,5,B
2018-04-03 13:45:42,13525.0,2,13408,2,13520.0,2,13525.0,6,B
2018-04-03 13:45:50,13520.0,4,13412,2,13515.0,16,13525.0,16,S
2018-04-03 13:46:08,13515.0,2,13414,-2,13515.0,12,13520.0,1,S
2018-04-03 13:46:13,13520.0,2,13416,-2,13520.0,9,13525.0,18,B
2018-04-03 13:46:33,13525.0,2,13418,0,13520.0,10,13525.0,6,B
2018-04-03 13:46:39,13525.0,2,13420,-2,13520.0,10,13525.0,3,B
2018-04-03 13:46:40,13525.0,6,13426,0,13520.0,16,13530.0,32,B
2018-04-03 13:46:47,13530.0,40,13466,-20,13525.0,5,13530.0,8,B
2018-04-03 13:46:48,13530.0,16,13482,0,13525.0,7,13535.0,2,B
2018-04-03 13:47:37,13540.0,2,13484,2,13535.0,1,13540.0,4,B
2018-04-03 13:47:47,13535.0,2,13486,0,13530.0,6,13540.0,12,S
2018-04-03 13:48:10,13540.0,6,13492,6,13535.0,1,13540.0,10,B
2018-04-03 13:48:13,13540.0,4,13496,4,13535.0,1,13540.0,8,B
2018-04-03 13:48:28,13535.0,2,13498,-2,13530.0,11,13535.0,4,S
2018-04-03 13:48:29,13530.0,2,13500,0,13530.0,5,13535.0,4,S
2018-04-03 13:48:30,13530.0,10,13510,2,13525.0,3,13530.0,4,S
2018-04-03 13:49:12,13525.0,2,13512,-2,13520.0,33,13530.0,15,S
2018-04-03 13:50:45,13530.0,2,13514,-2,13525.0,2,13530.0,5,B
2018-04-03 13:50:56,13530.0,2,13516,-2,13525.0,2,13530.0,3,B
2018-04-03 13:51:14,13525.0,4,13520,-4,13520.0,63,13530.0,8,S
2018-04-03 13:52:19,13530.0,14,13534,2,13520.0,79,13535.0,3,B
2018-04-03 13:52:39,13535.0,2,13536,2,13525.0,8,13535.0,2,B
2018-04-03 13:52:47,13530.0,4,13540,0,13530.0,1,13540.0,16,S
2018-04-03 13:53:28,13535.0,2,13542,0,13530.0,16,13540.0,10,B
2018-04-03 13:53:48,13530.0,2,13544,-2,13525.0,2,13535.0,4,S
2018-04-03 13:54:37,13525.0,4,13548,0,13520.0,63,13525.0,3,S
2018-04-03 13:54:38,13530.0,8,13556,-2,13520.0,64,13530.0,2,B
2018-04-03 13:54:52,13530.0,4,13560,2,13530.0,8,13535.0,6,B
2018-04-03 13:54:52,13530.0,6,13566,2,13530.0,5,13535.0,6,B
2018-04-03 13:55:37,13535.0,2,13568,0,13530.0,11,13540.0,15,B
2018-04-03 13:56:08,13530.0,6,13574,2,13530.0,8,13535.0,17,S
2018-04-03 13:56:09,13530.0,14,13588,6,13525.0,4,13535.0,17,S
2018-04-03 13:56:11,13530.0,2,13590,-2,13525.0,2,13535.0,19,S
2018-04-03 13:56:11,13525.0,2,13592,0,13525.0,1,13535.0,19,S
2018-04-03 13:56:28,13525.0,2,13594,2,13520.0,64,13525.0,4,S
2018-04-03 13:56:29,13525.0,4,13598,-2,13520.0,61,13525.0,2,S
2018-04-03 13:56:55,13525.0,10,13608,0,13525.0,5,13530.0,14,S
2018-04-03 13:57:36,13530.0,2,13610,0,13525.0,7,13535.0,16,B
2018-04-03 13:59:20,13525.0,10,13620,10,13525.0,8,13535.0,3,S
2018-04-03 14:00:03,13525.0,2,13622,2,13525.0,10,13530.0,3,S
2018-04-03 14:00:06,13525.0,14,13636,2,13525.0,3,13530.0,18,S
2018-04-03 14:00:06,13525.0,2,13638,0,13525.0,2,13530.0,19,S
2018-04-03 14:00:07,13525.0,4,13642,0,13520.0,63,13525.0,1,S
2018-04-03 14:00:21,13520.0,40,13682,-10,13520.0,38,13525.0,10,S
2018-04-03 14:00:22,13520.0,22,13704,-12,13520.0,27,13525.0,20,S
2018-04-03 14:00:22,13520.0,2,13706,0,13520.0,26,13525.0,21,S
2018-04-03 14:00:23,13520.0,2,13708,-2,13520.0,25,13525.0,9,S
2018-04-03 14:00:35,13525.0,10,13718,0,13520.0,25,13525.0,4,B
2018-04-03 14:00:36,13525.0,4,13722,2,13525.0,1,13530.0,3,B
2018-04-03 14:00:36,13525.0,2,13724,0,13525.0,1,13530.0,8,B
2018-04-03 14:01:02,13520.0,2,13726,0,13520.0,27,13530.0,3,S
2018-04-03 14:01:33,13525.0,2,13728,-2,13520.0,25,13530.0,8,B
2018-04-03 14:01:35,13525.0,2,13730,-2,13520.0,25,13530.0,10,B
2018-04-03 14:01:53,13520.0,2,13732,-2,13520.0,74,13525.0,3,S
2018-04-03 14:02:02,13520.0,4,13736,-4,13520.0,72,13525.0,7,S
2018-04-03 14:02:03,13520.0,8,13744,-8,13520.0,68,13525.0,6,S
2018-04-03 14:02:09,13520.0,4,13748,-4,13520.0,66,13525.0,6,S
2018-04-03 14:02:10,13520.0,2,13750,0,13520.0,65,13525.0,6,S
2018-04-03 14:02:21,13525.0,10,13760,10,13525.0,4,13530.0,5,B
2018-04-03 14:02:53,13530.0,18,13778,0,13525.0,8,13530.0,3,B
2018-04-03 14:02:54,13535.0,8,13786,4,13530.0,4,13535.0,6,B
2018-04-03 14:02:55,13530.0,4,13790,-2,13530.0,2,13535.0,6,S
2018-04-03 14:02:58,13530.0,4,13794,2,13525.0,2,13535.0,8,S
2018-04-03 14:03:07,13530.0,2,13796,0,13525.0,3,13535.0,10,S
2018-04-03 14:03:17,13525.0,8,13804,2,13520.0,44,13525.0,16,S
2018-04-03 14:03:17,13525.0,32,13836,18,13520.0,44,13535.0,10,S
2018-04-03 14:03:22,13530.0,2,13838,0,13525.0,14,13535.0,8,B
2018-04-03 14:03:38,13535.0,4,13842,4,13535.0,1,13540.0,22,B
2018-04-03 14:03:39,13535.0,2,13844,0,13530.0,1,13535.0,2,B
2018-04-03 14:03:43,13540.0,2,13846,2,13530.0,3,13540.0,18,B
2018-04-03 14:03:57,13540.0,2,13848,0,13530.0,7,13540.0,13,B
2018-04-03 14:03:58,13540.0,20,13868,-8,13530.0,7,13540.0,3,B
2018-04-03 14:04:05,13535.0,2,13870,-2,13535.0,2,13540.0,9,S
2018-04-03 14:04:41,13540.0,2,13872,2,13535.0,11,13540.0,6,B
2018-04-03 14:04:43,13540.0,4,13876,4,13535.0,11,13540.0,3,B
2018-04-03 14:04:54,13535.0,6,13882,4,13535.0,8,13540.0,3,S
2018-04-03 14:05:02,13535.0,16,13898,16,13530.0,12,13535.0,2,S
2018-04-03 14:05:03,13535.0,4,13902,4,13530.0,10,13540.0,11,S
2018-04-03 14:05:08,13530.0,2,13904,-2,13530.0,9,13540.0,11,S
2018-04-03 14:05:14,13530.0,2,13906,0,13530.0,6,13535.0,4,S
2018-04-03 14:05:32,13535.0,2,13908,-2,13530.0,6,13535.0,2,B
2018-04-03 14:06:00,13535.0,2,13910,0,13530.0,19,13535.0,5,B
2018-04-03 14:06:00,13535.0,10,13920,0,13530.0,19,13540.0,4,B
2018-04-03 14:06:23,13535.0,4,13924,-4,13530.0,8,13540.0,11,B
2018-04-03 14:06:25,13530.0,8,13932,-8,13530.0,2,13535.0,8,S
2018-04-03 14:06:25,13530.0,4,13936,0,13525.0,4,13530.0,1,S
2018-04-03 14:07:04,13525.0,4,13940,-4,13520.0,20,13530.0,4,S
2018-04-03 14:07:10,13525.0,4,13944,4,13520.0,36,13525.0,3,S
2018-04-03 14:07:11,13525.0,6,13950,4,13520.0,36,13530.0,2,S
2018-04-03 14:07:21,13530.0,2,13952,2,13525.0,3,13535.0,10,B
2018-04-03 14:07:54,13535.0,2,13954,2,13530.0,2,13535.0,4,B
2018-04-03 14:08:01,13535.0,4,13958,4,13525.0,6,13535.0,3,B
2018-04-03 14:08:11,13525.0,2,13960,0,13525.0,9,13535.0,3,S
2018-04-03 14:08:41,13535.0,2,13962,0,13525.0,8,13535.0,5,B
2018-04-03 14:10:17,13535.0,2,13964,2,13525.0,7,13535.0,6,B
2018-04-03 14:10:21,13530.0,4,13968,-2,13525.0,2,13530.0,3,S
2018-04-03 14:12:06,13525.0,16,13984,-12,13525.0,3,13535.0,3,S
2018-04-03 14:13:42,13535.0,4,13988,-2,13530.0,1,13535.0,2,B
2018-04-03 14:13:42,13535.0,4,13992,-2,13535.0,1,13540.0,12,B
2018-04-03 14:13:43,13535.0,2,13994,0,13530.0,6,13540.0,10,B
2018-04-03 14:14:01,13535.0,2,13996,0,13530.0,7,13540.0,4,B
2018-04-03 14:14:24,13540.0,2,13998,0,13540.0,1,13545.0,5,B
2018-04-03 14:14:25,13540.0,2,14000,2,13540.0,2,13545.0,8,B
2018-04-03 14:14:25,13540.0,4,14004,4,13535.0,7,13545.0,9,B
2018-04-03 14:14:42,13545.0,2,14006,2,13540.0,3,13550.0,26,B
2018-04-03 14:14:45,13540.0,6,14012,-6,13535.0,6,13545.0,3,S
2018-04-03 14:16:05,13535.0,12,14024,8,13530.0,3,13540.0,2,S
2018-04-03 14:16:30,13520.0,4,14028,-4,13520.0,19,13530.0,9,S
2018-04-03 14:17:26,13525.0,2,14030,0,13525.0,8,13535.0,5,B
2018-04-03 14:18:12,13530.0,2,14032,0,13530.0,1,13535.0,3,B
2018-04-03 14:18:13,13530.0,2,14034,0,13525.0,19,13535.0,2,B
2018-04-03 14:18:17,13535.0,2,14036,0,13530.0,2,13535.0,1,B
2018-04-03 14:18:42,13530.0,2,14038,2,13530.0,1,13535.0,1,S
2018-04-03 14:19:00,13535.0,2,14040,-2,13530.0,2,13540.0,20,B
2018-04-03 14:20:06,13530.0,2,14042,2,13530.0,1,13540.0,7,S
2018-04-03 14:20:16,13530.0,2,14044,0,13525.0,16,13535.0,1,S
2018-04-03 14:21:14,13525.0,6,14050,6,13525.0,1,13535.0,1,S
2018-04-03 14:21:19,13525.0,4,14054,4,13520.0,88,13525.0,1,S
2018-04-03 14:21:19,13525.0,2,14056,2,13525.0,10,13535.0,2,S
2018-04-03 14:21:36,13525.0,2,14058,2,13525.0,3,13530.0,3,S
2018-04-03 14:21:51,13530.0,2,14060,0,13525.0,2,13530.0,7,B
2018-04-03 14:21:53,13530.0,2,14062,0,13525.0,2,13530.0,6,B
2018-04-03 14:22:11,13525.0,10,14072,0,13520.0,67,13525.0,4,S
2018-04-03 14:22:11,13525.0,6,14078,-6,13520.0,65,13525.0,1,S
2018-04-03 14:22:18,13520.0,4,14082,-4,13520.0,62,13525.0,1,S
2018-04-03 14:22:22,13520.0,2,14084,-2,13520.0,60,13525.0,7,S
2018-04-03 14:22:29,13520.0,14,14098,-2,13520.0,53,13525.0,13,S
2018-04-03 14:22:33,13520.0,22,14120,-20,13520.0,42,13525.0,17,S
2018-04-03 14:22:34,13520.0,4,14124,0,13520.0,40,13525.0,17,S
2018-04-03 14:22:35,13520.0,2,14126,-2,13520.0,39,13525.0,17,S
2018-04-03 14:22:51,13520.0,10,14136,0,13520.0,34,13525.0,19,S
2018-04-03 14:22:52,13520.0,20,14156,-20,13520.0,24,13525.0,19,S
2018-04-03 14:22:54,13525.0,10,14166,-8,13520.0,24,13525.0,16,B
2018-04-03 14:22:58,13520.0,8,14174,-8,13520.0,20,13525.0,20,S
2018-04-03 14:22:59,13520.0,10,14184,0,13520.0,15,13525.0,20,S
2018-04-03 14:23:01,13520.0,2,14186,-2,13520.0,14,13525.0,20,S
2018-04-03 14:23:14,13520.0,2,14188,0,13520.0,13,13525.0,28,S
2018-04-03 14:23:28,13520.0,2,14190,0,13520.0,24,13525.0,34,S
2018-04-03 14:23:29,13520.0,2,14192,-2,13520.0,21,13525.0,34,S
2018-04-03 14:23:47,13525.0,68,14260,-20,13525.0,16,13530.0,5,B
2018-04-03 14:23:48,13525.0,6,14266,0,13525.0,13,13530.0,3,B
2018-04-03 14:23:57,13525.0,14,14280,-14,13525.0,6,13530.0,7,B
2018-04-03 14:24:04,13525.0,10,14290,0,13525.0,1,13530.0,3,B
2018-04-03 14:24:04,13525.0,2,14292,0,13520.0,22,13525.0,4,B
2018-04-03 14:24:09,13520.0,40,14332,0,13520.0,1,13525.0,4,S
2018-04-03 14:24:23,13520.0,4,14336,2,13515.0,3,13520.0,8,S
2018-04-03 14:24:24,13520.0,8,14344,4,13515.0,6,13520.0,4,S
2018-04-03 14:24:27,13515.0,10,14354,-4,13510.0,16,13515.0,5,S
2018-04-03 14:24:28,13515.0,10,14364,-10,13510.0,16,13520.0,5,S
2018-04-03 14:24:56,13510.0,10,14374,-6,13505.0,20,13510.0,5,S
2018-04-03 14:24:56,13510.0,10,14384,-10,13510.0,1,13520.0,5,S
2018-04-03 14:25:00,13510.0,8,14392,8,13505.0,13,13515.0,1,S
2018-04-03 14:25:05,13510.0,2,14394,0,13505.0,13,13515.0,1,S
2018-04-03 14:25:21,13510.0,6,14400,-4,13510.0,1,13520.0,6,S
2018-04-03 14:25:32,13515.0,2,14402,-2,13510.0,1,13520.0,8,B
2018-04-03 14:25:40,13515.0,8,14410,0,13510.0,2,13515.0,6,B
2018-04-03 14:25:41,13515.0,12,14422,-4,13510.0,5,13520.0,3,B
2018-04-03 14:25:55,13515.0,2,14424,0,13515.0,1,13520.0,1,B
2018-04-03 14:26:02,13520.0,2,14426,0,13515.0,5,13525.0,6,B
2018-04-03 14:26:06,13520.0,4,14430,-4,13515.0,20,13520.0,2,B
2018-04-03 14:26:06,13520.0,4,14434,0,13520.0,6,13525.0,1,B
2018-04-03 14:26:22,13525.0,6,14440,2,13520.0,50,13525.0,2,B
2018-04-03 14:26:24,13520.0,4,14444,-2,13520.0,48,13530.0,16,S
2018-04-03 14:26:32,13525.0,2,14446,0,13520.0,49,13525.0,4,B
2018-04-03 14:27:02,13525.0,2,14448,0,13520.0,49,13525.0,5,B
2018-04-03 14:27:08,13525.0,2,14450,2,13520.0,48,13525.0,4,B
2018-04-03 14:27:08,13525.0,2,14452,2,13520.0,48,13525.0,1,B
2018-04-03 14:27:18,13520.0,2,14454,-2,13520.0,47,13530.0,2,S
2018-04-03 14:28:05,13520.0,8,14462,-8,13520.0,46,13530.0,24,S
2018-04-03 14:28:13,13520.0,2,14464,0,13520.0,44,13525.0,2,S
2018-04-03 14:29:36,13520.0,20,14484,0,13520.0,36,13525.0,17,S
2018-04-03 14:29:54,13520.0,2,14486,-2,13520.0,33,13525.0,19,S
2018-04-03 14:29:55,13520.0,2,14488,0,13520.0,32,13525.0,19,S
2018-04-03 14:29:58,13520.0,8,14496,-8,13520.0,28,13525.0,19,S
2018-04-03 14:30:02,13525.0,2,14498,0,13520.0,28,13525.0,17,B
2018-04-03 14:30:29,13520.0,40,14538,0,13520.0,8,13525.0,19,S
2018-04-03 14:30:34,13525.0,4,14542,4,13520.0,11,13525.0,14,B
2018-04-03 14:30:36,13525.0,4,14546,2,13520.0,25,13525.0,12,B
2018-04-03 14:30:37,13525.0,24,14570,0,13520.0,14,13530.0,25,B
2018-04-03 14:30:47,13530.0,2,14572,0,13525.0,6,13530.0,21,B
2018-04-03 14:30:47,13530.0,2,14574,0,13525.0,6,13530.0,20,B
2018-04-03 14:30:55,13530.0,2,14576,2,13525.0,6,13535.0,16,B
2018-04-03 14:31:03,13535.0,6,14582,-6,13530.0,3,13535.0,8,B
2018-04-03 14:31:06,13535.0,2,14584,0,13530.0,8,13535.0,7,B
2018-04-03 14:31:13,13535.0,10,14594,2,13525.0,4,13535.0,5,B
2018-04-03 14:31:22,13530.0,2,14596,0,13525.0,5,13530.0,1,S
2018-04-03 14:31:42,13530.0,2,14598,0,13525.0,4,13530.0,7,S
2018-04-03 14:32:02,13530.0,2,14600,0,13525.0,4,13530.0,6,S
2018-04-03 14:32:16,13530.0,12,14612,-2,13525.0,7,13535.0,7,S
2018-04-03 14:32:16,13540.0,14,14626,10,13530.0,32,13540.0,2,B
2018-04-03 14:32:21,13540.0,2,14628,2,13535.0,4,13545.0,4,B
2018-04-03 14:32:37,13540.0,2,14630,0,13540.0,2,13545.0,6,B
2018-04-03 14:32:38,13540.0,4,14634,2,13535.0,2,13545.0,6,B
2018-04-03 14:32:40,13540.0,2,14636,0,13535.0,1,13545.0,4,B
2018-04-03 14:32:55,13540.0,2,14638,2,13535.0,4,13540.0,2,B
2018-04-03 14:33:01,13535.0,6,14644,0,13535.0,1,13540.0,3,S
2018-04-03 14:33:01,13535.0,2,14646,-2,13530.0,8,13535.0,2,S
2018-04-03 14:33:10,13535.0,2,14648,-2,13530.0,5,13540.0,3,S
2018-04-03 14:33:11,13530.0,2,14650,0,13530.0,3,13535.0,4,S
2018-04-03 14:33:15,13535.0,4,14654,-2,13535.0,2,13540.0,5,B
2018-04-03 14:33:15,13535.0,4,14658,0,13530.0,3,13540.0,5,B
2018-04-03 14:33:48,13535.0,2,14660,2,13530.0,3,13535.0,1,B
2018-04-03 14:33:50,13535.0,2,14662,0,13530.0,4,13540.0,9,B
2018-04-03 14:35:01,13545.0,2,14664,-2,13535.0,4,13545.0,6,B
2018-04-03 14:35:02,13540.0,2,14666,2,13535.0,4,13545.0,4,S
2018-04-03 14:35:35,13540.0,2,14668,0,13535.0,4,13540.0,2,S
2018-04-03 14:35:44,13540.0,2,14670,-2,13535.0,1,13540.0,1,S
2018-04-03 14:36:46,13540.0,2,14672,0,13535.0,3,13540.0,1,S
2018-04-03 14:36:47,13540.0,2,14674,2,13535.0,3,13545.0,9,S
2018-04-03 14:36:47,13550.0,18,14692,2,13545.0,7,13550.0,22,B
2018-04-03 14:36:48,13550.0,24,14716,22,13545.0,1,13550.0,9,B
2018-04-03 14:36:49,13545.0,6,14722,0,13545.0,1,13550.0,12,S
2018-04-03 14:36:49,13545.0,2,14724,0,13540.0,7,13550.0,10,S
2018-04-03 14:36:51,13550.0,8,14732,8,13545.0,4,13550.0,5,B
2018-04-03 14:36:52,13550.0,10,14742,6,13550.0,5,13555.0,3,B
2018-04-03 14:36:59,13550.0,2,14744,2,13550.0,2,13555.0,1,B
2018-04-03 14:37:00,13555.0,8,14752,0,13550.0,1,13560.0,6,B
2018-04-03 14:37:00,13555.0,2,14754,-2,13550.0,1,13560.0,6,B
2018-04-03 14:37:41,13545.0,4,14758,-2,13540.0,1,13545.0,3,S
2018-04-03 14:37:45,13545.0,2,14760,2,13540.0,2,13550.0,8,S
2018-04-03 14:38:30,13540.0,2,14762,2,13535.0,2,13545.0,4,S
2018-04-03 14:39:29,13535.0,4,14766,0,13535.0,1,13540.0,3,S
2018-04-03 14:39:30,13535.0,2,14768,2,13530.0,8,13540.0,3,S
2018-04-03 14:39:38,13535.0,2,14770,0,13530.0,5,13535.0,2,S
2018-04-03 14:41:20,13535.0,2,14772,0,13530.0,3,13535.0,1,S
2018-04-03 14:41:20,13535.0,2,14774,-2,13535.0,2,13540.0,6,S
2018-04-03 14:41:21,13535.0,4,14778,0,13530.0,6,13540.0,2,S
2018-04-03 14:43:11,13530.0,12,14790,-6,13530.0,12,13540.0,9,S
2018-04-03 14:43:47,13540.0,4,14794,-4,13535.0,2,13545.0,5,B
2018-04-03 14:44:48,13535.0,2,14796,2,13530.0,24,13540.0,7,S
2018-04-03 14:45:35,13535.0,2,14798,0,13530.0,25,13540.0,2,S
2018-04-03 14:46:12,13540.0,2,14800,2,13535.0,3,13540.0,1,B
2018-04-03 14:46:20,13540.0,2,14802,0,13530.0,19,13540.0,3,B
2018-04-03 14:46:26,13535.0,6,14808,-2,13535.0,3,13540.0,3,S
2018-04-03 14:46:26,13535.0,6,14814,0,13530.0,19,13540.0,3,S
2018-04-03 14:46:29,13535.0,2,14816,0,13530.0,18,13540.0,2,S
2018-04-03 14:46:37,13535.0,2,14818,0,13530.0,18,13540.0,2,S
2018-04-03 14:46:48,13535.0,4,14822,0,13530.0,17,13540.0,2,S
2018-04-03 14:47:14,13535.0,2,14824,2,13530.0,17,13540.0,4,S
2018-04-03 14:47:22,13540.0,16,14840,-14,13540.0,4,13545.0,6,B
2018-04-03 14:47:22,13540.0,8,14848,-4,13530.0,5,13540.0,2,B
2018-04-03 14:47:28,13535.0,2,14850,-2,13530.0,5,13540.0,4,S
2018-04-03 14:47:58,13540.0,2,14852,0,13535.0,5,13540.0,1,B
2018-04-03 14:49:02,13540.0,6,14858,4,13535.0,10,13545.0,3,B
2018-04-03 14:49:08,13545.0,2,14860,0,13540.0,4,13550.0,5,B
2018-04-03 14:49:12,13550.0,12,14872,2,13545.0,2,13555.0,4,B
2018-04-03 14:49:15,13550.0,4,14876,-4,13545.0,1,13550.0,2,B
2018-04-03 14:49:26,13545.0,2,14878,-2,13545.0,1,13550.0,4,S
2018-04-03 14:49:50,13550.0,8,14886,0,13545.0,1,13555.0,7,B
2018-04-03 14:50:01,13545.0,2,14888,2,13545.0,1,13555.0,5,S
2018-04-03 14:50:32,13545.0,2,14890,0,13550.0,1,13555.0,2,S
2018-04-03 14:50:32,13550.0,2,14892,0,13545.0,2,13555.0,3,B
2018-04-03 14:50:39,13550.0,2,14894,-2,13545.0,3,13555.0,3,B
2018-04-03 14:51:00,13550.0,2,14896,0,13545.0,3,13555.0,6,B
2018-04-03 14:51:04,13550.0,4,14900,2,13545.0,3,13560.0,8,B
2018-04-03 14:51:20,13545.0,2,14902,-2,13540.0,4,13550.0,1,S
2018-04-03 14:51:32,13545.0,2,14904,0,13545.0,7,13550.0,2,S
2018-04-03 14:51:43,13550.0,14,14918,-2,13540.0,1,13550.0,5,B
2018-04-03 14:53:04,13540.0,6,14924,-2,13535.0,1,13550.0,1,S
2018-04-03 14:53:53,13545.0,2,14926,0,13540.0,2,13550.0,4,B
2018-04-03 14:55:01,13540.0,2,14928,-2,13535.0,1,13545.0,3,S
2018-04-03 14:55:06,13540.0,2,14930,-2,13530.0,8,13540.0,2,S
2018-04-03 14:55:07,13535.0,2,14932,0,13530.0,9,13535.0,1,S
2018-04-03 14:55:09,13530.0,2,14934,0,13530.0,7,13535.0,1,S
2018-04-03 14:55:15,13530.0,2,14936,2,13530.0,4,13535.0,2,S
2018-04-03 14:55:16,13530.0,2,14938,0,13530.0,3,13535.0,2,S
2018-04-03 14:55:16,13530.0,6,14944,4,13525.0,1,13535.0,2,S
2018-04-03 14:55:18,13535.0,2,14946,0,13525.0,2,13535.0,1,B
2018-04-03 14:55:36,13525.0,2,14948,-2,13525.0,6,13540.0,1,S
2018-04-03 14:55:59,13525.0,6,14954,-4,13525.0,2,13535.0,3,S
2018-04-03 14:56:11,13530.0,6,14960,4,13530.0,2,13535.0,2,B
2018-04-03 14:56:17,13530.0,4,14964,-2,13525.0,3,13530.0,16,B
2018-04-03 14:56:23,13530.0,2,14966,0,13525.0,3,13530.0,15,B
2018-04-03 14:56:44,13530.0,4,14970,-4,13525.0,2,13530.0,13,B
2018-04-03 14:56:50,13530.0,2,14972,-2,13525.0,2,13530.0,12,B
2018-04-03 14:57:06,13525.0,4,14976,-2,13520.0,5,13530.0,15,S
2018-04-03 14:57:13,13520.0,6,14982,-2,13520.0,1,13530.0,17,S
2018-04-03 14:57:25,13525.0,2,14984,0,13520.0,1,13530.0,20,B
2018-04-03 14:57:28,13520.0,2,14986,0,13515.0,3,13530.0,19,S
2018-04-03 14:57:36,13525.0,8,14994,-4,13525.0,4,13530.0,20,B
2018-04-03 14:57:37,13525.0,8,15002,-6,13515.0,4,13530.0,20,B
2018-04-03 14:57:43,13520.0,2,15004,-2,13515.0,5,13525.0,2,S
2018-04-03 14:57:46,13520.0,2,15006,0,13515.0,5,13525.0,4,S
2018-04-03 14:57:51,13520.0,2,15008,0,13515.0,5,13520.0,2,S
2018-04-03 14:58:00,13515.0,2,15010,0,13515.0,6,13530.0,5,S
2018-04-03 14:58:01,13515.0,12,15022,-6,13515.0,1,13530.0,7,S
2018-04-03 14:58:21,13520.0,2,15024,0,13515.0,2,13520.0,5,B
2018-04-03 14:58:22,13520.0,2,15026,2,13515.0,2,13520.0,4,B
2018-04-03 14:58:26,13520.0,4,15030,0,13510.0,9,13520.0,3,B
2018-04-03 14:58:31,13520.0,2,15032,0,13510.0,9,13520.0,2,B
2018-04-03 14:58:33,13520.0,2,15034,0,13510.0,9,13520.0,1,B
2018-04-03 14:58:35,13520.0,2,15036,0,13515.0,1,13525.0,2,B
2018-04-03 14:58:59,13515.0,2,15038,2,13515.0,1,13520.0,2,S
2018-04-03 14:59:00,13520.0,6,15044,-4,13515.0,1,13525.0,5,B
2018-04-03 14:59:07,13520.0,2,15046,0,13515.0,3,13520.0,1,B
2018-04-03 14:59:15,13520.0,2,15048,2,13515.0,2,13525.0,7,B
2018-04-03 14:59:17,13520.0,2,15050,-2,13515.0,1,13525.0,7,B
2018-04-03 14:59:20,13525.0,2,15052,-2,13515.0,1,13525.0,6,B
2018-04-03 14:59:23,13520.0,2,15054,0,13515.0,1,13525.0,8,S
2018-04-03 14:59:24,13525.0,2,15056,-2,13520.0,1,13525.0,7,B
2018-04-03 14:59:24,13525.0,2,15058,0,13520.0,1,13525.0,6,B
2018-04-03 14:59:28,13525.0,2,15060,0,13520.0,1,13525.0,5,B
2018-04-03 14:59:30,13525.0,2,15062,-2,13520.0,1,13525.0,3,B
2018-04-03 14:59:30,13520.0,2,15064,0,13515.0,1,13525.0,3,S
2018-04-03 14:59:31,13515.0,2,15066,0,13520.0,1,13525.0,4,S
2018-04-03 14:59:31,13525.0,4,15070,-2,13515.0,1,13525.0,3,B
2018-04-03 14:59:32,13515.0,2,15072,0,13510.0,8,13525.0,3,S
2018-04-03 14:59:41,13515.0,2,15074,-2,13510.0,5,13525.0,8,S
2018-04-03 14:59:42,13510.0,4,15078,0,13510.0,4,13525.0,7,S
2018-04-03 20:59:00,13535.0,400,400,53960,0.0,0,0.0,0,B
2018-04-03 21:00:00,13530.0,2,402,2,13530.0,5,13535.0,1,S
2018-04-03 21:00:01,13530.0,14,416,12,13515.0,1,13530.0,4,S
2018-04-03 21:00:01,13530.0,4,420,0,13515.0,1,13530.0,7,S
2018-04-03 21:00:03,13515.0,34,454,28,13510.0,15,13515.0,4,S
2018-04-03 21:00:03,13515.0,4,458,2,13510.0,3,13515.0,2,S
2018-04-03 21:00:04,13525.0,6,464,2,13510.0,1,13530.0,3,B
2018-04-03 21:00:06,13530.0,2,466,-2,13515.0,2,13530.0,3,B
2018-04-03 21:00:12,13515.0,2,468,0,13510.0,5,13515.0,1,S
2018-04-03 21:00:12,13515.0,2,470,0,13515.0,2,13525.0,1,S
2018-04-03 21:00:14,13510.0,2,472,2,13500.0,1,13510.0,19,S
2018-04-03 21:00:16,13505.0,6,478,6,13505.0,2,13510.0,18,S
2018-04-03 21:00:17,13505.0,4,482,-2,13500.0,4,13510.0,18,S
2018-04-03 21:00:20,13500.0,2,484,-2,13500.0,4,13510.0,18,S
2018-04-03 21:00:24,13510.0,2,486,0,13500.0,12,13510.0,18,B
2018-04-03 21:00:26,13500.0,20,506,12,13500.0,2,13510.0,18,S
2018-04-03 21:00:28,13510.0,2,508,2,13500.0,4,13510.0,17,B
2018-04-03 21:00:29,13510.0,6,514,4,13505.0,12,13510.0,13,B
2018-04-03 21:00:29,13510.0,2,516,0,13505.0,12,13510.0,12,B
2018-04-03 21:00:32,13510.0,2,518,2,13505.0,1,13510.0,12,B
2018-04-03 21:00:36,13510.0,2,520,0,13505.0,12,13510.0,11,B
2018-04-03 21:00:36,13510.0,6,526,4,13505.0,12,13510.0,8,B
2018-04-03 21:00:37,13510.0,4,530,2,13505.0,12,13510.0,6,B
2018-04-03 21:00:37,13510.0,12,542,0,13510.0,1,13520.0,2,B
2018-04-03 21:00:38,13510.0,2,544,0,13505.0,12,13520.0,4,B
2018-04-03 21:00:39,13505.0,20,564,18,13505.0,5,13520.0,4,S
2018-04-03 21:00:44,13520.0,2,566,0,13505.0,5,13520.0,1,B
2018-04-03 21:00:50,13525.0,4,570,-2,13515.0,1,13525.0,1,B
2018-04-03 21:01:06,13525.0,2,572,-2,13520.0,1,13530.0,4,B
2018-04-03 21:01:07,13525.0,4,576,-4,13520.0,1,13525.0,6,B
2018-04-03 21:01:07,13520.0,2,578,0,13515.0,5,13525.0,7,S
2018-04-03 21:01:13,13515.0,2,580,0,13515.0,3,13520.0,3,S
2018-04-03 21:01:14,13515.0,2,582,2,13515.0,2,13520.0,3,S
2018-04-03 21:01:15,13515.0,4,586,0,13510.0,7,13520.0,3,S
2018-04-03 21:01:17,13510.0,2,588,0,13510.0,7,13515.0,1,S
2018-04-03 21:01:18,13515.0,2,590,0,13510.0,7,13520.0,1,B
2018-04-03 21:01:24,13510.0,2,592,2,13510.0,10,13520.0,1,S
2018-04-03 21:01:34,13520.0,2,594,0,13515.0,2,13520.0,1,B
2018-04-03 21:01:38,13520.0,2,596,2,13515.0,3,13520.0,1,B
2018-04-03 21:01:40,13520.0,2,598,2,13515.0,3,13525.0,3,B
2018-04-03 21:01:51,13525.0,8,606,8,13525.0,27,13530.0,1,B
2018-04-03 21:01:55,13525.0,2,608,2,13525.0,26,13530.0,2,B
2018-04-03 21:02:01,13530.0,2,610,-2,13525.0,26,13530.0,1,B
2018-04-03 21:02:01,13530.0,2,612,2,13530.0,1,13535.0,12,B
2018-04-03 21:02:02,13530.0,2,614,-2,13525.0,26,13535.0,12,B
2018-04-03 21:02:07,13530.0,2,616,0,13525.0,25,13535.0,12,B
2018-04-03 21:02:10,13525.0,4,620,4,13525.0,24,13535.0,29,S
2018-04-03 21:02:13,13525.0,4,624,0,13525.0,22,13530.0,1,S
2018-04-03 21:02:14,13530.0,2,626,0,13525.0,22,13535.0,15,B
2018-04-03 21:02:15,13535.0,4,630,0,13525.0,22,13535.0,14,B
2018-04-03 21:02:23,13535.0,2,632,0,13525.0,21,13535.0,13,B
2018-04-03 21:02:29,13530.0,28,660,20,13530.0,1,13550.0,1,S
2018-04-03 21:02:30,13525.0,40,700,38,13525.0,3,13545.0,7,S
2018-04-03 21:02:32,13540.0,2,702,-2,13530.0,1,13540.0,1,B
2018-04-03 21:02:36,13530.0,2,704,2,13525.0,3,13540.0,1,S
2018-04-03 21:02:37,13525.0,6,710,6,13520.0,3,13525.0,17,S
2018-04-03 21:02:37,13525.0,2,712,0,13520.0,5,13525.0,17,S
2018-04-03 21:02:38,13525.0,2,714,0,13520.0,8,13525.0,16,S
2018-04-03 21:02:39,13525.0,2,716,0,13520.0,6,13525.0,15,S
2018-04-03 21:02:40,13525.0,2,718,0,13520.0,6,13525.0,14,S
2018-04-03 21:02:45,13525.0,8,726,4,13520.0,2,13525.0,11,S
2018-04-03 21:02:47,13520.0,2,728,0,13520.0,4,13525.0,10,S
2018-04-03 21:02:50,13520.0,10,738,2,13515.0,1,13520.0,15,S
2018-04-03 21:02:58,13520.0,2,740,0,13515.0,11,13520.0,14,S
2018-04-03 21:03:02,13515.0,22,762,20,13510.0,7,13515.0,9,S
2018-04-03 21:03:02,13515.0,6,768,2,13510.0,7,13515.0,6,S
2018-04-03 21:03:03,13515.0,12,780,0,13515.0,4,13520.0,14,S
2018-04-03 21:03:03,13515.0,2,782,-2,13515.0,3,13520.0,14,S
2018-04-03 21:03:04,13515.0,6,788,-6,13510.0,9,13515.0,8,S
2018-04-03 21:03:05,13510.0,12,800,-6,13505.0,7,13520.0,14,S
2018-04-03 21:03:21,13505.0,2,802,-2,13505.0,6,13515.0,8,S
2018-04-03 21:03:25,13505.0,12,814,0,13500.0,11,13510.0,20,S
2018-04-03 21:03:35,13510.0,20,834,0,13500.0,22,13510.0,10,B
2018-04-03 21:03:36,13510.0,2,836,2,13500.0,22,13510.0,9,B
2018-04-03 21:03:41,13505.0,4,840,0,13500.0,22,13510.0,9,S
2018-04-03 21:03:47,13500.0,14,854,8,13495.0,31,13500.0,13,S
2018-04-03 21:03:47,13500.0,8,862,8,13495.0,34,13500.0,9,S
2018-04-03 21:03:48,13500.0,2,864,0,13495.0,34,13500.0,8,S
2018-04-03 21:03:49,13500.0,8,872,8,13495.0,34,13500.0,4,S
2018-04-03 21:03:50,13500.0,8,880,8,13500.0,1,13510.0,9,S
2018-04-03 21:03:52,13505.0,2,882,-2,13500.0,1,13505.0,1,B
2018-04-03 21:03:54,13510.0,2,884,0,13500.0,2,13510.0,10,B
2018-04-03 21:03:56,13510.0,2,886,-2,13500.0,2,13505.0,3,B
2018-04-03 21:03:59,13505.0,6,892,2,13505.0,3,13510.0,9,S
2018-04-03 21:04:00,13505.0,8,900,-2,13500.0,1,13505.0,1,S
2018-04-03 21:04:03,13500.0,4,904,0,13495.0,7,13500.0,1,S
2018-04-03 21:04:04,13495.0,6,910,2,13495.0,1,13500.0,2,S
2018-04-03 21:04:05,13495.0,2,912,0,13480.0,30,13490.0,1,S
2018-04-03 21:04:05,13490.0,2,914,2,13490.0,9,13495.0,2,S
2018-04-03 21:04:07,13495.0,4,918,2,13490.0,3,13500.0,2,B
2018-04-03 21:04:08,13490.0,4,922,2,13485.0,6,13490.0,10,S
2018-04-03 21:04:09,13490.0,20,942,20,13490.0,2,13495.0,1,S
2018-04-03 21:04:09,13490.0,2,944,0,13490.0,1,13495.0,1,S
2018-04-03 21:04:10,13495.0,4,948,0,13495.0,8,13500.0,2,B
2018-04-03 21:04:11,13500.0,2,950,0,13495.0,8,13505.0,1,B
2018-04-03 21:04:15,13495.0,2,952,0,13495.0,7,13505.0,2,S
2018-04-03 21:04:30,13505.0,6,958,-2,13505.0,4,13510.0,6,B
2018-04-03 21:04:31,13505.0,8,966,-2,13495.0,1,13505.0,2,B
2018-04-03 21:04:32,13495.0,6,972,2,13485.0,33,13495.0,7,S
2018-04-03 21:04:37,13495.0,2,974,0,13485.0,34,13495.0,6,S
2018-04-03 21:04:42,13495.0,2,976,0,13485.0,35,13495.0,5,S
2018-04-03 21:04:44,13495.0,10,986,10,13490.0,2,13505.0,4,S
2018-04-03 21:04:54,13500.0,2,988,-2,13495.0,2,13500.0,1,B
2018-04-03 21:04:56,13500.0,2,990,0,13495.0,2,13505.0,4,B
2018-04-03 21:04:58,13500.0,2,992,0,13495.0,2,13505.0,3,B
2018-04-03 21:05:03,13505.0,4,996,-4,13495.0,5,13510.0,8,B
2018-04-03 21:05:04,13510.0,2,998,0,13500.0,7,13510.0,2,B
2018-04-03 21:05:10,13510.0,4,1002,2,13500.0,7,13515.0,1,B
2018-04-03 21:05:12,13510.0,2,1004,0,13500.0,10,13515.0,4,B
2018-04-03 21:05:25,13515.0,2,1006,0,13505.0,3,13520.0,2,B
2018-04-03 21:06:00,13520.0,2,1008,0,13515.0,10,13520.0,3,B
2018-04-03 21:06:01,13520.0,2,1010,0,13515.0,10,13520.0,2,B
2018-04-03 21:06:01,13520.0,4,1014,-2,13515.0,10,13525.0,14,B
2018-04-03 21:06:11,13525.0,2,1016,2,13515.0,13,13525.0,12,B
2018-04-03 21:06:12,13525.0,2,1018,-2,13515.0,13,13525.0,11,B
2018-04-03 21:06:14,13525.0,2,1020,2,13515.0,13,13525.0,10,B
2018-04-03 21:06:15,13525.0,2,1022,2,13520.0,5,13525.0,9,B
2018-04-03 21:06:16,13525.0,12,1034,0,13520.0,7,13525.0,3,B
2018-04-03 21:06:17,13525.0,6,1040,2,13525.0,1,13530.0,2,B
2018-04-03 21:06:17,13525.0,2,1042,0,13520.0,7,13530.0,2,B
2018-04-03 21:06:20,13535.0,2,1044,-2,13525.0,5,13535.0,6,B
2018-04-03 21:06:26,13530.0,2,1046,0,13525.0,6,13535.0,5,S
2018-04-03 21:06:29,13535.0,10,1056,4,13535.0,5,13540.0,15,B
2018-04-03 21:06:30,13535.0,10,1066,0,13525.0,6,13535.0,4,B
2018-04-03 21:06:43,13535.0,6,1072,2,13535.0,3,13540.0,5,B
2018-04-03 21:06:44,13535.0,6,1078,0,13530.0,2,13535.0,1,B
2018-04-03 21:06:46,13535.0,4,1082,0,13535.0,8,13540.0,6,B
2018-04-03 21:06:46,13535.0,2,1084,0,13535.0,7,13540.0,6,B
2018-04-03 21:06:47,13535.0,2,1086,2,13535.0,6,13540.0,5,B
2018-04-03 21:06:47,13535.0,2,1088,2,13535.0,5,13540.0,5,B
2018-04-03 21:06:49,13535.0,8,1096,8,13535.0,1,13540.0,7,B
2018-04-03 21:06:50,13535.0,2,1098,2,13530.0,3,13535.0,4,B
2018-04-03 21:06:51,13530.0,2,1100,2,13530.0,1,13535.0,3,S
2018-04-03 21:06:58,13530.0,2,1102,2,13530.0,4,13535.0,2,S
2018-04-03 21:07:01,13530.0,4,1106,4,13530.0,2,13535.0,3,S
2018-04-03 21:07:02,13535.0,10,1116,0,13535.0,5,13540.0,18,B
2018-04-03 21:07:03,13535.0,10,1126,10,13530.0,2,13535.0,1,B
2018-04-03 21:07:07,13530.0,4,1130,0,13520.0,7,13535.0,1,S
2018-04-03 21:07:17,13530.0,6,1136,0,13515.0,11,13530.0,6,S
2018-04-03 21:07:33,13520.0,4,1140,0,13520.0,4,13525.0,1,S
2018-04-03 21:07:33,13525.0,2,1142,0,13520.0,4,13530.0,6,B
2018-04-03 21:07:47,13525.0,2,1144,0,13520.0,5,13530.0,7,B
2018-04-03 21:07:49,13525.0,2,1146,0,13520.0,3,13530.0,7,B
2018-04-03 21:08:13,13520.0,2,1148,-2,13515.0,4,13525.0,4,S
2018-04-03 21:08:42,13515.0,2,1150,2,13515.0,3,13520.0,2,S
2018-04-03 21:08:50,13515.0,2,1152,2,13515.0,2,13520.0,2,S
2018-04-03 21:09:04,13520.0,4,1156,0,13515.0,6,13525.0,2,B
2018-04-03 21:09:05,13520.0,2,1158,0,13515.0,6,13525.0,3,B
2018-04-03 21:09:07,13520.0,4,1162,0,13520.0,1,13525.0,1,B
2018-04-03 21:09:25,13530.0,2,1164,2,13520.0,6,13530.0,5,B
2018-04-03 21:09:41,13520.0,2,1166,0,13515.0,3,13525.0,1,S
2018-04-03 21:09:57,13515.0,2,1168,0,13510.0,5,13520.0,1,S
2018-04-03 21:10:23,13510.0,10,1178,-2,13505.0,4,13510.0,1,S
2018-04-03 21:10:26,13505.0,8,1186,4,13500.0,9,13505.0,1,S
2018-04-03 21:10:27,13505.0,2,1188,-2,13500.0,9,13510.0,2,S
2018-04-03 21:10:31,13505.0,2,1190,0,13500.0,9,13510.0,2,S
2018-04-03 21:10:35,13505.0,4,1194,4,13500.0,9,13510.0,7,S
2018-04-03 21:10:48,13505.0,2,1196,0,13500.0,29,13510.0,5,S
2018-04-03 21:10:50,13500.0,10,1206,6,13500.0,24,13505.0,1,S
2018-04-03 21:10:52,13500.0,50,1256,0,13495.0,16,13505.0,15,S
2018-04-03 21:10:53,13495.0,6,1262,-2,13495.0,13,13500.0,8,S
2018-04-03 21:10:53,13495.0,28,1290,-12,13490.0,9,13500.0,7,S
2018-04-03 21:10:54,13490.0,18,1308,6,13485.0,18,13500.0,25,S
2018-04-03 21:10:55,13485.0,18,1326,6,13485.0,15,13495.0,5,S
2018-04-03 21:10:56,13485.0,14,1340,-2,13485.0,8,13490.0,2,S
2018-04-03 21:10:56,13485.0,14,1354,4,13485.0,1,13490.0,18,S
2018-04-03 21:10:57,13485.0,2,1356,0,13480.0,36,13490.0,6,S
2018-04-03 21:10:58,13480.0,2,1358,-2,13480.0,28,13490.0,6,S
2018-04-03 21:10:59,13485.0,14,1372,-6,13480.0,31,13495.0,2,B
2018-04-03 21:11:00,13485.0,2,1374,-2,13480.0,40,13500.0,8,B
2018-04-03 21:11:04,13485.0,2,1376,2,13480.0,30,13495.0,4,B
2018-04-03 21:11:12,13480.0,2,1378,2,13480.0,28,13485.0,5,S
2018-04-03 21:11:12,13480.0,4,1382,4,13480.0,26,13485.0,5,S
2018-04-03 21:11:13,13485.0,2,1384,0,13480.0,26,13485.0,4,B
2018-04-03 21:11:15,13480.0,20,1404,6,13480.0,21,13490.0,3,S
2018-04-03 21:11:15,13480.0,8,1412,8,13480.0,17,13485.0,1,S
2018-04-03 21:11:16,13480.0,34,1446,14,13475.0,1,13480.0,1,S
2018-04-03 21:11:17,13475.0,2,1448,0,13480.0,4,13485.0,15,S
2018-04-03 21:11:17,13480.0,10,1458,-2,13470.0,3,13485.0,15,B
2018-04-03 21:11:20,13485.0,2,1460,0,13470.0,17,13485.0,1,B
2018-04-03 21:11:23,13490.0,4,1464,0,13480.0,1,13495.0,17,B
2018-04-03 21:11:23,13495.0,2,1466,0,13480.0,1,13495.0,17,B
2018-04-03 21:11:26,13495.0,2,1468,0,13485.0,1,13500.0,22,B
2018-04-03 21:11:37,13495.0,2,1470,0,13495.0,1,13500.0,11,B
2018-04-03 21:11:39,13495.0,4,1474,2,13490.0,18,13495.0,2,B
2018-04-03 21:11:39,13495.0,4,1478,4,13490.0,6,13500.0,11,B
2018-04-03 21:11:40,13495.0,2,1480,0,13490.0,6,13500.0,11,B
2018-04-03 21:11:41,13500.0,6,1486,0,13490.0,6,13500.0,8,B
2018-04-03 21:11:46,13495.0,2,1488,2,13490.0,3,13500.0,13,S
2018-04-03 21:11:51,13495.0,2,1490,0,13490.0,3,13500.0,10,S
2018-04-03 21:12:01,13500.0,2,1492,2,13490.0,3,13500.0,10,B
2018-04-03 21:12:04,13490.0,2,1494,-2,13490.0,1,13495.0,2,S
2018-04-03 21:12:05,13490.0,2,1496,0,13485.0,1,13495.0,5,S
2018-04-03 21:12:15,13490.0,2,1498,0,13485.0,16,13495.0,2,S
2018-04-03 21:12:23,13490.0,2,1500,0,13485.0,16,13490.0,29,S
2018-04-03 21:12:24,13490.0,8,1508,-8,13485.0,16,13490.0,25,S
2018-04-03 21:12:28,13490.0,8,1516,0,13485.0,16,13490.0,21,S
2018-04-03 21:12:29,13490.0,42,1558,-28,13490.0,3,13495.0,1,S
2018-04-03 21:12:29,13495.0,2,1560,0,13495.0,1,13500.0,11,B
2018-04-03 21:12:30,13495.0,2,1562,-2,13495.0,12,13500.0,9,B
2018-04-03 21:12:36,13495.0,26,1588,0,13490.0,9,13500.0,7,B
2018-04-03 21:12:39,13495.0,12,1600,4,13490.0,13,13495.0,7,B
2018-04-03 21:12:44,13495.0,2,1602,2,13490.0,13,13495.0,6,B
2018-04-03 21:12:45,13495.0,6,1608,6,13490.0,12,13495.0,3,B
2018-04-03 21:12:47,13495.0,2,1610,2,13490.0,12,13495.0,2,B
2018-04-03 21:12:54,13495.0,2,1612,0,13490.0,9,13495.0,1,B
2018-04-03 21:12:58,13495.0,2,1614,2,13490.0,12,13500.0,11,B
2018-04-03 21:12:59,13495.0,2,1616,-2,13490.0,12,13495.0,3,B
2018-04-03 21:13:00,13500.0,20,1636,18,13490.0,9,13500.0,2,B
2018-04-03 21:13:03,13500.0,2,1638,0,13490.0,7,13500.0,2,B
2018-04-03 21:13:21,13490.0,20,1658,2,13485.0,2,13500.0,2,S
2018-04-03 21:13:22,13490.0,2,1660,0,13485.0,4,13490.0,9,S
2018-04-03 21:13:22,13490.0,4,1664,0,13485.0,7,13490.0,7,S
2018-04-03 21:13:24,13490.0,14,1678,0,13485.0,9,13500.0,2,S
2018-04-03 21:13:25,13490.0,6,1684,6,13485.0,7,13500.0,3,S
2018-04-03 21:13:49,13490.0,2,1686,0,13490.0,1,13500.0,5,S
2018-04-03 21:14:21,13490.0,2,1688,-2,13485.0,7,13495.0,2,S
2018-04-03 21:14:30,13490.0,2,1690,2,13485.0,9,13495.0,4,S
2018-04-03 21:14:41,13490.0,2,1692,0,13485.0,4,13495.0,5,S
2018-04-03 21:14:57,13485.0,4,1696,-2,13485.0,2,13495.0,7,S
2018-04-03 21:15:03,13495.0,2,1698,2,13490.0,6,13495.0,3,B
2018-04-03 21:15:03,13495.0,6,1704,0,13490.0,6,13500.0,7,B
2018-04-03 21:15:05,13500.0,2,1706,0,13495.0,2,13500.0,2,B
2018-04-03 21:15:22,13500.0,4,1710,2,13495.0,2,13505.0,3,B
2018-04-03 21:15:28,13500.0,2,1712,2,13495.0,2,13500.0,1,B
2018-04-03 21:15:34,13495.0,2,1714,2,13495.0,2,13500.0,1,S
2018-04-03 21:15:38,13495.0,10,1724,-6,13490.0,4,13500.0,2,S
2018-04-03 21:15:45,13495.0,2,1726,0,13495.0,2,13500.0,2,S
2018-04-03 21:15:53,13500.0,2,1728,0,13495.0,3,13500.0,1,B
2018-04-03 21:15:57,13500.0,2,1730,0,13495.0,11,13505.0,3,B
2018-04-03 21:15:58,13505.0,2,1732,-2,13500.0,1,13505.0,1,B
2018-04-03 21:16:01,13505.0,6,1738,-4,13505.0,2,13510.0,19,B
2018-04-03 21:16:01,13505.0,4,1742,-4,13500.0,1,13505.0,3,B
2018-04-03 21:16:04,13505.0,2,1744,-2,13500.0,1,13505.0,1,B
2018-04-03 21:16:06,13500.0,2,1746,0,13500.0,2,13505.0,1,S
2018-04-03 21:16:44,13500.0,2,1748,0,13495.0,9,13500.0,2,S
2018-04-03 21:16:44,13495.0,2,1750,0,13495.0,7,13500.0,2,S
2018-04-03 21:16:45,13495.0,6,1756,0,13495.0,8,13500.0,2,S
2018-04-03 21:17:23,13500.0,4,1760,4,13495.0,8,13500.0,3,B
2018-04-03 21:17:31,13495.0,2,1762,0,13495.0,7,13500.0,4,S
2018-04-03 21:17:33,13500.0,2,1764,0,13495.0,7,13500.0,3,B
2018-04-03 21:17:42,13500.0,2,1766,2,13495.0,7,13500.0,1,B
2018-04-03 21:17:43,13500.0,2,1768,0,13495.0,7,13505.0,37,B
2018-04-03 21:17:49,13505.0,2,1770,0,13500.0,4,13505.0,41,B
2018-04-03 21:17:55,13505.0,2,1772,0,13500.0,4,13505.0,40,B
2018-04-03 21:18:00,13500.0,2,1774,0,13500.0,3,13505.0,40,S
2018-04-03 21:18:01,13505.0,2,1776,0,13500.0,3,13505.0,39,B
2018-04-03 21:18:07,13505.0,2,1778,0,13500.0,3,13505.0,40,B
2018-04-03 21:18:11,13505.0,2,1780,0,13500.0,3,13505.0,39,B
2018-04-03 21:18:16,13505.0,70,1850,70,13500.0,3,13505.0,5,B
2018-04-03 21:18:22,13505.0,2,1852,0,13500.0,3,13505.0,9,B
2018-04-03 21:18:25,13500.0,6,1858,-6,13495.0,5,13500.0,4,S
2018-04-03 21:18:49,13500.0,2,1860,-2,13495.0,7,13505.0,41,S
2018-04-03 21:18:52,13500.0,2,1862,2,13500.0,2,13505.0,26,S
2018-04-03 21:18:59,13500.0,2,1864,2,13495.0,9,13505.0,27,S
2018-04-03 21:19:10,13495.0,2,1866,0,13495.0,8,13505.0,27,S
2018-04-03 21:19:17,13505.0,2,1868,0,13495.0,8,13505.0,25,B
2018-04-03 21:19:23,13500.0,2,1870,2,13500.0,1,13505.0,25,S
2018-04-03 21:19:24,13500.0,2,1872,0,13500.0,1,13505.0,25,S
2018-04-03 21:20:05,13500.0,4,1876,-2,13500.0,1,13505.0,28,S
2018-04-03 21:20:06,13500.0,2,1878,-2,13495.0,9,13500.0,1,S
2018-04-03 21:20:15,13500.0,2,1880,-2,13495.0,9,13500.0,1,S
2018-04-03 21:20:20,13495.0,2,1882,-2,13495.0,8,13505.0,28,S
2018-04-03 21:20:26,13500.0,2,1884,-2,13495.0,8,13500.0,3,B
2018-04-03 21:20:51,13495.0,10,1894,2,13495.0,11,13500.0,4,S
2018-04-03 21:20:58,13495.0,4,1898,2,13495.0,9,13500.0,19,S
2018-04-03 21:20:58,13495.0,6,1904,-6,13495.0,6,13500.0,19,S
2018-04-03 21:20:59,13495.0,8,1912,-8,13495.0,2,13500.0,19,S
2018-04-03 21:20:59,13495.0,4,1916,0,13490.0,2,13495.0,2,S
2018-04-03 21:21:02,13490.0,2,1918,0,13490.0,1,13495.0,13,S
2018-04-03 21:21:03,13490.0,2,1920,2,13485.0,6,13495.0,13,S
2018-04-03 21:21:04,13490.0,2,1922,0,13485.0,8,13495.0,13,S
2018-04-03 21:21:07,13485.0,2,1924,0,13485.0,6,13495.0,12,S
2018-04-03 21:21:16,13490.0,4,1928,-4,13490.0,2,13495.0,27,B
2018-04-03 21:21:20,13490.0,2,1930,0,13490.0,1,13495.0,13,B
2018-04-03 21:21:27,13490.0,2,1932,-2,13485.0,6,13490.0,34,B
2018-04-03 21:21:41,13485.0,22,1954,-10,13480.0,27,13485.0,23,S
2018-04-03 21:21:41,13485.0,46,2000,-18,13480.0,30,13495.0,11,S
2018-04-03 21:21:56,13480.0,2,2002,0,13480.0,22,13490.0,11,S
2018-04-03 21:22:02,13490.0,8,2010,8,13485.0,6,13490.0,7,B
2018-04-03 21:22:08,13490.0,2,2012,0,13485.0,6,13490.0,6,B
2018-04-03 21:22:09,13490.0,2,2014,0,13485.0,6,13490.0,5,B
2018-04-03 21:22:10,13490.0,2,2016,0,13485.0,12,13490.0,4,B
2018-04-03 21:22:12,13490.0,2,2018,2,13485.0,12,13490.0,3,B
2018-04-03 21:22:13,13490.0,2,2020,2,13485.0,8,13490.0,2,B
2018-04-03 21:22:14,13485.0,4,2024,0,13485.0,6,13490.0,3,S
2018-04-03 21:22:25,13490.0,2,2026,2,13485.0,11,13490.0,2,B
2018-04-03 21:22:37,13490.0,2,2028,0,13485.0,6,13490.0,1,B
2018-04-03 21:22:41,13490.0,2,2030,0,13490.0,3,13495.0,7,B
2018-04-03 21:22:50,13490.0,2,2032,0,13490.0,2,13495.0,5,B
2018-04-03 21:23:02,13490.0,8,2040,0,13485.0,17,13495.0,7,B
2018-04-03 21:23:03,13490.0,2,2042,0,13485.0,17,13495.0,8,B
2018-04-03 21:23:04,13490.0,2,2044,0,13485.0,17,13495.0,6,B
2018-04-03 21:23:06,13490.0,2,2046,0,13485.0,17,13495.0,6,B
2018-04-03 21:23:54,13495.0,4,2050,0,13490.0,1,13495.0,7,B
2018-04-03 21:24:00,13490.0,2,2052,0,13485.0,16,13490.0,9,S
2018-04-03 21:24:05,13490.0,2,2054,0,13485.0,16,13490.0,8,S
2018-04-03 21:24:06,13490.0,2,2056,0,13485.0,16,13490.0,7,S
2018-04-03 21:24:17,13490.0,2,2058,0,13485.0,22,13490.0,7,S
2018-04-03 21:24:28,13490.0,2,2060,0,13485.0,23,13490.0,6,S
2018-04-03 21:24:32,13490.0,2,2062,0,13485.0,23,13490.0,5,S
2018-04-03 21:24:36,13490.0,2,2064,0,13485.0,23,13490.0,4,S
2018-04-03 21:24:37,13490.0,4,2068,0,13485.0,30,13490.0,2,S
2018-04-03 21:24:37,13490.0,4,2072,2,13485.0,30,13495.0,6,S
2018-04-03 21:24:40,13485.0,40,2112,10,13485.0,9,13490.0,2,S
2018-04-03 21:24:40,13485.0,24,2136,14,13480.0,20,13495.0,6,S
2018-04-03 21:24:48,13490.0,2,2138,-2,13485.0,6,13495.0,5,B
2018-04-03 21:24:52,13490.0,2,2140,-2,13485.0,6,13495.0,6,B
2018-04-03 21:25:08,13490.0,2,2142,-2,13490.0,4,13495.0,7,B
2018-04-03 21:25:09,13490.0,8,2150,6,13485.0,8,13490.0,1,B
2018-04-03 21:25:10,13490.0,2,2152,2,13490.0,3,13495.0,7,B
2018-04-03 21:25:14,13490.0,10,2162,0,13490.0,1,13495.0,7,B
2018-04-03 21:25:14,13490.0,4,2166,0,13485.0,5,13495.0,7,B
2018-04-03 21:25:22,13495.0,2,2168,-2,13490.0,3,13495.0,7,B
2018-04-03 21:25:26,13495.0,2,2170,-2,13490.0,3,13495.0,1,B
2018-04-03 21:25:31,13495.0,2,2172,0,13490.0,3,13500.0,22,B
2018-04-03 21:25:43,13490.0,20,2192,2,13490.0,5,13500.0,24,S
2018-04-03 21:25:58,13490.0,8,2200,-8,13490.0,1,13495.0,6,S
2018-04-03 21:25:59,13490.0,2,2202,2,13485.0,4,13490.0,9,S
2018-04-03 21:26:15,13485.0,6,2208,0,13480.0,25,13485.0,2,S
2018-04-03 21:26:15,13485.0,4,2212,4,13485.0,2,13490.0,9,S
2018-04-03 21:26:18,13485.0,10,2222,0,13480.0,24,13490.0,9,S
2018-04-03 21:26:36,13480.0,4,2226,0,13480.0,14,13485.0,5,S
2018-04-03 21:26:37,13480.0,10,2236,8,13480.0,9,13485.0,5,S
2018-04-03 21:26:39,13480.0,10,2246,4,13480.0,4,13485.0,5,S
2018-04-03 21:26:40,13480.0,2,2248,0,13480.0,3,13485.0,14,S
2018-04-03 21:26:40,13480.0,6,2254,-4,13475.0,18,13485.0,14,S
2018-04-03 21:26:42,13480.0,2,2256,0,13480.0,1,13485.0,14,S
2018-04-03 21:26:51,13485.0,2,2258,0,13475.0,26,13485.0,13,B
2018-04-03 21:27:08,13485.0,4,2262,4,13480.0,1,13485.0,15,B
2018-04-03 21:27:09,13485.0,2,2264,2,13480.0,1,13485.0,14,B
2018-04-03 21:27:28,13485.0,2,2266,0,13480.0,4,13485.0,14,B
2018-04-03 21:27:30,13480.0,2,2268,0,13480.0,3,13485.0,14,S
2018-04-03 21:27:30,13485.0,2,2270,0,13480.0,3,13485.0,13,B
2018-04-03 21:27:35,13485.0,2,2272,2,13480.0,3,13485.0,12,B
2018-04-03 21:27:45,13485.0,2,2274,0,13480.0,3,13485.0,12,B
2018-04-03 21:27:57,13485.0,2,2276,2,13480.0,3,13485.0,10,B
2018-04-03 21:27:59,13485.0,2,2278,0,13480.0,4,13485.0,9,B
2018-04-03 21:28:03,13485.0,2,2280,2,13480.0,4,13485.0,8,B
2018-04-03 21:28:22,13485.0,2,2282,2,13480.0,5,13485.0,6,B
2018-04-03 21:28:23,13485.0,12,2294,8,13485.0,1,13490.0,6,B
2018-04-03 21:28:24,13490.0,2,2296,0,13480.0,5,13490.0,3,B
2018-04-03 21:28:28,13490.0,2,2298,-2,13485.0,1,13490.0,3,B
2018-04-03 21:28:36,13490.0,2,2300,0,13485.0,4,13490.0,3,B
2018-04-03 21:28:38,13490.0,2,2302,-2,13485.0,4,13490.0,2,B
2018-04-03 21:28:42,13490.0,2,2304,0,13485.0,4,13490.0,1,B
2018-04-03 21:28:46,13490.0,2,2306,0,13485.0,4,13490.0,1,B
2018-04-03 21:28:50,13490.0,2,2308,0,13485.0,4,13490.0,1,B
2018-04-03 21:28:50,13490.0,2,2310,0,13485.0,5,13490.0,1,B
2018-04-03 21:28:51,13490.0,2,2312,0,13485.0,5,13490.0,1,B
2018-04-03 21:28:52,13490.0,2,2314,2,13485.0,5,13495.0,6,B
2018-04-03 21:28:59,13485.0,2,2316,0,13485.0,4,13495.0,16,S
2018-04-03 21:29:00,13495.0,2,2318,-2,13485.0,4,13495.0,15,B
2018-04-03 21:29:17,13490.0,2,2320,0,13485.0,7,13490.0,1,S
2018-04-03 21:29:20,13490.0,2,2322,0,13485.0,7,13495.0,16,S
2018-04-03 21:29:38,13490.0,2,2324,0,13490.0,1,13495.0,5,S
2018-04-03 21:30:17,13490.0,2,2326,2,13485.0,7,13495.0,5,S
2018-04-03 21:30:18,13495.0,2,2328,0,13485.0,7,13495.0,4,B
2018-04-03 21:30:33,13485.0,4,2332,4,13485.0,16,13495.0,5,S
2018-04-03 21:30:34,13495.0,2,2334,2,13490.0,1,13495.0,4,B
2018-04-03 21:30:42,13495.0,4,2338,4,13495.0,12,13500.0,24,B
2018-04-03 21:30:47,13500.0,2,2340,0,13495.0,5,13500.0,18,B
2018-04-03 21:30:47,13500.0,36,2376,16,13500.0,9,13505.0,30,B
2018-04-03 21:30:48,13500.0,4,2380,-2,13500.0,6,13505.0,30,B
2018-04-03 21:30:48,13500.0,12,2392,-2,13495.0,3,13505.0,27,B
2018-04-03 21:30:58,13500.0,2,2394,0,13500.0,4,13505.0,25,B
2018-04-03 21:30:59,13500.0,2,2396,0,13500.0,3,13505.0,25,B
2018-04-03 21:31:05,13505.0,4,2400,0,13500.0,3,13505.0,24,B
2018-04-03 21:31:05,13505.0,2,2402,0,13500.0,3,13505.0,23,B
2018-04-03 21:31:10,13505.0,4,2406,0,13500.0,12,13505.0,21,B
2018-04-03 21:31:11,13505.0,4,2410,2,13500.0,10,13505.0,19,B
2018-04-03 21:31:11,13505.0,14,2424,14,13500.0,10,13505.0,12,B
2018-04-03 21:31:12,13505.0,14,2438,8,13500.0,10,13505.0,5,B
2018-04-03 21:31:12,13505.0,10,2448,0,13500.0,10,13510.0,31,B
2018-04-03 21:31:19,13510.0,2,2450,0,13505.0,3,13510.0,27,B
2018-04-03 21:31:20,13510.0,54,2504,52,13510.0,8,13515.0,6,B
2018-04-03 21:31:23,13510.0,2,2506,2,13510.0,8,13515.0,20,B
2018-04-03 21:31:24,13515.0,4,2510,0,13510.0,7,13515.0,19,B
2018-04-03 21:31:28,13510.0,2,2512,0,13510.0,6,13515.0,20,S
2018-04-03 21:31:28,13510.0,12,2524,-2,13505.0,4,13510.0,2,S
2018-04-03 21:31:29,13505.0,2,2526,-2,13505.0,3,13510.0,6,S
2018-04-03 21:31:31,13510.0,14,2540,12,13510.0,2,13515.0,22,B
2018-04-03 21:31:31,13510.0,4,2544,0,13505.0,3,13510.0,1,B
2018-04-03 21:31:36,13505.0,2,2546,0,13505.0,3,13510.0,6,S
2018-04-03 21:31:39,13510.0,2,2548,-2,13505.0,2,13510.0,6,B
2018-04-03 21:31:39,13505.0,4,2552,2,13500.0,12,13510.0,8,S
2018-04-03 21:31:44,13505.0,2,2554,-2,13500.0,12,13510.0,24,S
2018-04-03 21:32:04,13505.0,2,2556,0,13500.0,10,13505.0,12,S
2018-04-03 21:32:12,13505.0,2,2558,0,13500.0,10,13505.0,11,S
2018-04-03 21:32:21,13500.0,2,2560,-2,13500.0,9,13505.0,14,S
2018-04-03 21:32:41,13500.0,14,2574,-14,13500.0,4,13505.0,9,S
2018-04-03 21:32:50,13500.0,2,2576,-2,13500.0,3,13505.0,9,S
2018-04-03 21:32:52,13500.0,4,2580,2,13500.0,1,13505.0,16,S
2018-04-03 21:32:55,13500.0,2,2582,2,13500.0,2,13505.0,15,S
2018-04-03 21:32:57,13500.0,4,2586,0,13495.0,2,13500.0,5,S
2018-04-03 21:33:24,13495.0,4,2590,2,13495.0,1,13500.0,9,S
2018-04-03 21:33:32,13500.0,2,2592,0,13495.0,1,13500.0,8,B
2018-04-03 21:33:35,13500.0,2,2594,0,13495.0,1,13500.0,7,B
2018-04-03 21:33:39,13500.0,2,2596,0,13495.0,1,13500.0,6,B
2018-04-03 21:33:58,13495.0,2,2598,-2,13495.0,2,13500.0,6,S
2018-04-03 21:34:00,13500.0,2,2600,0,13495.0,3,13500.0,5,B
2018-04-03 21:34:12,13500.0,2,2602,0,13495.0,3,13500.0,5,B
2018-04-03 21:34:18,13500.0,2,2604,0,13495.0,3,13500.0,4,B
2018-04-03 21:34:36,13500.0,2,2606,0,13495.0,4,13500.0,3,B
2018-04-03 21:34:44,13500.0,2,2608,0,13495.0,4,13500.0,2,B
2018-04-03 21:34:52,13500.0,2,2610,0,13495.0,5,13500.0,2,B
2018-04-03 21:34:57,13500.0,2,2612,0,13500.0,1,13505.0,19,B
2018-04-03 21:35:04,13500.0,2,2614,-2,13500.0,1,13505.0,20,B
2018-04-03 21:35:09,13505.0,2,2616,-2,13500.0,4,13505.0,18,B
2018-04-03 21:35:22,13505.0,2,2618,0,13500.0,5,13505.0,22,B
2018-04-03 21:35:28,13505.0,2,2620,0,13500.0,15,13505.0,21,B
2018-04-03 21:35:33,13505.0,14,2634,4,13500.0,28,13505.0,14,B
2018-04-03 21:35:34,13505.0,20,2654,20,13500.0,28,13505.0,4,B
2018-04-03 21:35:34,13505.0,8,2662,0,13505.0,1,13510.0,20,B
2018-04-03 21:35:43,13510.0,2,2664,0,13505.0,19,13510.0,18,B
2018-04-03 21:35:45,13510.0,2,2666,0,13505.0,29,13510.0,17,B
2018-04-03 21:35:48,13510.0,2,2668,0,13505.0,28,13510.0,16,B
2018-04-03 21:36:00,13505.0,2,2670,2,13505.0,15,13510.0,16,S
2018-04-03 21:36:01,13510.0,4,2674,2,13505.0,15,13510.0,14,B
2018-04-03 21:36:15,13505.0,2,2676,0,13505.0,9,13510.0,15,S
2018-04-03 21:36:42,13505.0,2,2678,0,13505.0,8,13510.0,15,S
2018-04-03 21:36:43,13510.0,2,2680,0,13505.0,1,13510.0,14,B
2018-04-03 21:36:49,13505.0,2,2682,2,13505.0,1,13510.0,12,S
2018-04-03 21:36:53,13505.0,2,2684,2,13505.0,14,13510.0,12,S
2018-04-03 21:36:54,13510.0,2,2686,0,13505.0,14,13510.0,11,B
2018-04-03 21:36:57,13510.0,12,2698,12,13505.0,14,13510.0,5,B
2018-04-03 21:36:57,13510.0,10,2708,4,13510.0,2,13515.0,13,B
2018-04-03 21:36:58,13510.0,2,2710,-2,13505.0,14,13515.0,14,B
2018-04-03 21:37:09,13510.0,4,2714,0,13505.0,4,13515.0,14,B
2018-04-03 21:37:11,13505.0,2,2716,2,13505.0,2,13515.0,14,S
2018-04-03 21:37:18,13510.0,2,2718,0,13510.0,1,13515.0,14,B
2018-04-03 21:37:19,13515.0,2,2720,0,13510.0,1,13515.0,13,B
2018-04-03 21:37:26,13510.0,2,2722,0,13505.0,2,13515.0,11,S
2018-04-03 21:37:32,13505.0,2,2724,0,13505.0,1,13515.0,10,S
2018-04-03 21:37:32,13515.0,2,2726,0,13505.0,1,13515.0,9,B
2018-04-03 21:37:41,13505.0,2,2728,2,13505.0,13,13515.0,9,S
2018-04-03 21:37:53,13510.0,2,2730,0,13510.0,1,13515.0,8,B
2018-04-03 21:37:58,13515.0,2,2732,0,13510.0,3,13515.0,7,B
2018-04-03 21:37:59,13515.0,2,2734,-2,13510.0,3,13515.0,6,B
2018-04-03 21:38:00,13515.0,2,2736,0,13510.0,3,13515.0,5,B
2018-04-03 21:38:01,13510.0,2,2738,2,13510.0,2,13515.0,5,S
2018-04-03 21:38:07,13515.0,2,2740,0,13510.0,2,13515.0,4,B
2018-04-03 21:38:10,13515.0,2,2742,0,13510.0,2,13515.0,3,B
2018-04-03 21:38:25,13510.0,4,2746,-2,13505.0,6,13515.0,8,S
2018-04-03 21:38:39,13515.0,2,2748,0,13505.0,8,13515.0,8,B
2018-04-03 21:38:46,13510.0,2,2750,0,13505.0,8,13510.0,1,S
2018-04-03 21:38:52,13510.0,2,2752,-2,13505.0,6,13510.0,2,S
2018-04-03 21:38:52,13510.0,2,2754,-2,13505.0,6,13510.0,2,S
2018-04-03 21:39:08,13510.0,2,2756,-2,13505.0,6,13510.0,2,S
2018-04-03 21:39:10,13505.0,2,2758,0,13505.0,5,13510.0,2,S
2018-04-03 21:39:20,13505.0,2,2760,2,13505.0,4,13510.0,4,S
2018-04-03 21:39:27,13505.0,8,2768,-6,13500.0,8,13510.0,9,S
2018-04-03 21:39:28,13500.0,6,2774,2,13500.0,5,13505.0,1,S
2018-04-03 21:39:38,13500.0,2,2776,2,13500.0,3,13505.0,3,S
2018-04-03 21:39:39,13500.0,6,2782,0,13495.0,9,13505.0,6,S
2018-04-03 21:40:12,13505.0,2,2784,-2,13500.0,3,13510.0,6,B
2018-04-03 21:40:14,13510.0,2,2786,-2,13505.0,1,13510.0,3,B
2018-04-03 21:40:28,13510.0,2,2788,0,13505.0,6,13510.0,2,B
2018-04-03 21:40:40,13510.0,2,2790,-2,13505.0,6,13510.0,1,B
2018-04-03 21:40:41,13510.0,2,2792,0,13510.0,2,13515.0,13,B
2018-04-03 21:40:43,13510.0,4,2796,-4,13505.0,3,13515.0,12,B
2018-04-03 21:40:56,13515.0,2,2798,2,13505.0,5,13515.0,8,B
2018-04-03 21:41:18,13505.0,4,2802,4,13500.0,12,13510.0,2,S
2018-04-03 21:41:19,13510.0,2,2804,-2,13500.0,13,13510.0,2,B
2018-04-03 21:41:22,13500.0,2,2806,-2,13500.0,12,13510.0,3,S
2018-04-03 21:41:25,13510.0,2,2808,-2,13500.0,11,13510.0,2,B
2018-04-03 21:41:32,13510.0,2,2810,-2,13500.0,12,13510.0,3,B
2018-04-03 21:41:38,13510.0,2,2812,0,13500.0,12,13510.0,2,B
2018-04-03 21:41:50,13510.0,2,2814,-2,13505.0,4,13515.0,7,B
2018-04-03 21:41:56,13515.0,2,2816,0,13505.0,4,13515.0,5,B
2018-04-03 21:43:05,13515.0,8,2824,-4,13510.0,10,13515.0,2,B
2018-04-03 21:43:30,13515.0,4,2828,0,13510.0,25,13520.0,6,B
2018-04-03 21:45:09,13510.0,2,2830,2,13510.0,15,13515.0,10,S
2018-04-03 21:45:34,13515.0,2,2832,-2,13510.0,26,13515.0,3,B
2018-04-03 21:46:08,13515.0,2,2834,0,13510.0,32,13515.0,3,B
2018-04-03 21:46:12,13515.0,2,2836,0,13510.0,32,13515.0,2,B
2018-04-03 21:46:27,13515.0,4,2840,0,13515.0,4,13520.0,6,B
2018-04-03 21:46:43,13520.0,8,2848,4,13515.0,14,13520.0,1,B
2018-04-03 21:46:44,13520.0,2,2850,2,13520.0,9,13525.0,4,B
2018-04-03 21:46:46,13525.0,2,2852,-2,13520.0,11,13525.0,1,B
2018-04-03 21:46:51,13525.0,2,2854,0,13520.0,11,13530.0,10,B
2018-04-03 21:46:57,13525.0,8,2862,0,13525.0,11,13530.0,14,B
2018-04-03 21:47:02,13530.0,8,2870,6,13525.0,5,13530.0,11,B
2018-04-03 21:47:03,13530.0,4,2874,4,13525.0,5,13530.0,9,B
2018-04-03 21:47:11,13525.0,4,2878,-2,13525.0,3,13530.0,9,S
2018-04-03 21:47:12,13525.0,6,2884,-2,13515.0,3,13525.0,3,S
2018-04-03 21:47:12,13515.0,10,2894,6,13515.0,9,13525.0,9,S
2018-04-03 21:47:16,13525.0,2,2896,0,13515.0,10,13525.0,9,B
2018-04-03 21:47:46,13525.0,2,2898,-2,13520.0,6,13525.0,7,B
2018-04-03 21:47:50,13525.0,2,2900,0,13520.0,6,13525.0,6,B
2018-04-03 21:47:53,13525.0,2,2902,-2,13520.0,6,13525.0,5,B
2018-04-03 21:47:59,13525.0,2,2904,-2,13520.0,6,13525.0,4,B
2018-04-03 21:48:20,13520.0,16,2920,2,13515.0,13,13520.0,2,S
2018-04-03 21:48:20,13520.0,4,2924,0,13515.0,13,13525.0,2,S
2018-04-03 21:49:04,13520.0,2,2926,0,13520.0,1,13525.0,7,S
2018-04-03 21:49:08,13520.0,2,2928,2,13515.0,35,13525.0,7,S
2018-04-03 21:49:45,13520.0,2,2930,0,13515.0,13,13520.0,3,S
2018-04-03 21:50:06,13515.0,2,2932,0,13515.0,13,13520.0,3,S
2018-04-03 21:50:06,13515.0,24,2956,4,13515.0,13,13520.0,3,S
2018-04-03 21:50:14,13510.0,6,2962,0,13515.0,13,13520.0,3,S
2018-04-03 21:50:16,13510.0,12,2974,12,13515.0,13,13520.0,3,S
2018-04-03 21:50:16,13510.0,4,2978,-4,13515.0,13,13520.0,3,S
2018-04-03 21:50:33,13505.0,2,2980,2,13515.0,13,13520.0,3,S
2018-04-03 21:50:39,13505.0,2,2982,-2,13515.0,13,13520.0,3,S
2018-04-03 21:50:46,13510.0,2,2984,0,13515.0,13,13520.0,3,B
2018-04-03 21:51:05,13505.0,2,2986,-2,13515.0,13,13520.0,3,S
2018-04-03 21:51:05,13505.0,2,2988,2,13515.0,13,13520.0,3,S
2018-04-03 21:51:10,13505.0,2,2990,2,13515.0,13,13520.0,3,S
2018-04-03 21:51:12,13505.0,6,2996,4,13515.0,13,13520.0,3,S
2018-04-03 21:51:12,13505.0,4,3000,0,13515.0,13,13520.0,3,S
2018-04-03 21:51:20,13505.0,2,3002,2,13515.0,13,13520.0,3,S
2018-04-03 21:51:38,13510.0,2,3004,-2,13515.0,13,13520.0,3,B
2018-04-03 21:52:08,13510.0,2,3006,0,13505.0,8,13510.0,5,B
2018-04-03 21:52:08,13510.0,8,3014,0,13505.0,8,13510.0,1,B
2018-04-03 21:52:27,13510.0,4,3018,-2,13505.0,18,13515.0,7,B
2018-04-03 21:52:29,13510.0,2,3020,0,13510.0,2,13515.0,4,B
2018-04-03 21:52:41,13515.0,2,3022,-2,13505.0,18,13515.0,5,B
2018-04-03 21:52:51,13510.0,2,3024,-2,13505.0,8,13510.0,3,S
2018-04-03 21:52:54,13510.0,2,3026,-2,13505.0,8,13510.0,2,S
2018-04-03 21:53:14,13505.0,18,3044,-16,13500.0,1,13505.0,1,S
2018-04-03 21:53:50,13505.0,2,3046,0,13500.0,24,13505.0,4,S
2018-04-03 21:53:51,13505.0,8,3054,6,13500.0,24,13510.0,8,S
2018-04-03 21:54:09,13505.0,2,3056,-2,13500.0,2,13505.0,1,S
2018-04-03 21:54:29,13505.0,2,3058,0,13500.0,2,13505.0,1,S
2018-04-03 21:54:34,13505.0,2,3060,2,13505.0,1,13510.0,14,S
2018-04-03 21:54:34,13505.0,2,3062,2,13500.0,2,13505.0,1,S
2018-04-03 21:54:38,13500.0,2,3064,0,13500.0,2,13505.0,1,S
2018-04-03 21:54:42,13505.0,2,3066,0,13500.0,1,13510.0,14,B
2018-04-03 21:54:49,13510.0,4,3070,-4,13505.0,1,13510.0,6,B
2018-04-03 21:56:24,13505.0,4,3074,-4,13505.0,3,13510.0,4,S
2018-04-03 21:56:28,13510.0,6,3080,-6,13505.0,26,13510.0,1,B
2018-04-03 21:56:29,13510.0,2,3082,0,13505.0,26,13515.0,8,B
2018-04-03 21:56:37,13510.0,4,3086,0,13505.0,26,13515.0,6,B
2018-04-03 21:56:45,13515.0,6,3092,-4,13510.0,27,13520.0,11,B
2018-04-03 21:57:21,13515.0,2,3094,0,13510.0,3,13515.0,3,B
2018-04-03 21:57:21,13515.0,6,3100,0,13505.0,1,13515.0,7,B
2018-04-03 21:58:06,13510.0,2,3102,2,13505.0,1,13510.0,2,S
2018-04-03 21:58:24,13505.0,2,3104,-2,13500.0,11,13505.0,1,S
2018-04-03 21:58:34,13500.0,2,3106,2,13500.0,2,13505.0,2,S
2018-04-03 21:58:37,13500.0,2,3108,0,13500.0,4,13505.0,2,S
2018-04-03 21:58:42,13500.0,2,3110,0,13495.0,10,13505.0,3,S
2018-04-03 21:59:03,13495.0,2,3112,0,13495.0,5,13500.0,5,S
2018-04-03 21:59:25,13500.0,2,3114,2,13495.0,5,13500.0,8,B
2018-04-03 21:59:42,13495.0,2,3116,2,13495.0,5,13500.0,5,S
2018-04-03 22:00:18,13495.0,4,3120,-2,13495.0,3,13500.0,7,S
2018-04-03 22:00:18,13495.0,6,3126,4,13490.0,13,13495.0,5,S
2018-04-03 22:00:21,13490.0,2,3128,2,13490.0,12,13495.0,3,S
2018-04-03 22:00:25,13490.0,2,3130,0,13490.0,11,13495.0,6,S
2018-04-03 22:00:25,13490.0,22,3152,0,13485.0,7,13490.0,1,S
2018-04-03 22:00:28,13485.0,14,3166,-4,13480.0,11,13485.0,5,S
2018-04-03 22:00:28,13485.0,8,3174,-8,13480.0,12,13485.0,1,S
2018-04-03 22:00:31,13485.0,2,3176,0,13485.0,1,13495.0,3,S
2018-04-03 22:00:37,13480.0,70,3246,-26,13480.0,1,13495.0,6,S
2018-04-03 22:00:46,13485.0,6,3252,2,13480.0,23,13495.0,11,B
2018-04-03 22:00:47,13485.0,2,3254,2,13480.0,23,13495.0,11,B
2018-04-03 22:00:53,13495.0,20,3274,14,13485.0,1,13500.0,4,B
2018-04-03 22:00:55,13485.0,8,3282,6,13480.0,23,13495.0,3,S
2018-04-03 22:01:00,13485.0,2,3284,0,13480.0,4,13490.0,3,S
2018-04-03 22:01:21,13490.0,2,3286,-2,13485.0,1,13495.0,7,B
2018-04-03 22:01:28,13490.0,2,3288,0,13490.0,2,13500.0,4,B
2018-04-03 22:01:38,13495.0,2,3290,2,13490.0,1,13500.0,5,B
2018-04-03 22:02:03,13495.0,4,3294,0,13490.0,3,13495.0,1,B
2018-04-03 22:02:05,13495.0,2,3296,0,13490.0,3,13500.0,8,B
2018-04-03 22:04:25,13490.0,2,3298,2,13490.0,10,13500.0,5,S
2018-04-03 22:04:51,13500.0,4,3302,-4,13495.0,5,13500.0,1,B
2018-04-03 22:04:51,13500.0,2,3304,-2,13495.0,27,13505.0,6,B
2018-04-03 22:07:23,13500.0,2,3306,2,13495.0,50,13505.0,4,B
2018-04-03 22:07:44,13505.0,2,3308,0,13495.0,38,13505.0,4,B
2018-04-03 22:08:05,13505.0,2,3310,0,13500.0,1,13505.0,4,B
2018-04-03 22:08:09,13505.0,2,3312,0,13500.0,1,13505.0,2,B
2018-04-03 22:08:17,13505.0,4,3316,-2,13495.0,41,13510.0,9,B
2018-04-03 22:08:22,13500.0,2,3318,0,13495.0,17,13500.0,1,S
2018-04-03 22:08:45,13500.0,2,3320,-2,13495.0,13,13505.0,7,S
2018-04-03 22:08:46,13495.0,2,3322,-2,13495.0,13,13505.0,6,S
2018-04-03 22:09:01,13495.0,6,3328,-6,13495.0,9,13505.0,7,S
2018-04-03 22:09:51,13500.0,2,3330,0,13495.0,8,13500.0,2,B
2018-04-03 22:10:04,13500.0,2,3332,0,13495.0,8,13500.0,1,B
2018-04-03 22:10:19,13495.0,8,3340,0,13495.0,4,13500.0,17,S
2018-04-03 22:10:19,13495.0,8,3348,-2,13490.0,13,13500.0,18,S
2018-04-03 22:11:16,13495.0,2,3350,0,13490.0,10,13495.0,1,S
2018-04-03 22:11:41,13495.0,2,3352,2,13495.0,9,13500.0,8,S
2018-04-03 22:12:04,13495.0,2,3354,0,13490.0,22,13500.0,7,S
2018-04-03 22:12:35,13495.0,6,3360,4,13495.0,13,13500.0,8,S
2018-04-03 22:12:37,13495.0,4,3364,2,13495.0,9,13500.0,3,S
2018-04-03 22:12:38,13495.0,2,3366,2,13490.0,21,13500.0,8,S
2018-04-03 22:14:33,13495.0,2,3368,2,13495.0,2,13500.0,9,S
2018-04-03 22:15:02,13495.0,2,3370,0,13495.0,18,13500.0,2,S
2018-04-03 22:15:38,13495.0,2,3372,-2,13495.0,5,13500.0,5,S
2018-04-03 22:15:49,13495.0,2,3374,-2,13495.0,4,13500.0,6,S
2018-04-03 22:15:59,13495.0,2,3376,0,13495.0,14,13500.0,5,S
2018-04-03 22:16:44,13500.0,4,3380,0,13495.0,5,13500.0,4,B
2018-04-03 22:16:44,13500.0,8,3388,-2,13500.0,10,13505.0,5,B
2018-04-03 22:16:55,13510.0,8,3396,-8,13505.0,13,13515.0,21,B
2018-04-03 22:17:08,13515.0,10,3406,-8,13515.0,1,13520.0,7,B
2018-04-03 22:17:08,13515.0,2,3408,0,13510.0,14,13515.0,2,B
2018-04-03 22:17:09,13515.0,2,3410,-2,13505.0,18,13515.0,1,B
2018-04-03 22:17:20,13515.0,2,3412,0,13510.0,12,13515.0,1,B
2018-04-03 22:17:22,13515.0,2,3414,2,13510.0,12,13520.0,10,B
2018-04-03 22:17:33,13520.0,2,3416,0,13515.0,13,13520.0,2,B
2018-04-03 22:17:40,13515.0,2,3418,2,13515.0,12,13520.0,5,S
2018-04-03 22:17:41,13515.0,4,3422,0,13510.0,22,13520.0,7,S
2018-04-03 22:17:59,13515.0,6,3428,0,13510.0,18,13520.0,7,S
2018-04-03 22:18:05,13515.0,4,3432,0,13510.0,18,13520.0,22,S
2018-04-03 22:18:18,13520.0,2,3434,0,13510.0,18,13520.0,11,B
2018-04-03 22:18:22,13510.0,2,3436,0,13510.0,17,13520.0,11,S
2018-04-03 22:18:32,13520.0,2,3438,0,13510.0,17,13520.0,17,B
2018-04-03 22:18:53,13520.0,20,3458,18,13510.0,16,13520.0,7,B
2018-04-03 22:18:57,13520.0,2,3460,0,13510.0,19,13520.0,7,B
2018-04-03 22:19:41,13520.0,2,3462,2,13515.0,40,13520.0,7,B
2018-04-03 22:19:50,13515.0,2,3464,2,13515.0,39,13520.0,22,S
2018-04-03 22:19:51,13515.0,6,3470,0,13515.0,36,13520.0,22,S
2018-04-03 22:19:51,13515.0,4,3474,4,13515.0,34,13520.0,23,S
2018-04-03 22:19:53,13515.0,2,3476,2,13515.0,33,13520.0,23,S
2018-04-03 22:20:04,13515.0,2,3478,0,13515.0,32,13520.0,16,S
2018-04-03 22:20:14,13520.0,2,3480,2,13515.0,32,13520.0,15,B
2018-04-03 22:20:30,13520.0,18,3498,16,13515.0,32,13520.0,7,B
2018-04-03 22:20:33,13515.0,2,3500,2,13515.0,31,13520.0,7,S
2018-04-03 22:20:38,13520.0,10,3510,-8,13515.0,26,13520.0,2,B
2018-04-03 22:20:40,13520.0,2,3512,0,13515.0,26,13520.0,8,B
2018-04-03 22:20:40,13520.0,16,3528,10,13520.0,4,13525.0,6,B
2018-04-03 22:20:49,13520.0,2,3530,2,13520.0,1,13525.0,4,B
2018-04-03 22:20:59,13520.0,2,3532,0,13515.0,29,13525.0,4,B
2018-04-03 22:21:00,13525.0,10,3542,-8,13515.0,29,13530.0,24,B
2018-04-03 22:21:00,13525.0,2,3544,0,13515.0,29,13525.0,3,B
2018-04-03 22:21:01,13520.0,2,3546,2,13515.0,29,13525.0,8,S
2018-04-03 22:21:52,13525.0,2,3548,0,13515.0,29,13525.0,8,B
2018-04-03 22:22:11,13520.0,2,3550,-2,13515.0,29,13525.0,8,S
2018-04-03 22:22:28,13525.0,4,3554,4,13515.0,29,13525.0,8,B
2018-04-03 22:22:38,13520.0,2,3556,-2,13515.0,29,13525.0,8,S
2018-04-03 22:23:07,13520.0,4,3560,-4,13515.0,29,13525.0,8,S
2018-04-03 22:23:09,13520.0,2,3562,0,13515.0,29,13525.0,8,S
2018-04-03 22:23:18,13520.0,2,3564,2,13515.0,29,13525.0,8,S
2018-04-03 22:24:25,13515.0,6,3570,6,13515.0,24,13520.0,2,S
2018-04-03 22:24:35,13515.0,4,3574,4,13515.0,22,13520.0,2,S
2018-04-03 22:24:42,13520.0,2,3576,2,13515.0,22,13520.0,1,B
2018-04-03 22:24:47,13520.0,2,3578,0,13520.0,1,13525.0,35,B
2018-04-03 22:24:47,13520.0,2,3580,0,13515.0,24,13520.0,4,B
2018-04-03 22:25:46,13515.0,2,3582,2,13515.0,23,13520.0,20,S
2018-04-03 22:25:47,13515.0,2,3584,2,13515.0,22,13520.0,20,S
2018-04-03 22:25:47,13515.0,2,3586,0,13515.0,21,13520.0,20,S
2018-04-03 22:25:48,13515.0,2,3588,0,13515.0,20,13520.0,20,S
2018-04-03 22:25:52,13515.0,2,3590,0,13515.0,19,13520.0,8,S
2018-04-03 22:26:00,13515.0,2,3592,2,13515.0,18,13520.0,8,S
2018-04-03 22:26:01,13515.0,2,3594,2,13515.0,17,13520.0,8,S
2018-04-03 22:26:32,13515.0,2,3596,0,13515.0,14,13520.0,8,S
2018-04-03 22:26:33,13515.0,6,3602,0,13515.0,11,13520.0,8,S
2018-04-03 22:26:33,13515.0,2,3604,0,13515.0,10,13520.0,8,S
2018-04-03 22:26:34,13515.0,2,3606,2,13515.0,9,13520.0,8,S
2018-04-03 22:26:38,13515.0,2,3608,0,13515.0,8,13520.0,8,S
2018-04-03 22:26:41,13515.0,2,3610,2,13515.0,7,13520.0,8,S
2018-04-03 22:26:51,13515.0,2,3612,2,13515.0,6,13520.0,8,S
2018-04-03 22:26:54,13515.0,2,3614,2,13515.0,5,13520.0,8,S
2018-04-03 22:27:04,13515.0,2,3616,2,13515.0,4,13520.0,8,S
2018-04-03 22:27:15,13520.0,16,3632,0,13520.0,2,13525.0,10,B
2018-04-03 22:27:15,13520.0,4,3636,0,13515.0,6,13525.0,13,B
2018-04-03 22:27:27,13520.0,2,3638,0,13520.0,2,13525.0,2,B
2018-04-03 22:27:39,13520.0,2,3640,0,13520.0,1,13525.0,2,B
2018-04-03 22:27:48,13520.0,2,3642,2,13515.0,21,13525.0,2,B
2018-04-03 22:28:33,13525.0,4,3646,0,13520.0,8,13525.0,2,B
2018-04-03 22:28:40,13520.0,2,3648,0,13520.0,7,13530.0,27,S
2018-04-03 22:28:47,13520.0,2,3650,0,13520.0,6,13525.0,1,S
2018-04-03 22:29:01,13520.0,2,3652,0,13520.0,3,13525.0,2,S
2018-04-03 22:29:27,13520.0,2,3654,0,13520.0,3,13525.0,3,S
2018-04-03 22:29:53,13520.0,2,3656,0,13520.0,1,13525.0,4,S
2018-04-03 22:29:54,13520.0,2,3658,0,13520.0,1,13525.0,4,S
2018-04-03 22:29:56,13520.0,2,3660,0,13520.0,1,13525.0,3,S
2018-04-03 22:29:58,13520.0,2,3662,0,13515.0,26,13525.0,2,S
2018-04-03 22:30:18,13525.0,2,3664,0,13520.0,19,13530.0,20,B
2018-04-03 22:30:25,13520.0,2,3666,0,13520.0,24,13530.0,12,S
2018-04-03 22:30:29,13525.0,2,3668,2,13520.0,24,13530.0,12,B
2018-04-03 22:30:42,13525.0,6,3674,0,13520.0,10,13530.0,10,B
2018-04-03 22:31:02,13520.0,2,3676,-2,13520.0,11,13530.0,12,S
2018-04-03 22:31:08,13525.0,2,3678,-2,13520.0,11,13530.0,11,B
2018-04-03 22:31:33,13525.0,4,3682,-4,13520.0,9,13525.0,4,B
2018-04-03 22:31:43,13525.0,4,3686,-4,13520.0,9,13530.0,14,B
2018-04-03 22:32:30,13530.0,18,3704,8,13525.0,4,13535.0,13,B
2018-04-03 22:33:08,13525.0,4,3708,2,13525.0,5,13530.0,1,S
2018-04-03 22:33:09,13525.0,6,3714,-6,13520.0,22,13525.0,1,S
2018-04-03 22:33:14,13520.0,2,3716,0,13520.0,9,13525.0,4,S
2018-04-03 22:33:16,13520.0,2,3718,-2,13520.0,8,13525.0,4,S
2018-04-03 22:33:23,13520.0,2,3720,0,13520.0,4,13525.0,5,S
2018-04-03 22:33:37,13520.0,2,3722,-2,13520.0,3,13525.0,6,S
2018-04-03 22:33:38,13520.0,2,3724,2,13520.0,3,13525.0,5,S
2018-04-03 22:33:39,13520.0,2,3726,0,13515.0,25,13525.0,6,S
2018-04-03 22:34:10,13525.0,6,3732,0,13515.0,16,13525.0,5,B
2018-04-03 22:34:23,13525.0,4,3736,0,13515.0,16,13525.0,3,B
2018-04-03 22:35:14,13515.0,40,3776,18,13510.0,12,13525.0,5,S
2018-04-03 22:35:15,13525.0,4,3780,-4,13520.0,2,13525.0,3,B
2018-04-03 22:35:16,13525.0,2,3782,0,13520.0,6,13530.0,7,B
2018-04-03 22:36:00,13520.0,2,3784,0,13515.0,4,13520.0,9,S
2018-04-03 22:37:01,13515.0,18,3802,2,13510.0,17,13515.0,1,S
2018-04-03 22:37:01,13515.0,2,3804,0,13515.0,2,13520.0,13,S
2018-04-03 22:37:03,13515.0,4,3808,4,13510.0,17,13515.0,3,S
2018-04-03 22:37:07,13515.0,2,3810,2,13510.0,17,13515.0,2,S
2018-04-03 22:37:12,13515.0,2,3812,2,13510.0,17,13515.0,1,S
2018-04-03 22:37:13,13515.0,2,3814,2,13510.0,17,13520.0,13,S
2018-04-03 22:37:22,13515.0,2,3816,0,13510.0,17,13520.0,13,S
2018-04-03 22:38:07,13515.0,2,3818,0,13515.0,4,13520.0,11,S
2018-04-03 22:38:13,13515.0,2,3820,-2,13515.0,3,13520.0,13,S
2018-04-03 22:38:14,13515.0,6,3826,0,13510.0,8,13520.0,16,S
2018-04-03 22:38:39,13515.0,2,3828,0,13510.0,7,13515.0,2,S
2018-04-03 22:38:59,13510.0,2,3830,0,13510.0,7,13515.0,4,S
2018-04-03 22:39:06,13515.0,8,3838,4,13510.0,21,13520.0,15,B
2018-04-03 22:39:28,13515.0,2,3840,0,13510.0,20,13520.0,15,B
2018-04-03 22:40:19,13520.0,30,3870,-6,13520.0,5,13525.0,7,B
2018-04-03 22:40:29,13520.0,10,3880,0,13515.0,22,13520.0,5,B
2018-04-03 22:40:29,13520.0,8,3888,6,13515.0,22,13520.0,1,B
2018-04-03 22:40:30,13520.0,2,3890,0,13515.0,22,13525.0,6,B
2018-04-03 22:40:37,13525.0,12,3902,-6,13515.0,26,13525.0,2,B
2018-04-03 22:40:38,13530.0,14,3916,-2,13530.0,10,13535.0,12,B
2018-04-03 22:40:38,13530.0,12,3928,8,13530.0,3,13535.0,9,B
2018-04-03 22:40:39,13530.0,8,3936,0,13525.0,18,13530.0,5,B
2018-04-03 22:40:41,13535.0,2,3938,-2,13530.0,1,13535.0,12,B
2018-04-03 22:40:43,13535.0,2,3940,0,13530.0,17,13535.0,7,B
2018-04-03 22:40:43,13535.0,2,3942,0,13530.0,17,13535.0,6,B
2018-04-03 22:40:47,13535.0,2,3944,2,13530.0,18,13535.0,5,B
2018-04-03 22:40:52,13535.0,2,3946,0,13530.0,16,13535.0,3,B
2018-04-03 22:40:53,13535.0,6,3952,-2,13530.0,18,13540.0,16,B
2018-04-03 22:41:00,13530.0,2,3954,2,13530.0,3,13535.0,3,S
2018-04-03 22:41:02,13535.0,2,3956,0,13530.0,15,13540.0,15,B
2018-04-03 22:41:16,13530.0,2,3958,0,13525.0,6,13530.0,7,S
2018-04-03 22:41:18,13525.0,8,3966,-2,13520.0,6,13525.0,2,S
2018-04-03 22:41:20,13515.0,6,3972,4,13520.0,1,13525.0,2,S
2018-04-03 22:41:26,13520.0,2,3974,0,13520.0,16,13530.0,6,B
2018-04-03 22:41:45,13525.0,4,3978,0,13520.0,3,13530.0,16,B
2018-04-03 22:41:52,13525.0,2,3980,0,13520.0,6,13525.0,1,B
2018-04-03 22:41:59,13520.0,2,3982,2,13520.0,5,13525.0,1,S
2018-04-03 22:42:21,13525.0,2,3984,0,13520.0,13,13530.0,3,B
2018-04-03 22:43:10,13525.0,12,3996,0,13520.0,13,13530.0,16,B
2018-04-03 22:43:13,13525.0,4,4000,0,13520.0,10,13525.0,4,B
2018-04-03 22:43:18,13520.0,4,4004,-2,13520.0,5,13525.0,25,S
2018-04-03 22:43:18,13520.0,10,4014,-4,13515.0,9,13525.0,29,S
2018-04-03 22:43:53,13515.0,2,4016,-2,13510.0,7,13515.0,1,S
2018-04-03 22:44:19,13510.0,10,4026,2,13505.0,3,13515.0,22,S
2018-04-03 22:44:22,13505.0,2,4028,-2,13500.0,5,13505.0,1,S
2018-04-03 22:44:26,13500.0,4,4032,2,13500.0,3,13505.0,17,S
2018-04-03 22:44:26,13500.0,6,4038,6,13495.0,7,13500.0,8,S
2018-04-03 22:44:28,13500.0,2,4040,0,13495.0,7,13500.0,4,S
2018-04-03 22:44:28,13500.0,6,4046,6,13495.0,7,13500.0,1,S
2018-04-03 22:44:30,13495.0,6,4052,4,13495.0,5,13500.0,15,S
2018-04-03 22:44:31,13495.0,10,4062,-6,13495.0,1,13500.0,16,S
2018-04-03 22:44:31,13495.0,2,4064,0,13490.0,9,13500.0,6,S
2018-04-03 22:44:33,13500.0,2,4066,2,13495.0,24,13505.0,8,B
2018-04-03 22:44:44,13495.0,8,4074,6,13495.0,14,13505.0,5,S
2018-04-03 22:44:51,13505.0,6,4080,2,13500.0,2,13505.0,1,B
2018-04-03 22:44:58,13505.0,2,4082,0,13500.0,2,13510.0,8,B
2018-04-03 22:45:06,13510.0,6,4088,0,13500.0,4,13510.0,2,B
2018-04-03 22:45:27,13500.0,2,4090,-2,13500.0,3,13510.0,2,S
2018-04-03 22:45:43,13505.0,14,4104,-6,13500.0,19,13505.0,1,B
2018-04-03 22:45:44,13505.0,2,4106,-2,13500.0,10,13510.0,3,B
2018-04-03 22:45:54,13510.0,2,4108,-2,13505.0,3,13510.0,2,B
2018-04-03 22:46:38,13510.0,4,4112,-4,13505.0,6,13515.0,21,B
2018-04-03 22:49:13,13510.0,10,4122,4,13510.0,8,13515.0,5,B
2018-04-03 22:49:21,13510.0,2,4124,2,13510.0,8,13515.0,5,B
2018-04-03 22:49:21,13510.0,2,4126,0,13510.0,7,13515.0,5,B
2018-04-03 22:49:22,13510.0,2,4128,0,13510.0,6,13515.0,5,B
2018-04-03 22:49:41,13515.0,10,4138,-2,13510.0,6,13515.0,2,B
2018-04-03 22:49:42,13510.0,10,4148,10,13510.0,1,13515.0,3,S
2018-04-03 22:50:04,13515.0,6,4154,-4,13510.0,1,13520.0,8,B
2018-04-03 22:50:05,13510.0,2,4156,0,13505.0,3,13510.0,2,S
2018-04-03 22:50:09,13510.0,4,4160,4,13505.0,6,13515.0,2,S
2018-04-03 22:50:44,13510.0,2,4162,-2,13510.0,1,13515.0,2,S
2018-04-03 22:51:01,13515.0,4,4166,-4,13510.0,1,13520.0,18,B
2018-04-03 22:51:02,13510.0,2,4168,0,13505.0,6,13510.0,1,S
2018-04-03 22:51:02,13510.0,2,4170,2,13505.0,6,13520.0,6,S
2018-04-03 22:52:03,13510.0,8,4178,-6,13510.0,4,13515.0,14,S
2018-04-03 22:52:03,13510.0,6,4184,-2,13510.0,1,13515.0,16,S
2018-04-03 22:52:07,13510.0,2,4186,-2,13505.0,4,13515.0,4,S
2018-04-03 22:52:29,13505.0,2,4188,0,13505.0,2,13510.0,8,S
2018-04-03 22:52:38,13505.0,10,4198,4,13500.0,11,13505.0,2,S
2018-04-03 22:52:38,13505.0,4,4202,0,13500.0,14,13515.0,15,S
2018-04-03 22:52:59,13515.0,2,4204,0,13510.0,1,13515.0,3,B
2018-04-03 22:53:21,13510.0,2,4206,0,13510.0,9,13515.0,2,S
2018-04-03 22:53:52,13510.0,2,4208,0,13510.0,8,13515.0,5,S
2018-04-03 22:54:30,13510.0,20,4228,0,13510.0,1,13515.0,4,S
2018-04-03 22:54:34,13510.0,2,4230,2,13505.0,6,13515.0,6,S
2018-04-03 22:54:49,13505.0,2,4232,2,13505.0,2,13510.0,8,S
2018-04-03 22:54:50,13505.0,2,4234,-2,13505.0,1,13510.0,8,S
2018-04-03 22:54:52,13505.0,2,4236,2,13505.0,1,13510.0,8,S
2018-04-03 22:55:05,13505.0,4,4240,4,13500.0,18,13505.0,6,S
2018-04-03 22:55:05,13505.0,2,4242,0,13500.0,17,13505.0,5,S
2018-04-03 22:55:12,13500.0,16,4258,-6,13490.0,7,13500.0,2,S
2018-04-03 22:55:12,13500.0,4,4262,0,13495.0,2,13505.0,2,S
2018-04-03 22:55:20,13500.0,6,4268,0,13495.0,2,13500.0,2,S
2018-04-03 22:55:22,13500.0,2,4270,2,13495.0,2,13500.0,3,S
2018-04-03 22:55:55,13500.0,2,4272,2,13495.0,2,13500.0,2,S
2018-04-03 22:56:11,13500.0,2,4274,-2,13495.0,2,13500.0,1,S
2018-04-03 22:56:13,13500.0,2,4276,-2,13495.0,3,13505.0,2,S
2018-04-03 22:57:05,13505.0,2,4278,-2,13500.0,6,13505.0,1,B
2018-04-03 22:57:29,13505.0,2,4280,-2,13500.0,19,13515.0,18,B
2018-04-03 22:58:00,13510.0,12,4292,-2,13500.0,11,13515.0,7,B
2018-04-03 22:58:02,13500.0,2,4294,-2,13500.0,1,13510.0,1,S
2018-04-03 22:58:28,13505.0,2,4296,0,13500.0,3,13510.0,4,B
2018-04-03 22:58:41,13510.0,2,4298,-2,13500.0,4,13510.0,3,B
2018-04-03 22:58:48,13510.0,6,4304,-4,13510.0,1,13515.0,16,B
2018-04-03 22:58:48,13510.0,2,4306,0,13500.0,4,13515.0,16,B
2018-04-03 22:59:00,13510.0,2,4308,0,13500.0,2,13510.0,1,B
2018-04-03 22:59:01,13510.0,2,4310,-2,13500.0,2,13515.0,16,B
2018-04-03 22:59:11,13510.0,2,4312,-2,13500.0,2,13515.0,18,B
2018-04-03 22:59:21,13510.0,2,4314,-2,13500.0,3,13515.0,18,B
2018-04-03 22:59:30,13490.0,10,4324,0,13490.0,26,13510.0,1,S
2018-04-03 22:59:40,13495.0,2,4326,-2,13490.0,2,13510.0,4,B
2018-04-03 22:59:50,13510.0,4,4330,-2,13490.0,2,13510.0,2,B
2018-04-04 09:00:01,13520.0,2,4332,2,13490.0,4,13520.0,4,B
2018-04-04 09:00:03,13495.0,2,4334,2,13495.0,5,13505.0,1,S
2018-04-04 09:00:05,13500.0,2,4336,2,13490.0,4,13505.0,18,B
2018-04-04 09:00:07,13490.0,8,4344,2,13485.0,1,13495.0,1,S
2018-04-04 09:00:08,13490.0,6,4350,0,13485.0,1,13490.0,1,S
2018-04-04 09:00:08,13490.0,2,4352,-2,13485.0,3,13495.0,1,S
2018-04-04 09:00:09,13485.0,6,4358,4,13480.0,6,13490.0,9,S
2018-04-04 09:00:12,13480.0,12,4370,10,13475.0,6,13485.0,13,S
2018-04-04 09:00:13,13480.0,6,4376,0,13475.0,6,13485.0,12,S
2018-04-04 09:00:14,13475.0,4,4380,-2,13475.0,5,13480.0,2,S
2018-04-04 09:00:14,13470.0,20,4400,10,13470.0,8,13480.0,5,S
2018-04-04 09:00:16,13470.0,2,4402,-2,13470.0,7,13475.0,4,S
2018-04-04 09:00:16,13470.0,12,4414,-2,13470.0,1,13475.0,9,S
2018-04-04 09:00:17,13470.0,2,4416,0,13465.0,4,13470.0,1,S
2018-04-04 09:00:17,13470.0,4,4420,-2,13465.0,3,13470.0,8,S
2018-04-04 09:00:19,13470.0,8,4428,8,13465.0,5,13475.0,27,S
2018-04-04 09:00:20,13465.0,2,4430,0,13465.0,7,13475.0,8,S
2018-04-04 09:00:22,13470.0,10,4440,0,13465.0,7,13475.0,1,B
2018-04-04 09:00:22,13465.0,2,4442,0,13465.0,6,13475.0,1,S
2018-04-04 09:00:23,13465.0,12,4454,-6,13460.0,1,13465.0,29,S
2018-04-04 09:00:23,13465.0,12,4466,-6,13460.0,1,13465.0,23,S
2018-04-04 09:00:24,13465.0,26,4492,-26,13460.0,3,13465.0,10,S
2018-04-04 09:00:25,13465.0,20,4512,0,13460.0,2,13470.0,6,S
2018-04-04 09:00:28,13470.0,2,4514,2,13465.0,3,13470.0,5,B
2018-04-04 09:00:30,13470.0,2,4516,2,13465.0,4,13470.0,4,B
2018-04-04 09:00:32,13470.0,8,4524,0,13470.0,6,13475.0,4,B
2018-04-04 09:00:36,13480.0,2,4526,2,13470.0,8,13480.0,1,B
2018-04-04 09:00:39,13480.0,2,4528,0,13470.0,7,13480.0,13,B
2018-04-04 09:00:45,13480.0,2,4530,0,13470.0,18,13480.0,9,B
2018-04-04 09:00:45,13470.0,2,4532,0,13470.0,17,13480.0,9,S
2018-04-04 09:00:50,13475.0,6,4538,0,13470.0,17,13480.0,2,B
2018-04-04 09:00:53,13480.0,2,4540,2,13475.0,10,13485.0,5,B
2018-04-04 09:00:55,13480.0,2,4542,0,13470.0,18,13480.0,1,B
2018-04-04 09:00:56,13480.0,2,4544,0,13475.0,10,13485.0,10,B
2018-04-04 09:01:02,13485.0,2,4546,0,13485.0,7,13490.0,2,B
2018-04-04 09:01:03,13490.0,4,4550,2,13485.0,8,13495.0,6,B
2018-04-04 09:01:05,13495.0,6,4556,0,13495.0,1,13505.0,12,B
2018-04-04 09:01:07,13500.0,2,4558,2,13495.0,2,13500.0,4,B
2018-04-04 09:01:07,13500.0,8,4566,0,13500.0,3,13510.0,12,B
2018-04-04 09:01:08,13500.0,2,4568,-2,13495.0,2,13510.0,16,B
2018-04-04 09:01:08,13500.0,2,4570,2,13495.0,2,13500.0,1,B
2018-04-04 09:01:09,13500.0,2,4572,0,13495.0,2,13505.0,4,B
2018-04-04 09:01:10,13500.0,2,4574,0,13500.0,1,13505.0,3,B
2018-04-04 09:01:11,13500.0,2,4576,0,13495.0,3,13505.0,3,B
2018-04-04 09:01:11,13495.0,10,4586,2,13490.0,4,13505.0,3,S
2018-04-04 09:01:16,13500.0,2,4588,0,13495.0,10,13505.0,5,B
2018-04-04 09:01:19,13495.0,10,4598,0,13490.0,1,13500.0,4,S
2018-04-04 09:01:20,13490.0,2,4600,2,13480.0,12,13490.0,1,S
2018-04-04 09:01:21,13490.0,2,4602,-2,13480.0,2,13495.0,5,S
2018-04-04 09:01:29,13490.0,2,4604,0,13480.0,5,13490.0,3,S
2018-04-04 09:01:29,13490.0,4,4608,0,13480.0,5,13490.0,1,S
2018-04-04 09:01:30,13490.0,2,4610,-2,13490.0,10,13495.0,2,S
2018-04-04 09:01:30,13495.0,4,4614,2,13490.0,10,13500.0,31,B
2018-04-04 09:01:32,13495.0,6,4620,0,13490.0,10,13500.0,6,B
2018-04-04 09:01:33,13500.0,12,4632,4,13495.0,1,13505.0,15,B
2018-04-04 09:01:34,13495.0,2,4634,-2,13495.0,1,13500.0,8,S
2018-04-04 09:01:34,13500.0,10,4644,8,13495.0,1,13505.0,16,B
2018-04-04 09:01:35,13500.0,2,4646,0,13495.0,1,13500.0,1,B
2018-04-04 09:01:36,13500.0,2,4648,2,13495.0,1,13500.0,1,B
2018-04-04 09:01:38,13500.0,2,4650,0,13495.0,2,13505.0,3,B
2018-04-04 09:01:38,13500.0,2,4652,0,13495.0,3,13500.0,3,B
2018-04-04 09:01:45,13500.0,2,4654,0,13495.0,2,13500.0,4,B
2018-04-04 09:01:46,13500.0,2,4656,0,13495.0,2,13500.0,3,B
2018-04-04 09:01:47,13495.0,4,4660,-2,13495.0,1,13500.0,3,S
2018-04-04 09:01:48,13495.0,2,4662,0,13495.0,1,13500.0,3,S
2018-04-04 09:01:48,13495.0,2,4664,0,13490.0,10,13500.0,3,S
2018-04-04 09:01:57,13500.0,8,4672,0,13500.0,2,13505.0,3,B
2018-04-04 09:01:57,13500.0,4,4676,-4,13495.0,2,13505.0,3,B
2018-04-04 09:02:01,13500.0,10,4686,-2,13490.0,14,13505.0,3,B
2018-04-04 09:02:11,13490.0,10,4696,-10,13490.0,6,13495.0,1,S
2018-04-04 09:02:21,13490.0,2,4698,-2,13490.0,6,13500.0,6,S
2018-04-04 09:02:36,13490.0,4,4702,0,13490.0,3,13495.0,5,S
2018-04-04 09:02:37,13490.0,6,4708,0,13480.0,6,13495.0,6,S
2018-04-04 09:02:47,13490.0,20,4728,-4,13480.0,4,13490.0,11,S
2018-04-04 09:02:48,13485.0,2,4730,2,13480.0,4,13490.0,1,S
2018-04-04 09:02:56,13480.0,20,4750,6,13475.0,12,13490.0,6,S
2018-04-04 09:03:02,13480.0,2,4752,-2,13480.0,5,13490.0,3,S
2018-04-04 09:03:07,13480.0,2,4754,0,13480.0,5,13490.0,1,S
2018-04-04 09:03:11,13480.0,2,4756,0,13480.0,9,13485.0,6,S
2018-04-04 09:03:12,13480.0,2,4758,-2,13480.0,8,13485.0,7,S
2018-04-04 09:03:13,13480.0,16,4774,-8,13470.0,22,13485.0,7,S
2018-04-04 09:03:16,13475.0,4,4778,0,13470.0,24,13475.0,3,S
2018-04-04 09:03:17,13480.0,8,4786,0,13480.0,6,13485.0,7,B
2018-04-04 09:03:17,13480.0,12,4798,-8,13470.0,24,13485.0,7,B
2018-04-04 09:03:20,13475.0,12,4810,-2,13475.0,4,13480.0,7,S
2018-04-04 09:03:21,13475.0,8,4818,0,13470.0,27,13480.0,4,S
2018-04-04 09:03:22,13480.0,10,4828,-2,13480.0,5,13485.0,3,B
2018-04-04 09:03:22,13480.0,10,4838,0,13470.0,27,13480.0,2,B
2018-04-04 09:03:23,13475.0,4,4842,0,13470.0,27,13480.0,9,S
2018-04-04 09:03:28,13480.0,12,4854,-2,13480.0,4,13485.0,14,B
2018-04-04 09:03:28,13480.0,4,4858,-4,13480.0,2,13485.0,14,B
2018-04-04 09:03:29,13480.0,6,4864,0,13470.0,23,13480.0,4,B
2018-04-04 09:03:36,13475.0,4,4868,2,13475.0,16,13480.0,19,S
2018-04-04 09:03:37,13480.0,18,4886,0,13475.0,17,13480.0,10,B
2018-04-04 09:03:37,13480.0,4,4890,0,13475.0,17,13480.0,8,B
2018-04-04 09:03:38,13480.0,16,4906,16,13475.0,17,13485.0,2,B
2018-04-04 09:03:44,13480.0,4,4910,0,13475.0,17,13480.0,1,B
2018-04-04 09:03:47,13480.0,2,4912,2,13475.0,14,13485.0,1,B
2018-04-04 09:03:58,13480.0,2,4914,2,13475.0,12,13485.0,16,B
2018-04-04 09:04:03,13475.0,2,4916,2,13475.0,10,13480.0,20,S
2018-04-04 09:04:06,13480.0,50,4966,28,13470.0,24,13480.0,10,B
2018-04-04 09:04:06,13475.0,12,4978,8,13470.0,24,13480.0,22,S
2018-04-04 09:04:08,13480.0,20,4998,0,13470.0,24,13480.0,15,B
2018-04-04 09:04:11,13470.0,48,5046,-8,13465.0,2,13475.0,6,S
2018-04-04 09:04:15,13470.0,2,5048,0,13465.0,6,13470.0,5,S
2018-04-04 09:04:17,13465.0,4,5052,2,13465.0,7,13470.0,5,S
2018-04-04 09:04:18,13465.0,6,5058,6,13460.0,8,13465.0,3,S
2018-04-04 09:04:18,13465.0,10,5068,-4,13465.0,3,13470.0,1,S
2018-04-04 09:04:20,13465.0,4,5072,-4,13460.0,10,13470.0,1,S
2018-04-04 09:04:21,13465.0,2,5074,-2,13460.0,11,13470.0,1,S
2018-04-04 09:04:22,13465.0,2,5076,-2,13465.0,2,13470.0,1,S
2018-04-04 09:04:24,13465.0,2,5078,0,13465.0,3,13470.0,1,S
2018-04-04 09:04:26,13470.0,8,5086,-6,13470.0,6,13480.0,25,B
2018-04-04 09:04:27,13470.0,2,5088,-2,13470.0,5,13475.0,12,B
2018-04-04 09:04:28,13470.0,10,5098,-8,13465.0,1,13475.0,12,B
2018-04-04 09:04:29,13465.0,2,5100,0,13465.0,2,13470.0,1,S
2018-04-04 09:04:32,13465.0,2,5102,0,13460.0,12,13470.0,2,S
2018-04-04 09:04:35,13465.0,2,5104,0,13460.0,9,13470.0,4,S
2018-04-04 09:04:40,13460.0,2,5106,0,13460.0,10,13470.0,7,S
2018-04-04 09:04:40,13460.0,4,5110,-2,13460.0,6,13470.0,7,S
2018-04-04 09:04:47,13460.0,6,5116,6,13460.0,4,13470.0,7,S
2018-04-04 09:04:49,13455.0,18,5134,8,13450.0,7,13455.0,11,S
2018-04-04 09:04:49,13455.0,24,5158,8,13455.0,7,13470.0,12,S
2018-04-04 09:04:52,13455.0,6,5164,-4,13455.0,7,13465.0,12,S
2018-04-04 09:04:52,13465.0,4,5168,2,13460.0,1,13465.0,11,B
2018-04-04 09:04:54,13460.0,4,5172,-2,13455.0,7,13465.0,12,S
2018-04-04 09:04:55,13465.0,2,5174,0,13460.0,1,13465.0,11,B
2018-04-04 09:04:55,13465.0,20,5194,-6,13460.0,3,13465.0,1,B
2018-04-04 09:04:57,13465.0,2,5196,0,13460.0,5,13470.0,6,B
2018-04-04 09:05:06,13465.0,4,5200,4,13465.0,2,13470.0,5,B
2018-04-04 09:05:06,13470.0,14,5214,0,13460.0,9,13470.0,2,B
2018-04-04 09:05:10,13470.0,2,5216,2,13460.0,5,13470.0,1,B
2018-04-04 09:05:11,13460.0,4,5220,0,13460.0,4,13470.0,2,S
2018-04-04 09:05:15,13470.0,4,5224,4,13470.0,4,13475.0,5,B
2018-04-04 09:05:15,13475.0,2,5226,2,13470.0,4,13480.0,3,B
2018-04-04 09:05:27,13480.0,4,5230,0,13475.0,5,13480.0,3,B
2018-04-04 09:05:28,13480.0,6,5236,-2,13475.0,5,13485.0,3,B
2018-04-04 09:05:31,13480.0,2,5238,2,13475.0,2,13485.0,2,B
2018-04-04 09:05:35,13480.0,4,5242,0,13480.0,6,13485.0,5,B
2018-04-04 09:05:38,13480.0,2,5244,2,13480.0,5,13485.0,5,B
2018-04-04 09:05:43,13480.0,10,5254,8,13470.0,17,13485.0,4,B
2018-04-04 09:05:50,13475.0,2,5256,2,13470.0,12,13475.0,4,S
2018-04-04 09:06:23,13475.0,6,5262,2,13475.0,1,13480.0,22,S
2018-04-04 09:06:24,13475.0,2,5264,-2,13470.0,31,13480.0,22,S
2018-04-04 09:06:25,13475.0,10,5274,-8,13470.0,30,13475.0,1,S
2018-04-04 09:06:31,13475.0,4,5278,0,13475.0,1,13480.0,29,S
2018-04-04 09:06:32,13475.0,2,5280,-2,13470.0,30,13480.0,26,S
2018-04-04 09:06:37,13470.0,10,5290,-10,13470.0,25,13480.0,26,S
2018-04-04 09:06:45,13475.0,36,5326,0,13470.0,26,13475.0,2,B
2018-04-04 09:06:45,13475.0,4,5330,4,13475.0,4,13480.0,4,B
2018-04-04 09:06:50,13480.0,2,5332,0,13475.0,3,13480.0,2,B
2018-04-04 09:07:09,13475.0,4,5336,4,13470.0,27,13480.0,6,S
2018-04-04 09:07:10,13475.0,2,5338,-2,13470.0,26,13480.0,22,S
2018-04-04 09:07:11,13475.0,2,5340,-2,13470.0,26,13480.0,22,S
2018-04-04 09:07:21,13475.0,2,5342,0,13470.0,26,13480.0,10,S
2018-04-04 09:07:38,13475.0,8,5350,0,13470.0,26,13475.0,6,S
2018-04-04 09:07:47,13470.0,2,5352,0,13470.0,25,13475.0,7,S
2018-04-04 09:07:55,13475.0,10,5362,0,13470.0,25,13475.0,2,B
2018-04-04 09:07:56,13475.0,4,5366,0,13470.0,25,13480.0,9,B
2018-04-04 09:08:13,13475.0,2,5368,0,13475.0,1,13480.0,11,B
2018-04-04 09:08:14,13475.0,2,5370,0,13470.0,25,13480.0,11,B
2018-04-04 09:08:24,13475.0,10,5380,-4,13470.0,25,13475.0,2,B
2018-04-04 09:08:30,13475.0,2,5382,0,13475.0,2,13480.0,10,B
2018-04-04 09:08:34,13475.0,2,5384,2,13475.0,1,13480.0,10,B
2018-04-04 09:08:50,13475.0,6,5390,2,13470.0,28,13480.0,12,B
2018-04-04 09:08:57,13475.0,2,5392,0,13470.0,28,13480.0,11,B
2018-04-04 09:09:23,13480.0,2,5394,0,13475.0,12,13480.0,8,B
2018-04-04 09:09:41,13475.0,16,5410,-6,13475.0,7,13480.0,8,S
2018-04-04 09:09:47,13480.0,8,5418,0,13475.0,7,13480.0,4,B
2018-04-04 09:10:00,13480.0,2,5420,0,13475.0,7,13480.0,3,B
2018-04-04 09:10:04,13480.0,6,5426,0,13480.0,1,13485.0,4,B
2018-04-04 09:10:05,13485.0,8,5434,8,13485.0,6,13490.0,19,B
2018-04-04 09:10:05,13485.0,4,5438,4,13485.0,4,13490.0,20,B
2018-04-04 09:10:18,13490.0,2,5440,2,13485.0,4,13495.0,6,B
2018-04-04 09:10:32,13495.0,6,5446,-4,13485.0,7,13495.0,9,B
2018-04-04 09:11:00,13490.0,2,5448,-2,13485.0,6,13495.0,5,S
2018-04-04 09:11:24,13490.0,8,5456,4,13485.0,2,13490.0,8,S
2018-04-04 09:11:29,13485.0,2,5458,2,13485.0,1,13490.0,8,S
2018-04-04 09:11:40,13485.0,2,5460,2,13480.0,5,13490.0,9,S
2018-04-04 09:11:47,13485.0,2,5462,0,13485.0,1,13490.0,9,S
2018-04-04 09:11:56,13490.0,2,5464,2,13485.0,5,13490.0,4,B
2018-04-04 09:11:56,13490.0,8,5472,2,13490.0,7,13495.0,6,B
2018-04-04 09:12:04,13490.0,4,5476,4,13490.0,4,13495.0,2,B
2018-04-04 09:12:17,13495.0,6,5482,-6,13490.0,4,13500.0,9,B
2018-04-04 09:12:18,13490.0,6,5488,2,13490.0,1,13500.0,11,S
2018-04-04 09:12:22,13495.0,2,5490,-2,13490.0,2,13495.0,3,B
2018-04-04 09:12:25,13490.0,2,5492,0,13485.0,2,13490.0,4,S
2018-04-04 09:12:56,13490.0,4,5496,0,13485.0,7,13490.0,4,S
2018-04-04 09:13:07,13485.0,10,5506,0,13480.0,3,13490.0,5,S
2018-04-04 09:13:43,13490.0,6,5512,-2,13485.0,8,13490.0,2,B
2018-04-04 09:13:44,13490.0,4,5516,0,13485.0,9,13495.0,5,B
2018-04-04 09:13:53,13495.0,2,5518,-2,13495.0,2,13500.0,11,B
2018-04-04 09:14:02,13500.0,2,5520,2,13495.0,4,13500.0,6,B
2018-04-04 09:14:03,13500.0,2,5522,2,13495.0,5,13500.0,5,B
2018-04-04 09:14:06,13495.0,2,5524,0,13495.0,3,13500.0,5,S
2018-04-04 09:14:06,13495.0,4,5528,-4,13495.0,1,13500.0,5,S
2018-04-04 09:14:07,13495.0,2,5530,0,13495.0,1,13500.0,5,S
2018-04-04 09:14:11,13495.0,4,5534,4,13490.0,4,13495.0,3,S
2018-04-04 09:14:12,13495.0,4,5538,0,13490.0,4,13495.0,1,S
2018-04-04 09:14:19,13495.0,2,5540,0,13490.0,3,13500.0,7,S
2018-04-04 09:14:28,13495.0,2,5542,0,13490.0,5,13495.0,2,S
2018-04-04 09:14:29,13495.0,4,5546,-4,13490.0,3,13500.0,12,S
2018-04-04 09:14:52,13500.0,20,5566,-6,13490.0,15,13500.0,11,B
2018-04-04 09:15:13,13500.0,22,5588,22,13500.0,9,13505.0,6,B
2018-04-04 09:15:16,13505.0,8,5596,-2,13505.0,16,13510.0,18,B
2018-04-04 09:15:17,13510.0,4,5600,-4,13505.0,17,13510.0,1,B
2018-04-04 09:15:18,13510.0,4,5604,2,13505.0,17,13515.0,13,B
2018-04-04 09:15:19,13510.0,4,5608,-4,13505.0,17,13515.0,13,B
2018-04-04 09:15:21,13515.0,32,5640,-4,13515.0,2,13520.0,14,B
2018-04-04 09:15:21,13515.0,4,5644,-4,13505.0,2,13515.0,3,B
2018-04-04 09:15:29,13510.0,22,5666,-6,13505.0,5,13515.0,2,S
2018-04-04 09:15:42,13510.0,2,5668,0,13505.0,8,13515.0,2,S
2018-04-04 09:15:47,13515.0,4,5672,0,13515.0,8,13520.0,6,B
2018-04-04 09:15:50,13515.0,2,5674,0,13515.0,7,13520.0,5,B
2018-04-04 09:15:58,13515.0,2,5676,-2,13515.0,6,13520.0,4,B
2018-04-04 09:15:59,13515.0,12,5688,0,13510.0,10,13520.0,4,B
2018-04-04 09:16:02,13515.0,2,5690,0,13515.0,7,13520.0,13,B
2018-04-04 09:16:02,13515.0,8,5698,0,13515.0,3,13520.0,10,B
2018-04-04 09:16:06,13515.0,6,5704,0,13510.0,2,13520.0,8,B
2018-04-04 09:16:18,13515.0,2,5706,2,13510.0,2,13520.0,8,B
2018-04-04 09:16:23,13520.0,2,5708,2,13510.0,6,13520.0,7,B
2018-04-04 09:16:26,13520.0,6,5714,-2,13515.0,5,13525.0,4,B
2018-04-04 09:16:33,13515.0,2,5716,0,13515.0,2,13525.0,7,S
2018-04-04 09:16:39,13520.0,2,5718,0,13510.0,7,13520.0,7,B
2018-04-04 09:16:41,13520.0,2,5720,0,13510.0,6,13520.0,5,B
2018-04-04 09:16:43,13520.0,2,5722,-2,13510.0,6,13520.0,5,B
2018-04-04 09:16:59,13515.0,2,5724,0,13510.0,4,13520.0,3,S
2018-04-04 09:16:59,13510.0,2,5726,0,13510.0,5,13520.0,3,S
2018-04-04 09:17:00,13515.0,2,5728,2,13510.0,5,13520.0,3,B
2018-04-04 09:17:03,13515.0,2,5730,-2,13515.0,3,13520.0,2,B
2018-04-04 09:17:04,13515.0,2,5732,0,13510.0,2,13520.0,3,B
2018-04-04 09:17:04,13510.0,2,5734,0,13505.0,5,13515.0,9,S
2018-04-04 09:17:06,13505.0,2,5736,0,13500.0,15,13510.0,1,S
2018-04-04 09:17:14,13515.0,2,5738,0,13505.0,4,13515.0,5,B
2018-04-04 09:17:27,13515.0,4,5742,2,13505.0,5,13515.0,4,B
2018-04-04 09:17:44,13515.0,2,5744,0,13510.0,6,13520.0,10,B
2018-04-04 09:17:49,13510.0,4,5748,4,13505.0,7,13515.0,1,S
2018-04-04 09:18:09,13510.0,2,5750,0,13510.0,3,13520.0,7,S
2018-04-04 09:18:10,13510.0,2,5752,0,13510.0,4,13520.0,8,S
2018-04-04 09:18:14,13520.0,6,5758,6,13515.0,6,13525.0,5,B
2018-04-04 09:18:14,13525.0,2,5760,2,13525.0,1,13530.0,12,B
2018-04-04 09:18:15,13535.0,28,5788,18,13535.0,3,13540.0,9,B
2018-04-04 09:18:15,13535.0,12,5800,0,13530.0,4,13540.0,11,B
2018-04-04 09:18:16,13530.0,4,5804,2,13525.0,1,13535.0,7,S
2018-04-04 09:18:22,13540.0,20,5824,-2,13525.0,7,13540.0,12,B
2018-04-04 09:18:27,13535.0,2,5826,0,13535.0,1,13540.0,2,S
2018-04-04 09:18:29,13540.0,2,5828,0,13535.0,4,13545.0,13,B
2018-04-04 09:18:41,13540.0,2,5830,-2,13535.0,3,13540.0,4,B
2018-04-04 09:18:45,13545.0,8,5838,0,13540.0,3,13545.0,6,B
2018-04-04 09:18:46,13545.0,2,5840,0,13540.0,3,13545.0,5,B
2018-04-04 09:18:46,13545.0,12,5852,10,13545.0,1,13550.0,16,B
2018-04-04 09:18:48,13545.0,2,5854,0,13540.0,7,13550.0,15,B
2018-04-04 09:18:51,13545.0,6,5860,-2,13540.0,3,13545.0,7,B
2018-04-04 09:18:53,13545.0,2,5862,0,13540.0,2,13545.0,1,B
2018-04-04 09:18:54,13550.0,8,5870,0,13540.0,2,13550.0,30,B
2018-04-04 09:19:01,13545.0,2,5872,0,13545.0,2,13550.0,33,S
2018-04-04 09:19:02,13545.0,4,5876,4,13540.0,4,13545.0,9,S
2018-04-04 09:19:03,13540.0,4,5880,0,13535.0,5,13545.0,7,S
2018-04-04 09:19:12,13535.0,2,5882,-2,13535.0,1,13540.0,2,S
2018-04-04 09:19:13,13535.0,2,5884,2,13530.0,13,13535.0,1,S
2018-04-04 09:19:16,13530.0,6,5890,-4,13530.0,8,13535.0,7,S
2018-04-04 09:19:18,13530.0,2,5892,0,13530.0,7,13535.0,4,S
2018-04-04 09:19:21,13530.0,8,5900,-8,13530.0,3,13535.0,8,S
2018-04-04 09:19:22,13535.0,2,5902,0,13530.0,3,13535.0,7,B
2018-04-04 09:19:22,13530.0,2,5904,0,13530.0,2,13535.0,7,S
2018-04-04 09:19:25,13535.0,2,5906,0,13530.0,2,13535.0,6,B
2018-04-04 09:19:42,13530.0,2,5908,0,13530.0,2,13535.0,2,S
2018-04-04 09:19:44,13535.0,4,5912,-2,13535.0,1,13540.0,7,B
2018-04-04 09:19:44,13535.0,2,5914,-2,13530.0,1,13535.0,9,B
2018-04-04 09:19:45,13530.0,2,5916,0,13525.0,8,13530.0,2,S
2018-04-04 09:19:59,13525.0,10,5926,-8,13525.0,1,13530.0,3,S
2018-04-04 09:20:17,13525.0,2,5928,-2,13525.0,1,13530.0,10,S
2018-04-04 09:20:20,13525.0,4,5932,0,13520.0,18,13525.0,8,S
2018-04-04 09:20:21,13525.0,2,5934,0,13520.0,16,13525.0,7,S
2018-04-04 09:20:23,13525.0,2,5936,0,13520.0,14,13525.0,6,S
2018-04-04 09:20:24,13520.0,2,5938,-2,13520.0,13,13525.0,6,S
2018-04-04 09:20:32,13530.0,24,5962,14,13525.0,4,13530.0,5,B
2018-04-04 09:20:32,13525.0,2,5964,0,13525.0,2,13530.0,4,S
2018-04-04 09:20:35,13530.0,8,5972,8,13525.0,4,13535.0,6,B
2018-04-04 09:21:01,13530.0,2,5974,2,13530.0,2,13540.0,8,B
2018-04-04 09:21:10,13530.0,2,5976,0,13530.0,4,13535.0,4,B
2018-04-04 09:21:18,13530.0,2,5978,0,13530.0,3,13535.0,7,B
2018-04-04 09:21:19,13530.0,6,5984,-6,13525.0,4,13530.0,12,B
2018-04-04 09:21:25,13520.0,2,5986,0,13520.0,8,13525.0,4,S
2018-04-04 09:21:36,13520.0,2,5988,0,13520.0,8,13530.0,6,S
2018-04-04 09:21:46,13530.0,4,5992,2,13525.0,4,13530.0,1,B
2018-04-04 09:21:47,13530.0,2,5994,2,13525.0,6,13535.0,6,B
2018-04-04 09:21:47,13530.0,2,5996,0,13525.0,6,13535.0,4,B
2018-04-04 09:22:09,13530.0,4,6000,4,13525.0,3,13530.0,5,B
2018-04-04 09:22:29,13530.0,2,6002,0,13525.0,2,13530.0,4,B
2018-04-04 09:23:04,13520.0,18,6020,4,13515.0,3,13525.0,5,S
2018-04-04 09:23:17,13515.0,4,6024,2,13510.0,3,13520.0,5,S
2018-04-04 09:23:20,13520.0,2,6026,2,13510.0,2,13520.0,6,B
2018-04-04 09:23:50,13510.0,2,6028,0,13510.0,4,13515.0,1,S
2018-04-04 09:23:53,13510.0,2,6030,0,13510.0,3,13520.0,8,S
2018-04-04 09:24:03,13515.0,2,6032,2,13515.0,1,13520.0,8,B
2018-04-04 09:24:04,13520.0,4,6036,0,13520.0,3,13525.0,9,B
2018-04-04 09:24:04,13520.0,2,6038,-2,13520.0,2,13525.0,10,B
2018-04-04 09:24:05,13520.0,4,6042,0,13515.0,2,13525.0,7,B
2018-04-04 09:24:12,13515.0,2,6044,2,13510.0,4,13515.0,4,S
2018-04-04 09:24:22,13510.0,2,6046,0,13510.0,4,13515.0,4,S
2018-04-04 09:24:23,13515.0,2,6048,2,13510.0,3,13515.0,3,B
2018-04-04 09:24:37,13515.0,2,6050,0,13510.0,3,13515.0,3,B
2018-04-04 09:24:38,13520.0,14,6064,8,13515.0,1,13520.0,1,B
2018-04-04 09:24:42,13515.0,2,6066,0,13510.0,21,13520.0,2,S
2018-04-04 09:24:51,13515.0,2,6068,-2,13510.0,9,13520.0,16,S
2018-04-04 09:24:57,13520.0,20,6088,0,13510.0,7,13520.0,7,B
2018-04-04 09:25:22,13520.0,4,6092,0,13520.0,3,13525.0,4,B
2018-04-04 09:25:23,13530.0,8,6100,4,13520.0,3,13530.0,9,B
2018-04-04 09:25:30,13520.0,2,6102,2,13520.0,4,13530.0,13,S
2018-04-04 09:25:34,13520.0,10,6112,6,13515.0,18,13520.0,5,S
2018-04-04 09:25:45,13525.0,12,6124,10,13515.0,13,13525.0,4,B
2018-04-04 09:26:12,13520.0,2,6126,0,13515.0,5,13520.0,11,S
2018-04-04 09:26:21,13515.0,8,6134,2,13510.0,4,13515.0,1,S
2018-04-04 09:26:44,13510.0,8,6142,4,13505.0,3,13510.0,6,S
2018-04-04 09:26:44,13510.0,12,6154,12,13505.0,5,13515.0,5,S
2018-04-04 09:26:48,13510.0,2,6156,0,13510.0,1,13515.0,4,S
2018-04-04 09:26:52,13510.0,2,6158,0,13510.0,1,13515.0,3,S
2018-04-04 09:27:04,13510.0,2,6160,0,13505.0,6,13515.0,5,S
2018-04-04 09:27:33,13505.0,2,6162,0,13505.0,1,13510.0,6,S
2018-04-04 09:27:39,13505.0,4,6166,4,13500.0,13,13505.0,3,S
2018-04-04 09:27:40,13505.0,2,6168,0,13500.0,12,13510.0,6,S
2018-04-04 09:27:47,13505.0,2,6170,-2,13500.0,13,13505.0,1,S
2018-04-04 09:27:51,13505.0,4,6174,-2,13505.0,5,13510.0,8,S
2018-04-04 09:28:02,13510.0,6,6180,-4,13505.0,5,13510.0,5,B
2018-04-04 09:28:12,13510.0,2,6182,-2,13500.0,16,13510.0,12,B
2018-04-04 09:28:14,13510.0,10,6192,-4,13500.0,16,13510.0,8,B
2018-04-04 09:28:17,13510.0,4,6196,2,13505.0,8,13510.0,7,B
2018-04-04 09:28:20,13505.0,2,6198,2,13505.0,2,13510.0,6,S
2018-04-04 09:28:32,13505.0,4,6202,0,13500.0,20,13510.0,8,S
2018-04-04 09:28:54,13505.0,4,6206,4,13500.0,16,13505.0,1,S
2018-04-04 09:28:54,13505.0,2,6208,0,13500.0,16,13510.0,11,S
2018-04-04 09:28:55,13510.0,2,6210,2,13505.0,1,13510.0,6,B
2018-04-04 09:29:08,13505.0,2,6212,0,13500.0,16,13505.0,4,S
2018-04-04 09:29:11,13505.0,2,6214,2,13500.0,28,13505.0,3,S
2018-04-04 09:29:11,13505.0,6,6220,2,13500.0,28,13510.0,6,S
2018-04-04 09:30:00,13500.0,2,6222,0,13500.0,14,13505.0,4,S
2018-04-04 09:30:05,13505.0,8,6230,-4,13500.0,14,13510.0,11,B
2018-04-04 09:30:08,13510.0,8,6238,4,13505.0,6,13510.0,2,B
2018-04-04 09:30:08,13510.0,2,6240,0,13505.0,6,13510.0,1,B
2018-04-04 09:30:22,13510.0,2,6242,0,13505.0,5,13515.0,6,B
2018-04-04 09:31:07,13515.0,2,6244,0,13510.0,3,13515.0,6,B
2018-04-04 09:31:24,13510.0,6,6250,-6,13505.0,7,13515.0,8,S
2018-04-04 09:31:25,13505.0,8,6258,2,13505.0,1,13510.0,14,S
2018-04-04 09:31:26,13505.0,2,6260,0,13500.0,14,13510.0,14,S
2018-04-04 09:31:39,13515.0,82,6342,-20,13515.0,36,13520.0,42,B
2018-04-04 09:31:40,13515.0,72,6414,-24,13505.0,1,13515.0,10,B
2018-04-04 09:32:09,13500.0,2,6416,2,13500.0,13,13505.0,2,S
2018-04-04 09:32:10,13500.0,16,6432,0,13500.0,4,13505.0,2,S
2018-04-04 09:32:10,13500.0,8,6440,-2,13495.0,4,13505.0,3,S
2018-04-04 09:32:12,13500.0,4,6444,0,13500.0,2,13505.0,6,S
2018-04-04 09:32:12,13500.0,4,6448,0,13495.0,4,13505.0,5,S
2018-04-04 09:32:18,13495.0,10,6458,-2,13490.0,14,13495.0,5,S
2018-04-04 09:32:19,13490.0,2,6460,0,13490.0,12,13495.0,5,S
2018-04-04 09:32:22,13495.0,8,6468,0,13490.0,12,13500.0,6,B
2018-04-04 09:32:23,13495.0,2,6470,0,13490.0,13,13495.0,1,B
2018-04-04 09:32:24,13495.0,2,6472,2,13495.0,2,13500.0,2,B
2018-04-04 09:32:40,13495.0,2,6474,0,13490.0,14,13495.0,4,B
2018-04-04 09:32:42,13495.0,2,6476,0,13490.0,14,13495.0,3,B
2018-04-04 09:32:43,13495.0,6,6482,0,13495.0,9,13500.0,16,B
2018-04-04 09:32:43,13495.0,18,6500,-14,13490.0,15,13495.0,2,B
2018-04-04 09:32:49,13495.0,6,6506,-6,13490.0,36,13495.0,1,B
2018-04-04 09:32:49,13495.0,2,6508,-2,13495.0,1,13500.0,4,B
2018-04-04 09:33:10,13500.0,2,6510,-2,13490.0,44,13500.0,1,B
2018-04-04 09:33:11,13495.0,2,6512,0,13490.0,44,13500.0,1,S
2018-04-04 09:33:14,13490.0,2,6514,0,13490.0,43,13500.0,2,S
2018-04-04 09:33:49,13500.0,2,6516,0,13495.0,1,13500.0,2,B
2018-04-04 09:34:02,13490.0,20,6536,0,13490.0,11,13500.0,2,S
2018-04-04 09:34:04,13500.0,4,6540,-2,13500.0,1,13505.0,6,B
2018-04-04 09:34:23,13500.0,48,6588,40,13495.0,8,13500.0,26,B
2018-04-04 09:34:24,13500.0,2,6590,0,13495.0,10,13500.0,25,B
2018-04-04 09:35:04,13495.0,4,6594,0,13495.0,5,13500.0,45,S
2018-04-04 09:35:20,13495.0,12,6606,6,13490.0,28,13495.0,4,S
2018-04-04 09:35:20,13500.0,16,6622,12,13495.0,8,13500.0,41,B
2018-04-04 09:36:01,13500.0,4,6626,2,13495.0,5,13500.0,39,B
2018-04-04 09:36:07,13500.0,4,6630,0,13495.0,9,13500.0,37,B
2018-04-04 09:36:08,13500.0,4,6634,4,13495.0,9,13500.0,35,B
2018-04-04 09:36:11,13500.0,2,6636,2,13495.0,9,13500.0,34,B
2018-04-04 09:36:14,13500.0,10,6646,0,13495.0,9,13500.0,29,B
2018-04-04 09:36:19,13500.0,2,6648,0,13495.0,28,13500.0,28,B
2018-04-04 09:36:20,13500.0,8,6656,8,13495.0,24,13500.0,24,B
2018-04-04 09:36:23,13500.0,4,6660,4,13495.0,22,13500.0,22,B
2018-04-04 09:36:27,13500.0,2,6662,2,13495.0,10,13500.0,21,B
2018-04-04 09:36:36,13500.0,2,6664,0,13495.0,9,13500.0,20,B
2018-04-04 09:37:06,13495.0,6,6670,-6,13495.0,3,13500.0,20,S
2018-04-04 09:37:57,13495.0,2,6672,0,13495.0,7,13500.0,20,S
2018-04-04 09:38:01,13495.0,2,6674,0,13495.0,6,13500.0,20,S
2018-04-04 09:38:25,13500.0,4,6678,4,13495.0,6,13500.0,20,B
2018-04-04 09:38:56,13500.0,2,6680,0,13495.0,6,13500.0,17,B
2018-04-04 09:39:14,13495.0,2,6682,0,13495.0,7,13500.0,19,S
2018-04-04 09:39:49,13500.0,10,6692,0,13495.0,7,13500.0,17,B
2018-04-04 09:39:50,13495.0,10,6702,2,13495.0,2,13500.0,17,S
2018-04-04 09:40:06,13500.0,4,6706,0,13495.0,4,13500.0,15,B
2018-04-04 09:40:07,13495.0,4,6710,0,13495.0,2,13500.0,15,S
2018-04-04 09:40:14,13500.0,4,6714,0,13495.0,2,13500.0,13,B
2018-04-04 09:40:15,13495.0,4,6718,0,13490.0,16,13500.0,13,S
2018-04-04 09:40:41,13500.0,2,6720,2,13490.0,14,13500.0,13,B
2018-04-04 09:41:54,13495.0,12,6732,2,13490.0,14,13500.0,8,S
2018-04-04 09:41:58,13495.0,2,6734,2,13490.0,12,13495.0,4,S
2018-04-04 09:42:18,13490.0,2,6736,-2,13490.0,11,13495.0,4,S
2018-04-04 09:42:23,13490.0,8,6744,2,13490.0,7,13500.0,14,S
2018-04-04 09:42:37,13495.0,2,6746,2,13490.0,9,13500.0,16,B
2018-04-04 09:42:47,13490.0,2,6748,2,13490.0,8,13500.0,16,S
2018-04-04 09:42:48,13500.0,2,6750,2,13490.0,8,13500.0,15,B
2018-04-04 09:43:00,13500.0,24,6774,-8,13490.0,8,13500.0,3,B
2018-04-04 09:43:47,13500.0,8,6782,-2,13490.0,11,13500.0,2,B
2018-04-04 09:44:25,13495.0,2,6784,0,13490.0,11,13500.0,3,S
2018-04-04 09:44:33,13490.0,10,6794,-2,13490.0,5,13495.0,1,S
2018-04-04 09:46:06,13495.0,2,6796,0,13490.0,6,13495.0,1,B
2018-04-04 09:46:39,13500.0,4,6800,-2,13495.0,5,13505.0,6,B
2018-04-04 09:47:05,13500.0,2,6802,2,13495.0,4,13500.0,2,B
2018-04-04 09:47:07,13500.0,4,6806,0,13500.0,4,13505.0,5,B
2018-04-04 09:47:07,13500.0,2,6808,-2,13500.0,3,13505.0,5,B
2018-04-04 09:48:20,13505.0,4,6812,0,13500.0,7,13510.0,1,B
2018-04-04 09:48:33,13510.0,2,6814,0,13505.0,7,13515.0,23,B
2018-04-04 09:48:55,13515.0,4,6818,4,13505.0,5,13515.0,23,B
2018-04-04 09:49:02,13505.0,2,6820,2,13500.0,7,13510.0,10,S
2018-04-04 09:49:42,13515.0,4,6824,0,13510.0,4,13515.0,23,B
2018-04-04 09:49:43,13510.0,4,6828,2,13505.0,1,13510.0,3,S
2018-04-04 09:49:43,13510.0,2,6830,-2,13505.0,2,13515.0,23,S
2018-04-04 09:50:06,13510.0,4,6834,0,13510.0,4,13515.0,21,S
2018-04-04 09:50:24,13510.0,4,6838,2,13505.0,2,13510.0,3,S
2018-04-04 09:50:25,13505.0,4,6842,2,13500.0,22,13510.0,5,S
2018-04-04 09:50:28,13505.0,2,6844,0,13505.0,1,13510.0,9,S
2018-04-04 09:51:30,13510.0,18,6862,-12,13505.0,1,13515.0,25,B
2018-04-04 09:52:09,13510.0,2,6864,-2,13510.0,2,13515.0,24,B
2018-04-04 09:52:42,13515.0,46,6910,-40,13510.0,1,13520.0,17,B
2018-04-04 09:52:46,13515.0,2,6912,0,13510.0,1,13515.0,1,B
2018-04-04 09:52:50,13510.0,2,6914,2,13505.0,18,13515.0,4,S
2018-04-04 09:52:51,13510.0,2,6916,0,13505.0,16,13510.0,1,S
2018-04-04 09:53:01,13510.0,2,6918,0,13505.0,36,13515.0,5,S
2018-04-04 09:53:46,13515.0,10,6928,-2,13505.0,24,13520.0,14,B
2018-04-04 09:53:49,13510.0,2,6930,0,13505.0,24,13515.0,4,S
2018-04-04 09:55:46,13510.0,2,6932,-2,13510.0,7,13515.0,1,S
2018-04-04 09:56:11,13515.0,2,6934,0,13510.0,7,13520.0,12,B
2018-04-04 09:56:23,13510.0,2,6936,-2,13510.0,2,13515.0,4,S
2018-04-04 09:56:24,13510.0,2,6938,2,13505.0,27,13515.0,5,S
2018-04-04 09:56:34,13510.0,2,6940,-2,13505.0,28,13515.0,5,S
2018-04-04 09:57:18,13505.0,2,6942,2,13505.0,23,13510.0,2,S
2018-04-04 09:57:37,13505.0,4,6946,4,13505.0,21,13510.0,3,S
2018-04-04 09:57:49,13515.0,2,6948,0,13510.0,9,13520.0,14,B
2018-04-04 09:58:02,13515.0,2,6950,-2,13510.0,7,13520.0,16,B
2018-04-04 09:58:44,13510.0,6,6956,-2,13505.0,25,13510.0,2,S
2018-04-04 09:58:48,13505.0,4,6960,0,13505.0,20,13510.0,2,S
2018-04-04 09:59:25,13510.0,8,6968,4,13505.0,23,13515.0,4,B
2018-04-04 09:59:37,13505.0,6,6974,0,13505.0,20,13515.0,6,S
2018-04-04 09:59:37,13515.0,12,6986,-4,13515.0,22,13520.0,40,B
2018-04-04 09:59:38,13505.0,46,7032,-12,13505.0,20,13515.0,3,S
2018-04-04 09:59:41,13510.0,2,7034,0,13505.0,20,13515.0,2,B
2018-04-04 10:01:04,13510.0,2,7036,2,13505.0,23,13515.0,3,B
2018-04-04 10:01:15,13515.0,4,7040,0,13510.0,3,13520.0,20,B
2018-04-04 10:03:32,13515.0,2,7042,-2,13515.0,5,13520.0,15,B
2018-04-04 10:03:36,13520.0,4,7046,0,13515.0,5,13520.0,13,B
2018-04-04 10:03:38,13515.0,2,7048,-2,13515.0,4,13520.0,13,S
2018-04-04 10:04:11,13515.0,2,7050,0,13515.0,2,13520.0,13,S
2018-04-04 10:04:35,13520.0,2,7052,0,13515.0,3,13520.0,12,B
2018-04-04 10:04:45,13520.0,18,7070,0,13515.0,9,13520.0,3,B
2018-04-04 10:04:45,13520.0,6,7076,0,13515.0,13,13525.0,4,B
2018-04-04 10:05:12,13525.0,2,7078,-2,13520.0,4,13525.0,2,B
2018-04-04 10:05:13,13525.0,2,7080,0,13520.0,4,13525.0,1,B
2018-04-04 10:05:36,13520.0,2,7082,0,13520.0,2,13525.0,9,S
2018-04-04 10:05:47,13520.0,2,7084,-2,13515.0,2,13520.0,4,S
2018-04-04 10:06:31,13510.0,12,7096,2,13505.0,18,13510.0,4,S
2018-04-04 10:06:32,13510.0,2,7098,0,13505.0,21,13510.0,4,S
2018-04-04 10:06:35,13510.0,2,7100,0,13505.0,24,13510.0,3,S
2018-04-04 10:06:36,13510.0,6,7106,6,13505.0,24,13515.0,1,S
2018-04-04 10:06:42,13510.0,6,7112,4,13505.0,24,13510.0,7,S
2018-04-04 10:06:43,13510.0,6,7118,0,13505.0,24,13510.0,4,S
2018-04-04 10:06:43,13510.0,2,7120,2,13505.0,24,13510.0,3,S
2018-04-04 10:06:44,13510.0,2,7122,2,13505.0,24,13510.0,2,S
2018-04-04 10:06:47,13505.0,20,7142,20,13505.0,14,13510.0,2,S
2018-04-04 10:06:53,13505.0,20,7162,10,13505.0,4,13510.0,2,S
2018-04-04 10:07:02,13510.0,6,7168,6,13505.0,5,13515.0,1,B
2018-04-04 10:07:02,13505.0,12,7180,4,13500.0,16,13505.0,4,S
2018-04-04 10:07:03,13505.0,8,7188,6,13505.0,6,13510.0,1,S
2018-04-04 10:07:04,13510.0,2,7190,0,13510.0,1,13515.0,2,B
2018-04-04 10:07:08,13510.0,2,7192,2,13510.0,2,13520.0,9,B
2018-04-04 10:07:10,13510.0,4,7196,4,13505.0,22,13510.0,8,B
2018-04-04 10:07:12,13510.0,10,7206,0,13505.0,20,13510.0,3,B
2018-04-04 10:07:13,13510.0,2,7208,2,13505.0,20,13510.0,2,B
2018-04-04 10:07:15,13505.0,20,7228,20,13505.0,14,13510.0,2,S
2018-04-04 10:07:21,13505.0,20,7248,8,13500.0,8,13510.0,2,S
2018-04-04 10:07:25,13500.0,20,7268,8,13500.0,3,13510.0,3,S
2018-04-04 10:07:38,13505.0,2,7270,0,13500.0,3,13510.0,4,B
2018-04-04 10:08:18,13505.0,4,7274,4,13500.0,23,13505.0,8,B
2018-04-04 10:08:36,13500.0,20,7294,20,13500.0,12,13510.0,3,S
2018-04-04 10:08:58,13505.0,4,7298,-2,13500.0,12,13510.0,9,B
2018-04-04 10:10:03,13510.0,4,7302,0,13510.0,1,13515.0,8,B
2018-04-04 10:10:04,13510.0,4,7306,-4,13505.0,15,13515.0,8,B
2018-04-04 10:10:16,13510.0,16,7322,-12,13500.0,15,13510.0,1,B
2018-04-04 10:11:12,13510.0,4,7326,4,13505.0,6,13510.0,3,B
2018-04-04 10:11:22,13505.0,4,7330,-4,13505.0,10,13515.0,5,S
2018-04-04 10:11:51,13505.0,2,7332,-2,13510.0,1,13515.0,5,S
2018-04-04 10:11:52,13510.0,2,7334,-2,13505.0,6,13515.0,5,B
2018-04-04 10:12:57,13515.0,6,7340,-2,13510.0,6,13520.0,5,B
2018-04-04 10:13:04,13515.0,6,7346,-6,13510.0,5,13520.0,4,B
2018-04-04 10:13:12,13515.0,2,7348,-2,13505.0,12,13515.0,3,B
2018-04-04 10:13:43,13515.0,4,7352,-2,13515.0,7,13520.0,20,B
2018-04-04 10:13:43,13515.0,8,7360,-2,13515.0,3,13520.0,20,B
2018-04-04 10:13:44,13515.0,6,7366,0,13505.0,13,13520.0,20,B
2018-04-04 10:13:54,13520.0,4,7370,2,13515.0,1,13520.0,12,B
2018-04-04 10:14:00,13520.0,2,7372,2,13515.0,9,13520.0,9,B
2018-04-04 10:14:00,13520.0,18,7390,16,13515.0,9,13525.0,6,B
2018-04-04 10:30:15,13520.0,2,7392,-2,13515.0,1,13520.0,2,B
2018-04-04 10:30:15,13520.0,4,7396,2,13515.0,6,13525.0,7,B
2018-04-04 10:30:16,13520.0,2,7398,0,13515.0,7,13520.0,19,B
2018-04-04 10:30:26,13515.0,2,7400,0,13515.0,1,13520.0,19,S
2018-04-04 10:30:42,13515.0,2,7402,2,13510.0,6,13520.0,19,S
2018-04-04 10:30:49,13510.0,2,7404,0,13510.0,4,13515.0,1,S
2018-04-04 10:31:09,13510.0,4,7408,4,13505.0,18,13515.0,6,S
2018-04-04 10:31:26,13505.0,8,7416,2,13505.0,14,13515.0,10,S
2018-04-04 10:31:45,13510.0,4,7420,0,13505.0,14,13510.0,2,B
2018-04-04 10:31:55,13505.0,4,7424,2,13505.0,12,13510.0,4,S
2018-04-04 10:31:56,13505.0,2,7426,-2,13505.0,11,13510.0,7,S
2018-04-04 10:32:26,13505.0,10,7436,2,13505.0,6,13510.0,3,S
2018-04-04 10:32:36,13505.0,10,7446,0,13505.0,1,13510.0,3,S
2018-04-04 10:32:54,13505.0,2,7448,0,13505.0,10,13510.0,3,S
2018-04-04 10:33:00,13505.0,10,7458,2,13505.0,1,13510.0,3,S
2018-04-04 10:33:19,13505.0,2,7460,0,13505.0,3,13510.0,3,S
2018-04-04 10:33:47,13510.0,2,7462,0,13505.0,1,13510.0,2,B
2018-04-04 10:34:12,13505.0,4,7466,2,13505.0,3,13510.0,2,S
2018-04-04 10:34:20,13505.0,4,7470,2,13505.0,3,13510.0,2,S
2018-04-04 10:34:36,13505.0,6,7476,6,13500.0,16,13505.0,1,S
2018-04-04 10:34:36,13505.0,4,7480,4,13500.0,16,13510.0,1,S
2018-04-04 10:34:43,13510.0,2,7482,0,13510.0,2,13515.0,8,B
2018-04-04 10:34:56,13510.0,2,7484,0,13505.0,7,13510.0,7,B
2018-04-04 10:34:57,13510.0,2,7486,2,13505.0,7,13510.0,6,B
2018-04-04 10:35:05,13510.0,2,7488,2,13505.0,6,13510.0,5,B
2018-04-04 10:35:10,13505.0,24,7512,24,13500.0,44,13505.0,18,S
2018-04-04 10:35:11,13505.0,4,7516,0,13500.0,44,13505.0,16,S
2018-04-04 10:35:12,13505.0,28,7544,28,13500.0,28,13505.0,2,S
2018-04-04 10:35:13,13505.0,4,7548,0,13505.0,3,13510.0,12,S
2018-04-04 10:35:20,13505.0,6,7554,0,13500.0,28,13505.0,1,S
2018-04-04 10:35:20,13505.0,2,7556,0,13500.0,28,13510.0,12,S
2018-04-04 10:35:28,13505.0,12,7568,10,13500.0,44,13505.0,24,S
2018-04-04 10:35:36,13505.0,24,7592,8,13500.0,28,13505.0,12,S
2018-04-04 10:35:37,13505.0,2,7594,2,13500.0,27,13505.0,11,S
2018-04-04 10:35:44,13500.0,10,7604,10,13500.0,22,13505.0,11,S
2018-04-04 10:35:57,13500.0,2,7606,2,13500.0,8,13505.0,11,S
2018-04-04 10:35:59,13500.0,16,7622,12,13495.0,16,13500.0,8,S
2018-04-04 10:36:05,13500.0,16,7638,16,13495.0,15,13505.0,2,S
2018-04-04 10:36:12,13505.0,4,7642,4,13505.0,8,13510.0,9,B
2018-04-04 10:36:12,13505.0,16,7658,6,13500.0,1,13510.0,12,B
2018-04-04 10:36:13,13495.0,22,7680,4,13495.0,6,13510.0,15,S
2018-04-04 10:36:24,13495.0,14,7694,4,13490.0,12,13495.0,1,S
2018-04-04 10:36:25,13495.0,2,7696,2,13500.0,1,13505.0,3,S
2018-04-04 10:36:36,13500.0,2,7698,0,13495.0,18,13500.0,29,B
2018-04-04 10:36:36,13505.0,64,7762,-4,13500.0,1,13510.0,14,B
2018-04-04 10:36:43,13500.0,2,7764,0,13500.0,11,13505.0,7,S
2018-04-04 10:37:04,13500.0,20,7784,20,13500.0,1,13505.0,5,S
2018-04-04 10:37:17,13505.0,10,7794,0,13500.0,11,13510.0,12,B
2018-04-04 10:37:42,13505.0,4,7798,2,13500.0,3,13505.0,1,B
2018-04-04 10:37:48,13505.0,2,7800,0,13500.0,4,13505.0,1,B
2018-04-04 10:38:08,13505.0,2,7802,-2,13500.0,4,13505.0,1,B
2018-04-04 10:38:31,13505.0,2,7804,0,13500.0,4,13510.0,12,B
2018-04-04 10:38:32,13505.0,2,7806,0,13500.0,4,13510.0,12,B
2018-04-04 10:38:43,13510.0,18,7824,12,13505.0,1,13515.0,4,B
2018-04-04 10:38:45,13515.0,4,7828,-4,13510.0,1,13515.0,2,B
2018-04-04 10:39:00,13515.0,2,7830,0,13510.0,1,13520.0,6,B
2018-04-04 10:39:03,13520.0,2,7832,-2,13510.0,21,13520.0,5,B
2018-04-04 10:39:18,13515.0,2,7834,-2,13510.0,23,13520.0,12,S
2018-04-04 10:39:25,13515.0,2,7836,0,13510.0,6,13520.0,17,S
2018-04-04 10:40:05,13515.0,2,7838,2,13510.0,6,13515.0,7,S
2018-04-04 10:40:07,13515.0,2,7840,0,13510.0,6,13515.0,6,S
2018-04-04 10:40:08,13515.0,12,7852,-4,13510.0,7,13520.0,6,S
2018-04-04 10:40:09,13520.0,6,7858,-2,13515.0,8,13525.0,6,B
2018-04-04 10:40:16,13520.0,2,7860,0,13515.0,7,13525.0,2,B
2018-04-04 10:40:24,13520.0,2,7862,-2,13515.0,7,13525.0,5,B
2018-04-04 10:41:16,13510.0,4,7866,2,13510.0,2,13515.0,8,S
2018-04-04 10:41:16,13510.0,2,7868,2,13505.0,3,13515.0,7,S
2018-04-04 10:41:19,13515.0,2,7870,-2,13505.0,8,13515.0,4,B
2018-04-04 10:41:33,13520.0,2,7872,2,13510.0,6,13520.0,10,B
2018-04-04 10:42:16,13520.0,2,7874,0,13510.0,14,13520.0,13,B
2018-04-04 10:42:22,13520.0,2,7876,0,13510.0,14,13520.0,12,B
2018-04-04 10:42:32,13515.0,2,7878,-2,13510.0,8,13520.0,30,S
2018-04-04 10:42:54,13515.0,2,7880,0,13510.0,12,13520.0,29,S
2018-04-04 10:43:54,13520.0,2,7882,0,13515.0,1,13520.0,10,B
2018-04-04 10:43:55,13520.0,18,7900,8,13515.0,20,13525.0,12,B
2018-04-04 10:43:57,13525.0,18,7918,-8,13520.0,23,13530.0,7,B
2018-04-04 10:44:03,13525.0,4,7922,0,13520.0,2,13530.0,6,B
2018-04-04 10:44:32,13515.0,10,7932,6,13510.0,11,13515.0,2,S
2018-04-04 10:44:33,13510.0,8,7940,0,13510.0,11,13515.0,2,S
2018-04-04 10:44:34,13510.0,2,7942,0,13510.0,8,13515.0,3,S
2018-04-04 10:44:35,13515.0,2,7944,-2,13510.0,11,13520.0,3,B
2018-04-04 10:44:36,13520.0,2,7946,0,13515.0,3,13525.0,5,B
2018-04-04 10:45:06,13525.0,4,7950,-4,13520.0,4,13525.0,1,B
2018-04-04 10:45:06,13525.0,2,7952,-2,13520.0,5,13530.0,7,B
2018-04-04 10:45:27,13525.0,10,7962,10,13525.0,2,13530.0,5,B
2018-04-04 10:45:29,13525.0,4,7966,0,13520.0,2,13530.0,7,B
2018-04-04 10:45:43,13515.0,4,7970,2,13510.0,10,13515.0,3,S
2018-04-04 10:45:45,13515.0,2,7972,0,13510.0,11,13515.0,2,S
2018-04-04 10:45:53,13515.0,4,7976,4,13515.0,4,13520.0,2,S
2018-04-04 10:45:54,13520.0,2,7978,-2,13510.0,8,13520.0,5,B
2018-04-04 10:46:12,13515.0,4,7982,2,13510.0,28,13515.0,8,S
2018-04-04 10:46:12,13515.0,8,7990,0,13510.0,28,13515.0,4,S
2018-04-04 10:46:13,13515.0,2,7992,2,13510.0,18,13515.0,3,S
2018-04-04 10:46:14,13515.0,4,7996,4,13510.0,18,13515.0,1,S
2018-04-04 10:46:25,13515.0,2,7998,2,13510.0,17,13520.0,1,S
2018-04-04 10:46:33,13515.0,2,8000,0,13520.0,2,13530.0,11,S
2018-04-04 10:46:35,13520.0,2,8002,0,13520.0,1,13525.0,3,B
2018-04-04 10:46:36,13520.0,2,8004,-2,13515.0,2,13525.0,3,B
2018-04-04 10:46:45,13520.0,20,8024,20,13515.0,3,13525.0,3,B
2018-04-04 10:46:46,13525.0,2,8026,2,13520.0,6,13530.0,9,B
2018-04-04 10:46:48,13530.0,8,8034,2,13525.0,2,13530.0,4,B
2018-04-04 10:46:51,13525.0,2,8036,-2,13520.0,18,13530.0,4,S
2018-04-04 10:46:52,13525.0,2,8038,2,13520.0,5,13530.0,5,S
2018-04-04 10:46:57,13520.0,2,8040,2,13515.0,3,13520.0,1,S
2018-04-04 10:47:20,13515.0,8,8048,8,13510.0,42,13515.0,1,S
2018-04-04 10:47:21,13515.0,2,8050,0,13515.0,4,13525.0,2,S
2018-04-04 10:47:26,13515.0,6,8056,6,13515.0,1,13520.0,1,S
2018-04-04 10:47:27,13515.0,2,8058,2,13510.0,15,13515.0,2,S
2018-04-04 10:47:27,13510.0,2,8060,-2,13510.0,14,13515.0,3,S
2018-04-04 10:47:30,13515.0,2,8062,-2,13510.0,13,13520.0,5,B
2018-04-04 10:47:54,13510.0,12,8074,4,13510.0,24,13520.0,1,S
2018-04-04 10:47:59,13520.0,4,8078,0,13520.0,3,13525.0,8,B
2018-04-04 10:47:59,13520.0,6,8084,0,13510.0,27,13520.0,1,B
2018-04-04 10:48:01,13510.0,6,8090,4,13510.0,24,13520.0,1,S
2018-04-04 10:48:05,13515.0,2,8092,0,13510.0,11,13515.0,1,B
2018-04-04 10:48:12,13515.0,2,8094,0,13510.0,9,13520.0,7,B
2018-04-04 10:48:16,13510.0,18,8112,18,13505.0,5,13510.0,1,S
2018-04-04 10:48:17,13510.0,2,8114,0,13505.0,4,13515.0,3,S
2018-04-04 10:48:30,13515.0,2,8116,0,13515.0,4,13520.0,8,B
2018-04-04 10:48:48,13515.0,2,8118,0,13515.0,7,13520.0,8,B
2018-04-04 10:48:49,13515.0,14,8132,2,13510.0,5,13515.0,1,B
2018-04-04 10:49:07,13510.0,2,8134,0,13505.0,12,13510.0,3,S
2018-04-04 10:49:07,13510.0,6,8140,6,13505.0,10,13515.0,1,S
2018-04-04 10:49:08,13520.0,6,8146,0,13505.0,13,13520.0,3,B
2018-04-04 10:49:15,13515.0,2,8148,0,13510.0,2,13515.0,2,S
2018-04-04 10:49:26,13520.0,2,8150,0,13510.0,2,13520.0,5,B
2018-04-04 10:49:30,13510.0,2,8152,2,13505.0,9,13510.0,4,S
2018-04-04 10:49:31,13510.0,2,8154,2,13505.0,7,13510.0,3,S
2018-04-04 10:49:34,13510.0,2,8156,2,13505.0,5,13510.0,2,S
2018-04-04 10:49:35,13510.0,2,8158,2,13505.0,5,13510.0,1,S
2018-04-04 10:49:54,13510.0,2,8160,0,13505.0,5,13515.0,7,S
2018-04-04 10:50:00,13515.0,2,8162,-2,13505.0,5,13510.0,2,B
2018-04-04 10:50:05,13505.0,10,8172,6,13500.0,15,13510.0,2,S
2018-04-04 10:50:10,13505.0,2,8174,2,13500.0,9,13510.0,2,S
2018-04-04 10:50:16,13505.0,2,8176,0,13505.0,1,13510.0,3,S
2018-04-04 10:50:22,13510.0,2,8178,-2,13500.0,9,13510.0,5,B
2018-04-04 10:50:50,13500.0,2,8180,0,13500.0,5,13510.0,4,S
2018-04-04 10:51:19,13500.0,2,8182,0,13500.0,4,13510.0,4,S
2018-04-04 10:51:50,13510.0,2,8184,0,13505.0,3,13510.0,3,B
2018-04-04 10:51:54,13510.0,2,8186,-2,13505.0,3,13510.0,2,B
2018-04-04 10:52:00,13510.0,2,8188,-2,13505.0,3,13510.0,1,B
2018-04-04 10:52:08,13505.0,2,8190,0,13500.0,5,13510.0,5,S
2018-04-04 10:52:09,13505.0,2,8192,-2,13500.0,5,13510.0,6,S
2018-04-04 10:52:26,13505.0,2,8194,0,13500.0,6,13510.0,5,S
2018-04-04 10:53:00,13510.0,4,8198,-4,13500.0,7,13510.0,4,B
2018-04-04 10:53:00,13510.0,2,8200,-2,13500.0,7,13510.0,4,B
2018-04-04 10:53:27,13505.0,2,8202,-2,13500.0,10,13510.0,7,S
2018-04-04 10:53:42,13500.0,18,8220,-2,13495.0,2,13500.0,4,S
2018-04-04 10:53:55,13500.0,8,8228,-6,13495.0,2,13500.0,1,S
2018-04-04 10:54:33,13505.0,4,8232,0,13495.0,17,13505.0,1,B
2018-04-04 10:54:47,13505.0,8,8240,-2,13495.0,18,13510.0,17,B
2018-04-04 10:55:12,13505.0,2,8242,2,13500.0,1,13505.0,1,B
2018-04-04 10:55:28,13500.0,2,8244,2,13500.0,1,13505.0,1,S
2018-04-04 10:55:36,13505.0,2,8246,0,13500.0,17,13510.0,8,B
2018-04-04 10:57:06,13505.0,2,8248,0,13500.0,17,13510.0,7,B
2018-04-04 10:59:21,13505.0,2,8250,-2,13500.0,18,13510.0,2,B
2018-04-04 10:59:30,13505.0,2,8252,0,13500.0,18,13510.0,2,B
2018-04-04 10:59:32,13505.0,4,8256,0,13500.0,18,13510.0,2,B
2018-04-04 10:59:42,13505.0,2,8258,2,13500.0,6,13505.0,4,B
2018-04-04 10:59:52,13505.0,6,8264,4,13500.0,18,13505.0,1,B
2018-04-04 10:59:52,13505.0,2,8266,2,13500.0,32,13510.0,5,B
2018-04-04 11:00:37,13505.0,2,8268,0,13500.0,4,13510.0,5,B
2018-04-04 11:00:53,13500.0,2,8270,0,13495.0,6,13505.0,2,S
2018-04-04 11:01:27,13505.0,2,8272,0,13500.0,3,13505.0,3,B
2018-04-04 11:01:45,13505.0,4,8276,-4,13505.0,2,13510.0,8,B
2018-04-04 11:01:48,13510.0,2,8278,0,13505.0,2,13510.0,4,B
2018-04-04 11:01:48,13510.0,4,8282,2,13505.0,5,13510.0,2,B
2018-04-04 11:01:49,13510.0,4,8286,4,13505.0,5,13515.0,5,B
2018-04-04 11:03:05,13510.0,2,8288,-2,13505.0,3,13510.0,1,B
2018-04-04 11:03:18,13505.0,6,8294,-4,13500.0,17,13505.0,2,S
2018-04-04 11:03:18,13505.0,4,8298,0,13500.0,17,13510.0,2,S
2018-04-04 11:04:14,13505.0,2,8300,0,13500.0,6,13510.0,4,S
2018-04-04 11:05:00,13505.0,2,8302,0,13500.0,7,13510.0,2,S
2018-04-04 11:05:06,13505.0,4,8306,0,13500.0,35,13505.0,1,S
2018-04-04 11:05:07,13505.0,2,8308,2,13505.0,5,13510.0,1,S
2018-04-04 11:05:09,13505.0,2,8310,2,13505.0,12,13510.0,1,S
2018-04-04 11:05:22,13510.0,2,8312,0,13505.0,13,13515.0,10,B
2018-04-04 11:05:43,13515.0,20,8332,-14,13505.0,14,13520.0,34,B
2018-04-04 11:05:44,13515.0,4,8336,0,13505.0,14,13515.0,3,B
2018-04-04 11:05:51,13515.0,2,8338,0,13510.0,1,13520.0,34,B
2018-04-04 11:05:55,13510.0,4,8342,-2,13505.0,15,13515.0,4,S
2018-04-04 11:05:56,13515.0,20,8362,-10,13505.0,13,13510.0,1,B
2018-04-04 11:05:56,13510.0,2,8364,0,13505.0,13,13520.0,34,S
2018-04-04 11:06:04,13515.0,2,8366,2,13510.0,5,13515.0,4,B
2018-04-04 11:06:12,13510.0,2,8368,0,13505.0,14,13515.0,5,S
2018-04-04 11:06:54,13515.0,2,8370,2,13515.0,4,13520.0,25,B
2018-04-04 11:06:55,13515.0,8,8378,4,13510.0,3,13515.0,1,B
2018-04-04 11:07:02,13515.0,2,8380,-2,13515.0,1,13520.0,25,B
2018-04-04 11:07:19,13515.0,2,8382,0,13510.0,4,13520.0,24,B
2018-04-04 11:07:46,13510.0,10,8392,0,13510.0,1,13515.0,1,S
2018-04-04 11:07:51,13520.0,20,8412,-18,13510.0,5,13520.0,5,B
2018-04-04 11:07:52,13520.0,2,8414,2,13515.0,2,13520.0,3,B
2018-04-04 11:07:52,13520.0,2,8416,0,13515.0,2,13525.0,8,B
2018-04-04 11:07:56,13520.0,2,8418,0,13520.0,4,13525.0,5,B
2018-04-04 11:07:56,13520.0,8,8426,-8,13515.0,2,13525.0,5,B
2018-04-04 11:08:28,13510.0,2,8428,2,13510.0,1,13515.0,1,S
2018-04-04 11:09:11,13510.0,2,8430,0,13510.0,2,13515.0,4,S
2018-04-04 11:09:11,13510.0,2,8432,0,13510.0,1,13515.0,16,S
2018-04-04 11:09:12,13510.0,2,8434,0,13505.0,3,13515.0,16,S
2018-04-04 11:09:47,13510.0,2,8436,0,13505.0,1,13515.0,17,S
2018-04-04 11:09:51,13510.0,2,8438,0,13505.0,2,13510.0,3,S
2018-04-04 11:10:27,13505.0,8,8446,-8,13500.0,7,13510.0,3,S
2018-04-04 11:10:48,13505.0,2,8448,-2,13500.0,7,13510.0,6,S
2018-04-04 11:11:13,13510.0,6,8454,-4,13500.0,8,13510.0,3,B
2018-04-04 11:11:44,13505.0,2,8456,2,13505.0,1,13510.0,6,S
2018-04-04 11:11:46,13510.0,2,8458,0,13505.0,1,13510.0,4,B
2018-04-04 11:12:03,13505.0,2,8460,0,13500.0,14,13510.0,30,S
2018-04-04 11:12:34,13515.0,60,8520,-10,13500.0,15,13510.0,3,B
2018-04-04 11:12:42,13510.0,2,8522,2,13500.0,17,13510.0,3,S
2018-04-04 11:13:00,13505.0,2,8524,0,13500.0,17,13510.0,2,S
2018-04-04 11:13:20,13505.0,2,8526,0,13500.0,17,13510.0,2,S
2018-04-04 11:13:28,13505.0,2,8528,2,13500.0,17,13510.0,2,S
2018-04-04 11:13:56,13500.0,2,8530,0,13500.0,13,13505.0,2,S
2018-04-04 11:13:57,13500.0,16,8546,-12,13500.0,5,13505.0,2,S
2018-04-04 11:14:54,13505.0,6,8552,0,13500.0,19,13505.0,2,B
2018-04-04 11:14:55,13505.0,4,8556,4,13500.0,19,13510.0,13,B
2018-04-04 11:17:11,13500.0,2,8558,0,13500.0,5,13505.0,4,S
2018-04-04 11:17:11,13500.0,10,8568,-2,13495.0,9,13505.0,8,S
2018-04-04 11:17:16,13500.0,2,8570,0,13495.0,8,13505.0,9,S
2018-04-04 11:17:38,13505.0,10,8580,0,13495.0,8,13505.0,5,B
2018-04-04 11:17:48,13500.0,4,8584,-2,13495.0,8,13505.0,5,S
2018-04-04 11:18:11,13505.0,4,8588,-4,13500.0,5,13510.0,14,B
2018-04-04 11:18:46,13505.0,4,8592,-4,13500.0,3,13510.0,14,B
2018-04-04 11:19:35,13510.0,6,8598,-6,13500.0,4,13510.0,13,B
2018-04-04 11:19:52,13510.0,2,8600,0,13505.0,6,13510.0,9,B
2018-04-04 11:19:58,13510.0,2,8602,2,13505.0,3,13510.0,8,B
2018-04-04 11:20:01,13505.0,2,8604,0,13505.0,1,13510.0,10,S
2018-04-04 11:20:32,13505.0,2,8606,0,13500.0,19,13510.0,8,S
2018-04-04 11:21:36,13510.0,6,8612,0,13500.0,7,13510.0,9,B
2018-04-04 11:21:40,13500.0,16,8628,-14,13495.0,21,13510.0,7,S
2018-04-04 11:21:41,13500.0,4,8632,0,13500.0,4,13510.0,8,S
2018-04-04 11:21:57,13505.0,2,8634,-2,13500.0,3,13505.0,1,B
2018-04-04 11:22:26,13505.0,2,8636,0,13500.0,17,13510.0,6,B
2018-04-04 11:23:36,13505.0,2,8638,0,13500.0,19,13510.0,6,B
2018-04-04 11:23:37,13510.0,8,8646,-2,13500.0,5,13510.0,18,B
2018-04-04 11:23:45,13505.0,2,8648,-2,13500.0,5,13510.0,18,S
2018-04-04 11:23:53,13505.0,2,8650,-2,13505.0,1,13510.0,5,S
2018-04-04 11:24:10,13505.0,2,8652,-2,13505.0,1,13510.0,3,S
2018-04-04 11:24:10,13505.0,2,8654,-2,13505.0,1,13510.0,3,S
2018-04-04 11:24:27,13505.0,4,8658,-2,13505.0,1,13510.0,3,S
2018-04-04 11:24:33,13510.0,2,8660,0,13505.0,3,13510.0,4,B
2018-04-04 11:24:47,13505.0,6,8666,0,13505.0,1,13510.0,1,S
2018-04-04 11:24:53,13505.0,2,8668,0,13505.0,1,13510.0,3,S
2018-04-04 11:24:54,13505.0,2,8670,2,13500.0,12,13510.0,5,S
2018-04-04 11:25:38,13515.0,6,8676,-2,13505.0,1,13515.0,3,B
2018-04-04 11:26:39,13505.0,2,8678,2,13500.0,10,13505.0,29,S
2018-04-04 11:26:41,13505.0,2,8680,0,13500.0,13,13505.0,28,S
2018-04-04 11:27:01,13500.0,26,8706,4,13495.0,20,13500.0,7,S
2018-04-04 11:27:01,13500.0,14,8720,8,13500.0,2,13510.0,3,S
2018-04-04 11:27:07,13500.0,8,8728,8,13495.0,21,13500.0,4,S
2018-04-04 11:27:08,13500.0,8,8736,4,13495.0,21,13510.0,4,S
2018-04-04 11:27:39,13505.0,6,8742,-6,13500.0,1,13505.0,2,B
2018-04-04 11:27:54,13500.0,2,8744,0,13495.0,10,13500.0,5,S
2018-04-04 11:28:11,13500.0,4,8748,0,13495.0,12,13500.0,3,S
2018-04-04 11:28:17,13500.0,4,8752,0,13495.0,12,13500.0,1,S
2018-04-04 11:28:46,13500.0,2,8754,0,13495.0,12,13500.0,4,S
2018-04-04 11:29:00,13495.0,6,8760,-6,13495.0,9,13500.0,3,S
2018-04-04 11:29:14,13500.0,2,8762,0,13495.0,9,13500.0,1,B
2018-04-04 11:29:16,13495.0,4,8766,-2,13495.0,7,13500.0,1,S
2018-04-04 11:29:29,13495.0,2,8768,-2,13495.0,4,13500.0,4,S
2018-04-04 11:29:29,13495.0,2,8770,-2,13495.0,3,13500.0,4,S
2018-04-04 11:29:30,13495.0,2,8772,-2,13495.0,2,13500.0,4,S
2018-04-04 11:29:30,13495.0,2,8774,0,13495.0,1,13500.0,4,S
2018-04-04 11:29:39,13505.0,6,8780,-6,13495.0,1,13505.0,4,B
2018-04-04 11:29:46,13495.0,2,8782,-2,13490.0,10,13495.0,2,S
2018-04-04 11:29:47,13490.0,2,8784,-2,13490.0,5,13495.0,3,S
2018-04-04 11:29:55,13490.0,2,8786,0,13490.0,4,13495.0,3,S
2018-04-04 11:29:59,13495.0,6,8792,2,13490.0,4,13500.0,2,B
2018-04-04 13:30:00,13490.0,10,8802,-8,13485.0,4,13490.0,10,S
2018-04-04 13:30:01,13490.0,20,8822,-4,13490.0,2,13500.0,3,S
2018-04-04 13:30:03,13490.0,6,8828,2,13485.0,4,13495.0,7,S
2018-04-04 13:30:04,13485.0,2,8830,0,13485.0,3,13490.0,1,S
2018-04-04 13:30:04,13485.0,6,8836,-4,13480.0,6,13490.0,2,S
2018-04-04 13:30:05,13485.0,2,8838,0,13480.0,7,13495.0,7,S
2018-04-04 13:30:25,13480.0,2,8840,2,13480.0,6,13490.0,4,S
2018-04-04 13:30:28,13490.0,12,8852,-6,13490.0,4,13495.0,6,B
2018-04-04 13:30:29,13490.0,8,8860,-6,13480.0,6,13485.0,1,B
2018-04-04 13:30:29,13485.0,2,8862,0,13480.0,6,13490.0,3,S
2018-04-04 13:30:39,13490.0,2,8864,0,13480.0,7,13490.0,5,B
2018-04-04 13:30:49,13490.0,4,8868,-4,13480.0,9,13490.0,2,B
2018-04-04 13:31:11,13485.0,4,8872,2,13485.0,1,13490.0,3,S
2018-04-04 13:31:14,13490.0,4,8876,0,13485.0,1,13495.0,16,B
2018-04-04 13:31:18,13485.0,2,8878,0,13480.0,10,13490.0,4,S
2018-04-04 13:31:31,13485.0,4,8882,4,13480.0,11,13490.0,2,S
2018-04-04 13:32:05,13485.0,2,8884,2,13480.0,10,13490.0,8,S
2018-04-04 13:32:12,13485.0,4,8888,0,13480.0,12,13485.0,3,S
2018-04-04 13:32:21,13485.0,2,8890,2,13480.0,12,13485.0,3,S
2018-04-04 13:32:23,13485.0,2,8892,0,13480.0,12,13485.0,3,S
2018-04-04 13:32:29,13485.0,4,8896,-2,13480.0,11,13490.0,4,S
2018-04-04 13:32:52,13485.0,2,8898,0,13480.0,11,13490.0,5,S
2018-04-04 13:33:02,13490.0,6,8904,2,13490.0,7,13495.0,4,B
2018-04-04 13:33:07,13490.0,2,8906,0,13490.0,6,13495.0,3,B
2018-04-04 13:33:29,13495.0,2,8908,0,13490.0,6,13495.0,1,B
2018-04-04 13:33:45,13490.0,2,8910,2,13490.0,5,13495.0,3,S
2018-04-04 13:33:47,13490.0,10,8920,10,13485.0,6,13495.0,2,S
2018-04-04 13:34:11,13490.0,6,8926,4,13485.0,2,13495.0,3,S
2018-04-04 13:34:16,13485.0,2,8928,0,13485.0,1,13490.0,1,S
2018-04-04 13:34:33,13485.0,26,8954,0,13485.0,7,13490.0,6,S
2018-04-04 13:34:34,13485.0,14,8968,-12,13480.0,23,13490.0,6,S
2018-04-04 13:34:35,13480.0,2,8970,0,13480.0,8,13485.0,5,S
2018-04-04 13:34:59,13485.0,2,8972,0,13480.0,8,13485.0,1,B
2018-04-04 13:35:01,13480.0,2,8974,2,13480.0,7,13485.0,2,S
2018-04-04 13:35:02,13480.0,2,8976,2,13480.0,6,13485.0,4,S
2018-04-04 13:35:06,13485.0,4,8980,4,13480.0,6,13485.0,2,B
2018-04-04 13:35:20,13480.0,10,8990,4,13480.0,1,13485.0,5,S
2018-04-04 13:35:27,13480.0,2,8992,0,13475.0,9,13480.0,1,S
2018-04-04 13:35:27,13480.0,2,8994,-2,13475.0,6,13485.0,5,S
2018-04-04 13:35:32,13485.0,16,9010,10,13485.0,12,13490.0,10,B
2018-04-04 13:35:33,13485.0,24,9034,8,13475.0,7,13485.0,1,B
2018-04-04 13:35:56,13485.0,6,9040,4,13480.0,8,13485.0,1,B
2018-04-04 13:35:57,13485.0,2,9042,0,13480.0,8,13490.0,9,B
2018-04-04 13:35:59,13485.0,2,9044,0,13480.0,8,13485.0,1,B
2018-04-04 13:35:59,13485.0,2,9046,0,13480.0,8,13490.0,6,B
2018-04-04 13:36:13,13485.0,4,9050,4,13480.0,7,13490.0,11,B
2018-04-04 13:36:24,13490.0,4,9054,4,13485.0,13,13490.0,4,B
2018-04-04 13:36:50,13485.0,2,9056,2,13485.0,10,13490.0,5,S
2018-04-04 13:37:20,13490.0,6,9062,6,13485.0,10,13490.0,2,B
2018-04-04 13:37:37,13490.0,4,9066,2,13485.0,12,13495.0,5,B
2018-04-04 13:38:18,13485.0,2,9068,0,13485.0,10,13490.0,2,S
2018-04-04 13:38:25,13490.0,2,9070,2,13485.0,10,13495.0,4,B
2018-04-04 13:38:46,13495.0,2,9072,2,13485.0,12,13495.0,3,B
2018-04-04 13:38:52,13495.0,2,9074,0,13485.0,13,13495.0,2,B
2018-04-04 13:38:59,13485.0,8,9082,0,13485.0,9,13495.0,2,S
2018-04-04 13:39:01,13490.0,2,9084,-2,13485.0,9,13495.0,3,B
2018-04-04 13:39:15,13490.0,2,9086,0,13485.0,15,13495.0,4,B
2018-04-04 13:39:47,13490.0,2,9088,0,13485.0,10,13495.0,3,B
2018-04-04 13:39:55,13490.0,4,9092,4,13485.0,10,13495.0,6,B
2018-04-04 13:40:11,13490.0,2,9094,0,13485.0,10,13495.0,6,B
2018-04-04 13:40:17,13495.0,2,9096,-2,13485.0,10,13495.0,4,B
2018-04-04 13:40:49,13490.0,2,9098,-2,13485.0,8,13490.0,1,S
2018-04-04 13:41:04,13490.0,2,9100,-2,13485.0,8,13490.0,20,S
2018-04-04 13:41:20,13490.0,2,9102,2,13485.0,10,13490.0,27,S
2018-04-04 13:41:21,13490.0,12,9114,4,13485.0,25,13490.0,21,S
2018-04-04 13:41:22,13490.0,2,9116,0,13485.0,25,13490.0,20,S
2018-04-04 13:41:22,13490.0,2,9118,2,13485.0,13,13490.0,19,S
2018-04-04 13:41:47,13490.0,20,9138,20,13485.0,11,13490.0,9,S
2018-04-04 13:41:48,13490.0,2,9140,2,13485.0,11,13490.0,8,S
2018-04-04 13:41:53,13490.0,4,9144,0,13485.0,15,13490.0,6,S
2018-04-04 13:41:54,13490.0,6,9150,2,13485.0,13,13490.0,3,S
2018-04-04 13:41:59,13490.0,2,9152,0,13485.0,13,13490.0,2,S
2018-04-04 13:42:08,13490.0,2,9154,2,13485.0,13,13490.0,1,S
2018-04-04 13:42:12,13490.0,2,9156,2,13485.0,13,13495.0,4,S
2018-04-04 13:42:44,13490.0,2,9158,0,13485.0,9,13495.0,6,S
2018-04-04 13:42:53,13495.0,2,9160,0,13490.0,1,13495.0,4,B
2018-04-04 13:43:25,13490.0,2,9162,-2,13485.0,9,13495.0,6,S
2018-04-04 13:44:07,13490.0,2,9164,0,13485.0,6,13490.0,5,S
2018-04-04 13:44:10,13490.0,2,9166,0,13485.0,6,13490.0,3,S
2018-04-04 13:45:42,13490.0,2,9168,0,13485.0,20,13490.0,2,S
2018-04-04 13:45:46,13490.0,4,9172,0,13485.0,8,13495.0,4,S
2018-04-04 13:46:58,13490.0,4,9176,-4,13490.0,1,13495.0,7,S
2018-04-04 13:47:12,13490.0,2,9178,0,13490.0,1,13495.0,9,S
2018-04-04 13:47:24,13490.0,2,9180,-2,13490.0,1,13495.0,10,S
2018-04-04 13:47:37,13490.0,2,9182,0,13490.0,1,13495.0,9,S
2018-04-04 13:48:02,13495.0,18,9200,-6,13495.0,9,13500.0,19,B
2018-04-04 13:48:02,13495.0,14,9214,-6,13495.0,2,13500.0,21,B
2018-04-04 13:48:03,13495.0,4,9218,0,13490.0,2,13495.0,1,B
2018-04-04 13:48:07,13495.0,2,9220,-2,13490.0,2,13495.0,3,B
2018-04-04 13:50:50,13495.0,2,9222,2,13490.0,6,13495.0,6,B
2018-04-04 13:50:55,13495.0,2,9224,-2,13490.0,5,13495.0,5,B
2018-04-04 13:51:37,13490.0,2,9226,0,13490.0,7,13495.0,7,S
2018-04-04 13:51:38,13490.0,14,9240,6,13485.0,9,13490.0,3,S
2018-04-04 13:51:43,13490.0,2,9242,0,13485.0,8,13490.0,2,S
2018-04-04 13:51:46,13490.0,4,9246,2,13485.0,7,13495.0,24,S
2018-04-04 13:52:21,13485.0,2,9248,0,13485.0,6,13490.0,6,S
2018-04-04 13:52:21,13485.0,6,9254,-6,13485.0,3,13490.0,20,S
2018-04-04 13:52:22,13485.0,4,9258,0,13485.0,1,13490.0,20,S
2018-04-04 13:52:22,13485.0,2,9260,0,13480.0,25,13485.0,2,S
2018-04-04 13:52:29,13480.0,2,9262,0,13480.0,20,13485.0,3,S
2018-04-04 13:52:31,13480.0,4,9266,-2,13480.0,18,13485.0,3,S
2018-04-04 13:52:41,13485.0,2,9268,0,13480.0,10,13485.0,7,B
2018-04-04 13:52:43,13480.0,2,9270,0,13480.0,9,13485.0,7,S
2018-04-04 13:52:51,13485.0,2,9272,0,13480.0,9,13485.0,7,B
2018-04-04 13:53:01,13480.0,2,9274,0,13480.0,13,13485.0,8,S
2018-04-04 13:53:01,13480.0,4,9278,-4,13480.0,11,13485.0,10,S
2018-04-04 13:53:02,13480.0,22,9300,8,13475.0,5,13480.0,6,S
2018-04-04 13:53:02,13475.0,8,9308,6,13470.0,8,13480.0,7,S
2018-04-04 13:53:03,13470.0,10,9318,8,13465.0,5,13470.0,6,S
2018-04-04 13:53:04,13460.0,10,9328,4,13460.0,4,13465.0,1,S
2018-04-04 13:53:04,13460.0,4,9332,4,13460.0,2,13465.0,1,S
2018-04-04 13:53:05,13465.0,8,9340,6,13460.0,2,13465.0,1,B
2018-04-04 13:53:06,13465.0,2,9342,0,13460.0,4,13470.0,18,B
2018-04-04 13:53:07,13465.0,6,9348,2,13460.0,19,13470.0,3,B
2018-04-04 13:53:13,13460.0,2,9350,0,13460.0,1,13465.0,3,S
2018-04-04 13:53:15,13460.0,4,9354,0,13460.0,1,13470.0,16,S
2018-04-04 13:53:20,13455.0,2,9356,0,13455.0,2,13460.0,2,S
2018-04-04 13:53:21,13455.0,2,9358,0,13455.0,1,13460.0,3,S
2018-04-04 13:53:21,13455.0,2,9360,0,13450.0,33,13455.0,5,S
2018-04-04 13:53:22,13455.0,2,9362,0,13450.0,22,13455.0,5,S
2018-04-04 13:53:23,13455.0,10,9372,-8,13450.0,21,13460.0,16,S
2018-04-04 13:53:24,13450.0,2,9374,0,13450.0,20,13460.0,16,S
2018-04-04 13:53:24,13450.0,16,9390,-14,13450.0,29,13460.0,3,S
2018-04-04 13:53:25,13450.0,2,9392,0,13455.0,1,13460.0,3,S
2018-04-04 13:53:28,13455.0,2,9394,2,13450.0,19,13460.0,3,B
2018-04-04 13:53:32,13455.0,2,9396,2,13455.0,3,13460.0,20,B
2018-04-04 13:53:33,13460.0,10,9406,10,13455.0,3,13460.0,15,B
2018-04-04 13:53:34,13450.0,10,9416,-6,13450.0,27,13460.0,15,S
2018-04-04 13:53:39,13460.0,6,9422,2,13455.0,19,13460.0,14,B
2018-04-04 13:53:39,13460.0,28,9450,-4,13455.0,6,13465.0,6,B
2018-04-04 13:53:40,13460.0,2,9452,-2,13455.0,1,13460.0,2,B
2018-04-04 13:53:47,13455.0,2,9454,2,13455.0,1,13460.0,4,S
2018-04-04 13:53:48,13460.0,6,9460,4,13460.0,3,13465.0,19,B
2018-04-04 13:53:49,13455.0,10,9470,4,13450.0,16,13460.0,31,S
2018-04-04 13:53:58,13460.0,2,9472,-2,13455.0,4,13465.0,4,B
2018-04-04 13:54:00,13460.0,10,9482,4,13455.0,6,13460.0,5,B
2018-04-04 13:54:00,13460.0,10,9492,0,13460.0,5,13470.0,3,B
2018-04-04 13:54:02,13460.0,4,9496,-4,13455.0,6,13465.0,4,B
2018-04-04 13:54:03,13455.0,2,9498,2,13450.0,19,13460.0,2,S
2018-04-04 13:54:06,13455.0,6,9504,-6,13455.0,6,13465.0,6,S
2018-04-04 13:54:11,13465.0,2,9506,2,13465.0,1,13470.0,7,B
2018-04-04 13:54:12,13465.0,4,9510,0,13460.0,5,13470.0,6,B
2018-04-04 13:54:24,13465.0,2,9512,2,13460.0,1,13465.0,19,B
2018-04-04 13:54:27,13460.0,2,9514,-2,13455.0,6,13460.0,1,S
2018-04-04 13:54:28,13455.0,4,9518,-2,13455.0,1,13460.0,3,S
2018-04-04 13:54:28,13450.0,4,9522,0,13450.0,19,13455.0,1,S
2018-04-04 13:54:29,13450.0,30,9552,2,13445.0,14,13450.0,1,S
2018-04-04 13:54:30,13450.0,2,9554,0,13445.0,13,13450.0,2,S
2018-04-04 13:54:31,13445.0,26,9580,2,13440.0,63,13445.0,9,S
2018-04-04 13:54:31,13440.0,22,9602,-22,13440.0,52,13445.0,9,S
2018-04-04 13:54:32,13440.0,32,9634,0,13440.0,44,13445.0,20,S
2018-04-04 13:54:32,13445.0,38,9672,16,13440.0,58,13445.0,1,B
2018-04-04 13:54:33,13445.0,2,9674,0,13440.0,45,13450.0,3,B
2018-04-04 13:54:33,13440.0,4,9678,2,13440.0,44,13450.0,2,S
2018-04-04 13:54:35,13440.0,10,9688,0,13440.0,39,13450.0,2,S
2018-04-04 13:54:40,13445.0,4,9692,0,13440.0,37,13450.0,4,B
2018-04-04 13:54:41,13445.0,4,9696,2,13440.0,37,13450.0,4,B
2018-04-04 13:54:42,13445.0,2,9698,0,13445.0,2,13450.0,5,B
2018-04-04 13:54:49,13450.0,2,9700,0,13440.0,41,13450.0,5,B
2018-04-04 13:54:50,13445.0,2,9702,-2,13445.0,4,13450.0,7,S
2018-04-04 13:54:51,13450.0,10,9712,-6,13445.0,6,13455.0,3,B
2018-04-04 13:54:52,13450.0,2,9714,-2,13450.0,4,13455.0,3,B
2018-04-04 13:54:58,13450.0,2,9716,0,13450.0,3,13455.0,3,B
2018-04-04 13:55:01,13450.0,2,9718,-2,13450.0,2,13455.0,3,B
2018-04-04 13:55:02,13450.0,2,9720,0,13450.0,5,13455.0,3,B
2018-04-04 13:55:03,13455.0,2,9722,0,13450.0,5,13455.0,2,B
2018-04-04 13:55:07,13455.0,2,9724,0,13450.0,4,13455.0,1,B
2018-04-04 13:55:10,13450.0,2,9726,0,13450.0,3,13455.0,1,S
2018-04-04 13:55:10,13455.0,2,9728,0,13450.0,3,13460.0,4,B
2018-04-04 13:55:17,13455.0,2,9730,-2,13450.0,9,13460.0,5,B
2018-04-04 13:55:39,13460.0,2,9732,2,13450.0,14,13460.0,2,B
2018-04-04 13:55:51,13460.0,2,9734,0,13455.0,2,13460.0,1,B
2018-04-04 13:56:00,13460.0,2,9736,0,13455.0,2,13465.0,4,B
2018-04-04 13:56:10,13455.0,4,9740,-4,13450.0,19,13455.0,22,S
2018-04-04 13:56:17,13455.0,2,9742,-2,13450.0,13,13455.0,19,S
2018-04-04 13:56:25,13455.0,6,9748,0,13450.0,11,13455.0,16,S
2018-04-04 13:56:44,13455.0,12,9760,-12,13450.0,18,13455.0,10,S
2018-04-04 13:56:45,13455.0,4,9764,0,13450.0,18,13455.0,8,S
2018-04-04 13:56:48,13455.0,2,9766,0,13450.0,19,13455.0,7,S
2018-04-04 13:56:49,13455.0,10,9776,-10,13450.0,19,13455.0,2,S
2018-04-04 13:56:50,13455.0,4,9780,-4,13450.0,31,13460.0,6,S
2018-04-04 13:57:02,13455.0,20,9800,20,13455.0,2,13460.0,6,S
2018-04-04 13:57:02,13455.0,4,9804,0,13450.0,19,13460.0,6,S
2018-04-04 13:57:07,13455.0,2,9806,0,13450.0,17,13455.0,9,S
2018-04-04 13:57:08,13455.0,18,9824,18,13455.0,1,13460.0,9,S
2018-04-04 13:57:08,13455.0,2,9826,0,13450.0,18,13460.0,9,S
2018-04-04 13:57:13,13450.0,20,9846,18,13450.0,3,13455.0,7,S
2018-04-04 13:57:15,13455.0,2,9848,0,13450.0,13,13460.0,8,B
2018-04-04 13:57:18,13450.0,20,9868,2,13450.0,8,13460.0,1,S
2018-04-04 13:57:37,13460.0,4,9872,0,13455.0,12,13465.0,6,B
2018-04-04 13:57:53,13460.0,2,9874,0,13455.0,10,13460.0,3,B
2018-04-04 13:57:53,13460.0,2,9876,0,13455.0,10,13460.0,3,B
2018-04-04 13:58:00,13455.0,20,9896,20,13450.0,11,13460.0,3,S
2018-04-04 13:58:11,13455.0,2,9898,0,13450.0,11,13455.0,2,S
2018-04-04 13:58:11,13455.0,4,9902,-4,13450.0,11,13460.0,3,S
2018-04-04 13:58:16,13455.0,2,9904,2,13450.0,10,13455.0,4,S
2018-04-04 13:58:21,13455.0,2,9906,2,13450.0,10,13455.0,3,S
2018-04-04 13:58:22,13455.0,2,9908,2,13450.0,9,13455.0,2,S
2018-04-04 13:58:24,13455.0,4,9912,0,13455.0,10,13460.0,8,S
2018-04-04 13:59:37,13455.0,10,9922,0,13455.0,6,13460.0,10,S
2018-04-04 13:59:37,13455.0,12,9934,4,13450.0,11,13455.0,1,S
2018-04-04 13:59:39,13455.0,4,9938,0,13455.0,3,13460.0,12,S
2018-04-04 13:59:40,13455.0,6,9944,6,13450.0,11,13455.0,3,S
2018-04-04 13:59:46,13455.0,4,9948,0,13450.0,16,13460.0,12,S
2018-04-04 13:59:59,13455.0,6,9954,6,13455.0,7,13460.0,12,S
2018-04-04 13:59:59,13455.0,14,9968,12,13450.0,16,13455.0,10,S
2018-04-04 14:00:00,13455.0,2,9970,2,13450.0,16,13455.0,4,S
2018-04-04 14:00:05,13450.0,32,10002,18,13445.0,9,13450.0,4,S
2018-04-04 14:00:05,13450.0,8,10010,0,13445.0,8,13455.0,5,S
2018-04-04 14:00:11,13455.0,10,10020,10,13455.0,6,13460.0,19,B
2018-04-04 14:00:12,13455.0,12,10032,4,13445.0,9,13455.0,1,B
2018-04-04 14:00:17,13445.0,14,10046,6,13440.0,42,13445.0,3,S
2018-04-04 14:00:21,13440.0,2,10048,0,13440.0,39,13445.0,6,S
2018-04-04 14:00:21,13440.0,4,10052,-2,13440.0,37,13445.0,8,S
2018-04-04 14:00:22,13445.0,4,10056,0,13440.0,37,13445.0,3,B
2018-04-04 14:00:25,13440.0,2,10058,0,13440.0,41,13445.0,4,S
2018-04-04 14:00:26,13445.0,6,10064,2,13440.0,39,13445.0,3,B
2018-04-04 14:00:26,13440.0,2,10066,0,13440.0,38,13445.0,3,S
2018-04-04 14:00:27,13440.0,32,10098,-2,13440.0,22,13445.0,3,S
2018-04-04 14:00:27,13440.0,44,10142,4,13435.0,27,13440.0,16,S
2018-04-04 14:00:29,13435.0,26,10168,0,13435.0,13,13440.0,9,S
2018-04-04 14:00:29,13435.0,8,10176,0,13435.0,9,13440.0,23,S
2018-04-04 14:00:30,13435.0,14,10190,0,13435.0,2,13440.0,25,S
2018-04-04 14:00:30,13440.0,2,10192,0,13435.0,2,13440.0,26,B
2018-04-04 14:00:31,13435.0,8,10200,-8,13430.0,24,13435.0,2,S
2018-04-04 14:00:31,13435.0,4,10204,-4,13435.0,3,13440.0,9,S
2018-04-04 14:00:35,13435.0,2,10206,-2,13435.0,15,13440.0,2,S
2018-04-04 14:00:35,13440.0,4,10210,-4,13435.0,15,13445.0,5,B
2018-04-04 14:00:53,13450.0,2,10212,-2,13440.0,1,13450.0,20,B
2018-04-04 14:00:57,13440.0,2,10214,2,13435.0,19,13440.0,19,S
2018-04-04 14:00:58,13440.0,10,10224,10,13435.0,1,13440.0,14,S
2018-04-04 14:01:00,13440.0,14,10238,0,13435.0,1,13440.0,8,S
2018-04-04 14:01:01,13435.0,2,10240,0,13430.0,14,13440.0,14,S
2018-04-04 14:01:05,13440.0,20,10260,-4,13430.0,28,13440.0,3,B
2018-04-04 14:01:06,13440.0,6,10266,2,13440.0,5,13445.0,6,B
2018-04-04 14:01:07,13440.0,2,10268,0,13440.0,3,13445.0,3,B
2018-04-04 14:01:11,13440.0,2,10270,-2,13440.0,2,13445.0,3,B
2018-04-04 14:01:15,13445.0,2,10272,0,13440.0,3,13445.0,3,B
2018-04-04 14:01:16,13445.0,8,10280,-6,13440.0,2,13450.0,21,B
2018-04-04 14:01:27,13445.0,2,10282,2,13445.0,18,13450.0,14,B
2018-04-04 14:01:27,13445.0,26,10308,24,13445.0,19,13450.0,2,B
2018-04-04 14:01:28,13450.0,4,10312,0,13445.0,19,13455.0,11,B
2018-04-04 14:01:29,13445.0,2,10314,0,13445.0,3,13450.0,7,S
2018-04-04 14:01:32,13445.0,4,10318,-2,13445.0,2,13450.0,3,S
2018-04-04 14:01:33,13445.0,4,10322,0,13440.0,8,13450.0,4,S
2018-04-04 14:01:38,13445.0,2,10324,0,13440.0,8,13450.0,8,S
2018-04-04 14:01:41,13445.0,2,10326,0,13440.0,8,13445.0,4,S
2018-04-04 14:01:42,13440.0,18,10344,-6,13435.0,6,13440.0,1,S
2018-04-04 14:01:51,13435.0,2,10346,0,13435.0,2,13445.0,13,S
2018-04-04 14:01:54,13435.0,2,10348,-2,13435.0,2,13445.0,13,S
2018-04-04 14:02:05,13440.0,4,10352,0,13440.0,5,13445.0,13,B
2018-04-04 14:02:06,13440.0,2,10354,-2,13440.0,15,13445.0,7,B
2018-04-04 14:02:11,13440.0,4,10358,0,13440.0,13,13445.0,5,B
2018-04-04 14:02:15,13445.0,2,10360,2,13440.0,13,13445.0,4,B
2018-04-04 14:02:15,13445.0,8,10368,4,13445.0,1,13450.0,21,B
2018-04-04 14:02:16,13445.0,6,10374,0,13445.0,11,13450.0,8,B
2018-04-04 14:02:16,13445.0,2,10376,-2,13445.0,10,13450.0,6,B
2018-04-04 14:02:17,13445.0,8,10384,-4,13445.0,6,13450.0,6,B
2018-04-04 14:02:18,13445.0,2,10386,-2,13445.0,5,13450.0,19,B
2018-04-04 14:02:18,13445.0,10,10396,-2,13440.0,2,13450.0,19,B
2018-04-04 14:02:25,13445.0,4,10400,2,13440.0,4,13445.0,3,B
2018-04-04 14:02:26,13445.0,6,10406,0,13440.0,5,13450.0,24,B
2018-04-04 14:02:29,13450.0,10,10416,6,13440.0,5,13450.0,20,B
2018-04-04 14:02:30,13450.0,4,10420,0,13440.0,5,13450.0,18,B
2018-04-04 14:02:38,13450.0,10,10430,0,13440.0,7,13450.0,12,B
2018-04-04 14:02:44,13450.0,2,10432,0,13445.0,3,13450.0,11,B
2018-04-04 14:02:45,13450.0,18,10450,0,13445.0,3,13450.0,2,B
2018-04-04 14:02:46,13450.0,4,10454,-4,13445.0,3,13455.0,9,B
2018-04-04 14:02:51,13455.0,2,10456,-2,13450.0,4,13455.0,4,B
2018-04-04 14:02:51,13455.0,4,10460,2,13450.0,4,13455.0,2,B
2018-04-04 14:03:06,13450.0,4,10464,-2,13445.0,9,13455.0,6,S
2018-04-04 14:03:09,13450.0,4,10468,0,13445.0,3,13450.0,1,S
2018-04-04 14:03:10,13450.0,2,10470,-2,13445.0,6,13455.0,12,S
2018-04-04 14:03:11,13450.0,2,10472,0,13445.0,6,13450.0,3,S
2018-04-04 14:03:24,13445.0,2,10474,0,13445.0,2,13450.0,6,S
2018-04-04 14:03:24,13445.0,4,10478,4,13440.0,8,13450.0,18,S
2018-04-04 14:03:25,13445.0,2,10480,-2,13440.0,6,13450.0,16,S
2018-04-04 14:03:31,13440.0,2,10482,2,13440.0,2,13445.0,1,S
2018-04-04 14:03:35,13445.0,2,10484,0,13440.0,6,13450.0,5,B
2018-04-04 14:03:35,13445.0,4,10488,-2,13440.0,10,13450.0,1,B
2018-04-04 14:03:42,13450.0,2,10490,2,13445.0,1,13450.0,13,B
2018-04-04 14:03:49,13445.0,2,10492,-2,13440.0,3,13450.0,17,S
2018-04-04 14:03:54,13440.0,2,10494,2,13440.0,13,13450.0,18,S
2018-04-04 14:03:56,13450.0,2,10496,2,13440.0,13,13450.0,14,B
2018-04-04 14:04:02,13450.0,2,10498,2,13440.0,13,13450.0,11,B
2018-04-04 14:04:08,13450.0,2,10500,2,13440.0,13,13450.0,17,B
2018-04-04 14:04:36,13445.0,2,10502,0,13440.0,11,13445.0,9,S
2018-04-04 14:04:41,13440.0,4,10506,-2,13440.0,9,13445.0,9,S
2018-04-04 14:04:42,13445.0,2,10508,0,13440.0,10,13445.0,8,B
2018-04-04 14:04:51,13445.0,2,10510,0,13440.0,9,13445.0,7,B
2018-04-04 14:04:52,13440.0,18,10528,0,13435.0,20,13440.0,1,S
2018-04-04 14:05:07,13435.0,4,10532,-2,13430.0,22,13440.0,3,S
2018-04-04 14:05:16,13440.0,2,10534,2,13430.0,20,13440.0,6,B
2018-04-04 14:05:17,13430.0,20,10554,-20,13430.0,10,13440.0,6,S
2018-04-04 14:05:19,13430.0,2,10556,-2,13430.0,7,13435.0,2,S
2018-04-04 14:05:20,13430.0,14,10570,10,13425.0,3,13435.0,3,S
2018-04-04 14:05:20,13425.0,2,10572,-2,13425.0,1,13430.0,5,S
2018-04-04 14:05:23,13425.0,2,10574,-2,13420.0,13,13435.0,10,S
2018-04-04 14:05:23,13425.0,2,10576,-2,13425.0,21,13430.0,4,S
2018-04-04 14:05:28,13425.0,2,10578,0,13425.0,20,13430.0,6,S
2018-04-04 14:05:31,13430.0,2,10580,0,13425.0,22,13435.0,9,B
2018-04-04 14:05:37,13430.0,2,10582,0,13425.0,22,13430.0,1,B
2018-04-04 14:05:39,13430.0,2,10584,2,13430.0,2,13435.0,2,B
2018-04-04 14:05:42,13430.0,2,10586,0,13430.0,2,13435.0,9,B
2018-04-04 14:05:48,13430.0,2,10588,0,13430.0,2,13435.0,9,B
2018-04-04 14:05:50,13430.0,10,10598,-8,13430.0,1,13435.0,9,B
2018-04-04 14:05:52,13435.0,12,10610,-8,13430.0,6,13435.0,3,B
2018-04-04 14:05:53,13435.0,6,10616,-4,13435.0,1,13440.0,5,B
2018-04-04 14:05:55,13435.0,2,10618,0,13430.0,3,13440.0,3,B
2018-04-04 14:05:56,13440.0,10,10628,6,13440.0,6,13445.0,12,B
2018-04-04 14:05:57,13440.0,12,10640,0,13430.0,3,13440.0,8,B
2018-04-04 14:05:58,13440.0,2,10642,2,13430.0,22,13435.0,1,B
2018-04-04 14:05:59,13435.0,2,10644,0,13435.0,1,13440.0,16,S
2018-04-04 14:06:03,13435.0,2,10646,0,13430.0,22,13435.0,12,S
2018-04-04 14:06:03,13435.0,28,10674,-2,13435.0,1,13440.0,8,S
2018-04-04 14:06:04,13435.0,2,10676,2,13430.0,21,13435.0,2,S
2018-04-04 14:06:04,13435.0,4,10680,-4,13435.0,6,13440.0,8,S
2018-04-04 14:06:07,13440.0,2,10682,0,13435.0,2,13440.0,4,B
2018-04-04 14:06:08,13435.0,4,10686,0,13430.0,29,13435.0,3,S
2018-04-04 14:06:08,13435.0,6,10692,6,13430.0,29,13440.0,3,S
2018-04-04 14:06:11,13440.0,2,10694,2,13435.0,4,13440.0,1,B
2018-04-04 14:06:18,13435.0,4,10698,-4,13435.0,6,13445.0,2,S
2018-04-04 14:06:26,13445.0,2,10700,0,13440.0,4,13450.0,12,B
2018-04-04 14:06:29,13445.0,2,10702,-2,13440.0,4,13445.0,3,B
2018-04-04 14:06:32,13445.0,2,10704,-2,13445.0,5,13450.0,10,B
2018-04-04 14:06:48,13445.0,2,10706,0,13445.0,3,13450.0,9,B
2018-04-04 14:06:58,13445.0,6,10712,-4,13440.0,17,13445.0,7,B
2018-04-04 14:06:58,13445.0,8,10720,-2,13440.0,19,13445.0,3,B
2018-04-04 14:07:02,13445.0,2,10722,-2,13440.0,8,13445.0,2,B
2018-04-04 14:07:02,13445.0,2,10724,0,13440.0,8,13445.0,1,B
2018-04-04 14:07:05,13445.0,4,10728,-2,13445.0,1,13450.0,11,B
2018-04-04 14:07:06,13445.0,2,10730,2,13445.0,1,13450.0,11,B
2018-04-04 14:07:09,13450.0,18,10748,12,13445.0,1,13455.0,8,B
2018-04-04 14:07:09,13450.0,2,10750,0,13445.0,1,13455.0,9,B
2018-04-04 14:07:19,13450.0,2,10752,2,13450.0,1,13455.0,3,B
2018-04-04 14:07:22,13455.0,2,10754,0,13450.0,1,13455.0,2,B
2018-04-04 14:07:24,13455.0,4,10758,2,13450.0,1,13460.0,22,B
2018-04-04 14:07:28,13450.0,4,10762,0,13450.0,2,13460.0,20,S
2018-04-04 14:07:38,13455.0,2,10764,2,13455.0,1,13460.0,19,B
2018-04-04 14:07:39,13455.0,2,10766,2,13450.0,5,13460.0,19,B
2018-04-04 14:07:46,13450.0,4,10770,4,13450.0,1,13455.0,5,S
2018-04-04 14:07:47,13450.0,2,10772,2,13445.0,5,13455.0,7,S
2018-04-04 14:07:50,13455.0,2,10774,0,13445.0,2,13455.0,7,B
2018-04-04 14:08:43,13450.0,2,10776,-2,13445.0,5,13455.0,16,S
2018-04-04 14:09:02,13445.0,4,10780,-2,13440.0,5,13450.0,7,S
2018-04-04 14:09:09,13440.0,2,10782,0,13435.0,7,13440.0,3,S
2018-04-04 14:09:12,13440.0,2,10784,0,13435.0,2,13440.0,2,S
2018-04-04 14:09:15,13435.0,2,10786,-2,13430.0,6,13440.0,7,S
2018-04-04 14:09:22,13430.0,6,10792,0,13430.0,1,13435.0,5,S
2018-04-04 14:09:22,13430.0,2,10794,2,13425.0,23,13435.0,5,S
2018-04-04 14:09:27,13430.0,4,10798,0,13425.0,20,13435.0,4,S
2018-04-04 14:09:32,13435.0,4,10802,-4,13430.0,1,13435.0,3,B
2018-04-04 14:09:39,13435.0,6,10808,6,13435.0,1,13440.0,9,B
2018-04-04 14:09:39,13435.0,2,10810,2,13430.0,3,13435.0,1,B
2018-04-04 14:09:50,13435.0,2,10812,0,13430.0,3,13435.0,1,B
2018-04-04 14:09:57,13430.0,6,10818,-6,13425.0,23,13435.0,1,S
2018-04-04 14:10:00,13425.0,2,10820,-2,13425.0,23,13435.0,3,S
2018-04-04 14:10:17,13435.0,6,10826,6,13430.0,1,13435.0,1,B
2018-04-04 14:10:17,13435.0,2,10828,2,13435.0,6,13440.0,5,B
2018-04-04 14:10:18,13440.0,2,10830,-2,13440.0,1,13445.0,4,B
2018-04-04 14:10:32,13450.0,2,10832,0,13445.0,1,13450.0,7,B
2018-04-04 14:10:37,13445.0,2,10834,2,13440.0,3,13450.0,8,S
2018-04-04 14:10:51,13445.0,2,10836,2,13440.0,4,13450.0,10,S
2018-04-04 14:10:59,13450.0,4,10840,0,13445.0,3,13450.0,8,B
2018-04-04 14:11:04,13445.0,6,10846,4,13440.0,3,13450.0,9,S
2018-04-04 14:11:16,13440.0,2,10848,-2,13435.0,2,13445.0,7,S
2018-04-04 14:11:31,13435.0,2,10850,-2,13430.0,3,13440.0,3,S
2018-04-04 14:11:42,13440.0,2,10852,2,13430.0,6,13440.0,2,B
2018-04-04 14:12:11,13435.0,2,10854,2,13430.0,4,13440.0,19,S
2018-04-04 14:12:13,13440.0,6,10860,-4,13430.0,4,13440.0,19,B
2018-04-04 14:12:17,13440.0,2,10862,2,13430.0,5,13440.0,18,B
2018-04-04 14:12:22,13440.0,2,10864,0,13430.0,5,13440.0,17,B
2018-04-04 14:12:25,13430.0,14,10878,4,13425.0,21,13430.0,3,S
2018-04-04 14:12:26,13430.0,6,10884,0,13425.0,23,13440.0,19,S
2018-04-04 14:12:28,13440.0,2,10886,2,13430.0,8,13440.0,1,B
2018-04-04 14:12:39,13440.0,4,10890,2,13430.0,11,13440.0,9,B
2018-04-04 14:12:47,13440.0,18,10908,0,13440.0,10,13445.0,10,B
2018-04-04 14:13:10,13435.0,8,10916,-6,13435.0,5,13445.0,5,S
2018-04-04 14:13:11,13445.0,4,10920,4,13440.0,5,13445.0,3,B
2018-04-04 14:13:12,13440.0,6,10926,-6,13440.0,2,13445.0,3,S
2018-04-04 14:13:13,13435.0,4,10930,0,13435.0,6,13445.0,4,S
2018-04-04 14:13:17,13445.0,2,10932,2,13435.0,3,13445.0,8,B
2018-04-04 14:13:20,13430.0,2,10934,-2,13430.0,8,13440.0,2,S
2018-04-04 14:13:23,13435.0,4,10938,-2,13435.0,20,13440.0,3,B
2018-04-04 14:13:26,13435.0,4,10942,-4,13435.0,20,13440.0,3,B
2018-04-04 14:13:29,13435.0,2,10944,-2,13435.0,39,13440.0,3,B
2018-04-04 14:13:40,13440.0,6,10950,-6,13440.0,7,13445.0,8,B
2018-04-04 14:13:44,13445.0,6,10956,4,13440.0,7,13445.0,6,B
2018-04-04 14:13:47,13440.0,4,10960,-4,13440.0,5,13445.0,3,S
2018-04-04 14:13:53,13445.0,4,10964,4,13440.0,5,13445.0,1,B
2018-04-04 14:13:59,13445.0,2,10966,2,13440.0,5,13445.0,3,B
2018-04-04 14:14:00,13440.0,10,10976,0,13435.0,45,13440.0,5,S
2018-04-04 14:14:16,13440.0,10,10986,10,13440.0,1,13445.0,6,S
2018-04-04 14:14:20,13445.0,4,10990,0,13440.0,1,13445.0,3,B
2018-04-04 14:14:26,13445.0,6,10996,-2,13445.0,1,13450.0,11,B
2018-04-04 14:14:35,13450.0,2,10998,0,13445.0,1,13450.0,7,B
2018-04-04 14:14:42,13450.0,4,11002,-2,13440.0,5,13450.0,5,B
2018-04-04 14:14:55,13440.0,2,11004,2,13440.0,3,13445.0,3,S
2018-04-04 14:14:55,13435.0,16,11020,-6,13435.0,38,13445.0,17,S
2018-04-04 14:14:56,13435.0,10,11030,-6,13435.0,33,13440.0,1,S
2018-04-04 14:14:58,13435.0,2,11032,0,13435.0,30,13440.0,1,S
2018-04-04 14:14:59,13435.0,2,11034,0,13435.0,29,13440.0,15,S
2018-04-04 14:14:59,13435.0,4,11038,-4,13435.0,27,13440.0,15,S
2018-04-04 14:15:00,13435.0,12,11050,-6,13435.0,21,13440.0,15,S
2018-04-04 14:15:00,13435.0,8,11058,-8,13435.0,17,13440.0,15,S
2018-04-04 14:15:01,13435.0,34,11092,-6,13430.0,5,13440.0,15,S
2018-04-04 14:15:02,13430.0,2,11094,0,13430.0,3,13435.0,1,S
2018-04-04 14:15:02,13430.0,6,11100,2,13425.0,2,13430.0,3,S
2018-04-04 14:15:03,13425.0,2,11102,0,13425.0,1,13430.0,3,S
2018-04-04 14:15:03,13425.0,2,11104,0,13420.0,11,13430.0,15,S
2018-04-04 14:15:04,13420.0,2,11106,0,13420.0,8,13425.0,7,S
2018-04-04 14:15:07,13425.0,12,11118,-2,13420.0,9,13430.0,18,B
2018-04-04 14:15:08,13420.0,6,11124,0,13420.0,9,13430.0,13,S
2018-04-04 14:15:09,13420.0,2,11126,0,13420.0,8,13430.0,16,S
2018-04-04 14:15:10,13425.0,2,11128,0,13420.0,8,13425.0,1,B
2018-04-04 14:15:12,13420.0,4,11132,2,13420.0,4,13425.0,14,S
2018-04-04 14:15:13,13420.0,6,11138,4,13420.0,1,13425.0,14,S
2018-04-04 14:15:13,13415.0,4,11142,4,13415.0,4,13425.0,14,S
2018-04-04 14:15:15,13420.0,2,11144,0,13420.0,1,13425.0,19,B
2018-04-04 14:15:17,13420.0,2,11146,2,13415.0,4,13425.0,15,B
2018-04-04 14:15:17,13415.0,2,11148,2,13415.0,3,13425.0,18,S
2018-04-04 14:15:20,13425.0,2,11150,0,13420.0,2,13430.0,16,B
2018-04-04 14:15:21,13420.0,2,11152,2,13420.0,1,13430.0,17,S
2018-04-04 14:15:26,13430.0,4,11156,0,13415.0,9,13430.0,16,B
2018-04-04 14:15:39,13420.0,4,11160,-2,13420.0,1,13425.0,1,S
2018-04-04 14:15:43,13425.0,2,11162,2,13420.0,4,13425.0,1,B
2018-04-04 14:15:43,13425.0,2,11164,-2,13420.0,4,13430.0,6,B
2018-04-04 14:15:44,13425.0,2,11166,2,13420.0,4,13430.0,6,B
2018-04-04 14:15:46,13420.0,2,11168,0,13420.0,2,13430.0,6,S
2018-04-04 14:15:46,13420.0,4,11172,0,13415.0,8,13430.0,6,S
2018-04-04 14:15:57,13420.0,2,11174,-2,13415.0,3,13425.0,12,S
2018-04-04 14:15:59,13415.0,2,11176,2,13415.0,3,13425.0,9,S
2018-04-04 14:16:11,13420.0,8,11184,0,13415.0,19,13420.0,6,B
2018-04-04 14:16:12,13420.0,12,11196,8,13420.0,1,13425.0,7,B
2018-04-04 14:16:13,13420.0,6,11202,2,13415.0,7,13420.0,17,B
2018-04-04 14:16:14,13420.0,2,11204,2,13415.0,6,13420.0,16,B
2018-04-04 14:16:35,13420.0,2,11206,2,13415.0,5,13420.0,85,B
2018-04-04 14:16:41,13415.0,2,11208,0,13415.0,4,13420.0,105,S
2018-04-04 14:16:41,13415.0,2,11210,2,13415.0,3,13420.0,105,S
2018-04-04 14:16:47,13420.0,2,11212,2,13415.0,3,13420.0,104,B
2018-04-04 14:16:59,13420.0,2,11214,0,13415.0,6,13420.0,103,B
2018-04-04 14:16:59,13420.0,4,11218,2,13415.0,7,13420.0,101,B
2018-04-04 14:17:08,13420.0,2,11220,0,13415.0,5,13420.0,100,B
2018-04-04 14:17:25,13415.0,10,11230,2,13415.0,1,13420.0,100,S
2018-04-04 14:17:25,13415.0,4,11234,0,13410.0,34,13420.0,100,S
2018-04-04 14:17:28,13415.0,4,11238,0,13410.0,32,13420.0,100,S
2018-04-04 14:17:46,13415.0,2,11240,-2,13415.0,7,13420.0,100,S
2018-04-04 14:17:47,13420.0,2,11242,0,13415.0,8,13420.0,99,B
2018-04-04 14:17:51,13415.0,16,11258,6,13415.0,1,13420.0,100,S
2018-04-04 14:17:52,13415.0,2,11260,2,13410.0,22,13415.0,1,S
2018-04-04 14:17:53,13420.0,2,11262,2,13415.0,1,13420.0,101,B
2018-04-04 14:18:00,13415.0,2,11264,0,13410.0,22,13420.0,101,S
2018-04-04 14:18:15,13410.0,2,11266,-2,13410.0,20,13415.0,29,S
2018-04-04 14:18:17,13415.0,2,11268,2,13410.0,20,13415.0,25,B
2018-04-04 14:18:20,13410.0,2,11270,-2,13410.0,18,13415.0,25,S
2018-04-04 14:18:23,13410.0,24,11294,-4,13410.0,6,13415.0,30,S
2018-04-04 14:18:24,13405.0,22,11316,12,13405.0,10,13415.0,31,S
2018-04-04 14:18:24,13405.0,8,11324,0,13405.0,6,13410.0,1,S
2018-04-04 14:18:27,13410.0,6,11330,-2,13405.0,8,13415.0,30,B
2018-04-04 14:18:28,13410.0,2,11332,2,13405.0,13,13415.0,27,B
2018-04-04 14:18:28,13410.0,2,11334,2,13405.0,13,13415.0,25,B
2018-04-04 14:18:29,13410.0,2,11336,0,13405.0,10,13415.0,26,B
2018-04-04 14:18:31,13410.0,2,11338,0,13405.0,12,13415.0,6,B
2018-04-04 14:18:35,13405.0,2,11340,2,13405.0,9,13415.0,7,S
2018-04-04 14:18:36,13405.0,16,11356,-6,13400.0,33,13405.0,13,S
2018-04-04 14:18:36,13405.0,26,11382,-26,13405.0,8,13415.0,8,S
2018-04-04 14:18:39,13405.0,2,11384,0,13405.0,4,13410.0,1,S
2018-04-04 14:18:49,13410.0,4,11388,4,13410.0,1,13415.0,9,B
2018-04-04 14:19:01,13410.0,2,11390,-2,13410.0,3,13415.0,4,B
2018-04-04 14:19:04,13415.0,10,11400,2,13415.0,1,13420.0,83,B
2018-04-04 14:19:09,13415.0,4,11404,0,13415.0,4,13420.0,81,B
2018-04-04 14:19:10,13415.0,4,11408,0,13415.0,2,13420.0,81,B
2018-04-04 14:19:12,13420.0,12,11420,0,13415.0,1,13420.0,76,B
2018-04-04 14:19:19,13420.0,40,11460,20,13415.0,9,13420.0,55,B
2018-04-04 14:19:20,13420.0,80,11540,34,13415.0,22,13420.0,14,B
2018-04-04 14:19:20,13420.0,28,11568,-2,13420.0,8,13425.0,4,B
2018-04-04 14:19:24,13425.0,2,11570,2,13420.0,8,13430.0,8,B
2018-04-04 14:19:28,13430.0,14,11584,-8,13420.0,10,13430.0,1,B
2018-04-04 14:19:30,13430.0,2,11586,-2,13430.0,3,13435.0,7,B
2018-04-04 14:19:30,13430.0,6,11592,0,13425.0,2,13435.0,7,B
2018-04-04 14:19:34,13435.0,2,11594,0,13430.0,8,13440.0,2,B
2018-04-04 14:19:36,13440.0,4,11598,-2,13440.0,6,13445.0,5,B
2018-04-04 14:19:37,13440.0,6,11604,-6,13440.0,3,13445.0,7,B
2018-04-04 14:19:38,13440.0,6,11610,0,13435.0,2,13440.0,1,B
2018-04-04 14:19:39,13440.0,8,11618,2,13440.0,4,13445.0,6,B
2018-04-04 14:19:51,13440.0,2,11620,-2,13430.0,18,13440.0,1,B
2018-04-04 14:19:58,13440.0,2,11622,2,13440.0,9,13445.0,11,B
2018-04-04 14:19:59,13440.0,6,11628,0,13440.0,6,13445.0,9,B
2018-04-04 14:19:59,13440.0,12,11640,6,13435.0,5,13445.0,9,B
2018-04-04 14:20:12,13440.0,2,11642,0,13440.0,8,13445.0,6,B
2018-04-04 14:20:17,13445.0,12,11654,2,13445.0,2,13450.0,16,B
2018-04-04 14:20:20,13445.0,2,11656,0,13445.0,1,13450.0,15,B
2018-04-04 14:20:20,13445.0,2,11658,-2,13445.0,1,13450.0,15,B
2018-04-04 14:20:21,13445.0,2,11660,0,13445.0,1,13450.0,14,B
2018-04-04 14:20:26,13450.0,2,11662,0,13445.0,1,13450.0,13,B
2018-04-04 14:20:27,13450.0,2,11664,-2,13445.0,1,13450.0,12,B
2018-04-04 14:20:31,13450.0,2,11666,-2,13440.0,6,13450.0,15,B
2018-04-04 14:20:49,13440.0,2,11668,0,13440.0,5,13445.0,1,S
2018-04-04 14:20:51,13440.0,2,11670,-2,13435.0,5,13445.0,7,S
2018-04-04 14:20:53,13440.0,2,11672,0,13435.0,18,13445.0,2,S
2018-04-04 14:20:56,13440.0,2,11674,2,13440.0,1,13445.0,2,S
2018-04-04 14:21:13,13440.0,2,11676,0,13440.0,1,13445.0,8,S
2018-04-04 14:21:27,13440.0,2,11678,0,13435.0,22,13445.0,7,S
2018-04-04 14:21:31,13440.0,2,11680,-2,13435.0,6,13440.0,4,S
2018-04-04 14:21:42,13440.0,2,11682,0,13435.0,4,13445.0,13,S
2018-04-04 14:21:47,13440.0,2,11684,-2,13435.0,6,13445.0,11,S
2018-04-04 14:22:01,13440.0,4,11688,4,13440.0,3,13445.0,14,S
2018-04-04 14:22:01,13440.0,6,11694,6,13435.0,5,13445.0,14,S
2018-04-04 14:22:16,13440.0,2,11696,-2,13435.0,9,13445.0,10,S
2018-04-04 14:22:35,13440.0,4,11700,-4,13440.0,3,13445.0,10,S
2018-04-04 14:22:35,13440.0,4,11704,0,13440.0,1,13445.0,10,S
2018-04-04 14:22:36,13440.0,2,11706,0,13435.0,6,13440.0,3,S
2018-04-04 14:22:55,13435.0,2,11708,0,13430.0,6,13440.0,1,S
2018-04-04 14:23:02,13430.0,2,11710,0,13430.0,9,13440.0,1,S
2018-04-04 14:23:12,13430.0,2,11712,0,13430.0,9,13440.0,2,S
2018-04-04 14:23:14,13435.0,2,11714,0,13435.0,1,13440.0,2,B
2018-04-04 14:23:15,13435.0,2,11716,2,13430.0,9,13440.0,2,B
2018-04-04 14:23:38,13435.0,4,11720,0,13430.0,4,13440.0,5,B
2018-04-04 14:23:56,13435.0,2,11722,0,13430.0,10,13440.0,4,B
2018-04-04 14:24:13,13435.0,2,11724,-2,13435.0,2,13440.0,4,B
2018-04-04 14:24:51,13435.0,2,11726,-2,13435.0,2,13440.0,4,B
2018-04-04 14:25:36,13430.0,2,11728,0,13430.0,14,13435.0,3,S
2018-04-04 14:25:37,13430.0,12,11740,0,13430.0,7,13435.0,4,S
2018-04-04 14:25:38,13430.0,14,11754,-2,13425.0,5,13435.0,6,S
2018-04-04 14:26:01,13425.0,2,11756,-2,13425.0,1,13430.0,1,S
2018-04-04 14:26:27,13430.0,2,11758,0,13425.0,2,13430.0,3,B
2018-04-04 14:26:29,13430.0,2,11760,0,13430.0,1,13435.0,4,B
2018-04-04 14:26:43,13430.0,2,11762,0,13425.0,21,13435.0,2,B
2018-04-04 14:27:04,13435.0,2,11764,0,13430.0,7,13435.0,1,B
2018-04-04 14:27:07,13435.0,2,11766,0,13430.0,11,13440.0,4,B
2018-04-04 14:27:23,13440.0,2,11768,0,13435.0,2,13440.0,1,B
2018-04-04 14:27:24,13440.0,2,11770,2,13435.0,4,13445.0,14,B
2018-04-04 14:27:43,13440.0,2,11772,2,13435.0,3,13445.0,16,B
2018-04-04 14:28:07,13435.0,2,11774,0,13430.0,11,13440.0,2,S
2018-04-04 14:28:09,13430.0,2,11776,-2,13430.0,6,13435.0,3,S
2018-04-04 14:28:32,13435.0,6,11782,4,13435.0,2,13440.0,5,B
2018-04-04 14:28:32,13435.0,4,11786,4,13430.0,1,13440.0,4,B
2018-04-04 14:28:51,13430.0,2,11788,-2,13430.0,1,13440.0,5,S
2018-04-04 14:29:14,13430.0,4,11792,2,13430.0,2,13440.0,5,S
2018-04-04 14:29:30,13430.0,2,11794,0,13430.0,3,13435.0,2,S
2018-04-04 14:29:33,13435.0,2,11796,-2,13430.0,3,13435.0,1,B
2018-04-04 14:29:43,13430.0,6,11802,0,13425.0,20,13430.0,7,S
2018-04-04 14:29:44,13430.0,8,11810,4,13425.0,18,13430.0,3,S
2018-04-04 14:29:44,13430.0,2,11812,2,13425.0,5,13430.0,2,S
2018-04-04 14:29:51,13430.0,4,11816,4,13425.0,5,13435.0,3,S
2018-04-04 14:30:03,13435.0,4,11820,2,13435.0,1,13440.0,9,B
2018-04-04 14:30:03,13435.0,2,11822,0,13425.0,36,13435.0,3,B
2018-04-04 14:30:12,13440.0,2,11824,0,13430.0,6,13440.0,7,B
2018-04-04 14:30:18,13435.0,2,11826,0,13430.0,2,13435.0,1,S
2018-04-04 14:30:28,13435.0,2,11828,0,13430.0,3,13435.0,4,S
2018-04-04 14:30:44,13435.0,2,11830,0,13430.0,6,13435.0,3,S
2018-04-04 14:30:48,13430.0,18,11848,6,13425.0,32,13430.0,1,S
2018-04-04 14:30:48,13435.0,8,11856,0,13435.0,1,13440.0,8,B
2018-04-04 14:30:49,13435.0,2,11858,0,13430.0,1,13440.0,9,B
2018-04-04 14:30:57,13435.0,2,11860,-2,13435.0,9,13440.0,9,B
2018-04-04 14:31:15,13435.0,10,11870,-2,13435.0,5,13440.0,3,B
2018-04-04 14:31:15,13435.0,10,11880,-4,13430.0,5,13435.0,3,B
2018-04-04 14:31:26,13430.0,2,11882,0,13430.0,4,13435.0,2,S
2018-04-04 14:31:56,13435.0,2,11884,2,13430.0,5,13440.0,13,B
2018-04-04 14:32:30,13435.0,2,11886,2,13430.0,8,13440.0,12,B
2018-04-04 14:32:53,13435.0,2,11888,0,13430.0,8,13440.0,13,B
2018-04-04 14:33:28,13435.0,2,11890,2,13430.0,6,13435.0,6,B
2018-04-04 14:33:35,13435.0,2,11892,2,13430.0,6,13435.0,5,B
2018-04-04 14:33:51,13435.0,2,11894,0,13430.0,6,13435.0,5,B
2018-04-04 14:34:16,13430.0,2,11896,-2,13430.0,4,13435.0,5,S
2018-04-04 14:34:26,13435.0,2,11898,0,13430.0,5,13435.0,4,B
2018-04-04 14:34:34,13430.0,8,11906,-2,13425.0,8,13435.0,18,S
2018-04-04 14:34:59,13425.0,6,11912,2,13420.0,8,13425.0,1,S
2018-04-04 14:35:00,13425.0,2,11914,0,13425.0,2,13430.0,6,S
2018-04-04 14:35:02,13430.0,2,11916,0,13420.0,7,13430.0,5,B
2018-04-04 14:35:08,13420.0,2,11918,2,13420.0,4,13430.0,22,S
2018-04-04 14:35:09,13430.0,4,11922,-2,13420.0,4,13430.0,20,B
2018-04-04 14:35:19,13425.0,2,11924,2,13420.0,3,13425.0,2,S
2018-04-04 14:36:04,13425.0,8,11932,8,13425.0,4,13435.0,18,S
2018-04-04 14:36:21,13430.0,2,11934,0,13430.0,1,13435.0,1,B
2018-04-04 14:36:22,13435.0,2,11936,0,13435.0,1,13440.0,10,B
2018-04-04 14:36:22,13435.0,2,11938,0,13430.0,5,13440.0,10,B
2018-04-04 14:36:29,13435.0,2,11940,0,13430.0,5,13440.0,10,B
2018-04-04 14:37:02,13435.0,2,11942,0,13430.0,7,13440.0,10,B
2018-04-04 14:37:28,13440.0,12,11954,8,13435.0,14,13445.0,15,B
2018-04-04 14:37:51,13440.0,2,11956,0,13440.0,1,13445.0,12,B
2018-04-04 14:37:56,13440.0,4,11960,2,13435.0,14,13445.0,12,B
2018-04-04 14:37:59,13440.0,2,11962,0,13435.0,14,13445.0,12,B
2018-04-04 14:38:39,13435.0,2,11964,2,13430.0,32,13445.0,15,S
2018-04-04 14:39:09,13435.0,2,11966,-2,13435.0,9,13445.0,16,S
2018-04-04 14:39:18,13440.0,2,11968,0,13435.0,10,13445.0,16,B
2018-04-04 14:39:25,13440.0,2,11970,2,13435.0,10,13445.0,18,B
2018-04-04 14:39:35,13440.0,2,11972,2,13435.0,4,13445.0,16,B
2018-04-04 14:40:09,13445.0,26,11998,22,13440.0,5,13450.0,16,B
2018-04-04 14:40:10,13450.0,2,12000,-2,13440.0,5,13450.0,14,B
2018-04-04 14:40:25,13450.0,2,12002,0,13440.0,1,13450.0,14,B
2018-04-04 14:40:27,13450.0,2,12004,0,13440.0,1,13450.0,13,B
2018-04-04 14:40:43,13440.0,2,12006,0,13435.0,32,13450.0,14,S
2018-04-04 14:40:56,13440.0,2,12008,0,13435.0,7,13445.0,2,S
2018-04-04 14:41:03,13435.0,2,12010,2,13435.0,2,13440.0,2,S
2018-04-04 14:41:06,13435.0,2,12012,-2,13435.0,1,13440.0,3,S
2018-04-04 14:41:27,13440.0,4,12016,0,13435.0,1,13445.0,6,B
2018-04-04 14:42:08,13435.0,2,12018,-2,13430.0,19,13440.0,5,S
2018-04-04 14:42:48,13435.0,2,12020,2,13425.0,6,13435.0,5,S
2018-04-04 14:44:32,13425.0,2,12022,0,13425.0,6,13430.0,5,S
2018-04-04 14:44:36,13425.0,6,12028,-2,13425.0,4,13430.0,7,S
2018-04-04 14:44:49,13425.0,2,12030,-2,13425.0,3,13430.0,2,S
2018-04-04 14:44:50,13430.0,4,12034,2,13425.0,3,13430.0,1,B
2018-04-04 14:44:51,13430.0,2,12036,0,13425.0,3,13435.0,8,B
2018-04-04 14:45:00,13435.0,2,12038,2,13430.0,1,13435.0,6,B
2018-04-04 14:45:16,13425.0,8,12046,2,13425.0,2,13430.0,1,S
2018-04-04 14:45:46,13425.0,8,12054,6,13420.0,6,13425.0,6,S
2018-04-04 14:45:46,13425.0,4,12058,2,13420.0,6,13425.0,4,S
2018-04-04 14:45:55,13425.0,8,12066,0,13425.0,1,13430.0,3,S
2018-04-04 14:46:01,13425.0,2,12068,-2,13420.0,5,13430.0,4,S
2018-04-04 14:46:13,13420.0,2,12070,0,13420.0,5,13430.0,9,S
2018-04-04 14:46:17,13425.0,2,12072,0,13420.0,5,13430.0,9,B
2018-04-04 14:46:25,13425.0,2,12074,2,13420.0,5,13425.0,4,B
2018-04-04 14:46:32,13420.0,10,12084,2,13415.0,11,13420.0,53,S
2018-04-04 14:46:35,13415.0,2,12086,0,13415.0,9,13420.0,53,S
2018-04-04 14:46:36,13415.0,18,12104,-14,13410.0,1,13420.0,55,S
2018-04-04 14:46:36,13410.0,4,12108,-2,13410.0,1,13415.0,4,S
2018-04-04 14:46:37,13415.0,2,12110,0,13410.0,7,13415.0,3,B
2018-04-04 14:46:46,13415.0,2,12112,2,13405.0,11,13415.0,2,B
2018-04-04 14:46:56,13410.0,6,12118,-2,13405.0,7,13410.0,2,S
2018-04-04 14:46:56,13410.0,4,12122,2,13410.0,3,13415.0,3,S
2018-04-04 14:46:57,13410.0,2,12124,0,13405.0,10,13415.0,1,S
2018-04-04 14:47:04,13405.0,2,12126,-2,13405.0,8,13415.0,3,S
2018-04-04 14:47:10,13405.0,8,12134,-8,13405.0,6,13415.0,5,S
2018-04-04 14:47:15,13410.0,2,12136,-2,13405.0,5,13410.0,1,B
2018-04-04 14:47:16,13410.0,2,12138,0,13410.0,3,13420.0,3,B
2018-04-04 14:47:42,13415.0,2,12140,2,13410.0,2,13420.0,3,B
2018-04-04 14:47:56,13410.0,4,12144,-4,13410.0,5,13420.0,8,S
2018-04-04 14:48:02,13415.0,2,12146,0,13410.0,6,13420.0,6,B
2018-04-04 14:48:08,13415.0,2,12148,0,13410.0,5,13415.0,1,B
2018-04-04 14:48:42,13410.0,2,12150,0,13410.0,2,13415.0,5,S
2018-04-04 14:48:50,13410.0,4,12154,4,13405.0,10,13415.0,9,S
2018-04-04 14:48:56,13405.0,10,12164,-6,13400.0,37,13410.0,4,S
2018-04-04 14:49:01,13400.0,2,12166,0,13400.0,34,13405.0,5,S
2018-04-04 14:49:01,13410.0,16,12182,-4,13400.0,32,13410.0,2,B
2018-04-04 14:49:05,13400.0,4,12186,0,13400.0,33,13410.0,5,S
2018-04-04 14:49:15,13405.0,6,12192,6,13400.0,32,13405.0,3,B
2018-04-04 14:49:17,13400.0,2,12194,-2,13400.0,32,13405.0,4,S
2018-04-04 14:49:19,13400.0,2,12196,-2,13400.0,30,13405.0,4,S
2018-04-04 14:49:20,13400.0,8,12204,-8,13400.0,26,13405.0,5,S
2018-04-04 14:49:20,13400.0,18,12222,-12,13400.0,17,13405.0,5,S
2018-04-04 14:49:21,13400.0,2,12224,-2,13400.0,16,13405.0,4,S
2018-04-04 14:49:23,13405.0,4,12228,-2,13400.0,16,13405.0,5,B
2018-04-04 14:49:25,13405.0,2,12230,-2,13400.0,19,13410.0,8,B
2018-04-04 14:49:35,13405.0,2,12232,0,13405.0,4,13410.0,10,B
2018-04-04 14:49:37,13410.0,2,12234,0,13405.0,8,13410.0,4,B
2018-04-04 14:49:48,13405.0,6,12240,6,13405.0,4,13410.0,2,S
2018-04-04 14:50:08,13405.0,4,12244,-2,13405.0,5,13410.0,7,S
2018-04-04 14:50:13,13405.0,10,12254,2,13400.0,18,13410.0,6,S
2018-04-04 14:50:24,13410.0,10,12264,0,13405.0,8,13410.0,2,B
2018-04-04 14:50:29,13405.0,6,12270,4,13400.0,20,13410.0,4,S
2018-04-04 14:50:37,13405.0,2,12272,0,13400.0,17,13410.0,6,S
2018-04-04 14:50:40,13410.0,4,12276,-2,13400.0,17,13410.0,4,B
2018-04-04 14:50:48,13400.0,2,12278,0,13400.0,21,13410.0,4,S
2018-04-04 14:50:51,13410.0,4,12282,0,13405.0,1,13410.0,5,B
2018-04-04 14:50:52,13400.0,42,12324,22,13400.0,1,13410.0,7,S
2018-04-04 14:50:55,13395.0,2,12326,-2,13395.0,3,13405.0,4,S
2018-04-04 14:50:59,13400.0,2,12328,0,13395.0,2,13400.0,4,B
2018-04-04 14:51:02,13400.0,4,12332,2,13395.0,4,13400.0,2,B
2018-04-04 14:51:02,13400.0,4,12336,4,13400.0,2,13405.0,4,B
2018-04-04 14:51:04,13400.0,4,12340,4,13395.0,5,13400.0,1,B
2018-04-04 14:51:05,13400.0,2,12342,2,13395.0,3,13400.0,1,B
2018-04-04 14:51:05,13400.0,2,12344,0,13395.0,3,13405.0,3,B
2018-04-04 14:51:35,13415.0,6,12350,-4,13405.0,3,13415.0,3,B
2018-04-04 14:51:39,13415.0,2,12352,0,13405.0,4,13415.0,4,B
2018-04-04 14:51:39,13415.0,4,12356,0,13405.0,4,13415.0,4,B
2018-04-04 14:51:42,13415.0,2,12358,-2,13410.0,3,13420.0,10,B
2018-04-04 14:52:03,13420.0,6,12364,4,13415.0,2,13420.0,5,B
2018-04-04 14:52:22,13415.0,2,12366,0,13415.0,3,13420.0,6,S
2018-04-04 14:52:24,13415.0,4,12370,-4,13415.0,1,13420.0,6,S
2018-04-04 14:52:25,13415.0,2,12372,2,13410.0,7,13415.0,2,S
2018-04-04 14:52:25,13415.0,2,12374,-2,13410.0,4,13415.0,1,S
2018-04-04 14:52:26,13410.0,4,12378,-4,13405.0,5,13415.0,2,S
2018-04-04 14:52:58,13405.0,2,12380,0,13400.0,5,13410.0,4,S
2018-04-04 14:53:04,13400.0,2,12382,2,13395.0,3,13405.0,3,S
2018-04-04 14:53:06,13395.0,2,12384,2,13390.0,5,13400.0,2,S
2018-04-04 14:53:12,13395.0,2,12386,-2,13390.0,8,13395.0,2,S
2018-04-04 14:53:15,13400.0,10,12396,-6,13390.0,8,13405.0,8,B
2018-04-04 14:53:19,13390.0,16,12412,2,13390.0,2,13400.0,7,S
2018-04-04 14:53:19,13390.0,4,12416,2,13385.0,6,13390.0,11,S
2018-04-04 14:53:21,13385.0,2,12418,0,13385.0,4,13390.0,2,S
2018-04-04 14:53:22,13385.0,2,12420,-2,13385.0,3,13390.0,2,S
2018-04-04 14:53:27,13385.0,6,12426,-6,13380.0,8,13390.0,3,S
2018-04-04 14:53:40,13380.0,6,12432,-4,13380.0,6,13385.0,3,S
2018-04-04 14:53:42,13380.0,2,12434,0,13380.0,5,13385.0,3,S
2018-04-04 14:53:43,13380.0,2,12436,2,13380.0,4,13385.0,3,S
2018-04-04 14:53:44,13380.0,6,12442,-2,13380.0,1,13390.0,3,S
2018-04-04 14:53:45,13380.0,2,12444,0,13380.0,1,13390.0,2,S
2018-04-04 14:53:51,13385.0,6,12450,2,13385.0,5,13390.0,4,B
2018-04-04 14:53:54,13385.0,4,12454,2,13385.0,4,13390.0,2,B
2018-04-04 14:53:56,13390.0,2,12456,2,13385.0,4,13390.0,1,B
2018-04-04 14:54:02,13385.0,12,12468,-2,13380.0,3,13390.0,7,S
2018-04-04 14:54:04,13380.0,4,12472,4,13375.0,3,13380.0,2,S
2018-04-04 14:54:11,13380.0,6,12478,-2,13375.0,3,13380.0,2,S
2018-04-04 14:54:12,13380.0,4,12482,-4,13375.0,3,13385.0,3,S
2018-04-04 14:54:15,13385.0,2,12484,-2,13380.0,6,13385.0,1,B
2018-04-04 14:54:17,13380.0,2,12486,2,13380.0,7,13390.0,6,S
2018-04-04 14:54:20,13380.0,2,12488,0,13380.0,6,13390.0,6,S
2018-04-04 14:54:23,13385.0,6,12494,-4,13385.0,1,13390.0,1,B
2018-04-04 14:54:26,13390.0,6,12500,6,13390.0,7,13395.0,4,B
2018-04-04 14:54:28,13395.0,4,12504,0,13395.0,3,13400.0,5,B
2018-04-04 14:54:28,13390.0,20,12524,-4,13390.0,1,13400.0,1,S
2018-04-04 14:54:29,13395.0,2,12526,0,13390.0,1,13400.0,2,B
2018-04-04 14:54:39,13395.0,4,12530,0,13390.0,4,13400.0,4,B
2018-04-04 14:54:43,13390.0,2,12532,-2,13390.0,3,13400.0,7,S
2018-04-04 14:54:54,13400.0,4,12536,2,13395.0,3,13405.0,4,B
2018-04-04 14:55:02,13400.0,22,12558,22,13395.0,3,13405.0,5,B
2018-04-04 14:55:03,13405.0,4,12562,-2,13405.0,1,13410.0,6,B
2018-04-04 14:55:05,13405.0,2,12564,-2,13395.0,3,13405.0,1,B
2018-04-04 14:55:07,13410.0,4,12568,0,13405.0,4,13410.0,4,B
2018-04-04 14:55:08,13410.0,2,12570,0,13405.0,3,13410.0,2,B
2018-04-04 14:55:09,13410.0,4,12574,-2,13410.0,1,13415.0,8,B
2018-04-04 14:55:10,13410.0,2,12576,-2,13405.0,2,13415.0,7,B
2018-04-04 14:55:10,13410.0,2,12578,-2,13410.0,2,13415.0,7,B
2018-04-04 14:55:11,13415.0,2,12580,2,13410.0,2,13415.0,5,B
2018-04-04 14:55:13,13415.0,10,12590,6,13410.0,2,13420.0,9,B
2018-04-04 14:55:15,13420.0,2,12592,2,13415.0,2,13420.0,8,B
2018-04-04 14:55:18,13415.0,2,12594,-2,13415.0,1,13420.0,7,S
2018-04-04 14:55:20,13420.0,2,12596,2,13415.0,1,13420.0,7,B
2018-04-04 14:55:22,13415.0,2,12598,0,13410.0,1,13420.0,6,S
2018-04-04 14:55:23,13420.0,2,12600,0,13410.0,1,13420.0,5,B
2018-04-04 14:55:25,13415.0,2,12602,0,13405.0,3,13420.0,5,S
2018-04-04 14:55:33,13410.0,2,12604,0,13405.0,4,13410.0,1,S
2018-04-04 14:55:37,13405.0,4,12608,2,13390.0,45,13410.0,5,S
2018-04-04 14:56:00,13405.0,6,12614,-2,13400.0,1,13405.0,1,S
2018-04-04 14:56:01,13400.0,2,12616,-2,13395.0,3,13405.0,1,S
2018-04-04 14:56:06,13420.0,8,12624,-6,13400.0,1,13420.0,8,B
2018-04-04 14:56:16,13405.0,2,12626,2,13400.0,3,13415.0,9,S
2018-04-04 14:56:26,13410.0,2,12628,0,13400.0,5,13415.0,4,B
2018-04-04 14:56:41,13415.0,2,12630,-2,13405.0,2,13415.0,4,B
2018-04-04 14:56:51,13415.0,4,12634,4,13410.0,1,13415.0,2,B
2018-04-04 14:57:00,13410.0,2,12636,-2,13400.0,1,13410.0,1,S
2018-04-04 14:57:01,13410.0,2,12638,2,13405.0,9,13415.0,2,S
2018-04-04 14:57:03,13415.0,4,12642,0,13410.0,4,13420.0,11,B
2018-04-04 14:57:08,13410.0,2,12644,-2,13400.0,1,13420.0,8,S
2018-04-04 14:57:49,13415.0,2,12646,0,13405.0,3,13415.0,2,B
2018-04-04 14:57:59,13415.0,6,12652,6,13405.0,4,13410.0,3,B
2018-04-04 14:58:00,13430.0,44,12696,-16,13405.0,4,13435.0,4,B
2018-04-04 14:58:03,13415.0,2,12698,2,13405.0,3,13425.0,1,S
2018-04-04 14:58:09,13415.0,2,12700,0,13410.0,3,13425.0,1,S
2018-04-04 14:58:18,13420.0,2,12702,0,13420.0,1,13425.0,2,B
2018-04-04 14:58:18,13420.0,2,12704,0,13415.0,2,13425.0,2,B
2018-04-04 14:58:22,13425.0,6,12710,2,13415.0,2,13430.0,8,B
2018-04-04 14:58:26,13420.0,2,12712,0,13415.0,2,13430.0,7,S
2018-04-04 14:58:32,13420.0,2,12714,2,13415.0,2,13425.0,2,S
2018-04-04 14:58:37,13415.0,2,12716,-2,13415.0,1,13420.0,1,S
2018-04-04 14:58:48,13415.0,2,12718,0,13415.0,1,13425.0,1,S
2018-04-04 14:58:54,13420.0,4,12722,4,13415.0,1,13420.0,3,B
2018-04-04 14:58:57,13430.0,10,12732,-2,13415.0,1,13430.0,8,B
2018-04-04 14:58:59,13430.0,2,12734,2,13415.0,1,13430.0,8,B
2018-04-04 14:59:00,13430.0,6,12740,0,13420.0,1,13430.0,5,B
2018-04-04 14:59:08,13420.0,2,12742,2,13415.0,2,13425.0,2,S
2018-04-04 14:59:13,13425.0,2,12744,2,13420.0,1,13430.0,5,B
2018-04-04 14:59:21,13420.0,2,12746,2,13415.0,2,13420.0,1,S
2018-04-04 14:59:22,13420.0,2,12748,2,13415.0,2,13425.0,1,S
2018-04-04 14:59:29,13420.0,2,12750,0,13415.0,2,13425.0,1,S
2018-04-04 14:59:30,13425.0,4,12754,-4,13415.0,1,13430.0,6,B
2018-04-04 14:59:44,13415.0,4,12758,-2,13415.0,6,13425.0,2,S
2018-04-04 14:59:56,13420.0,2,12760,0,13415.0,1,13425.0,1,B
2018-04-04 14:59:57,13425.0,2,12762,0,13415.0,1,13430.0,7,B
2018-04-04 14:59:58,13415.0,2,12764,-2,13410.0,4,13420.0,1,S
2018-04-09 08:59:00,13485.0,14,14,55116,0.0,0,0.0,0,B
2018-04-09 09:00:00,13480.0,4,18,4,13450.0,1,13480.0,1,S
2018-04-09 09:00:01,13450.0,36,54,-6,13445.0,1,13450.0,5,S
2018-04-09 09:00:01,13450.0,10,64,4,13455.0,13,13585.0,1,S
2018-04-09 09:00:03,13480.0,2,66,0,13485.0,5,13520.0,4,B
2018-04-09 09:00:04,13500.0,2,68,2,13495.0,3,13505.0,1,B
2018-04-09 09:00:05,13500.0,6,74,2,13500.0,3,13505.0,2,B
2018-04-09 09:00:05,13495.0,2,76,0,13495.0,1,13505.0,1,S
2018-04-09 09:00:06,13505.0,2,78,0,13495.0,4,13500.0,10,B
2018-04-09 09:00:06,13505.0,22,100,0,13485.0,5,13500.0,3,B
2018-04-09 09:00:09,13485.0,2,102,0,13485.0,5,13495.0,1,S
2018-04-09 09:00:10,13485.0,12,114,-10,13485.0,4,13500.0,1,S
2018-04-09 09:00:12,13485.0,2,116,0,13480.0,7,13490.0,1,S
2018-04-09 09:00:12,13495.0,4,120,-2,13480.0,7,13495.0,4,B
2018-04-09 09:00:15,13490.0,4,124,2,13480.0,7,13490.0,3,S
2018-04-09 09:00:16,13480.0,14,138,-4,13480.0,3,13485.0,4,S
2018-04-09 09:00:16,13480.0,6,144,0,13465.0,15,13485.0,5,S
2018-04-09 09:00:20,13475.0,2,146,0,13465.0,4,13475.0,5,S
2018-04-09 09:00:21,13475.0,2,148,0,13465.0,3,13475.0,4,S
2018-04-09 09:00:22,13465.0,6,154,6,13455.0,1,13470.0,2,S
2018-04-09 09:00:23,13455.0,6,160,-4,13450.0,3,13465.0,2,S
2018-04-09 09:00:24,13465.0,16,176,-4,13450.0,2,13465.0,10,B
2018-04-09 09:00:25,13450.0,2,178,2,13450.0,1,13465.0,1,S
2018-04-09 09:00:26,13455.0,2,180,2,13450.0,1,13460.0,2,B
2018-04-09 09:00:26,13450.0,2,182,0,13425.0,1,13455.0,2,S
2018-04-09 09:00:28,13450.0,2,184,-2,13450.0,5,13470.0,1,S
2018-04-09 09:00:30,13460.0,2,186,0,13450.0,5,13465.0,5,B
2018-04-09 09:00:31,13450.0,4,190,-2,13450.0,3,13460.0,1,S
2018-04-09 09:00:33,13450.0,2,192,-2,13450.0,2,13460.0,1,S
2018-04-09 09:00:34,13450.0,4,196,-2,13440.0,5,13450.0,1,S
2018-04-09 09:00:35,13450.0,2,198,-2,13455.0,1,13460.0,3,S
2018-04-09 09:00:35,13450.0,6,204,0,13450.0,4,13455.0,2,S
2018-04-09 09:00:37,13455.0,4,208,2,13450.0,4,13460.0,1,B
2018-04-09 09:00:38,13455.0,2,210,2,13455.0,2,13465.0,2,B
2018-04-09 09:00:39,13455.0,4,214,0,13450.0,4,13455.0,1,B
2018-04-09 09:00:41,13465.0,8,222,8,13455.0,2,13465.0,2,B
2018-04-09 09:00:43,13455.0,4,226,2,13450.0,1,13460.0,5,S
2018-04-09 09:00:44,13455.0,2,228,2,13450.0,5,13465.0,7,S
2018-04-09 09:00:45,13470.0,4,232,0,13465.0,11,13475.0,1,B
2018-04-09 09:00:45,13475.0,4,236,2,13475.0,2,13480.0,2,B
2018-04-09 09:00:46,13475.0,4,240,4,13465.0,5,13475.0,2,B
2018-04-09 09:00:49,13480.0,2,242,0,13470.0,6,13480.0,1,B
2018-04-09 09:00:50,13485.0,2,244,0,13475.0,9,13485.0,4,B
2018-04-09 09:00:52,13485.0,14,258,0,13470.0,6,13490.0,5,B
2018-04-09 09:00:57,13480.0,4,262,4,13480.0,2,13490.0,1,S
2018-04-09 09:01:00,13485.0,2,264,0,13480.0,13,13490.0,3,B
2018-04-09 09:01:01,13485.0,2,266,0,13485.0,8,13490.0,1,B
2018-04-09 09:01:02,13490.0,2,268,0,13485.0,1,13500.0,4,B
2018-04-09 09:01:03,13500.0,4,272,-2,13495.0,11,13525.0,2,B
2018-04-09 09:01:04,13500.0,4,276,4,13505.0,5,13510.0,2,B
2018-04-09 09:01:05,13505.0,12,288,8,13500.0,1,13505.0,6,B
2018-04-09 09:01:05,13500.0,2,290,0,13495.0,5,13505.0,5,S
2018-04-09 09:01:06,13500.0,2,292,-2,13500.0,3,13505.0,4,S
2018-04-09 09:01:06,13500.0,14,306,2,13500.0,9,13520.0,14,S
2018-04-09 09:01:09,13510.0,2,308,-2,13505.0,1,13510.0,2,B
2018-04-09 09:01:09,13505.0,8,316,8,13505.0,1,13515.0,4,S
2018-04-09 09:01:10,13515.0,2,318,-2,13515.0,1,13520.0,1,B
2018-04-09 09:01:10,13515.0,2,320,0,13505.0,9,13520.0,1,B
2018-04-09 09:01:13,13520.0,6,326,6,13520.0,1,13525.0,6,B
2018-04-09 09:01:13,13520.0,2,328,0,13515.0,5,13525.0,1,B
2018-04-09 09:01:15,13520.0,4,332,0,13510.0,4,13520.0,2,B
2018-04-09 09:01:15,13520.0,2,334,-2,13515.0,15,13525.0,2,B
2018-04-09 09:01:18,13520.0,2,336,2,13515.0,12,13525.0,2,B
2018-04-09 09:01:18,13515.0,6,342,6,13515.0,9,13525.0,1,S
2018-04-09 09:01:19,13520.0,2,344,0,13510.0,5,13520.0,1,B
2018-04-09 09:01:20,13520.0,2,346,-2,13510.0,8,13525.0,2,B
2018-04-09 09:01:22,13520.0,22,368,-2,13520.0,10,13525.0,5,B
2018-04-09 09:01:22,13520.0,20,388,-10,13505.0,3,13525.0,2,B
2018-04-09 09:01:24,13520.0,28,416,2,13520.0,7,13525.0,30,B
2018-04-09 09:01:24,13520.0,14,430,0,13515.0,1,13520.0,3,B
2018-04-09 09:01:25,13520.0,6,436,2,13510.0,3,13525.0,1,B
2018-04-09 09:01:26,13525.0,4,440,4,13520.0,6,13545.0,1,B
2018-04-09 09:01:27,13525.0,24,464,12,13525.0,4,13535.0,2,B
2018-04-09 09:01:27,13540.0,40,504,0,13535.0,2,13540.0,23,B
2018-04-09 09:01:28,13535.0,4,508,0,13520.0,26,13535.0,4,S
2018-04-09 09:01:30,13525.0,6,514,0,13530.0,20,13535.0,4,S
2018-04-09 09:01:30,13525.0,42,556,-6,13520.0,23,13525.0,5,S
2018-04-09 09:01:31,13525.0,10,566,-8,13520.0,22,13530.0,5,S
2018-04-09 09:01:32,13520.0,6,572,-6,13520.0,20,13525.0,3,S
2018-04-09 09:01:33,13525.0,2,574,0,13525.0,2,13530.0,9,B
2018-04-09 09:01:34,13525.0,4,578,0,13525.0,10,13530.0,7,B
2018-04-09 09:01:34,13530.0,2,580,0,13525.0,10,13530.0,7,B
2018-04-09 09:01:36,13530.0,18,598,-6,13530.0,1,13535.0,1,B
2018-04-09 09:01:36,13530.0,6,604,2,13525.0,3,13530.0,6,B
2018-04-09 09:01:37,13525.0,6,610,0,13520.0,20,13530.0,15,S
2018-04-09 09:01:40,13520.0,10,620,0,13520.0,15,13525.0,6,S
2018-04-09 09:01:41,13525.0,20,640,-4,13520.0,15,13525.0,17,B
2018-04-09 09:01:42,13520.0,10,650,-4,13520.0,13,13530.0,1,S
2018-04-09 09:01:43,13525.0,2,652,2,13525.0,2,13530.0,5,B
2018-04-09 09:01:44,13520.0,2,654,0,13520.0,12,13530.0,2,S
2018-04-09 09:01:45,13525.0,6,660,0,13520.0,12,13530.0,2,B
2018-04-09 09:01:46,13520.0,2,662,-2,13520.0,11,13530.0,1,S
2018-04-09 09:01:50,13530.0,2,664,0,13520.0,11,13530.0,1,B
2018-04-09 09:01:51,13520.0,4,668,0,13520.0,11,13530.0,5,S
2018-04-09 09:01:55,13525.0,4,672,0,13525.0,8,13530.0,5,B
2018-04-09 09:01:56,13530.0,8,680,0,13525.0,8,13530.0,1,B
2018-04-09 09:01:57,13525.0,2,682,0,13525.0,7,13530.0,7,S
2018-04-09 09:01:59,13530.0,2,684,-2,13525.0,9,13535.0,3,B
2018-04-09 09:02:00,13530.0,2,686,2,13525.0,7,13535.0,9,B
2018-04-09 09:02:00,13535.0,2,688,0,13525.0,7,13535.0,10,B
2018-04-09 09:02:01,13525.0,2,690,0,13525.0,6,13535.0,6,S
2018-04-09 09:02:02,13535.0,4,694,4,13525.0,9,13545.0,3,B
2018-04-09 09:02:03,13535.0,2,696,0,13535.0,6,13540.0,16,B
2018-04-09 09:02:04,13545.0,4,700,-4,13540.0,3,13545.0,10,B
2018-04-09 09:02:06,13535.0,24,724,24,13525.0,8,13540.0,5,S
2018-04-09 09:02:08,13535.0,4,728,0,13530.0,13,13535.0,3,S
2018-04-09 09:02:10,13535.0,8,736,-6,13535.0,6,13540.0,22,S
2018-04-09 09:02:10,13530.0,26,762,0,13530.0,6,13535.0,6,S
2018-04-09 09:02:12,13535.0,2,764,0,13530.0,7,13535.0,4,B
2018-04-09 09:02:13,13530.0,14,778,-10,13525.0,6,13530.0,1,S
2018-04-09 09:02:14,13530.0,6,784,0,13530.0,17,13535.0,15,S
2018-04-09 09:02:14,13530.0,22,806,-12,13530.0,6,13535.0,15,S
2018-04-09 09:02:15,13530.0,10,816,-6,13530.0,1,13535.0,15,S
2018-04-09 09:02:15,13530.0,2,818,0,13525.0,6,13535.0,15,S
2018-04-09 09:02:16,13535.0,10,828,10,13525.0,6,13535.0,13,B
2018-04-09 09:02:19,13535.0,6,834,4,13530.0,21,13540.0,17,B
2018-04-09 09:02:19,13530.0,2,836,-2,13530.0,20,13540.0,18,S
2018-04-09 09:02:23,13530.0,2,838,0,13530.0,19,13535.0,12,S
2018-04-09 09:02:24,13530.0,2,840,0,13530.0,18,13535.0,12,S
2018-04-09 09:02:25,13535.0,2,842,0,13535.0,20,13540.0,4,B
2018-04-09 09:02:27,13540.0,8,850,-8,13535.0,20,13545.0,3,B
2018-04-09 09:02:28,13535.0,4,854,-4,13535.0,18,13545.0,18,S
2018-04-09 09:02:31,13540.0,2,856,2,13535.0,18,13545.0,18,B
2018-04-09 09:02:32,13535.0,2,858,-2,13535.0,17,13540.0,11,S
2018-04-09 09:02:32,13535.0,34,892,0,13530.0,17,13535.0,3,S
2018-04-09 09:02:33,13535.0,8,900,0,13535.0,6,13545.0,23,S
2018-04-09 09:02:34,13535.0,10,910,-10,13535.0,1,13540.0,11,S
2018-04-09 09:02:35,13535.0,4,914,0,13530.0,17,13535.0,1,S
2018-04-09 09:02:35,13535.0,2,916,-2,13530.0,17,13545.0,24,S
2018-04-09 09:02:36,13535.0,4,920,-2,13530.0,17,13545.0,24,S
2018-04-09 09:02:41,13530.0,2,922,0,13530.0,38,13535.0,1,S
2018-04-09 09:02:42,13530.0,6,928,-2,13530.0,36,13540.0,1,S
2018-04-09 09:02:44,13535.0,2,930,0,13535.0,19,13540.0,2,B
2018-04-09 09:02:45,13535.0,10,940,0,13535.0,14,13540.0,7,B
2018-04-09 09:02:46,13540.0,8,948,2,13535.0,24,13545.0,10,B
2018-04-09 09:02:48,13540.0,2,950,-2,13540.0,2,13545.0,13,B
2018-04-09 09:02:51,13540.0,6,956,0,13535.0,26,13545.0,10,B
2018-04-09 09:02:53,13545.0,2,958,2,13540.0,30,13545.0,9,B
2018-04-09 09:02:54,13540.0,60,1018,0,13535.0,24,13545.0,9,S
2018-04-09 09:02:54,13540.0,2,1020,2,13535.0,26,13545.0,10,S
2018-04-09 09:02:58,13540.0,2,1022,-2,13540.0,19,13545.0,10,S
2018-04-09 09:02:59,13540.0,4,1026,0,13540.0,17,13545.0,10,S
2018-04-09 09:03:00,13540.0,20,1046,0,13540.0,10,13545.0,10,S
2018-04-09 09:03:01,13545.0,4,1050,4,13540.0,10,13545.0,8,B
2018-04-09 09:03:01,13545.0,8,1058,0,13540.0,10,13545.0,4,B
2018-04-09 09:03:02,13545.0,4,1062,-2,13540.0,10,13545.0,2,B
2018-04-09 09:03:03,13550.0,6,1068,2,13545.0,2,13550.0,14,B
2018-04-09 09:03:03,13550.0,26,1094,-2,13545.0,3,13550.0,1,B
2018-04-09 09:03:04,13545.0,6,1100,0,13540.0,10,13550.0,1,S
2018-04-09 09:03:04,13540.0,4,1104,-4,13540.0,5,13545.0,16,S
2018-04-09 09:03:05,13540.0,10,1114,0,13535.0,24,13540.0,1,S
2018-04-09 09:03:05,13535.0,16,1130,-16,13535.0,16,13540.0,1,S
2018-04-09 09:03:10,13535.0,2,1132,-2,13535.0,15,13540.0,11,S
2018-04-09 09:03:12,13535.0,2,1134,-2,13535.0,14,13540.0,11,S
2018-04-09 09:03:12,13535.0,8,1142,0,13535.0,10,13540.0,11,S
2018-04-09 09:03:15,13535.0,2,1144,0,13535.0,9,13540.0,14,S
2018-04-09 09:03:16,13535.0,2,1146,0,13535.0,8,13540.0,14,S
2018-04-09 09:03:20,13535.0,8,1154,-8,13535.0,5,13540.0,14,S
2018-04-09 09:03:20,13540.0,8,1162,-2,13535.0,2,13540.0,13,B
2018-04-09 09:03:21,13535.0,4,1166,-2,13530.0,34,13535.0,5,S
2018-04-09 09:03:22,13530.0,14,1180,-12,13530.0,27,13535.0,3,S
2018-04-09 09:03:24,13530.0,2,1182,-2,13530.0,28,13535.0,3,S
2018-04-09 09:03:26,13530.0,22,1204,-14,13530.0,17,13535.0,15,S
2018-04-09 09:03:26,13530.0,6,1210,-2,13530.0,14,13535.0,2,S
2018-04-09 09:03:27,13530.0,30,1240,-4,13525.0,6,13530.0,13,S
2018-04-09 09:03:28,13525.0,12,1252,-10,13520.0,10,13530.0,13,S
2018-04-09 09:03:29,13530.0,4,1256,2,13530.0,1,13535.0,18,B
2018-04-09 09:03:34,13520.0,2,1258,-2,13520.0,11,13530.0,12,S
2018-04-09 09:03:37,13505.0,34,1292,-24,13500.0,5,13505.0,1,S
2018-04-09 09:03:38,13505.0,2,1294,0,13510.0,3,13525.0,5,S
2018-04-09 09:03:39,13520.0,8,1302,2,13515.0,2,13525.0,3,B
2018-04-09 09:03:40,13515.0,8,1310,6,13510.0,15,13525.0,3,S
2018-04-09 09:03:44,13510.0,2,1312,0,13510.0,2,13520.0,3,S
2018-04-09 09:03:44,13510.0,2,1314,2,13510.0,1,13520.0,3,S
2018-04-09 09:03:47,13510.0,2,1316,-2,13505.0,6,13520.0,6,S
2018-04-09 09:03:47,13515.0,2,1318,0,13505.0,5,13515.0,5,B
2018-04-09 09:03:51,13505.0,2,1320,-2,13505.0,3,13515.0,8,S
2018-04-09 09:03:52,13515.0,6,1326,0,13505.0,4,13515.0,2,B
2018-04-09 09:03:54,13515.0,2,1328,0,13510.0,2,13520.0,5,B
2018-04-09 09:03:56,13520.0,4,1332,2,13515.0,1,13525.0,4,B
2018-04-09 09:04:05,13510.0,6,1338,0,13505.0,4,13515.0,6,S
2018-04-09 09:04:15,13505.0,8,1346,2,13500.0,5,13505.0,6,S
2018-04-09 09:04:17,13500.0,10,1356,-2,13485.0,12,13505.0,9,S
2018-04-09 09:04:19,13490.0,2,1358,-2,13490.0,13,13500.0,1,S
2018-04-09 09:04:22,13485.0,4,1362,-2,13485.0,1,13495.0,3,S
2018-04-09 09:04:23,13485.0,2,1364,0,13475.0,3,13485.0,4,S
2018-04-09 09:04:24,13490.0,2,1366,0,13485.0,1,13490.0,13,B
2018-04-09 09:04:25,13485.0,2,1368,-2,13480.0,1,13490.0,2,S
2018-04-09 09:04:25,13480.0,2,1370,-2,13480.0,1,13485.0,5,S
2018-04-09 09:04:26,13480.0,4,1374,0,13475.0,6,13480.0,1,S
2018-04-09 09:04:26,13475.0,10,1384,4,13475.0,2,13485.0,6,S
2018-04-09 09:04:28,13480.0,2,1386,0,13475.0,1,13485.0,6,B
2018-04-09 09:04:31,13475.0,2,1388,0,13475.0,6,13480.0,2,S
2018-04-09 09:04:31,13475.0,2,1390,0,13475.0,5,13485.0,6,S
2018-04-09 09:04:32,13475.0,4,1394,-2,13475.0,3,13480.0,5,S
2018-04-09 09:04:32,13475.0,6,1400,0,13470.0,1,13475.0,2,S
2018-04-09 09:04:33,13470.0,2,1402,2,13470.0,1,13475.0,2,S
2018-04-09 09:04:34,13470.0,2,1404,2,13470.0,1,13475.0,2,S
2018-04-09 09:04:34,13470.0,6,1410,-2,13475.0,1,13480.0,7,S
2018-04-09 09:04:35,13475.0,4,1414,4,13470.0,1,13480.0,6,B
2018-04-09 09:04:35,13475.0,2,1416,0,13465.0,1,13475.0,11,B
2018-04-09 09:04:36,13465.0,2,1418,2,13465.0,1,13470.0,1,S
2018-04-09 09:04:36,13470.0,4,1422,-2,13470.0,21,13480.0,6,B
2018-04-09 09:04:37,13475.0,14,1436,0,13475.0,1,13485.0,2,B
2018-04-09 09:04:37,13480.0,6,1442,4,13480.0,13,13490.0,1,B
2018-04-09 09:04:38,13480.0,2,1444,2,13485.0,1,13500.0,15,B
2018-04-09 09:04:38,13480.0,2,1446,0,13480.0,5,13495.0,7,B
2018-04-09 09:04:39,13485.0,2,1448,0,13485.0,9,13495.0,7,B
2018-04-09 09:04:39,13485.0,2,1450,0,13490.0,1,13495.0,4,B
2018-04-09 09:04:40,13485.0,6,1456,2,13480.0,9,13490.0,1,B
2018-04-09 09:04:40,13480.0,8,1464,-2,13480.0,2,13485.0,11,S
2018-04-09 09:04:41,13480.0,4,1468,0,13475.0,1,13485.0,10,S
2018-04-09 09:04:42,13475.0,2,1470,2,13475.0,9,13485.0,1,S
2018-04-09 09:04:42,13470.0,2,1472,2,13470.0,2,13480.0,4,S
2018-04-09 09:04:43,13475.0,2,1474,0,13475.0,3,13485.0,1,B
2018-04-09 09:04:43,13475.0,6,1480,6,13470.0,2,13475.0,1,B
2018-04-09 09:04:44,13475.0,4,1484,4,13475.0,1,13480.0,3,B
2018-04-09 09:04:44,13480.0,4,1488,2,13470.0,2,13480.0,2,B
2018-04-09 09:04:45,13475.0,2,1490,0,13470.0,3,13485.0,1,S
2018-04-09 09:04:45,13475.0,2,1492,0,13470.0,4,13480.0,2,S
2018-04-09 09:04:46,13470.0,2,1494,0,13470.0,2,13480.0,5,S
2018-04-09 09:04:46,13470.0,2,1496,0,13470.0,1,13480.0,5,S
2018-04-09 09:04:47,13470.0,4,1500,0,13470.0,1,13485.0,2,S
2018-04-09 09:04:49,13465.0,8,1508,4,13455.0,12,13465.0,7,S
2018-04-09 09:04:49,13460.0,2,1510,0,13440.0,3,13465.0,12,S
2018-04-09 09:04:50,13445.0,20,1530,-16,13445.0,33,13460.0,1,S
2018-04-09 09:04:51,13455.0,2,1532,0,13450.0,1,13460.0,3,B
2018-04-09 09:04:51,13465.0,8,1540,0,13455.0,6,13465.0,6,B
2018-04-09 09:04:52,13460.0,2,1542,0,13455.0,6,13465.0,8,S
2018-04-09 09:04:53,13455.0,10,1552,6,13455.0,2,13465.0,9,S
2018-04-09 09:04:54,13465.0,6,1558,0,13460.0,1,13465.0,3,B
2018-04-09 09:05:00,13460.0,10,1568,-2,13460.0,2,13470.0,4,S
2018-04-09 09:05:01,13460.0,10,1578,10,13460.0,16,13470.0,1,S
2018-04-09 09:05:02,13470.0,2,1580,0,13460.0,6,13470.0,6,B
2018-04-09 09:05:05,13460.0,2,1582,2,13460.0,5,13470.0,15,S
2018-04-09 09:05:06,13465.0,2,1584,2,13455.0,4,13465.0,5,B
2018-04-09 09:05:09,13465.0,2,1586,-2,13460.0,7,13470.0,5,B
2018-04-09 09:05:11,13470.0,10,1596,2,13470.0,1,13475.0,4,B
2018-04-09 09:05:12,13475.0,2,1598,-2,13465.0,17,13485.0,1,B
2018-04-09 09:05:18,13480.0,2,1600,2,13470.0,6,13480.0,1,B
2018-04-09 09:05:20,13470.0,12,1612,0,13465.0,4,13475.0,8,S
2018-04-09 09:05:25,13470.0,2,1614,2,13460.0,9,13470.0,6,S
2018-04-09 09:05:33,13470.0,4,1618,0,13465.0,6,13470.0,2,S
2018-04-09 09:05:34,13465.0,12,1630,8,13460.0,6,13470.0,9,S
2018-04-09 09:05:41,13470.0,2,1632,2,13465.0,6,13470.0,2,B
2018-04-09 09:05:41,13470.0,8,1640,-2,13465.0,5,13470.0,4,B
2018-04-09 09:05:43,13470.0,2,1642,2,13465.0,5,13470.0,3,B
2018-04-09 09:05:50,13465.0,2,1644,-2,13465.0,2,13470.0,3,S
2018-04-09 09:05:59,13470.0,8,1652,-2,13465.0,2,13475.0,8,B
2018-04-09 09:06:02,13465.0,2,1654,-2,13465.0,4,13470.0,3,S
2018-04-09 09:06:04,13470.0,2,1656,0,13465.0,4,13470.0,2,B
2018-04-09 09:06:05,13465.0,8,1664,8,13460.0,8,13470.0,2,S
2018-04-09 09:06:08,13455.0,20,1684,2,13445.0,2,13465.0,3,S
2018-04-09 09:06:10,13455.0,2,1686,0,13435.0,7,13445.0,5,S
2018-04-09 09:06:15,13445.0,4,1690,0,13440.0,3,13450.0,8,S
2018-04-09 09:06:23,13440.0,2,1692,0,13435.0,3,13445.0,12,S
2018-04-09 09:06:27,13440.0,16,1708,2,13435.0,9,13440.0,10,S
2018-04-09 09:06:27,13440.0,40,1748,12,13440.0,6,13450.0,13,S
2018-04-09 09:06:30,13440.0,2,1750,2,13440.0,4,13445.0,4,S
2018-04-09 09:06:30,13445.0,2,1752,0,13445.0,1,13450.0,8,B
2018-04-09 09:06:31,13445.0,2,1754,-2,13440.0,4,13450.0,11,B
2018-04-09 09:06:35,13440.0,2,1756,0,13435.0,12,13445.0,2,S
2018-04-09 09:06:35,13445.0,6,1762,2,13445.0,4,13450.0,3,B
2018-04-09 09:06:42,13445.0,2,1764,2,13445.0,1,13450.0,8,B
2018-04-09 09:06:42,13445.0,4,1768,-2,13440.0,2,13450.0,7,B
2018-04-09 09:06:43,13440.0,2,1770,2,13440.0,1,13445.0,1,S
2018-04-09 09:06:44,13445.0,2,1772,-2,13445.0,1,13450.0,6,B
2018-04-09 09:06:46,13445.0,2,1774,0,13440.0,3,13445.0,2,B
2018-04-09 09:06:50,13440.0,4,1778,4,13435.0,8,13440.0,2,S
2018-04-09 09:06:54,13440.0,6,1784,0,13435.0,10,13445.0,6,S
2018-04-09 09:06:57,13435.0,10,1794,2,13435.0,5,13445.0,9,S
2018-04-09 09:07:00,13440.0,2,1796,-2,13435.0,5,13440.0,2,B
2018-04-09 09:07:02,13435.0,2,1798,-2,13435.0,4,13440.0,2,S
2018-04-09 09:07:07,13435.0,4,1802,-4,13430.0,2,13440.0,11,S
2018-04-09 09:07:08,13440.0,4,1806,0,13440.0,1,13445.0,4,B
2018-04-09 09:07:09,13440.0,8,1814,6,13440.0,4,13445.0,1,B
2018-04-09 09:07:10,13445.0,2,1816,0,13440.0,4,13450.0,6,B
2018-04-09 09:07:15,13445.0,4,1820,-4,13445.0,4,13455.0,27,B
2018-04-09 09:07:17,13445.0,2,1822,0,13450.0,11,13460.0,30,B
2018-04-09 09:07:30,13460.0,6,1828,0,13455.0,3,13465.0,6,B
2018-04-09 09:07:35,13465.0,8,1836,-6,13465.0,6,13470.0,10,B
2018-04-09 09:07:36,13460.0,18,1854,-14,13455.0,3,13465.0,49,S
2018-04-09 09:07:50,13460.0,20,1874,-2,13455.0,2,13460.0,24,S
2018-04-09 09:07:53,13460.0,6,1880,0,13455.0,6,13460.0,7,S
2018-04-09 09:07:53,13460.0,8,1888,0,13455.0,6,13465.0,30,S
2018-04-09 09:07:55,13460.0,4,1892,2,13455.0,6,13465.0,17,S
2018-04-09 09:07:55,13465.0,4,1896,4,13460.0,9,13465.0,5,B
2018-04-09 09:07:56,13465.0,12,1908,0,13460.0,9,13470.0,13,B
2018-04-09 09:07:56,13470.0,6,1914,6,13465.0,18,13470.0,3,B
2018-04-09 09:07:57,13470.0,6,1920,4,13470.0,7,13475.0,1,B
2018-04-09 09:07:57,13470.0,2,1922,2,13470.0,3,13475.0,12,B
2018-04-09 09:08:09,13470.0,14,1936,4,13465.0,1,13475.0,32,B
2018-04-09 09:08:10,13475.0,2,1938,0,13465.0,2,13475.0,31,B
2018-04-09 09:08:10,13475.0,2,1940,0,13465.0,2,13475.0,30,B
2018-04-09 09:08:20,13470.0,2,1942,0,13465.0,5,13470.0,4,S
2018-04-09 09:08:25,13465.0,2,1944,0,13465.0,4,13470.0,4,S
2018-04-09 09:08:28,13465.0,8,1952,4,13460.0,3,13465.0,1,S
2018-04-09 09:09:00,13460.0,2,1954,2,13455.0,21,13465.0,4,S
2018-04-09 09:09:04,13465.0,4,1958,-4,13455.0,5,13465.0,7,B
2018-04-09 09:09:06,13455.0,2,1960,0,13455.0,5,13465.0,41,S
2018-04-09 09:09:06,13455.0,2,1962,0,13455.0,4,13465.0,41,S
2018-04-09 09:09:07,13455.0,4,1966,2,13455.0,2,13465.0,41,S
2018-04-09 09:09:07,13455.0,2,1968,0,13450.0,17,13465.0,42,S
2018-04-09 09:09:08,13450.0,2,1970,0,13450.0,17,13455.0,2,S
2018-04-09 09:09:09,13455.0,4,1974,0,13450.0,16,13460.0,1,B
2018-04-09 09:09:14,13460.0,4,1978,0,13455.0,2,13465.0,24,B
2018-04-09 09:09:16,13455.0,2,1980,-2,13450.0,17,13460.0,2,S
2018-04-09 09:09:23,13460.0,2,1982,0,13455.0,6,13465.0,3,B
2018-04-09 09:09:31,13460.0,2,1984,0,13455.0,1,13460.0,1,B
2018-04-09 09:09:43,13465.0,2,1986,2,13460.0,1,13470.0,7,B
2018-04-09 09:10:03,13470.0,2,1988,0,13465.0,6,13475.0,18,B
2018-04-09 09:10:05,13475.0,2,1990,0,13465.0,7,13480.0,24,B
2018-04-09 09:10:27,13480.0,2,1992,2,13470.0,8,13480.0,20,B
2018-04-09 09:10:30,13480.0,4,1996,0,13470.0,8,13480.0,18,B
2018-04-09 09:10:34,13470.0,10,2006,8,13470.0,4,13475.0,7,S
2018-04-09 09:10:35,13470.0,2,2008,2,13470.0,3,13475.0,1,S
2018-04-09 09:10:40,13475.0,2,2010,0,13470.0,1,13480.0,19,B
2018-04-09 09:10:41,13475.0,2,2012,2,13470.0,2,13475.0,7,B
2018-04-09 09:10:42,13470.0,4,2016,-2,13465.0,3,13475.0,2,S
2018-04-09 09:10:42,13465.0,2,2018,0,13460.0,1,13470.0,52,S
2018-04-09 09:10:43,13465.0,2,2020,2,13460.0,1,13465.0,1,S
2018-04-09 09:10:43,13470.0,8,2028,2,13450.0,6,13465.0,1,B
2018-04-09 09:10:44,13470.0,2,2030,0,13455.0,2,13465.0,2,B
2018-04-09 09:10:45,13460.0,2,2032,2,13455.0,5,13465.0,16,S
2018-04-09 09:10:46,13455.0,6,2038,4,13455.0,3,13465.0,1,S
2018-04-09 09:10:48,13455.0,6,2044,0,13455.0,2,13465.0,15,S
2018-04-09 09:10:53,13465.0,2,2046,-2,13455.0,2,13465.0,2,B
2018-04-09 09:11:04,13455.0,4,2050,-4,13450.0,6,13460.0,9,S
2018-04-09 09:11:09,13455.0,2,2052,2,13450.0,6,13455.0,3,S
2018-04-09 09:11:13,13455.0,2,2054,2,13450.0,6,13460.0,7,S
2018-04-09 09:11:18,13450.0,4,2058,0,13450.0,4,13455.0,1,S
2018-04-09 09:11:19,13455.0,2,2060,2,13450.0,4,13455.0,1,B
2018-04-09 09:11:21,13460.0,4,2064,-2,13455.0,2,13460.0,4,B
2018-04-09 09:11:22,13460.0,8,2072,4,13460.0,1,13465.0,5,B
2018-04-09 09:11:23,13460.0,6,2078,0,13455.0,3,13460.0,2,B
2018-04-09 09:11:23,13460.0,4,2082,4,13460.0,1,13470.0,21,B
2018-04-09 09:11:29,13465.0,2,2084,2,13460.0,1,13465.0,1,B
2018-04-09 09:11:32,13465.0,2,2086,0,13460.0,1,13465.0,1,B
2018-04-09 09:11:34,13465.0,2,2088,2,13460.0,1,13470.0,21,B
2018-04-09 09:11:35,13460.0,2,2090,-2,13455.0,2,13460.0,2,S
2018-04-09 09:11:36,13455.0,2,2092,0,13450.0,6,13455.0,5,S
2018-04-09 09:11:37,13455.0,4,2096,4,13450.0,4,13460.0,26,S
2018-04-09 09:11:39,13455.0,4,2100,4,13455.0,1,13460.0,25,S
2018-04-09 09:11:49,13455.0,6,2106,0,13450.0,10,13460.0,1,S
2018-04-09 09:11:49,13455.0,2,2108,0,13450.0,10,13460.0,25,S
2018-04-09 09:11:50,13450.0,12,2120,4,13450.0,3,13455.0,10,S
2018-04-09 09:11:51,13450.0,6,2126,2,13445.0,5,13450.0,1,S
2018-04-09 09:11:51,13445.0,2,2128,2,13445.0,2,13455.0,9,S
2018-04-09 09:12:02,13455.0,4,2132,4,13450.0,2,13460.0,5,B
2018-04-09 09:12:08,13460.0,2,2134,2,13455.0,1,13465.0,6,B
2018-04-09 09:12:09,13460.0,4,2138,0,13455.0,4,13460.0,15,B
2018-04-09 09:12:10,13460.0,2,2140,0,13455.0,40,13460.0,14,B
2018-04-09 09:12:10,13460.0,14,2154,6,13455.0,44,13460.0,7,B
2018-04-09 09:12:11,13460.0,4,2158,4,13455.0,44,13460.0,5,B
2018-04-09 09:12:11,13460.0,10,2168,0,13455.0,44,13465.0,1,B
2018-04-09 09:12:15,13465.0,2,2170,0,13455.0,42,13465.0,29,B
2018-04-09 09:12:15,13465.0,2,2172,0,13455.0,43,13465.0,28,B
2018-04-09 09:12:26,13455.0,10,2182,2,13455.0,80,13460.0,2,S
2018-04-09 09:12:27,13455.0,6,2188,-6,13455.0,78,13460.0,23,S
2018-04-09 09:12:27,13455.0,16,2204,-12,13455.0,70,13460.0,28,S
2018-04-09 09:12:28,13455.0,4,2208,-4,13455.0,68,13460.0,28,S
2018-04-09 09:12:28,13455.0,4,2212,0,13455.0,66,13460.0,29,S
2018-04-09 09:12:29,13455.0,6,2218,-4,13455.0,23,13460.0,28,S
2018-04-09 09:12:29,13475.0,88,2306,-36,13455.0,19,13475.0,1,B
2018-04-09 09:12:30,13460.0,2,2308,0,13455.0,22,13465.0,10,S
2018-04-09 09:12:32,13460.0,6,2314,4,13455.0,21,13465.0,2,S
2018-04-09 09:12:35,13455.0,14,2328,0,13455.0,15,13465.0,2,S
2018-04-09 09:12:36,13465.0,4,2332,4,13460.0,4,13470.0,3,B
2018-04-09 09:12:41,13460.0,4,2336,0,13455.0,16,13460.0,1,S
2018-04-09 09:12:41,13465.0,4,2340,2,13460.0,1,13465.0,2,B
2018-04-09 09:12:46,13455.0,20,2360,0,13455.0,5,13465.0,11,S
2018-04-09 09:12:46,13465.0,2,2362,2,13455.0,5,13465.0,10,B
2018-04-09 09:12:48,13460.0,2,2364,2,13455.0,5,13465.0,2,S
2018-04-09 09:13:04,13455.0,6,2370,2,13450.0,10,13455.0,12,S
2018-04-09 09:13:05,13450.0,4,2374,2,13450.0,4,13455.0,9,S
2018-04-09 09:13:05,13450.0,8,2382,-4,13445.0,5,13455.0,10,S
2018-04-09 09:13:13,13450.0,2,2384,0,13445.0,8,13455.0,8,S
2018-04-09 09:13:24,13455.0,4,2388,-4,13455.0,5,13465.0,9,B
2018-04-09 09:13:29,13450.0,10,2398,6,13450.0,1,13460.0,12,S
2018-04-09 09:13:30,13455.0,4,2402,0,13450.0,1,13460.0,16,B
2018-04-09 09:13:35,13455.0,2,2404,0,13450.0,5,13460.0,4,B
2018-04-09 09:13:50,13450.0,2,2406,0,13450.0,3,13460.0,15,S
2018-04-09 09:13:52,13455.0,2,2408,0,13450.0,7,13460.0,7,B
2018-04-09 09:14:05,13450.0,2,2410,-2,13445.0,8,13455.0,18,S
2018-04-09 09:14:23,13450.0,6,2416,-6,13450.0,3,13460.0,25,S
2018-04-09 09:14:30,13460.0,6,2422,6,13455.0,8,13460.0,2,B
2018-04-09 09:14:30,13460.0,4,2426,0,13460.0,6,13465.0,3,B
2018-04-09 09:14:38,13460.0,2,2428,2,13465.0,49,13470.0,22,B
2018-04-09 09:14:46,13465.0,2,2430,0,13465.0,48,13470.0,24,B
2018-04-09 09:14:47,13465.0,4,2434,0,13465.0,46,13470.0,24,B
2018-04-09 09:14:49,13470.0,4,2438,-2,13465.0,46,13470.0,22,B
2018-04-09 09:14:51,13470.0,2,2440,0,13465.0,46,13470.0,23,B
2018-04-09 09:14:57,13470.0,22,2462,22,13465.0,36,13470.0,22,B
2018-04-09 09:15:04,13470.0,8,2470,4,13465.0,37,13470.0,13,B
2018-04-09 09:15:04,13470.0,4,2474,4,13465.0,37,13470.0,11,B
2018-04-09 09:15:08,13470.0,4,2478,0,13465.0,38,13470.0,10,B
2018-04-09 09:15:08,13470.0,10,2488,4,13465.0,38,13470.0,5,B
2018-04-09 09:15:09,13470.0,10,2498,-2,13470.0,2,13475.0,7,B
2018-04-09 09:15:10,13475.0,8,2506,-2,13470.0,5,13480.0,6,B
2018-04-09 09:15:22,13475.0,2,2508,0,13470.0,8,13480.0,11,B
2018-04-09 09:15:24,13475.0,10,2518,8,13470.0,2,13480.0,11,B
2018-04-09 09:15:31,13470.0,2,2520,0,13470.0,3,13475.0,1,S
2018-04-09 09:15:34,13475.0,2,2522,2,13470.0,2,13475.0,1,B
2018-04-09 09:15:40,13475.0,4,2526,2,13475.0,34,13480.0,16,B
2018-04-09 09:15:41,13480.0,4,2530,0,13475.0,34,13480.0,15,B
2018-04-09 09:15:49,13475.0,4,2534,4,13475.0,32,13480.0,16,S
2018-04-09 09:15:51,13475.0,2,2536,2,13475.0,31,13480.0,17,S
2018-04-09 09:15:52,13480.0,10,2546,-6,13475.0,31,13480.0,10,B
2018-04-09 09:16:01,13475.0,16,2562,16,13475.0,23,13480.0,12,S
2018-04-09 09:16:01,13475.0,26,2588,20,13475.0,10,13480.0,24,S
2018-04-09 09:16:02,13470.0,28,2616,20,13465.0,3,13475.0,14,S
2018-04-09 09:16:05,13475.0,2,2618,-2,13470.0,3,13475.0,1,B
2018-04-09 09:16:11,13475.0,14,2632,8,13475.0,13,13480.0,14,B
2018-04-09 09:16:12,13475.0,10,2642,8,13475.0,8,13480.0,15,B
2018-04-09 09:16:13,13475.0,2,2644,0,13475.0,7,13480.0,15,B
2018-04-09 09:16:14,13475.0,14,2658,0,13470.0,2,13480.0,10,B
2018-04-09 09:16:15,13465.0,10,2668,6,13465.0,7,13470.0,1,S
2018-04-09 09:16:15,13470.0,4,2672,0,13470.0,3,13480.0,11,B
2018-04-09 09:16:16,13465.0,4,2676,2,13465.0,6,13480.0,12,S
2018-04-09 09:16:29,13475.0,10,2686,8,13465.0,9,13475.0,4,B
2018-04-09 09:16:39,13475.0,6,2692,-4,13475.0,1,13480.0,12,B
2018-04-09 09:16:39,13475.0,2,2694,0,13470.0,10,13480.0,9,B
2018-04-09 09:16:43,13475.0,2,2696,2,13475.0,1,13480.0,9,B
2018-04-09 09:16:43,13475.0,2,2698,2,13470.0,10,13480.0,9,B
2018-04-09 09:16:44,13480.0,6,2704,6,13475.0,11,13480.0,6,B
2018-04-09 09:16:44,13480.0,12,2716,4,13475.0,14,13485.0,7,B
2018-04-09 09:16:48,13475.0,14,2730,2,13475.0,8,13485.0,3,S
2018-04-09 09:16:48,13475.0,6,2736,0,13475.0,5,13485.0,3,S
2018-04-09 09:16:58,13485.0,2,2738,0,13475.0,2,13485.0,9,B
2018-04-09 09:17:03,13475.0,14,2752,0,13475.0,6,13485.0,5,S
2018-04-09 09:17:04,13485.0,4,2756,-4,13480.0,1,13485.0,1,B
2018-04-09 09:17:06,13480.0,12,2768,6,13475.0,6,13480.0,45,S
2018-04-09 09:17:07,13480.0,50,2818,24,13475.0,7,13480.0,20,S
2018-04-09 09:17:07,13480.0,40,2858,40,13480.0,5,13490.0,7,S
2018-04-09 09:17:09,13485.0,2,2860,-2,13485.0,1,13490.0,5,B
2018-04-09 09:17:14,13485.0,2,2862,-2,13485.0,2,13490.0,9,B
2018-04-09 09:17:17,13490.0,4,2866,0,13485.0,7,13490.0,7,B
2018-04-09 09:17:17,13485.0,24,2890,18,13485.0,20,13495.0,3,S
2018-04-09 09:17:20,13490.0,4,2894,0,13490.0,3,13500.0,22,B
2018-04-09 09:17:21,13495.0,4,2898,2,13490.0,1,13500.0,19,B
2018-04-09 09:17:22,13500.0,2,2900,2,13490.0,2,13500.0,18,B
2018-04-09 09:17:24,13500.0,2,2902,2,13490.0,3,13500.0,17,B
2018-04-09 09:17:25,13490.0,6,2908,6,13485.0,11,13490.0,2,S
2018-04-09 09:17:25,13490.0,4,2912,0,13490.0,3,13495.0,2,S
2018-04-09 09:17:29,13500.0,6,2918,0,13490.0,3,13500.0,15,B
2018-04-09 09:17:30,13500.0,14,2932,-6,13495.0,6,13500.0,6,B
2018-04-09 09:17:31,13510.0,14,2946,6,13505.0,2,13510.0,16,B
2018-04-09 09:17:32,13505.0,10,2956,0,13500.0,2,13505.0,1,S
2018-04-09 09:17:32,13495.0,8,2964,-2,13495.0,5,13505.0,1,S
2018-04-09 09:17:38,13495.0,4,2968,-4,13485.0,16,13500.0,19,S
2018-04-09 09:17:39,13495.0,2,2970,-2,13490.0,4,13495.0,1,S
2018-04-09 09:17:41,13495.0,2,2972,0,13490.0,4,13500.0,9,S
2018-04-09 09:17:43,13500.0,2,2974,0,13490.0,6,13500.0,1,B
2018-04-09 09:17:48,13505.0,2,2976,2,13500.0,5,13510.0,7,B
2018-04-09 09:17:50,13510.0,4,2980,0,13505.0,2,13515.0,5,B
2018-04-09 09:17:51,13510.0,4,2984,0,13505.0,4,13510.0,7,B
2018-04-09 09:17:51,13505.0,2,2986,2,13505.0,1,13510.0,9,S
2018-04-09 09:17:53,13510.0,6,2992,0,13505.0,2,13515.0,8,B
2018-04-09 09:17:55,13505.0,2,2994,2,13505.0,1,13515.0,9,S
2018-04-09 09:18:05,13505.0,2,2996,-2,13510.0,4,13520.0,7,S
2018-04-09 09:18:07,13520.0,2,2998,0,13510.0,8,13525.0,5,B
2018-04-09 09:18:08,13520.0,4,3002,0,13515.0,5,13525.0,2,B
2018-04-09 09:18:11,13525.0,4,3006,0,13520.0,3,13530.0,30,B
2018-04-09 09:18:15,13525.0,4,3010,4,13520.0,1,13525.0,4,B
2018-04-09 09:18:18,13530.0,4,3014,2,13520.0,2,13530.0,31,B
2018-04-09 09:18:18,13530.0,16,3030,0,13520.0,4,13530.0,19,B
2018-04-09 09:18:19,13530.0,12,3042,-6,13525.0,5,13530.0,14,B
2018-04-09 09:18:20,13535.0,46,3088,-14,13535.0,1,13540.0,19,B
2018-04-09 09:18:21,13535.0,8,3096,2,13535.0,4,13540.0,6,B
2018-04-09 09:18:21,13540.0,28,3124,-4,13535.0,2,13540.0,2,B
2018-04-09 09:18:22,13535.0,4,3128,4,13530.0,6,13535.0,3,S
2018-04-09 09:18:22,13535.0,4,3132,0,13535.0,4,13540.0,13,S
2018-04-09 09:18:23,13540.0,10,3142,-4,13535.0,7,13540.0,1,B
2018-04-09 09:18:25,13545.0,4,3146,0,13540.0,1,13545.0,7,B
2018-04-09 09:18:26,13535.0,10,3156,0,13535.0,2,13545.0,7,S
2018-04-09 09:18:26,13545.0,6,3162,0,13540.0,3,13545.0,4,B
2018-04-09 09:18:27,13545.0,8,3170,0,13540.0,4,13550.0,11,B
2018-04-09 09:18:29,13550.0,14,3184,12,13545.0,9,13550.0,2,B
2018-04-09 09:18:29,13555.0,8,3192,-2,13555.0,4,13560.0,6,B
2018-04-09 09:18:30,13555.0,6,3198,0,13555.0,3,13560.0,7,B
2018-04-09 09:18:31,13565.0,14,3212,-4,13560.0,25,13570.0,2,B
2018-04-09 09:18:31,13570.0,2,3214,2,13565.0,1,13570.0,1,B
2018-04-09 09:18:33,13575.0,6,3220,2,13570.0,5,13580.0,4,B
2018-04-09 09:18:34,13575.0,2,3222,2,13570.0,8,13585.0,6,B
2018-04-09 09:18:34,13575.0,2,3224,-2,13570.0,6,13575.0,4,B
2018-04-09 09:18:35,13575.0,14,3238,-4,13575.0,3,13585.0,8,B
2018-04-09 09:18:36,13575.0,6,3244,4,13575.0,2,13580.0,7,B
2018-04-09 09:18:37,13570.0,6,3250,6,13570.0,5,13580.0,4,S
2018-04-09 09:18:40,13575.0,8,3258,2,13570.0,5,13580.0,1,B
2018-04-09 09:18:40,13575.0,2,3260,2,13570.0,3,13575.0,5,B
2018-04-09 09:18:43,13570.0,6,3266,0,13565.0,10,13575.0,7,S
2018-04-09 09:18:44,13570.0,2,3268,2,13560.0,9,13570.0,9,S
2018-04-09 09:18:45,13570.0,2,3270,2,13560.0,3,13570.0,8,S
2018-04-09 09:18:46,13570.0,2,3272,0,13560.0,3,13570.0,9,S
2018-04-09 09:18:47,13560.0,2,3274,-2,13555.0,5,13560.0,2,S
2018-04-09 09:18:50,13560.0,10,3284,2,13555.0,3,13560.0,3,S
2018-04-09 09:18:51,13555.0,6,3290,4,13550.0,2,13555.0,2,S
2018-04-09 09:18:51,13555.0,4,3294,-4,13555.0,2,13560.0,6,S
2018-04-09 09:18:52,13555.0,2,3296,0,13550.0,4,13560.0,10,S
2018-04-09 09:18:55,13550.0,2,3298,-2,13550.0,1,13560.0,11,S
2018-04-09 09:18:56,13555.0,2,3300,2,13550.0,1,13555.0,7,B
2018-04-09 09:18:57,13555.0,2,3302,0,13550.0,1,13560.0,12,B
2018-04-09 09:18:57,13555.0,2,3304,0,13555.0,2,13560.0,9,B
2018-04-09 09:18:58,13550.0,24,3328,-14,13535.0,1,13545.0,2,S
2018-04-09 09:18:58,13545.0,6,3334,-2,13545.0,12,13555.0,3,S
2018-04-09 09:19:00,13550.0,4,3338,4,13545.0,1,13550.0,1,B
2018-04-09 09:19:00,13550.0,2,3340,2,13545.0,1,13555.0,8,B
2018-04-09 09:19:03,13555.0,4,3344,2,13545.0,15,13555.0,14,B
2018-04-09 09:19:05,13555.0,2,3346,0,13540.0,17,13550.0,1,B
2018-04-09 09:19:08,13545.0,6,3352,-6,13540.0,13,13550.0,3,S
2018-04-09 09:19:12,13540.0,10,3362,0,13540.0,12,13545.0,2,S
2018-04-09 09:19:15,13540.0,4,3366,4,13535.0,5,13545.0,18,S
2018-04-09 09:19:19,13535.0,2,3368,0,13530.0,5,13540.0,2,S
2018-04-09 09:19:20,13535.0,2,3370,0,13535.0,1,13545.0,7,S
2018-04-09 09:19:33,13545.0,6,3376,6,13540.0,1,13545.0,3,B
2018-04-09 09:19:34,13540.0,2,3378,-2,13535.0,14,13545.0,3,S
2018-04-09 09:19:35,13535.0,34,3412,14,13530.0,9,13535.0,23,S
2018-04-09 09:19:36,13535.0,46,3458,32,13535.0,43,13545.0,5,S
2018-04-09 09:19:38,13535.0,2,3460,2,13530.0,5,13540.0,1,S
2018-04-09 09:19:57,13540.0,4,3464,0,13535.0,5,13545.0,8,B
2018-04-09 09:19:58,13535.0,10,3474,10,13530.0,17,13545.0,2,S
2018-04-09 09:20:07,13545.0,6,3480,4,13545.0,2,13550.0,9,B
2018-04-09 09:20:07,13545.0,4,3484,0,13540.0,1,13545.0,5,B
2018-04-09 09:20:08,13540.0,2,3486,2,13535.0,2,13545.0,6,S
2018-04-09 09:20:09,13540.0,10,3496,10,13535.0,3,13545.0,6,S
2018-04-09 09:20:14,13535.0,4,3500,-2,13530.0,6,13545.0,7,S
2018-04-09 09:20:21,13535.0,4,3504,0,13530.0,7,13540.0,9,S
2018-04-09 09:20:23,13535.0,2,3506,0,13530.0,5,13535.0,4,S
2018-04-09 09:20:28,13535.0,4,3510,-4,13530.0,4,13535.0,2,S
2018-04-09 09:20:29,13535.0,2,3512,0,13530.0,5,13535.0,1,S
2018-04-09 09:20:30,13530.0,2,3514,2,13530.0,3,13535.0,1,S
2018-04-09 09:20:35,13535.0,2,3516,-2,13530.0,4,13535.0,2,B
2018-04-09 09:20:45,13535.0,6,3522,6,13535.0,8,13545.0,6,B
2018-04-09 09:20:46,13535.0,2,3524,2,13535.0,7,13545.0,6,B
2018-04-09 09:20:50,13540.0,2,3526,0,13535.0,6,13540.0,1,B
2018-04-09 09:20:53,13545.0,20,3546,4,13530.0,6,13545.0,2,B
2018-04-09 09:21:01,13545.0,2,3548,2,13535.0,5,13545.0,5,B
2018-04-09 09:21:01,13540.0,20,3568,6,13535.0,1,13545.0,21,S
2018-04-09 09:21:02,13535.0,2,3570,0,13530.0,8,13540.0,5,S
2018-04-09 09:21:18,13530.0,2,3572,0,13530.0,7,13535.0,17,S
2018-04-09 09:21:19,13535.0,24,3596,20,13530.0,5,13535.0,9,B
2018-04-09 09:21:19,13535.0,2,3598,2,13530.0,5,13535.0,6,B
2018-04-09 09:21:20,13530.0,2,3600,0,13530.0,4,13535.0,6,S
2018-04-09 09:21:21,13535.0,2,3602,2,13530.0,4,13535.0,5,B
2018-04-09 09:21:21,13530.0,4,3606,-2,13530.0,2,13535.0,5,S
2018-04-09 09:21:22,13530.0,4,3610,2,13525.0,5,13535.0,5,S
2018-04-09 09:21:22,13525.0,2,3612,0,13525.0,3,13535.0,7,S
2018-04-09 09:21:23,13530.0,2,3614,2,13525.0,2,13530.0,9,B
2018-04-09 09:21:27,13530.0,2,3616,0,13525.0,2,13530.0,8,B
2018-04-09 09:21:30,13525.0,4,3620,4,13525.0,1,13530.0,7,S
2018-04-09 09:21:34,13525.0,2,3622,2,13520.0,13,13530.0,7,S
2018-04-09 09:21:39,13525.0,2,3624,0,13515.0,6,13525.0,2,S
2018-04-09 09:21:42,13520.0,2,3626,2,13515.0,5,13525.0,4,S
2018-04-09 09:21:50,13525.0,16,3642,14,13525.0,2,13530.0,13,B
2018-04-09 09:21:52,13525.0,4,3646,0,13520.0,4,13530.0,8,B
2018-04-09 09:21:56,13530.0,2,3648,2,13520.0,3,13530.0,9,B
2018-04-09 09:21:59,13520.0,2,3650,-2,13515.0,6,13525.0,4,S
2018-04-09 09:22:07,13520.0,4,3654,0,13515.0,6,13525.0,4,S
2018-04-09 09:22:09,13515.0,4,3658,2,13510.0,3,13520.0,4,S
2018-04-09 09:22:09,13510.0,2,3660,-2,13510.0,4,13520.0,4,S
2018-04-09 09:22:10,13520.0,2,3662,0,13510.0,3,13520.0,3,B
2018-04-09 09:22:13,13520.0,14,3676,4,13510.0,9,13525.0,9,B
2018-04-09 09:22:13,13520.0,16,3692,16,13520.0,28,13525.0,9,B
2018-04-09 09:22:14,13520.0,8,3700,4,13520.0,24,13525.0,8,B
2018-04-09 09:22:14,13520.0,40,3740,20,13520.0,4,13525.0,10,B
2018-04-09 09:22:15,13520.0,8,3748,6,13515.0,2,13525.0,7,B
2018-04-09 09:22:23,13525.0,4,3752,4,13520.0,1,13525.0,4,B
2018-04-09 09:22:26,13525.0,10,3762,0,13525.0,9,13530.0,12,B
2018-04-09 09:22:26,13525.0,4,3766,4,13525.0,7,13530.0,12,B
2018-04-09 09:22:27,13525.0,2,3768,0,13525.0,6,13530.0,12,B
2018-04-09 09:22:27,13525.0,2,3770,0,13525.0,5,13530.0,7,B
2018-04-09 09:22:36,13525.0,2,3772,0,13525.0,4,13530.0,8,B
2018-04-09 09:22:41,13530.0,2,3774,0,13525.0,4,13530.0,7,B
2018-04-09 09:22:43,13530.0,8,3782,4,13525.0,8,13530.0,3,B
2018-04-09 09:22:44,13530.0,6,3788,6,13530.0,10,13535.0,6,B
2018-04-09 09:22:44,13535.0,2,3790,0,13535.0,1,13540.0,6,B
2018-04-09 09:22:45,13535.0,2,3792,0,13530.0,10,13535.0,1,B
2018-04-09 09:22:55,13535.0,2,3794,-2,13530.0,10,13535.0,2,B
2018-04-09 09:23:00,13535.0,4,3798,0,13530.0,11,13535.0,1,B
2018-04-09 09:23:01,13535.0,4,3802,2,13535.0,8,13540.0,7,B
2018-04-09 09:23:01,13535.0,10,3812,8,13535.0,3,13540.0,4,B
2018-04-09 09:23:02,13535.0,6,3818,6,13530.0,1,13540.0,4,B
2018-04-09 09:23:05,13540.0,2,3820,2,13530.0,1,13540.0,15,B
2018-04-09 09:23:07,13540.0,2,3822,2,13530.0,1,13535.0,4,B
2018-04-09 09:23:17,13535.0,2,3824,2,13530.0,3,13535.0,1,S
2018-04-09 09:23:20,13535.0,2,3826,0,13535.0,3,13540.0,27,S
2018-04-09 09:23:20,13535.0,6,3832,0,13530.0,1,13540.0,28,S
2018-04-09 09:23:21,13535.0,2,3834,0,13525.0,5,13535.0,1,S
2018-04-09 09:23:27,13530.0,2,3836,-2,13530.0,9,13535.0,5,S
2018-04-09 09:23:27,13530.0,4,3840,-4,13530.0,5,13535.0,5,S
2018-04-09 09:23:34,13525.0,2,3842,0,13520.0,4,13530.0,5,S
2018-04-09 09:23:35,13520.0,2,3844,0,13515.0,5,13525.0,4,S
2018-04-09 09:23:38,13515.0,2,3846,2,13510.0,8,13520.0,3,S
2018-04-09 09:23:43,13520.0,2,3848,0,13510.0,7,13520.0,7,B
2018-04-09 09:23:45,13510.0,6,3854,2,13505.0,9,13515.0,3,S
2018-04-09 09:23:54,13515.0,2,3856,-2,13510.0,2,13515.0,3,B
2018-04-09 09:23:55,13510.0,2,3858,0,13505.0,7,13515.0,2,S
2018-04-09 09:23:59,13505.0,14,3872,-8,13505.0,7,13510.0,1,S
2018-04-09 09:24:00,13510.0,2,3874,-2,13510.0,2,13515.0,4,B
2018-04-09 09:24:02,13515.0,10,3884,0,13510.0,3,13520.0,8,B
2018-04-09 09:24:03,13515.0,4,3888,0,13515.0,2,13520.0,5,B
2018-04-09 09:24:03,13515.0,4,3892,2,13510.0,3,13520.0,8,B
2018-04-09 09:24:09,13515.0,4,3896,0,13510.0,3,13520.0,8,B
2018-04-09 09:24:30,13515.0,2,3898,-2,13510.0,4,13520.0,7,B
2018-04-09 09:24:49,13520.0,2,3900,0,13515.0,10,13520.0,5,B
2018-04-09 09:24:51,13520.0,2,3902,0,13515.0,10,13520.0,4,B
2018-04-09 09:24:57,13520.0,4,3906,-4,13515.0,11,13520.0,2,B
2018-04-09 09:24:57,13520.0,4,3910,4,13515.0,11,13525.0,7,B
2018-04-09 09:25:00,13525.0,4,3914,0,13520.0,10,13525.0,2,B
2018-04-09 09:25:01,13525.0,4,3918,-4,13525.0,2,13530.0,3,B
2018-04-09 09:25:02,13530.0,2,3920,-2,13525.0,4,13535.0,6,B
2018-04-09 09:25:04,13535.0,2,3922,0,13530.0,8,13540.0,6,B
2018-04-09 09:25:16,13530.0,8,3930,0,13530.0,4,13535.0,5,S
2018-04-09 09:25:17,13530.0,8,3938,0,13525.0,3,13535.0,5,S
2018-04-09 09:25:17,13530.0,2,3940,0,13525.0,3,13530.0,3,S
2018-04-09 09:25:20,13530.0,2,3942,2,13525.0,2,13530.0,5,S
2018-04-09 09:25:21,13530.0,4,3946,0,13525.0,6,13535.0,8,S
2018-04-09 09:25:31,13530.0,2,3948,0,13525.0,2,13530.0,3,S
2018-04-09 09:25:39,13530.0,2,3950,0,13525.0,2,13530.0,3,S
2018-04-09 09:25:50,13530.0,6,3956,0,13530.0,2,13535.0,7,S
2018-04-09 09:25:51,13530.0,4,3960,4,13525.0,4,13530.0,4,S
2018-04-09 09:25:52,13525.0,6,3966,0,13520.0,2,13525.0,4,S
2018-04-09 09:26:00,13525.0,2,3968,-2,13520.0,7,13530.0,6,S
2018-04-09 09:26:05,13525.0,2,3970,2,13525.0,4,13530.0,6,S
2018-04-09 09:26:10,13525.0,8,3978,4,13520.0,4,13530.0,17,S
2018-04-09 09:26:23,13525.0,2,3980,2,13520.0,2,13525.0,5,S
2018-04-09 09:26:31,13525.0,2,3982,0,13525.0,4,13530.0,9,S
2018-04-09 09:26:45,13525.0,2,3984,0,13525.0,3,13530.0,6,S
2018-04-09 09:26:47,13525.0,2,3986,0,13525.0,2,13530.0,5,S
2018-04-09 09:26:52,13525.0,4,3990,0,13520.0,6,13530.0,6,S
2018-04-09 09:26:55,13525.0,2,3992,0,13525.0,2,13530.0,6,S
2018-04-09 09:26:56,13525.0,2,3994,-2,13525.0,1,13530.0,5,S
2018-04-09 09:27:03,13530.0,4,3998,0,13525.0,6,13530.0,3,B
2018-04-09 09:27:04,13530.0,6,4004,-6,13530.0,9,13535.0,6,B
2018-04-09 09:27:16,13535.0,4,4008,0,13530.0,12,13540.0,5,B
2018-04-09 09:27:28,13535.0,2,4010,-2,13530.0,8,13540.0,8,B
2018-04-09 09:27:35,13535.0,2,4012,-2,13530.0,8,13540.0,8,B
2018-04-09 09:27:48,13540.0,2,4014,0,13535.0,2,13540.0,7,B
2018-04-09 09:28:05,13540.0,2,4016,0,13535.0,2,13540.0,7,B
2018-04-09 09:28:13,13535.0,2,4018,0,13530.0,15,13540.0,8,S
2018-04-09 09:28:21,13535.0,2,4020,0,13530.0,17,13540.0,8,S
2018-04-09 09:28:25,13530.0,42,4062,32,13525.0,11,13530.0,9,S
2018-04-09 09:28:25,13530.0,18,4080,8,13530.0,1,13540.0,11,S
2018-04-09 09:28:26,13540.0,2,4082,0,13530.0,2,13540.0,12,B
2018-04-09 09:28:31,13540.0,20,4102,-12,13530.0,3,13540.0,2,B
2018-04-09 09:28:37,13535.0,2,4104,-2,13535.0,1,13540.0,4,S
2018-04-09 09:29:09,13535.0,2,4106,2,13530.0,5,13535.0,1,S
2018-04-09 09:29:09,13535.0,2,4108,0,13535.0,6,13540.0,7,S
2018-04-09 09:29:13,13540.0,2,4110,-2,13535.0,3,13540.0,5,B
2018-04-09 09:29:15,13535.0,8,4118,-6,13530.0,9,13535.0,1,S
2018-04-09 09:29:16,13535.0,2,4120,0,13535.0,1,13540.0,5,S
2018-04-09 09:29:34,13535.0,2,4122,2,13530.0,9,13540.0,5,S
2018-04-09 09:29:54,13540.0,28,4150,2,13535.0,8,13545.0,6,B
2018-04-09 09:29:55,13545.0,2,4152,2,13540.0,11,13545.0,1,B
2018-04-09 09:30:01,13540.0,2,4154,0,13535.0,7,13545.0,5,S
2018-04-09 09:30:03,13545.0,2,4156,-2,13540.0,1,13545.0,2,B
2018-04-09 09:30:03,13540.0,2,4158,0,13535.0,8,13545.0,2,S
2018-04-09 09:30:29,13540.0,2,4160,0,13535.0,3,13545.0,8,S
2018-04-09 09:30:30,13535.0,6,4166,0,13530.0,8,13540.0,9,S
2018-04-09 09:30:55,13530.0,2,4168,-2,13530.0,1,13535.0,7,S
2018-04-09 09:30:59,13530.0,4,4172,-4,13525.0,5,13535.0,7,S
2018-04-09 09:31:22,13525.0,2,4174,0,13525.0,2,13530.0,3,S
2018-04-09 09:31:27,13525.0,2,4176,2,13520.0,15,13530.0,3,S
2018-04-09 09:31:28,13520.0,2,4178,-2,13520.0,5,13530.0,3,S
2018-04-09 09:31:33,13530.0,6,4184,2,13525.0,9,13535.0,9,B
2018-04-09 09:32:14,13530.0,2,4186,2,13530.0,6,13540.0,4,B
2018-04-09 09:33:22,13535.0,12,4198,-2,13535.0,1,13540.0,16,B
2018-04-09 09:33:23,13540.0,2,4200,-2,13535.0,8,13545.0,19,B
2018-04-09 09:33:31,13540.0,2,4202,-2,13535.0,2,13540.0,1,B
2018-04-09 09:33:41,13540.0,2,4204,-2,13535.0,1,13540.0,2,B
2018-04-09 09:33:44,13540.0,2,4206,0,13535.0,2,13545.0,19,B
2018-04-09 09:33:51,13540.0,2,4208,-2,13540.0,4,13545.0,16,B
2018-04-09 09:33:51,13540.0,8,4216,-8,13535.0,2,13545.0,16,B
2018-04-09 09:33:59,13535.0,2,4218,0,13530.0,5,13540.0,25,S
2018-04-09 09:34:14,13535.0,6,4224,0,13535.0,2,13545.0,17,S
2018-04-09 09:34:17,13540.0,2,4226,0,13535.0,3,13540.0,1,B
2018-04-09 09:34:36,13540.0,10,4236,10,13540.0,5,13545.0,4,B
2018-04-09 09:34:37,13540.0,2,4238,2,13540.0,4,13545.0,4,B
2018-04-09 09:34:37,13540.0,2,4240,0,13540.0,3,13545.0,4,B
2018-04-09 09:34:38,13540.0,6,4246,6,13535.0,4,13545.0,4,B
2018-04-09 09:35:19,13540.0,2,4248,2,13535.0,6,13545.0,15,B
2018-04-09 09:35:22,13540.0,4,4252,0,13535.0,21,13545.0,13,B
2018-04-09 09:35:34,13540.0,2,4254,0,13535.0,7,13545.0,14,B
2018-04-09 09:35:53,13545.0,20,4274,4,13535.0,6,13540.0,1,B
2018-04-09 09:35:54,13540.0,2,4276,0,13535.0,6,13545.0,5,S
2018-04-09 09:35:59,13545.0,12,4288,2,13545.0,4,13550.0,25,B
2018-04-09 09:36:00,13545.0,8,4296,6,13540.0,1,13545.0,3,B
2018-04-09 09:36:10,13545.0,4,4300,2,13545.0,3,13550.0,29,B
2018-04-09 09:36:10,13545.0,6,4306,4,13540.0,2,13545.0,4,B
2018-04-09 09:36:11,13545.0,6,4312,6,13545.0,7,13550.0,16,B
2018-04-09 09:36:12,13545.0,4,4316,2,13545.0,5,13550.0,17,B
2018-04-09 09:36:12,13545.0,2,4318,0,13545.0,4,13550.0,17,B
2018-04-09 09:36:13,13545.0,8,4326,0,13540.0,2,13545.0,2,B
2018-04-09 09:36:13,13540.0,4,4330,-2,13535.0,7,13540.0,1,S
2018-04-09 09:36:14,13540.0,2,4332,-2,13535.0,7,13545.0,7,S
2018-04-09 09:36:28,13540.0,8,4340,8,13540.0,1,13545.0,21,S
2018-04-09 09:36:28,13540.0,2,4342,2,13535.0,7,13545.0,21,S
2018-04-09 09:36:58,13535.0,2,4344,-2,13535.0,6,13540.0,13,S
2018-04-09 09:36:59,13540.0,2,4346,2,13535.0,6,13540.0,11,B
2018-04-09 09:37:12,13535.0,12,4358,8,13530.0,4,13540.0,12,S
2018-04-09 09:37:15,13535.0,2,4360,-2,13530.0,8,13540.0,12,S
2018-04-09 09:37:18,13535.0,2,4362,-2,13530.0,8,13540.0,12,S
2018-04-09 09:37:21,13535.0,10,4372,0,13530.0,7,13540.0,13,S
2018-04-09 09:37:44,13530.0,18,4390,-2,13525.0,1,13535.0,13,S
2018-04-09 09:37:49,13520.0,2,4392,0,13520.0,5,13530.0,5,S
2018-04-09 09:37:52,13520.0,8,4400,2,13515.0,17,13520.0,4,S
2018-04-09 09:37:53,13520.0,8,4408,8,13520.0,1,13525.0,1,S
2018-04-09 09:37:59,13525.0,4,4412,-2,13520.0,2,13525.0,1,B
2018-04-09 09:38:00,13525.0,2,4414,2,13525.0,6,13530.0,7,B
2018-04-09 09:38:00,13525.0,6,4420,0,13525.0,3,13530.0,7,B
2018-04-09 09:38:01,13525.0,2,4422,2,13525.0,2,13530.0,7,B
2018-04-09 09:38:02,13525.0,4,4426,4,13520.0,1,13530.0,7,B
2018-04-09 09:38:10,13525.0,2,4428,2,13525.0,1,13530.0,5,B
2018-04-09 09:38:19,13520.0,2,4430,-2,13515.0,4,13520.0,4,S
2018-04-09 09:38:20,13515.0,4,4434,4,13510.0,6,13515.0,1,S
2018-04-09 09:38:21,13520.0,4,4438,2,13515.0,3,13520.0,2,B
2018-04-09 09:38:21,13520.0,2,4440,-2,13515.0,3,13525.0,7,B
2018-04-09 09:38:27,13520.0,2,4442,2,13510.0,6,13525.0,10,B
2018-04-09 09:38:28,13520.0,2,4444,0,13515.0,1,13520.0,2,B
2018-04-09 09:38:31,13515.0,2,4446,0,13510.0,6,13525.0,10,S
2018-04-09 09:38:40,13515.0,4,4450,0,13510.0,6,13515.0,12,S
2018-04-09 09:38:45,13510.0,4,4454,-2,13510.0,1,13515.0,1,S
2018-04-09 09:38:46,13515.0,2,4456,0,13510.0,2,13520.0,11,B
2018-04-09 09:38:51,13510.0,4,4460,-4,13510.0,1,13515.0,1,S
2018-04-09 09:38:58,13515.0,4,4464,2,13510.0,4,13520.0,1,B
2018-04-09 09:38:59,13520.0,2,4466,0,13515.0,2,13525.0,6,B
2018-04-09 09:39:01,13520.0,2,4468,2,13515.0,6,13525.0,5,B
2018-04-09 09:39:05,13520.0,4,4472,2,13515.0,2,13520.0,4,B
2018-04-09 09:39:13,13515.0,2,4474,-2,13515.0,1,13520.0,8,S
2018-04-09 09:39:39,13515.0,2,4476,2,13510.0,3,13520.0,6,S
2018-04-09 09:39:53,13510.0,10,4486,0,13505.0,15,13510.0,5,S
2018-04-09 09:39:53,13505.0,18,4504,0,13505.0,11,13515.0,4,S
2018-04-09 09:40:04,13505.0,22,4526,0,13500.0,11,13510.0,13,S
2018-04-09 09:40:05,13505.0,6,4532,2,13505.0,2,13510.0,11,S
2018-04-09 09:40:06,13505.0,14,4546,4,13500.0,9,13505.0,4,S
2018-04-09 09:40:07,13505.0,6,4552,-2,13500.0,8,13510.0,6,S
2018-04-09 09:40:14,13510.0,2,4554,-2,13505.0,4,13515.0,7,B
2018-04-09 09:40:19,13510.0,2,4556,0,13505.0,5,13510.0,1,B
2018-04-09 09:40:23,13505.0,2,4558,0,13505.0,11,13510.0,13,S
2018-04-09 09:40:25,13505.0,18,4576,-6,13505.0,3,13510.0,18,S
2018-04-09 09:40:25,13505.0,6,4582,0,13500.0,10,13505.0,8,S
2018-04-09 09:40:26,13505.0,2,4584,2,13500.0,9,13505.0,4,S
2018-04-09 09:40:26,13500.0,12,4596,8,13500.0,3,13505.0,5,S
2018-04-09 09:40:27,13500.0,4,4600,0,13500.0,1,13505.0,4,S
2018-04-09 09:40:29,13500.0,2,4602,0,13495.0,10,13500.0,5,S
2018-04-09 09:40:30,13500.0,2,4604,0,13495.0,9,13500.0,4,S
2018-04-09 09:40:34,13495.0,2,4606,0,13495.0,6,13500.0,4,S
2018-04-09 09:40:40,13500.0,2,4608,0,13495.0,9,13500.0,11,B
2018-04-09 09:40:42,13500.0,2,4610,0,13495.0,9,13500.0,10,B
2018-04-09 09:40:47,13495.0,4,4614,-4,13495.0,7,13500.0,10,S
2018-04-09 09:40:50,13495.0,2,4616,-2,13495.0,8,13500.0,10,S
2018-04-09 09:40:53,13495.0,12,4628,4,13495.0,2,13500.0,11,S
2018-04-09 09:40:54,13495.0,4,4632,4,13490.0,15,13495.0,4,S
2018-04-09 09:40:54,13490.0,22,4654,0,13490.0,4,13500.0,13,S
2018-04-09 09:40:55,13495.0,18,4672,-2,13485.0,2,13495.0,1,B
2018-04-09 09:40:55,13495.0,2,4674,2,13480.0,4,13490.0,2,B
2018-04-09 09:41:09,13480.0,2,4676,0,13480.0,2,13490.0,9,S
2018-04-09 09:41:13,13465.0,14,4690,-6,13475.0,1,13485.0,1,S
2018-04-09 09:41:13,13475.0,2,4692,0,13475.0,1,13480.0,1,B
2018-04-09 09:41:14,13480.0,2,4694,0,13475.0,6,13485.0,2,B
2018-04-09 09:41:23,13480.0,2,4696,0,13480.0,4,13485.0,1,B
2018-04-09 09:41:35,13475.0,2,4698,0,13470.0,7,13480.0,8,S
2018-04-09 09:41:41,13475.0,2,4700,-2,13475.0,5,13480.0,9,S
2018-04-09 09:41:44,13480.0,2,4702,0,13470.0,9,13480.0,8,B
2018-04-09 09:41:50,13475.0,4,4706,-4,13470.0,8,13475.0,2,S
2018-04-09 09:41:50,13475.0,4,4710,0,13470.0,8,13475.0,2,S
2018-04-09 09:41:51,13475.0,4,4714,0,13470.0,8,13475.0,1,S
2018-04-09 09:41:51,13475.0,2,4716,2,13475.0,2,13480.0,8,S
2018-04-09 09:41:53,13480.0,12,4728,8,13480.0,1,13485.0,2,B
2018-04-09 09:41:56,13480.0,4,4732,-2,13480.0,3,13485.0,7,B
2018-04-09 09:41:57,13480.0,2,4734,0,13475.0,6,13485.0,6,B
2018-04-09 09:42:04,13475.0,6,4740,2,13475.0,1,13480.0,2,S
2018-04-09 09:42:14,13475.0,2,4742,-2,13470.0,2,13475.0,7,S
2018-04-09 09:42:16,13475.0,14,4756,-2,13475.0,1,13480.0,4,S
2018-04-09 09:42:19,13480.0,2,4758,-2,13475.0,5,13480.0,1,B
2018-04-09 09:42:28,13480.0,2,4760,-2,13475.0,6,13485.0,6,B
2018-04-09 09:42:37,13480.0,2,4762,-2,13480.0,4,13485.0,2,B
2018-04-09 09:42:42,13480.0,2,4764,-2,13480.0,1,13485.0,2,B
2018-04-09 09:42:43,13480.0,2,4766,-2,13475.0,9,13480.0,1,B
2018-04-09 09:42:44,13480.0,2,4768,0,13480.0,1,13485.0,6,B
2018-04-09 09:42:45,13480.0,2,4770,0,13475.0,7,13485.0,5,B
2018-04-09 09:42:52,13475.0,2,4772,2,13475.0,6,13485.0,7,S
2018-04-09 09:43:03,13480.0,8,4780,0,13475.0,5,13480.0,1,B
2018-04-09 09:43:04,13480.0,2,4782,2,13475.0,6,13485.0,7,B
2018-04-09 09:43:05,13480.0,4,4786,2,13475.0,6,13480.0,17,B
2018-04-09 09:43:06,13480.0,4,4790,0,13475.0,5,13485.0,7,B
2018-04-09 09:43:08,13480.0,2,4792,2,13475.0,4,13485.0,6,B
2018-04-09 09:43:19,13485.0,2,4794,0,13480.0,5,13485.0,2,B
2018-04-09 09:43:25,13485.0,2,4796,0,13480.0,5,13490.0,6,B
2018-04-09 09:43:33,13485.0,2,4798,0,13480.0,3,13485.0,1,B
2018-04-09 09:43:33,13485.0,2,4800,2,13485.0,2,13490.0,5,B
2018-04-09 09:43:35,13490.0,10,4810,-6,13485.0,6,13495.0,4,B
2018-04-09 09:43:37,13495.0,2,4812,0,13490.0,9,13500.0,5,B
2018-04-09 09:43:38,13495.0,2,4814,0,13490.0,10,13500.0,3,B
2018-04-09 09:43:40,13490.0,2,4816,0,13490.0,10,13500.0,1,S
2018-04-09 09:43:45,13490.0,8,4824,6,13485.0,9,13495.0,4,S
2018-04-09 09:43:54,13500.0,4,4828,4,13490.0,6,13500.0,5,B
2018-04-09 09:43:57,13500.0,2,4830,0,13495.0,1,13500.0,2,B
2018-04-09 09:43:58,13500.0,2,4832,0,13500.0,1,13505.0,6,B
2018-04-09 09:44:03,13500.0,2,4834,0,13500.0,1,13505.0,1,B
2018-04-09 09:44:03,13500.0,2,4836,2,13495.0,3,13505.0,1,B
2018-04-09 09:44:04,13505.0,6,4842,2,13500.0,3,13510.0,4,B
2018-04-09 09:44:06,13500.0,2,4844,-2,13495.0,4,13505.0,2,S
2018-04-09 09:44:32,13490.0,2,4846,-2,13490.0,1,13495.0,4,S
2018-04-09 09:44:48,13490.0,2,4848,2,13485.0,5,13495.0,6,S
2018-04-09 09:44:50,13485.0,2,4850,2,13480.0,4,13490.0,3,S
2018-04-09 09:44:51,13485.0,2,4852,0,13480.0,6,13485.0,3,S
2018-04-09 09:44:52,13480.0,2,4854,0,13480.0,3,13490.0,3,S
2018-04-09 09:44:53,13485.0,2,4856,0,13480.0,2,13485.0,4,B
2018-04-09 09:44:57,13480.0,2,4858,-2,13475.0,3,13485.0,4,S
2018-04-09 09:45:00,13480.0,6,4864,-6,13475.0,3,13485.0,2,S
2018-04-09 09:45:14,13475.0,14,4878,0,13475.0,6,13480.0,3,S
2018-04-09 09:45:15,13480.0,4,4882,-4,13475.0,11,13485.0,6,B
2018-04-09 09:45:17,13480.0,2,4884,0,13480.0,1,13490.0,2,B
2018-04-09 09:45:20,13480.0,4,4888,-4,13475.0,17,13480.0,5,B
2018-04-09 09:45:21,13480.0,10,4898,-6,13480.0,16,13490.0,2,B
2018-04-09 09:45:27,13490.0,2,4900,0,13485.0,3,13495.0,4,B
2018-04-09 09:45:30,13490.0,2,4902,0,13485.0,3,13495.0,4,B
2018-04-09 09:45:34,13490.0,2,4904,-2,13485.0,5,13495.0,5,B
2018-04-09 09:45:48,13485.0,2,4906,-2,13480.0,30,13490.0,2,S
2018-04-09 09:46:05,13480.0,2,4908,2,13480.0,7,13485.0,1,S
2018-04-09 09:46:09,13485.0,2,4910,-2,13485.0,9,13490.0,5,B
2018-04-09 09:46:10,13485.0,2,4912,-2,13485.0,4,13490.0,1,B
2018-04-09 09:46:35,13485.0,2,4914,-2,13485.0,3,13490.0,1,B
2018-04-09 09:46:38,13490.0,2,4916,0,13485.0,17,13495.0,3,B
2018-04-09 09:46:43,13495.0,2,4918,0,13490.0,4,13500.0,13,B
2018-04-09 09:46:49,13490.0,2,4920,-2,13490.0,1,13495.0,1,S
2018-04-09 09:46:51,13490.0,2,4922,0,13490.0,1,13495.0,1,S
2018-04-09 09:47:06,13490.0,2,4924,2,13485.0,3,13495.0,8,S
2018-04-09 09:47:25,13480.0,2,4926,-2,13480.0,2,13490.0,5,S
2018-04-09 09:47:52,13485.0,2,4928,-2,13480.0,4,13490.0,6,B
2018-04-09 09:48:02,13480.0,2,4930,2,13475.0,6,13485.0,7,S
2018-04-09 09:48:04,13475.0,2,4932,0,13475.0,1,13480.0,7,S
2018-04-09 09:48:19,13480.0,2,4934,2,13475.0,1,13480.0,5,B
2018-04-09 09:48:23,13480.0,2,4936,-2,13480.0,3,13485.0,1,B
2018-04-09 09:48:41,13480.0,2,4938,-2,13480.0,2,13490.0,8,B
2018-04-09 09:49:15,13490.0,2,4940,2,13485.0,23,13495.0,8,B
2018-04-09 09:49:26,13495.0,4,4944,2,13495.0,3,13500.0,14,B
2018-04-09 09:49:27,13495.0,6,4950,4,13490.0,1,13500.0,16,B
2018-04-09 09:49:33,13490.0,2,4952,0,13490.0,1,13495.0,1,S
2018-04-09 09:49:45,13495.0,2,4954,0,13490.0,6,13500.0,12,B
2018-04-09 09:49:50,13495.0,2,4956,2,13495.0,2,13500.0,4,B
2018-04-09 09:49:53,13495.0,2,4958,-2,13490.0,6,13500.0,7,B
2018-04-09 09:50:19,13490.0,2,4960,0,13485.0,20,13495.0,6,S
2018-04-09 09:50:30,13495.0,4,4964,2,13490.0,30,13500.0,7,B
2018-04-09 09:50:53,13500.0,4,4968,0,13490.0,2,13500.0,5,B
2018-04-09 09:50:53,13500.0,2,4970,2,13490.0,2,13500.0,4,B
2018-04-09 09:51:21,13495.0,2,4972,2,13490.0,3,13500.0,9,S
2018-04-09 09:52:10,13500.0,2,4974,2,13495.0,1,13500.0,6,B
2018-04-09 09:52:35,13500.0,10,4984,4,13495.0,7,13505.0,6,B
2018-04-09 09:52:36,13500.0,4,4988,0,13495.0,7,13505.0,6,B
2018-04-09 09:53:11,13500.0,2,4990,0,13495.0,9,13505.0,3,B
2018-04-09 09:53:19,13495.0,2,4992,0,13495.0,6,13500.0,8,S
2018-04-09 09:53:20,13495.0,4,4996,-4,13495.0,4,13500.0,3,S
2018-04-09 09:53:23,13495.0,2,4998,0,13495.0,3,13500.0,4,S
2018-04-09 09:53:23,13500.0,2,5000,0,13495.0,2,13500.0,3,B
2018-04-09 09:53:28,13500.0,2,5002,2,13495.0,2,13500.0,1,B
2018-04-09 09:53:49,13500.0,2,5004,0,13495.0,4,13500.0,2,B
2018-04-09 09:53:52,13495.0,8,5012,4,13490.0,3,13500.0,4,S
2018-04-09 09:53:55,13500.0,8,5020,-2,13495.0,4,13505.0,6,B
2018-04-09 09:54:01,13495.0,2,5022,0,13490.0,5,13500.0,2,S
2018-04-09 09:54:04,13495.0,2,5024,0,13490.0,3,13495.0,3,S
2018-04-09 09:55:11,13495.0,2,5026,2,13490.0,7,13495.0,1,S
2018-04-09 09:55:21,13490.0,2,5028,0,13490.0,2,13495.0,5,S
2018-04-09 09:55:22,13490.0,4,5032,-2,13485.0,8,13490.0,1,S
2018-04-09 09:56:05,13485.0,2,5034,0,13480.0,8,13490.0,8,S
2018-04-09 09:56:07,13485.0,2,5036,0,13480.0,7,13485.0,1,S
2018-04-09 09:56:07,13490.0,6,5042,2,13480.0,7,13490.0,2,B
2018-04-09 09:56:08,13490.0,2,5044,2,13480.0,7,13490.0,2,B
2018-04-09 09:56:08,13490.0,2,5046,2,13480.0,7,13490.0,1,B
2018-04-09 09:56:13,13490.0,2,5048,0,13490.0,1,13495.0,14,B
2018-04-09 09:56:35,13490.0,2,5050,0,13485.0,5,13495.0,8,B
2018-04-09 09:56:43,13490.0,2,5052,-2,13485.0,4,13490.0,1,B
2018-04-09 09:56:44,13490.0,2,5054,0,13485.0,4,13495.0,10,B
2018-04-09 09:56:50,13495.0,2,5056,2,13490.0,13,13495.0,7,B
2018-04-09 09:57:06,13485.0,4,5060,0,13480.0,8,13490.0,10,S
2018-04-09 09:57:29,13490.0,2,5062,-2,13485.0,4,13495.0,6,B
2018-04-09 09:57:53,13490.0,2,5064,-2,13485.0,2,13490.0,1,B
2018-04-09 09:58:02,13485.0,8,5072,2,13480.0,13,13485.0,16,S
2018-04-09 09:58:03,13485.0,8,5080,8,13480.0,14,13485.0,12,S
2018-04-09 09:58:03,13485.0,4,5084,0,13480.0,13,13485.0,10,S
2018-04-09 09:58:10,13480.0,2,5086,-2,13480.0,10,13485.0,10,S
2018-04-09 09:58:10,13485.0,14,5100,2,13480.0,32,13485.0,3,B
2018-04-09 09:58:11,13485.0,6,5106,0,13485.0,1,13490.0,1,B
2018-04-09 09:58:35,13485.0,6,5112,2,13480.0,30,13490.0,1,B
2018-04-09 09:58:36,13485.0,6,5118,6,13485.0,5,13490.0,1,B
2018-04-09 09:58:36,13485.0,8,5126,6,13485.0,1,13490.0,1,B
2018-04-09 09:58:39,13490.0,2,5128,-2,13485.0,4,13495.0,3,B
2018-04-09 09:58:44,13490.0,2,5130,0,13490.0,1,13500.0,7,B
2018-04-09 09:58:51,13490.0,2,5132,2,13490.0,1,13500.0,4,B
2018-04-09 09:58:53,13490.0,2,5134,2,13490.0,1,13500.0,4,B
2018-04-09 09:58:53,13490.0,2,5136,2,13485.0,23,13500.0,5,B
2018-04-09 09:58:55,13490.0,2,5138,2,13490.0,1,13500.0,4,B
2018-04-09 09:58:56,13490.0,2,5140,0,13485.0,39,13500.0,4,B
2018-04-09 09:58:57,13490.0,2,5142,2,13485.0,39,13500.0,4,B
2018-04-09 09:58:59,13490.0,2,5144,2,13490.0,1,13500.0,4,B
2018-04-09 09:58:59,13490.0,2,5146,2,13485.0,22,13495.0,3,B
2018-04-09 09:59:00,13490.0,2,5148,2,13485.0,39,13500.0,4,B
2018-04-09 09:59:02,13490.0,2,5150,2,13485.0,22,13500.0,5,B
2018-04-09 09:59:03,13485.0,2,5152,0,13485.0,22,13500.0,5,S
2018-04-09 09:59:04,13485.0,4,5156,0,13480.0,26,13490.0,4,S
2018-04-09 09:59:07,13485.0,2,5158,-2,13480.0,7,13485.0,6,S
2018-04-09 09:59:41,13485.0,4,5162,-4,13485.0,1,13490.0,8,S
2018-04-09 09:59:48,13485.0,2,5164,0,13480.0,25,13490.0,8,S
2018-04-09 09:59:48,13480.0,2,5166,0,13480.0,25,13490.0,8,S
2018-04-09 10:00:03,13485.0,4,5170,4,13480.0,29,13485.0,1,B
2018-04-09 10:00:23,13485.0,2,5172,0,13485.0,2,13490.0,4,B
2018-04-09 10:00:24,13485.0,4,5176,-4,13480.0,12,13485.0,5,B
2018-04-09 10:00:31,13485.0,4,5180,0,13480.0,11,13485.0,2,B
2018-04-09 10:00:36,13480.0,20,5200,12,13480.0,1,13485.0,2,S
2018-04-09 10:00:37,13480.0,4,5204,0,13480.0,1,13490.0,5,S
2018-04-09 10:00:55,13490.0,6,5210,4,13485.0,7,13495.0,7,B
2018-04-09 10:01:11,13495.0,2,5212,-2,13485.0,7,13495.0,4,B
2018-04-09 10:01:15,13495.0,10,5222,6,13485.0,8,13500.0,7,B
2018-04-09 10:01:23,13495.0,8,5230,2,13495.0,1,13500.0,6,B
2018-04-09 10:01:24,13495.0,2,5232,0,13485.0,4,13495.0,2,B
2018-04-09 10:01:32,13495.0,4,5236,-2,13490.0,1,13495.0,1,B
2018-04-09 10:01:37,13490.0,2,5238,2,13485.0,2,13490.0,1,S
2018-04-09 10:01:37,13485.0,2,5240,2,13485.0,1,13490.0,1,S
2018-04-09 10:01:49,13490.0,4,5244,2,13490.0,3,13495.0,7,B
2018-04-09 10:01:49,13490.0,6,5250,0,13485.0,1,13490.0,1,B
2018-04-09 10:01:59,13485.0,2,5252,2,13480.0,4,13490.0,6,S
2018-04-09 10:02:18,13485.0,2,5254,2,13485.0,4,13490.0,7,S
2018-04-09 10:02:24,13485.0,2,5256,2,13485.0,3,13490.0,4,S
2018-04-09 10:02:30,13485.0,4,5260,4,13485.0,1,13490.0,4,S
2018-04-09 10:02:31,13485.0,2,5262,0,13480.0,4,13485.0,1,S
2018-04-09 10:02:35,13485.0,4,5266,2,13480.0,9,13485.0,18,S
2018-04-09 10:02:43,13485.0,2,5268,2,13480.0,3,13485.0,17,S
2018-04-09 10:03:01,13480.0,10,5278,8,13475.0,7,13480.0,15,S
2018-04-09 10:03:03,13475.0,8,5286,2,13470.0,12,13480.0,15,S
2018-04-09 10:03:05,13475.0,12,5298,-6,13470.0,6,13480.0,19,S
2018-04-09 10:03:09,13475.0,2,5300,-2,13475.0,1,13480.0,15,S
2018-04-09 10:03:13,13480.0,2,5302,2,13475.0,1,13480.0,14,B
2018-04-09 10:03:18,13480.0,2,5304,2,13475.0,7,13480.0,13,B
2018-04-09 10:03:19,13480.0,10,5314,0,13475.0,7,13480.0,8,B
2018-04-09 10:03:19,13480.0,16,5330,16,13475.0,9,13485.0,6,B
2018-04-09 10:03:20,13480.0,2,5332,2,13480.0,1,13485.0,1,B
2018-04-09 10:03:50,13480.0,2,5334,0,13475.0,5,13485.0,2,B
2018-04-09 10:04:09,13485.0,2,5336,0,13480.0,1,13485.0,1,B
2018-04-09 10:04:22,13485.0,2,5338,-2,13485.0,2,13490.0,8,B
2018-04-09 10:04:23,13490.0,4,5342,-4,13485.0,3,13495.0,13,B
2018-04-09 10:04:24,13490.0,2,5344,0,13485.0,3,13495.0,14,B
2018-04-09 10:05:01,13485.0,2,5346,-2,13485.0,1,13490.0,2,S
2018-04-09 10:05:02,13485.0,2,5348,0,13480.0,21,13490.0,2,S
2018-04-09 10:05:05,13480.0,4,5352,0,13475.0,20,13485.0,3,S
2018-04-09 10:05:09,13480.0,2,5354,0,13475.0,19,13480.0,4,S
2018-04-09 10:05:10,13480.0,2,5356,2,13475.0,20,13480.0,3,S
2018-04-09 10:05:11,13480.0,6,5362,0,13480.0,2,13485.0,5,S
2018-04-09 10:05:12,13480.0,4,5366,0,13475.0,24,13485.0,3,S
2018-04-09 10:06:31,13480.0,2,5368,-2,13480.0,1,13485.0,3,S
2018-04-09 10:07:24,13480.0,4,5372,-2,13475.0,9,13485.0,4,S
2018-04-09 10:07:31,13480.0,2,5374,2,13475.0,10,13480.0,10,S
2018-04-09 10:07:44,13475.0,2,5376,0,13475.0,1,13480.0,12,S
2018-04-09 10:08:03,13475.0,2,5378,0,13470.0,7,13475.0,1,S
2018-04-09 10:08:18,13470.0,2,5380,0,13470.0,4,13475.0,3,S
2018-04-09 10:08:18,13465.0,24,5404,6,13460.0,2,13465.0,18,S
2018-04-09 10:08:19,13465.0,4,5408,2,13460.0,4,13465.0,16,S
2018-04-09 10:08:20,13465.0,14,5422,6,13460.0,8,13465.0,9,S
2018-04-09 10:08:21,13465.0,18,5440,14,13465.0,5,13470.0,2,S
2018-04-09 10:08:22,13470.0,4,5444,-4,13465.0,5,13475.0,3,B
2018-04-09 10:08:30,13465.0,10,5454,8,13460.0,40,13465.0,15,S
2018-04-09 10:08:30,13465.0,30,5484,22,13465.0,16,13475.0,2,S
2018-04-09 10:08:32,13475.0,8,5492,-4,13475.0,1,13480.0,6,B
2018-04-09 10:08:32,13475.0,2,5494,0,13465.0,18,13475.0,4,B
2018-04-09 10:08:36,13465.0,20,5514,6,13470.0,1,13475.0,4,S
2018-04-09 10:08:40,13470.0,2,5516,0,13465.0,7,13475.0,2,B
2018-04-09 10:08:46,13470.0,2,5518,2,13465.0,6,13470.0,2,B
2018-04-09 10:08:57,13470.0,2,5520,0,13470.0,1,13475.0,2,B
2018-04-09 10:09:04,13480.0,2,5522,0,13470.0,4,13480.0,5,B
2018-04-09 10:09:15,13470.0,12,5534,0,13465.0,8,13470.0,14,S
2018-04-09 10:09:21,13465.0,8,5542,4,13460.0,29,13465.0,16,S
2018-04-09 10:09:21,13465.0,10,5552,8,13460.0,32,13465.0,11,S
2018-04-09 10:09:22,13465.0,2,5554,2,13460.0,17,13465.0,10,S
2018-04-09 10:09:24,13465.0,4,5558,0,13460.0,15,13465.0,8,S
2018-04-09 10:09:39,13465.0,6,5564,2,13465.0,2,13470.0,12,S
2018-04-09 10:09:40,13465.0,4,5568,0,13460.0,15,13465.0,4,S
2018-04-09 10:09:42,13460.0,20,5588,0,13460.0,5,13465.0,3,S
2018-04-09 10:09:42,13455.0,16,5604,-6,13455.0,7,13465.0,3,S
2018-04-09 10:09:43,13455.0,4,5608,-4,13455.0,9,13460.0,14,S
2018-04-09 10:09:43,13460.0,18,5626,-16,13455.0,1,13460.0,13,B
2018-04-09 10:09:44,13455.0,2,5628,-2,13450.0,22,13455.0,1,S
2018-04-09 10:09:51,13455.0,16,5644,14,13450.0,37,13460.0,13,S
2018-04-09 10:09:52,13455.0,2,5646,-2,13450.0,37,13460.0,15,S
2018-04-09 10:10:00,13455.0,2,5648,0,13450.0,23,13460.0,16,S
2018-04-09 10:10:07,13455.0,2,5650,0,13450.0,23,13455.0,2,S
2018-04-09 10:10:14,13455.0,2,5652,-2,13450.0,25,13455.0,1,S
2018-04-09 10:10:15,13455.0,2,5654,0,13450.0,25,13460.0,22,S
2018-04-09 10:10:16,13450.0,40,5694,14,13450.0,5,13460.0,22,S
2018-04-09 10:10:17,13450.0,6,5700,-2,13450.0,3,13460.0,22,S
2018-04-09 10:10:23,13455.0,2,5702,0,13450.0,3,13460.0,22,B
2018-04-09 10:10:31,13455.0,6,5708,0,13450.0,3,13455.0,2,B
2018-04-09 10:10:41,13455.0,6,5714,-2,13450.0,6,13455.0,1,B
2018-04-09 10:10:42,13455.0,2,5716,0,13450.0,18,13460.0,24,B
2018-04-09 10:10:45,13455.0,4,5720,2,13450.0,6,13460.0,21,B
2018-04-09 10:10:53,13450.0,4,5724,-2,13450.0,3,13455.0,4,S
2018-04-09 10:11:15,13460.0,10,5734,-10,13455.0,2,13460.0,14,B
2018-04-09 10:11:16,13460.0,8,5742,0,13455.0,3,13460.0,10,B
2018-04-09 10:11:16,13460.0,20,5762,12,13455.0,16,13465.0,7,B
2018-04-09 10:11:17,13455.0,36,5798,34,13450.0,37,13455.0,2,S
2018-04-09 10:11:18,13455.0,4,5802,0,13455.0,8,13465.0,3,S
2018-04-09 10:11:30,13465.0,2,5804,0,13460.0,7,13465.0,2,B
2018-04-09 10:11:37,13465.0,2,5806,-2,13460.0,6,13465.0,5,B
2018-04-09 10:11:45,13465.0,2,5808,0,13460.0,6,13470.0,8,B
2018-04-09 10:12:03,13470.0,2,5810,0,13465.0,2,13475.0,9,B
2018-04-09 10:12:11,13470.0,2,5812,0,13470.0,1,13475.0,9,B
2018-04-09 10:12:12,13470.0,2,5814,0,13465.0,1,13475.0,9,B
2018-04-09 10:12:18,13470.0,4,5818,-4,13465.0,1,13475.0,9,B
2018-04-09 10:12:42,13465.0,4,5822,-2,13460.0,8,13470.0,14,S
2018-04-09 10:13:03,13465.0,2,5824,0,13460.0,1,13465.0,4,S
2018-04-09 10:13:08,13460.0,2,5826,0,13455.0,3,13465.0,4,S
2018-04-09 10:13:13,13455.0,40,5866,4,13460.0,1,13465.0,2,S
2018-04-09 10:13:14,13460.0,2,5868,0,13455.0,1,13465.0,2,B
2018-04-09 10:13:24,13455.0,2,5870,2,13450.0,10,13460.0,3,S
2018-04-09 10:13:35,13460.0,2,5872,-2,13455.0,1,13460.0,2,B
2018-04-09 10:13:39,13460.0,2,5874,-2,13455.0,3,13460.0,1,B
2018-04-09 10:13:43,13460.0,2,5876,2,13455.0,4,13460.0,1,B
2018-04-09 10:13:44,13460.0,2,5878,-2,13455.0,4,13460.0,1,B
2018-04-09 10:14:06,13455.0,10,5888,4,13450.0,3,13455.0,35,S
2018-04-09 10:14:07,13455.0,4,5892,4,13450.0,3,13455.0,33,S
2018-04-09 10:14:13,13450.0,4,5896,4,13450.0,1,13455.0,35,S
2018-04-09 10:14:14,13450.0,2,5898,-2,13450.0,1,13455.0,35,S
2018-04-09 10:14:15,13450.0,2,5900,-2,13450.0,1,13455.0,35,S
2018-04-09 10:14:17,13450.0,2,5902,2,13445.0,6,13450.0,4,S
2018-04-09 10:14:32,13455.0,2,5904,0,13450.0,2,13455.0,1,B
2018-04-09 10:14:37,13455.0,2,5906,0,13455.0,9,13460.0,9,B
2018-04-09 10:14:41,13460.0,2,5908,0,13455.0,9,13460.0,5,B
2018-04-09 10:14:44,13455.0,12,5920,6,13455.0,3,13460.0,5,S
2018-04-09 10:14:45,13455.0,2,5922,0,13455.0,3,13460.0,6,S
2018-04-09 10:14:46,13455.0,2,5924,2,13455.0,2,13460.0,6,S
2018-04-09 10:14:47,13455.0,2,5926,2,13455.0,1,13460.0,5,S
2018-04-09 10:15:00,13455.0,2,5928,0,13450.0,5,13455.0,1,S
2018-04-09 10:30:02,13450.0,2,5930,-2,13450.0,2,13455.0,2,S
2018-04-09 10:30:27,13450.0,2,5932,0,13450.0,1,13455.0,3,S
2018-04-09 10:30:32,13455.0,2,5934,0,13455.0,2,13460.0,3,B
2018-04-09 10:30:35,13455.0,4,5938,2,13450.0,15,13455.0,31,B
2018-04-09 10:30:36,13455.0,8,5946,4,13450.0,15,13455.0,27,B
2018-04-09 10:30:52,13450.0,2,5948,0,13450.0,3,13455.0,29,S
2018-04-09 10:31:14,13455.0,6,5954,6,13450.0,11,13455.0,24,B
2018-04-09 10:31:20,13450.0,6,5960,4,13450.0,10,13455.0,24,S
2018-04-09 10:31:21,13455.0,4,5964,0,13450.0,10,13455.0,22,B
2018-04-09 10:31:24,13455.0,2,5966,2,13450.0,10,13455.0,21,B
2018-04-09 10:31:32,13455.0,8,5974,8,13450.0,10,13455.0,18,B
2018-04-09 10:31:32,13455.0,12,5986,10,13450.0,11,13455.0,12,B
2018-04-09 10:31:33,13455.0,8,5994,6,13450.0,11,13455.0,8,B
2018-04-09 10:31:33,13455.0,2,5996,2,13450.0,11,13455.0,7,B
2018-04-09 10:31:34,13455.0,2,5998,2,13450.0,10,13455.0,6,B
2018-04-09 10:31:34,13455.0,6,6004,4,13450.0,10,13455.0,3,B
2018-04-09 10:31:40,13455.0,6,6010,0,13455.0,1,13460.0,6,B
2018-04-09 10:31:41,13455.0,2,6012,0,13450.0,11,13455.0,1,B
2018-04-09 10:31:41,13455.0,2,6014,0,13450.0,11,13460.0,2,B
2018-04-09 10:31:51,13450.0,4,6018,-4,13450.0,1,13455.0,1,S
2018-04-09 10:31:56,13455.0,2,6020,2,13455.0,1,13460.0,6,B
2018-04-09 10:32:03,13455.0,2,6022,0,13450.0,3,13460.0,4,B
2018-04-09 10:32:17,13465.0,2,6024,0,13455.0,4,13465.0,5,B
2018-04-09 10:32:18,13465.0,2,6026,2,13455.0,4,13465.0,6,B
2018-04-09 10:32:19,13460.0,2,6028,0,13455.0,4,13465.0,5,S
2018-04-09 10:32:23,13465.0,4,6032,0,13455.0,4,13465.0,3,B
2018-04-09 10:32:31,13455.0,10,6042,8,13450.0,11,13455.0,35,S
2018-04-09 10:32:39,13455.0,2,6044,0,13450.0,14,13455.0,34,S
2018-04-09 10:32:40,13450.0,6,6050,2,13450.0,6,13455.0,34,S
2018-04-09 10:32:42,13450.0,4,6054,-2,13445.0,10,13455.0,34,S
2018-04-09 10:32:50,13450.0,2,6056,2,13445.0,13,13455.0,36,S
2018-04-09 10:32:57,13450.0,2,6058,0,13445.0,10,13455.0,37,S
2018-04-09 10:33:02,13450.0,4,6062,-2,13445.0,13,13455.0,37,S
2018-04-09 10:33:06,13450.0,2,6064,-2,13445.0,12,13455.0,37,S
2018-04-09 10:33:20,13450.0,2,6066,0,13445.0,12,13455.0,37,S
2018-04-09 10:33:34,13450.0,2,6068,0,13445.0,11,13450.0,1,S
2018-04-09 10:33:36,13450.0,2,6070,0,13445.0,11,13455.0,36,S
2018-04-09 10:33:51,13455.0,2,6072,0,13450.0,2,13455.0,1,B
2018-04-09 10:34:02,13455.0,2,6074,-2,13450.0,3,13455.0,3,B
2018-04-09 10:34:03,13450.0,6,6080,2,13445.0,13,13450.0,31,S
2018-04-09 10:34:12,13450.0,2,6082,0,13445.0,14,13450.0,30,S
2018-04-09 10:34:16,13450.0,2,6084,2,13445.0,14,13450.0,29,S
2018-04-09 10:34:22,13450.0,10,6094,0,13445.0,9,13450.0,24,S
2018-04-09 10:34:24,13450.0,2,6096,2,13445.0,9,13450.0,23,S
2018-04-09 10:34:32,13450.0,2,6098,0,13445.0,10,13450.0,22,S
2018-04-09 10:34:35,13450.0,44,6142,18,13450.0,11,13455.0,4,S
2018-04-09 10:34:39,13450.0,2,6144,2,13445.0,16,13455.0,1,S
2018-04-09 10:34:48,13450.0,2,6146,2,13445.0,21,13455.0,1,S
2018-04-09 10:34:52,13445.0,2,6148,2,13445.0,21,13455.0,3,S
2018-04-09 10:34:55,13455.0,6,6154,-2,13445.0,39,13460.0,5,B
2018-04-09 10:35:10,13455.0,2,6156,2,13445.0,15,13455.0,18,B
2018-04-09 10:35:16,13445.0,30,6186,22,13440.0,50,13445.0,25,S
2018-04-09 10:35:16,13445.0,28,6214,8,13440.0,54,13445.0,11,S
2018-04-09 10:35:17,13445.0,2,6216,2,13440.0,43,13445.0,10,S
2018-04-09 10:35:21,13445.0,6,6222,0,13440.0,42,13445.0,7,S
2018-04-09 10:35:22,13445.0,8,6230,0,13440.0,54,13445.0,3,S
2018-04-09 10:35:34,13445.0,2,6232,0,13440.0,38,13445.0,2,S
2018-04-09 10:35:39,13445.0,4,6236,0,13440.0,45,13450.0,3,S
2018-04-09 10:35:42,13450.0,2,6238,2,13445.0,4,13455.0,4,B
2018-04-09 10:35:51,13450.0,2,6240,2,13450.0,1,13455.0,3,B
2018-04-09 10:36:01,13450.0,2,6242,0,13445.0,29,13455.0,2,B
2018-04-09 10:36:30,13450.0,2,6244,0,13445.0,7,13450.0,2,B
2018-04-09 10:36:31,13445.0,14,6258,14,13440.0,39,13445.0,33,S
2018-04-09 10:36:35,13445.0,2,6260,2,13440.0,39,13445.0,32,S
2018-04-09 10:37:08,13445.0,4,6264,0,13440.0,39,13445.0,30,S
2018-04-09 10:37:08,13445.0,36,6300,34,13440.0,44,13445.0,12,S
2018-04-09 10:37:09,13445.0,24,6324,18,13440.0,45,13450.0,1,S
2018-04-09 10:37:22,13455.0,2,6326,0,13450.0,1,13455.0,3,B
2018-04-09 10:37:44,13450.0,6,6332,4,13445.0,46,13450.0,37,S
2018-04-09 10:37:51,13450.0,2,6334,0,13445.0,30,13450.0,36,S
2018-04-09 10:37:56,13450.0,2,6336,2,13445.0,31,13450.0,35,S
2018-04-09 10:38:03,13450.0,2,6338,2,13445.0,30,13450.0,34,S
2018-04-09 10:38:06,13450.0,68,6406,68,13450.0,16,13455.0,3,S
2018-04-09 10:38:06,13450.0,8,6414,0,13450.0,12,13455.0,3,S
2018-04-09 10:38:15,13455.0,4,6418,2,13455.0,2,13460.0,7,B
2018-04-09 10:38:15,13455.0,4,6422,0,13450.0,12,13460.0,4,B
2018-04-09 10:38:30,13455.0,2,6424,0,13455.0,3,13460.0,11,B
2018-04-09 10:38:31,13455.0,6,6430,4,13450.0,14,13455.0,1,B
2018-04-09 10:38:38,13460.0,20,6450,-10,13450.0,16,13465.0,4,B
2018-04-09 10:38:46,13460.0,2,6452,2,13450.0,16,13460.0,4,B
2018-04-09 10:38:50,13455.0,2,6454,0,13450.0,16,13455.0,2,S
2018-04-09 10:38:58,13450.0,40,6494,34,13445.0,3,13450.0,20,S
2018-04-09 10:39:02,13445.0,20,6514,4,13440.0,40,13445.0,20,S
2018-04-09 10:39:04,13445.0,2,6516,2,13440.0,42,13445.0,19,S
2018-04-09 10:39:05,13445.0,2,6518,2,13440.0,42,13445.0,18,S
2018-04-09 10:39:08,13445.0,4,6522,0,13440.0,42,13445.0,16,S
2018-04-09 10:39:10,13445.0,28,6550,12,13440.0,40,13445.0,2,S
2018-04-09 10:39:10,13445.0,4,6554,4,13445.0,11,13450.0,23,S
2018-04-09 10:39:12,13445.0,8,6562,0,13445.0,6,13450.0,23,S
2018-04-09 10:39:32,13445.0,22,6584,0,13440.0,39,13450.0,23,S
2018-04-09 10:39:33,13445.0,2,6586,0,13440.0,40,13445.0,3,S
2018-04-09 10:39:44,13440.0,2,6588,2,13440.0,9,13445.0,6,S
2018-04-09 10:39:44,13440.0,8,6596,-6,13440.0,5,13445.0,6,S
2018-04-09 10:39:45,13440.0,2,6598,-2,13440.0,4,13445.0,6,S
2018-04-09 10:39:46,13445.0,2,6600,-2,13440.0,4,13445.0,6,B
2018-04-09 10:40:05,13445.0,2,6602,0,13440.0,7,13445.0,7,B
2018-04-09 10:40:08,13440.0,14,6616,0,13435.0,5,13440.0,13,S
2018-04-09 10:40:14,13440.0,12,6628,12,13435.0,18,13440.0,7,S
2018-04-09 10:40:14,13440.0,14,6642,4,13435.0,45,13445.0,5,S
2018-04-09 10:40:16,13440.0,2,6644,0,13440.0,1,13445.0,3,S
2018-04-09 10:40:22,13445.0,2,6646,0,13440.0,1,13445.0,1,B
2018-04-09 10:40:23,13445.0,2,6648,0,13440.0,1,13450.0,6,B
2018-04-09 10:40:32,13450.0,4,6652,0,13440.0,3,13450.0,8,B
2018-04-09 10:40:39,13450.0,2,6654,0,13440.0,5,13450.0,7,B
2018-04-09 10:40:40,13450.0,2,6656,-2,13440.0,5,13450.0,6,B
2018-04-09 10:41:16,13450.0,4,6660,-4,13445.0,10,13450.0,2,B
2018-04-09 10:41:18,13450.0,2,6662,-2,13445.0,10,13450.0,1,B
2018-04-09 10:41:25,13455.0,4,6666,0,13445.0,10,13455.0,4,B
2018-04-09 10:41:40,13445.0,26,6692,24,13440.0,42,13445.0,17,S
2018-04-09 10:41:40,13445.0,34,6726,26,13440.0,44,13455.0,11,S
2018-04-09 10:41:44,13450.0,2,6728,0,13445.0,2,13455.0,10,B
2018-04-09 10:42:08,13450.0,4,6732,4,13450.0,3,13455.0,20,B
2018-04-09 10:42:08,13450.0,6,6738,6,13445.0,8,13455.0,8,B
2018-04-09 10:42:22,13445.0,2,6740,0,13445.0,5,13450.0,2,S
2018-04-09 10:42:40,13445.0,10,6750,4,13440.0,5,13445.0,3,S
2018-04-09 10:42:46,13450.0,10,6760,2,13440.0,3,13445.0,1,B
2018-04-09 10:43:04,13440.0,2,6762,-2,13440.0,2,13445.0,1,S
2018-04-09 10:43:19,13440.0,4,6766,0,13440.0,5,13445.0,1,S
2018-04-09 10:43:40,13450.0,2,6768,0,13440.0,19,13450.0,4,B
2018-04-09 10:44:18,13445.0,2,6770,0,13440.0,20,13450.0,3,S
2018-04-09 10:44:33,13440.0,12,6782,0,13435.0,9,13445.0,6,S
2018-04-09 10:44:39,13445.0,2,6784,-2,13440.0,1,13445.0,4,B
2018-04-09 10:44:43,13445.0,2,6786,-2,13440.0,5,13445.0,1,B
2018-04-09 10:44:44,13445.0,2,6788,0,13440.0,5,13450.0,10,B
2018-04-09 10:45:01,13445.0,2,6790,0,13440.0,4,13445.0,1,B
2018-04-09 10:45:15,13440.0,4,6794,4,13435.0,10,13440.0,8,S
2018-04-09 10:45:16,13440.0,2,6796,0,13435.0,10,13440.0,7,S
2018-04-09 10:45:18,13440.0,14,6810,8,13435.0,7,13445.0,4,S
2018-04-09 10:45:39,13440.0,2,6812,0,13435.0,7,13445.0,3,S
2018-04-09 10:45:55,13445.0,4,6816,0,13440.0,4,13450.0,6,B
2018-04-09 10:46:20,13450.0,2,6818,2,13445.0,1,13450.0,2,B
2018-04-09 10:46:24,13455.0,2,6820,0,13445.0,3,13455.0,4,B
2018-04-09 10:46:37,13455.0,2,6822,0,13450.0,3,13460.0,8,B
2018-04-09 10:47:04,13460.0,2,6824,2,13455.0,1,13465.0,6,B
2018-04-09 10:47:22,13460.0,8,6832,8,13455.0,3,13460.0,16,B
2018-04-09 10:47:31,13455.0,2,6834,2,13450.0,20,13460.0,17,S
2018-04-09 10:47:32,13455.0,2,6836,2,13450.0,3,13455.0,5,S
2018-04-09 10:47:32,13450.0,2,6838,0,13445.0,22,13455.0,2,S
2018-04-09 10:47:37,13455.0,2,6840,2,13455.0,1,13460.0,25,B
2018-04-09 10:47:38,13455.0,2,6842,0,13450.0,1,13460.0,28,B
2018-04-09 10:47:52,13455.0,2,6844,-2,13450.0,6,13455.0,1,B
2018-04-09 10:47:58,13455.0,2,6846,0,13450.0,4,13460.0,3,B
2018-04-09 10:48:00,13450.0,12,6858,-4,13445.0,50,13450.0,4,S
2018-04-09 10:48:00,13455.0,10,6868,-10,13450.0,5,13460.0,4,B
2018-04-09 10:48:05,13450.0,2,6870,0,13445.0,53,13450.0,15,S
2018-04-09 10:48:05,13450.0,28,6898,4,13445.0,55,13450.0,1,S
2018-04-09 10:48:06,13450.0,2,6900,2,13450.0,1,13455.0,2,S
2018-04-09 10:48:12,13450.0,2,6902,-2,13445.0,53,13450.0,9,S
2018-04-09 10:48:14,13450.0,6,6908,-2,13445.0,39,13450.0,6,S
2018-04-09 10:48:22,13450.0,12,6920,0,13445.0,39,13455.0,2,S
2018-04-09 10:48:41,13455.0,14,6934,-8,13450.0,32,13455.0,13,B
2018-04-09 10:48:44,13455.0,2,6936,0,13450.0,5,13455.0,12,B
2018-04-09 10:48:46,13455.0,2,6938,-2,13450.0,3,13455.0,11,B
2018-04-09 10:48:53,13455.0,2,6940,-2,13450.0,3,13455.0,10,B
2018-04-09 10:48:55,13455.0,2,6942,-2,13450.0,5,13455.0,9,B
2018-04-09 10:49:17,13450.0,20,6962,-4,13445.0,39,13455.0,11,S
2018-04-09 10:49:18,13455.0,2,6964,0,13450.0,1,13455.0,10,B
2018-04-09 10:49:20,13455.0,18,6982,-2,13455.0,3,13460.0,7,B
2018-04-09 10:49:21,13455.0,10,6992,2,13450.0,3,13455.0,40,B
2018-04-09 10:49:28,13455.0,6,6998,6,13450.0,13,13455.0,38,B
2018-04-09 10:49:40,13450.0,20,7018,-2,13450.0,18,13455.0,37,S
2018-04-09 10:49:44,13450.0,6,7024,-2,13445.0,14,13450.0,7,S
2018-04-09 10:49:45,13460.0,28,7052,-6,13450.0,4,13455.0,1,B
2018-04-09 10:49:46,13460.0,4,7056,4,13455.0,1,13465.0,5,B
2018-04-09 10:49:52,13455.0,2,7058,0,13455.0,4,13465.0,4,S
2018-04-09 10:49:53,13455.0,18,7076,-8,13450.0,16,13455.0,1,S
2018-04-09 10:49:54,13460.0,4,7080,-2,13455.0,9,13465.0,4,B
2018-04-09 10:49:55,13460.0,2,7082,-2,13455.0,2,13465.0,4,B
2018-04-09 10:49:57,13465.0,4,7086,2,13455.0,4,13465.0,5,B
2018-04-09 10:49:59,13460.0,2,7088,2,13455.0,4,13460.0,3,S
2018-04-09 10:50:06,13455.0,4,7092,4,13450.0,12,13455.0,35,S
2018-04-09 10:50:06,13455.0,4,7096,4,13450.0,12,13455.0,33,S
2018-04-09 10:50:31,13455.0,54,7150,46,13450.0,9,13455.0,6,S
2018-04-09 10:50:32,13450.0,22,7172,-4,13450.0,8,13460.0,1,S
2018-04-09 10:50:38,13460.0,2,7174,0,13450.0,14,13460.0,3,B
2018-04-09 10:50:45,13460.0,8,7182,4,13460.0,6,13465.0,12,B
2018-04-09 10:50:45,13460.0,12,7194,4,13455.0,1,13465.0,8,B
2018-04-09 10:50:48,13455.0,2,7196,0,13455.0,1,13460.0,5,S
2018-04-09 10:51:03,13465.0,4,7200,-4,13455.0,6,13465.0,4,B
2018-04-09 10:51:07,13465.0,2,7202,0,13460.0,1,13465.0,4,B
2018-04-09 10:51:09,13460.0,2,7204,0,13455.0,5,13465.0,5,S
2018-04-09 10:51:09,13455.0,2,7206,-2,13455.0,4,13465.0,5,S
2018-04-09 10:51:15,13455.0,22,7228,8,13450.0,11,13455.0,29,S
2018-04-09 10:51:16,13455.0,6,7234,2,13450.0,13,13455.0,26,S
2018-04-09 10:51:27,13455.0,42,7276,26,13450.0,11,13455.0,5,S
2018-04-09 10:51:28,13460.0,16,7292,-2,13455.0,1,13460.0,2,B
2018-04-09 10:51:45,13465.0,4,7296,-2,13455.0,25,13465.0,4,B
2018-04-09 10:51:57,13465.0,2,7298,0,13455.0,29,13465.0,3,B
2018-04-09 10:52:04,13460.0,2,7300,0,13455.0,28,13465.0,6,S
2018-04-09 10:52:06,13460.0,2,7302,2,13455.0,28,13460.0,3,S
2018-04-09 10:52:08,13460.0,2,7304,0,13455.0,21,13465.0,6,S
2018-04-09 10:52:11,13465.0,2,7306,0,13455.0,23,13465.0,2,B
2018-04-09 10:52:12,13465.0,2,7308,2,13455.0,23,13465.0,1,B
2018-04-09 10:52:13,13465.0,2,7310,0,13455.0,23,13465.0,6,B
2018-04-09 10:52:14,13460.0,2,7312,0,13455.0,23,13460.0,1,S
2018-04-09 10:52:14,13460.0,2,7314,-2,13455.0,21,13465.0,6,S
2018-04-09 10:52:16,13460.0,2,7316,0,13455.0,23,13465.0,7,S
2018-04-09 10:52:24,13465.0,2,7318,0,13460.0,5,13470.0,6,B
2018-04-09 10:52:27,13470.0,2,7320,2,13465.0,4,13470.0,2,B
2018-04-09 10:52:28,13470.0,2,7322,0,13460.0,22,13470.0,1,B
2018-04-09 10:52:28,13470.0,2,7324,0,13460.0,23,13470.0,2,B
2018-04-09 10:52:34,13470.0,2,7326,0,13460.0,26,13470.0,3,B
2018-04-09 10:52:34,13460.0,56,7382,50,13455.0,27,13460.0,12,S
2018-04-09 10:52:35,13460.0,4,7386,4,13455.0,9,13460.0,10,S
2018-04-09 10:52:35,13460.0,2,7388,2,13455.0,11,13460.0,9,S
2018-04-09 10:52:36,13460.0,2,7390,2,13455.0,11,13460.0,8,S
2018-04-09 10:52:37,13460.0,4,7394,2,13455.0,8,13460.0,6,S
2018-04-09 10:52:37,13460.0,2,7396,2,13455.0,8,13460.0,5,S
2018-04-09 10:52:38,13460.0,2,7398,2,13455.0,8,13460.0,4,S
2018-04-09 10:52:39,13460.0,2,7400,2,13455.0,8,13460.0,3,S
2018-04-09 10:52:39,13460.0,2,7402,2,13455.0,8,13460.0,2,S
2018-04-09 10:52:40,13460.0,2,7404,2,13455.0,8,13460.0,1,S
2018-04-09 10:52:41,13460.0,2,7406,2,13455.0,8,13465.0,2,S
2018-04-09 10:52:45,13465.0,2,7408,0,13460.0,2,13465.0,1,B
2018-04-09 10:52:55,13465.0,2,7410,0,13460.0,6,13470.0,10,B
2018-04-09 10:52:58,13470.0,2,7412,2,13460.0,5,13470.0,5,B
2018-04-09 10:53:00,13470.0,2,7414,2,13460.0,6,13470.0,5,B
2018-04-09 10:53:01,13470.0,2,7416,0,13460.0,7,13470.0,5,B
2018-04-09 10:53:01,13470.0,2,7418,0,13460.0,7,13470.0,4,B
2018-04-09 10:53:02,13470.0,6,7424,4,13460.0,7,13470.0,6,B
2018-04-09 10:53:03,13470.0,2,7426,0,13460.0,7,13470.0,5,B
2018-04-09 10:53:03,13470.0,2,7428,0,13460.0,7,13470.0,4,B
2018-04-09 10:53:04,13470.0,2,7430,0,13460.0,7,13470.0,3,B
2018-04-09 10:53:05,13470.0,2,7432,2,13460.0,7,13470.0,2,B
2018-04-09 10:53:05,13470.0,2,7434,2,13460.0,7,13470.0,1,B
2018-04-09 10:53:06,13470.0,2,7436,0,13460.0,7,13470.0,2,B
2018-04-09 10:53:07,13470.0,2,7438,2,13460.0,7,13470.0,1,B
2018-04-09 10:53:07,13470.0,2,7440,2,13460.0,7,13470.0,1,B
2018-04-09 10:53:08,13470.0,2,7442,2,13460.0,8,13470.0,1,B
2018-04-09 10:53:09,13470.0,2,7444,0,13460.0,8,13470.0,1,B
2018-04-09 10:53:09,13470.0,2,7446,2,13460.0,8,13475.0,7,B
2018-04-09 10:53:10,13470.0,2,7448,2,13460.0,8,13470.0,3,B
2018-04-09 10:53:11,13470.0,2,7450,2,13460.0,6,13470.0,2,B
2018-04-09 10:53:12,13470.0,2,7452,2,13460.0,6,13470.0,1,B
2018-04-09 10:53:13,13470.0,2,7454,2,13460.0,6,13475.0,7,B
2018-04-09 10:53:13,13470.0,2,7456,0,13460.0,6,13475.0,7,B
2018-04-09 10:53:15,13470.0,2,7458,0,13465.0,3,13470.0,1,B
2018-04-09 10:53:19,13470.0,2,7460,0,13465.0,3,13475.0,5,B
2018-04-09 10:53:25,13470.0,2,7462,2,13465.0,1,13470.0,2,B
2018-04-09 10:53:32,13465.0,2,7464,0,13460.0,4,13470.0,2,S
2018-04-09 10:53:36,13465.0,2,7466,0,13460.0,4,13470.0,5,S
2018-04-09 10:53:40,13465.0,2,7468,2,13460.0,4,13470.0,5,S
2018-04-09 10:54:01,13460.0,4,7472,0,13460.0,1,13465.0,8,S
2018-04-09 10:54:02,13460.0,2,7474,0,13455.0,8,13460.0,1,S
2018-04-09 10:54:20,13455.0,2,7476,0,13455.0,9,13465.0,10,S
2018-04-09 10:54:33,13460.0,2,7478,2,13455.0,9,13465.0,6,B
2018-04-09 10:54:43,13460.0,2,7480,0,13455.0,9,13465.0,9,B
2018-04-09 10:54:53,13455.0,2,7482,0,13455.0,6,13460.0,1,S
2018-04-09 10:55:27,13460.0,2,7484,-2,13455.0,7,13460.0,1,B
2018-04-09 10:55:48,13460.0,8,7492,2,13455.0,6,13465.0,8,B
2018-04-09 10:55:56,13460.0,2,7494,0,13455.0,6,13460.0,1,B
2018-04-09 10:56:01,13460.0,2,7496,0,13455.0,8,13465.0,8,B
2018-04-09 10:56:04,13465.0,2,7498,2,13455.0,10,13465.0,6,B
2018-04-09 10:56:05,13465.0,2,7500,0,13455.0,10,13465.0,5,B
2018-04-09 10:56:06,13465.0,2,7502,0,13455.0,10,13465.0,4,B
2018-04-09 10:56:06,13465.0,4,7506,0,13455.0,10,13465.0,2,B
2018-04-09 10:56:07,13465.0,2,7508,0,13455.0,10,13465.0,1,B
2018-04-09 10:56:11,13465.0,2,7510,0,13455.0,10,13465.0,1,B
2018-04-09 10:56:11,13465.0,2,7512,2,13455.0,10,13470.0,23,B
2018-04-09 10:56:13,13470.0,2,7514,2,13455.0,10,13470.0,21,B
2018-04-09 10:56:13,13470.0,4,7518,2,13455.0,10,13465.0,4,B
2018-04-09 10:56:14,13470.0,2,7520,2,13455.0,10,13465.0,1,B
2018-04-09 10:56:19,13465.0,2,7522,0,13455.0,11,13465.0,7,S
2018-04-09 10:56:30,13465.0,2,7524,0,13460.0,6,13465.0,4,S
2018-04-09 10:56:37,13465.0,6,7530,-6,13460.0,6,13465.0,1,S
2018-04-09 10:56:49,13465.0,2,7532,0,13460.0,6,13470.0,20,S
2018-04-09 10:57:22,13465.0,10,7542,0,13465.0,45,13470.0,23,S
2018-04-09 10:57:22,13465.0,2,7544,0,13465.0,44,13470.0,23,S
2018-04-09 10:57:28,13470.0,2,7546,0,13465.0,44,13470.0,7,B
2018-04-09 10:57:28,13470.0,2,7548,0,13465.0,44,13470.0,6,B
2018-04-09 10:57:29,13470.0,4,7552,0,13465.0,44,13470.0,4,B
2018-04-09 10:57:30,13470.0,2,7554,0,13465.0,44,13470.0,3,B
2018-04-09 10:57:36,13470.0,2,7556,0,13465.0,50,13470.0,2,B
2018-04-09 10:57:38,13470.0,2,7558,2,13465.0,50,13470.0,1,B
2018-04-09 10:57:53,13470.0,4,7562,2,13465.0,49,13470.0,3,B
2018-04-09 10:57:53,13470.0,2,7564,0,13465.0,49,13470.0,2,B
2018-04-09 10:57:59,13470.0,2,7566,-2,13465.0,49,13470.0,1,B
2018-04-09 10:58:14,13470.0,2,7568,-2,13465.0,49,13470.0,1,B
2018-04-09 10:58:35,13470.0,2,7570,-2,13470.0,3,13475.0,8,B
2018-04-09 10:58:43,13475.0,2,7572,0,13470.0,4,13475.0,1,B
2018-04-09 10:59:36,13475.0,4,7576,-4,13475.0,1,13480.0,7,B
2018-04-09 10:59:43,13480.0,2,7578,0,13475.0,3,13480.0,2,B
2018-04-09 10:59:43,13480.0,2,7580,-2,13475.0,3,13480.0,1,B
2018-04-09 10:59:49,13480.0,2,7582,-2,13480.0,7,13485.0,15,B
2018-04-09 10:59:49,13480.0,6,7588,-4,13480.0,4,13485.0,16,B
2018-04-09 10:59:50,13480.0,8,7596,-8,13475.0,3,13485.0,16,B
2018-04-09 11:00:03,13480.0,4,7600,4,13475.0,9,13480.0,1,B
2018-04-09 11:00:03,13480.0,2,7602,0,13475.0,10,13485.0,7,B
2018-04-09 11:00:05,13475.0,4,7606,0,13475.0,8,13485.0,6,S
2018-04-09 11:00:20,13485.0,4,7610,4,13480.0,8,13485.0,1,B
2018-04-09 11:00:21,13485.0,2,7612,0,13480.0,10,13490.0,7,B
2018-04-09 11:00:31,13480.0,4,7616,0,13475.0,8,13480.0,3,S
2018-04-09 11:00:33,13480.0,2,7618,0,13475.0,6,13485.0,5,S
2018-04-09 11:00:41,13480.0,2,7620,0,13480.0,1,13485.0,4,S
2018-04-09 11:00:42,13480.0,2,7622,-2,13475.0,8,13485.0,4,S
2018-04-09 11:00:48,13480.0,2,7624,-2,13475.0,8,13485.0,4,S
2018-04-09 11:01:06,13480.0,2,7626,0,13480.0,1,13485.0,4,S
2018-04-09 11:01:30,13480.0,2,7628,0,13480.0,2,13485.0,5,S
2018-04-09 11:01:33,13475.0,2,7630,0,13475.0,8,13485.0,5,S
2018-04-09 11:01:41,13480.0,2,7632,0,13480.0,1,13485.0,4,B
2018-04-09 11:01:47,13480.0,2,7634,0,13475.0,7,13485.0,4,B
2018-04-09 11:02:09,13475.0,6,7640,0,13470.0,8,13480.0,2,S
2018-04-09 11:02:35,13475.0,10,7650,0,13470.0,3,13475.0,3,S
2018-04-09 11:03:07,13470.0,2,7652,0,13465.0,48,13475.0,2,S
2018-04-09 11:03:10,13465.0,2,7654,0,13465.0,49,13475.0,2,S
2018-04-09 11:03:22,13465.0,20,7674,20,13465.0,39,13475.0,2,S
2018-04-09 11:03:41,13470.0,2,7676,2,13470.0,1,13475.0,3,B
2018-04-09 11:03:53,13470.0,2,7678,2,13465.0,39,13475.0,23,B
2018-04-09 11:04:47,13475.0,2,7680,2,13470.0,57,13475.0,21,B
2018-04-09 11:04:55,13475.0,38,7718,28,13470.0,62,13475.0,3,B
2018-04-09 11:04:55,13475.0,6,7724,6,13475.0,5,13480.0,6,B
2018-04-09 11:05:30,13480.0,4,7728,-4,13475.0,14,13485.0,6,B
2018-04-09 11:05:45,13475.0,4,7732,0,13475.0,12,13485.0,6,S
2018-04-09 11:05:51,13485.0,10,7742,-8,13475.0,10,13485.0,1,B
2018-04-09 11:05:57,13485.0,2,7744,-2,13480.0,1,13485.0,2,B
2018-04-09 11:06:23,13485.0,2,7746,-2,13485.0,1,13490.0,5,B
2018-04-09 11:06:24,13485.0,2,7748,-2,13480.0,4,13490.0,5,B
2018-04-09 11:06:39,13485.0,2,7750,-2,13480.0,2,13490.0,7,B
2018-04-09 11:06:46,13480.0,2,7752,0,13480.0,1,13485.0,1,S
2018-04-09 11:06:57,13480.0,6,7758,-2,13475.0,6,13480.0,1,S
2018-04-09 11:07:19,13475.0,4,7762,-2,13470.0,56,13480.0,15,S
2018-04-09 11:07:48,13470.0,20,7782,20,13470.0,43,13475.0,2,S
2018-04-09 11:08:36,13475.0,2,7784,0,13475.0,9,13480.0,5,B
2018-04-09 11:08:40,13480.0,18,7802,-8,13470.0,53,13480.0,8,B
2018-04-09 11:08:43,13470.0,2,7804,0,13470.0,52,13480.0,6,S
2018-04-09 11:09:04,13480.0,4,7808,-2,13475.0,4,13480.0,3,B
2018-04-09 11:09:05,13480.0,6,7814,-4,13480.0,5,13485.0,7,B
2018-04-09 11:09:46,13490.0,10,7824,-4,13490.0,6,13495.0,18,B
2018-04-09 11:09:46,13490.0,12,7836,0,13480.0,4,13490.0,2,B
2018-04-09 11:10:15,13485.0,2,7838,0,13485.0,7,13490.0,16,S
2018-04-09 11:10:17,13485.0,14,7852,12,13480.0,5,13490.0,15,S
2018-04-09 11:10:36,13485.0,32,7884,-4,13485.0,4,13490.0,20,S
2018-04-09 11:10:36,13485.0,8,7892,-4,13475.0,14,13490.0,8,S
2018-04-09 11:10:49,13490.0,14,7906,-10,13490.0,7,13495.0,10,B
2018-04-09 11:10:49,13485.0,16,7922,-12,13480.0,5,13490.0,3,S
2018-04-09 11:11:00,13485.0,2,7924,-2,13480.0,5,13490.0,9,S
2018-04-09 11:11:21,13490.0,4,7928,0,13485.0,3,13490.0,4,B
2018-04-09 11:11:51,13495.0,2,7930,0,13490.0,8,13500.0,48,B
2018-04-09 11:11:54,13500.0,2,7932,0,13490.0,8,13500.0,43,B
2018-04-09 11:12:02,13500.0,6,7938,-6,13495.0,3,13500.0,41,B
2018-04-09 11:12:05,13495.0,6,7944,0,13490.0,5,13500.0,44,S
2018-04-09 11:12:09,13495.0,6,7950,-2,13495.0,3,13500.0,44,S
2018-04-09 11:12:09,13495.0,6,7956,0,13490.0,2,13500.0,44,S
2018-04-09 11:12:15,13490.0,2,7958,-2,13485.0,3,13495.0,4,S
2018-04-09 11:12:24,13500.0,14,7972,-12,13490.0,6,13500.0,43,B
2018-04-09 11:12:35,13490.0,2,7974,0,13490.0,5,13500.0,41,S
2018-04-09 11:12:46,13490.0,2,7976,-2,13490.0,4,13495.0,23,S
2018-04-09 11:12:47,13490.0,6,7982,2,13490.0,1,13495.0,23,S
2018-04-09 11:12:47,13490.0,2,7984,-2,13485.0,5,13495.0,24,S
2018-04-09 11:13:01,13495.0,10,7994,-2,13485.0,5,13495.0,8,B
2018-04-09 11:13:18,13485.0,2,7996,0,13480.0,6,13490.0,10,S
2018-04-09 11:13:58,13490.0,4,8000,0,13485.0,8,13490.0,9,B
2018-04-09 11:13:58,13490.0,2,8002,0,13485.0,8,13490.0,8,B
2018-04-09 11:13:59,13490.0,8,8010,2,13485.0,10,13490.0,4,B
2018-04-09 11:14:05,13490.0,2,8012,2,13485.0,9,13490.0,3,B
2018-04-09 11:14:24,13490.0,4,8016,4,13485.0,23,13490.0,2,B
2018-04-09 11:14:25,13490.0,4,8020,0,13485.0,23,13495.0,11,B
2018-04-09 11:15:37,13490.0,4,8024,0,13485.0,5,13495.0,14,B
2018-04-09 11:15:38,13490.0,4,8028,0,13485.0,8,13495.0,14,B
2018-04-09 11:15:51,13490.0,2,8030,-2,13485.0,8,13495.0,14,B
2018-04-09 11:15:52,13490.0,2,8032,2,13485.0,8,13495.0,14,B
2018-04-09 11:15:53,13490.0,2,8034,2,13485.0,8,13495.0,14,B
2018-04-09 11:16:15,13490.0,2,8036,0,13480.0,11,13490.0,2,B
2018-04-09 11:16:47,13490.0,2,8038,-2,13485.0,2,13490.0,2,B
2018-04-09 11:17:18,13490.0,2,8040,0,13485.0,3,13490.0,1,B
2018-04-09 11:17:41,13485.0,2,8042,-2,13485.0,10,13490.0,3,S
2018-04-09 11:18:13,13480.0,2,8044,-2,13480.0,6,13490.0,3,S
2018-04-09 11:18:19,13480.0,10,8054,4,13480.0,3,13490.0,3,S
2018-04-09 11:18:44,13485.0,2,8056,-2,13485.0,1,13490.0,4,B
2018-04-09 11:18:50,13490.0,2,8058,-2,13490.0,2,13495.0,27,B
2018-04-09 11:19:15,13490.0,4,8062,2,13485.0,17,13495.0,21,B
2018-04-09 11:19:16,13490.0,2,8064,0,13490.0,1,13495.0,21,B
2018-04-09 11:19:53,13490.0,12,8076,-8,13485.0,18,13495.0,19,B
2018-04-09 11:19:54,13490.0,2,8078,0,13485.0,6,13495.0,19,B
2018-04-09 11:20:01,13490.0,2,8080,2,13485.0,5,13490.0,1,B
2018-04-09 11:20:04,13485.0,2,8082,2,13485.0,7,13490.0,1,S
2018-04-09 11:21:52,13485.0,2,8084,0,13480.0,19,13490.0,8,S
2018-04-09 11:22:35,13480.0,2,8086,0,13480.0,1,13485.0,2,S
2018-04-09 11:22:41,13480.0,2,8088,2,13480.0,1,13485.0,1,S
2018-04-09 11:23:01,13480.0,2,8090,0,13475.0,9,13485.0,3,S
2018-04-09 11:23:24,13475.0,2,8092,0,13475.0,3,13480.0,2,S
2018-04-09 11:23:25,13475.0,2,8094,0,13475.0,2,13480.0,2,S
2018-04-09 11:23:27,13480.0,2,8096,-2,13480.0,1,13485.0,5,B
2018-04-09 11:23:32,13480.0,2,8098,0,13475.0,22,13485.0,5,B
2018-04-09 11:23:38,13480.0,2,8100,0,13475.0,11,13485.0,5,B
2018-04-09 11:24:14,13475.0,2,8102,0,13475.0,2,13480.0,1,S
2018-04-09 11:24:18,13480.0,2,8104,-2,13475.0,3,13485.0,5,B
2018-04-09 11:24:29,13480.0,2,8106,-2,13475.0,9,13485.0,4,B
2018-04-09 11:26:38,13480.0,2,8108,-2,13475.0,5,13485.0,6,B
2018-04-09 11:27:28,13480.0,2,8110,2,13480.0,3,13485.0,9,B
2018-04-09 11:27:28,13485.0,6,8116,-6,13480.0,4,13485.0,2,B
2018-04-09 11:28:56,13485.0,4,8120,-4,13485.0,1,13490.0,6,B
2018-04-09 11:28:57,13485.0,2,8122,0,13480.0,11,13490.0,6,B
2018-04-09 11:29:07,13485.0,2,8124,0,13485.0,1,13490.0,4,B
2018-04-09 11:29:11,13490.0,2,8126,0,13485.0,1,13490.0,4,B
2018-04-09 11:29:13,13485.0,4,8130,4,13480.0,9,13485.0,1,S
2018-04-09 11:29:18,13485.0,2,8132,2,13480.0,5,13490.0,6,S
2018-04-09 11:29:19,13485.0,2,8134,-2,13480.0,9,13490.0,6,S
2018-04-09 11:29:20,13490.0,4,8138,-2,13480.0,9,13490.0,4,B
2018-04-09 11:29:30,13490.0,2,8140,-2,13485.0,1,13490.0,3,B
2018-04-09 13:30:00,13495.0,36,8176,36,13485.0,6,13500.0,38,B
2018-04-09 13:30:01,13500.0,2,8178,-2,13490.0,1,13500.0,38,B
2018-04-09 13:30:03,13490.0,2,8180,0,13490.0,2,13500.0,38,S
2018-04-09 13:30:04,13500.0,2,8182,0,13490.0,2,13500.0,36,B
2018-04-09 13:30:07,13490.0,2,8184,-2,13485.0,6,13495.0,10,S
2018-04-09 13:30:12,13495.0,2,8186,2,13490.0,4,13500.0,36,B
2018-04-09 13:30:23,13495.0,2,8188,2,13490.0,6,13500.0,36,B
2018-04-09 13:30:26,13495.0,2,8190,0,13495.0,1,13500.0,35,B
2018-04-09 13:30:27,13495.0,2,8192,0,13490.0,6,13500.0,34,B
2018-04-09 13:30:45,13500.0,6,8198,0,13495.0,15,13500.0,35,B
2018-04-09 13:31:00,13500.0,4,8202,0,13490.0,18,13500.0,35,B
2018-04-09 13:31:06,13495.0,2,8204,0,13495.0,7,13500.0,45,S
2018-04-09 13:31:25,13500.0,10,8214,2,13495.0,27,13500.0,29,B
2018-04-09 13:31:26,13500.0,10,8224,8,13495.0,27,13500.0,24,B
2018-04-09 13:31:26,13500.0,4,8228,4,13495.0,27,13500.0,22,B
2018-04-09 13:31:27,13500.0,8,8236,0,13495.0,14,13500.0,19,B
2018-04-09 13:31:28,13500.0,2,8238,0,13495.0,15,13500.0,18,B
2018-04-09 13:31:29,13500.0,2,8240,2,13495.0,15,13500.0,17,B
2018-04-09 13:31:33,13500.0,2,8242,0,13495.0,15,13500.0,16,B
2018-04-09 13:31:33,13500.0,26,8268,20,13495.0,15,13500.0,3,B
2018-04-09 13:31:38,13500.0,2,8270,0,13495.0,15,13500.0,2,B
2018-04-09 13:31:41,13500.0,4,8274,4,13495.0,15,13505.0,7,B
2018-04-09 13:31:52,13505.0,2,8276,-2,13500.0,5,13510.0,12,B
2018-04-09 13:32:02,13505.0,8,8284,-6,13500.0,4,13510.0,11,B
2018-04-09 13:32:06,13505.0,14,8298,12,13495.0,13,13510.0,24,B
2018-04-09 13:32:18,13510.0,4,8302,0,13500.0,7,13510.0,6,B
2018-04-09 13:32:37,13505.0,2,8304,2,13500.0,7,13510.0,7,S
2018-04-09 13:32:40,13505.0,2,8306,2,13505.0,3,13510.0,7,S
2018-04-09 13:32:44,13505.0,2,8308,0,13505.0,2,13510.0,8,S
2018-04-09 13:32:47,13510.0,14,8322,-6,13500.0,7,13510.0,3,B
2018-04-09 13:33:00,13500.0,2,8324,2,13500.0,4,13510.0,30,S
2018-04-09 13:33:24,13505.0,8,8332,4,13505.0,1,13510.0,17,B
2018-04-09 13:33:26,13505.0,4,8336,-4,13505.0,3,13510.0,17,B
2018-04-09 13:33:26,13510.0,2,8338,0,13505.0,4,13510.0,16,B
2018-04-09 13:33:32,13505.0,2,8340,0,13505.0,15,13510.0,17,S
2018-04-09 13:33:38,13505.0,10,8350,2,13500.0,18,13510.0,17,S
2018-04-09 13:33:46,13505.0,2,8352,0,13500.0,19,13505.0,1,S
2018-04-09 13:33:51,13500.0,4,8356,-2,13500.0,5,13505.0,2,S
2018-04-09 13:33:51,13500.0,2,8358,0,13500.0,4,13505.0,2,S
2018-04-09 13:33:52,13500.0,8,8366,0,13495.0,3,13505.0,2,S
2018-04-09 13:33:54,13500.0,2,8368,2,13500.0,1,13505.0,2,S
2018-04-09 13:34:03,13505.0,2,8370,-2,13500.0,1,13505.0,1,B
2018-04-09 13:34:11,13505.0,2,8372,-2,13500.0,10,13505.0,1,B
2018-04-09 13:34:12,13500.0,10,8382,0,13500.0,5,13505.0,1,S
2018-04-09 13:34:42,13505.0,14,8396,4,13505.0,3,13510.0,19,B
2018-04-09 13:34:42,13505.0,6,8402,4,13500.0,14,13505.0,2,B
2018-04-09 13:34:50,13505.0,4,8406,4,13505.0,1,13510.0,9,B
2018-04-09 13:34:51,13505.0,2,8408,-2,13500.0,16,13510.0,5,B
2018-04-09 13:35:02,13505.0,2,8410,2,13500.0,16,13505.0,3,B
2018-04-09 13:35:03,13505.0,2,8412,0,13500.0,14,13505.0,2,B
2018-04-09 13:35:04,13505.0,2,8414,0,13500.0,14,13510.0,10,B
2018-04-09 13:35:29,13505.0,2,8416,-2,13505.0,1,13510.0,8,B
2018-04-09 13:35:30,13505.0,2,8418,-2,13500.0,17,13510.0,8,B
2018-04-09 13:35:59,13500.0,2,8420,-2,13500.0,15,13505.0,7,S
2018-04-09 13:36:02,13505.0,18,8438,-4,13500.0,10,13505.0,3,B
2018-04-09 13:36:09,13505.0,2,8440,0,13500.0,10,13505.0,2,B
2018-04-09 13:36:27,13505.0,4,8444,0,13500.0,9,13510.0,7,B
2018-04-09 13:36:38,13505.0,2,8446,-2,13505.0,3,13510.0,4,B
2018-04-09 13:36:39,13510.0,8,8454,-2,13510.0,1,13515.0,11,B
2018-04-09 13:36:39,13510.0,2,8456,0,13505.0,3,13515.0,13,B
2018-04-09 13:36:48,13515.0,6,8462,6,13505.0,5,13515.0,11,B
2018-04-09 13:36:50,13515.0,8,8470,4,13510.0,3,13515.0,1,B
2018-04-09 13:36:51,13515.0,2,8472,-2,13510.0,4,13520.0,8,B
2018-04-09 13:36:53,13520.0,2,8474,2,13510.0,3,13520.0,7,B
2018-04-09 13:37:00,13520.0,2,8476,0,13510.0,5,13520.0,8,B
2018-04-09 13:37:05,13515.0,2,8478,2,13510.0,5,13520.0,4,S
2018-04-09 13:37:16,13510.0,2,8480,2,13510.0,6,13520.0,14,S
2018-04-09 13:37:19,13515.0,2,8482,0,13510.0,6,13520.0,14,B
2018-04-09 13:37:29,13510.0,8,8490,4,13510.0,1,13515.0,1,S
2018-04-09 13:37:55,13515.0,2,8492,2,13510.0,8,13515.0,5,B
2018-04-09 13:38:02,13515.0,2,8494,2,13510.0,5,13515.0,4,B
2018-04-09 13:38:07,13515.0,4,8498,0,13510.0,18,13515.0,2,B
2018-04-09 13:38:37,13510.0,2,8500,2,13510.0,9,13515.0,3,S
2018-04-09 13:38:39,13515.0,4,8504,-4,13515.0,4,13520.0,20,B
2018-04-09 13:38:39,13515.0,2,8506,0,13515.0,3,13520.0,19,B
2018-04-09 13:38:40,13515.0,6,8512,-6,13510.0,10,13520.0,16,B
2018-04-09 13:38:42,13520.0,12,8524,0,13510.0,9,13520.0,10,B
2018-04-09 13:38:48,13515.0,2,8526,0,13510.0,8,13515.0,1,S
2018-04-09 13:38:51,13515.0,2,8528,2,13510.0,8,13515.0,6,S
2018-04-09 13:38:57,13515.0,2,8530,0,13510.0,8,13520.0,9,S
2018-04-09 13:39:41,13510.0,2,8532,0,13510.0,8,13515.0,1,S
2018-04-09 13:39:45,13515.0,2,8534,0,13510.0,7,13520.0,19,B
2018-04-09 13:39:59,13515.0,10,8544,-4,13515.0,1,13520.0,11,B
2018-04-09 13:40:01,13515.0,2,8546,0,13515.0,1,13520.0,9,B
2018-04-09 13:40:01,13515.0,2,8548,0,13515.0,1,13520.0,9,B
2018-04-09 13:40:02,13515.0,2,8550,0,13515.0,1,13520.0,9,B
2018-04-09 13:40:05,13520.0,4,8554,4,13515.0,4,13520.0,6,B
2018-04-09 13:40:08,13520.0,12,8566,0,13515.0,10,13525.0,7,B
2018-04-09 13:40:10,13520.0,2,8568,2,13520.0,1,13525.0,3,B
2018-04-09 13:40:10,13520.0,2,8570,2,13520.0,1,13525.0,3,B
2018-04-09 13:40:12,13520.0,2,8572,0,13515.0,9,13525.0,4,B
2018-04-09 13:40:25,13515.0,2,8574,0,13515.0,4,13520.0,5,S
2018-04-09 13:40:25,13510.0,12,8586,0,13510.0,6,13520.0,6,S
2018-04-09 13:40:36,13510.0,4,8590,-2,13510.0,3,13515.0,2,S
2018-04-09 13:40:40,13510.0,2,8592,-2,13510.0,2,13515.0,2,S
2018-04-09 13:40:41,13510.0,4,8596,0,13505.0,14,13515.0,3,S
2018-04-09 13:40:43,13505.0,4,8600,-2,13505.0,12,13510.0,3,S
2018-04-09 13:40:47,13510.0,2,8602,0,13505.0,12,13510.0,2,B
2018-04-09 13:40:49,13505.0,2,8604,2,13505.0,9,13510.0,5,S
2018-04-09 13:40:50,13505.0,4,8608,4,13505.0,7,13510.0,6,S
2018-04-09 13:41:11,13505.0,14,8622,-8,13500.0,13,13505.0,3,S
2018-04-09 13:41:12,13505.0,6,8628,0,13500.0,15,13510.0,4,S
2018-04-09 13:41:24,13505.0,2,8630,0,13505.0,1,13510.0,4,S
2018-04-09 13:41:27,13505.0,2,8632,0,13505.0,1,13510.0,6,S
2018-04-09 13:41:27,13505.0,2,8634,-2,13500.0,18,13510.0,6,S
2018-04-09 13:41:53,13500.0,2,8636,2,13500.0,13,13505.0,2,S
2018-04-09 13:42:10,13505.0,4,8640,-2,13500.0,13,13510.0,4,B
2018-04-09 13:42:18,13505.0,2,8642,-2,13500.0,12,13510.0,17,B
2018-04-09 13:42:28,13500.0,2,8644,2,13500.0,11,13505.0,1,S
2018-04-09 13:42:34,13505.0,4,8648,2,13505.0,3,13510.0,5,B
2018-04-09 13:42:35,13505.0,6,8654,2,13500.0,11,13505.0,1,B
2018-04-09 13:42:46,13505.0,2,8656,0,13500.0,11,13505.0,1,B
2018-04-09 13:43:05,13500.0,2,8658,2,13500.0,6,13505.0,3,S
2018-04-09 13:43:06,13500.0,2,8660,0,13500.0,5,13505.0,3,S
2018-04-09 13:43:11,13500.0,2,8662,0,13500.0,10,13505.0,3,S
2018-04-09 13:43:40,13505.0,2,8664,-2,13500.0,15,13510.0,7,B
2018-04-09 13:44:09,13505.0,2,8666,2,13500.0,18,13505.0,4,B
2018-04-09 13:44:09,13505.0,6,8672,0,13500.0,18,13505.0,1,B
2018-04-09 13:44:10,13505.0,2,8674,0,13500.0,18,13510.0,13,B
2018-04-09 13:44:26,13505.0,2,8676,0,13500.0,17,13510.0,11,B
2018-04-09 13:44:40,13510.0,2,8678,2,13500.0,20,13510.0,10,B
2018-04-09 13:44:50,13500.0,4,8682,2,13500.0,18,13510.0,14,S
2018-04-09 13:45:42,13510.0,10,8692,-6,13500.0,20,13510.0,9,B
2018-04-09 13:45:46,13500.0,2,8694,0,13500.0,19,13510.0,13,S
2018-04-09 13:46:05,13500.0,4,8698,0,13500.0,17,13505.0,1,S
2018-04-09 13:46:06,13500.0,4,8702,0,13500.0,14,13505.0,1,S
2018-04-09 13:46:11,13505.0,2,8704,0,13500.0,14,13510.0,10,B
2018-04-09 13:46:17,13500.0,2,8706,0,13500.0,14,13510.0,10,S
2018-04-09 13:46:55,13500.0,2,8708,0,13500.0,16,13505.0,4,S
2018-04-09 13:46:56,13500.0,26,8734,12,13495.0,27,13500.0,1,S
2018-04-09 13:47:00,13495.0,2,8736,2,13495.0,22,13500.0,3,S
2018-04-09 13:47:08,13500.0,2,8738,-2,13495.0,22,13500.0,2,B
2018-04-09 13:47:17,13495.0,2,8740,0,13495.0,21,13500.0,6,S
2018-04-09 13:47:17,13495.0,2,8742,0,13495.0,20,13500.0,10,S
2018-04-09 13:47:32,13500.0,2,8744,-2,13495.0,20,13500.0,9,B
2018-04-09 13:47:38,13495.0,34,8778,10,13490.0,9,13495.0,4,S
2018-04-09 13:47:40,13490.0,12,8790,4,13485.0,8,13495.0,11,S
2018-04-09 13:47:54,13490.0,2,8792,0,13490.0,1,13495.0,5,S
2018-04-09 13:47:57,13490.0,2,8794,-2,13490.0,2,13495.0,5,S
2018-04-09 13:48:11,13490.0,2,8796,-2,13485.0,9,13495.0,6,S
2018-04-09 13:48:58,13495.0,2,8798,0,13490.0,3,13495.0,4,B
2018-04-09 13:48:58,13495.0,8,8806,8,13495.0,4,13500.0,4,B
2018-04-09 13:49:16,13495.0,2,8808,2,13495.0,4,13505.0,10,B
2018-04-09 13:49:32,13495.0,4,8812,4,13490.0,5,13500.0,6,B
2018-04-09 13:49:36,13495.0,2,8814,0,13490.0,1,13495.0,4,B
2018-04-09 13:50:11,13495.0,2,8816,2,13490.0,1,13495.0,9,B
2018-04-09 13:50:25,13490.0,2,8818,0,13490.0,2,13495.0,10,S
2018-04-09 13:51:02,13495.0,4,8822,4,13490.0,20,13495.0,7,B
2018-04-09 13:51:03,13495.0,8,8830,4,13490.0,20,13495.0,3,B
2018-04-09 13:51:04,13495.0,6,8836,0,13490.0,20,13500.0,10,B
2018-04-09 13:51:36,13500.0,6,8842,-4,13495.0,29,13505.0,8,B
2018-04-09 13:51:51,13505.0,4,8846,2,13495.0,21,13505.0,5,B
2018-04-09 13:52:04,13500.0,12,8858,2,13495.0,16,13500.0,4,S
2018-04-09 13:52:04,13500.0,8,8866,8,13495.0,15,13505.0,5,S
2018-04-09 13:52:50,13495.0,6,8872,6,13495.0,10,13500.0,3,S
2018-04-09 13:54:01,13500.0,6,8878,-2,13500.0,2,13505.0,6,B
2018-04-09 13:54:25,13505.0,4,8882,0,13500.0,103,13505.0,1,B
2018-04-09 13:54:29,13505.0,4,8886,0,13505.0,1,13510.0,11,B
2018-04-09 13:54:33,13510.0,2,8888,0,13505.0,1,13510.0,12,B
2018-04-09 13:54:34,13510.0,2,8890,0,13505.0,1,13510.0,13,B
2018-04-09 13:54:42,13505.0,2,8892,-2,13500.0,108,13510.0,13,S
2018-04-09 13:54:57,13505.0,2,8894,-2,13500.0,106,13505.0,2,S
2018-04-09 13:54:58,13505.0,4,8898,-4,13500.0,106,13510.0,16,S
2018-04-09 13:54:59,13505.0,2,8900,0,13500.0,106,13505.0,1,S
2018-04-09 13:55:17,13505.0,2,8902,0,13505.0,4,13510.0,18,S
2018-04-09 13:55:46,13510.0,8,8910,-6,13505.0,4,13510.0,17,B
2018-04-09 13:56:10,13505.0,2,8912,0,13505.0,3,13510.0,16,S
2018-04-09 13:56:13,13510.0,4,8916,-2,13505.0,4,13510.0,8,B
2018-04-09 13:56:20,13505.0,2,8918,2,13505.0,3,13510.0,6,S
2018-04-09 13:56:23,13505.0,8,8926,6,13505.0,1,13510.0,6,S
2018-04-09 13:57:05,13510.0,2,8928,-2,13505.0,15,13510.0,3,B
2018-04-09 13:57:06,13510.0,2,8930,-2,13505.0,15,13510.0,2,B
2018-04-09 13:57:57,13505.0,4,8934,0,13505.0,9,13510.0,10,S
2018-04-09 13:58:14,13510.0,2,8936,-2,13505.0,14,13510.0,2,B
2018-04-09 13:59:02,13510.0,12,8948,10,13505.0,18,13515.0,11,B
2018-04-09 13:59:16,13505.0,28,8976,0,13505.0,4,13510.0,5,S
2018-04-09 13:59:17,13505.0,8,8984,0,13500.0,4,13510.0,8,S
2018-04-09 13:59:30,13500.0,2,8986,-2,13500.0,3,13510.0,17,S
2018-04-09 13:59:52,13505.0,4,8990,4,13505.0,18,13510.0,10,B
2018-04-09 13:59:53,13505.0,12,9002,12,13505.0,12,13510.0,10,B
2018-04-09 14:01:03,13505.0,2,9004,2,13505.0,24,13510.0,20,B
2018-04-09 14:01:17,13505.0,2,9006,0,13505.0,23,13510.0,21,B
2018-04-09 14:01:27,13505.0,2,9008,0,13505.0,22,13510.0,23,B
2018-04-09 14:01:43,13510.0,2,9010,2,13505.0,21,13510.0,22,B
2018-04-09 14:02:04,13510.0,2,9012,2,13505.0,21,13510.0,23,B
2018-04-09 14:02:58,13505.0,2,9014,2,13505.0,20,13510.0,24,S
2018-04-09 14:03:14,13510.0,4,9018,2,13505.0,19,13510.0,23,B
2018-04-09 14:03:28,13510.0,6,9024,6,13505.0,22,13510.0,18,B
2018-04-09 14:03:42,13510.0,8,9032,0,13505.0,25,13510.0,14,B
2018-04-09 14:03:42,13510.0,2,9034,-2,13505.0,37,13510.0,13,B
2018-04-09 14:04:24,13505.0,6,9040,6,13505.0,19,13510.0,13,S
2018-04-09 14:04:27,13510.0,10,9050,2,13505.0,14,13510.0,9,B
2018-04-09 14:04:28,13505.0,2,9052,0,13505.0,13,13510.0,9,S
2018-04-09 14:06:32,13505.0,2,9054,2,13505.0,14,13510.0,17,S
2018-04-09 14:06:32,13505.0,2,9056,2,13505.0,13,13510.0,17,S
2018-04-09 14:06:41,13505.0,8,9064,8,13505.0,9,13510.0,15,S
2018-04-09 14:06:42,13505.0,6,9070,0,13505.0,6,13510.0,15,S
2018-04-09 14:06:49,13505.0,12,9082,8,13500.0,28,13510.0,13,S
2018-04-09 14:06:58,13505.0,6,9088,4,13505.0,7,13510.0,31,S
2018-04-09 14:06:59,13505.0,14,9102,10,13500.0,26,13505.0,1,S
2018-04-09 14:06:59,13505.0,4,9106,0,13505.0,2,13510.0,33,S
2018-04-09 14:07:00,13505.0,4,9110,0,13500.0,26,13510.0,37,S
2018-04-09 14:07:07,13505.0,2,9112,0,13505.0,10,13510.0,22,S
2018-04-09 14:07:12,13505.0,20,9132,20,13500.0,41,13505.0,10,S
2018-04-09 14:07:17,13505.0,20,9152,20,13500.0,29,13505.0,1,S
2018-04-09 14:07:17,13505.0,2,9154,0,13500.0,29,13510.0,21,S
2018-04-09 14:07:29,13500.0,58,9212,44,13495.0,17,13500.0,11,S
2018-04-09 14:07:29,13500.0,4,9216,2,13495.0,17,13500.0,9,S
2018-04-09 14:07:33,13495.0,2,9218,0,13495.0,1,13500.0,11,S
2018-04-09 14:07:34,13495.0,2,9220,-2,13490.0,7,13500.0,14,S
2018-04-09 14:07:43,13495.0,4,9224,4,13495.0,2,13500.0,13,S
2018-04-09 14:07:45,13495.0,4,9228,4,13490.0,6,13500.0,10,S
2018-04-09 14:07:48,13495.0,2,9230,0,13490.0,6,13500.0,13,S
2018-04-09 14:07:52,13495.0,2,9232,0,13495.0,1,13500.0,11,S
2018-04-09 14:07:53,13495.0,4,9236,2,13490.0,7,13500.0,10,S
2018-04-09 14:08:08,13490.0,12,9248,6,13485.0,12,13490.0,14,S
2018-04-09 14:08:08,13490.0,4,9252,0,13485.0,14,13490.0,12,S
2018-04-09 14:08:09,13490.0,2,9254,0,13485.0,15,13490.0,12,S
2018-04-09 14:08:38,13490.0,2,9256,0,13485.0,12,13490.0,12,S
2018-04-09 14:08:51,13485.0,2,9258,-2,13485.0,11,13490.0,12,S
2018-04-09 14:08:52,13485.0,22,9280,-10,13480.0,8,13485.0,39,S
2018-04-09 14:08:52,13485.0,8,9288,0,13480.0,9,13485.0,35,S
2018-04-09 14:08:55,13485.0,4,9292,-2,13480.0,22,13485.0,33,S
2018-04-09 14:08:56,13485.0,10,9302,-10,13480.0,21,13485.0,28,S
2018-04-09 14:08:57,13485.0,2,9304,0,13480.0,10,13485.0,27,S
2018-04-09 14:09:00,13485.0,2,9306,0,13480.0,24,13485.0,26,S
2018-04-09 14:09:04,13480.0,2,9308,2,13480.0,23,13485.0,27,S
2018-04-09 14:09:21,13480.0,2,9310,2,13480.0,14,13485.0,28,S
2018-04-09 14:09:24,13485.0,4,9314,-4,13480.0,28,13485.0,25,B
2018-04-09 14:09:27,13480.0,2,9316,2,13480.0,27,13485.0,25,S
2018-04-09 14:09:36,13480.0,2,9318,2,13480.0,14,13485.0,26,S
2018-04-09 14:09:37,13485.0,2,9320,-2,13480.0,14,13485.0,25,B
2018-04-09 14:09:40,13485.0,6,9326,0,13480.0,14,13485.0,22,B
2018-04-09 14:09:41,13485.0,4,9330,-2,13480.0,14,13485.0,20,B
2018-04-09 14:09:42,13485.0,8,9338,-4,13480.0,26,13485.0,16,B
2018-04-09 14:09:43,13485.0,4,9342,0,13480.0,13,13485.0,14,B
2018-04-09 14:09:53,13485.0,2,9344,0,13480.0,28,13485.0,13,B
2018-04-09 14:09:54,13485.0,4,9348,0,13480.0,15,13485.0,11,B
2018-04-09 14:09:55,13485.0,2,9350,0,13480.0,14,13485.0,10,B
2018-04-09 14:10:00,13485.0,2,9352,0,13480.0,14,13485.0,9,B
2018-04-09 14:10:26,13485.0,2,9354,-2,13480.0,16,13485.0,7,B
2018-04-09 14:10:27,13485.0,2,9356,0,13480.0,16,13485.0,6,B
2018-04-09 14:10:35,13480.0,2,9358,2,13480.0,14,13485.0,7,S
2018-04-09 14:10:39,13485.0,10,9368,-8,13480.0,14,13485.0,2,B
2018-04-09 14:10:39,13485.0,4,9372,-2,13485.0,2,13490.0,7,B
2018-04-09 14:10:41,13490.0,4,9376,4,13485.0,5,13495.0,14,B
2018-04-09 14:10:46,13490.0,2,9378,-2,13485.0,5,13495.0,17,B
2018-04-09 14:11:01,13490.0,2,9380,2,13485.0,7,13495.0,14,B
2018-04-09 14:11:15,13490.0,2,9382,0,13490.0,2,13495.0,11,B
2018-04-09 14:11:16,13490.0,4,9386,4,13485.0,8,13490.0,3,B
2018-04-09 14:11:33,13490.0,2,9388,0,13485.0,7,13495.0,16,B
2018-04-09 14:12:26,13490.0,8,9396,-2,13485.0,2,13490.0,29,B
2018-04-09 14:13:06,13490.0,2,9398,2,13485.0,4,13490.0,28,B
2018-04-09 14:13:12,13490.0,20,9418,20,13485.0,4,13490.0,18,B
2018-04-09 14:13:16,13490.0,2,9420,2,13485.0,4,13490.0,17,B
2018-04-09 14:14:11,13490.0,4,9424,4,13485.0,6,13490.0,15,B
2018-04-09 14:14:15,13490.0,2,9426,2,13485.0,6,13490.0,14,B
2018-04-09 14:14:59,13490.0,4,9430,4,13485.0,6,13490.0,12,B
2018-04-09 14:15:05,13490.0,10,9440,10,13485.0,10,13490.0,7,B
2018-04-09 14:15:17,13490.0,12,9452,8,13485.0,11,13490.0,1,B
2018-04-09 14:15:28,13490.0,22,9474,-8,13490.0,17,13495.0,14,B
2018-04-09 14:15:28,13485.0,50,9524,-22,13480.0,14,13490.0,2,S
2018-04-09 14:15:37,13480.0,6,9530,-2,13480.0,10,13490.0,5,S
2018-04-09 14:15:44,13485.0,4,9534,0,13480.0,10,13490.0,2,B
2018-04-09 14:15:47,13480.0,2,9536,2,13480.0,8,13485.0,1,S
2018-04-09 14:15:56,13480.0,12,9548,10,13475.0,16,13480.0,4,S
2018-04-09 14:16:20,13480.0,8,9556,8,13480.0,2,13485.0,5,S
2018-04-09 14:16:37,13485.0,2,9558,0,13485.0,1,13490.0,7,B
2018-04-09 14:16:43,13490.0,2,9560,2,13485.0,1,13490.0,4,B
2018-04-09 14:17:00,13490.0,2,9562,-2,13485.0,1,13490.0,2,B
2018-04-09 14:17:01,13490.0,2,9564,-2,13485.0,5,13490.0,1,B
2018-04-09 14:17:01,13490.0,2,9566,0,13485.0,8,13495.0,13,B
2018-04-09 14:17:29,13490.0,4,9570,2,13485.0,4,13495.0,12,B
2018-04-09 14:18:06,13490.0,2,9572,0,13485.0,4,13495.0,12,B
2018-04-09 14:18:44,13490.0,2,9574,0,13485.0,9,13495.0,10,B
2018-04-09 14:19:25,13495.0,6,9580,0,13485.0,10,13495.0,6,B
2018-04-09 14:19:47,13495.0,4,9584,4,13485.0,5,13490.0,18,B
2018-04-09 14:19:54,13495.0,4,9588,4,13485.0,5,13490.0,16,B
2018-04-09 14:20:01,13490.0,20,9608,20,13485.0,5,13490.0,6,S
2018-04-09 14:20:06,13490.0,12,9620,12,13490.0,4,13495.0,10,S
2018-04-09 14:20:13,13495.0,4,9624,4,13490.0,4,13495.0,8,B
2018-04-09 14:20:42,13495.0,6,9630,4,13490.0,4,13495.0,2,B
2018-04-09 14:21:00,13490.0,8,9638,8,13485.0,7,13490.0,6,S
2018-04-09 14:21:06,13490.0,2,9640,2,13485.0,8,13490.0,5,S
2018-04-09 14:21:06,13490.0,2,9642,2,13485.0,8,13490.0,4,S
2018-04-09 14:21:08,13490.0,2,9644,2,13485.0,10,13490.0,3,S
2018-04-09 14:22:31,13490.0,2,9646,2,13485.0,8,13490.0,3,S
2018-04-09 14:23:01,13490.0,2,9648,0,13485.0,5,13490.0,3,S
2018-04-09 14:23:11,13490.0,2,9650,2,13485.0,5,13490.0,1,S
2018-04-09 14:23:30,13490.0,14,9664,10,13490.0,13,13495.0,5,S
2018-04-09 14:23:31,13490.0,2,9666,0,13490.0,12,13495.0,5,S
2018-04-09 14:23:59,13495.0,10,9676,0,13495.0,7,13500.0,16,B
2018-04-09 14:24:00,13495.0,14,9690,4,13490.0,1,13500.0,18,B
2018-04-09 14:24:06,13495.0,8,9698,4,13490.0,4,13500.0,18,B
2018-04-09 14:24:18,13495.0,2,9700,2,13490.0,4,13500.0,17,B
2018-04-09 14:24:28,13500.0,20,9720,20,13490.0,6,13500.0,7,B
2018-04-09 14:25:06,13500.0,20,9740,10,13500.0,9,13505.0,28,B
2018-04-09 14:25:06,13500.0,18,9758,18,13495.0,2,13500.0,4,B
2018-04-09 14:26:05,13490.0,4,9762,-4,13490.0,4,13495.0,2,S
2018-04-09 14:26:07,13490.0,8,9770,6,13485.0,14,13495.0,2,S
2018-04-09 14:26:08,13490.0,8,9778,0,13485.0,15,13495.0,2,S
2018-04-09 14:26:14,13495.0,2,9780,-2,13485.0,13,13495.0,1,B
2018-04-09 14:27:15,13490.0,8,9788,-6,13485.0,40,13490.0,1,S
2018-04-09 14:27:16,13490.0,2,9790,-2,13485.0,41,13495.0,5,S
2018-04-09 14:27:40,13490.0,2,9792,-2,13490.0,1,13495.0,3,S
2018-04-09 14:27:52,13495.0,2,9794,-2,13495.0,2,13500.0,14,B
2018-04-09 14:29:16,13495.0,2,9796,0,13495.0,1,13500.0,15,B
2018-04-09 14:29:17,13495.0,2,9798,0,13490.0,5,13500.0,15,B
2018-04-09 14:31:04,13495.0,2,9800,2,13490.0,8,13495.0,3,B
2018-04-09 14:31:19,13495.0,4,9804,0,13490.0,8,13495.0,1,B
2018-04-09 14:31:19,13495.0,2,9806,2,13495.0,4,13500.0,9,B
2018-04-09 14:31:20,13495.0,2,9808,0,13495.0,3,13500.0,9,B
2018-04-09 14:31:36,13500.0,10,9818,-4,13495.0,3,13500.0,6,B
2018-04-09 14:31:52,13500.0,6,9824,-4,13495.0,3,13500.0,3,B
2018-04-09 14:31:53,13500.0,2,9826,2,13495.0,3,13500.0,2,B
2018-04-09 14:32:10,13500.0,2,9828,0,13495.0,4,13505.0,10,B
2018-04-09 14:32:11,13495.0,2,9830,2,13495.0,6,13505.0,7,S
2018-04-09 14:32:13,13500.0,2,9832,0,13495.0,5,13505.0,7,B
2018-04-09 14:32:41,13500.0,2,9834,0,13495.0,6,13505.0,7,B
2018-04-09 14:33:01,13500.0,2,9836,0,13495.0,5,13500.0,1,B
2018-04-09 14:33:55,13500.0,6,9842,-4,13500.0,1,13505.0,12,B
2018-04-09 14:34:41,13500.0,2,9844,0,13495.0,7,13500.0,7,B
2018-04-09 14:35:18,13500.0,6,9850,0,13495.0,2,13505.0,11,B
2018-04-09 14:35:31,13505.0,2,9852,0,13500.0,2,13505.0,8,B
2018-04-09 14:35:35,13505.0,2,9854,2,13500.0,2,13505.0,7,B
2018-04-09 14:35:43,13500.0,4,9858,4,13500.0,1,13505.0,7,S
2018-04-09 14:36:18,13500.0,2,9860,2,13500.0,1,13505.0,11,S
2018-04-09 14:36:54,13500.0,2,9862,-2,13500.0,11,13505.0,8,S
2018-04-09 14:37:07,13500.0,2,9864,-2,13500.0,11,13505.0,8,S
2018-04-09 14:37:26,13500.0,4,9868,0,13500.0,9,13505.0,8,S
2018-04-09 14:37:58,13505.0,6,9874,-4,13505.0,1,13510.0,13,B
2018-04-09 14:38:12,13505.0,2,9876,-2,13500.0,13,13505.0,1,B
2018-04-09 14:38:44,13505.0,2,9878,-2,13500.0,12,13505.0,4,B
2018-04-09 14:39:01,13505.0,6,9884,0,13500.0,15,13505.0,1,B
2018-04-09 14:39:02,13505.0,2,9886,0,13505.0,1,13510.0,12,B
2018-04-09 14:39:44,13505.0,4,9890,0,13500.0,7,13510.0,11,B
2018-04-09 14:39:46,13505.0,2,9892,0,13505.0,7,13510.0,13,B
2018-04-09 14:40:13,13510.0,2,9894,2,13505.0,8,13510.0,9,B
2018-04-09 14:41:09,13505.0,2,9896,0,13500.0,26,13510.0,13,S
2018-04-09 14:41:09,13505.0,4,9900,0,13505.0,4,13510.0,13,S
2018-04-09 14:41:10,13505.0,8,9908,0,13500.0,22,13510.0,19,S
2018-04-09 14:41:24,13505.0,2,9910,0,13500.0,25,13510.0,17,S
2018-04-09 14:41:49,13505.0,2,9912,-2,13500.0,29,13505.0,1,S
2018-04-09 14:42:01,13505.0,2,9914,2,13500.0,22,13510.0,20,S
2018-04-09 14:42:02,13505.0,8,9922,6,13505.0,11,13510.0,21,S
2018-04-09 14:42:03,13505.0,2,9924,2,13505.0,10,13510.0,21,S
2018-04-09 14:42:09,13505.0,2,9926,2,13505.0,9,13510.0,14,S
2018-04-09 14:42:38,13505.0,8,9934,0,13505.0,5,13510.0,22,S
2018-04-09 14:42:39,13505.0,2,9936,0,13505.0,4,13510.0,22,S
2018-04-09 14:42:40,13510.0,2,9938,0,13505.0,4,13510.0,21,B
2018-04-09 14:42:43,13505.0,2,9940,0,13505.0,3,13510.0,21,S
2018-04-09 14:42:56,13510.0,2,9942,0,13505.0,3,13510.0,13,B
2018-04-09 14:43:42,13510.0,4,9946,0,13505.0,13,13510.0,11,B
2018-04-09 14:44:12,13505.0,2,9948,0,13505.0,22,13510.0,13,S
2018-04-09 14:44:21,13505.0,2,9950,2,13505.0,21,13510.0,14,S
2018-04-09 14:45:12,13505.0,2,9952,2,13505.0,20,13510.0,11,S
2018-04-09 14:45:14,13510.0,20,9972,-4,13505.0,10,13510.0,1,B
2018-04-09 14:45:18,13510.0,2,9974,-2,13505.0,11,13515.0,9,B
2018-04-09 14:45:31,13505.0,6,9980,-6,13505.0,11,13510.0,1,S
2018-04-09 14:45:39,13505.0,6,9986,0,13505.0,4,13510.0,6,S
2018-04-09 14:45:40,13505.0,8,9994,-4,13500.0,38,13510.0,5,S
2018-04-09 14:45:43,13500.0,2,9996,0,13500.0,38,13510.0,10,S
2018-04-09 14:45:53,13505.0,2,9998,0,13500.0,39,13505.0,1,B
2018-04-09 14:46:20,13500.0,16,10014,-14,13500.0,29,13505.0,8,S
2018-04-09 14:46:28,13505.0,4,10018,-4,13500.0,45,13505.0,8,B
2018-04-09 14:46:28,13505.0,4,10022,-4,13500.0,48,13505.0,6,B
2018-04-09 14:47:05,13505.0,2,10024,0,13500.0,30,13505.0,5,B
2018-04-09 14:47:12,13500.0,2,10026,-2,13500.0,29,13505.0,5,S
2018-04-09 14:47:14,13505.0,2,10028,0,13500.0,29,13505.0,4,B
2018-04-09 14:47:29,13500.0,2,10030,0,13500.0,28,13505.0,4,S
2018-04-09 14:47:56,13505.0,8,10038,-4,13500.0,34,13505.0,6,B
2018-04-09 14:47:57,13505.0,4,10042,-4,13500.0,34,13505.0,4,B
2018-04-09 14:49:14,13505.0,8,10050,-8,13500.0,18,13510.0,10,B
2018-04-09 14:49:15,13505.0,2,10052,0,13500.0,18,13510.0,10,B
2018-04-09 14:49:23,13510.0,2,10054,2,13505.0,9,13515.0,8,B
2018-04-09 14:49:23,13510.0,2,10056,0,13505.0,12,13515.0,6,B
2018-04-09 14:49:31,13510.0,2,10058,2,13510.0,8,13515.0,2,B
2018-04-09 14:49:31,13515.0,2,10060,-2,13510.0,10,13520.0,16,B
2018-04-09 14:49:34,13515.0,4,10064,-2,13515.0,2,13520.0,19,B
2018-04-09 14:49:35,13515.0,4,10068,0,13510.0,6,13520.0,16,B
2018-04-09 14:49:49,13520.0,10,10078,6,13515.0,1,13520.0,10,B
2018-04-09 14:49:50,13525.0,22,10100,-8,13520.0,8,13525.0,2,B
2018-04-09 14:49:50,13525.0,2,10102,-2,13520.0,9,13530.0,7,B
2018-04-09 14:49:52,13525.0,2,10104,0,13525.0,5,13530.0,5,B
2018-04-09 14:49:52,13525.0,2,10106,0,13525.0,1,13530.0,5,B
2018-04-09 14:49:53,13530.0,2,10108,0,13520.0,7,13530.0,4,B
2018-04-09 14:49:53,13520.0,12,10120,2,13520.0,5,13530.0,2,S
2018-04-09 14:49:58,13530.0,2,10122,2,13520.0,5,13530.0,3,B
2018-04-09 14:50:01,13525.0,4,10126,0,13525.0,2,13530.0,2,S
2018-04-09 14:50:02,13525.0,4,10130,4,13520.0,4,13525.0,6,S
2018-04-09 14:50:13,13520.0,2,10132,2,13515.0,8,13520.0,3,S
2018-04-09 14:50:13,13520.0,2,10134,0,13515.0,10,13520.0,2,S
2018-04-09 14:50:14,13520.0,4,10138,0,13515.0,10,13525.0,2,S
2018-04-09 14:50:32,13520.0,8,10146,-6,13515.0,8,13525.0,11,S
2018-04-09 14:50:39,13510.0,30,10176,-10,13510.0,3,13520.0,1,S
2018-04-09 14:50:40,13520.0,2,10178,0,13515.0,1,13520.0,2,B
2018-04-09 14:50:44,13515.0,2,10180,0,13510.0,4,13515.0,8,S
2018-04-09 14:51:17,13515.0,2,10182,0,13510.0,2,13520.0,12,S
2018-04-09 14:51:18,13520.0,8,10190,0,13515.0,1,13520.0,9,B
2018-04-09 14:51:30,13515.0,4,10194,4,13510.0,18,13520.0,4,S
2018-04-09 14:51:42,13510.0,2,10196,-2,13510.0,2,13515.0,7,S
2018-04-09 14:51:56,13515.0,4,10200,0,13510.0,16,13515.0,3,B
2018-04-09 14:52:12,13515.0,2,10202,0,13510.0,2,13515.0,2,B
2018-04-09 14:52:22,13515.0,4,10206,2,13515.0,4,13520.0,13,B
2018-04-09 14:52:23,13515.0,8,10214,6,13510.0,3,13520.0,13,B
2018-04-09 14:53:50,13510.0,4,10218,2,13510.0,2,13515.0,4,S
2018-04-09 14:54:08,13515.0,2,10220,-2,13510.0,5,13515.0,2,B
2018-04-09 14:54:09,13515.0,2,10222,-2,13510.0,30,13520.0,11,B
2018-04-09 14:54:21,13520.0,2,10224,2,13515.0,30,13520.0,4,B
2018-04-09 14:54:21,13520.0,8,10232,-4,13515.0,30,13525.0,8,B
2018-04-09 14:54:37,13520.0,2,10234,0,13515.0,1,13520.0,1,B
2018-04-09 14:54:41,13515.0,2,10236,0,13510.0,33,13520.0,5,S
2018-04-09 14:54:49,13515.0,2,10238,0,13510.0,11,13520.0,8,S
2018-04-09 14:55:10,13520.0,6,10244,2,13510.0,10,13520.0,3,B
2018-04-09 14:55:34,13515.0,2,10246,2,13510.0,5,13515.0,1,S
2018-04-09 14:55:51,13520.0,2,10248,0,13510.0,8,13520.0,4,B
2018-04-09 14:56:41,13515.0,2,10250,0,13510.0,5,13520.0,6,S
2018-04-09 14:57:47,13520.0,2,10252,-2,13515.0,3,13520.0,23,B
2018-04-09 14:58:05,13515.0,2,10254,2,13515.0,3,13520.0,20,S
2018-04-09 14:58:23,13520.0,22,10276,0,13515.0,7,13520.0,12,B
2018-04-09 14:58:29,13520.0,2,10278,2,13515.0,9,13520.0,11,B
2018-04-09 14:58:42,13515.0,14,10292,12,13510.0,14,13515.0,13,S
2018-04-09 14:58:43,13515.0,2,10294,0,13510.0,14,13515.0,12,S
2018-04-09 14:58:43,13510.0,2,10296,-2,13510.0,16,13515.0,12,S
2018-04-09 14:58:59,13515.0,2,10298,2,13510.0,47,13515.0,11,B
2018-04-09 14:59:07,13515.0,2,10300,0,13510.0,14,13515.0,10,B
2018-04-09 14:59:08,13515.0,2,10302,2,13510.0,14,13515.0,9,B
2018-04-09 14:59:19,13515.0,2,10304,2,13510.0,15,13515.0,11,B
2018-04-09 14:59:21,13510.0,4,10308,0,13510.0,12,13515.0,13,S
2018-04-09 14:59:24,13510.0,4,10312,4,13510.0,10,13515.0,13,S
2018-04-09 14:59:30,13510.0,2,10314,0,13510.0,9,13515.0,12,S
2018-04-09 14:59:34,13510.0,2,10316,0,13510.0,5,13515.0,13,S
2018-04-09 14:59:38,13510.0,14,10330,10,13505.0,9,13510.0,1,S
2018-04-09 14:59:39,13510.0,2,10332,0,13510.0,2,13515.0,12,S
2018-04-09 14:59:42,13510.0,2,10334,-2,13510.0,6,13515.0,10,S
2018-04-09 14:59:43,13510.0,4,10338,-4,13510.0,4,13515.0,10,S
2018-04-09 14:59:56,13510.0,8,10346,-2,13510.0,1,13515.0,10,S
2018-04-09 21:00:00,13525.0,2,2,56754,0.0,0,0.0,0,B
2018-04-09 21:00:01,13535.0,2,4,0,13525.0,1,13545.0,1,B
2018-04-09 21:00:01,13560.0,8,12,-4,13530.0,2,13560.0,9,B
2018-04-09 21:00:02,13560.0,8,20,-2,13535.0,1,13560.0,6,B
2018-04-09 21:00:03,13560.0,2,22,2,13545.0,17,13560.0,5,B
2018-04-09 21:00:04,13545.0,6,28,-6,13540.0,28,13550.0,1,S
2018-04-09 21:00:08,13540.0,2,30,0,13530.0,12,13545.0,1,S
2018-04-09 21:00:08,13545.0,2,32,2,13525.0,13,13550.0,1,B
2018-04-09 21:00:10,13545.0,2,34,0,13545.0,1,13550.0,2,B
2018-04-09 21:00:10,13545.0,2,36,0,13535.0,3,13550.0,2,B
2018-04-09 21:00:16,13540.0,2,38,0,13535.0,3,13545.0,3,S
2018-04-09 21:00:24,13545.0,68,106,-12,13540.0,1,13545.0,15,B
2018-04-09 21:00:26,13540.0,2,108,0,13535.0,4,13540.0,2,S
2018-04-09 21:00:29,13535.0,2,110,2,13535.0,4,13540.0,15,S
2018-04-09 21:00:33,13535.0,4,114,4,13535.0,5,13540.0,15,S
2018-04-09 21:00:35,13535.0,2,116,0,13535.0,4,13540.0,15,S
2018-04-09 21:00:35,13535.0,2,118,0,13535.0,3,13540.0,15,S
2018-04-09 21:00:39,13535.0,8,126,-2,13530.0,4,13535.0,2,S
2018-04-09 21:00:39,13535.0,2,128,-2,13530.0,16,13535.0,1,S
2018-04-09 21:00:44,13535.0,2,130,-2,13530.0,17,13535.0,1,S
2018-04-09 21:00:48,13535.0,2,132,-2,13530.0,8,13540.0,15,S
2018-04-09 21:01:06,13535.0,2,134,-2,13530.0,8,13535.0,1,S
2018-04-09 21:01:07,13535.0,2,136,2,13535.0,7,13540.0,17,S
2018-04-09 21:01:07,13535.0,2,138,2,13535.0,5,13540.0,17,S
2018-04-09 21:01:10,13540.0,6,144,2,13535.0,8,13540.0,14,B
2018-04-09 21:01:11,13540.0,28,172,12,13535.0,20,13545.0,15,B
2018-04-09 21:01:12,13545.0,10,182,8,13540.0,28,13545.0,10,B
2018-04-09 21:01:12,13545.0,6,188,4,13540.0,28,13545.0,8,B
2018-04-09 21:01:13,13545.0,16,204,4,13545.0,3,13550.0,2,B
2018-04-09 21:01:14,13545.0,6,210,0,13545.0,1,13550.0,2,B
2018-04-09 21:01:15,13545.0,2,212,-2,13540.0,13,13550.0,2,B
2018-04-09 21:01:17,13545.0,2,214,0,13535.0,5,13550.0,4,B
2018-04-09 21:01:25,13545.0,2,216,2,13540.0,1,13545.0,1,B
2018-04-09 21:01:28,13545.0,2,218,0,13540.0,3,13550.0,6,B
2018-04-09 21:01:32,13545.0,4,222,-4,13545.0,2,13550.0,8,B
2018-04-09 21:01:36,13545.0,4,226,-4,13540.0,1,13545.0,1,B
2018-04-09 21:01:42,13545.0,2,228,0,13545.0,1,13550.0,15,B
2018-04-09 21:01:43,13545.0,2,230,0,13540.0,1,13545.0,5,B
2018-04-09 21:01:43,13545.0,4,234,-2,13540.0,1,13550.0,15,B
2018-04-09 21:01:48,13550.0,2,236,-2,13545.0,4,13550.0,16,B
2018-04-09 21:01:59,13550.0,2,238,0,13545.0,8,13550.0,24,B
2018-04-09 21:01:59,13550.0,4,242,-4,13545.0,8,13550.0,22,B
2018-04-09 21:02:00,13550.0,8,250,0,13545.0,8,13550.0,18,B
2018-04-09 21:02:00,13550.0,4,254,0,13545.0,8,13550.0,16,B
2018-04-09 21:02:01,13550.0,4,258,0,13545.0,8,13550.0,14,B
2018-04-09 21:02:01,13550.0,8,266,0,13545.0,8,13550.0,10,B
2018-04-09 21:02:02,13550.0,4,270,0,13545.0,9,13550.0,8,B
2018-04-09 21:02:02,13545.0,6,276,0,13545.0,8,13550.0,6,S
2018-04-09 21:02:03,13550.0,12,288,0,13545.0,7,13550.0,2,B
2018-04-09 21:02:03,13550.0,4,292,0,13545.0,7,13555.0,2,B
2018-04-09 21:02:04,13550.0,4,296,-2,13545.0,7,13550.0,1,B
2018-04-09 21:02:04,13545.0,6,302,-6,13545.0,4,13550.0,7,S
2018-04-09 21:02:05,13545.0,4,306,-2,13545.0,2,13550.0,7,S
2018-04-09 21:02:05,13545.0,4,310,2,13540.0,5,13550.0,7,S
2018-04-09 21:02:07,13540.0,4,314,-2,13540.0,2,13545.0,7,S
2018-04-09 21:02:07,13540.0,4,318,2,13535.0,5,13545.0,7,S
2018-04-09 21:02:10,13535.0,10,328,10,13530.0,1,13535.0,4,S
2018-04-09 21:02:10,13530.0,2,330,0,13525.0,2,13535.0,4,S
2018-04-09 21:02:13,13535.0,4,334,-4,13525.0,2,13535.0,2,B
2018-04-09 21:02:13,13535.0,4,338,-4,13525.0,2,13535.0,5,B
2018-04-09 21:02:14,13525.0,4,342,4,13520.0,1,13535.0,5,S
2018-04-09 21:02:17,13530.0,4,346,-4,13520.0,1,13535.0,2,B
2018-04-09 21:02:17,13530.0,4,350,-4,13520.0,1,13530.0,1,B
2018-04-09 21:02:18,13530.0,2,352,-2,13530.0,1,13535.0,2,B
2018-04-09 21:02:18,13530.0,2,354,0,13530.0,2,13535.0,2,B
2018-04-09 21:02:19,13530.0,4,358,0,13530.0,2,13535.0,5,B
2018-04-09 21:02:19,13530.0,6,364,0,13530.0,1,13535.0,5,B
2018-04-09 21:02:20,13530.0,2,366,0,13530.0,1,13535.0,6,B
2018-04-09 21:02:20,13530.0,2,368,-2,13520.0,1,13535.0,6,B
2018-04-09 21:02:24,13525.0,2,370,2,13520.0,1,13525.0,2,S
2018-04-09 21:02:25,13520.0,2,372,-2,13510.0,1,13525.0,2,S
2018-04-09 21:02:28,13520.0,2,374,0,13510.0,1,13520.0,2,S
2018-04-09 21:02:32,13520.0,2,376,0,13520.0,1,13530.0,2,S
2018-04-09 21:02:39,13525.0,2,378,0,13520.0,1,13535.0,1,B
2018-04-09 21:02:49,13525.0,2,380,-2,13520.0,1,13525.0,1,B
2018-04-09 21:02:58,13520.0,8,388,0,13515.0,6,13525.0,1,S
2018-04-09 21:03:01,13520.0,2,390,0,13520.0,1,13525.0,2,S
2018-04-09 21:03:48,13520.0,6,396,4,13515.0,18,13520.0,14,S
2018-04-09 21:03:48,13520.0,14,410,6,13515.0,18,13520.0,7,S
2018-04-09 21:03:49,13520.0,14,424,0,13515.0,18,13530.0,5,S
2018-04-09 21:04:05,13530.0,6,430,0,13520.0,1,13530.0,3,B
2018-04-09 21:04:06,13525.0,2,432,0,13520.0,4,13530.0,3,S
2018-04-09 21:04:25,13525.0,2,434,-2,13520.0,3,13530.0,3,S
2018-04-09 21:04:34,13520.0,8,442,8,13515.0,18,13520.0,1,S
2018-04-09 21:04:35,13520.0,2,444,0,13515.0,18,13530.0,4,S
2018-04-09 21:05:01,13520.0,2,446,2,13520.0,1,13525.0,4,S
2018-04-09 21:05:02,13520.0,2,448,0,13515.0,6,13525.0,4,S
2018-04-09 21:05:16,13520.0,2,450,-2,13515.0,6,13520.0,11,S
2018-04-09 21:05:40,13515.0,2,452,-2,13515.0,5,13520.0,11,S
2018-04-09 21:05:52,13515.0,4,456,-4,13515.0,3,13520.0,13,S
2018-04-09 21:05:52,13515.0,6,462,2,13510.0,3,13520.0,13,S
2018-04-09 21:06:23,13515.0,2,464,2,13510.0,4,13515.0,2,S
2018-04-09 21:06:27,13515.0,2,466,2,13510.0,4,13515.0,1,S
2018-04-09 21:06:28,13515.0,2,468,0,13515.0,9,13520.0,11,S
2018-04-09 21:06:31,13520.0,4,472,2,13515.0,10,13520.0,8,B
2018-04-09 21:06:32,13515.0,2,474,0,13515.0,9,13520.0,8,S
2018-04-09 21:06:35,13515.0,4,478,-4,13515.0,7,13520.0,8,S
2018-04-09 21:06:38,13520.0,2,480,0,13515.0,7,13520.0,7,B
2018-04-09 21:06:47,13520.0,2,482,0,13515.0,7,13520.0,6,B
2018-04-09 21:06:48,13520.0,4,486,4,13515.0,7,13520.0,4,B
2018-04-09 21:07:04,13520.0,2,488,2,13515.0,7,13520.0,3,B
2018-04-09 21:07:15,13520.0,6,494,0,13520.0,7,13525.0,11,B
2018-04-09 21:07:33,13525.0,2,496,0,13520.0,7,13525.0,8,B
2018-04-09 21:07:34,13525.0,2,498,0,13520.0,7,13525.0,7,B
2018-04-09 21:07:45,13520.0,6,504,0,13520.0,4,13525.0,6,S
2018-04-09 21:08:19,13520.0,2,506,-2,13520.0,4,13525.0,6,S
2018-04-09 21:08:20,13525.0,4,510,2,13520.0,6,13525.0,3,B
2018-04-09 21:08:21,13525.0,6,516,6,13520.0,6,13530.0,6,B
2018-04-09 21:08:37,13530.0,4,520,2,13525.0,4,13535.0,2,B
2018-04-09 21:08:57,13535.0,2,522,2,13535.0,2,13540.0,1,B
2018-04-09 21:09:10,13535.0,2,524,2,13530.0,3,13535.0,1,B
2018-04-09 21:09:12,13540.0,2,526,0,13535.0,1,13540.0,6,B
2018-04-09 21:09:24,13535.0,2,528,2,13535.0,1,13540.0,8,S
2018-04-09 21:09:25,13535.0,2,530,2,13535.0,1,13540.0,6,S
2018-04-09 21:09:29,13535.0,2,532,0,13535.0,1,13540.0,6,S
2018-04-09 21:09:36,13535.0,4,536,4,13530.0,3,13535.0,8,S
2018-04-09 21:09:54,13530.0,2,538,-2,13525.0,3,13530.0,3,S
2018-04-09 21:10:09,13535.0,2,540,0,13530.0,2,13535.0,8,B
2018-04-09 21:10:10,13535.0,2,542,0,13530.0,2,13535.0,8,B
2018-04-09 21:10:12,13535.0,4,546,4,13530.0,4,13535.0,6,B
2018-04-09 21:10:14,13530.0,2,548,-2,13530.0,3,13535.0,6,S
2018-04-09 21:10:15,13530.0,6,554,6,13525.0,18,13535.0,6,S
2018-04-09 21:10:35,13530.0,2,556,0,13530.0,2,13535.0,5,S
2018-04-09 21:10:51,13530.0,2,558,2,13530.0,2,13535.0,7,S
2018-04-09 21:10:52,13530.0,2,560,2,13530.0,1,13535.0,7,S
2018-04-09 21:11:06,13535.0,2,562,2,13530.0,2,13535.0,6,B
2018-04-09 21:11:18,13530.0,2,564,2,13525.0,5,13535.0,9,S
2018-04-09 21:11:54,13530.0,8,572,8,13525.0,17,13530.0,1,S
2018-04-09 21:11:54,13530.0,2,574,0,13525.0,17,13535.0,7,S
2018-04-09 21:12:11,13530.0,4,578,4,13525.0,7,13530.0,3,S
2018-04-09 21:12:13,13525.0,2,580,0,13525.0,6,13530.0,3,S
2018-04-09 21:12:18,13530.0,6,586,6,13525.0,6,13535.0,7,B
2018-04-09 21:12:26,13535.0,6,592,6,13530.0,1,13535.0,4,B
2018-04-09 21:12:38,13535.0,8,600,8,13535.0,1,13540.0,4,B
2018-04-09 21:12:39,13540.0,4,604,4,13540.0,1,13545.0,4,B
2018-04-09 21:12:40,13545.0,8,612,0,13545.0,1,13550.0,26,B
2018-04-09 21:12:40,13545.0,6,618,4,13535.0,2,13545.0,4,B
2018-04-09 21:12:47,13550.0,6,624,4,13545.0,4,13550.0,22,B
2018-04-09 21:12:49,13550.0,2,626,2,13545.0,1,13550.0,21,B
2018-04-09 21:12:49,13545.0,6,632,2,13540.0,1,13545.0,3,S
2018-04-09 21:13:08,13540.0,2,634,2,13535.0,2,13545.0,1,S
2018-04-09 21:13:22,13540.0,2,636,0,13535.0,3,13540.0,1,S
2018-04-09 21:13:24,13540.0,2,638,2,13535.0,2,13540.0,1,S
2018-04-09 21:13:26,13540.0,2,640,0,13535.0,2,13545.0,7,S
2018-04-09 21:13:39,13540.0,2,642,0,13535.0,3,13540.0,1,S
2018-04-09 21:14:06,13535.0,2,644,-2,13535.0,1,13540.0,4,S
2018-04-09 21:14:07,13535.0,2,646,0,13535.0,1,13540.0,4,S
2018-04-09 21:14:07,13535.0,2,648,0,13530.0,1,13540.0,4,S
2018-04-09 21:14:10,13535.0,2,650,2,13530.0,2,13535.0,1,S
2018-04-09 21:14:14,13530.0,2,652,2,13530.0,1,13535.0,1,S
2018-04-09 21:14:42,13535.0,2,654,2,13535.0,2,13540.0,5,B
2018-04-09 21:14:51,13540.0,4,658,0,13535.0,3,13540.0,1,B
2018-04-09 21:14:52,13540.0,2,660,0,13535.0,2,13545.0,5,B
2018-04-09 21:15:22,13540.0,2,662,0,13535.0,5,13545.0,8,B
2018-04-09 21:15:34,13540.0,2,664,2,13535.0,5,13545.0,8,B
2018-04-09 21:15:35,13540.0,2,666,2,13535.0,5,13540.0,4,B
2018-04-09 21:15:46,13540.0,2,668,0,13535.0,6,13540.0,3,B
2018-04-09 21:15:53,13540.0,2,670,2,13535.0,6,13540.0,2,B
2018-04-09 21:16:10,13535.0,2,672,0,13535.0,5,13540.0,7,S
2018-04-09 21:16:14,13535.0,2,674,0,13535.0,4,13540.0,7,S
2018-04-09 21:16:14,13535.0,8,682,4,13530.0,4,13540.0,7,S
2018-04-09 21:16:46,13530.0,4,686,2,13530.0,3,13535.0,8,S
2018-04-09 21:16:54,13530.0,2,688,0,13530.0,1,13535.0,7,S
2018-04-09 21:16:57,13530.0,2,690,0,13525.0,4,13535.0,8,S
2018-04-09 21:16:59,13525.0,2,692,0,13525.0,2,13530.0,4,S
2018-04-09 21:17:43,13530.0,2,694,2,13525.0,3,13535.0,10,B
2018-04-09 21:17:48,13525.0,2,696,-2,13525.0,3,13535.0,8,S
2018-04-09 21:18:04,13525.0,2,698,2,13525.0,2,13535.0,6,S
2018-04-09 21:18:59,13525.0,6,704,2,13520.0,17,13530.0,4,S
2018-04-09 21:19:45,13530.0,6,710,0,13525.0,2,13535.0,10,B
2018-04-09 21:20:19,13535.0,2,712,0,13530.0,2,13540.0,4,B
2018-04-09 21:20:56,13535.0,2,714,2,13530.0,5,13535.0,1,B
2018-04-09 21:21:20,13535.0,2,716,0,13535.0,1,13540.0,7,B
2018-04-09 21:21:22,13540.0,2,718,2,13535.0,3,13540.0,5,B
2018-04-09 21:21:36,13535.0,2,720,-2,13535.0,2,13540.0,5,S
2018-04-09 21:21:42,13540.0,2,722,2,13535.0,13,13540.0,4,B
2018-04-09 21:21:43,13540.0,8,730,0,13540.0,3,13545.0,6,B
2018-04-09 21:21:44,13545.0,8,738,2,13545.0,2,13550.0,13,B
2018-04-09 21:21:45,13550.0,4,742,4,13545.0,14,13550.0,10,B
2018-04-09 21:21:45,13555.0,36,778,4,13550.0,12,13560.0,9,B
2018-04-09 21:21:46,13560.0,16,794,-2,13555.0,2,13560.0,1,B
2018-04-09 21:21:46,13565.0,4,798,-2,13555.0,16,13565.0,28,B
2018-04-09 21:21:47,13555.0,4,802,2,13550.0,12,13555.0,2,S
2018-04-09 21:21:48,13550.0,2,804,0,13550.0,11,13565.0,35,S
2018-04-09 21:21:55,13550.0,2,806,2,13555.0,1,13565.0,33,S
2018-04-09 21:22:00,13555.0,2,808,0,13550.0,11,13555.0,2,B
2018-04-09 21:22:00,13555.0,4,812,-4,13550.0,11,13560.0,1,B
2018-04-09 21:22:04,13560.0,4,816,4,13555.0,2,13565.0,34,B
2018-04-09 21:22:06,13560.0,4,820,-2,13560.0,1,13565.0,29,B
2018-04-09 21:22:07,13560.0,2,822,0,13555.0,1,13560.0,4,B
2018-04-09 21:22:09,13560.0,2,824,-2,13550.0,11,13560.0,20,B
2018-04-09 21:22:11,13560.0,4,828,-2,13550.0,11,13560.0,5,B
2018-04-09 21:22:11,13550.0,2,830,2,13550.0,10,13560.0,5,S
2018-04-09 21:22:12,13550.0,2,832,0,13550.0,9,13560.0,4,S
2018-04-09 21:22:18,13555.0,2,834,2,13550.0,10,13565.0,31,B
2018-04-09 21:22:27,13555.0,2,836,-2,13555.0,1,13560.0,1,B
2018-04-09 21:22:37,13555.0,2,838,2,13550.0,10,13560.0,3,B
2018-04-09 21:22:52,13555.0,2,840,-2,13550.0,10,13560.0,7,B
2018-04-09 21:22:57,13550.0,2,842,2,13550.0,9,13560.0,7,S
2018-04-09 21:23:01,13555.0,2,844,0,13555.0,27,13560.0,5,B
2018-04-09 21:23:01,13555.0,10,854,8,13555.0,22,13560.0,7,B
2018-04-09 21:23:19,13555.0,2,856,0,13555.0,21,13560.0,3,B
2018-04-09 21:23:22,13560.0,14,870,8,13555.0,21,13560.0,30,B
2018-04-09 21:23:22,13560.0,2,872,2,13555.0,21,13560.0,29,B
2018-04-09 21:23:23,13560.0,28,900,20,13555.0,21,13560.0,15,B
2018-04-09 21:23:23,13555.0,12,912,8,13555.0,21,13560.0,10,S
2018-04-09 21:23:26,13560.0,8,920,4,13555.0,18,13560.0,8,B
2018-04-09 21:23:31,13560.0,10,930,0,13555.0,18,13560.0,13,B
2018-04-09 21:23:31,13560.0,10,940,0,13555.0,18,13560.0,8,B
2018-04-09 21:23:32,13560.0,2,942,2,13555.0,18,13560.0,7,B
2018-04-09 21:23:51,13560.0,16,958,16,13560.0,6,13565.0,32,B
2018-04-09 21:23:51,13560.0,2,960,2,13560.0,5,13565.0,34,B
2018-04-09 21:23:54,13560.0,10,970,10,13555.0,18,13560.0,15,B
2018-04-09 21:24:00,13560.0,6,976,6,13555.0,18,13560.0,12,B
2018-04-09 21:24:13,13560.0,16,992,12,13555.0,31,13560.0,5,B
2018-04-09 21:24:13,13560.0,8,1000,8,13555.0,31,13560.0,1,B
2018-04-09 21:24:14,13560.0,2,1002,2,13555.0,31,13565.0,31,B
2018-04-09 21:24:16,13560.0,2,1004,0,13560.0,1,13565.0,28,B
2018-04-09 21:24:16,13565.0,2,1006,2,13560.0,1,13565.0,27,B
2018-04-09 21:24:17,13560.0,2,1008,0,13555.0,21,13565.0,29,S
2018-04-09 21:24:18,13560.0,10,1018,2,13560.0,1,13565.0,29,S
2018-04-09 21:24:19,13565.0,4,1022,2,13555.0,18,13565.0,30,B
2018-04-09 21:24:40,13555.0,32,1054,12,13555.0,2,13560.0,15,S
2018-04-09 21:24:40,13555.0,4,1058,4,13550.0,10,13555.0,2,S
2018-04-09 21:24:42,13555.0,8,1066,2,13555.0,6,13560.0,17,S
2018-04-09 21:24:46,13555.0,2,1068,2,13555.0,5,13560.0,17,S
2018-04-09 21:24:47,13555.0,2,1070,0,13555.0,4,13560.0,17,S
2018-04-09 21:24:49,13555.0,8,1078,0,13550.0,9,13555.0,1,S
2018-04-09 21:24:57,13550.0,10,1088,10,13550.0,4,13555.0,2,S
2018-04-09 21:25:14,13555.0,6,1094,0,13555.0,2,13560.0,18,B
2018-04-09 21:25:18,13555.0,2,1096,2,13555.0,1,13560.0,17,B
2018-04-09 21:25:24,13555.0,2,1098,0,13550.0,5,13560.0,17,B
2018-04-09 21:25:26,13555.0,2,1100,2,13555.0,2,13560.0,12,B
2018-04-09 21:25:43,13555.0,2,1102,2,13555.0,1,13560.0,12,B
2018-04-09 21:25:43,13555.0,4,1106,2,13550.0,7,13555.0,8,B
2018-04-09 21:25:44,13555.0,4,1110,0,13550.0,7,13555.0,6,B
2018-04-09 21:25:48,13555.0,10,1120,10,13550.0,7,13555.0,2,B
2018-04-09 21:25:49,13555.0,4,1124,4,13550.0,7,13560.0,15,B
2018-04-09 21:26:00,13560.0,10,1134,10,13555.0,2,13560.0,10,B
2018-04-09 21:26:21,13555.0,2,1136,2,13555.0,8,13560.0,8,S
2018-04-09 21:26:30,13560.0,10,1146,10,13555.0,8,13560.0,3,B
2018-04-09 21:26:32,13560.0,6,1152,6,13560.0,2,13565.0,19,B
2018-04-09 21:26:38,13560.0,6,1158,-2,13555.0,7,13565.0,17,B
2018-04-09 21:26:45,13560.0,2,1160,0,13555.0,7,13565.0,22,B
2018-04-09 21:27:22,13560.0,2,1162,2,13555.0,7,13565.0,22,B
2018-04-09 21:27:37,13560.0,2,1164,-2,13555.0,19,13565.0,19,B
2018-04-09 21:27:44,13565.0,2,1166,0,13560.0,2,13565.0,19,B
2018-04-09 21:28:02,13560.0,2,1168,0,13560.0,6,13565.0,20,S
2018-04-09 21:28:03,13560.0,2,1170,0,13560.0,5,13565.0,21,S
2018-04-09 21:28:08,13560.0,2,1172,-2,13560.0,6,13565.0,24,S
2018-04-09 21:28:09,13560.0,12,1184,2,13555.0,5,13565.0,24,S
2018-04-09 21:28:12,13560.0,2,1186,2,13555.0,5,13565.0,24,S
2018-04-09 21:28:13,13560.0,2,1188,-2,13555.0,5,13560.0,1,S
2018-04-09 21:28:28,13560.0,2,1190,0,13555.0,6,13565.0,24,S
2018-04-09 21:28:32,13555.0,2,1192,-2,13555.0,5,13565.0,24,S
2018-04-09 21:28:47,13555.0,2,1194,0,13555.0,4,13560.0,4,S
2018-04-09 21:28:49,13555.0,2,1196,0,13555.0,3,13560.0,4,S
2018-04-09 21:28:51,13555.0,2,1198,0,13555.0,2,13560.0,4,S
2018-04-09 21:28:56,13560.0,2,1200,-2,13555.0,2,13560.0,3,B
2018-04-09 21:29:03,13555.0,2,1202,-2,13555.0,1,13560.0,11,S
2018-04-09 21:29:04,13555.0,2,1204,2,13550.0,6,13560.0,11,S
2018-04-09 21:29:09,13550.0,2,1206,2,13550.0,5,13555.0,7,S
2018-04-09 21:29:10,13550.0,4,1210,4,13550.0,3,13555.0,8,S
2018-04-09 21:29:10,13550.0,6,1216,2,13545.0,6,13555.0,8,S
2018-04-09 21:29:18,13545.0,2,1218,0,13545.0,3,13555.0,8,S
2018-04-09 21:29:19,13545.0,4,1222,2,13550.0,1,13555.0,8,S
2018-04-09 21:29:20,13550.0,2,1224,-2,13550.0,5,13555.0,8,B
2018-04-09 21:29:20,13550.0,4,1228,-2,13550.0,3,13555.0,7,B
2018-04-09 21:29:21,13550.0,2,1230,0,13550.0,2,13555.0,7,B
2018-04-09 21:29:23,13550.0,4,1234,-2,13545.0,3,13555.0,8,B
2018-04-09 21:29:36,13550.0,4,1238,0,13540.0,7,13550.0,2,B
2018-04-09 21:29:46,13545.0,10,1248,6,13545.0,1,13550.0,1,S
2018-04-09 21:29:53,13545.0,4,1252,0,13540.0,16,13545.0,3,S
2018-04-09 21:29:53,13545.0,6,1258,6,13545.0,3,13550.0,3,S
2018-04-09 21:29:58,13545.0,8,1266,8,13540.0,17,13545.0,1,S
2018-04-09 21:29:59,13545.0,2,1268,0,13545.0,1,13550.0,3,S
2018-04-09 21:30:01,13545.0,6,1274,4,13540.0,5,13545.0,2,S
2018-04-09 21:30:01,13545.0,4,1278,0,13545.0,2,13550.0,3,S
2018-04-09 21:30:04,13545.0,4,1282,4,13540.0,5,13545.0,3,S
2018-04-09 21:30:05,13550.0,8,1290,6,13540.0,5,13550.0,2,B
2018-04-09 21:30:07,13550.0,2,1292,-2,13545.0,3,13550.0,1,B
2018-04-09 21:30:13,13555.0,2,1294,0,13545.0,5,13555.0,11,B
2018-04-09 21:30:20,13555.0,2,1296,0,13545.0,6,13555.0,10,B
2018-04-09 21:30:22,13545.0,10,1306,8,13545.0,1,13555.0,10,S
2018-04-09 21:30:29,13545.0,6,1312,2,13540.0,16,13545.0,2,S
2018-04-09 21:30:29,13545.0,4,1316,0,13545.0,4,13550.0,2,S
2018-04-09 21:30:31,13545.0,4,1320,4,13540.0,3,13550.0,6,S
2018-04-09 21:30:34,13540.0,8,1328,2,13535.0,3,13540.0,1,S
2018-04-09 21:30:35,13540.0,2,1330,2,13540.0,1,13545.0,1,S
2018-04-09 21:30:46,13540.0,2,1332,0,13540.0,1,13550.0,3,S
2018-04-09 21:31:04,13545.0,2,1334,2,13540.0,4,13545.0,4,B
2018-04-09 21:31:04,13545.0,8,1342,8,13540.0,4,13550.0,4,B
2018-04-09 21:31:05,13550.0,2,1344,0,13545.0,4,13550.0,3,B
2018-04-09 21:31:08,13545.0,8,1352,8,13540.0,4,13545.0,1,S
2018-04-09 21:31:09,13545.0,2,1354,2,13540.0,4,13550.0,3,S
2018-04-09 21:31:10,13550.0,2,1356,0,13545.0,1,13550.0,2,B
2018-04-09 21:31:16,13545.0,2,1358,0,13540.0,8,13550.0,2,S
2018-04-09 21:31:26,13545.0,2,1360,0,13540.0,5,13545.0,1,S
2018-04-09 21:31:30,13540.0,10,1370,10,13535.0,4,13550.0,6,S
2018-04-09 21:31:40,13545.0,2,1372,2,13540.0,19,13545.0,4,B
2018-04-09 21:31:40,13545.0,8,1380,4,13545.0,4,13550.0,3,B
2018-04-09 21:31:47,13550.0,2,1382,2,13545.0,5,13550.0,2,B
2018-04-09 21:31:56,13545.0,10,1392,8,13540.0,4,13550.0,5,S
2018-04-09 21:32:02,13540.0,4,1396,0,13540.0,1,13545.0,5,S
2018-04-09 21:32:03,13540.0,2,1398,0,13535.0,4,13545.0,6,S
2018-04-09 21:32:13,13535.0,6,1404,2,13530.0,15,13535.0,2,S
2018-04-09 21:32:13,13535.0,8,1412,6,13535.0,1,13540.0,2,S
2018-04-09 21:32:17,13535.0,2,1414,0,13530.0,15,13540.0,2,S
2018-04-09 21:32:25,13535.0,2,1416,0,13530.0,10,13535.0,2,S
2018-04-09 21:32:27,13530.0,10,1426,6,13530.0,5,13535.0,2,S
2018-04-09 21:32:28,13535.0,2,1428,2,13530.0,6,13535.0,2,B
2018-04-09 21:32:32,13535.0,2,1430,2,13535.0,1,13540.0,5,B
2018-04-09 21:32:33,13535.0,2,1432,0,13530.0,6,13540.0,5,B
2018-04-09 21:32:43,13530.0,10,1442,0,13530.0,1,13535.0,2,S
2018-04-09 21:32:43,13530.0,2,1444,2,13530.0,1,13535.0,1,S
2018-04-09 21:32:50,13530.0,4,1448,0,13525.0,18,13530.0,3,S
2018-04-09 21:32:51,13530.0,6,1454,6,13525.0,18,13535.0,3,S
2018-04-09 21:32:55,13530.0,4,1458,0,13530.0,1,13535.0,7,S
2018-04-09 21:32:55,13530.0,2,1460,2,13525.0,4,13535.0,7,S
2018-04-09 21:32:57,13525.0,8,1468,6,13520.0,31,13525.0,1,S
2018-04-09 21:32:57,13525.0,2,1470,2,13525.0,4,13530.0,1,S
2018-04-09 21:32:58,13535.0,2,1472,2,13525.0,3,13535.0,6,B
2018-04-09 21:33:03,13525.0,6,1478,2,13520.0,31,13525.0,2,S
2018-04-09 21:33:04,13525.0,4,1482,0,13525.0,3,13530.0,2,S
2018-04-09 21:33:05,13525.0,6,1488,4,13520.0,31,13525.0,2,S
2018-04-09 21:33:06,13525.0,4,1492,0,13525.0,2,13530.0,2,S
2018-04-09 21:33:10,13530.0,2,1494,2,13525.0,7,13530.0,6,B
2018-04-09 21:33:12,13530.0,10,1504,-2,13530.0,5,13535.0,6,B
2018-04-09 21:33:12,13530.0,8,1512,-4,13530.0,1,13535.0,6,B
2018-04-09 21:33:17,13530.0,2,1514,0,13530.0,1,13535.0,6,B
2018-04-09 21:33:18,13535.0,2,1516,-2,13530.0,1,13535.0,5,B
2018-04-09 21:33:19,13535.0,2,1518,0,13530.0,1,13535.0,4,B
2018-04-09 21:33:20,13535.0,2,1520,0,13530.0,1,13535.0,3,B
2018-04-09 21:33:25,13530.0,2,1522,2,13530.0,1,13535.0,9,S
2018-04-09 21:33:26,13530.0,2,1524,2,13525.0,8,13535.0,11,S
2018-04-09 21:33:42,13530.0,2,1526,0,13530.0,10,13535.0,7,S
2018-04-09 21:33:48,13535.0,2,1528,0,13530.0,10,13540.0,4,B
2018-04-09 21:33:53,13540.0,4,1532,0,13530.0,11,13535.0,1,B
2018-04-09 21:34:01,13540.0,2,1534,2,13530.0,11,13540.0,9,B
2018-04-09 21:35:00,13535.0,2,1536,2,13530.0,12,13535.0,2,S
2018-04-09 21:35:30,13535.0,2,1538,0,13530.0,12,13535.0,1,S
2018-04-09 21:35:38,13535.0,2,1540,2,13530.0,12,13540.0,5,S
2018-04-09 21:35:40,13530.0,2,1542,-2,13530.0,11,13540.0,7,S
2018-04-09 21:35:53,13530.0,2,1544,-2,13530.0,10,13540.0,8,S
2018-04-09 21:35:55,13530.0,2,1546,-2,13530.0,9,13540.0,8,S
2018-04-09 21:36:18,13540.0,2,1548,2,13535.0,3,13545.0,7,B
2018-04-09 21:36:21,13540.0,2,1550,2,13535.0,3,13540.0,1,B
2018-04-09 21:36:36,13540.0,2,1552,0,13535.0,4,13540.0,1,B
2018-04-09 21:36:44,13545.0,4,1556,0,13535.0,4,13545.0,8,B
2018-04-09 21:36:49,13545.0,4,1560,0,13535.0,4,13545.0,6,B
2018-04-09 21:37:28,13545.0,2,1562,0,13535.0,5,13545.0,7,B
2018-04-09 21:37:43,13535.0,2,1564,0,13535.0,4,13545.0,7,S
2018-04-09 21:38:53,13540.0,2,1566,0,13535.0,1,13540.0,4,B
2018-04-09 21:39:39,13535.0,2,1568,2,13530.0,11,13540.0,6,S
2018-04-09 21:39:57,13535.0,4,1572,2,13535.0,1,13540.0,4,S
2018-04-09 21:40:14,13535.0,2,1574,0,13530.0,9,13540.0,2,S
2018-04-09 21:40:40,13530.0,16,1590,4,13525.0,17,13535.0,4,S
2018-04-09 21:40:53,13530.0,4,1594,0,13525.0,18,13530.0,6,S
2018-04-09 21:40:54,13530.0,10,1604,8,13525.0,19,13530.0,1,S
2018-04-09 21:40:55,13530.0,2,1606,2,13530.0,2,13535.0,2,S
2018-04-09 21:41:02,13530.0,4,1610,-4,13530.0,2,13540.0,7,S
2018-04-09 21:41:02,13530.0,4,1614,2,13530.0,1,13540.0,7,S
2018-04-09 21:41:03,13525.0,6,1620,4,13525.0,4,13530.0,2,S
2018-04-09 21:41:04,13525.0,2,1622,0,13525.0,2,13530.0,2,S
2018-04-09 21:41:05,13530.0,4,1626,4,13525.0,3,13535.0,8,B
2018-04-09 21:41:26,13535.0,4,1630,2,13535.0,2,13540.0,7,B
2018-04-09 21:41:26,13535.0,4,1634,4,13530.0,5,13540.0,7,B
2018-04-09 21:41:38,13530.0,8,1642,6,13525.0,4,13540.0,7,S
2018-04-09 21:41:38,13530.0,2,1644,0,13525.0,15,13530.0,3,S
2018-04-09 21:41:39,13530.0,6,1650,6,13525.0,15,13535.0,2,S
2018-04-09 21:41:40,13530.0,8,1658,8,13525.0,4,13535.0,1,S
2018-04-09 21:41:40,13530.0,2,1660,2,13525.0,3,13530.0,3,S
2018-04-09 21:41:41,13530.0,6,1666,6,13530.0,1,13535.0,2,S
2018-04-09 21:41:41,13530.0,2,1668,2,13530.0,3,13535.0,2,S
2018-04-09 21:41:42,13530.0,2,1670,2,13530.0,2,13535.0,2,S
2018-04-09 21:41:42,13530.0,4,1674,4,13525.0,3,13530.0,1,S
2018-04-09 21:41:43,13530.0,2,1676,2,13530.0,2,13535.0,2,S
2018-04-09 21:41:43,13530.0,4,1680,4,13525.0,4,13535.0,2,S
2018-04-09 21:41:44,13530.0,4,1684,4,13525.0,4,13535.0,2,S
2018-04-09 21:41:45,13530.0,6,1690,6,13525.0,4,13535.0,2,S
2018-04-09 21:41:46,13530.0,4,1694,4,13525.0,4,13535.0,2,S
2018-04-09 21:41:56,13530.0,6,1700,4,13525.0,2,13530.0,2,S
2018-04-09 21:42:50,13525.0,2,1702,2,13525.0,4,13535.0,3,S
2018-04-09 21:43:40,13530.0,2,1704,0,13525.0,5,13535.0,5,B
2018-04-09 21:43:58,13525.0,10,1714,8,13525.0,1,13535.0,6,S
2018-04-09 21:43:59,13525.0,4,1718,2,13520.0,21,13530.0,2,S
2018-04-09 21:44:14,13530.0,6,1724,0,13520.0,45,13535.0,8,B
2018-04-09 21:44:21,13535.0,2,1726,2,13525.0,2,13535.0,7,B
2018-04-09 21:44:47,13535.0,2,1728,0,13530.0,2,13535.0,2,B
2018-04-09 21:44:47,13535.0,2,1730,-2,13530.0,2,13535.0,1,B
2018-04-09 21:44:48,13535.0,2,1732,0,13530.0,2,13540.0,5,B
2018-04-09 21:45:28,13530.0,2,1734,0,13525.0,19,13535.0,5,S
2018-04-09 21:45:44,13530.0,2,1736,0,13525.0,18,13535.0,6,S
2018-04-09 21:48:22,13530.0,2,1738,0,13525.0,5,13530.0,3,S
2018-04-09 21:48:22,13530.0,2,1740,0,13525.0,5,13530.0,2,S
2018-04-09 21:48:26,13525.0,2,1742,-2,13525.0,3,13530.0,7,S
2018-04-09 21:48:29,13525.0,6,1748,-4,13520.0,8,13530.0,7,S
2018-04-09 21:48:31,13520.0,10,1758,8,13515.0,7,13520.0,5,S
2018-04-09 21:48:31,13510.0,12,1770,-6,13510.0,13,13520.0,6,S
2018-04-09 21:48:32,13510.0,2,1772,-2,13510.0,12,13520.0,6,S
2018-04-09 21:48:54,13515.0,2,1774,0,13510.0,12,13520.0,3,B
2018-04-09 21:49:09,13515.0,2,1776,-2,13510.0,15,13520.0,3,B
2018-04-09 21:49:36,13520.0,8,1784,-6,13520.0,1,13525.0,11,B
2018-04-09 21:49:36,13520.0,2,1786,0,13515.0,3,13520.0,4,B
2018-04-09 21:49:37,13520.0,4,1790,0,13520.0,9,13525.0,7,B
2018-04-09 21:49:38,13520.0,2,1792,-2,13520.0,8,13525.0,4,B
2018-04-09 21:49:40,13520.0,2,1794,0,13520.0,8,13525.0,4,B
2018-04-09 21:49:45,13520.0,2,1796,0,13520.0,8,13525.0,5,B
2018-04-09 21:49:52,13520.0,2,1798,2,13520.0,4,13525.0,8,B
2018-04-09 21:49:53,13520.0,4,1802,4,13520.0,2,13525.0,8,B
2018-04-09 21:50:00,13520.0,2,1804,0,13520.0,1,13525.0,8,B
2018-04-09 21:50:04,13520.0,2,1806,0,13515.0,5,13525.0,7,B
2018-04-09 21:50:05,13520.0,2,1808,0,13515.0,5,13525.0,7,B
2018-04-09 21:50:18,13515.0,2,1810,2,13515.0,3,13520.0,8,S
2018-04-09 21:50:19,13515.0,4,1814,-2,13510.0,19,13520.0,8,S
2018-04-09 21:50:29,13515.0,2,1816,0,13510.0,17,13515.0,1,S
2018-04-09 21:51:01,13510.0,10,1826,0,13510.0,10,13515.0,8,S
2018-04-09 21:51:02,13510.0,14,1840,-2,13510.0,3,13515.0,20,S
2018-04-09 21:51:13,13510.0,2,1842,0,13510.0,4,13515.0,2,S
2018-04-09 21:51:31,13510.0,2,1844,2,13510.0,5,13515.0,1,S
2018-04-09 21:51:36,13510.0,2,1846,0,13510.0,4,13515.0,1,S
2018-04-09 21:51:54,13510.0,4,1850,-2,13510.0,1,13515.0,5,S
2018-04-09 21:51:56,13510.0,2,1852,-2,13505.0,21,13515.0,20,S
2018-04-09 21:51:58,13505.0,2,1854,2,13505.0,16,13510.0,4,S
2018-04-09 21:51:59,13505.0,2,1856,0,13505.0,15,13510.0,4,S
2018-04-09 21:52:06,13510.0,4,1860,2,13505.0,17,13510.0,2,B
2018-04-09 21:52:14,13510.0,8,1868,-6,13510.0,1,13515.0,7,B
2018-04-09 21:52:14,13510.0,2,1870,-2,13505.0,22,13515.0,5,B
2018-04-09 21:52:59,13515.0,2,1872,0,13510.0,20,13515.0,5,B
2018-04-09 21:53:13,13510.0,8,1880,8,13510.0,36,13515.0,21,S
2018-04-09 21:53:13,13510.0,78,1958,28,13505.0,20,13515.0,23,S
2018-04-09 21:53:14,13510.0,2,1960,0,13505.0,17,13515.0,11,S
2018-04-09 21:53:15,13510.0,2,1962,0,13505.0,17,13510.0,2,S
2018-04-09 21:53:17,13510.0,4,1966,0,13505.0,17,13515.0,8,S
2018-04-09 21:53:24,13510.0,2,1968,0,13510.0,19,13515.0,13,S
2018-04-09 21:53:24,13510.0,4,1972,0,13510.0,17,13515.0,15,S
2018-04-09 21:53:25,13510.0,4,1976,0,13510.0,15,13515.0,15,S
2018-04-09 21:53:28,13510.0,26,2002,6,13510.0,2,13515.0,15,S
2018-04-09 21:53:28,13510.0,4,2006,0,13505.0,18,13510.0,1,S
2018-04-09 21:53:29,13505.0,18,2024,-4,13505.0,9,13510.0,2,S
2018-04-09 21:53:29,13505.0,16,2040,0,13500.0,9,13505.0,6,S
2018-04-09 21:53:30,13500.0,12,2052,2,13495.0,4,13505.0,23,S
2018-04-09 21:53:30,13490.0,24,2076,2,13490.0,3,13495.0,2,S
2018-04-09 21:53:31,13495.0,8,2084,-4,13495.0,3,13505.0,11,B
2018-04-09 21:53:31,13495.0,6,2090,0,13490.0,3,13505.0,9,B
2018-04-09 21:53:38,13505.0,2,2092,2,13495.0,2,13505.0,3,B
2018-04-09 21:53:40,13500.0,2,2094,-2,13495.0,2,13505.0,1,S
2018-04-09 21:53:53,13505.0,6,2100,0,13505.0,2,13510.0,6,B
2018-04-09 21:53:53,13505.0,2,2102,-2,13505.0,1,13510.0,6,B
2018-04-09 21:53:55,13505.0,2,2104,-2,13500.0,2,13510.0,6,B
2018-04-09 21:54:15,13510.0,4,2108,4,13505.0,5,13515.0,8,B
2018-04-09 21:54:16,13510.0,2,2110,-2,13510.0,1,13515.0,8,B
2018-04-09 21:54:18,13515.0,2,2112,2,13505.0,5,13515.0,7,B
2018-04-09 21:54:19,13505.0,2,2114,-2,13505.0,4,13515.0,7,S
2018-04-09 21:56:04,13515.0,6,2120,0,13510.0,4,13515.0,2,B
2018-04-09 21:56:15,13515.0,4,2124,0,13515.0,1,13520.0,7,B
2018-04-09 21:56:24,13520.0,2,2126,2,13515.0,1,13520.0,6,B
2018-04-09 21:56:25,13515.0,2,2128,-2,13510.0,3,13515.0,1,S
2018-04-09 21:56:37,13515.0,2,2130,0,13510.0,1,13520.0,5,S
2018-04-09 21:57:18,13510.0,2,2132,0,13510.0,2,13520.0,37,S
2018-04-09 21:57:54,13510.0,2,2134,-2,13510.0,1,13515.0,3,S
2018-04-09 21:58:43,13515.0,8,2142,-4,13515.0,2,13520.0,23,B
2018-04-09 21:59:55,13515.0,4,2146,-4,13515.0,3,13520.0,19,B
2018-04-09 22:00:24,13515.0,2,2148,-2,13515.0,2,13520.0,20,B
2018-04-09 22:00:27,13515.0,4,2152,-4,13510.0,14,13520.0,20,B
2018-04-09 22:00:50,13515.0,4,2156,0,13515.0,7,13520.0,18,B
2018-04-09 22:02:17,13520.0,4,2160,4,13515.0,8,13520.0,15,B
2018-04-09 22:02:17,13520.0,4,2164,0,13515.0,11,13520.0,13,B
2018-04-09 22:02:45,13520.0,8,2172,8,13515.0,13,13520.0,9,B
2018-04-09 22:02:50,13520.0,16,2188,16,13515.0,15,13520.0,1,B
2018-04-09 22:02:50,13520.0,2,2190,2,13520.0,2,13525.0,5,B
2018-04-09 22:03:06,13525.0,2,2192,0,13520.0,6,13525.0,2,B
2018-04-09 22:03:34,13525.0,2,2194,2,13520.0,9,13525.0,1,B
2018-04-09 22:03:40,13525.0,2,2196,0,13525.0,1,13530.0,10,B
2018-04-09 22:04:20,13525.0,4,2200,0,13520.0,5,13525.0,3,B
2018-04-09 22:05:32,13525.0,4,2204,2,13520.0,20,13530.0,13,B
2018-04-09 22:05:36,13525.0,2,2206,0,13520.0,20,13530.0,10,B
2018-04-09 22:05:46,13530.0,2,2208,-2,13520.0,20,13530.0,9,B
2018-04-09 22:06:15,13525.0,2,2210,0,13520.0,4,13525.0,3,S
2018-04-09 22:06:37,13525.0,4,2214,4,13520.0,5,13525.0,1,S
2018-04-09 22:07:43,13520.0,2,2216,-2,13515.0,13,13525.0,15,S
2018-04-09 22:08:56,13515.0,4,2220,4,13515.0,8,13520.0,6,S
2018-04-09 22:09:09,13515.0,2,2222,-2,13515.0,6,13520.0,7,S
2018-04-09 22:09:18,13515.0,2,2224,-2,13515.0,4,13520.0,5,S
2018-04-09 22:09:24,13515.0,2,2226,-2,13515.0,3,13520.0,7,S
2018-04-09 22:10:30,13515.0,2,2228,0,13515.0,10,13520.0,5,S
2018-04-09 22:11:09,13520.0,2,2230,0,13515.0,10,13520.0,4,B
2018-04-09 22:11:48,13515.0,2,2232,0,13515.0,8,13520.0,4,S
2018-04-09 22:11:57,13520.0,4,2236,0,13515.0,7,13520.0,3,B
2018-04-09 22:12:11,13520.0,6,2242,-4,13515.0,6,13525.0,16,B
2018-04-09 22:12:17,13515.0,2,2244,-2,13515.0,7,13525.0,15,S
2018-04-09 22:15:49,13515.0,6,2250,2,13520.0,1,13525.0,5,S
2018-04-09 22:17:10,13520.0,2,2252,-2,13520.0,3,13525.0,4,B
2018-04-09 22:17:41,13520.0,4,2256,4,13520.0,2,13525.0,4,B
2018-04-09 22:19:56,13520.0,2,2258,0,13520.0,4,13525.0,5,B
2018-04-09 22:19:56,13520.0,8,2266,0,13515.0,6,13525.0,4,B
2018-04-09 22:20:43,13520.0,2,2268,0,13515.0,6,13520.0,1,B
2018-04-09 22:22:46,13520.0,2,2270,0,13520.0,2,13525.0,6,B
2018-04-09 22:23:57,13520.0,2,2272,-2,13520.0,2,13525.0,7,B
2018-04-09 22:23:58,13520.0,2,2274,0,13520.0,1,13525.0,7,B
2018-04-09 22:23:58,13520.0,2,2276,2,13515.0,6,13525.0,7,B
2018-04-09 22:24:36,13515.0,2,2278,-2,13515.0,5,13525.0,7,S
2018-04-09 22:24:45,13520.0,2,2280,-2,13520.0,2,13525.0,6,B
2018-04-09 22:25:44,13525.0,4,2284,-4,13520.0,18,13525.0,4,B
2018-04-09 22:25:45,13525.0,8,2292,2,13525.0,1,13530.0,8,B
2018-04-09 22:26:07,13530.0,2,2294,-2,13525.0,17,13530.0,3,B
2018-04-09 22:26:10,13530.0,2,2296,2,13525.0,4,13530.0,2,B
2018-04-09 22:26:19,13525.0,4,2300,0,13520.0,11,13525.0,2,S
2018-04-09 22:27:47,13525.0,2,2302,0,13520.0,4,13525.0,3,S
2018-04-09 22:28:02,13525.0,2,2304,-2,13520.0,24,13525.0,2,S
2018-04-09 22:28:03,13525.0,2,2306,-2,13520.0,36,13525.0,1,S
2018-04-09 22:28:03,13525.0,2,2308,0,13520.0,36,13530.0,8,S
2018-04-09 22:29:59,13525.0,4,2312,-4,13520.0,7,13530.0,15,S
2018-04-09 22:30:27,13525.0,6,2318,2,13520.0,24,13525.0,7,S
2018-04-09 22:30:27,13525.0,2,2320,0,13520.0,24,13525.0,6,S
2018-04-09 22:30:28,13525.0,12,2332,4,13525.0,2,13530.0,13,S
2018-04-09 22:30:46,13530.0,2,2334,-2,13520.0,24,13530.0,4,B
2018-04-09 22:31:06,13530.0,2,2336,0,13525.0,2,13530.0,1,B
2018-04-09 22:31:21,13530.0,4,2340,4,13525.0,36,13530.0,9,B
2018-04-09 22:31:47,13530.0,2,2342,2,13525.0,23,13530.0,8,B
2018-04-09 22:31:52,13530.0,4,2346,0,13525.0,7,13530.0,7,B
2018-04-09 22:33:52,13525.0,4,2350,0,13525.0,6,13530.0,10,S
2018-04-09 22:33:53,13525.0,8,2358,2,13525.0,2,13530.0,11,S
2018-04-09 22:33:53,13525.0,4,2362,4,13520.0,9,13530.0,11,S
2018-04-09 22:33:54,13520.0,2,2364,-2,13520.0,10,13530.0,11,S
2018-04-09 22:34:28,13525.0,12,2376,-10,13520.0,9,13525.0,2,B
2018-04-09 22:34:45,13525.0,4,2380,-4,13520.0,10,13530.0,12,B
2018-04-09 22:35:18,13525.0,2,2382,-2,13525.0,1,13530.0,11,B
2018-04-09 22:35:19,13530.0,2,2384,2,13525.0,1,13530.0,10,B
2018-04-09 22:35:32,13525.0,2,2386,2,13520.0,10,13530.0,10,S
2018-04-09 22:36:23,13525.0,2,2388,0,13525.0,2,13530.0,10,S
2018-04-09 22:36:55,13525.0,8,2396,-6,13520.0,36,13525.0,6,S
2018-04-09 22:36:56,13525.0,2,2398,-2,13520.0,36,13525.0,5,S
2018-04-09 22:36:57,13525.0,2,2400,0,13520.0,37,13525.0,4,S
2018-04-09 22:37:01,13525.0,2,2402,0,13520.0,24,13525.0,3,S
2018-04-09 22:37:03,13525.0,2,2404,0,13520.0,24,13525.0,2,S
2018-04-09 22:39:52,13520.0,4,2408,2,13520.0,8,13525.0,8,S
2018-04-09 22:39:59,13520.0,12,2420,-4,13520.0,2,13525.0,10,S
2018-04-09 22:40:00,13520.0,4,2424,4,13515.0,21,13520.0,1,S
2018-04-09 22:40:00,13520.0,2,2426,0,13520.0,2,13525.0,8,S
2018-04-09 22:40:01,13520.0,2,2428,0,13515.0,18,13520.0,1,S
2018-04-09 22:40:02,13520.0,4,2432,0,13515.0,18,13525.0,8,S
2018-04-09 22:42:35,13525.0,2,2434,0,13520.0,4,13525.0,3,B
2018-04-09 22:44:26,13525.0,2,2436,-2,13520.0,7,13525.0,2,B
2018-04-09 22:44:27,13525.0,4,2440,-2,13525.0,1,13530.0,12,B
2018-04-09 22:44:31,13530.0,14,2454,6,13525.0,18,13530.0,1,B
2018-04-09 22:44:32,13530.0,2,2456,-2,13530.0,1,13535.0,4,B
2018-04-09 22:44:33,13535.0,2,2458,0,13530.0,5,13540.0,4,B
2018-04-09 22:44:35,13535.0,2,2460,-2,13535.0,4,13540.0,1,B
2018-04-09 22:44:38,13545.0,2,2462,2,13540.0,3,13545.0,2,B
2018-04-09 22:44:39,13545.0,2,2464,-2,13540.0,3,13545.0,1,B
2018-04-09 22:44:39,13545.0,2,2466,0,13540.0,3,13550.0,7,B
2018-04-09 22:45:07,13540.0,6,2472,2,13535.0,1,13545.0,6,S
2018-04-09 22:45:23,13535.0,2,2474,0,13535.0,4,13540.0,1,S
2018-04-09 22:45:33,13540.0,2,2476,2,13535.0,4,13540.0,1,B
2018-04-09 22:45:43,13540.0,2,2478,0,13535.0,3,13540.0,2,B
2018-04-09 22:45:51,13540.0,4,2482,0,13540.0,2,13545.0,6,B
2018-04-09 22:45:54,13540.0,6,2488,-2,13535.0,18,13545.0,3,B
2018-04-09 22:45:55,13540.0,4,2492,0,13535.0,18,13540.0,4,B
2018-04-09 22:45:55,13540.0,6,2498,-6,13535.0,17,13540.0,6,B
2018-04-09 22:45:56,13540.0,2,2500,0,13535.0,4,13540.0,5,B
2018-04-09 22:46:02,13540.0,2,2502,0,13535.0,19,13540.0,6,B
2018-04-09 22:46:02,13540.0,10,2512,10,13535.0,30,13540.0,1,B
2018-04-09 22:46:03,13540.0,2,2514,0,13540.0,1,13545.0,5,B
2018-04-09 22:46:05,13540.0,6,2520,6,13535.0,17,13540.0,7,B
2018-04-09 22:46:08,13540.0,14,2534,2,13535.0,17,13545.0,5,B
2018-04-09 22:46:11,13540.0,2,2536,0,13540.0,7,13545.0,5,B
2018-04-09 22:46:27,13535.0,40,2576,-2,13535.0,4,13545.0,3,S
2018-04-09 22:47:12,13530.0,2,2578,0,13530.0,1,13535.0,4,S
2018-04-09 22:47:13,13530.0,2,2580,0,13525.0,12,13535.0,4,S
2018-04-09 22:47:54,13530.0,2,2582,0,13525.0,11,13535.0,7,S
2018-04-09 22:48:12,13530.0,2,2584,2,13525.0,12,13535.0,6,S
2018-04-09 22:48:23,13530.0,2,2586,2,13525.0,11,13535.0,7,S
2018-04-09 22:48:32,13530.0,2,2588,2,13525.0,13,13535.0,8,S
2018-04-09 22:48:35,13530.0,2,2590,0,13525.0,13,13535.0,8,S
2018-04-09 22:49:47,13530.0,6,2596,2,13525.0,25,13535.0,8,S
2018-04-09 22:50:33,13530.0,2,2598,-2,13525.0,25,13530.0,1,S
2018-04-09 22:51:04,13525.0,22,2620,-20,13525.0,3,13530.0,2,S
2018-04-09 22:51:05,13525.0,6,2626,-6,13520.0,2,13525.0,3,S
2018-04-09 22:51:06,13525.0,4,2630,0,13520.0,2,13525.0,2,S
2018-04-09 22:51:23,13520.0,2,2632,0,13520.0,1,13525.0,9,S
2018-04-09 22:51:23,13520.0,2,2634,0,13515.0,17,13525.0,9,S
2018-04-09 22:51:35,13515.0,6,2640,2,13515.0,13,13520.0,2,S
2018-04-09 22:51:42,13520.0,4,2644,0,13520.0,1,13525.0,7,B
2018-04-09 22:51:56,13525.0,4,2648,0,13520.0,3,13530.0,6,B
2018-04-09 22:52:36,13525.0,2,2650,0,13520.0,3,13530.0,8,B
2018-04-09 22:53:08,13525.0,2,2652,0,13520.0,15,13530.0,8,B
2018-04-09 22:53:17,13525.0,2,2654,-2,13520.0,15,13530.0,8,B
2018-04-09 22:54:58,13525.0,2,2656,-2,13520.0,27,13530.0,2,B
2018-04-09 22:54:59,13525.0,2,2658,-2,13525.0,1,13530.0,2,B
2018-04-09 22:55:03,13530.0,2,2660,0,13520.0,27,13530.0,2,B
2018-04-09 22:55:41,13530.0,14,2674,2,13530.0,3,13535.0,5,B
2018-04-09 22:55:41,13530.0,6,2680,4,13520.0,13,13530.0,2,B
2018-04-09 22:55:47,13530.0,4,2684,-2,13530.0,8,13535.0,2,B
2018-04-09 22:55:47,13530.0,6,2690,0,13530.0,5,13535.0,2,B
2018-04-09 22:55:53,13535.0,6,2696,0,13535.0,1,13540.0,13,B
2018-04-09 22:55:53,13535.0,2,2698,2,13530.0,5,13535.0,1,B
2018-04-09 22:56:03,13535.0,4,2702,-4,13535.0,2,13540.0,12,B
2018-04-09 22:56:04,13535.0,12,2714,0,13530.0,5,13540.0,12,B
2018-04-09 22:56:04,13540.0,2,2716,2,13530.0,5,13540.0,11,B
2018-04-09 22:56:05,13530.0,2,2718,0,13530.0,4,13535.0,3,S
2018-04-09 22:56:22,13530.0,2,2720,0,13530.0,3,13540.0,4,S
2018-04-09 22:56:29,13540.0,8,2728,4,13540.0,1,13545.0,4,B
2018-04-09 22:56:29,13540.0,2,2730,0,13530.0,3,13540.0,1,B
2018-04-09 22:56:52,13530.0,4,2734,-2,13530.0,1,13540.0,12,S
2018-04-09 22:57:02,13530.0,2,2736,0,13525.0,10,13535.0,1,S
2018-04-09 22:57:05,13530.0,2,2738,2,13525.0,10,13535.0,1,S
2018-04-09 22:57:19,13525.0,2,2740,0,13520.0,13,13530.0,1,S
2018-04-09 22:57:23,13525.0,2,2742,-2,13520.0,25,13530.0,1,S
2018-04-09 22:57:29,13525.0,2,2744,0,13525.0,49,13530.0,4,S
2018-04-09 22:57:35,13525.0,2,2746,0,13525.0,48,13530.0,3,S
2018-04-09 22:57:49,13530.0,4,2750,0,13525.0,55,13535.0,1,B
2018-04-09 22:58:01,13530.0,2,2752,-2,13525.0,8,13535.0,4,B
2018-04-09 22:58:23,13530.0,2,2754,0,13530.0,3,13535.0,4,B
2018-04-09 22:58:24,13530.0,2,2756,-2,13530.0,2,13535.0,4,B
2018-04-09 22:58:29,13530.0,2,2758,-2,13530.0,1,13535.0,4,B
2018-04-09 22:58:33,13530.0,2,2760,-2,13525.0,28,13535.0,4,B
2018-04-09 22:58:50,13525.0,2,2762,-2,13525.0,27,13530.0,3,S
2018-04-09 22:58:56,13525.0,20,2782,-18,13525.0,17,13530.0,4,S
2018-04-09 22:58:57,13530.0,2,2784,0,13525.0,17,13530.0,3,B
2018-04-09 22:59:02,13525.0,2,2786,-2,13525.0,16,13530.0,3,S
2018-04-09 22:59:05,13525.0,6,2792,-6,13525.0,13,13530.0,3,S
2018-04-09 22:59:15,13525.0,2,2794,0,13525.0,13,13535.0,3,S
2018-04-09 22:59:21,13525.0,4,2798,-2,13525.0,11,13530.0,2,S
2018-04-09 22:59:21,13525.0,2,2800,-2,13525.0,10,13530.0,2,S
2018-04-09 22:59:26,13530.0,2,2802,0,13525.0,11,13535.0,3,B
2018-04-09 22:59:29,13525.0,6,2808,-6,13525.0,7,13530.0,1,S
2018-04-09 22:59:38,13525.0,2,2810,0,13525.0,7,13530.0,1,S
2018-04-09 22:59:40,13530.0,2,2812,-2,13525.0,7,13535.0,2,B
2018-04-09 22:59:42,13530.0,4,2816,-2,13525.0,6,13535.0,1,B
2018-04-10 09:00:00,13525.0,10,2826,2,13525.0,4,13535.0,1,S
2018-04-10 09:00:01,13535.0,2,2828,0,13535.0,1,13545.0,3,B
2018-04-10 09:00:03,13545.0,2,2830,0,13540.0,11,13545.0,2,B
2018-04-10 09:00:04,13540.0,10,2840,10,13535.0,11,13545.0,5,S
2018-04-10 09:00:05,13540.0,2,2842,2,13535.0,11,13540.0,1,S
2018-04-10 09:00:05,13540.0,2,2844,0,13535.0,11,13540.0,1,S
2018-04-10 09:00:08,13535.0,2,2846,2,13535.0,9,13545.0,2,S
2018-04-10 09:00:15,13545.0,2,2848,0,13540.0,7,13545.0,1,B
2018-04-10 09:00:21,13545.0,2,2850,0,13540.0,7,13550.0,10,B
2018-04-10 09:00:30,13545.0,4,2854,4,13540.0,6,13545.0,1,B
2018-04-10 09:00:30,13545.0,2,2856,0,13540.0,6,13550.0,10,B
2018-04-10 09:00:32,13550.0,4,2860,4,13540.0,8,13545.0,1,B
2018-04-10 09:00:32,13545.0,2,2862,2,13540.0,11,13550.0,8,S
2018-04-10 09:00:48,13540.0,8,2870,6,13535.0,9,13545.0,10,S
2018-04-10 09:00:53,13540.0,2,2872,-2,13540.0,1,13545.0,10,S
2018-04-10 09:00:55,13540.0,2,2874,0,13535.0,9,13545.0,10,S
2018-04-10 09:00:57,13535.0,18,2892,18,13530.0,2,13535.0,41,S
2018-04-10 09:00:58,13535.0,20,2912,0,13530.0,2,13535.0,31,S
2018-04-10 09:01:02,13530.0,2,2914,0,13530.0,2,13535.0,31,S
2018-04-10 09:01:02,13530.0,4,2918,4,13530.0,1,13535.0,31,S
2018-04-10 09:01:04,13530.0,2,2920,0,13530.0,1,13535.0,31,S
2018-04-10 09:01:05,13530.0,2,2922,0,13525.0,4,13535.0,31,S
2018-04-10 09:01:06,13530.0,8,2930,8,13525.0,9,13535.0,31,S
2018-04-10 09:01:06,13535.0,2,2932,0,13530.0,5,13535.0,30,B
2018-04-10 09:01:09,13530.0,8,2940,4,13525.0,8,13530.0,5,S
2018-04-10 09:01:18,13525.0,2,2942,-2,13525.0,4,13530.0,2,S
2018-04-10 09:01:19,13530.0,2,2944,0,13525.0,4,13530.0,1,B
2018-04-10 09:01:21,13530.0,2,2946,-2,13525.0,5,13535.0,30,B
2018-04-10 09:01:21,13525.0,4,2950,-2,13525.0,4,13535.0,30,S
2018-04-10 09:01:28,13530.0,2,2952,0,13525.0,2,13530.0,5,B
2018-04-10 09:01:36,13530.0,10,2962,0,13525.0,3,13535.0,30,B
2018-04-10 09:01:37,13525.0,4,2966,-4,13525.0,1,13535.0,30,S
2018-04-10 09:01:49,13535.0,2,2968,2,13525.0,5,13535.0,31,B
2018-04-10 09:02:01,13530.0,2,2970,2,13525.0,10,13535.0,33,S
2018-04-10 09:02:08,13530.0,4,2974,2,13525.0,10,13535.0,33,S
2018-04-10 09:02:16,13535.0,14,2988,0,13525.0,10,13535.0,26,B
2018-04-10 09:02:19,13525.0,2,2990,2,13525.0,6,13530.0,13,S
2018-04-10 09:02:35,13525.0,8,2998,-6,13525.0,2,13530.0,1,S
2018-04-10 09:02:36,13525.0,4,3002,0,13520.0,4,13530.0,1,S
2018-04-10 09:02:51,13525.0,4,3006,0,13520.0,6,13530.0,4,S
2018-04-10 09:02:54,13530.0,6,3012,-6,13525.0,10,13535.0,22,B
2018-04-10 09:02:59,13530.0,2,3014,0,13525.0,12,13530.0,1,B
2018-04-10 09:03:07,13525.0,26,3040,6,13520.0,14,13525.0,9,S
2018-04-10 09:03:11,13525.0,16,3056,0,13520.0,11,13525.0,1,S
2018-04-10 09:03:18,13525.0,4,3060,0,13520.0,9,13525.0,2,S
2018-04-10 09:03:21,13525.0,2,3062,0,13520.0,9,13525.0,1,S
2018-04-10 09:03:37,13520.0,2,3064,2,13520.0,8,13530.0,9,S
2018-04-10 09:03:38,13520.0,2,3066,2,13520.0,7,13530.0,14,S
2018-04-10 09:03:40,13520.0,2,3068,0,13520.0,6,13530.0,14,S
2018-04-10 09:03:42,13520.0,8,3076,4,13515.0,15,13520.0,16,S
2018-04-10 09:03:49,13515.0,6,3082,-6,13515.0,14,13520.0,16,S
2018-04-10 09:03:54,13520.0,16,3098,10,13515.0,17,13520.0,8,B
2018-04-10 09:03:55,13520.0,16,3114,10,13520.0,2,13525.0,2,B
2018-04-10 09:03:55,13520.0,4,3118,0,13520.0,1,13530.0,5,B
2018-04-10 09:03:59,13520.0,6,3124,6,13515.0,15,13520.0,5,B
2018-04-10 09:03:59,13520.0,10,3134,4,13520.0,1,13525.0,1,B
2018-04-10 09:04:04,13520.0,2,3136,0,13525.0,5,13530.0,6,B
2018-04-10 09:04:11,13520.0,8,3144,6,13515.0,16,13520.0,6,B
2018-04-10 09:04:12,13520.0,12,3156,8,13520.0,4,13525.0,1,B
2018-04-10 09:04:16,13530.0,6,3162,0,13530.0,2,13535.0,1,B
2018-04-10 09:04:20,13530.0,4,3166,-4,13525.0,4,13535.0,4,B
2018-04-10 09:04:28,13525.0,8,3174,8,13520.0,10,13525.0,6,S
2018-04-10 09:04:28,13525.0,12,3186,12,13525.0,1,13530.0,1,S
2018-04-10 09:04:43,13525.0,6,3192,4,13520.0,3,13525.0,7,S
2018-04-10 09:04:49,13520.0,2,3194,-2,13520.0,3,13525.0,7,S
2018-04-10 09:04:49,13525.0,2,3196,0,13520.0,3,13525.0,6,B
2018-04-10 09:05:03,13525.0,10,3206,0,13520.0,5,13525.0,1,B
2018-04-10 09:05:04,13525.0,2,3208,0,13525.0,2,13530.0,1,B
2018-04-10 09:05:09,13525.0,2,3210,0,13525.0,19,13535.0,5,B
2018-04-10 09:05:10,13525.0,2,3212,2,13525.0,18,13535.0,5,B
2018-04-10 09:05:14,13535.0,2,3214,0,13530.0,3,13540.0,4,B
2018-04-10 09:05:19,13540.0,4,3218,-4,13535.0,9,13545.0,6,B
2018-04-10 09:05:22,13545.0,8,3226,4,13545.0,2,13550.0,10,B
2018-04-10 09:05:26,13550.0,12,3238,12,13545.0,14,13550.0,4,B
2018-04-10 09:05:26,13550.0,8,3246,2,13545.0,17,13555.0,3,B
2018-04-10 09:05:28,13555.0,6,3252,6,13555.0,6,13560.0,26,B
2018-04-10 09:05:29,13560.0,36,3288,22,13555.0,9,13560.0,9,B
2018-04-10 09:05:29,13560.0,14,3302,12,13555.0,9,13560.0,2,B
2018-04-10 09:05:32,13555.0,2,3304,0,13555.0,13,13560.0,4,S
2018-04-10 09:05:37,13555.0,2,3306,0,13555.0,13,13560.0,5,S
2018-04-10 09:05:37,13560.0,4,3310,4,13555.0,15,13560.0,4,B
2018-04-10 09:05:38,13555.0,4,3314,0,13555.0,15,13560.0,4,S
2018-04-10 09:05:38,13560.0,8,3322,0,13560.0,13,13565.0,6,B
2018-04-10 09:05:39,13565.0,2,3324,0,13560.0,12,13565.0,3,B
2018-04-10 09:05:39,13565.0,8,3332,4,13565.0,3,13570.0,5,B
2018-04-10 09:05:40,13565.0,2,3334,2,13565.0,3,13570.0,5,B
2018-04-10 09:05:41,13570.0,10,3344,6,13570.0,4,13575.0,2,B
2018-04-10 09:05:41,13575.0,2,3346,0,13570.0,2,13575.0,1,B
2018-04-10 09:05:42,13575.0,4,3350,0,13565.0,2,13575.0,2,B
2018-04-10 09:05:43,13575.0,2,3352,2,13565.0,2,13570.0,1,B
2018-04-10 09:05:44,13565.0,2,3354,0,13560.0,6,13570.0,3,S
2018-04-10 09:05:48,13560.0,2,3356,0,13560.0,1,13570.0,9,S
2018-04-10 09:05:49,13560.0,2,3358,0,13555.0,2,13570.0,9,S
2018-04-10 09:05:50,13570.0,2,3360,0,13560.0,1,13570.0,2,B
2018-04-10 09:05:50,13570.0,4,3364,-4,13570.0,3,13575.0,7,B
2018-04-10 09:05:51,13565.0,8,3372,-2,13560.0,1,13570.0,7,S
2018-04-10 09:05:51,13570.0,2,3374,0,13560.0,1,13570.0,6,B
2018-04-10 09:05:52,13565.0,4,3378,-2,13565.0,1,13575.0,2,S
2018-04-10 09:05:54,13565.0,14,3392,12,13560.0,5,13565.0,3,S
2018-04-10 09:05:55,13565.0,6,3398,6,13565.0,2,13570.0,1,S
2018-04-10 09:05:56,13570.0,2,3400,2,13565.0,1,13570.0,4,B
2018-04-10 09:06:02,13570.0,6,3406,-4,13570.0,1,13575.0,16,B
2018-04-10 09:06:05,13570.0,8,3414,8,13565.0,1,13575.0,13,B
2018-04-10 09:06:05,13565.0,2,3416,0,13560.0,1,13575.0,13,S
2018-04-10 09:06:08,13565.0,2,3418,2,13560.0,3,13570.0,8,S
2018-04-10 09:06:10,13570.0,4,3422,0,13560.0,5,13570.0,6,B
2018-04-10 09:06:12,13570.0,4,3426,-4,13565.0,1,13570.0,4,B
2018-04-10 09:06:13,13565.0,2,3428,0,13560.0,47,13570.0,4,S
2018-04-10 09:06:14,13565.0,4,3432,0,13560.0,38,13570.0,4,S
2018-04-10 09:06:18,13570.0,4,3436,0,13565.0,1,13570.0,2,B
2018-04-10 09:06:21,13570.0,4,3440,0,13570.0,3,13575.0,14,B
2018-04-10 09:06:23,13575.0,2,3442,0,13570.0,5,13575.0,12,B
2018-04-10 09:06:25,13570.0,6,3448,6,13570.0,2,13575.0,12,S
2018-04-10 09:06:26,13570.0,4,3452,4,13565.0,15,13570.0,3,S
2018-04-10 09:06:26,13575.0,32,3484,0,13570.0,1,13580.0,8,B
2018-04-10 09:06:31,13580.0,4,3488,-2,13575.0,1,13580.0,4,B
2018-04-10 09:06:32,13580.0,2,3490,-2,13575.0,1,13580.0,3,B
2018-04-10 09:06:33,13580.0,6,3496,4,13575.0,14,13585.0,17,B
2018-04-10 09:06:35,13585.0,4,3500,0,13580.0,1,13585.0,13,B
2018-04-10 09:06:36,13585.0,6,3506,2,13580.0,1,13585.0,10,B
2018-04-10 09:06:37,13580.0,2,3508,2,13575.0,16,13585.0,10,S
2018-04-10 09:06:38,13585.0,4,3512,4,13580.0,1,13585.0,8,B
2018-04-10 09:06:39,13580.0,2,3514,2,13575.0,16,13580.0,4,S
2018-04-10 09:06:41,13580.0,4,3518,4,13575.0,16,13580.0,3,S
2018-04-10 09:06:42,13580.0,4,3522,2,13575.0,15,13580.0,1,S
2018-04-10 09:06:43,13580.0,2,3524,0,13575.0,15,13585.0,15,S
2018-04-10 09:06:44,13580.0,2,3526,2,13575.0,15,13585.0,17,S
2018-04-10 09:06:48,13580.0,6,3532,-6,13575.0,1,13580.0,2,S
2018-04-10 09:06:49,13575.0,2,3534,2,13570.0,18,13580.0,2,S
2018-04-10 09:06:56,13575.0,2,3536,2,13570.0,18,13580.0,9,S
2018-04-10 09:07:02,13580.0,2,3538,2,13570.0,19,13580.0,9,B
2018-04-10 09:07:05,13580.0,2,3540,0,13570.0,17,13580.0,9,B
2018-04-10 09:07:08,13570.0,2,3542,0,13570.0,2,13575.0,1,S
2018-04-10 09:07:09,13570.0,2,3544,0,13570.0,3,13580.0,11,S
2018-04-10 09:07:16,13570.0,4,3548,4,13565.0,16,13575.0,20,S
2018-04-10 09:07:21,13575.0,2,3550,-2,13565.0,18,13575.0,14,B
2018-04-10 09:07:33,13575.0,10,3560,-10,13570.0,3,13575.0,11,B
2018-04-10 09:07:35,13570.0,2,3562,0,13570.0,2,13575.0,11,S
2018-04-10 09:07:38,13570.0,8,3570,6,13570.0,2,13575.0,4,S
2018-04-10 09:07:40,13570.0,4,3574,-2,13565.0,16,13570.0,2,S
2018-04-10 09:07:41,13570.0,6,3580,-2,13570.0,6,13575.0,3,S
2018-04-10 09:07:42,13575.0,2,3582,-2,13570.0,5,13575.0,3,B
2018-04-10 09:07:49,13570.0,4,3586,0,13570.0,3,13575.0,3,S
2018-04-10 09:07:50,13575.0,2,3588,0,13570.0,3,13575.0,2,B
2018-04-10 09:07:52,13575.0,4,3592,0,13570.0,3,13580.0,19,B
2018-04-10 09:07:55,13570.0,2,3594,2,13570.0,4,13575.0,8,S
2018-04-10 09:07:56,13575.0,4,3598,0,13570.0,4,13575.0,5,B
2018-04-10 09:07:58,13575.0,2,3600,0,13570.0,19,13580.0,18,B
2018-04-10 09:08:04,13570.0,6,3606,-2,13565.0,17,13575.0,16,S
2018-04-10 09:08:08,13575.0,2,3608,-2,13570.0,2,13575.0,8,B
2018-04-10 09:08:16,13575.0,6,3614,-4,13565.0,37,13575.0,4,B
2018-04-10 09:08:19,13570.0,2,3616,2,13565.0,38,13575.0,6,S
2018-04-10 09:08:28,13570.0,2,3618,2,13565.0,38,13575.0,10,S
2018-04-10 09:08:31,13575.0,2,3620,0,13565.0,52,13575.0,7,B
2018-04-10 09:08:35,13575.0,2,3622,-2,13570.0,2,13575.0,10,B
2018-04-10 09:08:50,13575.0,2,3624,2,13570.0,2,13575.0,7,B
2018-04-10 09:08:51,13575.0,8,3632,0,13570.0,1,13575.0,3,B
2018-04-10 09:08:52,13575.0,2,3634,0,13570.0,1,13575.0,2,B
2018-04-10 09:09:02,13575.0,6,3640,-4,13570.0,1,13575.0,5,B
2018-04-10 09:09:07,13575.0,4,3644,0,13570.0,3,13575.0,1,B
2018-04-10 09:09:11,13575.0,2,3646,0,13570.0,2,13575.0,1,B
2018-04-10 09:09:14,13575.0,2,3648,-2,13570.0,3,13575.0,1,B
2018-04-10 09:09:34,13575.0,2,3650,-2,13570.0,2,13575.0,14,B
2018-04-10 09:09:36,13570.0,8,3658,-2,13565.0,18,13575.0,13,S
2018-04-10 09:09:37,13575.0,2,3660,0,13570.0,1,13575.0,12,B
2018-04-10 09:09:40,13570.0,2,3662,0,13565.0,21,13570.0,1,S
2018-04-10 09:09:46,13570.0,2,3664,-2,13565.0,20,13575.0,1,S
2018-04-10 09:09:57,13575.0,2,3666,-2,13570.0,4,13575.0,9,B
2018-04-10 09:09:59,13575.0,6,3672,0,13570.0,4,13575.0,6,B
2018-04-10 09:10:01,13575.0,6,3678,0,13575.0,3,13580.0,17,B
2018-04-10 09:10:02,13580.0,6,3684,-2,13575.0,3,13580.0,14,B
2018-04-10 09:10:03,13580.0,6,3690,4,13570.0,18,13580.0,16,B
2018-04-10 09:10:15,13570.0,2,3692,2,13570.0,17,13575.0,1,S
2018-04-10 09:10:22,13575.0,2,3694,-2,13570.0,6,13580.0,17,B
2018-04-10 09:10:25,13575.0,2,3696,0,13575.0,3,13580.0,12,B
2018-04-10 09:10:27,13580.0,6,3702,0,13575.0,2,13580.0,9,B
2018-04-10 09:10:32,13580.0,4,3706,0,13575.0,3,13580.0,7,B
2018-04-10 09:10:36,13580.0,2,3708,2,13575.0,5,13580.0,6,B
2018-04-10 09:10:39,13580.0,8,3716,0,13575.0,8,13580.0,2,B
2018-04-10 09:10:40,13580.0,4,3720,2,13575.0,8,13585.0,10,B
2018-04-10 09:10:47,13585.0,2,3722,2,13575.0,6,13585.0,8,B
2018-04-10 09:10:47,13585.0,4,3726,-2,13575.0,6,13585.0,6,B
2018-04-10 09:10:50,13580.0,2,3728,0,13575.0,6,13585.0,6,S
2018-04-10 09:10:54,13575.0,6,3734,0,13575.0,3,13580.0,17,S
2018-04-10 09:10:55,13570.0,10,3744,4,13570.0,1,13575.0,10,S
2018-04-10 09:10:56,13570.0,2,3746,-2,13565.0,1,13575.0,6,S
2018-04-10 09:11:00,13570.0,2,3748,0,13565.0,2,13575.0,1,S
2018-04-10 09:11:03,13570.0,2,3750,-2,13565.0,7,13570.0,3,S
2018-04-10 09:11:06,13575.0,2,3752,0,13570.0,1,13575.0,3,B
2018-04-10 09:11:07,13575.0,2,3754,0,13570.0,1,13575.0,3,B
2018-04-10 09:11:11,13575.0,6,3760,-6,13570.0,2,13580.0,10,B
2018-04-10 09:11:12,13575.0,2,3762,-2,13570.0,2,13575.0,5,B
2018-04-10 09:11:13,13575.0,10,3772,4,13575.0,15,13580.0,11,B
2018-04-10 09:11:14,13575.0,8,3780,2,13575.0,11,13580.0,9,B
2018-04-10 09:11:16,13575.0,10,3790,8,13575.0,6,13580.0,8,B
2018-04-10 09:11:16,13580.0,2,3792,0,13575.0,6,13580.0,8,B
2018-04-10 09:11:18,13575.0,10,3802,0,13575.0,1,13580.0,8,S
2018-04-10 09:11:18,13575.0,2,3804,0,13570.0,2,13575.0,2,S
2018-04-10 09:11:26,13580.0,20,3824,4,13580.0,11,13585.0,8,B
2018-04-10 09:11:27,13580.0,22,3846,8,13575.0,1,13580.0,12,B
2018-04-10 09:11:27,13575.0,4,3850,2,13570.0,12,13580.0,14,S
2018-04-10 09:11:32,13580.0,2,3852,2,13575.0,1,13580.0,6,B
2018-04-10 09:11:36,13580.0,12,3864,8,13580.0,14,13585.0,8,B
2018-04-10 09:11:36,13580.0,2,3866,2,13580.0,13,13585.0,7,B
2018-04-10 09:11:43,13580.0,10,3876,10,13580.0,8,13585.0,11,B
2018-04-10 09:11:44,13580.0,2,3878,0,13580.0,7,13585.0,11,B
2018-04-10 09:11:46,13585.0,2,3880,0,13580.0,7,13585.0,10,B
2018-04-10 09:11:51,13585.0,22,3902,8,13585.0,10,13590.0,8,B
2018-04-10 09:11:59,13590.0,12,3914,4,13585.0,14,13595.0,5,B
2018-04-10 09:12:04,13590.0,2,3916,0,13590.0,14,13595.0,3,B
2018-04-10 09:12:06,13595.0,4,3920,-2,13590.0,14,13595.0,1,B
2018-04-10 09:12:06,13590.0,4,3924,-2,13590.0,13,13600.0,34,S
2018-04-10 09:12:12,13595.0,6,3930,-6,13595.0,1,13600.0,34,B
2018-04-10 09:12:13,13600.0,2,3932,0,13595.0,7,13600.0,33,B
2018-04-10 09:12:13,13595.0,6,3938,-2,13595.0,3,13600.0,32,S
2018-04-10 09:12:21,13600.0,40,3978,38,13595.0,2,13600.0,12,B
2018-04-10 09:12:23,13595.0,2,3980,0,13595.0,2,13600.0,12,S
2018-04-10 09:12:23,13600.0,12,3992,6,13595.0,8,13600.0,6,B
2018-04-10 09:12:24,13600.0,12,4004,12,13600.0,6,13605.0,2,B
2018-04-10 09:12:25,13610.0,4,4008,2,13600.0,7,13610.0,14,B
2018-04-10 09:12:25,13610.0,6,4014,0,13605.0,3,13610.0,11,B
2018-04-10 09:12:26,13610.0,2,4016,0,13605.0,5,13610.0,10,B
2018-04-10 09:12:27,13610.0,20,4036,20,13610.0,4,13615.0,3,B
2018-04-10 09:12:27,13615.0,4,4040,4,13610.0,4,13615.0,1,B
2018-04-10 09:12:28,13610.0,8,4048,2,13600.0,18,13615.0,4,S
2018-04-10 09:12:31,13610.0,4,4052,2,13605.0,1,13610.0,1,S
2018-04-10 09:12:39,13605.0,2,4054,0,13600.0,9,13610.0,7,S
2018-04-10 09:12:42,13600.0,2,4056,0,13600.0,6,13610.0,8,S
2018-04-10 09:12:43,13605.0,2,4058,-2,13600.0,6,13605.0,7,B
2018-04-10 09:12:48,13600.0,16,4074,6,13595.0,2,13605.0,6,S
2018-04-10 09:12:48,13600.0,4,4078,0,13595.0,1,13600.0,14,S
2018-04-10 09:12:49,13595.0,2,4080,2,13590.0,2,13600.0,17,S
2018-04-10 09:12:50,13595.0,2,4082,2,13590.0,3,13595.0,1,S
2018-04-10 09:12:56,13600.0,4,4086,0,13595.0,3,13600.0,13,B
2018-04-10 09:12:56,13600.0,6,4092,0,13595.0,1,13600.0,10,B
2018-04-10 09:13:06,13605.0,4,4096,2,13600.0,8,13610.0,13,B
2018-04-10 09:13:07,13610.0,6,4102,2,13600.0,9,13610.0,5,B
2018-04-10 09:13:10,13605.0,8,4110,4,13605.0,1,13610.0,14,S
2018-04-10 09:13:10,13605.0,2,4112,0,13605.0,2,13610.0,12,S
2018-04-10 09:13:12,13610.0,8,4120,0,13605.0,9,13610.0,8,B
2018-04-10 09:13:13,13610.0,8,4128,0,13605.0,9,13610.0,4,B
2018-04-10 09:13:13,13610.0,8,4136,-2,13605.0,10,13615.0,5,B
2018-04-10 09:13:14,13615.0,6,4142,0,13610.0,9,13615.0,1,B
2018-04-10 09:13:15,13615.0,2,4144,0,13615.0,3,13620.0,10,B
2018-04-10 09:13:16,13615.0,4,4148,4,13615.0,1,13620.0,10,B
2018-04-10 09:13:18,13620.0,4,4152,0,13615.0,5,13620.0,7,B
2018-04-10 09:13:19,13620.0,4,4156,2,13610.0,11,13620.0,6,B
2018-04-10 09:13:25,13610.0,4,4160,-4,13605.0,2,13610.0,5,S
2018-04-10 09:13:34,13610.0,2,4162,0,13605.0,4,13615.0,8,S
2018-04-10 09:13:35,13605.0,2,4164,2,13605.0,3,13610.0,1,S
2018-04-10 09:13:35,13605.0,2,4166,-2,13605.0,3,13615.0,9,S
2018-04-10 09:13:36,13615.0,2,4168,0,13605.0,4,13615.0,8,B
2018-04-10 09:13:38,13610.0,2,4170,2,13610.0,15,13615.0,6,S
2018-04-10 09:13:39,13610.0,2,4172,0,13610.0,14,13615.0,6,S
2018-04-10 09:13:43,13610.0,4,4176,2,13610.0,12,13615.0,6,S
2018-04-10 09:13:46,13610.0,2,4178,0,13610.0,11,13615.0,7,S
2018-04-10 09:13:59,13615.0,8,4186,4,13610.0,14,13615.0,13,B
2018-04-10 09:13:59,13610.0,2,4188,2,13610.0,14,13615.0,13,S
2018-04-10 09:14:01,13615.0,10,4198,6,13610.0,14,13615.0,8,B
2018-04-10 09:14:02,13615.0,16,4214,0,13615.0,5,13620.0,9,B
2018-04-10 09:14:07,13620.0,2,4216,2,13615.0,3,13620.0,8,B
2018-04-10 09:14:15,13620.0,2,4218,2,13615.0,4,13620.0,8,B
2018-04-10 09:14:17,13615.0,2,4220,0,13615.0,3,13620.0,8,S
2018-04-10 09:14:18,13615.0,6,4226,6,13615.0,3,13620.0,8,S
2018-04-10 09:14:18,13615.0,6,4232,6,13615.0,1,13620.0,8,S
2018-04-10 09:14:19,13615.0,2,4234,2,13610.0,24,13615.0,5,S
2018-04-10 09:14:21,13615.0,2,4236,-2,13610.0,21,13615.0,14,S
2018-04-10 09:14:27,13610.0,42,4278,18,13605.0,1,13615.0,10,S
2018-04-10 09:14:37,13610.0,2,4280,-2,13605.0,3,13610.0,6,S
2018-04-10 09:14:42,13610.0,4,4284,2,13605.0,2,13610.0,15,S
2018-04-10 09:14:43,13605.0,2,4286,2,13600.0,9,13610.0,15,S
2018-04-10 09:14:44,13600.0,2,4288,-2,13600.0,8,13605.0,5,S
2018-04-10 09:14:45,13600.0,10,4298,10,13595.0,10,13605.0,5,S
2018-04-10 09:14:47,13600.0,4,4302,0,13595.0,12,13605.0,14,S
2018-04-10 09:14:48,13595.0,2,4304,2,13595.0,22,13605.0,14,S
2018-04-10 09:14:51,13605.0,8,4312,-4,13600.0,6,13605.0,6,B
2018-04-10 09:14:56,13605.0,4,4316,0,13605.0,2,13610.0,13,B
2018-04-10 09:15:03,13605.0,2,4318,0,13600.0,3,13605.0,2,B
2018-04-10 09:15:09,13605.0,2,4320,2,13600.0,6,13605.0,1,B
2018-04-10 09:15:09,13605.0,4,4324,2,13605.0,9,13610.0,14,B
2018-04-10 09:15:12,13605.0,4,4328,0,13600.0,8,13610.0,12,B
2018-04-10 09:15:13,13600.0,2,4330,2,13595.0,22,13605.0,54,S
2018-04-10 09:15:17,13605.0,2,4332,2,13600.0,3,13605.0,51,B
2018-04-10 09:15:26,13600.0,6,4338,2,13600.0,2,13605.0,53,S
2018-04-10 09:15:27,13600.0,2,4340,2,13595.0,15,13600.0,7,S
2018-04-10 09:15:27,13600.0,2,4342,0,13595.0,15,13600.0,6,S
2018-04-10 09:15:28,13600.0,4,4346,0,13595.0,15,13600.0,4,S
2018-04-10 09:15:28,13595.0,6,4352,-6,13595.0,13,13600.0,4,S
2018-04-10 09:15:29,13600.0,4,4356,2,13595.0,14,13600.0,2,B
2018-04-10 09:15:30,13600.0,4,4360,4,13600.0,6,13605.0,55,B
2018-04-10 09:15:32,13600.0,2,4362,-2,13595.0,7,13605.0,55,B
2018-04-10 09:15:36,13600.0,4,4366,2,13600.0,6,13605.0,5,B
2018-04-10 09:15:37,13600.0,2,4368,2,13600.0,5,13605.0,5,B
2018-04-10 09:15:42,13600.0,10,4378,-2,13595.0,48,13600.0,50,B
2018-04-10 09:15:43,13600.0,8,4386,4,13595.0,48,13600.0,46,B
2018-04-10 09:15:47,13595.0,2,4388,-2,13595.0,21,13600.0,46,S
2018-04-10 09:15:51,13600.0,4,4392,4,13595.0,3,13600.0,44,B
2018-04-10 09:15:52,13600.0,8,4400,8,13595.0,3,13600.0,40,B
2018-04-10 09:15:52,13600.0,2,4402,2,13595.0,3,13600.0,39,B
2018-04-10 09:16:01,13595.0,4,4406,0,13595.0,2,13600.0,49,S
2018-04-10 09:16:02,13600.0,2,4408,2,13595.0,2,13600.0,48,B
2018-04-10 09:16:03,13595.0,2,4410,2,13595.0,1,13600.0,49,S
2018-04-10 09:16:04,13595.0,2,4412,-2,13590.0,33,13600.0,49,S
2018-04-10 09:16:07,13595.0,4,4416,0,13590.0,32,13600.0,49,S
2018-04-10 09:16:11,13595.0,2,4418,-2,13590.0,19,13595.0,3,S
2018-04-10 09:16:20,13595.0,2,4420,0,13590.0,22,13595.0,3,S
2018-04-10 09:16:37,13595.0,2,4422,2,13590.0,5,13595.0,5,S
2018-04-10 09:16:38,13590.0,2,4424,-2,13590.0,4,13595.0,6,S
2018-04-10 09:16:41,13590.0,12,4436,-2,13585.0,18,13590.0,34,S
2018-04-10 09:16:43,13585.0,10,4446,-10,13585.0,12,13590.0,34,S
2018-04-10 09:16:44,13585.0,4,4450,2,13580.0,5,13590.0,34,S
2018-04-10 09:16:46,13585.0,4,4454,0,13580.0,6,13590.0,34,S
2018-04-10 09:16:47,13585.0,2,4456,0,13580.0,5,13590.0,35,S
2018-04-10 09:16:49,13585.0,2,4458,2,13580.0,11,13590.0,35,S
2018-04-10 09:16:53,13580.0,2,4460,0,13580.0,9,13585.0,3,S
2018-04-10 09:16:58,13585.0,2,4462,0,13580.0,10,13590.0,2,B
2018-04-10 09:16:59,13590.0,2,4464,0,13580.0,10,13590.0,2,B
2018-04-10 09:17:08,13585.0,2,4466,2,13580.0,9,13585.0,33,S
2018-04-10 09:17:12,13585.0,68,4534,2,13585.0,7,13590.0,2,S
2018-04-10 09:17:14,13590.0,2,4536,2,13585.0,2,13595.0,5,B
2018-04-10 09:17:19,13585.0,6,4542,-4,13585.0,6,13590.0,1,S
2018-04-10 09:17:20,13595.0,4,4546,0,13585.0,4,13595.0,9,B
2018-04-10 09:17:27,13595.0,2,4548,0,13585.0,4,13595.0,8,B
2018-04-10 09:17:29,13595.0,6,4554,0,13585.0,5,13595.0,5,B
2018-04-10 09:17:31,13595.0,2,4556,-2,13585.0,4,13590.0,1,B
2018-04-10 09:17:41,13590.0,2,4558,2,13585.0,6,13595.0,7,S
2018-04-10 09:18:00,13595.0,2,4560,0,13585.0,10,13595.0,12,B
2018-04-10 09:18:09,13585.0,2,4562,2,13585.0,11,13595.0,13,S
2018-04-10 09:18:25,13585.0,6,4568,-2,13585.0,7,13595.0,13,S
2018-04-10 09:18:30,13595.0,2,4570,-2,13585.0,8,13595.0,12,B
2018-04-10 09:18:34,13590.0,2,4572,0,13585.0,7,13595.0,13,S
2018-04-10 09:18:37,13590.0,2,4574,0,13585.0,6,13595.0,13,S
2018-04-10 09:19:00,13590.0,2,4576,0,13585.0,16,13590.0,6,S
2018-04-10 09:19:06,13590.0,4,4580,2,13585.0,18,13590.0,2,S
2018-04-10 09:19:07,13590.0,2,4582,-2,13585.0,18,13590.0,1,S
2018-04-10 09:19:07,13590.0,2,4584,0,13585.0,18,13595.0,14,S
2018-04-10 09:19:21,13595.0,8,4592,0,13590.0,5,13595.0,7,B
2018-04-10 09:19:35,13595.0,2,4594,-2,13590.0,5,13595.0,7,B
2018-04-10 09:19:37,13595.0,14,4608,4,13595.0,4,13600.0,5,B
2018-04-10 09:19:38,13600.0,2,4610,2,13595.0,2,13600.0,2,B
2018-04-10 09:19:39,13600.0,4,4614,2,13600.0,3,13605.0,6,B
2018-04-10 09:19:45,13600.0,2,4616,2,13600.0,2,13605.0,5,B
2018-04-10 09:19:46,13600.0,2,4618,0,13600.0,5,13605.0,5,B
2018-04-10 09:19:48,13605.0,10,4628,8,13605.0,11,13610.0,4,B
2018-04-10 09:19:49,13610.0,2,4630,-2,13605.0,1,13610.0,7,B
2018-04-10 09:19:54,13615.0,4,4634,-2,13610.0,7,13615.0,2,B
2018-04-10 09:19:54,13615.0,4,4638,0,13610.0,7,13615.0,3,B
2018-04-10 09:19:55,13610.0,8,4646,4,13605.0,4,13615.0,15,S
2018-04-10 09:19:56,13615.0,2,4648,0,13610.0,7,13615.0,9,B
2018-04-10 09:19:57,13610.0,2,4650,2,13610.0,5,13615.0,9,S
2018-04-10 09:20:02,13615.0,18,4668,-4,13615.0,9,13620.0,19,B
2018-04-10 09:20:02,13615.0,18,4686,10,13615.0,12,13620.0,10,B
2018-04-10 09:20:03,13620.0,4,4690,0,13615.0,9,13620.0,8,B
2018-04-10 09:20:04,13615.0,8,4698,-2,13615.0,1,13620.0,8,S
2018-04-10 09:20:05,13620.0,2,4700,2,13615.0,2,13620.0,7,B
2018-04-10 09:20:06,13620.0,8,4708,2,13615.0,4,13620.0,3,B
2018-04-10 09:20:07,13620.0,6,4714,-2,13615.0,20,13625.0,4,B
2018-04-10 09:20:13,13625.0,4,4718,0,13625.0,4,13630.0,27,B
2018-04-10 09:20:14,13620.0,10,4728,-8,13615.0,18,13620.0,2,S
2018-04-10 09:20:14,13615.0,4,4732,4,13615.0,15,13625.0,18,S
2018-04-10 09:20:20,13610.0,12,4744,-4,13610.0,16,13625.0,14,S
2018-04-10 09:20:33,13620.0,2,4746,0,13615.0,2,13620.0,2,B
2018-04-10 09:20:36,13620.0,12,4758,0,13620.0,2,13625.0,16,B
2018-04-10 09:20:37,13630.0,86,4844,-10,13620.0,2,13635.0,11,B
2018-04-10 09:20:37,13630.0,4,4848,0,13630.0,1,13635.0,7,B
2018-04-10 09:20:38,13625.0,18,4866,2,13615.0,6,13625.0,7,S
2018-04-10 09:20:44,13625.0,2,4868,0,13615.0,1,13625.0,8,S
2018-04-10 09:20:47,13625.0,2,4870,0,13615.0,1,13625.0,17,S
2018-04-10 09:20:49,13625.0,12,4882,0,13615.0,1,13625.0,11,S
2018-04-10 09:20:49,13625.0,10,4892,0,13615.0,1,13625.0,7,S
2018-04-10 09:20:52,13615.0,2,4894,2,13615.0,1,13625.0,7,S
2018-04-10 09:20:53,13625.0,10,4904,10,13615.0,1,13620.0,1,B
2018-04-10 09:20:56,13620.0,2,4906,0,13620.0,2,13625.0,2,S
2018-04-10 09:20:57,13620.0,2,4908,0,13620.0,1,13625.0,7,S
2018-04-10 09:21:04,13620.0,2,4910,0,13615.0,4,13620.0,1,S
2018-04-10 09:21:09,13620.0,4,4914,0,13620.0,1,13625.0,10,S
2018-04-10 09:21:10,13620.0,2,4916,0,13615.0,2,13620.0,14,S
2018-04-10 09:21:13,13620.0,2,4918,0,13620.0,2,13625.0,9,S
2018-04-10 09:21:17,13620.0,8,4926,6,13615.0,4,13620.0,1,S
2018-04-10 09:21:17,13625.0,6,4932,0,13620.0,3,13630.0,5,B
2018-04-10 09:21:18,13625.0,2,4934,-2,13620.0,3,13635.0,11,B
2018-04-10 09:21:26,13625.0,2,4936,2,13620.0,3,13630.0,7,B
2018-04-10 09:21:27,13620.0,2,4938,0,13620.0,1,13625.0,22,S
2018-04-10 09:21:28,13620.0,2,4940,2,13615.0,9,13625.0,22,S
2018-04-10 09:21:33,13620.0,2,4942,2,13615.0,9,13625.0,23,S
2018-04-10 09:21:36,13620.0,8,4950,6,13615.0,8,13620.0,2,S
2018-04-10 09:21:41,13620.0,4,4954,-2,13615.0,8,13625.0,11,S
2018-04-10 09:21:41,13625.0,4,4958,0,13615.0,8,13625.0,8,B
2018-04-10 09:21:42,13615.0,2,4960,0,13620.0,1,13625.0,8,S
2018-04-10 09:21:43,13620.0,2,4962,0,13615.0,7,13625.0,8,B
2018-04-10 09:21:45,13630.0,12,4974,-12,13620.0,1,13630.0,7,B
2018-04-10 09:21:47,13625.0,2,4976,0,13620.0,5,13625.0,12,S
2018-04-10 09:21:48,13620.0,10,4986,4,13615.0,9,13620.0,5,S
2018-04-10 09:21:49,13620.0,10,4996,4,13620.0,12,13630.0,7,S
2018-04-10 09:21:50,13620.0,2,4998,0,13620.0,10,13630.0,7,S
2018-04-10 09:21:58,13630.0,2,5000,-2,13630.0,3,13635.0,14,B
2018-04-10 09:22:00,13630.0,4,5004,-4,13630.0,1,13635.0,10,B
2018-04-10 09:22:02,13630.0,2,5006,2,13630.0,4,13635.0,10,B
2018-04-10 09:22:05,13630.0,4,5010,0,13625.0,4,13630.0,3,B
2018-04-10 09:22:06,13625.0,4,5014,-2,13620.0,2,13630.0,16,S
2018-04-10 09:22:18,13625.0,2,5016,0,13620.0,1,13625.0,14,S
2018-04-10 09:22:21,13620.0,2,5018,0,13615.0,11,13625.0,13,S
2018-04-10 09:22:22,13615.0,16,5034,14,13610.0,7,13620.0,11,S
2018-04-10 09:22:23,13610.0,2,5036,0,13605.0,4,13615.0,11,S
2018-04-10 09:22:25,13610.0,2,5038,2,13605.0,22,13615.0,7,S
2018-04-10 09:22:26,13605.0,6,5044,0,13605.0,2,13615.0,7,S
2018-04-10 09:22:27,13600.0,2,5046,-2,13600.0,35,13610.0,5,S
2018-04-10 09:22:28,13610.0,2,5048,-2,13600.0,41,13610.0,5,B
2018-04-10 09:22:28,13610.0,10,5058,0,13610.0,5,13615.0,3,B
2018-04-10 09:22:29,13610.0,10,5068,4,13605.0,1,13610.0,1,B
2018-04-10 09:22:31,13610.0,4,5072,-4,13605.0,2,13615.0,3,B
2018-04-10 09:22:38,13610.0,4,5076,0,13610.0,3,13615.0,11,B
2018-04-10 09:22:38,13610.0,6,5082,0,13610.0,1,13615.0,10,B
2018-04-10 09:22:39,13610.0,2,5084,0,13605.0,3,13615.0,10,B
2018-04-10 09:22:44,13605.0,6,5090,-2,13605.0,13,13615.0,2,S
2018-04-10 09:22:44,13605.0,4,5094,-4,13600.0,50,13605.0,1,S
2018-04-10 09:22:45,13605.0,2,5096,0,13605.0,35,13615.0,2,S
2018-04-10 09:22:45,13605.0,2,5098,-2,13605.0,26,13615.0,2,S
2018-04-10 09:22:54,13610.0,12,5110,0,13600.0,31,13610.0,1,B
2018-04-10 09:22:57,13605.0,4,5114,0,13600.0,26,13610.0,8,S
2018-04-10 09:23:03,13600.0,2,5116,2,13600.0,26,13605.0,1,S
2018-04-10 09:23:07,13600.0,4,5120,0,13600.0,11,13605.0,1,S
2018-04-10 09:23:08,13605.0,2,5122,-2,13600.0,16,13610.0,3,B
2018-04-10 09:23:24,13605.0,6,5128,-4,13600.0,12,13610.0,6,B
2018-04-10 09:23:26,13605.0,2,5130,0,13605.0,22,13615.0,4,B
2018-04-10 09:23:30,13610.0,2,5132,0,13610.0,6,13615.0,1,B
2018-04-10 09:23:51,13610.0,2,5134,-2,13605.0,14,13615.0,6,B
2018-04-10 09:24:00,13615.0,6,5140,0,13615.0,2,13620.0,10,B
2018-04-10 09:24:03,13620.0,14,5154,-8,13620.0,3,13625.0,6,B
2018-04-10 09:24:03,13620.0,6,5160,-2,13615.0,2,13620.0,3,B
2018-04-10 09:24:12,13620.0,2,5162,0,13620.0,3,13625.0,5,B
2018-04-10 09:24:13,13620.0,10,5172,0,13620.0,8,13625.0,8,B
2018-04-10 09:24:16,13620.0,2,5174,0,13615.0,3,13620.0,10,B
2018-04-10 09:24:19,13615.0,2,5176,2,13615.0,1,13620.0,11,S
2018-04-10 09:24:19,13615.0,2,5178,0,13610.0,2,13620.0,11,S
2018-04-10 09:24:24,13615.0,2,5180,-2,13610.0,3,13615.0,1,S
2018-04-10 09:24:28,13615.0,16,5196,8,13615.0,12,13620.0,13,S
2018-04-10 09:24:28,13615.0,24,5220,16,13610.0,1,13615.0,5,S
2018-04-10 09:24:42,13610.0,2,5222,2,13610.0,6,13615.0,2,S
2018-04-10 09:24:57,13610.0,6,5228,6,13610.0,2,13615.0,3,S
2018-04-10 09:24:57,13610.0,2,5230,0,13610.0,1,13615.0,3,S
2018-04-10 09:25:12,13615.0,4,5234,-4,13615.0,2,13620.0,11,B
2018-04-10 09:25:15,13620.0,4,5238,0,13615.0,15,13620.0,8,B
2018-04-10 09:25:16,13620.0,4,5242,4,13615.0,15,13620.0,6,B
2018-04-10 09:25:25,13615.0,2,5244,2,13615.0,9,13620.0,6,S
2018-04-10 09:25:44,13615.0,2,5246,-2,13615.0,4,13620.0,9,S
2018-04-10 09:26:49,13620.0,18,5264,2,13620.0,1,13625.0,6,B
2018-04-10 09:27:01,13620.0,2,5266,2,13620.0,28,13625.0,5,B
2018-04-10 09:27:02,13625.0,10,5276,4,13625.0,2,13630.0,4,B
2018-04-10 09:27:03,13630.0,2,5278,2,13630.0,1,13635.0,9,B
2018-04-10 09:27:04,13635.0,6,5284,0,13630.0,5,13635.0,6,B
2018-04-10 09:27:04,13635.0,4,5288,0,13630.0,5,13635.0,4,B
2018-04-10 09:27:05,13635.0,8,5296,-2,13635.0,1,13640.0,3,B
2018-04-10 09:27:06,13635.0,2,5298,-2,13630.0,5,13640.0,4,B
2018-04-10 09:27:07,13635.0,2,5300,0,13635.0,14,13640.0,4,B
2018-04-10 09:27:07,13635.0,12,5312,4,13635.0,5,13640.0,9,B
2018-04-10 09:27:08,13635.0,2,5314,2,13630.0,2,13640.0,9,B
2018-04-10 09:27:10,13635.0,2,5316,-2,13630.0,4,13640.0,8,B
2018-04-10 09:27:11,13640.0,6,5322,-6,13640.0,7,13645.0,5,B
2018-04-10 09:27:13,13640.0,8,5330,0,13640.0,4,13645.0,7,B
2018-04-10 09:27:16,13640.0,4,5334,-4,13640.0,2,13645.0,7,B
2018-04-10 09:27:18,13640.0,2,5336,-2,13640.0,1,13645.0,7,B
2018-04-10 09:27:19,13645.0,2,5338,0,13640.0,1,13645.0,6,B
2018-04-10 09:27:20,13640.0,2,5340,2,13640.0,1,13645.0,6,S
2018-04-10 09:27:23,13640.0,4,5344,-2,13635.0,4,13645.0,6,S
2018-04-10 09:27:29,13640.0,2,5346,0,13640.0,6,13645.0,3,S
2018-04-10 09:27:42,13635.0,2,5348,0,13635.0,6,13640.0,12,S
2018-04-10 09:27:46,13635.0,2,5350,2,13635.0,5,13640.0,13,S
2018-04-10 09:27:55,13635.0,2,5352,2,13635.0,5,13640.0,14,S
2018-04-10 09:27:56,13635.0,10,5362,4,13630.0,3,13635.0,2,S
2018-04-10 09:28:01,13635.0,4,5366,4,13635.0,9,13640.0,1,S
2018-04-10 09:28:03,13640.0,2,5368,-2,13640.0,6,13645.0,6,B
2018-04-10 09:28:06,13645.0,8,5376,8,13645.0,1,13650.0,20,B
2018-04-10 09:28:07,13650.0,6,5382,2,13645.0,15,13650.0,14,B
2018-04-10 09:28:07,13650.0,8,5390,8,13645.0,8,13650.0,10,B
2018-04-10 09:28:10,13650.0,4,5394,4,13645.0,8,13650.0,8,B
2018-04-10 09:28:11,13650.0,2,5396,0,13645.0,8,13650.0,7,B
2018-04-10 09:28:11,13645.0,2,5398,0,13645.0,7,13650.0,7,S
2018-04-10 09:28:22,13640.0,2,5400,2,13635.0,2,13645.0,3,S
2018-04-10 09:28:29,13635.0,4,5404,0,13630.0,2,13635.0,1,S
2018-04-10 09:28:30,13635.0,2,5406,-2,13630.0,6,13635.0,1,S
2018-04-10 09:28:37,13640.0,2,5408,0,13630.0,8,13635.0,1,B
2018-04-10 09:28:37,13640.0,4,5412,0,13640.0,3,13645.0,7,B
2018-04-10 09:28:38,13635.0,8,5420,-2,13635.0,1,13640.0,2,S
2018-04-10 09:28:40,13635.0,2,5422,2,13635.0,9,13640.0,2,S
2018-04-10 09:28:43,13640.0,2,5424,2,13640.0,4,13645.0,6,B
2018-04-10 09:28:49,13640.0,8,5432,4,13635.0,2,13645.0,7,B
2018-04-10 09:28:52,13640.0,4,5436,2,13635.0,9,13645.0,5,B
2018-04-10 09:28:54,13645.0,2,5438,0,13640.0,21,13645.0,3,B
2018-04-10 09:28:55,13640.0,6,5444,-4,13640.0,20,13645.0,1,S
2018-04-10 09:28:59,13645.0,2,5446,0,13640.0,20,13650.0,12,B
2018-04-10 09:29:01,13650.0,8,5454,2,13645.0,14,13650.0,5,B
2018-04-10 09:29:01,13650.0,2,5456,0,13645.0,13,13650.0,4,B
2018-04-10 09:29:03,13650.0,8,5464,0,13645.0,13,13655.0,4,B
2018-04-10 09:29:06,13645.0,4,5468,2,13645.0,2,13650.0,9,S
2018-04-10 09:29:07,13650.0,2,5470,-2,13645.0,5,13655.0,10,B
2018-04-10 09:29:22,13650.0,2,5472,0,13640.0,4,13645.0,13,B
2018-04-10 09:29:23,13640.0,8,5480,0,13635.0,4,13645.0,10,S
2018-04-10 09:29:43,13630.0,16,5496,8,13625.0,18,13640.0,16,S
2018-04-10 09:29:52,13635.0,4,5500,0,13635.0,2,13640.0,3,B
2018-04-10 09:29:57,13640.0,4,5504,-2,13635.0,6,13645.0,6,B
2018-04-10 09:29:59,13640.0,4,5508,2,13635.0,3,13645.0,4,B
2018-04-10 09:30:00,13640.0,4,5512,0,13635.0,3,13640.0,3,B
2018-04-10 09:30:08,13635.0,2,5514,0,13635.0,1,13640.0,3,S
2018-04-10 09:30:13,13640.0,4,5518,0,13640.0,7,13645.0,3,B
2018-04-10 09:30:14,13640.0,2,5520,0,13640.0,3,13645.0,3,B
2018-04-10 09:30:17,13645.0,8,5528,-2,13640.0,6,13650.0,12,B
2018-04-10 09:30:21,13645.0,6,5534,2,13640.0,14,13650.0,9,B
2018-04-10 09:30:26,13640.0,2,5536,0,13640.0,13,13650.0,11,S
2018-04-10 09:30:31,13645.0,2,5538,2,13645.0,9,13650.0,12,B
2018-04-10 09:30:34,13645.0,4,5542,0,13645.0,7,13650.0,12,B
2018-04-10 09:30:36,13645.0,2,5544,2,13645.0,6,13650.0,14,B
2018-04-10 09:30:43,13645.0,10,5554,8,13645.0,1,13650.0,14,B
2018-04-10 09:30:44,13645.0,2,5556,0,13640.0,3,13645.0,1,B
2018-04-10 09:30:48,13635.0,8,5564,-2,13635.0,5,13645.0,7,S
2018-04-10 09:30:48,13635.0,2,5566,0,13635.0,4,13640.0,7,S
2018-04-10 09:30:56,13635.0,2,5568,0,13635.0,6,13640.0,9,S
2018-04-10 09:31:00,13640.0,2,5570,0,13635.0,6,13640.0,8,B
2018-04-10 09:31:02,13635.0,2,5572,0,13635.0,5,13640.0,12,S
2018-04-10 09:31:04,13635.0,8,5580,0,13635.0,1,13640.0,14,S
2018-04-10 09:31:04,13635.0,2,5582,2,13630.0,4,13635.0,1,S
2018-04-10 09:31:05,13630.0,2,5584,0,13625.0,7,13635.0,4,S
2018-04-10 09:31:06,13625.0,4,5588,2,13625.0,6,13635.0,5,S
2018-04-10 09:31:07,13625.0,6,5594,0,13625.0,3,13630.0,3,S
2018-04-10 09:31:07,13630.0,2,5596,-2,13620.0,3,13630.0,6,B
2018-04-10 09:31:08,13630.0,2,5598,-2,13620.0,5,13630.0,5,B
2018-04-10 09:31:08,13620.0,2,5600,0,13620.0,4,13630.0,7,S
2018-04-10 09:31:10,13620.0,2,5602,-2,13620.0,16,13630.0,4,S
2018-04-10 09:31:16,13630.0,6,5608,-2,13625.0,8,13635.0,6,B
2018-04-10 09:31:19,13635.0,2,5610,-2,13635.0,8,13640.0,4,B
2018-04-10 09:31:19,13635.0,6,5616,0,13625.0,6,13635.0,22,B
2018-04-10 09:31:20,13630.0,2,5618,2,13625.0,7,13630.0,2,S
2018-04-10 09:31:20,13630.0,6,5624,4,13630.0,7,13640.0,9,S
2018-04-10 09:31:25,13630.0,4,5628,2,13630.0,6,13640.0,5,S
2018-04-10 09:31:33,13630.0,2,5630,0,13630.0,4,13640.0,9,S
2018-04-10 09:31:54,13635.0,2,5632,0,13630.0,15,13635.0,1,B
2018-04-10 09:32:01,13640.0,4,5636,4,13635.0,1,13640.0,5,B
2018-04-10 09:32:01,13640.0,2,5638,2,13635.0,12,13640.0,1,B
2018-04-10 09:32:02,13635.0,2,5640,0,13635.0,11,13640.0,1,S
2018-04-10 09:32:06,13635.0,2,5642,2,13630.0,2,13640.0,9,S
2018-04-10 09:32:58,13640.0,2,5644,0,13630.0,11,13640.0,11,B
2018-04-10 09:33:09,13645.0,4,5648,2,13645.0,1,13650.0,21,B
2018-04-10 09:33:10,13645.0,6,5654,6,13635.0,1,13645.0,5,B
2018-04-10 09:33:24,13640.0,2,5656,2,13640.0,5,13645.0,6,S
2018-04-10 09:33:26,13645.0,2,5658,0,13640.0,5,13645.0,5,B
2018-04-10 09:33:40,13645.0,2,5660,-2,13640.0,5,13645.0,4,B
2018-04-10 09:33:51,13645.0,6,5666,-6,13645.0,9,13650.0,24,B
2018-04-10 09:33:56,13645.0,2,5668,0,13640.0,7,13650.0,23,B
2018-04-10 09:33:57,13650.0,20,5688,18,13640.0,6,13650.0,13,B
2018-04-10 09:33:57,13650.0,4,5692,2,13640.0,6,13650.0,11,B
2018-04-10 09:34:00,13650.0,2,5694,2,13645.0,11,13650.0,13,B
2018-04-10 09:34:04,13645.0,2,5696,2,13645.0,17,13650.0,11,S
2018-04-10 09:34:05,13650.0,4,5700,4,13645.0,17,13650.0,9,B
2018-04-10 09:34:06,13650.0,18,5718,-8,13650.0,1,13655.0,12,B
2018-04-10 09:34:07,13650.0,2,5720,0,13650.0,1,13655.0,9,B
2018-04-10 09:34:18,13650.0,2,5722,0,13650.0,1,13655.0,14,B
2018-04-10 09:34:20,13650.0,4,5726,0,13645.0,20,13655.0,8,B
2018-04-10 09:34:23,13655.0,4,5730,-2,13650.0,9,13655.0,6,B
2018-04-10 09:34:24,13655.0,2,5732,-2,13650.0,9,13655.0,5,B
2018-04-10 09:34:26,13655.0,10,5742,6,13650.0,9,13660.0,7,B
2018-04-10 09:34:27,13650.0,2,5744,2,13650.0,8,13660.0,5,S
2018-04-10 09:34:29,13660.0,4,5748,4,13655.0,14,13660.0,3,B
2018-04-10 09:34:33,13660.0,6,5754,6,13660.0,7,13665.0,18,B
2018-04-10 09:34:43,13655.0,2,5756,2,13655.0,4,13660.0,1,S
2018-04-10 09:34:44,13660.0,2,5758,2,13655.0,4,13660.0,5,B
2018-04-10 09:34:44,13660.0,10,5768,10,13660.0,9,13665.0,17,B
2018-04-10 09:34:45,13660.0,10,5778,6,13660.0,3,13665.0,17,B
2018-04-10 09:34:47,13660.0,2,5780,2,13660.0,2,13665.0,17,B
2018-04-10 09:34:48,13660.0,8,5788,-2,13655.0,4,13660.0,2,B
2018-04-10 09:34:50,13665.0,2,5790,2,13655.0,4,13665.0,17,B
2018-04-10 09:34:55,13655.0,2,5792,2,13655.0,3,13660.0,8,S
2018-04-10 09:34:59,13660.0,2,5794,2,13660.0,3,13665.0,20,B
2018-04-10 09:35:01,13665.0,36,5830,2,13665.0,1,13670.0,4,B
2018-04-10 09:35:01,13670.0,4,5834,4,13670.0,17,13675.0,2,B
2018-04-10 09:35:02,13680.0,24,5858,10,13670.0,20,13685.0,16,B
2018-04-10 09:35:03,13685.0,12,5870,0,13675.0,12,13685.0,15,B
2018-04-10 09:35:10,13680.0,12,5882,6,13680.0,1,13685.0,22,S
2018-04-10 09:35:10,13680.0,2,5884,2,13670.0,16,13675.0,2,S
2018-04-10 09:35:11,13675.0,2,5886,0,13670.0,4,13675.0,1,S
2018-04-10 09:35:18,13675.0,2,5888,2,13670.0,5,13680.0,9,S
2018-04-10 09:35:19,13680.0,2,5890,-2,13675.0,4,13680.0,3,B
2018-04-10 09:35:24,13680.0,2,5892,0,13675.0,5,13685.0,18,B
2018-04-10 09:35:26,13680.0,4,5896,4,13675.0,6,13685.0,16,B
2018-04-10 09:35:26,13685.0,6,5902,2,13675.0,6,13685.0,19,B
2018-04-10 09:35:28,13680.0,8,5910,-2,13675.0,4,13685.0,19,S
2018-04-10 09:35:29,13685.0,2,5912,0,13675.0,4,13685.0,18,B
2018-04-10 09:35:30,13680.0,2,5914,2,13675.0,5,13685.0,13,S
2018-04-10 09:35:34,13685.0,2,5916,2,13680.0,8,13685.0,11,B
2018-04-10 09:35:36,13680.0,2,5918,2,13680.0,7,13685.0,11,S
2018-04-10 09:35:38,13685.0,24,5942,20,13680.0,7,13685.0,1,B
2018-04-10 09:35:54,13685.0,4,5946,2,13685.0,3,13690.0,12,B
2018-04-10 09:35:55,13685.0,2,5948,0,13685.0,2,13690.0,12,B
2018-04-10 09:35:57,13685.0,2,5950,0,13685.0,1,13690.0,11,B
2018-04-10 09:35:58,13685.0,2,5952,0,13680.0,5,13685.0,3,B
2018-04-10 09:35:58,13680.0,2,5954,0,13680.0,2,13685.0,9,S
2018-04-10 09:36:01,13685.0,4,5958,2,13685.0,1,13690.0,8,B
2018-04-10 09:36:07,13685.0,2,5960,2,13685.0,36,13690.0,8,B
2018-04-10 09:36:08,13685.0,6,5966,2,13685.0,33,13690.0,12,B
2018-04-10 09:36:11,13685.0,10,5976,4,13685.0,34,13690.0,3,B
2018-04-10 09:36:11,13695.0,8,5984,0,13690.0,15,13695.0,7,B
2018-04-10 09:36:12,13695.0,12,5996,6,13690.0,16,13700.0,37,B
2018-04-10 09:36:14,13695.0,4,6000,0,13690.0,11,13695.0,5,B
2018-04-10 09:36:15,13700.0,2,6002,2,13695.0,1,13700.0,40,B
2018-04-10 09:36:16,13695.0,2,6004,2,13690.0,10,13700.0,41,S
2018-04-10 09:36:16,13700.0,6,6010,-2,13695.0,1,13700.0,35,B
2018-04-10 09:36:18,13695.0,2,6012,-2,13695.0,5,13700.0,36,S
2018-04-10 09:36:18,13695.0,10,6022,10,13690.0,10,13695.0,1,S
2018-04-10 09:36:21,13700.0,34,6056,4,13690.0,10,13700.0,20,B
2018-04-10 09:36:23,13695.0,2,6058,0,13690.0,10,13700.0,19,S
2018-04-10 09:36:25,13700.0,2,6060,2,13695.0,2,13700.0,18,B
2018-04-10 09:36:26,13700.0,6,6066,-4,13690.0,11,13700.0,16,B
2018-04-10 09:36:26,13700.0,2,6068,0,13690.0,11,13700.0,22,B
2018-04-10 09:36:29,13695.0,16,6084,4,13695.0,15,13700.0,8,S
2018-04-10 09:36:30,13700.0,2,6086,2,13695.0,15,13700.0,7,B
2018-04-10 09:36:30,13695.0,2,6088,0,13695.0,10,13700.0,7,S
2018-04-10 09:36:31,13695.0,24,6112,2,13690.0,8,13695.0,2,S
2018-04-10 09:36:31,13690.0,14,6126,0,13690.0,1,13695.0,3,S
2018-04-10 09:36:32,13695.0,2,6128,2,13690.0,2,13700.0,17,B
2018-04-10 09:36:35,13690.0,4,6132,0,13690.0,7,13700.0,8,S
2018-04-10 09:36:36,13700.0,4,6136,0,13690.0,7,13700.0,6,B
2018-04-10 09:36:36,13695.0,2,6138,2,13690.0,7,13695.0,1,S
2018-04-10 09:36:40,13695.0,2,6140,0,13690.0,6,13695.0,1,S
2018-04-10 09:36:41,13695.0,2,6142,2,13695.0,4,13700.0,10,S
2018-04-10 09:36:46,13695.0,2,6144,0,13695.0,4,13700.0,10,S
2018-04-10 09:36:47,13695.0,8,6152,6,13690.0,7,13700.0,10,S
2018-04-10 09:36:48,13690.0,2,6154,0,13690.0,2,13695.0,6,S
2018-04-10 09:36:49,13690.0,4,6158,0,13685.0,4,13695.0,7,S
2018-04-10 09:36:50,13695.0,18,6176,6,13695.0,6,13700.0,14,B
2018-04-10 09:36:50,13695.0,12,6188,10,13690.0,1,13695.0,2,B
2018-04-10 09:36:52,13690.0,2,6190,0,13685.0,7,13695.0,3,S
2018-04-10 09:36:57,13690.0,4,6194,0,13685.0,9,13690.0,5,S
2018-04-10 09:36:58,13690.0,2,6196,0,13685.0,9,13695.0,6,S
2018-04-10 09:37:04,13690.0,2,6198,0,13685.0,8,13695.0,7,S
2018-04-10 09:37:08,13695.0,2,6200,-2,13690.0,5,13695.0,5,B
2018-04-10 09:37:09,13690.0,2,6202,2,13690.0,4,13695.0,4,S
2018-04-10 09:37:15,13695.0,2,6204,0,13690.0,4,13695.0,3,B
2018-04-10 09:37:18,13695.0,8,6212,0,13695.0,3,13700.0,12,B
2018-04-10 09:37:18,13695.0,2,6214,0,13695.0,2,13700.0,12,B
2018-04-10 09:37:22,13695.0,6,6220,4,13690.0,5,13700.0,10,B
2018-04-10 09:37:22,13695.0,4,6224,4,13690.0,5,13700.0,10,B
2018-04-10 09:37:24,13695.0,2,6226,2,13690.0,5,13695.0,2,B
2018-04-10 09:37:26,13695.0,2,6228,0,13690.0,4,13695.0,7,B
2018-04-10 09:37:28,13695.0,10,6238,4,13690.0,4,13695.0,2,B
2018-04-10 09:37:35,13695.0,4,6242,0,13690.0,4,13695.0,3,B
2018-04-10 09:37:36,13690.0,2,6244,0,13690.0,3,13695.0,8,S
2018-04-10 09:37:37,13690.0,2,6246,2,13690.0,2,13695.0,8,S
2018-04-10 09:37:40,13695.0,2,6248,0,13690.0,2,13695.0,6,B
2018-04-10 09:37:41,13690.0,2,6250,0,13690.0,1,13695.0,6,S
2018-04-10 09:37:46,13695.0,2,6252,0,13690.0,3,13695.0,5,B
2018-04-10 09:37:47,13695.0,2,6254,0,13690.0,3,13695.0,3,B
2018-04-10 09:37:49,13695.0,2,6256,-2,13690.0,3,13695.0,3,B
2018-04-10 09:37:50,13695.0,6,6262,2,13685.0,8,13695.0,1,B
2018-04-10 09:37:52,13695.0,4,6266,2,13690.0,1,13695.0,2,B
2018-04-10 09:37:53,13690.0,2,6268,0,13685.0,10,13695.0,2,S
2018-04-10 09:37:54,13690.0,2,6270,0,13685.0,9,13695.0,2,S
2018-04-10 09:37:55,13690.0,4,6274,0,13685.0,9,13695.0,2,S
2018-04-10 09:37:56,13685.0,18,6292,-12,13680.0,22,13685.0,6,S
2018-04-10 09:37:57,13685.0,12,6304,-6,13685.0,8,13690.0,1,S
2018-04-10 09:37:57,13685.0,2,6306,-2,13685.0,2,13695.0,5,S
2018-04-10 09:38:00,13690.0,2,6308,0,13685.0,3,13690.0,1,B
2018-04-10 09:38:02,13690.0,4,6312,2,13685.0,3,13695.0,5,B
2018-04-10 09:38:05,13690.0,2,6314,0,13685.0,3,13695.0,5,B
2018-04-10 09:38:17,13685.0,2,6316,-2,13680.0,8,13690.0,7,S
2018-04-10 09:38:17,13680.0,2,6318,0,13680.0,7,13690.0,7,S
2018-04-10 09:38:22,13680.0,2,6320,2,13680.0,3,13685.0,4,S
2018-04-10 09:38:22,13680.0,2,6322,-2,13680.0,2,13685.0,6,S
2018-04-10 09:38:23,13680.0,4,6326,0,13675.0,9,13685.0,6,S
2018-04-10 09:38:24,13675.0,10,6336,10,13675.0,4,13685.0,7,S
2018-04-10 09:38:25,13680.0,2,6338,-2,13675.0,4,13685.0,7,B
2018-04-10 09:38:26,13675.0,2,6340,0,13675.0,3,13685.0,8,S
2018-04-10 09:38:34,13675.0,2,6342,0,13670.0,4,13680.0,9,S
2018-04-10 09:38:36,13680.0,2,6344,0,13675.0,1,13680.0,8,B
2018-04-10 09:38:41,13680.0,2,6346,0,13670.0,21,13680.0,6,B
2018-04-10 09:38:47,13670.0,2,6348,2,13670.0,4,13680.0,16,S
2018-04-10 09:38:48,13670.0,2,6350,2,13670.0,2,13680.0,16,S
2018-04-10 09:38:48,13670.0,4,6354,-4,13665.0,3,13670.0,5,S
2018-04-10 09:38:50,13670.0,10,6364,0,13670.0,2,13675.0,3,S
2018-04-10 09:38:56,13675.0,2,6366,0,13670.0,4,13675.0,3,B
2018-04-10 09:39:00,13675.0,2,6368,-2,13670.0,2,13675.0,2,B
2018-04-10 09:39:05,13675.0,2,6370,2,13670.0,2,13675.0,1,B
2018-04-10 09:39:05,13675.0,2,6372,2,13670.0,2,13680.0,15,B
2018-04-10 09:39:20,13675.0,2,6374,-2,13670.0,8,13680.0,15,B
2018-04-10 09:39:22,13670.0,2,6376,0,13670.0,6,13680.0,15,S
2018-04-10 09:39:30,13675.0,2,6378,0,13670.0,7,13675.0,1,B
2018-04-10 09:39:37,13670.0,2,6380,2,13670.0,6,13675.0,1,S
2018-04-10 09:39:41,13670.0,4,6384,0,13670.0,4,13675.0,1,S
2018-04-10 09:39:43,13670.0,2,6386,2,13670.0,3,13675.0,1,S
2018-04-10 09:39:45,13675.0,2,6388,-2,13670.0,3,13680.0,16,B
2018-04-10 09:39:51,13670.0,6,6394,0,13665.0,6,13675.0,9,S
2018-04-10 09:39:52,13665.0,4,6398,0,13665.0,2,13670.0,10,S
2018-04-10 09:39:53,13665.0,2,6400,0,13665.0,1,13670.0,10,S
2018-04-10 09:39:53,13665.0,2,6402,2,13660.0,13,13670.0,9,S
2018-04-10 09:39:58,13660.0,18,6420,18,13660.0,1,13665.0,12,S
2018-04-10 09:39:59,13660.0,2,6422,-2,13655.0,4,13660.0,2,S
2018-04-10 09:40:11,13660.0,8,6430,4,13655.0,19,13660.0,1,S
2018-04-10 09:40:11,13660.0,2,6432,0,13655.0,10,13665.0,5,S
2018-04-10 09:40:14,13665.0,2,6434,0,13655.0,7,13665.0,9,B
2018-04-10 09:40:16,13655.0,4,6438,-4,13655.0,1,13660.0,1,S
2018-04-10 09:40:17,13655.0,2,6440,2,13650.0,4,13655.0,7,S
2018-04-10 09:40:18,13655.0,2,6442,0,13650.0,3,13655.0,2,S
2018-04-10 09:40:20,13650.0,4,6446,2,13645.0,3,13650.0,2,S
2018-04-10 09:40:20,13650.0,2,6448,0,13650.0,2,13655.0,8,S
2018-04-10 09:40:22,13650.0,2,6450,0,13645.0,4,13655.0,6,S
2018-04-10 09:40:35,13650.0,4,6454,0,13650.0,7,13655.0,1,S
2018-04-10 09:40:45,13650.0,14,6468,12,13645.0,4,13650.0,3,S
2018-04-10 09:40:45,13650.0,6,6474,0,13645.0,4,13655.0,2,S
2018-04-10 09:40:46,13655.0,4,6478,2,13650.0,3,13655.0,5,B
2018-04-10 09:40:47,13655.0,2,6480,0,13650.0,3,13655.0,4,B
2018-04-10 09:40:49,13650.0,2,6482,0,13650.0,2,13655.0,4,S
2018-04-10 09:41:02,13655.0,8,6490,-8,13650.0,5,13660.0,9,B
2018-04-10 09:41:09,13655.0,4,6494,0,13650.0,4,13660.0,11,B
2018-04-10 09:41:09,13650.0,2,6496,2,13650.0,3,13655.0,1,S
2018-04-10 09:41:10,13655.0,2,6498,0,13650.0,3,13660.0,11,B
2018-04-10 09:41:14,13650.0,2,6500,0,13650.0,2,13655.0,2,S
2018-04-10 09:41:19,13650.0,2,6502,2,13650.0,1,13655.0,2,S
2018-04-10 09:41:19,13650.0,2,6504,0,13650.0,1,13655.0,1,S
2018-04-10 09:41:28,13655.0,2,6506,0,13650.0,4,13660.0,9,B
2018-04-10 09:41:34,13650.0,8,6514,4,13645.0,5,13655.0,25,S
2018-04-10 09:41:41,13650.0,2,6516,2,13645.0,3,13650.0,1,S
2018-04-10 09:41:51,13645.0,2,6518,-2,13645.0,3,13650.0,2,S
2018-04-10 09:41:53,13650.0,2,6520,0,13645.0,3,13650.0,1,B
2018-04-10 09:42:02,13645.0,4,6524,-4,13645.0,1,13655.0,13,S
2018-04-10 09:42:06,13650.0,2,6526,0,13645.0,4,13655.0,6,B
2018-04-10 09:42:16,13650.0,2,6528,-2,13650.0,3,13655.0,6,B
2018-04-10 09:42:22,13655.0,2,6530,-2,13650.0,3,13655.0,5,B
2018-04-10 09:42:31,13655.0,4,6534,0,13650.0,4,13660.0,11,B
2018-04-10 09:42:40,13655.0,2,6536,-2,13655.0,3,13660.0,9,B
2018-04-10 09:42:48,13655.0,2,6538,-2,13655.0,2,13660.0,9,B
2018-04-10 09:42:52,13655.0,4,6542,2,13650.0,3,13655.0,2,B
2018-04-10 09:43:05,13655.0,2,6544,2,13650.0,2,13655.0,5,B
2018-04-10 09:43:06,13655.0,2,6546,2,13650.0,4,13660.0,10,B
2018-04-10 09:43:12,13655.0,2,6548,0,13650.0,4,13660.0,11,B
2018-04-10 09:43:27,13650.0,6,6554,2,13650.0,11,13655.0,1,S
2018-04-10 09:43:30,13655.0,2,6556,0,13650.0,11,13660.0,25,B
2018-04-10 09:43:32,13655.0,2,6558,-2,13655.0,1,13660.0,11,B
2018-04-10 09:43:34,13655.0,2,6560,-2,13650.0,12,13660.0,11,B
2018-04-10 09:43:59,13655.0,2,6562,-2,13650.0,12,13660.0,5,B
2018-04-10 09:44:00,13655.0,2,6564,0,13650.0,12,13660.0,5,B
2018-04-10 09:44:45,13650.0,6,6570,-2,13650.0,10,13655.0,13,S
2018-04-10 09:44:45,13650.0,12,6582,-8,13650.0,4,13655.0,25,S
2018-04-10 09:44:46,13650.0,2,6584,-2,13650.0,3,13655.0,25,S
2018-04-10 09:44:46,13650.0,6,6590,-2,13645.0,7,13655.0,25,S
2018-04-10 09:45:02,13645.0,2,6592,-2,13645.0,5,13650.0,9,S
2018-04-10 09:45:07,13645.0,10,6602,-8,13640.0,7,13650.0,6,S
2018-04-10 09:45:15,13645.0,2,6604,-2,13645.0,1,13650.0,7,S
2018-04-10 09:45:28,13650.0,2,6606,2,13645.0,1,13650.0,10,B
2018-04-10 09:45:29,13645.0,2,6608,0,13640.0,12,13650.0,10,S
2018-04-10 09:45:38,13640.0,2,6610,0,13640.0,11,13650.0,10,S
2018-04-10 09:45:39,13650.0,4,6614,0,13640.0,11,13650.0,8,B
2018-04-10 09:45:51,13645.0,2,6616,0,13640.0,11,13650.0,11,S
2018-04-10 09:46:10,13640.0,26,6642,6,13635.0,6,13640.0,1,S
2018-04-10 09:46:11,13635.0,6,6648,2,13630.0,12,13640.0,13,S
2018-04-10 09:46:13,13635.0,6,6654,0,13630.0,11,13640.0,10,S
2018-04-10 09:46:19,13635.0,2,6656,0,13630.0,11,13635.0,4,S
2018-04-10 09:46:23,13630.0,6,6662,-6,13630.0,8,13635.0,5,S
2018-04-10 09:46:23,13630.0,4,6666,-2,13630.0,6,13635.0,4,S
2018-04-10 09:46:25,13630.0,2,6668,-2,13630.0,5,13635.0,4,S
2018-04-10 09:46:30,13635.0,2,6670,-2,13630.0,5,13640.0,7,B
2018-04-10 09:46:41,13635.0,2,6672,0,13635.0,3,13640.0,7,B
2018-04-10 09:46:44,13635.0,2,6674,0,13630.0,9,13635.0,2,B
2018-04-10 09:46:46,13635.0,2,6676,0,13630.0,9,13635.0,2,B
2018-04-10 09:46:47,13635.0,2,6678,0,13630.0,9,13635.0,1,B
2018-04-10 09:46:47,13635.0,4,6682,0,13630.0,9,13635.0,2,B
2018-04-10 09:46:48,13635.0,4,6686,0,13630.0,9,13640.0,6,B
2018-04-10 09:46:53,13635.0,2,6688,-2,13635.0,1,13640.0,6,B
2018-04-10 09:47:04,13630.0,4,6692,0,13630.0,8,13635.0,8,S
2018-04-10 09:47:05,13630.0,2,6694,-2,13630.0,7,13635.0,14,S
2018-04-10 09:47:05,13630.0,14,6708,-2,13625.0,6,13635.0,28,S
2018-04-10 09:47:06,13625.0,2,6710,0,13625.0,1,13630.0,7,S
2018-04-10 09:47:25,13625.0,2,6712,-2,13625.0,10,13630.0,26,S
2018-04-10 09:47:40,13630.0,2,6714,0,13625.0,14,13630.0,13,B
2018-04-10 09:47:45,13630.0,20,6734,-10,13625.0,15,13635.0,5,B
2018-04-10 09:47:47,13630.0,2,6736,0,13630.0,2,13635.0,9,B
2018-04-10 09:47:58,13635.0,2,6738,2,13630.0,2,13635.0,4,B
2018-04-10 09:48:00,13630.0,4,6742,-4,13625.0,18,13630.0,2,S
2018-04-10 09:48:00,13630.0,2,6744,-2,13625.0,17,13630.0,4,S
2018-04-10 09:48:01,13625.0,4,6748,0,13625.0,15,13630.0,4,S
2018-04-10 09:48:04,13630.0,10,6758,4,13630.0,4,13635.0,15,B
2018-04-10 09:48:09,13630.0,2,6760,0,13630.0,1,13635.0,4,B
2018-04-10 09:48:13,13630.0,6,6766,-6,13625.0,19,13635.0,6,B
2018-04-10 09:48:14,13630.0,2,6768,-2,13625.0,18,13635.0,6,B
2018-04-10 09:48:18,13635.0,2,6770,0,13630.0,2,13635.0,1,B
2018-04-10 09:48:26,13635.0,2,6772,2,13630.0,6,13640.0,6,B
2018-04-10 09:48:28,13630.0,2,6774,0,13630.0,8,13640.0,8,S
2018-04-10 09:48:40,13630.0,10,6784,-2,13630.0,5,13640.0,10,S
2018-04-10 09:49:11,13635.0,4,6788,-4,13630.0,4,13640.0,10,B
2018-04-10 09:49:32,13635.0,2,6790,-2,13635.0,3,13640.0,4,B
2018-04-10 09:49:49,13635.0,2,6792,0,13635.0,2,13640.0,8,B
2018-04-10 09:50:50,13635.0,2,6794,-2,13630.0,11,13640.0,105,B
2018-04-10 09:50:56,13635.0,2,6796,2,13630.0,5,13640.0,104,B
2018-04-10 09:50:57,13635.0,4,6800,-2,13630.0,8,13640.0,104,B
2018-04-10 09:51:07,13635.0,2,6802,2,13630.0,7,13640.0,104,B
2018-04-10 09:51:08,13630.0,2,6804,0,13630.0,6,13640.0,106,S
2018-04-10 09:51:39,13640.0,4,6808,0,13630.0,6,13640.0,104,B
2018-04-10 09:51:47,13635.0,2,6810,2,13635.0,1,13640.0,104,S
2018-04-10 09:51:52,13635.0,2,6812,0,13635.0,1,13640.0,104,S
2018-04-10 09:51:52,13635.0,2,6814,0,13630.0,5,13635.0,4,S
2018-04-10 09:52:21,13635.0,10,6824,6,13630.0,5,13635.0,1,S
2018-04-10 09:52:22,13630.0,2,6826,2,13630.0,4,13635.0,1,S
2018-04-10 09:52:25,13635.0,2,6828,2,13630.0,4,13640.0,105,B
2018-04-10 09:52:28,13635.0,2,6830,-2,13630.0,4,13640.0,104,B
2018-04-10 09:52:47,13630.0,8,6838,0,13625.0,25,13630.0,36,S
2018-04-10 09:53:03,13630.0,2,6840,-2,13625.0,22,13630.0,36,S
2018-04-10 09:53:16,13625.0,24,6864,-16,13625.0,6,13630.0,38,S
2018-04-10 09:53:17,13625.0,4,6868,-2,13625.0,4,13630.0,38,S
2018-04-10 09:53:24,13630.0,4,6872,-4,13625.0,11,13630.0,35,B
2018-04-10 09:53:40,13625.0,8,6880,6,13620.0,18,13630.0,35,S
2018-04-10 09:53:43,13625.0,2,6882,2,13620.0,16,13630.0,36,S
2018-04-10 09:53:49,13625.0,6,6888,-6,13625.0,8,13630.0,35,S
2018-04-10 09:53:50,13630.0,8,6896,-8,13625.0,6,13630.0,31,B
2018-04-10 09:53:50,13630.0,6,6902,0,13625.0,9,13630.0,28,B
2018-04-10 09:53:51,13630.0,6,6908,0,13625.0,12,13630.0,25,B
2018-04-10 09:53:53,13625.0,2,6910,-2,13625.0,10,13630.0,25,S
2018-04-10 09:53:59,13630.0,2,6912,0,13625.0,10,13630.0,27,B
2018-04-10 09:54:02,13630.0,10,6922,0,13625.0,10,13630.0,22,B
2018-04-10 09:54:05,13625.0,2,6924,0,13625.0,9,13630.0,22,S
2018-04-10 09:54:08,13625.0,6,6930,-6,13625.0,1,13630.0,34,S
2018-04-10 09:54:09,13625.0,4,6934,-4,13620.0,19,13630.0,34,S
2018-04-10 09:54:10,13625.0,2,6936,0,13625.0,1,13630.0,34,S
2018-04-10 09:54:16,13625.0,18,6954,-8,13620.0,23,13630.0,32,S
2018-04-10 09:54:25,13625.0,4,6958,0,13620.0,20,13625.0,8,S
2018-04-10 09:54:25,13625.0,4,6962,-4,13620.0,18,13625.0,6,S
2018-04-10 09:54:26,13625.0,8,6970,0,13620.0,18,13625.0,2,S
2018-04-10 09:54:26,13625.0,4,6974,0,13620.0,18,13630.0,33,S
2018-04-10 09:54:31,13625.0,22,6996,-6,13625.0,3,13630.0,32,S
2018-04-10 09:54:35,13630.0,10,7006,0,13625.0,3,13630.0,27,B
2018-04-10 09:54:37,13625.0,2,7008,2,13625.0,2,13630.0,15,S
2018-04-10 09:54:40,13625.0,6,7014,0,13620.0,32,13625.0,9,S
2018-04-10 09:54:41,13630.0,26,7040,-6,13625.0,2,13630.0,12,B
2018-04-10 09:54:45,13625.0,8,7048,-4,13620.0,32,13625.0,6,S
2018-04-10 09:54:46,13625.0,12,7060,-10,13620.0,32,13630.0,12,S
2018-04-10 09:54:49,13625.0,2,7062,2,13620.0,32,13630.0,12,S
2018-04-10 09:54:50,13625.0,14,7076,0,13620.0,32,13625.0,3,S
2018-04-10 09:54:50,13625.0,6,7082,-2,13620.0,32,13630.0,12,S
2018-04-10 09:54:53,13625.0,6,7088,-6,13620.0,32,13625.0,7,S
2018-04-10 09:54:54,13625.0,4,7092,0,13620.0,31,13625.0,5,S
2018-04-10 09:54:55,13625.0,12,7104,-8,13625.0,2,13630.0,12,S
2018-04-10 09:54:55,13630.0,2,7106,2,13625.0,4,13630.0,11,B
2018-04-10 09:54:57,13630.0,6,7112,0,13625.0,6,13630.0,7,B
2018-04-10 09:54:58,13625.0,18,7130,0,13620.0,33,13625.0,1,S
2018-04-10 09:54:59,13625.0,2,7132,0,13620.0,33,13630.0,8,S
2018-04-10 09:55:18,13625.0,4,7136,0,13620.0,32,13625.0,8,S
2018-04-10 09:55:19,13625.0,2,7138,0,13620.0,34,13625.0,7,S
2018-04-10 09:55:20,13625.0,14,7152,0,13620.0,34,13630.0,8,S
2018-04-10 09:55:31,13625.0,10,7162,0,13620.0,22,13625.0,5,S
2018-04-10 09:55:35,13620.0,2,7164,-2,13620.0,19,13625.0,10,S
2018-04-10 09:55:36,13620.0,4,7168,-2,13620.0,17,13625.0,10,S
2018-04-10 09:55:53,13620.0,8,7176,-4,13620.0,13,13625.0,16,S
2018-04-10 09:55:54,13620.0,26,7202,-10,13615.0,5,13620.0,2,S
2018-04-10 09:56:05,13615.0,2,7204,0,13615.0,1,13620.0,7,S
2018-04-10 09:56:07,13615.0,2,7206,-2,13610.0,32,13620.0,7,S
2018-04-10 09:56:08,13615.0,2,7208,0,13610.0,32,13615.0,6,S
2018-04-10 09:56:12,13615.0,2,7210,-2,13610.0,31,13615.0,5,S
2018-04-10 09:56:13,13615.0,8,7218,0,13610.0,31,13615.0,1,S
2018-04-10 09:56:13,13615.0,2,7220,0,13610.0,31,13620.0,2,S
2018-04-10 09:56:20,13610.0,4,7224,-2,13610.0,33,13620.0,3,S
2018-04-10 09:56:22,13615.0,2,7226,0,13610.0,34,13620.0,3,B
2018-04-10 09:56:23,13610.0,10,7236,-10,13610.0,29,13615.0,7,S
2018-04-10 09:56:26,13610.0,10,7246,-4,13610.0,22,13615.0,16,S
2018-04-10 09:56:27,13610.0,6,7252,-6,13610.0,20,13615.0,14,S
2018-04-10 09:56:27,13610.0,40,7292,-22,13605.0,11,13615.0,14,S
2018-04-10 09:56:28,13605.0,2,7294,0,13605.0,7,13610.0,15,S
2018-04-10 09:56:28,13605.0,14,7308,10,13600.0,40,13605.0,5,S
2018-04-10 09:56:29,13605.0,6,7314,0,13600.0,34,13610.0,17,S
2018-04-10 09:56:30,13605.0,8,7322,0,13605.0,1,13610.0,7,S
2018-04-10 09:56:33,13605.0,2,7324,-2,13605.0,1,13610.0,7,S
2018-04-10 09:56:33,13605.0,2,7326,-2,13600.0,38,13605.0,1,S
2018-04-10 09:56:34,13605.0,2,7328,2,13600.0,38,13610.0,8,S
2018-04-10 09:56:36,13600.0,6,7334,-2,13600.0,35,13610.0,9,S
2018-04-10 09:56:56,13610.0,14,7348,10,13610.0,3,13615.0,3,B
2018-04-10 09:56:59,13610.0,2,7350,2,13610.0,4,13620.0,9,B
2018-04-10 09:57:09,13610.0,4,7354,-4,13610.0,6,13620.0,11,B
2018-04-10 09:57:36,13615.0,10,7364,10,13615.0,2,13620.0,3,B
2018-04-10 09:57:38,13620.0,2,7366,2,13615.0,1,13620.0,4,B
2018-04-10 09:57:39,13620.0,4,7370,-4,13615.0,1,13620.0,2,B
2018-04-10 09:57:44,13620.0,2,7372,0,13615.0,6,13620.0,1,B
2018-04-10 09:57:45,13620.0,2,7374,0,13615.0,6,13625.0,4,B
2018-04-10 09:57:51,13620.0,2,7376,0,13620.0,1,13625.0,8,B
2018-04-10 09:57:53,13620.0,2,7378,0,13620.0,5,13625.0,2,B
2018-04-10 09:58:02,13620.0,2,7380,0,13620.0,3,13625.0,5,B
2018-04-10 09:58:07,13625.0,2,7382,2,13620.0,2,13625.0,4,B
2018-04-10 09:58:19,13620.0,2,7384,-2,13620.0,1,13625.0,4,S
2018-04-10 09:58:20,13620.0,2,7386,-2,13615.0,10,13625.0,5,S
2018-04-10 09:58:21,13615.0,4,7390,4,13615.0,3,13620.0,9,S
2018-04-10 09:58:34,13620.0,4,7394,2,13615.0,2,13620.0,7,B
2018-04-10 09:58:42,13620.0,2,7396,-2,13615.0,2,13620.0,4,B
2018-04-10 09:58:46,13620.0,2,7398,-2,13615.0,2,13620.0,6,B
2018-04-10 09:58:54,13615.0,2,7400,0,13615.0,1,13620.0,4,S
2018-04-10 09:59:01,13620.0,2,7402,-2,13615.0,1,13620.0,5,B
2018-04-10 09:59:10,13615.0,2,7404,2,13610.0,6,13620.0,5,S
2018-04-10 09:59:16,13610.0,2,7406,-2,13610.0,1,13615.0,4,S
2018-04-10 09:59:19,13610.0,2,7408,-2,13610.0,5,13620.0,10,S
2018-04-10 09:59:27,13620.0,2,7410,0,13610.0,21,13620.0,6,B
2018-04-10 09:59:36,13615.0,2,7412,2,13610.0,22,13620.0,6,S
2018-04-10 09:59:46,13615.0,2,7414,0,13615.0,11,13620.0,4,S
2018-04-10 09:59:46,13615.0,2,7416,0,13615.0,10,13620.0,22,S
2018-04-10 10:00:00,13615.0,2,7418,0,13615.0,9,13620.0,10,S
2018-04-10 10:00:01,13615.0,2,7420,2,13615.0,8,13620.0,10,S
2018-04-10 10:00:01,13615.0,2,7422,0,13615.0,7,13620.0,10,S
2018-04-10 10:00:12,13615.0,2,7424,0,13615.0,6,13620.0,7,S
2018-04-10 10:00:15,13615.0,2,7426,0,13615.0,5,13620.0,7,S
2018-04-10 10:00:16,13615.0,2,7428,2,13615.0,4,13620.0,6,S
2018-04-10 10:00:19,13615.0,8,7436,6,13610.0,8,13620.0,7,S
2018-04-10 10:00:43,13610.0,8,7444,-2,13605.0,28,13615.0,4,S
2018-04-10 10:00:44,13605.0,22,7466,-10,13605.0,1,13610.0,20,S
2018-04-10 10:00:45,13600.0,4,7470,4,13600.0,30,13605.0,10,S
2018-04-10 10:00:45,13605.0,4,7474,0,13600.0,31,13605.0,7,B
2018-04-10 10:00:46,13605.0,14,7488,14,13600.0,31,13610.0,9,B
2018-04-10 10:00:50,13600.0,2,7490,-2,13600.0,30,13605.0,7,S
2018-04-10 10:00:53,13605.0,2,7492,-2,13600.0,30,13605.0,9,B
2018-04-10 10:00:55,13605.0,6,7498,4,13600.0,30,13605.0,4,B
2018-04-10 10:00:58,13605.0,8,7506,-6,13600.0,29,13610.0,15,B
2018-04-10 10:01:02,13605.0,6,7512,6,13600.0,29,13605.0,1,B
2018-04-10 10:01:03,13605.0,2,7514,0,13605.0,2,13610.0,8,B
2018-04-10 10:01:10,13600.0,2,7516,2,13600.0,35,13610.0,9,S
2018-04-10 10:01:13,13600.0,4,7520,4,13600.0,36,13610.0,9,S
2018-04-10 10:01:17,13605.0,4,7524,-4,13600.0,33,13605.0,5,B
2018-04-10 10:01:19,13605.0,2,7526,-2,13600.0,33,13605.0,4,B
2018-04-10 10:01:19,13605.0,2,7528,0,13600.0,33,13605.0,3,B
2018-04-10 10:01:20,13605.0,2,7530,-2,13600.0,33,13605.0,2,B
2018-04-10 10:01:23,13605.0,4,7534,0,13600.0,33,13610.0,6,B
2018-04-10 10:01:29,13605.0,2,7536,0,13600.0,33,13610.0,6,B
2018-04-10 10:01:36,13610.0,2,7538,2,13600.0,33,13610.0,11,B
2018-04-10 10:01:39,13610.0,2,7540,0,13605.0,6,13610.0,7,B
2018-04-10 10:01:43,13610.0,2,7542,0,13605.0,8,13610.0,6,B
2018-04-10 10:01:50,13605.0,2,7544,0,13605.0,7,13610.0,6,S
2018-04-10 10:01:54,13605.0,10,7554,10,13605.0,2,13610.0,6,S
2018-04-10 10:01:55,13610.0,2,7556,-2,13605.0,3,13615.0,6,B
2018-04-10 10:02:13,13615.0,8,7564,2,13610.0,2,13615.0,2,B
2018-04-10 10:02:24,13615.0,2,7566,0,13615.0,1,13620.0,7,B
2018-04-10 10:02:28,13620.0,2,7568,0,13615.0,3,13620.0,6,B
2018-04-10 10:02:29,13615.0,2,7570,0,13615.0,1,13620.0,6,S
2018-04-10 10:02:32,13620.0,2,7572,-2,13610.0,9,13620.0,4,B
2018-04-10 10:02:40,13620.0,2,7574,0,13615.0,5,13620.0,2,B
2018-04-10 10:02:41,13620.0,4,7578,0,13620.0,3,13625.0,8,B
2018-04-10 10:02:50,13620.0,2,7580,0,13620.0,3,13625.0,2,B
2018-04-10 10:02:53,13625.0,4,7584,0,13620.0,1,13630.0,6,B
2018-04-10 10:02:55,13625.0,2,7586,-2,13620.0,5,13630.0,5,B
2018-04-10 10:02:57,13625.0,2,7588,-2,13620.0,5,13630.0,5,B
2018-04-10 10:02:58,13630.0,2,7590,-2,13620.0,5,13630.0,6,B
2018-04-10 10:03:17,13620.0,2,7592,0,13615.0,3,13620.0,2,S
2018-04-10 10:03:18,13625.0,4,7596,-2,13615.0,3,13625.0,3,B
2018-04-10 10:03:20,13615.0,6,7602,4,13610.0,12,13615.0,7,S
2018-04-10 10:03:20,13615.0,8,7610,4,13610.0,12,13615.0,3,S
2018-04-10 10:03:21,13610.0,20,7630,10,13610.0,3,13615.0,3,S
2018-04-10 10:03:23,13610.0,12,7642,8,13605.0,21,13610.0,4,S
2018-04-10 10:03:23,13610.0,18,7660,12,13605.0,19,13610.0,15,S
2018-04-10 10:03:25,13610.0,2,7662,0,13605.0,23,13610.0,14,S
2018-04-10 10:03:27,13605.0,20,7682,10,13600.0,27,13610.0,15,S
2018-04-10 10:03:29,13600.0,20,7702,2,13605.0,1,13610.0,16,S
2018-04-10 10:03:29,13605.0,2,7704,-2,13605.0,1,13610.0,16,B
2018-04-10 10:03:30,13605.0,2,7706,0,13605.0,1,13610.0,16,B
2018-04-10 10:03:32,13605.0,2,7708,0,13600.0,11,13610.0,18,B
2018-04-10 10:03:34,13610.0,2,7710,0,13600.0,14,13610.0,21,B
2018-04-10 10:03:35,13605.0,2,7712,-2,13600.0,14,13610.0,20,S
2018-04-10 10:03:36,13605.0,2,7714,0,13600.0,14,13610.0,20,S
2018-04-10 10:04:16,13600.0,20,7734,20,13600.0,6,13605.0,6,S
2018-04-10 10:04:18,13605.0,2,7736,0,13600.0,19,13605.0,5,B
2018-04-10 10:04:19,13605.0,10,7746,0,13600.0,19,13610.0,21,B
2018-04-10 10:04:19,13610.0,22,7768,2,13600.0,9,13610.0,19,B
2018-04-10 10:04:24,13600.0,20,7788,18,13600.0,1,13610.0,20,S
2018-04-10 10:04:30,13600.0,4,7792,2,13595.0,10,13600.0,8,S
2018-04-10 10:04:31,13600.0,8,7800,8,13595.0,9,13600.0,4,S
2018-04-10 10:04:34,13600.0,2,7802,0,13595.0,9,13600.0,3,S
2018-04-10 10:04:36,13600.0,6,7808,6,13595.0,10,13605.0,3,S
2018-04-10 10:04:41,13605.0,2,7810,0,13600.0,14,13605.0,5,B
2018-04-10 10:04:45,13600.0,20,7830,20,13600.0,4,13605.0,6,S
2018-04-10 10:04:55,13600.0,6,7836,6,13600.0,6,13605.0,6,S
2018-04-10 10:04:56,13605.0,2,7838,-2,13600.0,6,13605.0,5,B
2018-04-10 10:04:57,13600.0,2,7840,2,13600.0,5,13605.0,5,S
2018-04-10 10:05:06,13600.0,8,7848,0,13600.0,2,13605.0,8,S
2018-04-10 10:05:07,13600.0,6,7854,4,13595.0,10,13605.0,5,S
2018-04-10 10:05:26,13605.0,2,7856,0,13600.0,1,13605.0,3,B
2018-04-10 10:05:32,13605.0,2,7858,2,13600.0,10,13605.0,3,B
2018-04-10 10:05:33,13605.0,2,7860,0,13600.0,17,13605.0,2,B
2018-04-10 10:05:37,13605.0,2,7862,0,13600.0,17,13605.0,2,B
2018-04-10 10:05:40,13605.0,4,7866,0,13605.0,1,13610.0,40,B
2018-04-10 10:05:41,13605.0,2,7868,-2,13600.0,17,13605.0,3,B
2018-04-10 10:05:48,13605.0,6,7874,0,13600.0,17,13610.0,42,B
2018-04-10 10:05:51,13605.0,2,7876,-2,13600.0,23,13610.0,38,B
2018-04-10 10:05:54,13605.0,4,7880,-2,13600.0,23,13610.0,36,B
2018-04-10 10:05:58,13605.0,2,7882,0,13600.0,23,13610.0,36,B
2018-04-10 10:06:10,13605.0,4,7886,2,13600.0,20,13605.0,1,B
2018-04-10 10:06:11,13605.0,2,7888,-2,13600.0,19,13605.0,2,B
2018-04-10 10:06:12,13605.0,4,7892,0,13600.0,19,13610.0,39,B
2018-04-10 10:06:15,13605.0,4,7896,0,13605.0,3,13610.0,41,B
2018-04-10 10:06:16,13605.0,12,7908,12,13600.0,24,13610.0,44,B
2018-04-10 10:06:19,13605.0,2,7910,0,13600.0,25,13605.0,1,B
2018-04-10 10:06:24,13605.0,2,7912,0,13600.0,25,13610.0,41,B
2018-04-10 10:06:50,13610.0,2,7914,0,13605.0,7,13610.0,39,B
2018-04-10 10:06:51,13610.0,2,7916,0,13605.0,7,13610.0,38,B
2018-04-10 10:07:22,13610.0,6,7922,4,13605.0,25,13610.0,34,B
2018-04-10 10:07:22,13610.0,6,7928,2,13605.0,25,13610.0,31,B
2018-04-10 10:07:24,13610.0,2,7930,2,13605.0,13,13610.0,35,B
2018-04-10 10:07:53,13610.0,20,7950,20,13605.0,7,13610.0,15,B
2018-04-10 10:07:53,13610.0,2,7952,2,13605.0,7,13610.0,14,B
2018-04-10 10:07:54,13610.0,6,7958,0,13605.0,7,13610.0,11,B
2018-04-10 10:07:54,13610.0,4,7962,2,13605.0,18,13610.0,9,B
2018-04-10 10:07:55,13610.0,4,7966,0,13605.0,18,13610.0,7,B
2018-04-10 10:07:56,13610.0,2,7968,2,13605.0,18,13610.0,6,B
2018-04-10 10:08:00,13610.0,2,7970,0,13605.0,19,13610.0,8,B
2018-04-10 10:08:02,13610.0,2,7972,0,13605.0,19,13610.0,7,B
2018-04-10 10:08:03,13610.0,2,7974,-2,13605.0,19,13610.0,6,B
2018-04-10 10:08:04,13610.0,12,7986,8,13610.0,1,13615.0,17,B
2018-04-10 10:08:06,13610.0,4,7990,2,13605.0,19,13615.0,15,B
2018-04-10 10:08:08,13605.0,4,7994,4,13605.0,17,13615.0,15,S
2018-04-10 10:08:11,13610.0,4,7998,4,13610.0,12,13615.0,11,B
2018-04-10 10:08:11,13615.0,2,8000,-2,13610.0,12,13615.0,10,B
2018-04-10 10:08:21,13615.0,2,8002,2,13610.0,12,13615.0,11,B
2018-04-10 10:08:22,13615.0,12,8014,10,13610.0,12,13615.0,5,B
2018-04-10 10:08:31,13615.0,2,8016,0,13610.0,13,13615.0,4,B
2018-04-10 10:08:34,13615.0,2,8018,2,13610.0,13,13615.0,3,B
2018-04-10 10:08:39,13615.0,2,8020,2,13610.0,14,13615.0,2,B
2018-04-10 10:08:42,13615.0,2,8022,0,13610.0,14,13615.0,1,B
2018-04-10 10:08:48,13610.0,4,8026,0,13610.0,3,13615.0,13,S
2018-04-10 10:08:49,13610.0,4,8030,0,13610.0,1,13615.0,13,S
2018-04-10 10:08:49,13610.0,2,8032,2,13605.0,11,13615.0,12,S
2018-04-10 10:08:57,13610.0,2,8034,-2,13605.0,20,13615.0,5,S
2018-04-10 10:08:58,13610.0,2,8036,-2,13610.0,1,13615.0,4,S
2018-04-10 10:09:04,13610.0,4,8040,-4,13605.0,21,13615.0,10,S
2018-04-10 10:09:42,13615.0,6,8046,6,13610.0,3,13615.0,1,B
2018-04-10 10:09:45,13615.0,2,8048,0,13610.0,3,13620.0,8,B
2018-04-10 10:10:03,13615.0,16,8064,-2,13615.0,1,13620.0,9,B
2018-04-10 10:10:03,13615.0,4,8068,-4,13610.0,2,13620.0,4,B
2018-04-10 10:10:11,13615.0,2,8070,2,13615.0,6,13620.0,1,B
2018-04-10 10:10:13,13620.0,6,8076,6,13620.0,4,13625.0,15,B
2018-04-10 10:10:14,13620.0,4,8080,0,13620.0,2,13625.0,12,B
2018-04-10 10:10:15,13620.0,4,8084,0,13615.0,2,13625.0,16,B
2018-04-10 10:10:16,13625.0,2,8086,2,13615.0,2,13625.0,15,B
2018-04-10 10:10:18,13625.0,2,8088,0,13615.0,2,13625.0,14,B
2018-04-10 10:10:18,13625.0,2,8090,0,13615.0,2,13625.0,13,B
2018-04-10 10:10:19,13625.0,2,8092,0,13615.0,3,13625.0,12,B
2018-04-10 10:10:20,13625.0,2,8094,0,13615.0,3,13625.0,11,B
2018-04-10 10:10:24,13620.0,2,8096,2,13615.0,2,13625.0,11,S
2018-04-10 10:10:27,13620.0,2,8098,-2,13615.0,2,13625.0,11,S
2018-04-10 10:10:55,13615.0,4,8102,-2,13610.0,21,13620.0,1,S
2018-04-10 10:10:55,13620.0,2,8104,2,13615.0,4,13620.0,2,B
2018-04-10 10:10:56,13620.0,2,8106,0,13610.0,22,13620.0,2,B
2018-04-10 10:10:56,13620.0,2,8108,0,13610.0,5,13620.0,5,B
2018-04-10 10:11:11,13615.0,6,8114,-6,13615.0,1,13620.0,6,S
2018-04-10 10:12:00,13615.0,14,8128,-10,13615.0,2,13620.0,9,S
2018-04-10 10:12:00,13615.0,2,8130,-2,13615.0,1,13620.0,7,S
2018-04-10 10:12:04,13615.0,2,8132,-2,13610.0,4,13620.0,9,S
2018-04-10 10:12:11,13615.0,2,8134,0,13610.0,2,13615.0,2,S
2018-04-10 10:12:21,13615.0,2,8136,-2,13610.0,20,13620.0,6,S
2018-04-10 10:13:02,13615.0,2,8138,-2,13610.0,7,13615.0,2,S
2018-04-10 10:13:31,13610.0,2,8140,0,13610.0,6,13620.0,3,S
2018-04-10 10:13:45,13615.0,2,8142,0,13610.0,6,13620.0,3,B
2018-04-10 10:13:48,13620.0,2,8144,-2,13615.0,15,13625.0,14,B
2018-04-10 10:14:11,13620.0,2,8146,2,13620.0,3,13625.0,8,B
2018-04-10 10:14:11,13620.0,2,8148,0,13620.0,6,13625.0,8,B
2018-04-10 10:14:17,13625.0,10,8158,0,13615.0,14,13625.0,3,B
2018-04-10 10:14:20,13625.0,4,8162,0,13615.0,14,13625.0,6,B
2018-04-10 10:14:38,13625.0,10,8172,-2,13625.0,15,13630.0,6,B
2018-04-10 10:14:39,13625.0,10,8182,-6,13625.0,10,13630.0,6,B
2018-04-10 10:14:39,13625.0,6,8188,-6,13625.0,7,13630.0,7,B
2018-04-10 10:14:40,13625.0,2,8190,0,13625.0,6,13630.0,7,B
2018-04-10 10:14:42,13625.0,2,8192,0,13625.0,5,13630.0,2,B
2018-04-10 10:14:42,13625.0,2,8194,0,13625.0,4,13630.0,2,B
2018-04-10 10:14:48,13625.0,2,8196,0,13625.0,3,13630.0,1,B
2018-04-10 10:30:00,13625.0,8,8204,2,13620.0,2,13625.0,16,B
2018-04-10 10:30:01,13625.0,14,8218,10,13620.0,5,13625.0,9,B
2018-04-10 10:30:02,13625.0,18,8236,18,13625.0,9,13630.0,5,B
2018-04-10 10:30:10,13630.0,2,8238,2,13625.0,9,13630.0,4,B
2018-04-10 10:30:24,13630.0,4,8242,-2,13625.0,10,13630.0,2,B
2018-04-10 10:30:25,13625.0,12,8254,12,13625.0,4,13630.0,2,S
2018-04-10 10:30:25,13625.0,8,8262,4,13620.0,12,13630.0,6,S
2018-04-10 10:30:28,13625.0,2,8264,2,13620.0,4,13630.0,6,S
2018-04-10 10:30:31,13625.0,2,8266,0,13620.0,5,13630.0,5,S
2018-04-10 10:30:32,13630.0,10,8276,2,13630.0,1,13635.0,7,B
2018-04-10 10:30:32,13630.0,12,8288,2,13625.0,1,13635.0,4,B
2018-04-10 10:30:33,13635.0,14,8302,6,13625.0,1,13635.0,3,B
2018-04-10 10:30:34,13635.0,8,8310,0,13625.0,1,13635.0,1,B
2018-04-10 10:30:37,13630.0,2,8312,0,13620.0,6,13630.0,1,S
2018-04-10 10:30:45,13630.0,12,8324,-2,13630.0,4,13635.0,3,S
2018-04-10 10:30:45,13630.0,8,8332,-4,13625.0,1,13635.0,4,S
2018-04-10 10:30:46,13635.0,6,8338,2,13620.0,8,13635.0,2,B
2018-04-10 10:30:46,13635.0,8,8346,2,13620.0,8,13635.0,4,B
2018-04-10 10:30:47,13635.0,4,8350,0,13620.0,8,13635.0,2,B
2018-04-10 10:30:47,13635.0,4,8354,0,13635.0,2,13640.0,20,B
2018-04-10 10:30:48,13635.0,8,8362,6,13630.0,1,13635.0,7,B
2018-04-10 10:30:48,13640.0,40,8402,30,13625.0,5,13635.0,1,B
2018-04-10 10:30:51,13640.0,2,8404,2,13630.0,4,13640.0,5,B
2018-04-10 10:30:52,13640.0,4,8408,0,13630.0,4,13640.0,4,B
2018-04-10 10:31:15,13635.0,2,8410,-2,13635.0,1,13640.0,11,S
2018-04-10 10:31:21,13635.0,2,8412,0,13635.0,2,13640.0,7,S
2018-04-10 10:31:27,13635.0,2,8414,-2,13635.0,1,13640.0,3,S
2018-04-10 10:31:30,13640.0,6,8420,-2,13640.0,7,13645.0,5,B
2018-04-10 10:31:32,13640.0,6,8426,-6,13640.0,4,13645.0,4,B
2018-04-10 10:31:35,13640.0,2,8428,-2,13640.0,3,13645.0,7,B
2018-04-10 10:31:36,13640.0,2,8430,-2,13640.0,2,13645.0,7,B
2018-04-10 10:31:37,13640.0,4,8434,-4,13635.0,3,13645.0,7,B
2018-04-10 10:31:50,13635.0,2,8436,0,13630.0,7,13640.0,4,S
2018-04-10 10:31:55,13635.0,2,8438,-2,13630.0,8,13640.0,4,S
2018-04-10 10:32:07,13630.0,14,8452,-10,13625.0,9,13630.0,19,S
2018-04-10 10:32:18,13625.0,6,8458,-6,13625.0,1,13630.0,1,S
2018-04-10 10:32:19,13625.0,2,8460,0,13620.0,5,13630.0,2,S
2018-04-10 10:32:26,13620.0,38,8498,-18,13620.0,7,13630.0,2,S
2018-04-10 10:32:28,13625.0,2,8500,-2,13620.0,11,13630.0,4,B
2018-04-10 10:32:31,13620.0,4,8504,0,13620.0,9,13625.0,1,S
2018-04-10 10:32:35,13620.0,10,8514,-10,13615.0,4,13625.0,8,S
2018-04-10 10:32:44,13620.0,2,8516,-2,13620.0,9,13625.0,7,S
2018-04-10 10:32:51,13625.0,20,8536,-12,13615.0,5,13625.0,3,B
2018-04-10 10:32:58,13625.0,2,8538,-2,13620.0,2,13625.0,3,B
2018-04-10 10:33:00,13620.0,4,8542,0,13615.0,4,13620.0,1,S
2018-04-10 10:33:03,13620.0,4,8546,2,13615.0,5,13620.0,2,S
2018-04-10 10:33:04,13620.0,2,8548,0,13615.0,5,13625.0,5,S
2018-04-10 10:33:20,13615.0,2,8550,0,13615.0,12,13620.0,8,S
2018-04-10 10:33:20,13615.0,2,8552,-2,13615.0,11,13620.0,8,S
2018-04-10 10:33:21,13615.0,16,8568,-4,13615.0,4,13620.0,8,S
2018-04-10 10:33:21,13615.0,2,8570,-2,13615.0,3,13620.0,8,S
2018-04-10 10:33:22,13615.0,6,8576,-6,13610.0,5,13615.0,2,S
2018-04-10 10:33:24,13615.0,4,8580,-4,13610.0,5,13615.0,1,S
2018-04-10 10:33:28,13615.0,2,8582,0,13615.0,4,13620.0,2,S
2018-04-10 10:33:29,13615.0,2,8584,-2,13615.0,3,13620.0,2,S
2018-04-10 10:33:56,13620.0,4,8588,-4,13615.0,8,13625.0,6,B
2018-04-10 10:33:59,13615.0,4,8592,-4,13615.0,6,13625.0,3,S
2018-04-10 10:34:01,13620.0,2,8594,-2,13620.0,4,13625.0,2,B
2018-04-10 10:34:10,13620.0,4,8598,-2,13620.0,2,13625.0,3,B
2018-04-10 10:34:27,13625.0,2,8600,2,13620.0,1,13625.0,2,B
2018-04-10 10:34:54,13625.0,10,8610,-6,13625.0,7,13630.0,8,B
2018-04-10 10:35:01,13625.0,2,8612,0,13625.0,6,13630.0,5,B
2018-04-10 10:35:52,13625.0,2,8614,0,13625.0,6,13630.0,13,B
2018-04-10 10:35:57,13630.0,2,8616,0,13625.0,5,13630.0,5,B
2018-04-10 10:36:02,13625.0,10,8626,0,13620.0,4,13630.0,7,S
2018-04-10 10:36:03,13630.0,4,8630,0,13620.0,5,13630.0,5,B
2018-04-10 10:36:07,13625.0,2,8632,2,13620.0,4,13625.0,9,S
2018-04-10 10:36:22,13620.0,4,8636,4,13615.0,3,13625.0,14,S
2018-04-10 10:36:45,13620.0,4,8640,4,13615.0,4,13620.0,1,S
2018-04-10 10:36:57,13615.0,2,8642,0,13610.0,7,13615.0,1,S
2018-04-10 10:37:16,13615.0,12,8654,8,13610.0,6,13615.0,6,S
2018-04-10 10:37:17,13615.0,12,8666,0,13610.0,7,13620.0,7,S
2018-04-10 10:37:18,13615.0,4,8670,2,13615.0,1,13620.0,2,S
2018-04-10 10:38:22,13625.0,2,8672,-2,13615.0,6,13625.0,6,B
2018-04-10 10:38:43,13630.0,2,8674,-2,13625.0,3,13630.0,2,B
2018-04-10 10:38:44,13630.0,4,8678,2,13625.0,3,13635.0,8,B
2018-04-10 10:38:53,13635.0,2,8680,0,13625.0,6,13635.0,4,B
2018-04-10 10:38:56,13635.0,2,8682,0,13625.0,5,13635.0,2,B
2018-04-10 10:39:01,13635.0,8,8690,4,13635.0,1,13640.0,4,B
2018-04-10 10:39:02,13635.0,2,8692,0,13630.0,1,13640.0,6,B
2018-04-10 10:39:19,13630.0,2,8694,-2,13630.0,1,13635.0,16,S
2018-04-10 10:39:51,13630.0,6,8700,-6,13625.0,7,13635.0,16,S
2018-04-10 10:39:56,13630.0,2,8702,0,13630.0,1,13635.0,16,S
2018-04-10 10:40:08,13635.0,22,8724,0,13635.0,8,13640.0,11,B
2018-04-10 10:40:14,13640.0,2,8726,2,13635.0,8,13645.0,6,B
2018-04-10 10:40:30,13640.0,16,8742,-16,13635.0,3,13640.0,2,B
2018-04-10 10:40:36,13640.0,4,8746,0,13640.0,1,13645.0,3,B
2018-04-10 10:40:40,13640.0,2,8748,0,13635.0,3,13645.0,4,B
2018-04-10 10:40:40,13645.0,2,8750,-2,13635.0,3,13645.0,3,B
2018-04-10 10:40:41,13640.0,4,8754,0,13635.0,3,13645.0,3,S
2018-04-10 10:40:47,13640.0,2,8756,0,13630.0,6,13640.0,2,S
2018-04-10 10:41:06,13640.0,4,8760,0,13630.0,6,13635.0,3,S
2018-04-10 10:41:19,13635.0,10,8770,0,13625.0,23,13635.0,2,S
2018-04-10 10:41:28,13635.0,6,8776,2,13625.0,8,13635.0,2,S
2018-04-10 10:41:56,13630.0,2,8778,0,13625.0,8,13630.0,9,S
2018-04-10 10:41:57,13625.0,2,8780,-2,13625.0,7,13630.0,9,S
2018-04-10 10:42:08,13630.0,6,8786,0,13625.0,5,13630.0,7,B
2018-04-10 10:42:16,13630.0,6,8792,0,13625.0,5,13630.0,4,B
2018-04-10 10:42:16,13630.0,8,8800,2,13625.0,5,13635.0,6,B
2018-04-10 10:42:19,13635.0,2,8802,0,13630.0,2,13635.0,2,B
2018-04-10 10:42:35,13635.0,2,8804,2,13630.0,1,13635.0,1,B
2018-04-10 10:43:29,13630.0,2,8806,-2,13625.0,7,13635.0,12,S
2018-04-10 10:43:38,13625.0,10,8816,4,13625.0,2,13635.0,14,S
2018-04-10 10:43:43,13625.0,4,8820,2,13625.0,3,13635.0,13,S
2018-04-10 10:43:46,13625.0,4,8824,4,13625.0,1,13635.0,13,S
2018-04-10 10:43:52,13630.0,2,8826,0,13625.0,3,13635.0,13,B
2018-04-10 10:44:16,13625.0,2,8828,-2,13625.0,4,13630.0,10,S
2018-04-10 10:47:02,13630.0,8,8836,-8,13625.0,12,13630.0,6,B
2018-04-10 10:47:11,13630.0,4,8840,0,13625.0,24,13630.0,4,B
2018-04-10 10:47:49,13630.0,2,8842,0,13625.0,18,13630.0,8,B
2018-04-10 10:48:19,13630.0,2,8844,0,13625.0,18,13630.0,8,B
2018-04-10 10:48:22,13630.0,10,8854,0,13625.0,12,13630.0,3,B
2018-04-10 10:48:57,13625.0,2,8856,0,13625.0,18,13630.0,3,S
2018-04-10 10:49:29,13630.0,6,8862,4,13625.0,20,13635.0,19,B
2018-04-10 10:49:35,13630.0,2,8864,2,13625.0,21,13630.0,9,B
2018-04-10 10:50:04,13630.0,2,8866,2,13625.0,20,13630.0,8,B
2018-04-10 10:50:17,13630.0,2,8868,0,13625.0,20,13630.0,7,B
2018-04-10 10:51:16,13630.0,16,8884,16,13625.0,20,13635.0,18,B
2018-04-10 10:51:17,13635.0,10,8894,0,13630.0,13,13635.0,12,B
2018-04-10 10:51:47,13635.0,6,8900,6,13630.0,17,13635.0,9,B
2018-04-10 10:51:48,13635.0,2,8902,2,13630.0,13,13635.0,8,B
2018-04-10 10:51:48,13635.0,16,8918,16,13630.0,13,13640.0,6,B
2018-04-10 10:51:54,13640.0,2,8920,0,13640.0,2,13645.0,14,B
2018-04-10 10:52:57,13640.0,2,8922,-2,13635.0,18,13645.0,5,B
2018-04-10 10:53:13,13640.0,6,8928,-6,13635.0,17,13645.0,3,B
2018-04-10 10:53:14,13645.0,4,8932,2,13640.0,20,13645.0,1,B
2018-04-10 10:53:14,13645.0,2,8934,0,13645.0,1,13650.0,17,B
2018-04-10 10:53:19,13650.0,14,8948,6,13645.0,16,13650.0,5,B
2018-04-10 10:53:20,13650.0,10,8958,10,13645.0,4,13655.0,8,B
2018-04-10 10:53:27,13650.0,2,8960,2,13645.0,8,13655.0,8,B
2018-04-10 10:53:33,13650.0,2,8962,2,13645.0,9,13655.0,8,B
2018-04-10 10:53:42,13655.0,10,8972,4,13655.0,3,13660.0,14,B
2018-04-10 10:53:43,13655.0,6,8978,0,13650.0,1,13655.0,2,B
2018-04-10 10:53:44,13650.0,2,8980,2,13650.0,1,13655.0,1,S
2018-04-10 10:53:47,13655.0,2,8982,-2,13655.0,2,13660.0,11,B
2018-04-10 10:53:54,13655.0,4,8986,-4,13650.0,6,13660.0,6,B
2018-04-10 10:54:06,13650.0,4,8990,-4,13645.0,8,13650.0,2,S
2018-04-10 10:54:18,13640.0,2,8992,0,13640.0,3,13650.0,4,S
2018-04-10 10:54:35,13645.0,6,8998,0,13645.0,5,13650.0,7,B
2018-04-10 10:54:36,13640.0,14,9012,-2,13635.0,3,13640.0,3,S
2018-04-10 10:54:41,13640.0,2,9014,0,13635.0,8,13645.0,8,S
2018-04-10 10:54:44,13640.0,4,9018,0,13635.0,8,13645.0,10,S
2018-04-10 10:55:57,13645.0,2,9020,0,13645.0,4,13650.0,8,B
2018-04-10 10:55:57,13645.0,8,9028,0,13640.0,4,13650.0,9,B
2018-04-10 10:56:07,13640.0,6,9034,-4,13635.0,10,13640.0,1,S
2018-04-10 10:56:39,13635.0,2,9036,0,13635.0,3,13640.0,3,S
2018-04-10 10:56:40,13635.0,2,9038,-2,13635.0,2,13640.0,3,S
2018-04-10 10:56:45,13640.0,4,9042,0,13630.0,10,13640.0,8,B
2018-04-10 10:56:47,13635.0,2,9044,0,13630.0,10,13640.0,8,S
2018-04-10 10:57:17,13635.0,2,9046,0,13635.0,2,13640.0,2,S
2018-04-10 10:57:36,13640.0,4,9050,4,13635.0,3,13640.0,2,B
2018-04-10 10:57:37,13640.0,2,9052,-2,13635.0,4,13640.0,1,B
2018-04-10 10:57:37,13640.0,2,9054,-2,13640.0,1,13645.0,9,B
2018-04-10 10:58:05,13640.0,2,9056,0,13640.0,1,13645.0,9,B
2018-04-10 10:58:25,13640.0,2,9058,0,13635.0,5,13645.0,8,B
2018-04-10 10:58:29,13635.0,4,9062,-4,13635.0,1,13640.0,6,S
2018-04-10 10:58:30,13635.0,2,9064,2,13630.0,30,13640.0,11,S
2018-04-10 10:58:34,13635.0,2,9066,-2,13630.0,27,13635.0,3,S
2018-04-10 10:58:44,13635.0,2,9068,0,13630.0,27,13635.0,3,S
2018-04-10 10:58:51,13635.0,6,9074,-6,13630.0,27,13640.0,3,S
2018-04-10 10:59:04,13635.0,2,9076,0,13635.0,2,13640.0,6,S
2018-04-10 10:59:04,13640.0,2,9078,-2,13635.0,2,13640.0,5,B
2018-04-10 10:59:14,13640.0,8,9086,2,13635.0,8,13645.0,6,B
2018-04-10 10:59:18,13645.0,2,9088,0,13635.0,11,13645.0,2,B
2018-04-10 10:59:36,13640.0,2,9090,2,13635.0,10,13640.0,1,S
2018-04-10 10:59:46,13635.0,4,9094,4,13635.0,1,13640.0,3,S
2018-04-10 10:59:58,13635.0,2,9096,0,13630.0,27,13640.0,8,S
2018-04-10 11:00:14,13640.0,6,9102,-2,13640.0,2,13645.0,8,B
2018-04-10 11:00:15,13640.0,4,9106,-4,13635.0,1,13640.0,4,B
2018-04-10 11:01:04,13635.0,12,9118,-12,13630.0,30,13640.0,5,S
2018-04-10 11:01:06,13635.0,4,9122,-4,13635.0,1,13640.0,4,S
2018-04-10 11:01:07,13635.0,2,9124,-2,13635.0,1,13640.0,4,S
2018-04-10 11:01:19,13635.0,2,9126,2,13630.0,24,13635.0,4,S
2018-04-10 11:01:26,13630.0,6,9132,2,13630.0,21,13635.0,9,S
2018-04-10 11:01:27,13630.0,8,9140,-6,13630.0,17,13635.0,5,S
2018-04-10 11:01:33,13630.0,6,9146,-6,13630.0,14,13635.0,4,S
2018-04-10 11:01:35,13630.0,2,9148,-2,13630.0,13,13635.0,4,S
2018-04-10 11:01:39,13630.0,12,9160,0,13630.0,7,13635.0,4,S
2018-04-10 11:01:43,13630.0,2,9162,0,13630.0,6,13635.0,4,S
2018-04-10 11:01:47,13630.0,4,9166,-4,13630.0,4,13635.0,4,S
2018-04-10 11:01:47,13630.0,8,9174,-2,13625.0,8,13630.0,5,S
2018-04-10 11:01:48,13630.0,4,9178,4,13625.0,6,13630.0,3,S
2018-04-10 11:01:49,13625.0,2,9180,0,13625.0,5,13630.0,6,S
2018-04-10 11:01:51,13630.0,12,9192,12,13630.0,4,13635.0,5,B
2018-04-10 11:01:53,13635.0,8,9200,-2,13635.0,1,13640.0,8,B
2018-04-10 11:01:54,13635.0,2,9202,-2,13630.0,5,13635.0,4,B
2018-04-10 11:02:43,13630.0,14,9216,-6,13625.0,18,13630.0,1,S
2018-04-10 11:02:44,13630.0,4,9220,2,13625.0,21,13630.0,7,S
2018-04-10 11:02:44,13630.0,2,9222,2,13625.0,22,13630.0,6,S
2018-04-10 11:03:01,13630.0,6,9228,6,13625.0,10,13630.0,3,S
2018-04-10 11:03:04,13625.0,2,9230,0,13625.0,9,13630.0,3,S
2018-04-10 11:03:44,13625.0,4,9234,2,13625.0,7,13630.0,5,S
2018-04-10 11:03:45,13625.0,2,9236,-2,13625.0,6,13630.0,5,S
2018-04-10 11:05:22,13630.0,2,9238,2,13625.0,8,13630.0,3,B
2018-04-10 11:05:23,13630.0,2,9240,0,13625.0,6,13630.0,2,B
2018-04-10 11:05:54,13630.0,2,9242,0,13625.0,6,13630.0,1,B
2018-04-10 11:05:54,13630.0,2,9244,2,13625.0,6,13635.0,9,B
2018-04-10 11:08:48,13630.0,10,9254,2,13625.0,12,13635.0,4,B
2018-04-10 11:09:23,13630.0,2,9256,0,13630.0,1,13635.0,27,B
2018-04-10 11:09:26,13630.0,2,9258,-2,13625.0,10,13630.0,1,B
2018-04-10 11:10:55,13635.0,2,9260,0,13630.0,19,13635.0,24,B
2018-04-10 11:10:55,13635.0,28,9288,-12,13630.0,25,13635.0,10,B
2018-04-10 11:10:56,13635.0,2,9290,0,13630.0,13,13635.0,9,B
2018-04-10 11:10:56,13635.0,12,9302,-4,13630.0,13,13635.0,3,B
2018-04-10 11:11:02,13635.0,2,9304,0,13630.0,10,13635.0,2,B
2018-04-10 11:11:02,13635.0,4,9308,-2,13630.0,10,13640.0,9,B
2018-04-10 11:11:03,13640.0,4,9312,0,13630.0,10,13640.0,1,B
2018-04-10 11:11:13,13640.0,2,9314,2,13635.0,2,13640.0,1,B
2018-04-10 11:11:13,13640.0,2,9316,2,13635.0,2,13640.0,1,B
2018-04-10 11:11:16,13640.0,2,9318,2,13635.0,2,13645.0,10,B
2018-04-10 11:11:35,13645.0,2,9320,0,13640.0,4,13645.0,3,B
2018-04-10 11:11:38,13645.0,2,9322,0,13640.0,4,13645.0,2,B
2018-04-10 11:12:19,13640.0,4,9326,4,13640.0,2,13645.0,5,S
2018-04-10 11:12:20,13640.0,2,9328,-2,13635.0,5,13640.0,2,S
2018-04-10 11:13:03,13640.0,4,9332,0,13635.0,4,13645.0,8,S
2018-04-10 11:16:07,13625.0,2,9334,-2,13625.0,3,13630.0,1,S
2018-04-10 11:16:08,13625.0,2,9336,0,13625.0,2,13630.0,3,S
2018-04-10 11:16:09,13625.0,4,9340,0,13620.0,19,13630.0,3,S
2018-04-10 11:16:20,13620.0,8,9348,-4,13615.0,19,13625.0,4,S
2018-04-10 11:16:24,13615.0,2,9350,-2,13615.0,14,13625.0,5,S
2018-04-10 11:16:25,13615.0,4,9354,-4,13615.0,12,13620.0,6,S
2018-04-10 11:16:29,13615.0,10,9364,0,13615.0,8,13620.0,5,S
2018-04-10 11:16:29,13615.0,16,9380,0,13610.0,5,13615.0,7,S
2018-04-10 11:16:35,13610.0,2,9382,-2,13610.0,2,13615.0,3,S
2018-04-10 11:16:39,13610.0,2,9384,0,13610.0,1,13615.0,3,S
2018-04-10 11:16:40,13610.0,2,9386,-2,13610.0,1,13615.0,2,S
2018-04-10 11:16:41,13610.0,2,9388,-2,13605.0,10,13615.0,2,S
2018-04-10 11:16:41,13605.0,4,9392,0,13605.0,10,13615.0,2,S
2018-04-10 11:16:42,13605.0,2,9394,2,13605.0,10,13610.0,3,S
2018-04-10 11:16:42,13605.0,8,9402,-6,13605.0,9,13615.0,3,S
2018-04-10 11:16:44,13610.0,2,9404,-2,13605.0,9,13620.0,4,B
2018-04-10 11:16:45,13610.0,2,9406,-2,13610.0,8,13615.0,10,B
2018-04-10 11:16:46,13610.0,6,9412,-6,13610.0,5,13615.0,8,B
2018-04-10 11:16:48,13615.0,2,9414,0,13610.0,3,13615.0,8,B
2018-04-10 11:16:49,13615.0,12,9426,0,13610.0,3,13615.0,2,B
2018-04-10 11:16:50,13610.0,2,9428,2,13610.0,2,13615.0,1,S
2018-04-10 11:16:50,13615.0,2,9430,2,13610.0,2,13620.0,2,B
2018-04-10 11:16:53,13610.0,6,9436,-2,13605.0,35,13620.0,4,S
2018-04-10 11:16:56,13610.0,6,9442,-6,13610.0,8,13620.0,5,S
2018-04-10 11:17:11,13610.0,2,9444,0,13610.0,9,13620.0,12,S
2018-04-10 11:17:15,13610.0,4,9448,-2,13610.0,7,13620.0,5,S
2018-04-10 11:17:29,13610.0,2,9450,0,13610.0,7,13620.0,4,S
2018-04-10 11:17:34,13620.0,2,9452,2,13610.0,7,13620.0,3,B
2018-04-10 11:18:16,13620.0,2,9454,0,13610.0,9,13620.0,9,B
2018-04-10 11:18:33,13610.0,20,9474,8,13610.0,15,13620.0,7,S
2018-04-10 11:18:34,13615.0,2,9476,-2,13615.0,5,13620.0,7,B
2018-04-10 11:18:37,13615.0,8,9484,2,13610.0,8,13615.0,6,B
2018-04-10 11:18:37,13615.0,10,9494,4,13610.0,8,13615.0,1,B
2018-04-10 11:18:38,13615.0,2,9496,0,13610.0,6,13620.0,2,B
2018-04-10 11:19:37,13620.0,2,9498,-2,13615.0,4,13625.0,5,B
2018-04-10 11:20:22,13620.0,2,9500,-2,13615.0,7,13625.0,21,B
2018-04-10 11:20:33,13620.0,2,9502,0,13615.0,8,13625.0,14,B
2018-04-10 11:20:45,13615.0,6,9508,2,13610.0,8,13620.0,8,S
2018-04-10 11:21:01,13615.0,2,9510,0,13610.0,8,13620.0,3,S
2018-04-10 11:21:49,13615.0,2,9512,0,13610.0,20,13615.0,7,S
2018-04-10 11:22:14,13615.0,12,9524,-12,13610.0,8,13615.0,1,S
2018-04-10 11:22:15,13615.0,2,9526,0,13610.0,8,13620.0,2,S
2018-04-10 11:22:38,13610.0,2,9528,-2,13610.0,6,13615.0,3,S
2018-04-10 11:23:10,13610.0,2,9530,0,13610.0,2,13615.0,4,S
2018-04-10 11:23:11,13605.0,30,9560,-2,13605.0,6,13610.0,3,S
2018-04-10 11:23:11,13605.0,2,9562,2,13600.0,19,13605.0,1,S
2018-04-10 11:23:12,13605.0,2,9564,2,13600.0,19,13610.0,3,S
2018-04-10 11:24:14,13610.0,2,9566,-2,13605.0,18,13615.0,2,B
2018-04-10 11:25:11,13615.0,2,9568,0,13610.0,11,13620.0,19,B
2018-04-10 11:25:25,13615.0,2,9570,0,13610.0,4,13620.0,16,B
2018-04-10 11:25:36,13620.0,2,9572,0,13610.0,5,13620.0,13,B
2018-04-10 11:25:50,13620.0,20,9592,-18,13615.0,5,13620.0,4,B
2018-04-10 11:26:05,13615.0,2,9594,0,13615.0,4,13620.0,5,S
2018-04-10 11:26:07,13620.0,2,9596,-2,13615.0,4,13620.0,4,B
2018-04-10 11:26:15,13615.0,2,9598,0,13615.0,3,13620.0,3,S
2018-04-10 11:26:42,13620.0,4,9602,0,13615.0,21,13620.0,1,B
2018-04-10 11:26:54,13620.0,2,9604,-2,13615.0,7,13625.0,9,B
2018-04-10 11:27:32,13625.0,4,9608,2,13620.0,1,13625.0,1,B
2018-04-10 11:27:33,13620.0,2,9610,0,13620.0,1,13625.0,2,S
2018-04-10 11:27:58,13625.0,2,9612,-2,13620.0,3,13625.0,2,B
2018-04-10 11:28:09,13620.0,4,9616,0,13615.0,8,13620.0,1,S
2018-04-10 11:28:22,13625.0,2,9618,0,13615.0,9,13625.0,5,B
2018-04-10 11:29:17,13625.0,2,9620,0,13620.0,4,13630.0,6,B
2018-04-10 11:29:18,13620.0,2,9622,-2,13620.0,4,13630.0,6,S
2018-04-10 11:29:21,13620.0,2,9624,0,13620.0,4,13630.0,6,S
2018-04-10 11:29:30,13630.0,2,9626,0,13620.0,5,13630.0,5,B
2018-04-10 13:30:02,13625.0,2,9628,0,13620.0,4,13630.0,7,S
2018-04-10 13:31:54,13620.0,2,9630,0,13615.0,8,13620.0,2,S
2018-04-10 13:31:58,13620.0,2,9632,0,13615.0,8,13620.0,1,S
2018-04-10 13:31:59,13615.0,2,9634,0,13615.0,7,13620.0,1,S
2018-04-10 13:32:12,13620.0,2,9636,0,13615.0,15,13620.0,1,B
2018-04-10 13:32:15,13620.0,2,9638,0,13615.0,15,13625.0,7,B
2018-04-10 13:32:24,13625.0,8,9646,8,13615.0,15,13625.0,4,B
2018-04-10 13:32:33,13615.0,2,9648,0,13615.0,15,13620.0,1,S
2018-04-10 13:33:00,13625.0,2,9650,-2,13615.0,17,13625.0,4,B
2018-04-10 13:33:01,13625.0,2,9652,0,13615.0,16,13625.0,3,B
2018-04-10 13:33:27,13620.0,2,9654,2,13620.0,20,13625.0,3,S
2018-04-10 13:33:33,13625.0,2,9656,-2,13620.0,20,13625.0,1,B
2018-04-10 13:33:33,13625.0,6,9662,2,13625.0,19,13630.0,2,B
2018-04-10 13:33:37,13630.0,2,9664,0,13625.0,5,13630.0,1,B
2018-04-10 13:33:51,13625.0,2,9666,2,13625.0,4,13630.0,1,S
2018-04-10 13:33:57,13630.0,2,9668,2,13625.0,14,13635.0,19,B
2018-04-10 13:34:03,13630.0,2,9670,0,13625.0,16,13635.0,16,B
2018-04-10 13:34:29,13625.0,32,9702,32,13620.0,35,13625.0,4,S
2018-04-10 13:34:29,13625.0,8,9710,8,13620.0,37,13630.0,1,S
2018-04-10 13:34:59,13630.0,2,9712,-2,13625.0,12,13630.0,1,B
2018-04-10 13:35:01,13630.0,2,9714,0,13625.0,12,13635.0,14,B
2018-04-10 13:35:13,13635.0,8,9722,8,13635.0,18,13640.0,20,B
2018-04-10 13:35:13,13635.0,36,9758,36,13630.0,2,13635.0,2,B
2018-04-10 13:35:32,13635.0,2,9760,2,13630.0,8,13635.0,1,B
2018-04-10 13:35:34,13635.0,2,9762,0,13630.0,8,13640.0,14,B
2018-04-10 13:35:40,13640.0,6,9768,0,13635.0,1,13640.0,2,B
2018-04-10 13:36:15,13640.0,2,9770,0,13630.0,9,13640.0,2,B
2018-04-10 13:37:29,13640.0,4,9774,-2,13640.0,8,13645.0,14,B
2018-04-10 13:37:40,13640.0,4,9778,0,13635.0,10,13645.0,3,B
2018-04-10 13:37:44,13640.0,2,9780,2,13640.0,1,13645.0,3,B
2018-04-10 13:37:46,13645.0,6,9786,-2,13645.0,3,13650.0,8,B
2018-04-10 13:37:46,13645.0,6,9792,-2,13640.0,2,13645.0,18,B
2018-04-10 13:37:57,13640.0,4,9796,-2,13640.0,7,13645.0,18,S
2018-04-10 13:38:02,13640.0,12,9808,8,13635.0,8,13640.0,12,S
2018-04-10 13:38:02,13640.0,8,9816,8,13635.0,8,13640.0,8,S
2018-04-10 13:38:03,13640.0,10,9826,0,13635.0,5,13640.0,3,S
2018-04-10 13:38:04,13640.0,2,9828,2,13635.0,5,13640.0,2,S
2018-04-10 13:38:08,13640.0,2,9830,2,13635.0,6,13640.0,1,S
2018-04-10 13:38:20,13635.0,14,9844,-4,13630.0,4,13640.0,5,S
2018-04-10 13:39:11,13635.0,20,9864,8,13630.0,6,13640.0,9,S
2018-04-10 13:39:16,13640.0,2,9866,2,13630.0,7,13640.0,6,B
2018-04-10 13:39:29,13640.0,2,9868,2,13635.0,3,13640.0,4,B
2018-04-10 13:39:59,13635.0,2,9870,0,13630.0,7,13635.0,3,S
2018-04-10 13:40:27,13635.0,2,9872,0,13635.0,19,13640.0,17,S
2018-04-10 13:40:34,13640.0,30,9902,22,13640.0,5,13645.0,35,B
2018-04-10 13:40:35,13640.0,10,9912,6,13635.0,19,13640.0,1,B
2018-04-10 13:41:10,13640.0,6,9918,2,13640.0,17,13645.0,28,B
2018-04-10 13:41:18,13645.0,40,9958,30,13640.0,17,13645.0,4,B
2018-04-10 13:41:49,13645.0,14,9972,10,13645.0,13,13650.0,12,B
2018-04-10 13:41:49,13645.0,26,9998,26,13640.0,18,13645.0,15,B
2018-04-10 13:42:06,13645.0,30,10028,30,13645.0,4,13650.0,13,B
2018-04-10 13:42:06,13645.0,2,10030,2,13645.0,3,13650.0,13,B
2018-04-10 13:42:07,13645.0,4,10034,4,13645.0,1,13650.0,13,B
2018-04-10 13:42:07,13645.0,2,10036,2,13640.0,18,13650.0,12,B
2018-04-10 13:42:33,13645.0,2,10038,0,13640.0,18,13650.0,12,B
2018-04-10 13:43:00,13650.0,2,10040,0,13640.0,18,13650.0,11,B
2018-04-10 13:43:00,13650.0,2,10042,0,13640.0,18,13650.0,11,B
2018-04-10 13:43:05,13645.0,2,10044,-2,13640.0,18,13650.0,11,S
2018-04-10 13:43:16,13650.0,2,10046,0,13645.0,2,13650.0,9,B
2018-04-10 13:43:17,13650.0,6,10052,0,13645.0,6,13650.0,1,B
2018-04-10 13:43:17,13650.0,2,10054,0,13645.0,8,13655.0,7,B
2018-04-10 13:43:18,13650.0,2,10056,0,13650.0,1,13655.0,6,B
2018-04-10 13:43:24,13650.0,2,10058,0,13645.0,7,13655.0,6,B
2018-04-10 13:43:25,13660.0,34,10092,16,13645.0,7,13660.0,11,B
2018-04-10 13:43:33,13660.0,2,10094,2,13650.0,6,13660.0,16,B
2018-04-10 13:43:34,13655.0,2,10096,0,13650.0,3,13655.0,21,S
2018-04-10 13:43:35,13655.0,2,10098,2,13650.0,3,13655.0,19,S
2018-04-10 13:43:38,13650.0,2,10100,0,13645.0,4,13650.0,2,S
2018-04-10 13:43:38,13650.0,4,10104,4,13645.0,6,13655.0,22,S
2018-04-10 13:43:41,13655.0,2,10106,2,13645.0,6,13655.0,21,B
2018-04-10 13:43:44,13655.0,4,10110,4,13645.0,5,13655.0,20,B
2018-04-10 13:43:46,13645.0,26,10136,8,13640.0,16,13645.0,3,S
2018-04-10 13:43:46,13645.0,6,10142,0,13645.0,11,13650.0,1,S
2018-04-10 13:43:47,13650.0,2,10144,-2,13645.0,3,13655.0,5,B
2018-04-10 13:43:51,13655.0,2,10146,2,13650.0,1,13655.0,4,B
2018-04-10 13:43:54,13650.0,2,10148,0,13645.0,3,13655.0,7,S
2018-04-10 13:43:55,13650.0,2,10150,0,13645.0,1,13650.0,3,S
2018-04-10 13:43:58,13650.0,2,10152,2,13645.0,1,13650.0,2,S
2018-04-10 13:44:20,13650.0,2,10154,-2,13645.0,4,13650.0,1,S
2018-04-10 13:44:29,13650.0,12,10166,12,13645.0,4,13650.0,1,S
2018-04-10 13:44:42,13655.0,2,10168,2,13645.0,5,13655.0,7,B
2018-04-10 13:44:53,13655.0,2,10170,2,13650.0,3,13655.0,3,B
2018-04-10 13:44:55,13655.0,2,10172,0,13650.0,3,13655.0,2,B
2018-04-10 13:45:10,13655.0,6,10178,2,13655.0,1,13660.0,10,B
2018-04-10 13:45:11,13655.0,2,10180,0,13650.0,3,13655.0,1,B
2018-04-10 13:45:12,13655.0,2,10182,-2,13650.0,3,13660.0,13,B
2018-04-10 13:46:48,13655.0,2,10184,0,13655.0,14,13660.0,11,B
2018-04-10 13:46:48,13655.0,2,10186,0,13655.0,13,13660.0,13,B
2018-04-10 13:46:49,13655.0,8,10194,4,13655.0,9,13660.0,14,B
2018-04-10 13:46:50,13655.0,18,10212,18,13650.0,2,13655.0,14,B
2018-04-10 13:47:42,13655.0,4,10216,-2,13645.0,3,13655.0,16,B
2018-04-10 13:47:45,13655.0,2,10218,2,13645.0,3,13655.0,15,B
2018-04-10 13:48:00,13640.0,2,10220,0,13640.0,4,13650.0,11,S
2018-04-10 13:48:07,13645.0,4,10224,0,13645.0,1,13650.0,8,B
2018-04-10 13:48:38,13645.0,4,10228,0,13640.0,17,13650.0,8,B
2018-04-10 13:48:41,13645.0,2,10230,0,13640.0,17,13645.0,4,B
2018-04-10 13:48:42,13645.0,8,10238,-4,13645.0,1,13650.0,1,B
2018-04-10 13:49:16,13645.0,2,10240,-2,13640.0,5,13650.0,6,B
2018-04-10 13:49:20,13640.0,2,10242,0,13640.0,4,13650.0,5,S
2018-04-10 13:49:47,13640.0,18,10260,4,13635.0,17,13640.0,4,S
2018-04-10 13:49:47,13635.0,6,10266,2,13635.0,6,13640.0,2,S
2018-04-10 13:49:48,13640.0,4,10270,4,13640.0,4,13645.0,2,B
2018-04-10 13:51:10,13640.0,2,10272,0,13640.0,1,13645.0,3,B
2018-04-10 13:51:34,13640.0,4,10276,-2,13635.0,4,13645.0,6,B
2018-04-10 13:51:42,13635.0,2,10278,0,13635.0,2,13640.0,1,S
2018-04-10 13:53:12,13640.0,2,10280,0,13635.0,3,13640.0,2,B
2018-04-10 13:53:57,13635.0,2,10282,2,13635.0,3,13640.0,4,S
2018-04-10 13:53:58,13635.0,2,10284,0,13635.0,2,13640.0,4,S
2018-04-10 13:54:18,13640.0,2,10286,-2,13640.0,4,13645.0,5,B
2018-04-10 13:54:22,13640.0,2,10288,-2,13640.0,3,13645.0,4,B
2018-04-10 13:54:22,13640.0,6,10294,0,13635.0,3,13640.0,1,B
2018-04-10 13:55:15,13635.0,2,10296,0,13635.0,1,13640.0,3,S
2018-04-10 13:55:28,13640.0,2,10298,0,13640.0,1,13645.0,3,B
2018-04-10 13:55:28,13640.0,2,10300,0,13640.0,1,13645.0,3,B
2018-04-10 13:55:46,13640.0,2,10302,0,13635.0,6,13645.0,3,B
2018-04-10 13:55:59,13640.0,2,10304,2,13640.0,2,13645.0,2,B
2018-04-10 13:56:21,13645.0,4,10308,2,13645.0,2,13650.0,5,B
2018-04-10 13:56:56,13645.0,2,10310,0,13640.0,6,13645.0,4,B
2018-04-10 13:56:56,13645.0,6,10316,0,13640.0,18,13645.0,1,B
2018-04-10 13:56:57,13645.0,2,10318,0,13640.0,17,13650.0,7,B
2018-04-10 13:57:21,13650.0,10,10328,8,13645.0,2,13650.0,4,B
2018-04-10 13:57:21,13650.0,4,10332,-4,13645.0,2,13655.0,6,B
2018-04-10 13:57:26,13645.0,2,10334,0,13645.0,2,13655.0,5,S
2018-04-10 13:57:28,13650.0,2,10336,0,13645.0,2,13655.0,5,B
2018-04-10 13:57:46,13650.0,8,10344,0,13650.0,1,13655.0,8,B
2018-04-10 13:57:49,13650.0,2,10346,0,13645.0,2,13650.0,1,B
2018-04-10 13:58:25,13650.0,4,10350,2,13645.0,5,13655.0,10,B
2018-04-10 13:58:34,13655.0,2,10352,-2,13645.0,5,13655.0,9,B
2018-04-10 13:58:55,13650.0,12,10364,12,13645.0,3,13650.0,2,S
2018-04-10 13:59:19,13650.0,2,10366,2,13650.0,1,13655.0,8,S
2018-04-10 13:59:19,13650.0,2,10368,2,13645.0,3,13655.0,10,S
2018-04-10 13:59:29,13655.0,8,10376,4,13650.0,11,13655.0,1,B
2018-04-10 13:59:30,13655.0,2,10378,0,13650.0,12,13660.0,7,B
2018-04-10 14:00:01,13655.0,4,10382,4,13650.0,9,13655.0,2,B
2018-04-10 14:00:02,13655.0,4,10386,2,13655.0,3,13660.0,9,B
2018-04-10 14:00:48,13650.0,2,10388,0,13645.0,15,13655.0,3,S
2018-04-10 14:01:01,13655.0,6,10394,-4,13650.0,12,13655.0,4,B
2018-04-10 14:01:03,13650.0,4,10398,0,13650.0,2,13655.0,1,S
2018-04-10 14:01:05,13650.0,2,10400,-2,13645.0,3,13655.0,13,S
2018-04-10 14:01:52,13650.0,2,10402,0,13650.0,2,13655.0,2,S
2018-04-10 14:02:23,13650.0,2,10404,0,13650.0,1,13655.0,2,S
2018-04-10 14:02:28,13655.0,4,10408,2,13655.0,7,13660.0,9,B
2018-04-10 14:02:28,13655.0,2,10410,0,13655.0,1,13660.0,5,B
2018-04-10 14:02:29,13660.0,2,10412,0,13655.0,3,13660.0,4,B
2018-04-10 14:02:29,13660.0,2,10414,-2,13655.0,22,13660.0,3,B
2018-04-10 14:02:30,13660.0,2,10416,2,13655.0,22,13660.0,2,B
2018-04-10 14:02:33,13660.0,4,10420,4,13655.0,16,13665.0,8,B
2018-04-10 14:02:39,13660.0,2,10422,2,13660.0,6,13665.0,7,B
2018-04-10 14:02:43,13665.0,4,10426,2,13665.0,8,13670.0,11,B
2018-04-10 14:02:52,13670.0,14,10440,8,13665.0,12,13670.0,1,B
2018-04-10 14:02:53,13670.0,2,10442,0,13670.0,25,13675.0,16,B
2018-04-10 14:02:54,13675.0,16,10458,12,13670.0,22,13675.0,4,B
2018-04-10 14:02:54,13675.0,2,10460,2,13670.0,19,13675.0,3,B
2018-04-10 14:02:59,13670.0,20,10480,0,13670.0,5,13675.0,4,S
2018-04-10 14:03:02,13675.0,2,10482,2,13670.0,6,13675.0,2,B
2018-04-10 14:03:05,13675.0,6,10488,-2,13675.0,3,13680.0,12,B
2018-04-10 14:03:06,13680.0,4,10492,0,13675.0,4,13680.0,9,B
2018-04-10 14:03:07,13680.0,6,10498,0,13675.0,16,13680.0,6,B
2018-04-10 14:03:07,13680.0,10,10508,8,13675.0,16,13680.0,1,B
2018-04-10 14:03:11,13680.0,2,10510,0,13675.0,4,13685.0,3,B
2018-04-10 14:03:12,13685.0,18,10528,-14,13675.0,4,13685.0,3,B
2018-04-10 14:03:12,13685.0,10,10538,4,13685.0,3,13690.0,12,B
2018-04-10 14:03:13,13685.0,6,10544,4,13680.0,2,13685.0,2,B
2018-04-10 14:03:14,13680.0,2,10546,0,13675.0,5,13680.0,2,S
2018-04-10 14:03:15,13675.0,4,10550,-4,13675.0,1,13680.0,7,S
2018-04-10 14:03:16,13680.0,2,10552,0,13675.0,1,13680.0,6,B
2018-04-10 14:03:23,13680.0,2,10554,2,13680.0,2,13685.0,1,B
2018-04-10 14:03:28,13685.0,2,10556,0,13680.0,3,13685.0,3,B
2018-04-10 14:03:29,13685.0,4,10560,4,13680.0,3,13685.0,1,B
2018-04-10 14:03:33,13680.0,6,10566,6,13675.0,21,13685.0,2,S
2018-04-10 14:03:35,13685.0,6,10572,4,13680.0,11,13690.0,11,B
2018-04-10 14:03:39,13680.0,2,10574,0,13680.0,6,13690.0,7,S
2018-04-10 14:03:40,13690.0,2,10576,0,13680.0,6,13690.0,6,B
2018-04-10 14:03:44,13685.0,2,10578,0,13680.0,6,13690.0,6,S
2018-04-10 14:03:45,13690.0,2,10580,2,13680.0,6,13690.0,5,B
2018-04-10 14:03:47,13690.0,4,10584,0,13680.0,6,13690.0,4,B
2018-04-10 14:03:50,13690.0,4,10588,4,13680.0,6,13690.0,3,B
2018-04-10 14:03:54,13685.0,2,10590,0,13680.0,1,13685.0,4,S
2018-04-10 14:03:58,13685.0,2,10592,0,13680.0,1,13685.0,3,S
2018-04-10 14:04:00,13680.0,2,10594,-2,13675.0,2,13685.0,4,S
2018-04-10 14:04:08,13675.0,2,10596,-2,13675.0,2,13680.0,2,S
2018-04-10 14:04:08,13675.0,2,10598,0,13665.0,26,13680.0,6,S
2018-04-10 14:04:09,13670.0,2,10600,2,13670.0,5,13675.0,21,S
2018-04-10 14:04:10,13670.0,2,10602,-2,13670.0,6,13675.0,21,S
2018-04-10 14:04:10,13670.0,2,10604,2,13670.0,5,13675.0,21,S
2018-04-10 14:04:14,13675.0,6,10610,2,13670.0,3,13675.0,20,B
2018-04-10 14:04:17,13670.0,6,10616,-2,13665.0,15,13675.0,20,S
2018-04-10 14:04:40,13670.0,2,10618,0,13665.0,5,13670.0,1,S
2018-04-10 14:04:48,13670.0,6,10624,0,13665.0,18,13670.0,14,S
2018-04-10 14:04:49,13670.0,16,10640,-4,13670.0,2,13675.0,3,S
2018-04-10 14:04:51,13670.0,2,10642,2,13670.0,1,13675.0,5,S
2018-04-10 14:04:53,13675.0,2,10644,0,13670.0,2,13675.0,3,B
2018-04-10 14:05:00,13675.0,4,10648,0,13670.0,1,13675.0,3,B
2018-04-10 14:05:11,13675.0,18,10666,0,13675.0,6,13680.0,4,B
2018-04-10 14:05:12,13675.0,10,10676,8,13670.0,4,13680.0,9,B
2018-04-10 14:05:16,13675.0,4,10680,0,13675.0,1,13680.0,6,B
2018-04-10 14:05:18,13675.0,2,10682,2,13670.0,8,13680.0,8,B
2018-04-10 14:05:23,13675.0,2,10684,2,13670.0,2,13675.0,1,B
2018-04-10 14:05:30,13665.0,2,10686,2,13665.0,3,13675.0,18,S
2018-04-10 14:05:42,13670.0,8,10694,0,13670.0,1,13680.0,10,B
2018-04-10 14:05:47,13670.0,4,10698,4,13665.0,23,13675.0,2,B
2018-04-10 14:05:52,13665.0,2,10700,2,13665.0,20,13675.0,5,S
2018-04-10 14:06:24,13670.0,8,10708,2,13670.0,7,13675.0,5,B
2018-04-10 14:06:25,13670.0,4,10712,-4,13670.0,2,13675.0,6,B
2018-04-10 14:06:26,13670.0,4,10716,-4,13665.0,7,13675.0,6,B
2018-04-10 14:06:41,13670.0,6,10722,0,13665.0,12,13675.0,10,B
2018-04-10 14:06:55,13665.0,2,10724,-2,13665.0,9,13670.0,11,S
2018-04-10 14:06:56,13665.0,18,10742,4,13660.0,10,13670.0,9,S
2018-04-10 14:07:02,13660.0,10,10752,2,13660.0,10,13670.0,2,S
2018-04-10 14:07:04,13665.0,2,10754,-2,13660.0,11,13665.0,7,B
2018-04-10 14:07:21,13660.0,2,10756,0,13660.0,9,13665.0,8,S
2018-04-10 14:07:21,13660.0,8,10764,6,13660.0,5,13665.0,8,S
2018-04-10 14:07:22,13660.0,10,10774,-2,13655.0,3,13660.0,1,S
2018-04-10 14:07:31,13665.0,2,10776,0,13660.0,8,13665.0,7,B
2018-04-10 14:07:31,13660.0,30,10806,14,13660.0,18,13670.0,8,S
2018-04-10 14:07:33,13665.0,6,10812,6,13665.0,1,13670.0,2,B
2018-04-10 14:07:34,13670.0,2,10814,-2,13665.0,2,13670.0,3,B
2018-04-10 14:07:50,13665.0,2,10816,0,13660.0,19,13670.0,3,S
2018-04-10 14:08:36,13665.0,4,10820,4,13665.0,3,13670.0,7,S
2018-04-10 14:08:39,13665.0,2,10822,0,13665.0,2,13670.0,7,S
2018-04-10 14:08:40,13665.0,4,10826,4,13660.0,2,13670.0,7,S
2018-04-10 14:08:44,13660.0,2,10828,0,13655.0,5,13665.0,6,S
2018-04-10 14:08:58,13660.0,2,10830,-2,13655.0,4,13665.0,7,S
2018-04-10 14:09:08,13660.0,4,10834,4,13655.0,4,13665.0,5,S
2018-04-10 14:09:10,13655.0,6,10840,0,13650.0,5,13660.0,22,S
2018-04-10 14:09:11,13650.0,4,10844,-2,13650.0,2,13655.0,3,S
2018-04-10 14:09:12,13655.0,6,10850,0,13650.0,1,13655.0,17,B
2018-04-10 14:09:14,13650.0,2,10852,-2,13645.0,21,13655.0,17,S
2018-04-10 14:09:16,13650.0,2,10854,-2,13645.0,7,13655.0,17,S
2018-04-10 14:09:23,13645.0,4,10858,-2,13645.0,2,13655.0,20,S
2018-04-10 14:09:33,13645.0,2,10860,0,13645.0,5,13655.0,20,S
2018-04-10 14:09:50,13650.0,2,10862,0,13645.0,4,13650.0,7,B
2018-04-10 14:09:51,13650.0,6,10868,0,13645.0,4,13650.0,4,B
2018-04-10 14:09:54,13650.0,4,10872,0,13645.0,20,13650.0,2,B
2018-04-10 14:09:54,13650.0,4,10876,4,13645.0,8,13655.0,2,B
2018-04-10 14:10:02,13650.0,4,10880,0,13645.0,9,13655.0,2,B
2018-04-10 14:10:03,13650.0,2,10882,0,13645.0,9,13655.0,2,B
2018-04-10 14:10:14,13645.0,10,10892,0,13640.0,8,13645.0,2,S
2018-04-10 14:10:15,13640.0,2,10894,-2,13640.0,2,13645.0,11,S
2018-04-10 14:10:19,13645.0,6,10900,-4,13640.0,3,13645.0,6,B
2018-04-10 14:10:20,13645.0,6,10906,6,13640.0,3,13645.0,3,B
2018-04-10 14:10:24,13640.0,4,10910,4,13635.0,8,13640.0,18,S
2018-04-10 14:10:25,13640.0,2,10912,0,13635.0,7,13640.0,18,S
2018-04-10 14:10:27,13635.0,12,10924,2,13630.0,67,13635.0,13,S
2018-04-10 14:10:27,13630.0,2,10926,-2,13630.0,62,13635.0,30,S
2018-04-10 14:10:28,13635.0,12,10938,8,13630.0,60,13635.0,19,B
2018-04-10 14:10:30,13635.0,2,10940,2,13630.0,60,13635.0,8,B
2018-04-10 14:10:32,13635.0,2,10942,0,13630.0,60,13635.0,7,B
2018-04-10 14:10:33,13635.0,2,10944,2,13630.0,60,13635.0,6,B
2018-04-10 14:10:35,13635.0,8,10952,6,13630.0,60,13640.0,10,B
2018-04-10 14:10:37,13635.0,2,10954,0,13630.0,63,13640.0,3,B
2018-04-10 14:10:43,13635.0,2,10956,2,13630.0,63,13640.0,2,B
2018-04-10 14:10:47,13635.0,2,10958,-2,13635.0,1,13640.0,3,B
2018-04-10 14:11:09,13635.0,2,10960,0,13630.0,60,13635.0,2,B
2018-04-10 14:11:11,13630.0,12,10972,0,13630.0,54,13635.0,1,S
2018-04-10 14:11:11,13635.0,2,10974,-2,13630.0,54,13640.0,7,B
2018-04-10 14:11:18,13635.0,4,10978,2,13630.0,54,13640.0,11,B
2018-04-10 14:11:32,13630.0,2,10980,0,13630.0,53,13640.0,9,S
2018-04-10 14:11:35,13635.0,2,10982,2,13630.0,53,13635.0,8,B
2018-04-10 14:11:36,13635.0,16,10998,-8,13635.0,3,13640.0,12,B
2018-04-10 14:11:41,13635.0,2,11000,0,13635.0,11,13640.0,4,B
2018-04-10 14:11:42,13635.0,2,11002,-2,13635.0,8,13640.0,2,B
2018-04-10 14:11:44,13635.0,2,11004,0,13635.0,7,13640.0,5,B
2018-04-10 14:11:50,13635.0,2,11006,-2,13635.0,6,13640.0,3,B
2018-04-10 14:11:55,13640.0,2,11008,0,13635.0,6,13640.0,2,B
2018-04-10 14:11:57,13640.0,2,11010,2,13635.0,6,13640.0,1,B
2018-04-10 14:12:02,13640.0,2,11012,0,13635.0,6,13645.0,9,B
2018-04-10 14:12:07,13635.0,2,11014,-2,13635.0,5,13640.0,1,S
2018-04-10 14:12:07,13640.0,2,11016,0,13640.0,1,13645.0,11,B
2018-04-10 14:12:08,13640.0,2,11018,0,13635.0,2,13645.0,11,B
2018-04-10 14:12:12,13640.0,2,11020,0,13640.0,1,13645.0,11,B
2018-04-10 14:12:14,13645.0,2,11022,0,13640.0,1,13645.0,10,B
2018-04-10 14:12:18,13640.0,2,11024,-2,13635.0,3,13645.0,11,S
2018-04-10 14:12:21,13645.0,2,11026,2,13635.0,3,13645.0,10,B
2018-04-10 14:12:28,13640.0,2,11028,0,13635.0,3,13645.0,11,S
2018-04-10 14:12:56,13640.0,2,11030,-2,13635.0,3,13645.0,12,S
2018-04-10 14:12:58,13640.0,2,11032,0,13635.0,3,13645.0,12,S
2018-04-10 14:13:15,13635.0,2,11034,2,13635.0,1,13640.0,6,S
2018-04-10 14:13:16,13635.0,2,11036,2,13630.0,59,13635.0,19,S
2018-04-10 14:13:18,13635.0,8,11044,-6,13635.0,1,13640.0,9,S
2018-04-10 14:13:26,13635.0,2,11046,-2,13635.0,11,13640.0,10,S
2018-04-10 14:13:29,13635.0,10,11056,-4,13635.0,1,13640.0,10,S
2018-04-10 14:13:30,13635.0,2,11058,0,13630.0,54,13635.0,23,S
2018-04-10 14:13:40,13630.0,14,11072,14,13630.0,47,13635.0,25,S
2018-04-10 14:13:41,13630.0,4,11076,0,13630.0,45,13635.0,25,S
2018-04-10 14:13:44,13630.0,40,11116,40,13630.0,25,13635.0,6,S
2018-04-10 14:13:45,13630.0,2,11118,0,13630.0,24,13635.0,6,S
2018-04-10 14:13:47,13635.0,10,11128,2,13630.0,24,13640.0,7,B
2018-04-10 14:13:48,13640.0,4,11132,-2,13635.0,8,13645.0,27,B
2018-04-10 14:13:50,13635.0,2,11134,-2,13630.0,27,13640.0,27,S
2018-04-10 14:13:54,13635.0,2,11136,-2,13630.0,32,13640.0,14,S
2018-04-10 14:13:56,13635.0,2,11138,-2,13635.0,4,13640.0,3,S
2018-04-10 14:14:00,13635.0,2,11140,-2,13635.0,2,13640.0,8,S
2018-04-10 14:14:01,13635.0,2,11142,-2,13630.0,32,13640.0,8,S
2018-04-10 14:14:10,13635.0,2,11144,0,13635.0,1,13640.0,12,S
2018-04-10 14:14:27,13640.0,18,11162,-14,13635.0,14,13645.0,27,B
2018-04-10 14:14:32,13635.0,2,11164,2,13635.0,13,13645.0,20,S
2018-04-10 14:14:35,13635.0,2,11166,0,13635.0,12,13645.0,20,S
2018-04-10 14:15:08,13645.0,10,11176,10,13640.0,5,13645.0,14,B
2018-04-10 14:15:42,13640.0,2,11178,2,13640.0,6,13645.0,15,S
2018-04-10 14:16:23,13640.0,8,11186,8,13640.0,3,13645.0,15,S
2018-04-10 14:16:23,13640.0,6,11192,-2,13635.0,12,13645.0,16,S
2018-04-10 14:16:42,13635.0,2,11194,-2,13635.0,13,13645.0,18,S
2018-04-10 14:17:17,13635.0,2,11196,-2,13635.0,11,13640.0,1,S
2018-04-10 14:17:54,13635.0,2,11198,0,13635.0,10,13640.0,1,S
2018-04-10 14:17:55,13635.0,20,11218,-14,13630.0,31,13635.0,2,S
2018-04-10 14:17:56,13635.0,4,11222,-4,13635.0,3,13640.0,2,S
2018-04-10 14:18:37,13640.0,8,11230,-6,13635.0,9,13645.0,17,B
2018-04-10 14:18:38,13645.0,4,11234,0,13640.0,2,13645.0,14,B
2018-04-10 14:18:51,13645.0,10,11244,10,13640.0,1,13645.0,9,B
2018-04-10 14:20:37,13640.0,6,11250,6,13635.0,6,13640.0,4,S
2018-04-10 14:20:38,13640.0,8,11258,0,13640.0,1,13645.0,15,S
2018-04-10 14:20:45,13635.0,2,11260,-2,13635.0,18,13645.0,15,S
2018-04-10 14:20:52,13640.0,2,11262,0,13635.0,18,13640.0,2,B
2018-04-10 14:22:50,13635.0,8,11270,4,13630.0,17,13640.0,4,S
2018-04-10 14:22:59,13635.0,4,11274,0,13630.0,45,13640.0,7,S
2018-04-10 14:23:01,13635.0,2,11276,0,13635.0,2,13640.0,7,S
2018-04-10 14:23:32,13640.0,2,11278,-2,13635.0,7,13640.0,6,B
2018-04-10 14:24:04,13635.0,14,11292,-2,13630.0,21,13640.0,8,S
2018-04-10 14:24:46,13635.0,2,11294,0,13630.0,15,13640.0,11,S
2018-04-10 14:25:05,13630.0,2,11296,0,13630.0,16,13640.0,11,S
2018-04-10 14:25:08,13635.0,2,11298,2,13635.0,12,13640.0,8,B
2018-04-10 14:25:12,13635.0,2,11300,0,13635.0,10,13640.0,8,B
2018-04-10 14:25:25,13635.0,2,11302,0,13630.0,45,13640.0,8,B
2018-04-10 14:25:31,13635.0,2,11304,0,13630.0,21,13640.0,10,B
2018-04-10 14:25:43,13635.0,2,11306,0,13630.0,18,13640.0,12,B
2018-04-10 14:25:47,13635.0,2,11308,0,13630.0,18,13640.0,12,B
2018-04-10 14:25:54,13635.0,4,11312,0,13630.0,14,13640.0,9,B
2018-04-10 14:26:17,13630.0,2,11314,0,13630.0,13,13635.0,2,S
2018-04-10 14:26:26,13630.0,4,11318,4,13630.0,11,13635.0,1,S
2018-04-10 14:26:28,13630.0,2,11320,0,13630.0,10,13635.0,1,S
2018-04-10 14:26:40,13635.0,2,11322,-2,13630.0,10,13635.0,1,B
2018-04-10 14:28:46,13635.0,14,11336,8,13635.0,2,13640.0,5,B
2018-04-10 14:29:15,13635.0,2,11338,2,13635.0,6,13640.0,5,B
2018-04-10 14:30:07,13640.0,2,11340,0,13635.0,5,13640.0,4,B
2018-04-10 14:30:10,13640.0,8,11348,-2,13635.0,21,13645.0,14,B
2018-04-10 14:30:30,13645.0,10,11358,10,13640.0,1,13645.0,5,B
2018-04-10 14:30:52,13645.0,2,11360,2,13640.0,4,13645.0,3,B
2018-04-10 14:31:01,13645.0,6,11366,-2,13645.0,17,13650.0,10,B
2018-04-10 14:31:03,13650.0,8,11374,-2,13645.0,22,13655.0,21,B
2018-04-10 14:31:04,13650.0,2,11376,0,13645.0,22,13655.0,22,B
2018-04-10 14:31:05,13650.0,4,11380,4,13645.0,22,13655.0,22,B
2018-04-10 14:31:14,13645.0,2,11382,0,13645.0,21,13650.0,1,S
2018-04-10 14:31:44,13655.0,10,11392,10,13645.0,18,13655.0,18,B
2018-04-10 14:32:12,13650.0,8,11400,0,13645.0,18,13655.0,18,S
2018-04-10 14:34:04,13645.0,32,11432,-2,13640.0,5,13645.0,6,S
2018-04-10 14:34:34,13645.0,6,11438,0,13640.0,4,13645.0,3,S
2018-04-10 14:34:41,13640.0,2,11440,2,13640.0,1,13645.0,3,S
2018-04-10 14:34:48,13640.0,2,11442,0,13635.0,3,13640.0,1,S
2018-04-10 14:34:51,13635.0,2,11444,0,13635.0,3,13640.0,1,S
2018-04-10 14:34:55,13640.0,2,11446,2,13635.0,3,13645.0,4,B
2018-04-10 14:35:45,13635.0,2,11448,0,13635.0,1,13645.0,4,S
2018-04-10 14:35:48,13640.0,2,11450,-2,13635.0,1,13645.0,5,B
2018-04-10 14:38:30,13635.0,2,11452,2,13630.0,17,13640.0,3,S
2018-04-10 14:38:50,13635.0,2,11454,-2,13630.0,16,13640.0,17,S
2018-04-10 14:40:09,13640.0,2,11456,-2,13640.0,1,13645.0,9,B
2018-04-10 14:40:10,13640.0,2,11458,-2,13635.0,3,13640.0,1,B
2018-04-10 14:40:51,13640.0,4,11462,0,13635.0,21,13640.0,1,B
2018-04-10 14:40:52,13640.0,2,11464,0,13635.0,21,13645.0,2,B
2018-04-10 14:41:14,13645.0,2,11466,0,13640.0,1,13645.0,2,B
2018-04-10 14:41:24,13640.0,2,11468,2,13635.0,21,13645.0,4,S
2018-04-10 14:41:31,13635.0,8,11476,0,13630.0,14,13640.0,3,S
2018-04-10 14:42:45,13635.0,4,11480,2,13635.0,1,13640.0,6,S
2018-04-10 14:45:55,13635.0,4,11484,4,13635.0,2,13640.0,3,S
2018-04-10 14:46:16,13645.0,4,11488,0,13635.0,3,13645.0,8,B
2018-04-10 14:46:20,13640.0,2,11490,0,13635.0,3,13645.0,10,S
2018-04-10 14:46:36,13640.0,2,11492,-2,13640.0,1,13645.0,7,S
2018-04-10 14:46:37,13640.0,2,11494,-2,13635.0,3,13645.0,7,S
2018-04-10 14:46:48,13640.0,2,11496,2,13635.0,3,13645.0,6,S
2018-04-10 14:47:31,13640.0,2,11498,0,13635.0,5,13645.0,7,S
2018-04-10 14:48:59,13640.0,2,11500,2,13640.0,4,13645.0,7,S
2018-04-10 14:49:01,13640.0,4,11504,4,13640.0,2,13645.0,11,S
2018-04-10 14:49:12,13640.0,4,11508,0,13635.0,6,13645.0,9,S
2018-04-10 14:49:18,13635.0,6,11514,-4,13635.0,3,13645.0,8,S
2018-04-10 14:49:25,13640.0,4,11518,0,13640.0,3,13645.0,7,B
2018-04-10 14:50:15,13640.0,4,11522,-2,13640.0,5,13645.0,6,B
2018-04-10 14:50:25,13645.0,2,11524,0,13640.0,6,13645.0,5,B
2018-04-10 14:50:53,13640.0,2,11526,0,13640.0,6,13645.0,5,S
2018-04-10 14:51:13,13645.0,2,11528,0,13640.0,6,13645.0,4,B
2018-04-10 14:51:21,13645.0,4,11532,-4,13640.0,6,13645.0,2,B
2018-04-10 14:51:56,13645.0,2,11534,2,13640.0,6,13650.0,9,B
2018-04-10 14:52:05,13640.0,12,11546,10,13635.0,110,13640.0,14,S
2018-04-10 14:52:16,13640.0,2,11548,0,13635.0,107,13640.0,14,S
2018-04-10 14:52:34,13635.0,26,11574,24,13635.0,94,13640.0,1,S
2018-04-10 14:52:48,13640.0,2,11576,0,13635.0,94,13645.0,4,B
2018-04-10 14:53:01,13640.0,2,11578,0,13640.0,10,13645.0,6,B
2018-04-10 14:53:02,13640.0,12,11590,-6,13640.0,4,13645.0,4,B
2018-04-10 14:53:03,13640.0,6,11596,-6,13640.0,1,13645.0,4,B
2018-04-10 14:53:03,13640.0,2,11598,-2,13635.0,95,13645.0,4,B
2018-04-10 14:53:59,13635.0,40,11638,40,13635.0,75,13640.0,16,S
2018-04-10 14:54:00,13635.0,14,11652,12,13635.0,68,13640.0,4,S
2018-04-10 14:54:00,13635.0,32,11684,20,13635.0,52,13640.0,4,S
2018-04-10 14:54:01,13635.0,14,11698,8,13635.0,45,13640.0,4,S
2018-04-10 14:54:03,13635.0,26,11724,26,13635.0,32,13640.0,16,S
2018-04-10 14:54:04,13635.0,56,11780,32,13635.0,4,13640.0,28,S
2018-04-10 14:54:04,13635.0,8,11788,6,13630.0,26,13635.0,2,S
2018-04-10 14:54:05,13630.0,2,11790,0,13630.0,25,13635.0,1,S
2018-04-10 14:54:05,13635.0,2,11792,0,13630.0,24,13640.0,3,B
2018-04-10 14:54:08,13630.0,4,11796,0,13630.0,19,13640.0,16,S
2018-04-10 14:54:13,13635.0,2,11798,-2,13635.0,1,13640.0,4,B
2018-04-10 14:54:22,13635.0,2,11800,-2,13630.0,20,13640.0,6,B
2018-04-10 14:54:28,13635.0,8,11808,2,13635.0,2,13640.0,6,B
2018-04-10 14:54:33,13635.0,2,11810,-2,13635.0,8,13645.0,4,B
2018-04-10 14:55:06,13635.0,46,11856,12,13630.0,21,13635.0,7,B
2018-04-10 14:55:09,13635.0,2,11858,0,13630.0,22,13635.0,6,B
2018-04-10 14:55:15,13630.0,2,11860,0,13630.0,18,13635.0,7,S
2018-04-10 14:55:34,13630.0,20,11880,-2,13630.0,8,13635.0,6,S
2018-04-10 14:55:35,13630.0,2,11882,0,13630.0,7,13635.0,8,S
2018-04-10 14:55:35,13630.0,14,11896,6,13625.0,25,13630.0,2,S
2018-04-10 14:55:43,13630.0,4,11900,-2,13625.0,22,13630.0,1,S
2018-04-10 14:55:51,13625.0,2,11902,-2,13625.0,21,13630.0,4,S
2018-04-10 14:55:51,13625.0,4,11906,-4,13625.0,20,13630.0,3,S
2018-04-10 14:55:53,13625.0,18,11924,0,13625.0,11,13630.0,3,S
2018-04-10 14:55:53,13625.0,22,11946,18,13620.0,4,13625.0,8,S
2018-04-10 14:55:55,13620.0,2,11948,0,13620.0,3,13625.0,1,S
2018-04-10 14:56:07,13625.0,2,11950,2,13620.0,6,13630.0,2,B
2018-04-10 14:56:31,13625.0,2,11952,-2,13620.0,9,13630.0,14,B
2018-04-10 14:56:43,13625.0,2,11954,-2,13625.0,7,13630.0,12,B
2018-04-10 14:57:00,13625.0,2,11956,0,13625.0,5,13630.0,12,B
2018-04-10 14:57:00,13625.0,4,11960,0,13625.0,3,13630.0,12,B
2018-04-10 14:57:01,13625.0,4,11964,0,13625.0,1,13630.0,12,B
2018-04-10 14:57:01,13625.0,2,11966,0,13620.0,9,13630.0,12,B
2018-04-10 14:57:09,13620.0,6,11972,2,13620.0,3,13625.0,10,S
2018-04-10 14:57:09,13620.0,6,11978,0,13615.0,6,13625.0,12,S
2018-04-10 14:57:11,13625.0,2,11980,0,13615.0,9,13625.0,10,B
2018-04-10 14:57:20,13625.0,28,12008,-4,13625.0,86,13630.0,28,B
2018-04-10 14:57:20,13625.0,2,12010,-2,13625.0,85,13630.0,28,B
2018-04-10 14:57:21,13625.0,12,12022,0,13625.0,79,13630.0,28,B
2018-04-10 14:57:27,13625.0,2,12024,-2,13625.0,78,13630.0,13,B
2018-04-10 14:57:34,13625.0,2,12026,0,13625.0,77,13630.0,13,B
2018-04-10 14:57:34,13630.0,26,12052,-4,13630.0,65,13635.0,25,B
2018-04-10 14:57:36,13630.0,2,12054,-2,13630.0,64,13635.0,25,B
2018-04-10 14:57:45,13630.0,2,12056,2,13625.0,9,13635.0,10,B
2018-04-10 14:57:52,13635.0,22,12078,0,13635.0,22,13640.0,27,B
2018-04-10 14:57:55,13635.0,2,12080,-2,13635.0,21,13640.0,12,B
2018-04-10 14:57:56,13635.0,36,12116,-16,13635.0,3,13640.0,12,B
2018-04-10 14:57:56,13635.0,8,12124,0,13630.0,7,13635.0,1,B
2018-04-10 14:58:02,13630.0,2,12126,0,13630.0,5,13635.0,1,S
2018-04-10 14:58:03,13635.0,2,12128,0,13635.0,29,13640.0,12,B
2018-04-10 14:58:03,13635.0,2,12130,0,13635.0,29,13640.0,12,B
2018-04-10 14:58:04,13635.0,4,12134,0,13635.0,27,13640.0,12,B
2018-04-10 14:58:04,13635.0,4,12138,0,13635.0,25,13640.0,12,B
2018-04-10 14:58:13,13635.0,2,12140,-2,13630.0,5,13640.0,14,B
2018-04-10 14:58:15,13640.0,28,12168,-6,13630.0,5,13640.0,1,B
2018-04-10 14:58:21,13640.0,2,12170,-2,13640.0,9,13645.0,14,B
2018-04-10 14:58:31,13645.0,18,12188,0,13635.0,1,13645.0,10,B
2018-04-10 14:58:35,13640.0,2,12190,0,13635.0,2,13645.0,10,S
2018-04-10 14:58:41,13645.0,2,12192,0,13640.0,8,13645.0,11,B
2018-04-10 14:58:50,13640.0,4,12196,-4,13640.0,6,13645.0,11,S
2018-04-10 14:58:53,13645.0,8,12204,4,13640.0,6,13645.0,8,B
2018-04-10 14:58:55,13645.0,6,12210,0,13640.0,6,13645.0,5,B
2018-04-10 14:58:58,13645.0,10,12220,6,13640.0,8,13645.0,1,B
2018-04-10 14:59:00,13650.0,6,12226,-2,13640.0,8,13650.0,12,B
2018-04-10 14:59:03,13645.0,2,12228,2,13640.0,8,13650.0,16,S
2018-04-10 14:59:04,13640.0,2,12230,-2,13640.0,7,13650.0,16,S
2018-04-10 14:59:13,13645.0,6,12236,-4,13640.0,8,13645.0,3,B
2018-04-10 14:59:13,13645.0,6,12242,-2,13645.0,17,13650.0,19,B
2018-04-10 14:59:14,13640.0,50,12292,-28,13635.0,2,13645.0,1,S
2018-04-10 14:59:14,13650.0,4,12296,-2,13635.0,3,13640.0,1,B
2018-04-10 14:59:15,13640.0,2,12298,0,13635.0,3,13645.0,1,S
2018-04-10 14:59:30,13645.0,4,12302,-2,13640.0,2,13645.0,2,B
2018-04-10 14:59:42,13645.0,2,12304,0,13635.0,1,13645.0,3,B
2018-04-10 14:59:49,13645.0,6,12310,4,13645.0,1,13650.0,16,B
2018-04-10 14:59:50,13645.0,2,12312,0,13635.0,1,13650.0,16,B
2018-04-10 14:59:54,13650.0,12,12324,10,13635.0,2,13650.0,11,B
2018-04-10 20:59:00,13655.0,6,6,58596,0.0,0,0.0,0,B
2018-04-10 21:00:00,13655.0,2,8,0,13655.0,1,13670.0,7,B
2018-04-10 21:00:01,13650.0,8,16,4,13645.0,1,13650.0,14,S
2018-04-10 21:00:02,13645.0,2,18,2,13635.0,5,13645.0,1,S
2018-04-10 21:00:04,13645.0,8,26,0,13635.0,17,13645.0,2,S
2018-04-10 21:00:05,13645.0,6,32,2,13640.0,12,13650.0,14,S
2018-04-10 21:00:06,13640.0,26,58,0,13635.0,17,13640.0,1,S
2018-04-10 21:00:06,13640.0,2,60,0,13640.0,1,13665.0,3,S
2018-04-10 21:00:07,13645.0,4,64,4,13640.0,1,13645.0,1,B
2018-04-10 21:00:08,13640.0,2,66,2,13635.0,5,13655.0,1,S
2018-04-10 21:00:11,13655.0,10,76,0,13640.0,1,13655.0,1,B
2018-04-10 21:00:14,13645.0,2,78,2,13640.0,2,13650.0,1,S
2018-04-10 21:00:19,13645.0,2,80,-2,13645.0,1,13655.0,2,S
2018-04-10 21:00:23,13645.0,10,90,-10,13645.0,6,13655.0,4,S
2018-04-10 21:00:34,13655.0,2,92,2,13645.0,7,13655.0,1,B
2018-04-10 21:00:37,13650.0,2,94,0,13645.0,7,13655.0,1,S
2018-04-10 21:00:39,13660.0,8,102,-4,13660.0,46,13665.0,2,B
2018-04-10 21:00:39,13660.0,74,176,-36,13660.0,9,13665.0,5,B
2018-04-10 21:00:40,13660.0,4,180,0,13660.0,7,13665.0,5,B
2018-04-10 21:00:40,13660.0,2,182,0,13660.0,6,13665.0,5,B
2018-04-10 21:00:42,13660.0,8,190,0,13660.0,2,13665.0,5,B
2018-04-10 21:00:42,13660.0,2,192,0,13660.0,1,13665.0,5,B
2018-04-10 21:00:43,13660.0,2,194,0,13655.0,3,13660.0,7,B
2018-04-10 21:00:45,13655.0,2,196,2,13655.0,2,13660.0,6,S
2018-04-10 21:00:56,13655.0,2,198,2,13655.0,2,13660.0,5,S
2018-04-10 21:00:59,13655.0,2,200,0,13655.0,1,13660.0,5,S
2018-04-10 21:01:04,13660.0,4,204,2,13650.0,2,13660.0,4,B
2018-04-10 21:01:05,13655.0,2,206,-2,13650.0,4,13660.0,4,S
2018-04-10 21:01:08,13650.0,2,208,0,13650.0,1,13655.0,1,S
2018-04-10 21:01:12,13650.0,2,210,0,13645.0,18,13655.0,11,S
2018-04-10 21:01:13,13645.0,8,218,0,13645.0,14,13650.0,2,S
2018-04-10 21:01:18,13650.0,2,220,0,13645.0,14,13655.0,11,B
2018-04-10 21:01:20,13645.0,26,246,0,13640.0,2,13645.0,21,S
2018-04-10 21:01:25,13640.0,2,248,-2,13640.0,3,13645.0,22,S
2018-04-10 21:01:32,13640.0,12,260,8,13635.0,3,13640.0,17,S
2018-04-10 21:01:33,13635.0,2,262,-2,13635.0,4,13640.0,17,S
2018-04-10 21:01:34,13635.0,2,264,0,13630.0,2,13635.0,1,S
2018-04-10 21:01:35,13635.0,2,266,0,13630.0,1,13635.0,1,S
2018-04-10 21:01:35,13635.0,2,268,0,13630.0,1,13640.0,17,S
2018-04-10 21:01:36,13630.0,2,270,-2,13625.0,1,13640.0,18,S
2018-04-10 21:01:37,13625.0,2,272,0,13615.0,13,13625.0,2,S
2018-04-10 21:01:39,13615.0,26,298,-4,13610.0,10,13620.0,12,S
2018-04-10 21:01:41,13625.0,2,300,-2,13610.0,10,13635.0,13,B
2018-04-10 21:01:43,13620.0,2,302,-2,13615.0,3,13630.0,1,S
2018-04-10 21:01:45,13615.0,8,310,2,13610.0,10,13615.0,13,S
2018-04-10 21:01:46,13615.0,26,336,10,13610.0,10,13630.0,4,S
2018-04-10 21:02:01,13625.0,2,338,2,13620.0,16,13630.0,1,B
2018-04-10 21:02:05,13625.0,2,340,2,13625.0,2,13635.0,1,B
2018-04-10 21:02:15,13625.0,2,342,-2,13625.0,1,13630.0,1,B
2018-04-10 21:02:16,13630.0,2,344,0,13625.0,1,13635.0,1,B
2018-04-10 21:02:18,13630.0,2,346,2,13625.0,1,13635.0,2,B
2018-04-10 21:02:27,13630.0,2,348,0,13630.0,1,13635.0,2,B
2018-04-10 21:02:29,13630.0,2,350,2,13625.0,2,13635.0,1,B
2018-04-10 21:02:39,13630.0,4,354,4,13625.0,7,13635.0,2,B
2018-04-10 21:02:46,13635.0,2,356,2,13630.0,6,13645.0,17,B
2018-04-10 21:02:59,13640.0,2,358,2,13640.0,1,13645.0,3,B
2018-04-10 21:03:02,13640.0,2,360,0,13640.0,5,13645.0,3,B
2018-04-10 21:03:02,13635.0,14,374,-6,13630.0,1,13640.0,22,S
2018-04-10 21:03:04,13640.0,2,376,0,13630.0,1,13640.0,5,B
2018-04-10 21:03:07,13635.0,2,378,0,13630.0,1,13640.0,5,S
2018-04-10 21:03:09,13635.0,2,380,0,13630.0,3,13640.0,3,S
2018-04-10 21:03:12,13635.0,2,382,0,13635.0,5,13640.0,2,S
2018-04-10 21:03:15,13635.0,2,384,2,13635.0,4,13640.0,1,S
2018-04-10 21:03:16,13635.0,2,386,2,13630.0,4,13640.0,1,S
2018-04-10 21:03:22,13630.0,4,390,4,13630.0,2,13635.0,502,S
2018-04-10 21:03:22,13630.0,4,394,-2,13630.0,1,13635.0,502,S
2018-04-10 21:03:23,13630.0,2,396,0,13625.0,2,13635.0,502,S
2018-04-10 21:03:24,13630.0,2,398,0,13630.0,1,13635.0,502,S
2018-04-10 21:03:26,13630.0,2,400,0,13625.0,1,13635.0,502,S
2018-04-10 21:03:30,13630.0,2,402,2,13625.0,4,13635.0,502,S
2018-04-10 21:03:48,13630.0,2,404,0,13630.0,1,13635.0,501,S
2018-04-10 21:03:59,13635.0,2,406,0,13630.0,2,13635.0,500,B
2018-04-10 21:04:06,13630.0,4,410,0,13630.0,3,13635.0,499,S
2018-04-10 21:04:11,13635.0,2,412,2,13630.0,8,13635.0,498,B
2018-04-10 21:04:14,13630.0,4,416,0,13630.0,3,13635.0,499,S
2018-04-10 21:04:17,13630.0,4,420,-2,13630.0,1,13635.0,500,S
2018-04-10 21:04:19,13630.0,2,422,0,13625.0,5,13635.0,500,S
2018-04-10 21:04:21,13630.0,2,424,2,13625.0,8,13635.0,500,S
2018-04-10 21:04:23,13625.0,2,426,2,13625.0,8,13635.0,500,S
2018-04-10 21:04:24,13625.0,8,434,8,13625.0,4,13635.0,500,S
2018-04-10 21:04:28,13625.0,2,436,0,13620.0,4,13635.0,502,S
2018-04-10 21:04:38,13625.0,2,438,0,13625.0,5,13630.0,1,S
2018-04-10 21:04:42,13620.0,8,446,-6,13620.0,2,13625.0,1,S
2018-04-10 21:04:43,13620.0,2,448,-2,13620.0,1,13625.0,1,S
2018-04-10 21:04:45,13620.0,2,450,0,13615.0,2,13625.0,1,S
2018-04-10 21:04:58,13615.0,2,452,0,13610.0,10,13620.0,202,S
2018-04-10 21:04:58,13615.0,2,454,0,13610.0,10,13620.0,202,S
2018-04-10 21:05:00,13615.0,4,458,-2,13610.0,9,13615.0,2,S
2018-04-10 21:05:06,13615.0,2,460,0,13610.0,10,13615.0,100,S
2018-04-10 21:05:08,13610.0,20,480,2,13605.0,13,13610.0,90,S
2018-04-10 21:05:08,13610.0,18,498,0,13605.0,15,13610.0,81,S
2018-04-10 21:05:09,13610.0,14,512,0,13605.0,15,13610.0,74,S
2018-04-10 21:05:09,13610.0,2,514,0,13605.0,14,13610.0,73,S
2018-04-10 21:05:10,13610.0,2,516,0,13605.0,14,13610.0,72,S
2018-04-10 21:05:12,13605.0,2,518,0,13605.0,13,13610.0,72,S
2018-04-10 21:05:13,13610.0,10,528,0,13605.0,13,13610.0,67,B
2018-04-10 21:05:13,13610.0,2,530,0,13605.0,13,13610.0,66,B
2018-04-10 21:05:24,13605.0,2,532,0,13605.0,10,13610.0,68,S
2018-04-10 21:05:27,13605.0,2,534,-2,13605.0,11,13610.0,68,S
2018-04-10 21:05:31,13610.0,2,536,0,13605.0,12,13610.0,131,B
2018-04-10 21:05:32,13605.0,10,546,0,13605.0,7,13610.0,131,S
2018-04-10 21:05:32,13605.0,10,556,2,13605.0,2,13610.0,133,S
2018-04-10 21:05:38,13605.0,4,560,2,13600.0,6,13605.0,98,S
2018-04-10 21:05:43,13600.0,2,562,-2,13600.0,5,13605.0,98,S
2018-04-10 21:05:49,13600.0,4,566,0,13600.0,11,13605.0,98,S
2018-04-10 21:05:49,13605.0,2,568,0,13600.0,11,13605.0,97,B
2018-04-10 21:05:50,13605.0,26,594,10,13600.0,16,13605.0,85,B
2018-04-10 21:05:51,13605.0,4,598,4,13600.0,16,13605.0,83,B
2018-04-10 21:05:51,13605.0,6,604,6,13600.0,16,13605.0,80,B
2018-04-10 21:05:52,13605.0,2,606,2,13600.0,16,13605.0,79,B
2018-04-10 21:05:57,13605.0,40,646,20,13600.0,16,13605.0,59,B
2018-04-10 21:06:01,13605.0,2,648,0,13600.0,16,13605.0,58,B
2018-04-10 21:06:04,13605.0,20,668,0,13600.0,16,13605.0,48,B
2018-04-10 21:06:05,13605.0,2,670,0,13600.0,16,13605.0,47,B
2018-04-10 21:06:06,13600.0,6,676,0,13600.0,10,13605.0,48,S
2018-04-10 21:06:11,13605.0,4,680,0,13600.0,52,13605.0,44,B
2018-04-10 21:06:12,13600.0,2,682,0,13600.0,51,13605.0,44,S
2018-04-10 21:06:14,13605.0,6,688,6,13600.0,52,13605.0,41,B
2018-04-10 21:06:15,13605.0,4,692,4,13600.0,52,13605.0,39,B
2018-04-10 21:06:19,13605.0,2,694,2,13600.0,52,13605.0,38,B
2018-04-10 21:06:28,13605.0,2,696,2,13600.0,52,13605.0,38,B
2018-04-10 21:06:32,13605.0,2,698,0,13600.0,53,13605.0,37,B
2018-04-10 21:06:40,13605.0,2,700,0,13600.0,54,13605.0,36,B
2018-04-10 21:06:41,13605.0,24,724,4,13600.0,51,13605.0,24,B
2018-04-10 21:06:41,13605.0,14,738,8,13600.0,50,13605.0,17,B
2018-04-10 21:06:42,13605.0,4,742,4,13600.0,50,13605.0,15,B
2018-04-10 21:06:44,13600.0,4,746,4,13600.0,47,13605.0,15,S
2018-04-10 21:06:45,13605.0,2,748,2,13600.0,47,13605.0,14,B
2018-04-10 21:06:46,13605.0,2,750,2,13600.0,47,13605.0,13,B
2018-04-10 21:06:47,13605.0,2,752,2,13600.0,47,13605.0,12,B
2018-04-10 21:06:47,13605.0,2,754,0,13600.0,47,13605.0,11,B
2018-04-10 21:06:49,13605.0,2,756,0,13600.0,48,13605.0,10,B
2018-04-10 21:06:50,13605.0,20,776,0,13600.0,48,13610.0,132,B
2018-04-10 21:07:03,13600.0,2,778,0,13600.0,50,13610.0,132,S
2018-04-10 21:07:03,13600.0,4,782,0,13600.0,48,13610.0,132,S
2018-04-10 21:07:05,13600.0,10,792,6,13600.0,43,13610.0,132,S
2018-04-10 21:07:14,13600.0,2,794,2,13600.0,43,13605.0,3,S
2018-04-10 21:07:21,13605.0,2,796,0,13600.0,43,13605.0,3,B
2018-04-10 21:07:24,13605.0,2,798,-2,13600.0,43,13605.0,1,B
2018-04-10 21:07:29,13600.0,2,800,2,13600.0,39,13605.0,1,S
2018-04-10 21:07:30,13600.0,2,802,0,13600.0,38,13605.0,1,S
2018-04-10 21:07:30,13600.0,8,810,8,13600.0,34,13605.0,1,S
2018-04-10 21:07:43,13605.0,2,812,2,13600.0,34,13610.0,132,B
2018-04-10 21:07:47,13610.0,2,814,2,13605.0,1,13610.0,130,B
2018-04-10 21:07:49,13605.0,2,816,0,13600.0,39,13610.0,130,S
2018-04-10 21:07:54,13605.0,10,826,-2,13600.0,39,13605.0,2,S
2018-04-10 21:07:57,13605.0,6,832,-4,13605.0,2,13610.0,135,S
2018-04-10 21:07:57,13605.0,4,836,0,13600.0,39,13605.0,1,S
2018-04-10 21:08:02,13605.0,4,840,-4,13600.0,39,13610.0,135,S
2018-04-10 21:08:16,13605.0,2,842,0,13605.0,4,13610.0,135,S
2018-04-10 21:08:47,13610.0,4,846,2,13605.0,13,13610.0,127,B
2018-04-10 21:08:52,13610.0,4,850,4,13605.0,15,13610.0,125,B
2018-04-10 21:09:14,13610.0,4,854,0,13605.0,18,13610.0,123,B
2018-04-10 21:09:32,13605.0,2,856,0,13605.0,23,13610.0,123,S
2018-04-10 21:09:35,13610.0,4,860,4,13605.0,23,13610.0,121,B
2018-04-10 21:09:37,13610.0,8,868,0,13605.0,23,13610.0,117,B
2018-04-10 21:09:37,13610.0,2,870,2,13605.0,23,13610.0,116,B
2018-04-10 21:10:01,13610.0,10,880,0,13605.0,23,13610.0,111,B
2018-04-10 21:10:07,13610.0,20,900,0,13605.0,23,13610.0,101,B
2018-04-10 21:10:11,13610.0,12,912,0,13605.0,23,13610.0,98,B
2018-04-10 21:10:14,13610.0,22,934,0,13605.0,23,13610.0,87,B
2018-04-10 21:10:15,13610.0,20,954,0,13605.0,23,13610.0,77,B
2018-04-10 21:10:16,13610.0,6,960,4,13605.0,23,13610.0,74,B
2018-04-10 21:10:16,13610.0,2,962,2,13605.0,23,13610.0,73,B
2018-04-10 21:10:17,13610.0,2,964,2,13605.0,23,13610.0,72,B
2018-04-10 21:10:24,13610.0,10,974,0,13605.0,20,13610.0,67,B
2018-04-10 21:10:28,13610.0,4,978,4,13605.0,20,13610.0,65,B
2018-04-10 21:10:33,13610.0,4,982,4,13605.0,20,13610.0,63,B
2018-04-10 21:10:36,13610.0,2,984,0,13605.0,21,13610.0,62,B
2018-04-10 21:10:44,13610.0,20,1004,20,13605.0,21,13610.0,52,B
2018-04-10 21:11:03,13610.0,2,1006,0,13605.0,21,13610.0,51,B
2018-04-10 21:11:14,13610.0,22,1028,20,13605.0,23,13610.0,40,B
2018-04-10 21:11:14,13610.0,16,1044,0,13605.0,23,13610.0,32,B
2018-04-10 21:11:15,13610.0,10,1054,6,13605.0,23,13610.0,27,B
2018-04-10 21:11:15,13610.0,34,1088,30,13605.0,23,13610.0,10,B
2018-04-10 21:11:16,13610.0,20,1108,2,13610.0,2,13615.0,103,B
2018-04-10 21:11:16,13615.0,4,1112,0,13610.0,3,13615.0,98,B
2018-04-10 21:11:17,13615.0,8,1120,8,13610.0,1,13615.0,94,B
2018-04-10 21:11:21,13615.0,4,1124,0,13610.0,1,13615.0,92,B
2018-04-10 21:11:21,13615.0,8,1132,8,13610.0,1,13615.0,88,B
2018-04-10 21:11:24,13615.0,2,1134,0,13610.0,1,13615.0,87,B
2018-04-10 21:11:27,13615.0,10,1144,0,13610.0,2,13615.0,82,B
2018-04-10 21:11:28,13615.0,2,1146,0,13610.0,9,13615.0,81,B
2018-04-10 21:11:33,13615.0,32,1178,22,13610.0,12,13615.0,65,B
2018-04-10 21:11:34,13615.0,2,1180,0,13610.0,12,13615.0,64,B
2018-04-10 21:11:34,13615.0,14,1194,0,13610.0,5,13615.0,57,B
2018-04-10 21:11:36,13615.0,2,1196,2,13610.0,8,13615.0,56,B
2018-04-10 21:11:37,13615.0,76,1272,68,13610.0,13,13615.0,18,B
2018-04-10 21:11:37,13615.0,4,1276,2,13610.0,13,13615.0,16,B
2018-04-10 21:11:38,13615.0,2,1278,0,13610.0,7,13615.0,15,B
2018-04-10 21:11:39,13615.0,2,1280,2,13610.0,7,13615.0,14,B
2018-04-10 21:11:41,13615.0,10,1290,0,13610.0,7,13615.0,9,B
2018-04-10 21:11:42,13615.0,2,1292,2,13610.0,7,13615.0,8,B
2018-04-10 21:11:43,13615.0,2,1294,0,13610.0,12,13615.0,7,B
2018-04-10 21:11:47,13615.0,2,1296,0,13610.0,12,13615.0,7,B
2018-04-10 21:11:48,13615.0,2,1298,0,13610.0,13,13615.0,6,B
2018-04-10 21:11:50,13615.0,10,1308,0,13610.0,13,13615.0,1,B
2018-04-10 21:11:56,13615.0,2,1310,0,13615.0,1,13620.0,203,B
2018-04-10 21:11:57,13615.0,4,1314,-2,13610.0,9,13620.0,200,B
2018-04-10 21:11:58,13615.0,4,1318,0,13610.0,9,13620.0,200,B
2018-04-10 21:11:59,13615.0,4,1322,2,13610.0,9,13620.0,202,B
2018-04-10 21:12:00,13615.0,2,1324,2,13610.0,12,13615.0,1,B
2018-04-10 21:12:03,13615.0,2,1326,-2,13610.0,13,13620.0,202,B
2018-04-10 21:12:08,13610.0,4,1330,2,13610.0,12,13615.0,2,S
2018-04-10 21:12:09,13615.0,4,1334,-2,13615.0,3,13620.0,200,B
2018-04-10 21:12:09,13615.0,6,1340,-2,13610.0,13,13615.0,7,B
2018-04-10 21:12:16,13615.0,2,1342,-2,13610.0,15,13615.0,1,B
2018-04-10 21:12:18,13615.0,2,1344,2,13610.0,16,13620.0,200,B
2018-04-10 21:12:19,13615.0,2,1346,0,13610.0,16,13620.0,200,B
2018-04-10 21:12:22,13610.0,4,1350,2,13610.0,14,13620.0,200,S
2018-04-10 21:12:28,13620.0,10,1360,0,13610.0,18,13620.0,195,B
2018-04-10 21:12:31,13615.0,2,1362,0,13610.0,18,13620.0,195,S
2018-04-10 21:12:38,13620.0,10,1372,0,13615.0,1,13620.0,191,B
2018-04-10 21:12:39,13620.0,2,1374,2,13615.0,1,13620.0,190,B
2018-04-10 21:12:43,13620.0,2,1376,0,13615.0,1,13620.0,189,B
2018-04-10 21:12:54,13620.0,12,1388,12,13615.0,7,13620.0,182,B
2018-04-10 21:12:56,13620.0,2,1390,0,13615.0,7,13620.0,181,B
2018-04-10 21:13:01,13620.0,10,1400,0,13615.0,9,13620.0,176,B
2018-04-10 21:13:06,13620.0,2,1402,0,13615.0,9,13620.0,175,B
2018-04-10 21:13:09,13620.0,10,1412,0,13615.0,7,13620.0,171,B
2018-04-10 21:13:15,13615.0,2,1414,2,13615.0,6,13620.0,171,S
2018-04-10 21:13:15,13615.0,8,1422,4,13615.0,2,13620.0,171,S
2018-04-10 21:13:16,13615.0,4,1426,4,13610.0,19,13620.0,171,S
2018-04-10 21:13:17,13620.0,10,1436,0,13610.0,16,13620.0,166,B
2018-04-10 21:13:19,13615.0,2,1438,2,13610.0,16,13615.0,1,S
2018-04-10 21:13:23,13610.0,6,1444,-4,13610.0,10,13615.0,3,S
2018-04-10 21:13:45,13615.0,2,1446,0,13610.0,9,13615.0,5,B
2018-04-10 21:13:50,13615.0,4,1450,-2,13610.0,9,13615.0,3,B
2018-04-10 21:13:57,13615.0,6,1456,-4,13615.0,2,13620.0,178,B
2018-04-10 21:13:58,13615.0,4,1460,-4,13610.0,9,13615.0,1,B
2018-04-10 21:14:08,13615.0,4,1464,-4,13615.0,3,13620.0,178,B
2018-04-10 21:14:08,13615.0,6,1470,-6,13610.0,12,13620.0,178,B
2018-04-10 21:14:11,13615.0,2,1472,-2,13610.0,12,13620.0,178,B
2018-04-10 21:14:14,13615.0,2,1474,0,13610.0,13,13615.0,1,B
2018-04-10 21:14:22,13615.0,2,1476,2,13610.0,14,13620.0,178,B
2018-04-10 21:14:27,13610.0,2,1478,0,13610.0,13,13615.0,1,S
2018-04-10 21:14:30,13615.0,24,1502,10,13610.0,1,13620.0,181,B
2018-04-10 21:14:30,13610.0,2,1504,0,13605.0,9,13620.0,181,S
2018-04-10 21:14:34,13605.0,10,1514,2,13605.0,2,13615.0,18,S
2018-04-10 21:14:35,13605.0,4,1518,2,13600.0,41,13605.0,1,S
2018-04-10 21:14:37,13605.0,2,1520,0,13600.0,41,13610.0,1,S
2018-04-10 21:14:42,13610.0,2,1522,-2,13610.0,1,13615.0,19,B
2018-04-10 21:14:42,13610.0,2,1524,-2,13600.0,45,13615.0,19,B
2018-04-10 21:14:44,13610.0,2,1526,0,13600.0,47,13610.0,1,B
2018-04-10 21:14:46,13610.0,2,1528,-2,13605.0,1,13615.0,21,B
2018-04-10 21:14:58,13605.0,2,1530,0,13600.0,48,13615.0,15,S
2018-04-10 21:15:12,13610.0,2,1532,0,13605.0,5,13610.0,1,B
2018-04-10 21:15:12,13610.0,6,1538,-4,13605.0,5,13610.0,2,B
2018-04-10 21:15:13,13605.0,2,1540,2,13605.0,4,13610.0,2,S
2018-04-10 21:15:23,13605.0,2,1542,-2,13605.0,3,13610.0,3,S
2018-04-10 21:15:29,13610.0,2,1544,2,13605.0,3,13610.0,2,B
2018-04-10 21:15:31,13610.0,2,1546,2,13605.0,3,13610.0,1,B
2018-04-10 21:15:45,13610.0,4,1550,-2,13610.0,5,13615.0,5,B
2018-04-10 21:16:19,13615.0,2,1552,0,13610.0,3,13615.0,4,B
2018-04-10 21:16:22,13615.0,8,1560,2,13615.0,2,13620.0,169,B
2018-04-10 21:16:31,13615.0,4,1564,-2,13610.0,4,13620.0,180,B
2018-04-10 21:17:15,13615.0,2,1566,0,13610.0,23,13620.0,170,B
2018-04-10 21:18:41,13615.0,2,1568,2,13610.0,22,13620.0,171,B
2018-04-10 21:19:04,13615.0,2,1570,0,13610.0,20,13615.0,2,B
2018-04-10 21:19:04,13615.0,4,1574,-2,13610.0,20,13620.0,169,B
2018-04-10 21:19:20,13615.0,4,1578,0,13610.0,23,13615.0,2,B
2018-04-10 21:20:09,13615.0,10,1588,2,13610.0,122,13620.0,167,B
2018-04-10 21:20:12,13620.0,200,1788,0,13610.0,21,13620.0,70,B
2018-04-10 21:20:12,13620.0,14,1802,6,13610.0,21,13620.0,62,B
2018-04-10 21:20:43,13620.0,2,1804,2,13615.0,7,13620.0,59,B
2018-04-10 21:20:47,13620.0,2,1806,2,13615.0,6,13620.0,58,B
2018-04-10 21:20:56,13620.0,2,1808,0,13615.0,7,13620.0,55,B
2018-04-10 21:21:01,13620.0,22,1830,6,13615.0,27,13620.0,44,B
2018-04-10 21:21:01,13620.0,26,1856,2,13615.0,27,13620.0,31,B
2018-04-10 21:21:02,13620.0,2,1858,2,13615.0,7,13620.0,30,B
2018-04-10 21:21:04,13620.0,2,1860,0,13615.0,7,13620.0,29,B
2018-04-10 21:21:07,13620.0,30,1890,0,13615.0,7,13620.0,14,B
2018-04-10 21:21:08,13615.0,2,1892,2,13615.0,6,13620.0,14,S
2018-04-10 21:21:13,13620.0,2,1894,0,13615.0,7,13620.0,13,B
2018-04-10 21:21:17,13615.0,6,1900,6,13615.0,4,13620.0,17,S
2018-04-10 21:21:17,13615.0,4,1904,-2,13615.0,1,13620.0,17,S
2018-04-10 21:21:19,13620.0,2,1906,2,13610.0,6,13620.0,13,B
2018-04-10 21:21:22,13620.0,2,1908,0,13615.0,1,13620.0,12,B
2018-04-10 21:21:25,13620.0,24,1932,-2,13620.0,3,13625.0,12,B
2018-04-10 21:21:25,13620.0,2,1934,0,13620.0,2,13625.0,14,B
2018-04-10 21:21:26,13620.0,4,1938,-4,13615.0,1,13625.0,15,B
2018-04-10 21:21:40,13620.0,2,1940,0,13610.0,58,13620.0,5,B
2018-04-10 21:21:49,13620.0,2,1942,-2,13615.0,2,13620.0,40,B
2018-04-10 21:22:04,13620.0,2,1944,-2,13615.0,4,13620.0,34,B
2018-04-10 21:22:32,13620.0,2,1946,2,13615.0,14,13620.0,33,B
2018-04-10 21:22:33,13620.0,2,1948,2,13615.0,15,13620.0,32,B
2018-04-10 21:22:39,13615.0,2,1950,0,13615.0,13,13620.0,34,S
2018-04-10 21:22:51,13615.0,4,1954,0,13615.0,11,13620.0,32,S
2018-04-10 21:23:10,13615.0,4,1958,0,13615.0,9,13620.0,32,S
2018-04-10 21:23:44,13620.0,2,1960,0,13615.0,10,13620.0,31,B
2018-04-10 21:24:11,13615.0,2,1962,2,13615.0,8,13620.0,32,S
2018-04-10 21:24:18,13620.0,2,1964,2,13615.0,10,13620.0,31,B
2018-04-10 21:24:31,13615.0,2,1966,0,13615.0,9,13620.0,31,S
2018-04-10 21:24:37,13615.0,2,1968,2,13615.0,8,13620.0,31,S
2018-04-10 21:24:41,13615.0,6,1974,0,13615.0,5,13620.0,33,S
2018-04-10 21:24:42,13615.0,2,1976,0,13615.0,4,13620.0,33,S
2018-04-10 21:24:42,13615.0,2,1978,0,13615.0,4,13620.0,33,S
2018-04-10 21:24:47,13620.0,4,1982,4,13615.0,4,13620.0,32,B
2018-04-10 21:24:54,13620.0,2,1984,2,13615.0,3,13620.0,31,B
2018-04-10 21:25:02,13615.0,2,1986,2,13615.0,2,13620.0,29,S
2018-04-10 21:25:02,13615.0,2,1988,0,13615.0,1,13620.0,29,S
2018-04-10 21:25:07,13620.0,2,1990,2,13615.0,2,13620.0,28,B
2018-04-10 21:25:09,13615.0,4,1994,4,13610.0,56,13620.0,30,S
2018-04-10 21:25:13,13620.0,2,1996,0,13610.0,56,13620.0,29,B
2018-04-10 21:25:17,13620.0,6,2002,0,13610.0,56,13620.0,26,B
2018-04-10 21:25:34,13610.0,2,2004,-2,13610.0,56,13620.0,27,S
2018-04-10 21:26:28,13615.0,2,2006,2,13610.0,59,13615.0,12,B
2018-04-10 21:26:35,13610.0,2,2008,0,13610.0,57,13615.0,14,S
2018-04-10 21:27:04,13610.0,4,2012,0,13610.0,55,13615.0,14,S
2018-04-10 21:27:05,13610.0,2,2014,0,13610.0,54,13615.0,14,S
2018-04-10 21:27:23,13610.0,2,2016,0,13610.0,55,13615.0,20,S
2018-04-10 21:27:29,13615.0,4,2020,0,13610.0,68,13615.0,11,B
2018-04-10 21:27:29,13615.0,22,2042,14,13610.0,68,13620.0,26,B
2018-04-10 21:27:34,13620.0,4,2046,4,13615.0,1,13620.0,28,B
2018-04-10 21:28:06,13615.0,2,2048,2,13610.0,57,13620.0,28,S
2018-04-10 21:28:34,13615.0,2,2050,0,13615.0,1,13620.0,28,S
2018-04-10 21:29:08,13620.0,2,2052,0,13615.0,1,13620.0,26,B
2018-04-10 21:29:50,13610.0,2,2054,2,13610.0,57,13620.0,33,S
2018-04-10 21:30:00,13610.0,2,2056,2,13610.0,70,13620.0,31,S
2018-04-10 21:30:08,13615.0,2,2058,2,13610.0,70,13620.0,26,B
2018-04-10 21:30:13,13620.0,2,2060,0,13610.0,58,13620.0,25,B
2018-04-10 21:30:20,13620.0,2,2062,2,13615.0,3,13620.0,24,B
2018-04-10 21:31:21,13615.0,2,2064,0,13615.0,5,13620.0,26,S
2018-04-10 21:31:21,13615.0,4,2068,-2,13615.0,3,13620.0,26,S
2018-04-10 21:31:22,13615.0,6,2074,0,13610.0,55,13620.0,26,S
2018-04-10 21:31:50,13620.0,10,2084,0,13615.0,1,13620.0,19,B
2018-04-10 21:32:03,13620.0,30,2114,30,13615.0,1,13620.0,4,B
2018-04-10 21:32:51,13620.0,2,2116,-2,13615.0,12,13620.0,4,B
2018-04-10 21:32:51,13620.0,2,2118,0,13615.0,12,13620.0,3,B
2018-04-10 21:33:55,13620.0,4,2122,0,13620.0,1,13625.0,8,B
2018-04-10 21:34:08,13620.0,2,2124,2,13620.0,1,13625.0,7,B
2018-04-10 21:34:27,13620.0,6,2130,6,13615.0,14,13620.0,4,B
2018-04-10 21:34:48,13615.0,2,2132,0,13615.0,12,13620.0,5,S
2018-04-10 21:35:07,13620.0,8,2140,0,13615.0,16,13620.0,6,B
2018-04-10 21:35:08,13625.0,20,2160,-4,13620.0,14,13625.0,4,B
2018-04-10 21:35:08,13620.0,8,2168,0,13615.0,17,13620.0,2,S
2018-04-10 21:35:14,13620.0,2,2170,-2,13615.0,17,13620.0,2,S
2018-04-10 21:35:15,13620.0,2,2172,-2,13615.0,18,13620.0,1,S
2018-04-10 21:35:15,13620.0,2,2174,-2,13620.0,3,13625.0,4,S
2018-04-10 21:35:45,13620.0,2,2176,0,13620.0,3,13625.0,3,S
2018-04-10 21:35:58,13625.0,2,2178,0,13620.0,2,13625.0,2,B
2018-04-10 21:36:04,13620.0,6,2184,0,13615.0,22,13620.0,1,S
2018-04-10 21:37:22,13620.0,4,2188,0,13615.0,18,13620.0,3,S
2018-04-10 21:37:40,13620.0,8,2196,-2,13615.0,18,13620.0,4,S
2018-04-10 21:37:53,13615.0,2,2198,0,13615.0,16,13620.0,4,S
2018-04-10 21:38:02,13620.0,4,2202,4,13615.0,19,13620.0,2,B
2018-04-10 21:38:03,13620.0,4,2206,4,13615.0,19,13625.0,5,B
2018-04-10 21:38:11,13620.0,2,2208,2,13620.0,1,13625.0,4,B
2018-04-10 21:38:13,13620.0,2,2210,2,13620.0,1,13625.0,4,B
2018-04-10 21:38:17,13620.0,2,2212,2,13620.0,2,13625.0,4,B
2018-04-10 21:38:33,13620.0,8,2220,6,13620.0,2,13625.0,3,B
2018-04-10 21:38:36,13625.0,4,2224,2,13620.0,6,13625.0,1,B
2018-04-10 21:38:36,13625.0,2,2226,-2,13625.0,1,13630.0,4,B
2018-04-10 21:38:48,13635.0,2,2228,-2,13630.0,5,13640.0,8,B
2018-04-10 21:38:54,13635.0,2,2230,0,13635.0,1,13640.0,9,B
2018-04-10 21:38:56,13635.0,2,2232,0,13630.0,6,13640.0,8,B
2018-04-10 21:39:06,13635.0,2,2234,2,13630.0,4,13640.0,8,B
2018-04-10 21:39:09,13635.0,2,2236,0,13630.0,4,13640.0,8,B
2018-04-10 21:39:26,13635.0,4,2240,2,13625.0,1,13635.0,5,B
2018-04-10 21:40:09,13630.0,2,2242,-2,13625.0,5,13630.0,3,S
2018-04-10 21:40:10,13630.0,6,2248,-2,13630.0,1,13635.0,3,S
2018-04-10 21:40:14,13635.0,2,2250,0,13630.0,1,13640.0,10,B
2018-04-10 21:40:50,13640.0,2,2252,0,13630.0,7,13640.0,9,B
2018-04-10 21:41:19,13640.0,2,2254,2,13630.0,7,13640.0,14,B
2018-04-10 21:41:25,13635.0,2,2256,2,13630.0,8,13640.0,15,S
2018-04-10 21:41:30,13635.0,2,2258,2,13630.0,8,13640.0,15,S
2018-04-10 21:41:35,13630.0,2,2260,2,13630.0,7,13640.0,16,S
2018-04-10 21:41:40,13630.0,4,2264,0,13630.0,4,13635.0,7,S
2018-04-10 21:41:41,13630.0,8,2272,4,13625.0,2,13630.0,7,S
2018-04-10 21:41:42,13630.0,2,2274,2,13625.0,3,13630.0,3,S
2018-04-10 21:41:44,13625.0,2,2276,0,13625.0,1,13630.0,6,S
2018-04-10 21:41:54,13630.0,2,2278,0,13625.0,3,13635.0,9,B
2018-04-10 21:41:58,13635.0,2,2280,0,13625.0,3,13635.0,6,B
2018-04-10 21:42:00,13630.0,2,2282,0,13625.0,3,13635.0,7,S
2018-04-10 21:42:18,13630.0,2,2284,0,13625.0,2,13630.0,1,S
2018-04-10 21:42:38,13625.0,2,2286,0,13620.0,10,13630.0,5,S
2018-04-10 21:43:03,13625.0,2,2288,0,13620.0,21,13625.0,4,S
2018-04-10 21:43:03,13625.0,8,2296,4,13625.0,3,13630.0,2,S
2018-04-10 21:43:20,13625.0,4,2300,2,13620.0,24,13625.0,3,S
2018-04-10 21:43:20,13625.0,2,2302,0,13620.0,24,13625.0,3,S
2018-04-10 21:43:22,13625.0,2,2304,0,13620.0,24,13625.0,2,S
2018-04-10 21:43:24,13625.0,2,2306,0,13620.0,24,13625.0,1,S
2018-04-10 21:43:33,13625.0,2,2308,2,13620.0,24,13630.0,4,S
2018-04-10 21:43:43,13625.0,2,2310,2,13620.0,24,13630.0,4,S
2018-04-10 21:43:44,13630.0,2,2312,0,13620.0,29,13630.0,2,B
2018-04-10 21:44:06,13630.0,2,2314,2,13625.0,1,13630.0,4,B
2018-04-10 21:44:26,13625.0,4,2318,0,13620.0,10,13625.0,3,S
2018-04-10 21:45:07,13625.0,4,2322,4,13620.0,6,13625.0,4,S
2018-04-10 21:45:12,13625.0,2,2324,2,13620.0,6,13625.0,4,S
2018-04-10 21:45:15,13625.0,2,2326,0,13620.0,11,13625.0,3,S
2018-04-10 21:45:34,13620.0,10,2336,4,13620.0,6,13625.0,3,S
2018-04-10 21:45:34,13620.0,4,2340,0,13620.0,4,13625.0,3,S
2018-04-10 21:45:39,13620.0,8,2348,8,13615.0,17,13620.0,1,S
2018-04-10 21:45:42,13620.0,2,2350,2,13620.0,4,13625.0,4,S
2018-04-10 21:46:01,13620.0,8,2358,8,13615.0,32,13620.0,1,S
2018-04-10 21:46:07,13620.0,2,2360,2,13615.0,20,13625.0,4,S
2018-04-10 21:46:13,13620.0,2,2362,0,13615.0,20,13625.0,5,S
2018-04-10 21:47:14,13620.0,4,2366,4,13615.0,16,13620.0,1,S
2018-04-10 21:47:17,13615.0,2,2368,2,13615.0,15,13620.0,4,S
2018-04-10 21:47:21,13620.0,2,2370,0,13615.0,15,13620.0,1,B
2018-04-10 21:47:35,13620.0,2,2372,2,13615.0,15,13620.0,1,B
2018-04-10 21:48:03,13615.0,2,2374,2,13615.0,15,13625.0,5,S
2018-04-10 21:49:03,13620.0,4,2378,-4,13615.0,16,13625.0,6,B
2018-04-10 21:49:19,13620.0,6,2384,-4,13615.0,15,13620.0,1,B
2018-04-10 21:49:19,13620.0,2,2386,0,13615.0,15,13625.0,6,B
2018-04-10 21:50:11,13625.0,2,2388,2,13620.0,3,13630.0,6,B
2018-04-10 21:50:13,13630.0,2,2390,2,13625.0,1,13635.0,11,B
2018-04-10 21:50:15,13635.0,2,2392,-2,13625.0,2,13635.0,6,B
2018-04-10 21:50:22,13630.0,2,2394,0,13625.0,2,13635.0,5,S
2018-04-10 21:50:43,13630.0,2,2396,-2,13625.0,3,13635.0,8,S
2018-04-10 21:51:31,13630.0,2,2398,2,13625.0,7,13635.0,6,S
2018-04-10 21:51:45,13630.0,2,2400,0,13625.0,18,13635.0,6,S
2018-04-10 21:52:57,13635.0,4,2404,4,13625.0,6,13635.0,7,B
2018-04-10 21:53:22,13635.0,2,2406,0,13625.0,7,13635.0,6,B
2018-04-10 21:53:28,13630.0,2,2408,-2,13625.0,5,13630.0,4,S
2018-04-10 21:53:43,13625.0,2,2410,2,13625.0,5,13630.0,3,S
2018-04-10 21:53:46,13625.0,4,2414,-2,13625.0,2,13630.0,4,S
2018-04-10 21:53:47,13625.0,4,2418,-4,13620.0,6,13630.0,5,S
2018-04-10 21:54:43,13620.0,12,2430,-10,13620.0,11,13630.0,8,S
2018-04-10 21:54:49,13625.0,2,2432,2,13620.0,1,13630.0,20,B
2018-04-10 21:55:16,13625.0,2,2434,0,13615.0,12,13625.0,3,B
2018-04-10 21:55:26,13620.0,2,2436,-2,13620.0,1,13630.0,9,S
2018-04-10 21:56:15,13620.0,2,2438,2,13615.0,13,13625.0,4,S
2018-04-10 21:56:28,13615.0,2,2440,2,13615.0,11,13625.0,6,S
2018-04-10 21:56:31,13615.0,2,2442,2,13615.0,10,13625.0,6,S
2018-04-10 21:56:36,13615.0,2,2444,0,13615.0,9,13625.0,6,S
2018-04-10 21:56:38,13620.0,6,2450,0,13615.0,9,13625.0,9,B
2018-04-10 21:58:56,13620.0,8,2458,2,13620.0,4,13625.0,3,B
2018-04-10 22:00:16,13630.0,2,2460,0,13625.0,1,13630.0,3,B
2018-04-10 22:00:39,13630.0,4,2464,-2,13625.0,17,13635.0,7,B
2018-04-10 22:01:02,13635.0,4,2468,0,13630.0,15,13635.0,10,B
2018-04-10 22:01:05,13640.0,38,2506,-2,13640.0,8,13645.0,5,B
2018-04-10 22:01:05,13640.0,10,2516,4,13635.0,1,13645.0,8,B
2018-04-10 22:01:09,13645.0,4,2520,0,13635.0,4,13645.0,3,B
2018-04-10 22:01:18,13645.0,2,2522,0,13640.0,2,13650.0,9,B
2018-04-10 22:01:19,13645.0,4,2526,-2,13645.0,1,13650.0,10,B
2018-04-10 22:01:20,13645.0,2,2528,0,13640.0,3,13645.0,4,B
2018-04-10 22:01:21,13640.0,2,2530,2,13640.0,14,13645.0,2,S
2018-04-10 22:01:24,13645.0,2,2532,2,13640.0,14,13645.0,9,B
2018-04-10 22:01:24,13645.0,10,2542,6,13640.0,14,13645.0,4,B
2018-04-10 22:01:25,13645.0,2,2544,2,13640.0,13,13645.0,3,B
2018-04-10 22:01:29,13640.0,2,2546,2,13640.0,11,13645.0,3,S
2018-04-10 22:02:17,13640.0,6,2552,6,13635.0,6,13640.0,7,S
2018-04-10 22:02:24,13640.0,4,2556,4,13635.0,18,13640.0,6,S
2018-04-10 22:02:45,13635.0,8,2564,0,13635.0,1,13640.0,6,S
2018-04-10 22:02:46,13635.0,2,2566,-2,13630.0,9,13635.0,3,S
2018-04-10 22:04:27,13635.0,2,2568,2,13630.0,4,13635.0,3,S
2018-04-10 22:04:31,13630.0,2,2570,-2,13625.0,18,13635.0,7,S
2018-04-10 22:04:56,13635.0,2,2572,0,13630.0,2,13635.0,2,B
2018-04-10 22:05:11,13635.0,2,2574,0,13630.0,2,13635.0,2,B
2018-04-10 22:05:17,13635.0,2,2576,-2,13625.0,36,13635.0,1,B
2018-04-10 22:05:21,13635.0,2,2578,-2,13630.0,1,13635.0,2,B
2018-04-10 22:06:20,13630.0,4,2582,0,13625.0,24,13630.0,1,S
2018-04-10 22:06:21,13630.0,2,2584,0,13625.0,24,13635.0,4,S
2018-04-10 22:06:47,13635.0,2,2586,-2,13625.0,25,13635.0,3,B
2018-04-10 22:06:51,13630.0,2,2588,-2,13625.0,24,13635.0,3,S
2018-04-10 22:07:21,13630.0,2,2590,0,13625.0,26,13635.0,5,S
2018-04-10 22:09:16,13625.0,2,2592,2,13625.0,19,13635.0,9,S
2018-04-10 22:09:16,13625.0,4,2596,0,13625.0,17,13635.0,9,S
2018-04-10 22:10:19,13635.0,2,2598,0,13630.0,1,13635.0,4,B
2018-04-10 22:10:24,13630.0,2,2600,0,13625.0,22,13630.0,1,S
2018-04-10 22:10:47,13630.0,2,2602,2,13625.0,29,13635.0,4,S
2018-04-10 22:11:53,13635.0,4,2606,4,13630.0,16,13640.0,22,B
2018-04-10 22:13:06,13635.0,2,2608,0,13630.0,8,13635.0,4,B
2018-04-10 22:13:16,13635.0,2,2610,0,13630.0,11,13635.0,3,B
2018-04-10 22:13:46,13635.0,2,2612,0,13630.0,9,13635.0,2,B
2018-04-10 22:14:57,13630.0,2,2614,0,13630.0,5,13635.0,5,S
2018-04-10 22:15:16,13635.0,2,2616,2,13630.0,5,13635.0,4,B
2018-04-10 22:15:21,13635.0,2,2618,0,13630.0,5,13635.0,3,B
2018-04-10 22:15:30,13630.0,6,2624,2,13630.0,2,13635.0,5,S
2018-04-10 22:15:35,13630.0,2,2626,-2,13630.0,1,13635.0,23,S
2018-04-10 22:15:35,13630.0,2,2628,-2,13625.0,22,13635.0,23,S
2018-04-10 22:15:36,13630.0,2,2630,0,13625.0,14,13630.0,1,S
2018-04-10 22:16:48,13635.0,2,2632,2,13630.0,3,13635.0,5,B
2018-04-10 22:17:17,13635.0,2,2634,0,13630.0,2,13635.0,4,B
2018-04-10 22:17:20,13630.0,4,2638,2,13625.0,18,13635.0,20,S
2018-04-10 22:17:20,13635.0,2,2640,2,13625.0,13,13635.0,19,B
2018-04-10 22:17:42,13630.0,2,2642,0,13625.0,13,13630.0,2,S
2018-04-10 22:17:57,13625.0,2,2644,0,13625.0,12,13630.0,1,S
2018-04-10 22:18:15,13625.0,8,2652,-8,13625.0,7,13630.0,18,S
2018-04-10 22:18:15,13625.0,14,2666,-6,13620.0,9,13625.0,2,S
2018-04-10 22:18:21,13620.0,2,2668,-2,13620.0,4,13630.0,9,S
2018-04-10 22:18:33,13630.0,2,2670,2,13620.0,4,13630.0,9,B
2018-04-10 22:18:37,13625.0,2,2672,0,13625.0,2,13630.0,1,S
2018-04-10 22:18:48,13630.0,2,2674,2,13620.0,11,13630.0,4,B
2018-04-10 22:19:17,13630.0,2,2676,0,13620.0,4,13630.0,9,B
2018-04-10 22:20:17,13625.0,10,2686,10,13620.0,25,13625.0,1,S
2018-04-10 22:20:18,13625.0,2,2688,2,13625.0,1,13630.0,8,S
2018-04-10 22:20:21,13630.0,2,2690,0,13625.0,1,13630.0,7,B
2018-04-10 22:21:32,13630.0,2,2692,0,13625.0,3,13630.0,1,B
2018-04-10 22:21:34,13630.0,2,2694,0,13625.0,4,13635.0,11,B
2018-04-10 22:22:21,13630.0,2,2696,-2,13625.0,3,13635.0,11,B
2018-04-10 22:22:38,13635.0,2,2698,2,13625.0,3,13635.0,10,B
2018-04-10 22:23:15,13630.0,8,2706,8,13625.0,1,13630.0,1,S
2018-04-10 22:24:35,13635.0,6,2712,6,13630.0,7,13635.0,3,B
2018-04-10 22:25:22,13635.0,2,2714,-2,13630.0,2,13635.0,4,B
2018-04-10 22:25:47,13635.0,2,2716,0,13630.0,4,13635.0,4,B
2018-04-10 22:25:49,13630.0,2,2718,-2,13630.0,3,13635.0,7,S
2018-04-10 22:25:51,13635.0,2,2720,0,13630.0,3,13635.0,3,B
2018-04-10 22:26:11,13635.0,4,2724,0,13635.0,4,13640.0,17,B
2018-04-10 22:26:44,13635.0,2,2726,0,13635.0,4,13640.0,12,B
2018-04-10 22:26:44,13635.0,2,2728,2,13635.0,3,13640.0,30,B
2018-04-10 22:27:00,13635.0,2,2730,0,13635.0,2,13640.0,19,B
2018-04-10 22:27:23,13635.0,2,2732,0,13635.0,2,13640.0,16,B
2018-04-10 22:27:49,13640.0,2,2734,2,13635.0,1,13640.0,15,B
2018-04-10 22:28:03,13640.0,2,2736,0,13635.0,1,13640.0,14,B
2018-04-10 22:28:11,13640.0,6,2742,0,13635.0,1,13640.0,11,B
2018-04-10 22:30:00,13640.0,2,2744,-2,13635.0,6,13640.0,3,B
2018-04-10 22:30:00,13640.0,2,2746,0,13635.0,6,13640.0,2,B
2018-04-10 22:30:23,13640.0,2,2748,-2,13635.0,6,13640.0,1,B
2018-04-10 22:30:42,13640.0,2,2750,0,13635.0,6,13645.0,12,B
2018-04-10 22:30:47,13645.0,2,2752,2,13640.0,6,13645.0,4,B
2018-04-10 22:30:48,13645.0,2,2754,0,13640.0,6,13645.0,4,B
2018-04-10 22:30:49,13645.0,8,2762,4,13645.0,7,13650.0,8,B
2018-04-10 22:30:50,13650.0,2,2764,0,13645.0,3,13650.0,3,B
2018-04-10 22:30:51,13645.0,4,2768,2,13640.0,4,13645.0,3,S
2018-04-10 22:31:22,13645.0,16,2784,8,13635.0,4,13645.0,4,S
2018-04-10 22:31:30,13645.0,2,2786,0,13635.0,6,13645.0,4,S
2018-04-10 22:31:31,13645.0,2,2788,0,13635.0,6,13645.0,3,S
2018-04-10 22:31:50,13640.0,6,2794,0,13635.0,7,13645.0,2,S
2018-04-10 22:32:08,13635.0,4,2798,2,13635.0,1,13640.0,7,S
2018-04-10 22:32:15,13635.0,2,2800,0,13630.0,12,13640.0,7,S
2018-04-10 22:32:31,13630.0,2,2802,0,13630.0,4,13635.0,2,S
2018-04-10 22:32:37,13635.0,2,2804,-2,13630.0,10,13635.0,3,B
2018-04-10 22:32:37,13635.0,2,2806,-2,13630.0,10,13635.0,2,B
2018-04-10 22:33:18,13635.0,8,2814,-4,13635.0,1,13640.0,10,B
2018-04-10 22:33:28,13640.0,2,2816,-2,13640.0,3,13645.0,7,B
2018-04-10 22:33:38,13640.0,2,2818,0,13640.0,6,13650.0,10,B
2018-04-10 22:33:57,13645.0,10,2828,8,13645.0,2,13650.0,7,B
2018-04-10 22:34:47,13645.0,6,2834,6,13640.0,4,13645.0,2,B
2018-04-10 22:35:12,13645.0,4,2838,0,13640.0,6,13650.0,12,B
2018-04-10 22:35:25,13650.0,2,2840,0,13640.0,7,13650.0,10,B
2018-04-10 22:35:46,13640.0,2,2842,0,13640.0,2,13645.0,9,S
2018-04-10 22:35:46,13640.0,2,2844,2,13640.0,1,13645.0,9,S
2018-04-10 22:35:47,13640.0,2,2846,-2,13635.0,7,13645.0,9,S
2018-04-10 22:37:54,13635.0,2,2848,2,13635.0,1,13640.0,4,S
2018-04-10 22:38:13,13640.0,4,2852,0,13635.0,5,13645.0,21,B
2018-04-10 22:38:23,13635.0,2,2854,0,13635.0,4,13645.0,19,S
2018-04-10 22:38:37,13635.0,2,2856,-2,13635.0,4,13645.0,19,S
2018-04-10 22:40:25,13640.0,2,2858,-2,13635.0,4,13640.0,2,B
2018-04-10 22:40:37,13635.0,2,2860,0,13635.0,4,13640.0,7,S
2018-04-10 22:40:51,13635.0,2,2862,2,13635.0,3,13640.0,7,S
2018-04-10 22:41:02,13635.0,2,2864,0,13635.0,1,13640.0,7,S
2018-04-10 22:41:42,13635.0,2,2866,0,13630.0,7,13635.0,3,S
2018-04-10 22:43:21,13630.0,2,2868,0,13630.0,10,13640.0,10,S
2018-04-10 22:43:48,13635.0,2,2870,-2,13635.0,5,13640.0,9,B
2018-04-10 22:44:22,13640.0,4,2874,-2,13635.0,8,13645.0,13,B
2018-04-10 22:45:02,13640.0,2,2876,0,13640.0,3,13645.0,4,B
2018-04-10 22:45:15,13645.0,2,2878,-2,13635.0,8,13645.0,7,B
2018-04-10 22:45:16,13635.0,8,2886,-8,13635.0,4,13645.0,7,S
2018-04-10 22:45:26,13645.0,2,2888,-2,13635.0,5,13645.0,6,B
2018-04-10 22:46:32,13640.0,4,2892,0,13635.0,30,13640.0,8,S
2018-04-10 22:46:47,13640.0,2,2894,0,13635.0,6,13640.0,7,S
2018-04-10 22:46:51,13635.0,6,2900,0,13630.0,14,13640.0,7,S
2018-04-10 22:46:52,13635.0,2,2902,0,13635.0,1,13640.0,7,S
2018-04-10 22:47:42,13640.0,14,2916,10,13640.0,10,13645.0,8,B
2018-04-10 22:47:45,13645.0,6,2922,2,13640.0,26,13645.0,3,B
2018-04-10 22:47:45,13645.0,2,2924,2,13640.0,12,13645.0,2,B
2018-04-10 22:48:27,13640.0,2,2926,0,13640.0,10,13645.0,2,S
2018-04-10 22:48:46,13645.0,4,2930,0,13640.0,10,13650.0,11,B
2018-04-10 22:48:54,13645.0,2,2932,0,13640.0,14,13650.0,13,B
2018-04-10 22:50:27,13650.0,2,2934,0,13640.0,14,13645.0,1,B
2018-04-10 22:50:27,13645.0,2,2936,-2,13640.0,14,13650.0,14,S
2018-04-10 22:51:33,13650.0,2,2938,2,13645.0,4,13650.0,13,B
2018-04-10 22:51:49,13650.0,4,2942,0,13645.0,5,13650.0,9,B
2018-04-10 22:51:52,13650.0,10,2952,-4,13650.0,2,13655.0,7,B
2018-04-10 22:51:53,13655.0,2,2954,-2,13650.0,4,13655.0,2,B
2018-04-10 22:51:54,13655.0,2,2956,0,13650.0,4,13655.0,1,B
2018-04-10 22:51:55,13655.0,2,2958,2,13650.0,6,13660.0,9,B
2018-04-10 22:51:55,13660.0,4,2962,0,13655.0,1,13660.0,7,B
2018-04-10 22:52:01,13655.0,4,2966,-2,13650.0,5,13660.0,8,S
2018-04-10 22:52:12,13650.0,6,2972,-6,13650.0,1,13655.0,2,S
2018-04-10 22:52:15,13650.0,2,2974,0,13645.0,8,13655.0,6,S
2018-04-10 22:52:35,13655.0,2,2976,2,13650.0,2,13655.0,8,B
2018-04-10 22:52:42,13650.0,2,2978,0,13650.0,1,13655.0,9,S
2018-04-10 22:52:49,13650.0,2,2980,2,13645.0,6,13655.0,13,S
2018-04-10 22:53:22,13645.0,2,2982,-2,13640.0,15,13650.0,4,S
2018-04-10 22:53:27,13650.0,2,2984,-2,13640.0,17,13650.0,3,B
2018-04-10 22:53:33,13655.0,16,3000,12,13650.0,10,13655.0,9,B
2018-04-10 22:53:34,13660.0,8,3008,2,13655.0,2,13660.0,15,B
2018-04-10 22:53:34,13660.0,2,3010,0,13655.0,2,13660.0,16,B
2018-04-10 22:53:35,13660.0,2,3012,-2,13650.0,10,13660.0,16,B
2018-04-10 22:53:50,13655.0,2,3014,0,13650.0,3,13655.0,3,S
2018-04-10 22:54:05,13650.0,2,3016,-2,13650.0,13,13660.0,14,S
2018-04-10 22:54:11,13655.0,2,3018,-2,13650.0,9,13660.0,14,B
2018-04-10 22:54:16,13655.0,2,3020,0,13650.0,12,13660.0,14,B
2018-04-10 22:54:28,13655.0,2,3022,-2,13650.0,13,13660.0,11,B
2018-04-10 22:54:35,13655.0,20,3042,-20,13650.0,13,13660.0,12,B
2018-04-10 22:54:47,13650.0,20,3062,-12,13650.0,7,13660.0,13,S
2018-04-10 22:55:16,13650.0,2,3064,-2,13650.0,2,13655.0,8,S
2018-04-10 22:55:27,13655.0,2,3066,0,13650.0,12,13655.0,5,B
2018-04-10 22:55:35,13650.0,2,3068,-2,13650.0,11,13655.0,7,S
2018-04-10 22:55:41,13650.0,8,3076,0,13650.0,7,13655.0,14,S
2018-04-10 22:55:42,13650.0,4,3080,-2,13650.0,5,13655.0,14,S
2018-04-10 22:55:42,13650.0,10,3090,0,13645.0,5,13655.0,16,S
2018-04-10 22:55:46,13650.0,4,3094,-2,13650.0,2,13655.0,15,S
2018-04-10 22:55:47,13650.0,4,3098,-4,13645.0,4,13655.0,15,S
2018-04-10 22:56:02,13645.0,2,3100,-2,13645.0,1,13650.0,4,S
2018-04-10 22:56:04,13645.0,2,3102,-2,13640.0,10,13650.0,4,S
2018-04-10 22:56:05,13640.0,2,3104,0,13640.0,7,13645.0,4,S
2018-04-10 22:56:06,13640.0,2,3106,-2,13640.0,6,13645.0,3,S
2018-04-10 22:57:02,13640.0,2,3108,0,13640.0,8,13645.0,17,S
2018-04-10 22:57:04,13640.0,4,3112,-4,13640.0,6,13645.0,15,S
2018-04-10 22:57:12,13640.0,4,3116,-4,13640.0,4,13645.0,13,S
2018-04-10 22:57:14,13640.0,2,3118,0,13640.0,3,13645.0,13,S
2018-04-10 22:57:18,13640.0,2,3120,-2,13640.0,4,13645.0,4,S
2018-04-10 22:57:23,13640.0,8,3128,-8,13635.0,4,13640.0,7,S
2018-04-10 22:57:25,13640.0,6,3134,0,13635.0,2,13640.0,4,S
2018-04-10 22:57:34,13640.0,4,3138,-2,13635.0,3,13640.0,2,S
2018-04-10 22:57:52,13640.0,2,3140,-2,13635.0,4,13640.0,2,S
2018-04-10 22:58:01,13640.0,2,3142,0,13635.0,6,13645.0,3,S
2018-04-10 22:58:02,13645.0,2,3144,-2,13635.0,5,13645.0,2,B
2018-04-10 22:58:25,13640.0,2,3146,-2,13640.0,3,13645.0,2,S
2018-04-10 22:58:30,13640.0,4,3150,-4,13640.0,1,13645.0,1,S
2018-04-10 22:58:30,13640.0,2,3152,0,13635.0,3,13645.0,1,S
2018-04-10 22:58:39,13645.0,2,3154,-2,13635.0,17,13650.0,3,B
2018-04-10 22:58:40,13635.0,2,3156,0,13635.0,3,13650.0,5,S
2018-04-10 22:58:58,13635.0,2,3158,-2,13635.0,4,13650.0,3,S
2018-04-10 22:59:08,13645.0,6,3164,-6,13635.0,17,13660.0,19,B
2018-04-10 22:59:10,13645.0,2,3166,-2,13635.0,27,13655.0,3,B
2018-04-10 22:59:24,13635.0,2,3168,-2,13635.0,3,13650.0,2,S
2018-04-10 22:59:32,13650.0,4,3172,-4,13635.0,3,13655.0,2,B
2018-04-10 22:59:40,13650.0,2,3174,-2,13635.0,3,13655.0,4,B
2018-04-10 22:59:59,13635.0,4,3178,0,13630.0,7,13635.0,2,S
2018-04-10 22:59:59,13635.0,8,3186,-4,13635.0,2,13650.0,2,S
2018-04-11 09:00:00,13635.0,2,3188,0,13635.0,4,13650.0,2,S
2018-04-11 09:00:02,13635.0,8,3196,-2,13635.0,6,13650.0,12,S
2018-04-11 09:00:03,13640.0,2,3198,0,13635.0,3,13640.0,2,B
2018-04-11 09:00:07,13635.0,4,3202,0,13635.0,1,13640.0,2,S
2018-04-11 09:00:07,13635.0,4,3206,0,13630.0,19,13635.0,1,S
2018-04-11 09:00:08,13635.0,2,3208,0,13635.0,14,13640.0,2,S
2018-04-11 09:00:09,13635.0,6,3214,2,13635.0,6,13645.0,2,S
2018-04-11 09:00:13,13640.0,2,3216,2,13640.0,1,13645.0,2,B
2018-04-11 09:00:14,13640.0,2,3218,2,13635.0,3,13645.0,2,B
2018-04-11 09:00:17,13640.0,6,3224,0,13640.0,4,13655.0,12,B
2018-04-11 09:00:20,13655.0,8,3232,2,13655.0,10,13660.0,4,B
2018-04-11 09:00:20,13660.0,12,3244,2,13655.0,10,13665.0,2,B
2018-04-11 09:00:25,13660.0,2,3246,0,13655.0,29,13660.0,1,B
2018-04-11 09:00:26,13665.0,4,3250,-2,13655.0,31,13665.0,1,B
2018-04-11 09:00:27,13665.0,4,3254,-4,13665.0,9,13670.0,8,B
2018-04-11 09:00:28,13665.0,6,3260,0,13660.0,3,13670.0,8,B
2018-04-11 09:00:30,13665.0,2,3262,0,13660.0,3,13665.0,1,B
2018-04-11 09:00:34,13660.0,2,3264,-2,13655.0,1,13660.0,1,S
2018-04-11 09:00:34,13660.0,2,3266,-2,13655.0,1,13665.0,1,S
2018-04-11 09:00:38,13660.0,4,3270,2,13660.0,1,13665.0,3,S
2018-04-11 09:00:39,13660.0,2,3272,2,13655.0,1,13665.0,3,S
2018-04-11 09:00:41,13655.0,2,3274,-2,13650.0,7,13655.0,2,S
2018-04-11 09:00:41,13650.0,2,3276,2,13650.0,5,13655.0,2,S
2018-04-11 09:00:43,13655.0,4,3280,-4,13650.0,6,13660.0,1,B
2018-04-11 09:00:59,13650.0,2,3282,2,13645.0,5,13655.0,10,S
2018-04-11 09:01:04,13650.0,2,3284,0,13645.0,7,13655.0,2,S
2018-04-11 09:01:09,13650.0,2,3286,2,13645.0,5,13655.0,3,S
2018-04-11 09:01:10,13645.0,2,3288,2,13640.0,1,13650.0,8,S
2018-04-11 09:01:11,13645.0,2,3290,2,13635.0,2,13645.0,8,S
2018-04-11 09:01:11,13640.0,4,3294,2,13635.0,4,13640.0,5,S
2018-04-11 09:01:12,13640.0,4,3298,0,13635.0,8,13645.0,1,S
2018-04-11 09:01:12,13650.0,2,3300,-2,13645.0,1,13655.0,3,B
2018-04-11 09:01:17,13650.0,2,3302,0,13645.0,3,13650.0,1,B
2018-04-11 09:01:19,13645.0,2,3304,0,13645.0,2,13655.0,3,S
2018-04-11 09:01:25,13650.0,2,3306,2,13650.0,1,13655.0,2,B
2018-04-11 09:01:26,13660.0,6,3312,6,13655.0,3,13660.0,3,B
2018-04-11 09:01:29,13655.0,2,3314,0,13655.0,1,13660.0,3,S
2018-04-11 09:01:30,13655.0,2,3316,0,13650.0,2,13655.0,3,S
2018-04-11 09:01:41,13655.0,4,3320,2,13650.0,8,13655.0,1,S
2018-04-11 09:01:41,13655.0,2,3322,2,13650.0,7,13660.0,8,S
2018-04-11 09:01:50,13660.0,12,3334,10,13655.0,6,13665.0,2,B
2018-04-11 09:01:52,13665.0,4,3338,2,13660.0,5,13670.0,11,B
2018-04-11 09:01:58,13665.0,2,3340,2,13660.0,7,13670.0,11,B
2018-04-11 09:01:59,13670.0,2,3342,0,13660.0,9,13670.0,12,B
2018-04-11 09:02:02,13655.0,10,3352,8,13650.0,29,13665.0,7,S
2018-04-11 09:02:04,13665.0,10,3362,0,13660.0,2,13670.0,24,B
2018-04-11 09:02:09,13665.0,6,3368,0,13655.0,3,13670.0,13,B
2018-04-11 09:02:12,13655.0,2,3370,-2,13655.0,3,13660.0,3,S
2018-04-11 09:02:19,13660.0,2,3372,-2,13655.0,3,13660.0,3,B
2018-04-11 09:02:32,13665.0,4,3376,2,13660.0,2,13665.0,1,B
2018-04-11 09:02:32,13665.0,2,3378,0,13665.0,6,13670.0,11,B
2018-04-11 09:02:33,13670.0,12,3390,12,13660.0,4,13670.0,5,B
2018-04-11 09:02:33,13670.0,2,3392,2,13660.0,4,13670.0,8,B
2018-04-11 09:02:36,13670.0,8,3400,6,13670.0,1,13680.0,2,B
2018-04-11 09:02:37,13680.0,6,3406,4,13680.0,1,13685.0,3,B
2018-04-11 09:02:37,13685.0,2,3408,2,13680.0,2,13685.0,3,B
2018-04-11 09:02:38,13685.0,8,3416,6,13680.0,1,13690.0,15,B
2018-04-11 09:02:38,13685.0,2,3418,0,13685.0,10,13690.0,17,B
2018-04-11 09:02:39,13685.0,2,3420,2,13680.0,1,13690.0,17,B
2018-04-11 09:02:40,13685.0,4,3424,0,13685.0,4,13690.0,17,B
2018-04-11 09:02:42,13690.0,2,3426,2,13685.0,4,13690.0,16,B
2018-04-11 09:02:43,13685.0,2,3428,2,13685.0,3,13690.0,16,S
2018-04-11 09:02:46,13675.0,2,3430,2,13670.0,4,13675.0,3,S
2018-04-11 09:02:49,13680.0,2,3432,-2,13675.0,6,13680.0,1,B
2018-04-11 09:03:02,13685.0,4,3436,0,13685.0,16,13690.0,15,B
2018-04-11 09:03:03,13685.0,8,3444,2,13685.0,18,13690.0,12,B
2018-04-11 09:03:04,13690.0,4,3448,4,13685.0,15,13690.0,10,B
2018-04-11 09:03:05,13690.0,14,3462,10,13685.0,18,13690.0,3,B
2018-04-11 09:03:05,13690.0,16,3478,10,13690.0,15,13695.0,4,B
2018-04-11 09:03:06,13695.0,8,3486,4,13695.0,7,13700.0,12,B
2018-04-11 09:03:06,13695.0,2,3488,2,13695.0,6,13700.0,12,B
2018-04-11 09:03:08,13705.0,34,3522,32,13695.0,8,13705.0,7,B
2018-04-11 09:03:08,13705.0,12,3534,2,13700.0,1,13705.0,3,B
2018-04-11 09:03:09,13700.0,22,3556,2,13690.0,4,13700.0,3,S
2018-04-11 09:03:11,13695.0,6,3562,0,13690.0,1,13695.0,4,S
2018-04-11 09:03:12,13695.0,2,3564,-2,13690.0,3,13695.0,3,S
2018-04-11 09:03:14,13695.0,4,3568,4,13685.0,2,13695.0,4,S
2018-04-11 09:03:16,13695.0,2,3570,-2,13695.0,1,13700.0,11,S
2018-04-11 09:03:16,13695.0,2,3572,0,13690.0,1,13695.0,1,S
2018-04-11 09:03:18,13695.0,4,3576,2,13695.0,1,13700.0,9,S
2018-04-11 09:03:19,13695.0,2,3578,2,13690.0,3,13695.0,1,S
2018-04-11 09:03:21,13700.0,4,3582,2,13695.0,4,13700.0,1,B
2018-04-11 09:03:28,13700.0,4,3586,2,13690.0,4,13700.0,13,B
2018-04-11 09:03:30,13700.0,2,3588,2,13690.0,5,13695.0,3,B
2018-04-11 09:03:31,13700.0,8,3596,8,13690.0,4,13700.0,6,B
2018-04-11 09:03:34,13690.0,10,3606,6,13690.0,4,13700.0,2,S
2018-04-11 09:03:41,13690.0,2,3608,0,13690.0,3,13695.0,1,S
2018-04-11 09:03:43,13685.0,4,3612,0,13680.0,3,13690.0,20,S
2018-04-11 09:03:46,13680.0,20,3632,-14,13680.0,3,13690.0,18,S
2018-04-11 09:03:50,13690.0,8,3640,6,13680.0,5,13690.0,4,B
2018-04-11 09:03:53,13680.0,8,3648,2,13680.0,1,13690.0,3,S
2018-04-11 09:03:54,13680.0,6,3654,4,13680.0,1,13690.0,3,S
2018-04-11 09:03:56,13680.0,4,3658,-2,13675.0,1,13685.0,3,S
2018-04-11 09:03:59,13680.0,4,3662,0,13675.0,3,13680.0,1,S
2018-04-11 09:03:59,13680.0,2,3664,-2,13675.0,3,13685.0,1,S
2018-04-11 09:04:01,13685.0,2,3666,-2,13685.0,2,13690.0,2,B
2018-04-11 09:04:02,13685.0,2,3668,0,13680.0,7,13690.0,3,B
2018-04-11 09:04:03,13690.0,2,3670,0,13685.0,3,13690.0,2,B
2018-04-11 09:04:06,13685.0,2,3672,0,13685.0,1,13690.0,2,S
2018-04-11 09:04:09,13690.0,2,3674,0,13685.0,5,13695.0,2,B
2018-04-11 09:04:09,13695.0,4,3678,0,13690.0,5,13700.0,6,B
2018-04-11 09:04:11,13690.0,2,3680,0,13690.0,1,13695.0,9,S
2018-04-11 09:04:11,13690.0,2,3682,0,13690.0,2,13695.0,9,S
2018-04-11 09:04:14,13695.0,2,3684,0,13690.0,2,13695.0,5,B
2018-04-11 09:04:15,13690.0,2,3686,2,13690.0,1,13695.0,5,S
2018-04-11 09:04:16,13695.0,4,3690,0,13690.0,1,13695.0,6,B
2018-04-11 09:04:17,13695.0,2,3692,2,13690.0,1,13695.0,5,B
2018-04-11 09:04:18,13695.0,2,3694,0,13690.0,1,13695.0,4,B
2018-04-11 09:04:24,13690.0,2,3696,2,13690.0,2,13695.0,2,S
2018-04-11 09:04:25,13695.0,2,3698,0,13690.0,2,13695.0,18,B
2018-04-11 09:04:29,13690.0,4,3702,4,13685.0,2,13695.0,13,S
2018-04-11 09:04:32,13695.0,8,3710,0,13695.0,7,13700.0,3,B
2018-04-11 09:04:33,13695.0,2,3712,2,13695.0,6,13700.0,3,B
2018-04-11 09:04:33,13695.0,4,3716,2,13695.0,4,13700.0,2,B
2018-04-11 09:04:34,13700.0,4,3720,2,13695.0,8,13705.0,2,B
2018-04-11 09:04:34,13705.0,4,3724,2,13705.0,3,13710.0,9,B
2018-04-11 09:04:35,13705.0,6,3730,0,13700.0,2,13710.0,9,B
2018-04-11 09:04:47,13700.0,4,3734,2,13700.0,1,13705.0,2,S
2018-04-11 09:04:54,13700.0,4,3738,2,13700.0,10,13705.0,2,S
2018-04-11 09:05:01,13700.0,4,3742,4,13695.0,6,13705.0,3,S
2018-04-11 09:05:02,13695.0,6,3748,0,13690.0,2,13700.0,15,S
2018-04-11 09:05:06,13695.0,4,3752,4,13690.0,9,13700.0,9,S
2018-04-11 09:05:10,13695.0,8,3760,0,13690.0,3,13695.0,1,S
2018-04-11 09:05:14,13695.0,6,3766,-2,13685.0,2,13695.0,5,S
2018-04-11 09:05:17,13685.0,2,3768,0,13685.0,4,13690.0,8,S
2018-04-11 09:05:17,13685.0,10,3778,-2,13685.0,1,13690.0,8,S
2018-04-11 09:05:22,13690.0,4,3782,0,13685.0,2,13690.0,7,B
2018-04-11 09:05:33,13685.0,6,3788,-2,13680.0,4,13685.0,5,S
2018-04-11 09:05:37,13685.0,10,3798,-2,13685.0,1,13690.0,1,S
2018-04-11 09:05:51,13695.0,2,3800,0,13685.0,5,13695.0,4,B
2018-04-11 09:05:59,13685.0,2,3802,-2,13680.0,6,13685.0,14,S
2018-04-11 09:06:07,13680.0,10,3812,-6,13675.0,3,13680.0,5,S
2018-04-11 09:06:07,13675.0,4,3816,-2,13670.0,2,13680.0,6,S
2018-04-11 09:06:08,13670.0,4,3820,2,13665.0,2,13670.0,6,S
2018-04-11 09:06:09,13665.0,4,3824,0,13660.0,2,13665.0,10,S
2018-04-11 09:06:09,13660.0,4,3828,-2,13660.0,1,13665.0,10,S
2018-04-11 09:06:11,13665.0,20,3848,20,13660.0,24,13670.0,5,B
2018-04-11 09:06:13,13665.0,2,3850,0,13665.0,2,13670.0,4,B
2018-04-11 09:06:14,13665.0,4,3854,0,13660.0,10,13670.0,4,B
2018-04-11 09:06:15,13660.0,6,3860,4,13660.0,1,13665.0,7,S
2018-04-11 09:06:15,13660.0,2,3862,0,13655.0,2,13665.0,12,S
2018-04-11 09:06:16,13660.0,2,3864,-2,13655.0,3,13660.0,2,S
2018-04-11 09:06:16,13655.0,6,3870,2,13650.0,18,13655.0,2,S
2018-04-11 09:06:17,13655.0,4,3874,0,13650.0,22,13660.0,7,S
2018-04-11 09:06:19,13660.0,4,3878,-4,13660.0,1,13665.0,2,B
2018-04-11 09:06:21,13670.0,2,3880,-2,13660.0,4,13670.0,2,B
2018-04-11 09:06:22,13670.0,2,3882,-2,13660.0,4,13670.0,1,B
2018-04-11 09:06:27,13670.0,2,3884,-2,13660.0,8,13675.0,6,B
2018-04-11 09:06:28,13660.0,2,3886,0,13660.0,9,13675.0,10,S
2018-04-11 09:06:40,13665.0,2,3888,2,13665.0,3,13670.0,3,B
2018-04-11 09:06:48,13670.0,8,3896,6,13660.0,7,13670.0,1,B
2018-04-11 09:07:08,13670.0,2,3898,0,13670.0,11,13675.0,7,B
2018-04-11 09:07:09,13670.0,2,3900,-2,13670.0,9,13675.0,7,B
2018-04-11 09:07:17,13670.0,10,3910,-10,13670.0,3,13675.0,10,B
2018-04-11 09:07:19,13675.0,4,3914,0,13670.0,3,13675.0,8,B
2018-04-11 09:07:20,13670.0,2,3916,-2,13670.0,2,13675.0,8,S
2018-04-11 09:07:31,13670.0,4,3920,-4,13665.0,5,13675.0,8,S
2018-04-11 09:07:45,13670.0,4,3924,-4,13670.0,2,13675.0,8,S
2018-04-11 09:07:48,13675.0,16,3940,-2,13675.0,11,13680.0,2,B
2018-04-11 09:07:56,13675.0,2,3942,0,13675.0,6,13685.0,6,B
2018-04-11 09:07:58,13680.0,2,3944,0,13675.0,4,13685.0,6,B
2018-04-11 09:08:10,13675.0,6,3950,0,13665.0,30,13680.0,10,S
2018-04-11 09:08:28,13665.0,2,3952,-2,13665.0,2,13675.0,12,S
2018-04-11 09:08:44,13670.0,2,3954,0,13670.0,1,13675.0,1,B
2018-04-11 09:08:49,13670.0,4,3958,4,13665.0,16,13675.0,3,B
2018-04-11 09:08:54,13670.0,10,3968,4,13665.0,1,13675.0,6,B
2018-04-11 09:09:14,13665.0,2,3970,0,13660.0,6,13670.0,20,S
2018-04-11 09:09:34,13665.0,2,3972,-2,13665.0,2,13670.0,5,S
2018-04-11 09:09:37,13660.0,14,3986,8,13660.0,4,13665.0,8,S
2018-04-11 09:09:43,13660.0,8,3994,0,13655.0,5,13665.0,7,S
2018-04-11 09:09:51,13655.0,16,4010,4,13650.0,41,13655.0,2,S
2018-04-11 09:09:52,13650.0,2,4012,0,13650.0,36,13655.0,12,S
2018-04-11 09:09:52,13655.0,2,4014,0,13650.0,36,13655.0,11,B
2018-04-11 09:09:54,13655.0,2,4016,2,13650.0,36,13655.0,9,B
2018-04-11 09:09:58,13650.0,2,4018,-2,13650.0,35,13655.0,11,S
2018-04-11 09:09:59,13655.0,2,4020,0,13650.0,37,13655.0,8,B
2018-04-11 09:10:00,13655.0,16,4036,8,13655.0,3,13660.0,7,B
2018-04-11 09:10:09,13655.0,4,4040,-4,13655.0,1,13660.0,2,B
2018-04-11 09:10:15,13660.0,4,4044,-2,13660.0,2,13665.0,3,B
2018-04-11 09:10:27,13670.0,4,4048,0,13665.0,13,13670.0,1,B
2018-04-11 09:10:28,13670.0,2,4050,-2,13665.0,15,13675.0,3,B
2018-04-11 09:10:40,13675.0,2,4052,0,13665.0,2,13675.0,8,B
2018-04-11 09:10:54,13670.0,2,4054,2,13665.0,2,13670.0,1,S
2018-04-11 09:11:10,13670.0,2,4056,0,13665.0,1,13670.0,4,S
2018-04-11 09:11:14,13675.0,2,4058,0,13665.0,2,13675.0,8,B
2018-04-11 09:11:21,13670.0,2,4060,2,13665.0,1,13670.0,2,S
2018-04-11 09:11:21,13665.0,4,4064,0,13660.0,2,13665.0,3,S
2018-04-11 09:11:23,13665.0,2,4066,0,13660.0,2,13665.0,2,S
2018-04-11 09:11:23,13665.0,4,4070,0,13665.0,1,13670.0,2,S
2018-04-11 09:11:25,13675.0,2,4072,0,13665.0,13,13675.0,11,B
2018-04-11 09:11:34,13665.0,2,4074,-2,13665.0,15,13675.0,9,S
2018-04-11 09:11:45,13670.0,2,4076,0,13665.0,9,13670.0,5,B
2018-04-11 09:11:46,13670.0,2,4078,0,13665.0,9,13670.0,1,B
2018-04-11 09:11:47,13670.0,4,4082,4,13670.0,3,13675.0,26,B
2018-04-11 09:11:47,13670.0,6,4088,4,13665.0,1,13675.0,24,B
2018-04-11 09:11:49,13670.0,2,4090,-2,13665.0,1,13675.0,10,B
2018-04-11 09:11:55,13675.0,2,4092,0,13665.0,1,13675.0,9,B
2018-04-11 09:11:57,13665.0,2,4094,0,13660.0,4,13665.0,4,S
2018-04-11 09:11:57,13665.0,8,4102,-8,13660.0,7,13670.0,1,S
2018-04-11 09:11:58,13670.0,2,4104,0,13660.0,7,13670.0,1,B
2018-04-11 09:12:05,13670.0,2,4106,0,13660.0,5,13675.0,10,B
2018-04-11 09:12:14,13665.0,10,4116,-10,13665.0,2,13670.0,9,S
2018-04-11 09:12:14,13665.0,2,4118,-2,13660.0,3,13670.0,9,S
2018-04-11 09:12:25,13665.0,2,4120,0,13660.0,5,13670.0,7,S
2018-04-11 09:12:29,13665.0,2,4122,-2,13665.0,1,13670.0,4,S
2018-04-11 09:12:31,13665.0,2,4124,2,13660.0,7,13670.0,4,S
2018-04-11 09:12:34,13660.0,8,4132,-4,13660.0,3,13670.0,4,S
2018-04-11 09:12:37,13660.0,2,4134,-2,13655.0,7,13665.0,2,S
2018-04-11 09:12:38,13665.0,2,4136,2,13655.0,11,13665.0,1,B
2018-04-11 09:12:39,13665.0,2,4138,0,13655.0,11,13670.0,5,B
2018-04-11 09:12:44,13670.0,2,4140,-2,13660.0,3,13670.0,6,B
2018-04-11 09:13:12,13665.0,2,4142,2,13660.0,8,13670.0,1,S
2018-04-11 09:13:14,13670.0,2,4144,0,13665.0,4,13670.0,1,B
2018-04-11 09:13:33,13670.0,2,4146,0,13670.0,2,13675.0,10,B
2018-04-11 09:13:37,13670.0,2,4148,0,13665.0,6,13675.0,8,B
2018-04-11 09:13:41,13675.0,4,4152,4,13670.0,4,13675.0,6,B
2018-04-11 09:13:50,13670.0,2,4154,-2,13670.0,3,13675.0,10,S
2018-04-11 09:14:04,13675.0,2,4156,0,13670.0,3,13675.0,10,B
2018-04-11 09:14:47,13670.0,6,4162,2,13665.0,4,13670.0,11,S
2018-04-11 09:14:48,13665.0,6,4168,0,13665.0,1,13670.0,8,S
2018-04-11 09:15:11,13665.0,8,4176,2,13660.0,2,13665.0,2,S
2018-04-11 09:15:22,13670.0,2,4178,2,13660.0,5,13670.0,7,B
2018-04-11 09:15:48,13670.0,20,4198,-12,13660.0,5,13670.0,4,B
2018-04-11 09:16:07,13660.0,2,4200,0,13660.0,1,13665.0,6,S
2018-04-11 09:16:14,13660.0,2,4202,-2,13660.0,8,13670.0,8,S
2018-04-11 09:17:13,13665.0,2,4204,2,13660.0,6,13665.0,1,B
2018-04-11 09:17:37,13665.0,2,4206,2,13660.0,2,13670.0,8,B
2018-04-11 09:17:57,13665.0,4,4210,4,13660.0,6,13670.0,10,B
2018-04-11 09:18:09,13665.0,2,4212,-2,13665.0,3,13670.0,4,B
2018-04-11 09:18:25,13670.0,2,4214,-2,13660.0,9,13670.0,5,B
2018-04-11 09:19:23,13660.0,4,4218,-2,13660.0,8,13670.0,5,S
2018-04-11 09:19:37,13665.0,2,4220,0,13660.0,4,13665.0,3,B
2018-04-11 09:19:57,13660.0,14,4234,8,13660.0,1,13670.0,9,S
2018-04-11 09:20:17,13665.0,2,4236,0,13660.0,2,13665.0,2,B
2018-04-11 09:20:37,13660.0,10,4246,-2,13655.0,4,13665.0,4,S
2018-04-11 09:20:37,13655.0,2,4248,2,13655.0,2,13660.0,19,S
2018-04-11 09:20:38,13655.0,4,4252,0,13650.0,39,13655.0,1,S
2018-04-11 09:20:38,13655.0,2,4254,-2,13655.0,3,13660.0,10,S
2018-04-11 09:20:39,13655.0,6,4260,-2,13650.0,39,13655.0,8,S
2018-04-11 09:20:41,13650.0,60,4320,-4,13650.0,9,13655.0,14,S
2018-04-11 09:20:41,13650.0,12,4332,8,13650.0,3,13655.0,12,S
2018-04-11 09:20:42,13650.0,6,4338,6,13645.0,5,13650.0,4,S
2018-04-11 09:20:43,13650.0,2,4340,2,13645.0,5,13650.0,5,S
2018-04-11 09:20:43,13650.0,2,4342,2,13645.0,5,13650.0,3,S
2018-04-11 09:20:44,13650.0,6,4348,-4,13650.0,1,13655.0,6,S
2018-04-11 09:20:47,13650.0,2,4350,0,13650.0,1,13655.0,6,S
2018-04-11 09:20:53,13645.0,2,4352,0,13645.0,10,13655.0,6,S
2018-04-11 09:20:59,13655.0,2,4354,-2,13650.0,26,13660.0,7,B
2018-04-11 09:21:11,13660.0,2,4356,0,13650.0,28,13660.0,5,B
2018-04-11 09:21:37,13655.0,2,4358,-2,13650.0,26,13660.0,7,S
2018-04-11 09:21:58,13655.0,4,4362,4,13655.0,2,13660.0,7,S
2018-04-11 09:22:19,13655.0,2,4364,0,13655.0,1,13660.0,4,S
2018-04-11 09:22:24,13655.0,2,4366,0,13650.0,27,13655.0,2,S
2018-04-11 09:22:25,13655.0,4,4370,-4,13655.0,2,13660.0,9,S
2018-04-11 09:22:39,13650.0,20,4390,14,13650.0,18,13660.0,7,S
2018-04-11 09:22:46,13655.0,6,4396,0,13650.0,20,13660.0,1,B
2018-04-11 09:22:55,13655.0,4,4400,2,13650.0,17,13660.0,8,B
2018-04-11 09:23:11,13650.0,2,4402,2,13650.0,36,13655.0,9,S
2018-04-11 09:23:12,13650.0,14,4416,0,13650.0,31,13655.0,4,S
2018-04-11 09:23:14,13655.0,2,4418,-2,13650.0,31,13660.0,17,B
2018-04-11 09:23:37,13650.0,26,4444,18,13650.0,18,13655.0,5,S
2018-04-11 09:23:37,13650.0,36,4480,10,13645.0,5,13650.0,4,S
2018-04-11 09:23:38,13650.0,2,4482,0,13645.0,6,13650.0,6,S
2018-04-11 09:23:42,13645.0,10,4492,8,13640.0,32,13645.0,1,S
2018-04-11 09:23:42,13640.0,12,4504,2,13640.0,26,13645.0,11,S
2018-04-11 09:23:43,13640.0,52,4556,-12,13635.0,11,13640.0,10,S
2018-04-11 09:23:43,13635.0,10,4566,6,13635.0,6,13640.0,21,S
2018-04-11 09:23:44,13640.0,2,4568,0,13635.0,6,13640.0,10,B
2018-04-11 09:23:45,13635.0,2,4570,2,13635.0,6,13640.0,23,S
2018-04-11 09:23:45,13635.0,2,4572,0,13635.0,5,13640.0,22,S
2018-04-11 09:23:46,13635.0,10,4582,-2,13635.0,6,13640.0,6,S
2018-04-11 09:23:46,13640.0,6,4588,-4,13635.0,6,13645.0,17,B
2018-04-11 09:23:47,13650.0,32,4620,32,13650.0,4,13655.0,14,B
2018-04-11 09:23:48,13640.0,10,4630,8,13635.0,5,13640.0,1,S
2018-04-11 09:23:49,13635.0,2,4632,0,13640.0,1,13645.0,4,S
2018-04-11 09:23:52,13640.0,2,4634,-2,13635.0,2,13640.0,1,B
2018-04-11 09:23:52,13640.0,2,4636,-2,13635.0,2,13645.0,1,B
2018-04-11 09:23:53,13640.0,4,4640,-4,13640.0,1,13645.0,1,B
2018-04-11 09:23:55,13650.0,14,4654,10,13650.0,13,13655.0,3,B
2018-04-11 09:23:56,13650.0,26,4680,0,13645.0,1,13650.0,1,B
2018-04-11 09:23:57,13645.0,2,4682,-2,13645.0,7,13650.0,3,S
2018-04-11 09:23:57,13650.0,2,4684,-2,13645.0,1,13655.0,2,B
2018-04-11 09:23:58,13645.0,2,4686,-2,13645.0,1,13655.0,4,S
2018-04-11 09:23:59,13640.0,2,4688,-2,13640.0,1,13650.0,4,S
2018-04-11 09:24:03,13645.0,2,4690,-2,13640.0,6,13650.0,12,B
2018-04-11 09:24:04,13640.0,6,4696,0,13635.0,4,13650.0,14,S
2018-04-11 09:24:05,13640.0,2,4698,2,13635.0,3,13645.0,1,S
2018-04-11 09:24:07,13640.0,2,4700,-2,13645.0,9,13650.0,12,S
2018-04-11 09:24:10,13650.0,4,4704,-4,13640.0,6,13650.0,11,B
2018-04-11 09:24:14,13645.0,2,4706,2,13645.0,1,13650.0,13,S
2018-04-11 09:24:22,13640.0,2,4708,-2,13640.0,6,13645.0,7,S
2018-04-11 09:24:23,13645.0,2,4710,0,13640.0,8,13645.0,6,B
2018-04-11 09:24:41,13640.0,2,4712,0,13635.0,6,13640.0,1,S
2018-04-11 09:24:42,13640.0,4,4716,-2,13635.0,3,13645.0,8,S
2018-04-11 09:24:46,13635.0,2,4718,0,13635.0,6,13640.0,5,S
2018-04-11 09:24:57,13635.0,2,4720,-2,13635.0,3,13640.0,5,S
2018-04-11 09:25:00,13635.0,2,4722,0,13635.0,2,13640.0,5,S
2018-04-11 09:25:07,13640.0,8,4730,-8,13635.0,18,13640.0,1,B
2018-04-11 09:25:08,13640.0,2,4732,0,13640.0,2,13645.0,13,B
2018-04-11 09:25:17,13645.0,12,4744,0,13640.0,18,13650.0,7,B
2018-04-11 09:25:22,13650.0,2,4746,-2,13645.0,5,13650.0,2,B
2018-04-11 09:25:22,13650.0,4,4750,2,13645.0,7,13655.0,11,B
2018-04-11 09:25:26,13650.0,2,4752,0,13650.0,4,13655.0,4,B
2018-04-11 09:25:27,13650.0,2,4754,-2,13650.0,7,13655.0,4,B
2018-04-11 09:25:30,13655.0,4,4758,0,13655.0,1,13660.0,9,B
2018-04-11 09:25:37,13650.0,2,4760,-2,13650.0,1,13655.0,1,S
2018-04-11 09:25:42,13650.0,4,4764,-4,13650.0,2,13655.0,3,S
2018-04-11 09:25:44,13650.0,2,4766,0,13650.0,2,13655.0,3,S
2018-04-11 09:25:44,13655.0,6,4772,2,13655.0,7,13660.0,14,B
2018-04-11 09:25:45,13655.0,4,4776,0,13655.0,5,13660.0,12,B
2018-04-11 09:25:45,13655.0,2,4778,0,13655.0,4,13660.0,8,B
2018-04-11 09:25:46,13655.0,8,4786,8,13650.0,1,13660.0,6,B
2018-04-11 09:25:49,13650.0,2,4788,0,13645.0,1,13655.0,2,S
2018-04-11 09:25:53,13650.0,2,4790,-2,13645.0,4,13655.0,2,S
2018-04-11 09:26:22,13655.0,2,4792,-2,13650.0,5,13655.0,1,B
2018-04-11 09:26:32,13655.0,2,4794,0,13650.0,5,13660.0,9,B
2018-04-11 09:26:33,13655.0,2,4796,-2,13650.0,5,13655.0,4,B
2018-04-11 09:26:55,13650.0,2,4798,-2,13645.0,4,13655.0,6,S
2018-04-11 09:27:06,13650.0,2,4800,-2,13650.0,3,13655.0,6,S
2018-04-11 09:27:09,13650.0,6,4806,-6,13645.0,4,13650.0,4,S
2018-04-11 09:27:10,13650.0,4,4810,-4,13645.0,4,13650.0,2,S
2018-04-11 09:27:11,13650.0,4,4814,-4,13650.0,5,13655.0,6,S
2018-04-11 09:27:15,13650.0,2,4816,-2,13645.0,4,13650.0,1,S
2018-04-11 09:27:42,13655.0,4,4820,2,13655.0,6,13660.0,23,B
2018-04-11 09:27:43,13655.0,6,4826,6,13655.0,3,13660.0,23,B
2018-04-11 09:27:56,13655.0,6,4832,6,13650.0,1,13655.0,2,B
2018-04-11 09:28:22,13650.0,2,4834,0,13650.0,3,13655.0,5,S
2018-04-11 09:29:12,13645.0,2,4836,-2,13640.0,3,13650.0,5,S
2018-04-11 09:29:19,13640.0,2,4838,-2,13640.0,3,13650.0,6,S
2018-04-11 09:29:22,13650.0,4,4842,4,13650.0,6,13655.0,11,B
2018-04-11 09:29:28,13650.0,2,4844,2,13650.0,5,13655.0,5,B
2018-04-11 09:29:33,13650.0,4,4848,0,13650.0,3,13655.0,5,B
2018-04-11 09:29:36,13650.0,2,4850,2,13650.0,2,13655.0,5,B
2018-04-11 09:29:36,13650.0,2,4852,2,13650.0,2,13655.0,5,B
2018-04-11 09:29:43,13650.0,4,4856,-2,13645.0,18,13655.0,5,B
2018-04-11 09:30:54,13655.0,2,4858,-2,13650.0,1,13655.0,3,B
2018-04-11 09:30:56,13655.0,6,4864,4,13655.0,2,13660.0,19,B
2018-04-11 09:30:56,13655.0,4,4868,4,13650.0,1,13655.0,1,B
2018-04-11 09:31:14,13655.0,2,4870,2,13650.0,4,13655.0,1,B
2018-04-11 09:31:18,13655.0,2,4872,0,13650.0,4,13655.0,1,B
2018-04-11 09:31:21,13655.0,2,4874,2,13650.0,3,13660.0,21,B
2018-04-11 09:31:26,13660.0,6,4880,4,13650.0,3,13660.0,14,B
2018-04-11 09:31:29,13655.0,2,4882,2,13655.0,2,13660.0,14,S
2018-04-11 09:31:31,13655.0,4,4886,0,13650.0,3,13655.0,2,S
2018-04-11 09:31:33,13655.0,6,4892,0,13650.0,3,13660.0,14,S
2018-04-11 09:31:36,13660.0,6,4898,6,13650.0,3,13660.0,11,B
2018-04-11 09:31:38,13660.0,6,4904,6,13650.0,3,13655.0,2,B
2018-04-11 09:31:41,13655.0,4,4908,0,13655.0,1,13660.0,12,S
2018-04-11 09:31:42,13655.0,2,4910,2,13650.0,3,13660.0,16,S
2018-04-11 09:31:46,13655.0,2,4912,2,13655.0,2,13660.0,17,S
2018-04-11 09:31:46,13655.0,4,4916,0,13650.0,3,13660.0,17,S
2018-04-11 09:31:50,13660.0,6,4922,6,13650.0,3,13660.0,15,B
2018-04-11 09:31:56,13655.0,6,4928,0,13650.0,3,13655.0,7,S
2018-04-11 09:32:00,13655.0,6,4934,0,13650.0,3,13655.0,8,S
2018-04-11 09:32:03,13655.0,6,4940,0,13650.0,3,13655.0,5,S
2018-04-11 09:32:09,13650.0,6,4946,-2,13645.0,8,13650.0,7,S
2018-04-11 09:32:09,13650.0,6,4952,-6,13645.0,8,13650.0,4,S
2018-04-11 09:32:10,13650.0,8,4960,-4,13645.0,4,13655.0,6,S
2018-04-11 09:33:12,13650.0,4,4964,-2,13645.0,6,13655.0,6,S
2018-04-11 09:33:25,13650.0,12,4976,-2,13645.0,18,13650.0,4,S
2018-04-11 09:33:25,13650.0,8,4984,-8,13650.0,1,13655.0,2,S
2018-04-11 09:33:29,13650.0,2,4986,-2,13645.0,6,13655.0,2,S
2018-04-11 09:33:50,13645.0,2,4988,0,13640.0,6,13650.0,8,S
2018-04-11 09:33:56,13640.0,2,4990,0,13640.0,6,13650.0,8,S
2018-04-11 09:34:28,13640.0,10,5000,-8,13635.0,2,13645.0,15,S
2018-04-11 09:34:30,13640.0,6,5006,4,13640.0,7,13645.0,11,S
2018-04-11 09:34:32,13640.0,4,5010,-4,13640.0,1,13645.0,11,S
2018-04-11 09:34:49,13640.0,4,5014,0,13635.0,18,13640.0,3,S
2018-04-11 09:34:51,13640.0,2,5016,2,13635.0,6,13640.0,2,S
2018-04-11 09:35:04,13635.0,6,5022,-2,13630.0,16,13635.0,8,S
2018-04-11 09:35:26,13635.0,2,5024,2,13630.0,16,13640.0,19,S
2018-04-11 09:35:27,13630.0,30,5054,-26,13630.0,2,13640.0,17,S
2018-04-11 09:35:34,13635.0,20,5074,0,13630.0,7,13635.0,5,B
2018-04-11 09:36:01,13635.0,2,5076,2,13630.0,4,13635.0,4,B
2018-04-11 09:36:03,13635.0,2,5078,2,13630.0,4,13635.0,16,B
2018-04-11 09:36:04,13630.0,2,5080,0,13630.0,3,13635.0,16,S
2018-04-11 09:36:04,13630.0,4,5084,0,13630.0,1,13635.0,16,S
2018-04-11 09:36:05,13635.0,2,5086,2,13630.0,1,13635.0,15,B
2018-04-11 09:36:07,13630.0,4,5090,2,13625.0,6,13630.0,14,S
2018-04-11 09:36:09,13630.0,2,5092,2,13625.0,4,13630.0,13,S
2018-04-11 09:36:11,13630.0,2,5094,2,13625.0,4,13630.0,12,S
2018-04-11 09:36:13,13630.0,2,5096,0,13625.0,4,13630.0,11,S
2018-04-11 09:36:15,13630.0,2,5098,2,13625.0,4,13630.0,10,S
2018-04-11 09:36:19,13630.0,2,5100,2,13625.0,7,13630.0,9,S
2018-04-11 09:36:22,13630.0,2,5102,2,13625.0,7,13630.0,8,S
2018-04-11 09:36:23,13625.0,2,5104,0,13625.0,6,13630.0,8,S
2018-04-11 09:36:23,13620.0,14,5118,-8,13620.0,21,13630.0,8,S
2018-04-11 09:36:33,13625.0,2,5120,0,13625.0,7,13630.0,8,B
2018-04-11 09:36:34,13630.0,2,5122,2,13625.0,7,13630.0,7,B
2018-04-11 09:36:38,13625.0,18,5140,6,13620.0,36,13625.0,6,S
2018-04-11 09:36:38,13625.0,12,5152,8,13620.0,36,13630.0,9,S
2018-04-11 09:36:44,13630.0,18,5170,0,13625.0,10,13630.0,2,B
2018-04-11 09:36:45,13630.0,4,5174,4,13630.0,1,13635.0,7,B
2018-04-11 09:36:48,13630.0,2,5176,2,13630.0,2,13635.0,7,B
2018-04-11 09:36:53,13630.0,2,5178,-2,13630.0,1,13635.0,7,B
2018-04-11 09:36:58,13630.0,4,5182,0,13630.0,30,13635.0,7,B
2018-04-11 09:37:43,13630.0,6,5188,-4,13630.0,2,13635.0,6,B
2018-04-11 09:37:44,13630.0,4,5192,0,13630.0,1,13635.0,6,B
2018-04-11 09:37:46,13635.0,2,5194,2,13630.0,2,13640.0,26,B
2018-04-11 09:38:04,13630.0,6,5200,4,13625.0,8,13630.0,7,S
2018-04-11 09:38:04,13630.0,8,5208,4,13625.0,7,13630.0,3,S
2018-04-11 09:38:08,13625.0,2,5210,-2,13625.0,3,13630.0,6,S
2018-04-11 09:38:09,13625.0,2,5212,0,13625.0,2,13630.0,6,S
2018-04-11 09:38:29,13625.0,4,5216,-4,13620.0,10,13630.0,5,S
2018-04-11 09:38:41,13620.0,2,5218,-2,13625.0,3,13630.0,7,S
2018-04-11 09:38:53,13630.0,6,5224,2,13625.0,1,13630.0,7,B
2018-04-11 09:38:55,13625.0,2,5226,-2,13620.0,9,13630.0,7,S
2018-04-11 09:39:05,13630.0,2,5228,0,13625.0,7,13630.0,4,B
2018-04-11 09:39:10,13625.0,6,5234,0,13625.0,1,13630.0,4,S
2018-04-11 09:39:27,13625.0,4,5238,2,13625.0,2,13630.0,4,S
2018-04-11 09:39:42,13625.0,4,5242,4,13620.0,37,13625.0,8,S
2018-04-11 09:39:42,13625.0,6,5248,0,13620.0,39,13625.0,5,S
2018-04-11 09:39:43,13625.0,4,5252,4,13620.0,37,13625.0,3,S
2018-04-11 09:39:45,13625.0,6,5258,6,13620.0,39,13630.0,2,S
2018-04-11 09:40:06,13625.0,2,5260,0,13620.0,13,13625.0,8,S
2018-04-11 09:40:29,13620.0,4,5264,0,13620.0,10,13625.0,1,S
2018-04-11 09:40:29,13625.0,2,5266,2,13625.0,7,13630.0,6,B
2018-04-11 09:40:34,13625.0,2,5268,0,13625.0,3,13630.0,2,B
2018-04-11 09:40:45,13625.0,4,5272,0,13620.0,12,13630.0,4,B
2018-04-11 09:40:50,13620.0,2,5274,2,13620.0,24,13630.0,4,S
2018-04-11 09:41:02,13620.0,2,5276,2,13620.0,10,13625.0,1,S
2018-04-11 09:41:06,13625.0,2,5278,-2,13620.0,10,13630.0,6,B
2018-04-11 09:41:22,13625.0,2,5280,0,13625.0,1,13630.0,6,B
2018-04-11 09:41:50,13625.0,2,5282,2,13620.0,13,13630.0,7,B
2018-04-11 09:42:06,13625.0,2,5284,2,13620.0,13,13630.0,7,B
2018-04-11 09:42:29,13630.0,4,5288,4,13625.0,2,13630.0,5,B
2018-04-11 09:42:36,13630.0,2,5290,0,13625.0,2,13630.0,4,B
2018-04-11 09:43:17,13625.0,4,5294,-2,13625.0,1,13630.0,3,S
2018-04-11 09:43:43,13625.0,2,5296,0,13620.0,11,13625.0,6,S
2018-04-11 09:44:07,13625.0,2,5298,0,13620.0,8,13625.0,2,S
2018-04-11 09:45:02,13620.0,10,5308,-2,13620.0,2,13625.0,12,S
2018-04-11 09:45:03,13620.0,2,5310,0,13620.0,1,13625.0,12,S
2018-04-11 09:45:03,13620.0,2,5312,-2,13615.0,14,13625.0,24,S
2018-04-11 09:45:12,13620.0,2,5314,0,13615.0,10,13625.0,24,S
2018-04-11 09:45:16,13615.0,2,5316,2,13615.0,9,13625.0,12,S
2018-04-11 09:45:16,13615.0,4,5320,4,13615.0,7,13625.0,12,S
2018-04-11 09:45:34,13620.0,2,5322,2,13615.0,14,13620.0,1,B
2018-04-11 09:45:52,13615.0,4,5326,4,13615.0,10,13620.0,3,S
2018-04-11 09:46:03,13615.0,2,5328,0,13615.0,7,13620.0,12,S
2018-04-11 09:46:04,13615.0,2,5330,0,13615.0,6,13620.0,12,S
2018-04-11 09:46:09,13615.0,12,5342,-10,13615.0,1,13620.0,12,S
2018-04-11 09:46:09,13615.0,2,5344,-2,13610.0,73,13615.0,12,S
2018-04-11 09:46:10,13615.0,6,5350,2,13610.0,72,13615.0,1,S
2018-04-11 09:46:13,13610.0,2,5352,2,13610.0,69,13615.0,4,S
2018-04-11 09:46:19,13615.0,4,5356,-2,13610.0,69,13615.0,1,B
2018-04-11 09:46:20,13615.0,8,5364,8,13610.0,73,13620.0,6,B
2018-04-11 09:46:24,13615.0,4,5368,0,13610.0,73,13620.0,3,B
2018-04-11 09:47:26,13615.0,16,5384,8,13610.0,77,13615.0,2,B
2018-04-11 09:47:27,13615.0,2,5386,0,13610.0,76,13615.0,1,B
2018-04-11 09:47:27,13615.0,2,5388,0,13610.0,76,13620.0,4,B
2018-04-11 09:47:50,13615.0,2,5390,0,13610.0,77,13620.0,7,B
2018-04-11 09:47:57,13615.0,4,5394,0,13610.0,77,13615.0,8,B
2018-04-11 09:48:18,13615.0,2,5396,0,13610.0,70,13615.0,7,B
2018-04-11 09:48:20,13610.0,6,5402,6,13610.0,67,13615.0,7,S
2018-04-11 09:48:20,13615.0,4,5406,4,13610.0,69,13615.0,5,B
2018-04-11 09:48:24,13615.0,4,5410,4,13610.0,71,13615.0,3,B
2018-04-11 09:48:50,13615.0,2,5412,0,13610.0,72,13615.0,10,B
2018-04-11 09:48:51,13615.0,2,5414,2,13610.0,72,13615.0,9,B
2018-04-11 09:48:54,13615.0,2,5416,0,13610.0,70,13615.0,8,B
2018-04-11 09:48:57,13610.0,100,5516,98,13610.0,20,13615.0,8,S
2018-04-11 09:48:58,13610.0,2,5518,0,13610.0,19,13615.0,8,S
2018-04-11 09:49:08,13610.0,40,5558,30,13605.0,93,13615.0,8,S
2018-04-11 09:49:11,13610.0,6,5564,2,13605.0,114,13610.0,2,S
2018-04-11 09:49:11,13610.0,4,5568,0,13605.0,114,13615.0,8,S
2018-04-11 09:49:14,13610.0,2,5570,-2,13605.0,78,13610.0,2,S
2018-04-11 09:49:24,13610.0,2,5572,0,13610.0,1,13615.0,12,S
2018-04-11 09:49:24,13610.0,2,5574,2,13605.0,75,13610.0,2,S
2018-04-11 09:49:51,13610.0,6,5580,6,13605.0,88,13615.0,13,S
2018-04-11 09:49:58,13605.0,2,5582,-2,13605.0,71,13615.0,17,S
2018-04-11 09:49:58,13610.0,4,5586,-4,13605.0,64,13610.0,1,B
2018-04-11 09:50:03,13605.0,20,5606,16,13605.0,54,13610.0,3,S
2018-04-11 09:50:09,13605.0,40,5646,40,13605.0,34,13610.0,3,S
2018-04-11 09:50:13,13605.0,40,5686,40,13605.0,14,13610.0,3,S
2018-04-11 09:50:15,13610.0,2,5688,-2,13610.0,1,13615.0,10,B
2018-04-11 09:50:36,13615.0,6,5694,4,13610.0,10,13615.0,7,B
2018-04-11 09:50:46,13610.0,10,5704,2,13605.0,44,13610.0,3,S
2018-04-11 09:51:02,13610.0,8,5712,4,13605.0,16,13610.0,6,S
2018-04-11 09:51:03,13605.0,2,5714,2,13605.0,15,13610.0,6,S
2018-04-11 09:51:07,13610.0,2,5716,0,13605.0,15,13610.0,3,B
2018-04-11 09:51:19,13605.0,4,5720,4,13605.0,13,13610.0,9,S
2018-04-11 09:51:20,13605.0,10,5730,8,13605.0,8,13610.0,6,S
2018-04-11 09:51:25,13605.0,10,5740,8,13605.0,3,13610.0,3,S
2018-04-11 09:51:27,13605.0,2,5742,-2,13605.0,2,13610.0,3,S
2018-04-11 09:51:29,13605.0,2,5744,0,13605.0,1,13610.0,5,S
2018-04-11 09:51:30,13605.0,2,5746,-2,13600.0,20,13610.0,6,S
2018-04-11 09:51:37,13600.0,10,5756,-2,13600.0,11,13605.0,3,S
2018-04-11 09:51:38,13600.0,20,5776,0,13600.0,1,13605.0,4,S
2018-04-11 09:51:38,13595.0,4,5780,-2,13595.0,3,13600.0,1,S
2018-04-11 09:51:39,13595.0,12,5792,-4,13590.0,6,13595.0,2,S
2018-04-11 09:51:39,13595.0,4,5796,-4,13595.0,2,13600.0,3,S
2018-04-11 09:51:41,13595.0,2,5798,-2,13590.0,11,13600.0,29,S
2018-04-11 09:51:43,13595.0,4,5802,4,13590.0,9,13600.0,26,S
2018-04-11 09:51:44,13590.0,10,5812,0,13585.0,4,13590.0,3,S
2018-04-11 09:51:45,13585.0,4,5816,-2,13580.0,6,13590.0,18,S
2018-04-11 09:51:45,13585.0,10,5826,-4,13585.0,6,13590.0,12,S
2018-04-11 09:51:46,13585.0,12,5838,-4,13580.0,6,13585.0,7,S
2018-04-11 09:51:48,13585.0,6,5844,-2,13585.0,2,13595.0,6,S
2018-04-11 09:51:49,13595.0,2,5846,0,13585.0,1,13595.0,10,B
2018-04-11 09:51:53,13590.0,2,5848,-2,13580.0,10,13590.0,14,S
2018-04-11 09:51:58,13585.0,2,5850,0,13580.0,10,13585.0,5,S
2018-04-11 09:51:59,13575.0,18,5868,6,13570.0,3,13575.0,1,S
2018-04-11 09:51:59,13565.0,14,5882,4,13565.0,7,13575.0,3,S
2018-04-11 09:52:00,13560.0,18,5900,10,13555.0,3,13570.0,10,S
2018-04-11 09:52:00,13555.0,4,5904,4,13550.0,10,13555.0,2,S
2018-04-11 09:52:01,13555.0,2,5906,0,13555.0,2,13560.0,8,S
2018-04-11 09:52:01,13555.0,4,5910,4,13555.0,3,13560.0,8,S
2018-04-11 09:52:03,13555.0,2,5912,0,13555.0,3,13560.0,6,S
2018-04-11 09:52:03,13555.0,4,5916,-4,13550.0,12,13560.0,8,S
2018-04-11 09:52:05,13555.0,2,5918,0,13550.0,9,13555.0,1,S
2018-04-11 09:52:06,13550.0,4,5922,2,13550.0,8,13555.0,1,S
2018-04-11 09:52:06,13555.0,8,5930,2,13550.0,5,13555.0,1,B
2018-04-11 09:52:07,13550.0,10,5940,-6,13550.0,10,13560.0,6,S
2018-04-11 09:52:08,13550.0,2,5942,0,13550.0,11,13560.0,6,S
2018-04-11 09:52:09,13550.0,12,5954,4,13550.0,4,13555.0,1,S
2018-04-11 09:52:10,13555.0,2,5956,-2,13550.0,5,13560.0,6,B
2018-04-11 09:52:12,13555.0,4,5960,0,13555.0,4,13560.0,7,B
2018-04-11 09:52:14,13560.0,4,5964,4,13560.0,9,13565.0,2,B
2018-04-11 09:52:15,13560.0,2,5966,0,13560.0,9,13570.0,8,B
2018-04-11 09:52:21,13570.0,2,5968,2,13560.0,7,13570.0,7,B
2018-04-11 09:52:27,13565.0,2,5970,2,13565.0,2,13570.0,4,S
2018-04-11 09:52:28,13565.0,2,5972,0,13560.0,3,13565.0,1,S
2018-04-11 09:52:29,13565.0,2,5974,-2,13560.0,3,13570.0,6,S
2018-04-11 09:52:29,13560.0,2,5976,0,13560.0,5,13570.0,5,S
2018-04-11 09:52:31,13560.0,2,5978,-2,13560.0,5,13565.0,2,S
2018-04-11 09:52:34,13565.0,2,5980,0,13560.0,8,13565.0,1,B
2018-04-11 09:52:37,13565.0,4,5984,-2,13560.0,3,13570.0,4,B
2018-04-11 09:52:42,13565.0,2,5986,-2,13565.0,2,13570.0,4,B
2018-04-11 09:52:49,13570.0,2,5988,0,13565.0,4,13575.0,6,B
2018-04-11 09:53:02,13570.0,2,5990,-2,13565.0,12,13575.0,3,B
2018-04-11 09:53:15,13575.0,6,5996,2,13570.0,8,13580.0,9,B
2018-04-11 09:53:19,13575.0,2,5998,0,13575.0,1,13580.0,9,B
2018-04-11 09:53:20,13575.0,2,6000,0,13570.0,3,13580.0,9,B
2018-04-11 09:53:26,13580.0,2,6002,-2,13575.0,2,13580.0,3,B
2018-04-11 09:53:33,13580.0,2,6004,0,13570.0,7,13580.0,9,B
2018-04-11 09:53:36,13580.0,4,6008,4,13575.0,1,13580.0,4,B
2018-04-11 09:53:39,13580.0,6,6014,0,13575.0,4,13585.0,6,B
2018-04-11 09:53:42,13585.0,2,6016,-2,13580.0,2,13585.0,1,B
2018-04-11 09:53:44,13580.0,4,6020,0,13575.0,9,13580.0,8,S
2018-04-11 09:53:51,13575.0,4,6024,-2,13575.0,4,13580.0,7,S
2018-04-11 09:53:52,13575.0,2,6026,0,13575.0,1,13580.0,7,S
2018-04-11 09:53:54,13575.0,4,6030,-4,13575.0,1,13580.0,7,S
2018-04-11 09:53:55,13575.0,4,6034,-2,13575.0,1,13580.0,7,S
2018-04-11 09:54:02,13575.0,2,6036,0,13570.0,17,13575.0,4,S
2018-04-11 09:54:03,13575.0,2,6038,0,13570.0,18,13575.0,1,S
2018-04-11 09:54:13,13570.0,8,6046,0,13570.0,11,13575.0,10,S
2018-04-11 09:54:14,13570.0,2,6048,0,13570.0,10,13575.0,9,S
2018-04-11 09:54:23,13570.0,2,6050,0,13570.0,9,13575.0,5,S
2018-04-11 09:54:30,13570.0,4,6054,0,13570.0,7,13575.0,3,S
2018-04-11 09:54:30,13570.0,2,6056,0,13570.0,6,13575.0,3,S
2018-04-11 09:54:32,13575.0,2,6058,0,13570.0,6,13575.0,2,B
2018-04-11 09:54:33,13570.0,4,6062,-4,13570.0,4,13575.0,2,S
2018-04-11 09:54:33,13570.0,4,6066,0,13570.0,2,13575.0,2,S
2018-04-11 09:54:34,13570.0,4,6070,2,13565.0,10,13570.0,5,S
2018-04-11 09:54:40,13565.0,20,6090,0,13560.0,4,13570.0,8,S
2018-04-11 09:54:45,13565.0,2,6092,0,13560.0,3,13565.0,4,S
2018-04-11 09:54:47,13560.0,6,6098,4,13555.0,9,13560.0,7,S
2018-04-11 09:54:47,13560.0,6,6104,0,13555.0,8,13560.0,4,S
2018-04-11 09:54:49,13560.0,8,6112,8,13555.0,6,13565.0,5,S
2018-04-11 09:54:52,13555.0,2,6114,2,13560.0,1,13565.0,5,S
2018-04-11 09:54:54,13555.0,10,6124,6,13555.0,3,13565.0,4,S
2018-04-11 09:55:03,13560.0,2,6126,2,13555.0,6,13560.0,2,B
2018-04-11 09:55:05,13555.0,4,6130,2,13555.0,4,13560.0,3,S
2018-04-11 09:55:10,13555.0,2,6132,2,13555.0,8,13560.0,4,S
2018-04-11 09:55:11,13560.0,12,6144,8,13555.0,6,13565.0,5,B
2018-04-11 09:55:14,13555.0,10,6154,-6,13555.0,3,13565.0,5,S
2018-04-11 09:55:16,13565.0,2,6156,0,13565.0,1,13570.0,8,B
2018-04-11 09:55:17,13565.0,2,6158,-2,13565.0,8,13570.0,3,B
2018-04-11 09:55:19,13565.0,2,6160,0,13560.0,5,13570.0,10,B
2018-04-11 09:55:22,13560.0,14,6174,-8,13560.0,2,13570.0,10,S
2018-04-11 09:55:25,13570.0,8,6182,0,13565.0,1,13570.0,2,B
2018-04-11 09:55:28,13565.0,2,6184,0,13565.0,2,13570.0,2,S
2018-04-11 09:55:30,13565.0,4,6188,0,13565.0,1,13570.0,1,S
2018-04-11 09:55:36,13565.0,2,6190,0,13565.0,1,13570.0,7,S
2018-04-11 09:55:43,13560.0,2,6192,-2,13560.0,6,13570.0,12,S
2018-04-11 09:55:46,13570.0,2,6194,0,13565.0,3,13570.0,5,B
2018-04-11 09:55:47,13570.0,2,6196,-2,13565.0,3,13570.0,4,B
2018-04-11 09:55:50,13565.0,2,6198,0,13560.0,12,13570.0,6,S
2018-04-11 09:55:51,13570.0,4,6202,-4,13565.0,1,13570.0,9,B
2018-04-11 09:55:56,13565.0,2,6204,2,13560.0,11,13570.0,9,S
2018-04-11 09:56:09,13565.0,2,6206,0,13560.0,13,13570.0,10,S
2018-04-11 09:56:14,13570.0,8,6214,0,13560.0,13,13570.0,6,B
2018-04-11 09:56:21,13565.0,2,6216,-2,13565.0,5,13575.0,9,S
2018-04-11 09:56:33,13575.0,4,6220,4,13570.0,7,13575.0,2,B
2018-04-11 09:56:33,13575.0,4,6224,0,13570.0,7,13580.0,15,B
2018-04-11 09:56:39,13580.0,2,6226,-2,13575.0,1,13580.0,9,B
2018-04-11 09:56:47,13580.0,2,6228,-2,13575.0,19,13580.0,7,B
2018-04-11 09:56:49,13580.0,2,6230,-2,13575.0,7,13580.0,7,B
2018-04-11 09:56:54,13575.0,2,6232,2,13575.0,1,13580.0,12,S
2018-04-11 09:56:54,13575.0,2,6234,2,13570.0,3,13575.0,5,S
2018-04-11 09:56:55,13570.0,2,6236,2,13565.0,5,13575.0,5,S
2018-04-11 09:57:06,13570.0,2,6238,2,13565.0,8,13570.0,1,S
2018-04-11 09:57:11,13570.0,2,6240,2,13565.0,3,13575.0,12,S
2018-04-11 09:57:16,13580.0,2,6242,0,13570.0,5,13580.0,11,B
2018-04-11 09:57:17,13575.0,2,6244,-2,13570.0,5,13580.0,11,S
2018-04-11 09:57:18,13570.0,2,6246,0,13570.0,4,13580.0,11,S
2018-04-11 09:57:24,13575.0,2,6248,0,13570.0,6,13580.0,11,B
2018-04-11 09:57:33,13575.0,2,6250,0,13575.0,3,13580.0,5,B
2018-04-11 09:57:39,13580.0,4,6254,-2,13575.0,3,13580.0,3,B
2018-04-11 09:57:40,13575.0,6,6260,0,13570.0,6,13580.0,3,S
2018-04-11 09:57:45,13580.0,2,6262,2,13575.0,1,13580.0,2,B
2018-04-11 09:57:51,13575.0,6,6268,0,13570.0,19,13575.0,1,S
2018-04-11 09:57:52,13575.0,2,6270,0,13575.0,1,13580.0,6,S
2018-04-11 09:57:55,13575.0,4,6274,4,13570.0,19,13580.0,4,S
2018-04-11 09:58:11,13575.0,4,6278,-4,13575.0,1,13580.0,4,S
2018-04-11 09:58:12,13580.0,6,6284,4,13575.0,5,13585.0,7,B
2018-04-11 09:58:26,13580.0,4,6288,4,13575.0,21,13580.0,1,B
2018-04-11 09:58:27,13580.0,2,6290,2,13575.0,21,13585.0,5,B
2018-04-11 09:58:33,13585.0,4,6294,2,13580.0,6,13590.0,9,B
2018-04-11 09:58:41,13585.0,4,6298,0,13585.0,2,13590.0,7,B
2018-04-11 09:58:59,13580.0,4,6302,2,13575.0,17,13585.0,8,S
2018-04-11 09:59:07,13585.0,2,6304,-2,13575.0,8,13585.0,8,B
2018-04-11 09:59:13,13580.0,2,6306,0,13575.0,4,13580.0,4,S
2018-04-11 09:59:17,13580.0,2,6308,2,13575.0,9,13580.0,4,S
2018-04-11 09:59:29,13580.0,2,6310,2,13575.0,10,13580.0,9,S
2018-04-11 09:59:33,13580.0,2,6312,0,13575.0,10,13580.0,8,S
2018-04-11 09:59:34,13580.0,6,6318,2,13575.0,10,13580.0,5,S
2018-04-11 09:59:44,13580.0,2,6320,2,13575.0,10,13580.0,6,S
2018-04-11 09:59:45,13575.0,2,6322,-2,13575.0,8,13580.0,8,S
2018-04-11 09:59:45,13575.0,16,6338,-4,13570.0,4,13580.0,10,S
2018-04-11 09:59:46,13575.0,2,6340,-2,13570.0,3,13575.0,1,S
2018-04-11 10:00:03,13570.0,2,6342,2,13570.0,2,13575.0,6,S
2018-04-11 10:00:29,13575.0,4,6346,0,13570.0,8,13580.0,15,B
2018-04-11 10:00:30,13580.0,14,6360,10,13580.0,1,13585.0,7,B
2018-04-11 10:00:52,13585.0,2,6362,0,13580.0,15,13585.0,2,B
2018-04-11 10:00:57,13585.0,2,6364,0,13580.0,9,13585.0,4,B
2018-04-11 10:01:01,13585.0,2,6366,-2,13580.0,8,13585.0,3,B
2018-04-11 10:01:01,13585.0,2,6368,-2,13580.0,8,13585.0,2,B
2018-04-11 10:01:02,13585.0,4,6372,0,13580.0,8,13590.0,9,B
2018-04-11 10:01:07,13590.0,12,6384,8,13590.0,9,13595.0,8,B
2018-04-11 10:01:14,13595.0,10,6394,0,13590.0,10,13595.0,2,B
2018-04-11 10:01:15,13595.0,6,6400,2,13590.0,10,13600.0,35,B
2018-04-11 10:01:16,13595.0,4,6404,-2,13590.0,10,13600.0,40,B
2018-04-11 10:01:17,13595.0,2,6406,0,13590.0,10,13595.0,2,B
2018-04-11 10:01:31,13595.0,12,6418,-4,13590.0,10,13595.0,9,B
2018-04-11 10:01:47,13590.0,4,6422,-4,13585.0,4,13595.0,10,S
2018-04-11 10:01:55,13585.0,2,6424,0,13585.0,1,13590.0,4,S
2018-04-11 10:01:58,13590.0,2,6426,0,13585.0,7,13590.0,1,B
2018-04-11 10:01:59,13590.0,2,6428,2,13585.0,19,13595.0,13,B
2018-04-11 10:02:02,13590.0,2,6430,2,13590.0,1,13595.0,10,B
2018-04-11 10:02:11,13590.0,8,6438,4,13590.0,5,13595.0,10,B
2018-04-11 10:02:11,13590.0,4,6442,4,13590.0,4,13595.0,10,B
2018-04-11 10:02:14,13590.0,2,6444,2,13590.0,3,13595.0,10,B
2018-04-11 10:02:16,13590.0,2,6446,0,13590.0,5,13595.0,10,B
2018-04-11 10:02:29,13595.0,2,6448,2,13590.0,4,13595.0,7,B
2018-04-11 10:02:31,13590.0,2,6450,0,13590.0,3,13595.0,7,S
2018-04-11 10:02:44,13590.0,2,6452,2,13590.0,4,13595.0,8,S
2018-04-11 10:02:51,13590.0,2,6454,2,13590.0,3,13595.0,8,S
2018-04-11 10:02:57,13590.0,8,6462,-2,13585.0,19,13590.0,6,S
2018-04-11 10:02:59,13590.0,4,6466,0,13585.0,7,13590.0,4,S
2018-04-11 10:03:03,13585.0,2,6468,2,13580.0,5,13585.0,2,S
2018-04-11 10:03:11,13580.0,2,6470,2,13580.0,2,13585.0,3,S
2018-04-11 10:03:58,13585.0,2,6472,-2,13580.0,4,13585.0,1,B
2018-04-11 10:04:03,13580.0,2,6474,0,13580.0,3,13585.0,8,S
2018-04-11 10:04:03,13580.0,2,6476,0,13580.0,2,13585.0,8,S
2018-04-11 10:04:04,13580.0,4,6480,-2,13575.0,6,13585.0,8,S
2018-04-11 10:04:34,13580.0,4,6484,2,13575.0,2,13580.0,3,S
2018-04-11 10:04:42,13580.0,2,6486,2,13575.0,2,13580.0,2,S
2018-04-11 10:04:48,13575.0,4,6490,2,13570.0,6,13575.0,1,S
2018-04-11 10:04:49,13570.0,2,6492,-2,13570.0,3,13575.0,8,S
2018-04-11 10:04:51,13570.0,6,6498,-4,13565.0,9,13575.0,7,S
2018-04-11 10:05:03,13565.0,2,6500,0,13565.0,3,13570.0,1,S
2018-04-11 10:05:10,13565.0,4,6504,4,13565.0,2,13570.0,1,S
2018-04-11 10:05:13,13570.0,2,6506,-2,13570.0,1,13575.0,8,B
2018-04-11 10:05:13,13570.0,2,6508,0,13565.0,2,13570.0,9,B
2018-04-11 10:05:18,13570.0,4,6512,0,13565.0,6,13570.0,1,B
2018-04-11 10:05:22,13570.0,2,6514,-2,13570.0,2,13575.0,4,B
2018-04-11 10:05:31,13570.0,2,6516,0,13570.0,3,13575.0,5,B
2018-04-11 10:05:34,13575.0,2,6518,0,13570.0,5,13575.0,2,B
2018-04-11 10:05:36,13575.0,4,6522,0,13575.0,3,13580.0,2,B
2018-04-11 10:05:37,13580.0,2,6524,2,13575.0,2,13580.0,1,B
2018-04-11 10:05:39,13575.0,2,6526,0,13575.0,2,13580.0,1,S
2018-04-11 10:06:00,13575.0,2,6528,-2,13570.0,5,13575.0,1,S
2018-04-11 10:06:10,13575.0,2,6530,-2,13575.0,2,13580.0,2,S
2018-04-11 10:06:58,13575.0,8,6538,-6,13570.0,8,13580.0,2,S
2018-04-11 10:07:03,13575.0,2,6540,0,13570.0,8,13580.0,6,S
2018-04-11 10:07:23,13575.0,2,6542,0,13575.0,2,13580.0,2,S
2018-04-11 10:07:43,13575.0,4,6546,-2,13570.0,22,13580.0,2,S
2018-04-11 10:07:44,13575.0,2,6548,0,13575.0,1,13580.0,2,S
2018-04-11 10:07:45,13575.0,2,6550,0,13570.0,22,13580.0,2,S
2018-04-11 10:07:51,13575.0,2,6552,-2,13575.0,5,13580.0,4,S
2018-04-11 10:08:30,13575.0,4,6556,-2,13570.0,7,13580.0,7,S
2018-04-11 10:09:03,13570.0,12,6568,-6,13565.0,24,13575.0,1,S
2018-04-11 10:09:03,13570.0,4,6572,4,13565.0,26,13575.0,2,S
2018-04-11 10:09:20,13570.0,2,6574,2,13565.0,25,13575.0,3,S
2018-04-11 10:09:50,13565.0,4,6578,-4,13565.0,4,13570.0,5,S
2018-04-11 10:10:00,13570.0,2,6580,0,13565.0,4,13570.0,3,B
2018-04-11 10:10:03,13570.0,2,6582,0,13565.0,4,13570.0,2,B
2018-04-11 10:10:08,13570.0,2,6584,-2,13565.0,4,13570.0,1,B
2018-04-11 10:10:21,13570.0,2,6586,0,13565.0,19,13575.0,7,B
2018-04-11 10:10:32,13570.0,10,6596,6,13570.0,1,13575.0,5,B
2018-04-11 10:10:43,13575.0,2,6598,0,13570.0,2,13575.0,4,B
2018-04-11 10:10:44,13575.0,2,6600,2,13570.0,2,13575.0,3,B
2018-04-11 10:10:46,13575.0,6,6606,6,13570.0,9,13580.0,9,B
2018-04-11 10:11:12,13575.0,2,6608,0,13570.0,8,13580.0,7,B
2018-04-11 10:11:15,13580.0,4,6612,-2,13575.0,2,13585.0,9,B
2018-04-11 10:11:30,13580.0,2,6614,-2,13580.0,2,13585.0,2,B
2018-04-11 10:11:37,13585.0,4,6618,4,13580.0,5,13590.0,9,B
2018-04-11 10:11:41,13590.0,2,6620,0,13580.0,4,13590.0,7,B
2018-04-11 10:11:49,13590.0,2,6622,-2,13580.0,4,13590.0,6,B
2018-04-11 10:12:04,13585.0,2,6624,-2,13580.0,3,13585.0,7,S
2018-04-11 10:12:24,13580.0,2,6626,0,13580.0,3,13585.0,15,S
2018-04-11 10:12:43,13585.0,2,6628,0,13580.0,6,13585.0,12,B
2018-04-11 10:13:20,13580.0,2,6630,0,13580.0,4,13585.0,16,S
2018-04-11 10:13:38,13580.0,2,6632,-2,13580.0,2,13585.0,17,S
2018-04-11 10:13:38,13580.0,4,6636,2,13575.0,4,13580.0,3,S
2018-04-11 10:13:41,13575.0,2,6638,0,13570.0,5,13575.0,1,S
2018-04-11 10:14:15,13580.0,8,6646,0,13580.0,1,13585.0,17,B
2018-04-11 10:14:16,13580.0,2,6648,2,13575.0,5,13580.0,1,B
2018-04-11 10:14:21,13580.0,2,6650,0,13580.0,1,13585.0,16,B
2018-04-11 10:14:26,13580.0,2,6652,0,13575.0,7,13585.0,16,B
2018-04-11 10:14:35,13580.0,2,6654,0,13575.0,18,13585.0,13,B
2018-04-11 10:30:01,13580.0,2,6656,0,13575.0,2,13580.0,1,B
2018-04-11 10:30:03,13575.0,2,6658,0,13575.0,4,13580.0,1,S
2018-04-11 10:30:21,13575.0,4,6662,2,13575.0,22,13585.0,14,S
2018-04-11 10:30:43,13575.0,2,6664,-2,13575.0,1,13580.0,4,S
2018-04-11 10:30:59,13575.0,2,6666,0,13570.0,7,13580.0,4,S
2018-04-11 10:31:21,13575.0,4,6670,-4,13570.0,5,13580.0,7,S
2018-04-11 10:32:02,13570.0,10,6680,2,13565.0,8,13575.0,1,S
2018-04-11 10:32:54,13580.0,2,6682,-2,13570.0,3,13580.0,6,B
2018-04-11 10:33:35,13580.0,2,6684,0,13575.0,4,13580.0,1,B
2018-04-11 10:33:36,13580.0,2,6686,2,13575.0,4,13585.0,25,B
2018-04-11 10:34:00,13585.0,2,6688,2,13575.0,20,13585.0,16,B
2018-04-11 10:34:55,13585.0,2,6690,2,13580.0,19,13585.0,16,B
2018-04-11 10:34:59,13585.0,2,6692,2,13580.0,8,13585.0,15,B
2018-04-11 10:35:00,13585.0,2,6694,2,13580.0,13,13585.0,14,B
2018-04-11 10:35:01,13585.0,28,6722,24,13580.0,28,13590.0,9,B
2018-04-11 10:35:02,13585.0,8,6730,-2,13585.0,6,13590.0,5,B
2018-04-11 10:35:02,13590.0,10,6740,2,13585.0,1,13590.0,4,B
2018-04-11 10:35:15,13585.0,2,6742,0,13580.0,7,13585.0,1,S
2018-04-11 10:35:16,13585.0,2,6744,2,13580.0,2,13585.0,5,S
2018-04-11 10:36:06,13585.0,2,6746,2,13580.0,10,13590.0,5,S
2018-04-11 10:36:17,13580.0,4,6750,4,13575.0,6,13585.0,8,S
2018-04-11 10:37:32,13575.0,2,6752,2,13575.0,4,13580.0,1,S
2018-04-11 10:37:47,13580.0,2,6754,2,13575.0,4,13585.0,8,B
2018-04-11 10:41:06,13585.0,2,6756,0,13585.0,2,13590.0,5,B
2018-04-11 10:41:12,13585.0,2,6758,2,13585.0,3,13590.0,5,B
2018-04-11 10:41:23,13585.0,4,6762,2,13585.0,1,13590.0,5,B
2018-04-11 10:41:39,13585.0,2,6764,2,13580.0,9,13590.0,7,B
2018-04-11 10:41:52,13585.0,4,6768,-2,13580.0,18,13590.0,12,B
2018-04-11 10:42:00,13585.0,4,6772,4,13580.0,19,13585.0,3,B
2018-04-11 10:42:08,13585.0,2,6774,0,13580.0,6,13585.0,2,B
2018-04-11 10:42:30,13585.0,2,6776,2,13580.0,5,13585.0,4,B
2018-04-11 10:42:32,13585.0,4,6780,-2,13580.0,33,13585.0,2,B
2018-04-11 10:42:33,13585.0,4,6784,-4,13580.0,31,13590.0,7,B
2018-04-11 10:42:53,13590.0,2,6786,2,13585.0,4,13590.0,5,B
2018-04-11 10:43:01,13590.0,2,6788,2,13585.0,4,13590.0,4,B
2018-04-11 10:43:01,13590.0,2,6790,2,13585.0,4,13590.0,3,B
2018-04-11 10:43:28,13590.0,2,6792,0,13585.0,4,13590.0,2,B
2018-04-11 10:43:50,13590.0,4,6796,0,13585.0,5,13595.0,18,B
2018-04-11 10:43:54,13595.0,24,6820,-2,13590.0,34,13600.0,11,B
2018-04-11 10:43:55,13600.0,2,6822,-2,13595.0,4,13600.0,10,B
2018-04-11 10:43:55,13600.0,2,6824,2,13595.0,4,13600.0,7,B
2018-04-11 10:43:59,13595.0,2,6826,-2,13590.0,39,13600.0,9,S
2018-04-11 10:44:02,13600.0,4,6830,0,13590.0,2,13600.0,11,B
2018-04-11 10:44:03,13595.0,2,6832,0,13595.0,2,13600.0,9,S
2018-04-11 10:44:04,13600.0,8,6840,0,13595.0,2,13600.0,5,B
2018-04-11 10:44:05,13595.0,2,6842,0,13595.0,1,13600.0,5,S
2018-04-11 10:44:06,13595.0,2,6844,2,13590.0,4,13600.0,5,S
2018-04-11 10:44:13,13595.0,2,6846,-2,13590.0,5,13600.0,8,S
2018-04-11 10:44:16,13595.0,2,6848,0,13590.0,18,13600.0,6,S
2018-04-11 10:44:25,13595.0,2,6850,0,13590.0,4,13595.0,1,S
2018-04-11 10:44:26,13590.0,4,6854,0,13590.0,5,13595.0,1,S
2018-04-11 10:44:45,13595.0,2,6856,-2,13590.0,5,13600.0,14,B
2018-04-11 10:45:06,13595.0,2,6858,-2,13590.0,5,13595.0,1,B
2018-04-11 10:45:17,13595.0,2,6860,2,13590.0,32,13600.0,10,B
2018-04-11 10:45:37,13595.0,2,6862,0,13590.0,19,13595.0,2,B
2018-04-11 10:45:39,13590.0,2,6864,2,13590.0,18,13595.0,3,S
2018-04-11 10:46:03,13590.0,8,6872,-2,13585.0,5,13595.0,4,S
2018-04-11 10:47:05,13595.0,2,6874,0,13590.0,3,13595.0,2,B
2018-04-11 10:47:05,13595.0,2,6876,-2,13590.0,8,13595.0,1,B
2018-04-11 10:47:06,13595.0,2,6878,0,13595.0,1,13600.0,12,B
2018-04-11 10:47:13,13595.0,2,6880,0,13590.0,9,13600.0,8,B
2018-04-11 10:47:25,13595.0,2,6882,2,13595.0,1,13600.0,11,B
2018-04-11 10:47:43,13600.0,2,6884,-2,13595.0,5,13600.0,8,B
2018-04-11 10:47:50,13600.0,2,6886,2,13595.0,5,13600.0,7,B
2018-04-11 10:47:56,13600.0,2,6888,2,13595.0,5,13600.0,6,B
2018-04-11 10:47:58,13600.0,2,6890,2,13595.0,5,13600.0,5,B
2018-04-11 10:47:59,13600.0,2,6892,2,13595.0,5,13600.0,4,B
2018-04-11 10:48:18,13595.0,2,6894,2,13590.0,6,13600.0,9,S
2018-04-11 10:50:00,13600.0,4,6898,4,13590.0,10,13600.0,7,B
2018-04-11 10:50:01,13600.0,4,6902,4,13590.0,10,13600.0,5,B
2018-04-11 10:50:02,13600.0,4,6906,2,13590.0,10,13600.0,3,B
2018-04-11 10:50:03,13600.0,4,6910,2,13590.0,11,13600.0,2,B
2018-04-11 10:50:04,13600.0,4,6914,4,13590.0,12,13600.0,2,B
2018-04-11 10:50:05,13600.0,4,6918,2,13590.0,12,13600.0,1,B
2018-04-11 10:50:06,13600.0,4,6922,0,13590.0,12,13605.0,12,B
2018-04-11 10:50:40,13600.0,4,6926,-2,13590.0,3,13600.0,7,B
2018-04-11 10:51:31,13595.0,2,6928,0,13590.0,2,13600.0,11,S
2018-04-11 10:53:26,13590.0,2,6930,0,13590.0,1,13595.0,2,S
2018-04-11 10:53:35,13595.0,4,6934,0,13590.0,3,13600.0,16,B
2018-04-11 10:54:55,13590.0,2,6936,2,13590.0,3,13595.0,5,S
2018-04-11 10:54:59,13590.0,6,6942,0,13585.0,4,13595.0,5,S
2018-04-11 10:55:16,13585.0,2,6944,0,13585.0,1,13590.0,4,S
2018-04-11 10:55:24,13585.0,2,6946,-2,13580.0,17,13590.0,4,S
2018-04-11 10:55:32,13580.0,2,6948,-2,13580.0,2,13585.0,5,S
2018-04-11 10:55:33,13580.0,4,6952,0,13575.0,18,13585.0,5,S
2018-04-11 10:55:45,13580.0,2,6954,0,13580.0,4,13590.0,9,S
2018-04-11 10:56:04,13580.0,2,6956,2,13580.0,6,13590.0,10,S
2018-04-11 10:56:16,13580.0,2,6958,0,13575.0,8,13580.0,3,S
2018-04-11 10:56:20,13580.0,2,6960,0,13575.0,8,13580.0,2,S
2018-04-11 10:56:32,13580.0,6,6966,2,13580.0,3,13585.0,2,S
2018-04-11 10:56:34,13580.0,6,6972,2,13580.0,1,13585.0,3,S
2018-04-11 10:56:35,13580.0,2,6974,-2,13575.0,8,13585.0,3,S
2018-04-11 10:56:45,13580.0,2,6976,0,13580.0,1,13585.0,2,S
2018-04-11 10:57:05,13575.0,2,6978,0,13575.0,6,13580.0,6,S
2018-04-11 10:57:07,13580.0,2,6980,-2,13575.0,8,13585.0,14,B
2018-04-11 10:57:29,13575.0,10,6990,8,13575.0,4,13580.0,1,S
2018-04-11 10:57:31,13575.0,6,6996,4,13570.0,22,13575.0,2,S
2018-04-11 10:57:32,13575.0,4,7000,2,13570.0,21,13580.0,2,S
2018-04-11 10:57:49,13575.0,2,7002,0,13575.0,1,13580.0,2,S
2018-04-11 10:58:00,13575.0,4,7006,4,13575.0,1,13580.0,1,S
2018-04-11 10:58:26,13575.0,2,7008,2,13575.0,3,13580.0,1,S
2018-04-11 10:58:38,13575.0,2,7010,2,13575.0,5,13580.0,1,S
2018-04-11 10:58:41,13580.0,2,7012,0,13575.0,6,13585.0,11,B
2018-04-11 10:59:27,13575.0,2,7014,-2,13575.0,6,13580.0,4,S
2018-04-11 10:59:55,13575.0,2,7016,-2,13575.0,5,13585.0,11,S
2018-04-11 10:59:58,13575.0,6,7022,0,13575.0,2,13585.0,11,S
2018-04-11 11:00:12,13575.0,6,7028,2,13570.0,20,13575.0,2,S
2018-04-11 11:00:13,13575.0,4,7032,0,13570.0,20,13580.0,5,S
2018-04-11 11:00:39,13575.0,4,7036,2,13575.0,4,13580.0,5,S
2018-04-11 11:00:49,13580.0,2,7038,0,13575.0,5,13580.0,4,B
2018-04-11 11:00:52,13580.0,8,7046,8,13575.0,19,13585.0,13,B
2018-04-11 11:01:32,13590.0,4,7050,2,13580.0,18,13590.0,1,B
2018-04-11 11:01:33,13590.0,2,7052,0,13580.0,6,13590.0,1,B
2018-04-11 11:02:06,13590.0,2,7054,2,13590.0,5,13595.0,4,B
2018-04-11 11:03:24,13590.0,2,7056,2,13585.0,33,13595.0,8,B
2018-04-11 11:03:33,13590.0,2,7058,-2,13585.0,31,13595.0,12,B
2018-04-11 11:03:57,13590.0,2,7060,0,13585.0,7,13590.0,3,B
2018-04-11 11:03:59,13590.0,2,7062,0,13585.0,5,13590.0,2,B
2018-04-11 11:05:01,13585.0,2,7064,-2,13585.0,3,13590.0,3,S
2018-04-11 11:05:02,13585.0,6,7070,2,13580.0,4,13585.0,6,S
2018-04-11 11:05:02,13580.0,2,7072,-2,13575.0,33,13585.0,4,S
2018-04-11 11:05:10,13580.0,2,7074,0,13580.0,1,13585.0,3,S
2018-04-11 11:05:22,13580.0,2,7076,2,13575.0,2,13580.0,4,S
2018-04-11 11:05:24,13580.0,2,7078,2,13575.0,17,13585.0,9,S
2018-04-11 11:06:09,13580.0,6,7084,0,13575.0,5,13580.0,2,S
2018-04-11 11:07:20,13580.0,2,7086,2,13575.0,3,13580.0,2,S
2018-04-11 11:07:31,13575.0,2,7088,0,13575.0,1,13580.0,2,S
2018-04-11 11:07:37,13580.0,2,7090,0,13575.0,6,13585.0,15,B
2018-04-11 11:07:44,13580.0,2,7092,0,13575.0,19,13585.0,15,B
2018-04-11 11:09:21,13580.0,2,7094,0,13580.0,1,13585.0,12,B
2018-04-11 11:09:22,13580.0,2,7096,-2,13575.0,10,13585.0,12,B
2018-04-11 11:10:50,13580.0,4,7100,2,13580.0,3,13585.0,8,B
2018-04-11 11:10:51,13580.0,6,7106,-6,13575.0,12,13580.0,1,B
2018-04-11 11:10:59,13575.0,2,7108,-2,13575.0,3,13580.0,4,S
2018-04-11 11:11:03,13575.0,2,7110,-2,13575.0,2,13580.0,4,S
2018-04-11 11:11:03,13575.0,4,7114,-2,13570.0,7,13575.0,5,S
2018-04-11 11:11:20,13580.0,2,7116,2,13580.0,1,13585.0,14,B
2018-04-11 11:11:29,13580.0,2,7118,-2,13575.0,5,13580.0,2,B
2018-04-11 11:11:39,13575.0,2,7120,0,13575.0,5,13585.0,12,S
2018-04-11 11:12:20,13580.0,2,7122,0,13575.0,12,13580.0,1,B
2018-04-11 11:12:23,13580.0,2,7124,-2,13575.0,12,13585.0,15,B
2018-04-11 11:12:38,13580.0,2,7126,2,13575.0,7,13580.0,9,B
2018-04-11 11:12:40,13580.0,2,7128,0,13575.0,10,13580.0,8,B
2018-04-11 11:12:43,13580.0,2,7130,2,13575.0,34,13580.0,7,B
2018-04-11 11:12:44,13580.0,2,7132,2,13575.0,34,13580.0,6,B
2018-04-11 11:12:53,13580.0,2,7134,2,13575.0,21,13580.0,5,B
2018-04-11 11:13:06,13580.0,6,7140,2,13575.0,21,13580.0,2,B
2018-04-11 11:13:09,13580.0,4,7144,0,13575.0,21,13585.0,11,B
2018-04-11 11:13:10,13580.0,2,7146,0,13580.0,1,13585.0,11,B
2018-04-11 11:13:34,13580.0,4,7150,0,13575.0,23,13585.0,9,B
2018-04-11 11:13:39,13575.0,2,7152,0,13575.0,21,13585.0,9,S
2018-04-11 11:14:31,13585.0,2,7154,2,13580.0,2,13585.0,8,B
2018-04-11 11:14:32,13580.0,2,7156,2,13580.0,1,13585.0,8,S
2018-04-11 11:14:40,13580.0,2,7158,0,13575.0,23,13585.0,8,S
2018-04-11 11:15:41,13580.0,2,7160,-2,13575.0,10,13580.0,1,S
2018-04-11 11:15:58,13580.0,2,7162,-2,13575.0,6,13580.0,1,S
2018-04-11 11:16:03,13575.0,6,7168,6,13575.0,3,13580.0,3,S
2018-04-11 11:16:03,13575.0,6,7174,2,13570.0,12,13575.0,9,S
2018-04-11 11:16:07,13575.0,2,7176,0,13570.0,6,13575.0,5,S
2018-04-11 11:16:26,13570.0,10,7186,-4,13570.0,1,13575.0,1,S
2018-04-11 11:16:46,13570.0,2,7188,2,13565.0,7,13575.0,3,S
2018-04-11 11:16:47,13565.0,4,7192,-4,13565.0,4,13570.0,1,S
2018-04-11 11:16:56,13570.0,2,7194,0,13570.0,3,13575.0,2,B
2018-04-11 11:16:58,13570.0,2,7196,0,13570.0,1,13575.0,3,B
2018-04-11 11:17:00,13570.0,2,7198,0,13565.0,24,13570.0,1,B
2018-04-11 11:17:02,13570.0,2,7200,-2,13565.0,24,13575.0,6,B
2018-04-11 11:17:27,13570.0,2,7202,0,13565.0,7,13570.0,2,B
2018-04-11 11:17:27,13570.0,2,7204,0,13565.0,7,13570.0,1,B
2018-04-11 11:17:29,13565.0,2,7206,-2,13565.0,5,13570.0,3,S
2018-04-11 11:17:47,13570.0,2,7208,2,13565.0,5,13570.0,3,B
2018-04-11 11:17:55,13565.0,4,7212,-2,13565.0,3,13570.0,5,S
2018-04-11 11:18:04,13570.0,2,7214,-2,13565.0,4,13575.0,11,B
2018-04-11 11:18:05,13570.0,2,7216,2,13565.0,6,13575.0,11,B
2018-04-11 11:18:11,13570.0,2,7218,0,13565.0,3,13575.0,11,B
2018-04-11 11:18:26,13570.0,2,7220,2,13565.0,3,13570.0,1,B
2018-04-11 11:18:45,13570.0,4,7224,-4,13570.0,2,13575.0,6,B
2018-04-11 11:18:48,13570.0,2,7226,2,13570.0,2,13575.0,3,B
2018-04-11 11:19:02,13570.0,2,7228,-2,13565.0,10,13570.0,1,B
2018-04-11 11:19:22,13570.0,2,7230,0,13570.0,1,13575.0,4,B
2018-04-11 11:19:50,13575.0,8,7238,-4,13575.0,1,13580.0,9,B
2018-04-11 11:19:51,13575.0,2,7240,0,13570.0,2,13580.0,10,B
2018-04-11 11:20:04,13570.0,2,7242,0,13570.0,3,13575.0,3,S
2018-04-11 11:20:06,13570.0,2,7244,2,13570.0,2,13575.0,6,S
2018-04-11 11:20:09,13570.0,4,7248,4,13565.0,8,13570.0,2,S
2018-04-11 11:20:10,13570.0,2,7250,2,13565.0,5,13570.0,1,S
2018-04-11 11:20:19,13565.0,4,7254,-2,13565.0,3,13570.0,1,S
2018-04-11 11:20:30,13565.0,2,7256,-2,13565.0,2,13570.0,1,S
2018-04-11 11:20:34,13570.0,2,7258,0,13565.0,18,13575.0,4,B
2018-04-11 11:21:06,13570.0,4,7262,0,13565.0,20,13575.0,5,B
2018-04-11 11:21:12,13570.0,2,7264,-2,13565.0,8,13575.0,5,B
2018-04-11 11:21:24,13575.0,6,7270,2,13565.0,21,13575.0,3,B
2018-04-11 11:22:03,13570.0,2,7272,0,13565.0,10,13575.0,4,S
2018-04-11 11:22:31,13570.0,2,7274,2,13570.0,9,13575.0,7,S
2018-04-11 11:22:31,13570.0,18,7292,10,13565.0,4,13570.0,4,S
2018-04-11 11:23:02,13565.0,2,7294,2,13565.0,3,13570.0,8,S
2018-04-11 11:23:03,13565.0,2,7296,0,13565.0,2,13570.0,8,S
2018-04-11 11:23:10,13570.0,2,7298,0,13565.0,2,13570.0,5,B
2018-04-11 11:23:22,13570.0,4,7302,2,13565.0,18,13575.0,10,B
2018-04-11 11:24:00,13570.0,2,7304,0,13565.0,5,13575.0,8,B
2018-04-11 11:24:15,13565.0,2,7306,0,13565.0,2,13570.0,11,S
2018-04-11 11:24:17,13565.0,4,7310,0,13560.0,34,13570.0,9,S
2018-04-11 11:24:48,13565.0,2,7312,-2,13560.0,21,13570.0,13,S
2018-04-11 11:24:56,13565.0,2,7314,-2,13565.0,1,13570.0,10,S
2018-04-11 11:24:56,13565.0,2,7316,-2,13560.0,19,13570.0,10,S
2018-04-11 11:25:02,13560.0,6,7322,-4,13560.0,15,13565.0,7,S
2018-04-11 11:25:03,13560.0,4,7326,4,13560.0,13,13565.0,7,S
2018-04-11 11:25:04,13560.0,4,7330,0,13560.0,11,13565.0,9,S
2018-04-11 11:25:06,13565.0,2,7332,0,13560.0,11,13565.0,4,B
2018-04-11 11:25:08,13565.0,4,7336,2,13560.0,11,13565.0,1,B
2018-04-11 11:25:42,13570.0,2,7338,0,13560.0,11,13570.0,10,B
2018-04-11 11:25:59,13570.0,6,7344,-2,13570.0,1,13575.0,9,B
2018-04-11 11:26:06,13575.0,2,7346,-2,13570.0,8,13575.0,2,B
2018-04-11 11:26:06,13575.0,4,7350,0,13570.0,20,13580.0,7,B
2018-04-11 11:26:36,13575.0,4,7354,-2,13570.0,3,13580.0,11,B
2018-04-11 11:26:47,13570.0,2,7356,2,13570.0,1,13575.0,13,S
2018-04-11 11:27:26,13575.0,10,7366,-4,13570.0,4,13575.0,4,B
2018-04-11 11:27:30,13575.0,8,7374,0,13575.0,1,13580.0,12,B
2018-04-11 11:27:31,13575.0,2,7376,2,13570.0,4,13580.0,13,B
2018-04-11 11:27:57,13570.0,2,7378,0,13570.0,1,13575.0,5,S
2018-04-11 11:28:00,13570.0,2,7380,2,13565.0,20,13575.0,5,S
2018-04-11 11:29:00,13575.0,6,7386,-4,13570.0,2,13575.0,6,B
2018-04-11 11:29:01,13575.0,4,7390,-4,13570.0,2,13575.0,4,B
2018-04-11 11:29:01,13570.0,2,7392,2,13570.0,1,13575.0,4,S
2018-04-11 11:29:02,13570.0,2,7394,0,13565.0,20,13575.0,4,S
2018-04-11 11:29:07,13575.0,2,7396,0,13565.0,20,13575.0,3,B
2018-04-11 11:29:13,13570.0,2,7398,0,13570.0,1,13575.0,2,S
2018-04-11 11:29:32,13570.0,2,7400,0,13565.0,19,13570.0,1,S
2018-04-11 11:29:33,13570.0,2,7402,0,13565.0,20,13575.0,4,S
2018-04-11 13:30:00,13565.0,10,7412,-4,13565.0,1,13570.0,1,S
2018-04-11 13:30:08,13570.0,2,7414,-2,13565.0,12,13575.0,1,B
2018-04-11 13:30:09,13565.0,2,7416,0,13565.0,11,13575.0,1,S
2018-04-11 13:30:13,13570.0,2,7418,0,13570.0,1,13575.0,3,B
2018-04-11 13:30:44,13570.0,2,7420,-2,13570.0,1,13575.0,13,B
2018-04-11 13:30:46,13575.0,2,7422,0,13570.0,5,13580.0,15,B
2018-04-11 13:30:52,13580.0,2,7424,0,13570.0,7,13580.0,11,B
2018-04-11 13:32:15,13580.0,2,7426,0,13575.0,1,13580.0,5,B
2018-04-11 13:32:34,13580.0,2,7428,0,13570.0,11,13580.0,5,B
2018-04-11 13:32:35,13580.0,2,7430,-2,13570.0,13,13580.0,4,B
2018-04-11 13:32:38,13580.0,2,7432,-2,13575.0,4,13580.0,1,B
2018-04-11 13:32:40,13580.0,2,7434,2,13575.0,4,13585.0,11,B
2018-04-11 13:33:00,13585.0,2,7436,0,13575.0,9,13585.0,7,B
2018-04-11 13:33:01,13585.0,4,7440,0,13575.0,9,13585.0,5,B
2018-04-11 13:34:29,13575.0,2,7442,2,13575.0,3,13580.0,5,S
2018-04-11 13:35:01,13575.0,2,7444,0,13575.0,6,13580.0,1,S
2018-04-11 13:35:22,13575.0,4,7448,-4,13575.0,1,13580.0,2,S
2018-04-11 13:35:49,13575.0,2,7450,0,13575.0,4,13580.0,1,S
2018-04-11 13:36:45,13570.0,8,7458,0,13565.0,7,13575.0,22,S
2018-04-11 13:36:59,13570.0,2,7460,0,13565.0,5,13575.0,15,S
2018-04-11 13:37:57,13580.0,2,7462,2,13575.0,4,13580.0,1,B
2018-04-11 13:38:25,13580.0,6,7468,-4,13575.0,2,13580.0,1,B
2018-04-11 13:38:53,13575.0,2,7470,2,13575.0,1,13580.0,5,S
2018-04-11 13:38:53,13575.0,2,7472,2,13570.0,8,13580.0,5,S
2018-04-11 13:38:56,13570.0,2,7474,-2,13565.0,7,13575.0,9,S
2018-04-11 13:39:36,13565.0,4,7478,2,13565.0,1,13570.0,26,S
2018-04-11 13:39:37,13565.0,2,7480,0,13560.0,18,13570.0,26,S
2018-04-11 13:39:59,13560.0,20,7500,10,13555.0,7,13560.0,1,S
2018-04-11 13:40:00,13560.0,4,7504,-2,13555.0,6,13560.0,1,S
2018-04-11 13:40:00,13560.0,2,7506,0,13555.0,6,13565.0,9,S
2018-04-11 13:40:02,13555.0,2,7508,0,13555.0,5,13560.0,13,S
2018-04-11 13:40:11,13560.0,2,7510,0,13555.0,5,13560.0,14,B
2018-04-11 13:40:18,13560.0,2,7512,0,13555.0,7,13560.0,10,B
2018-04-11 13:40:30,13555.0,2,7514,-2,13555.0,4,13560.0,8,S
2018-04-11 13:40:36,13555.0,2,7516,0,13555.0,3,13560.0,12,S
2018-04-11 13:40:41,13560.0,2,7518,0,13555.0,3,13560.0,12,B
2018-04-11 13:40:47,13560.0,2,7520,2,13555.0,3,13560.0,16,B
2018-04-11 13:40:51,13555.0,2,7522,0,13555.0,2,13560.0,21,S
2018-04-11 13:40:52,13555.0,4,7526,-4,13550.0,12,13560.0,21,S
2018-04-11 13:40:56,13555.0,2,7528,-2,13550.0,9,13555.0,2,S
2018-04-11 13:41:06,13555.0,2,7530,-2,13550.0,9,13560.0,17,S
2018-04-11 13:41:06,13555.0,2,7532,0,13550.0,9,13555.0,3,S
2018-04-11 13:41:23,13555.0,2,7534,-2,13555.0,4,13560.0,9,S
2018-04-11 13:41:33,13555.0,6,7540,0,13555.0,1,13560.0,8,S
2018-04-11 13:41:35,13555.0,2,7542,2,13550.0,11,13555.0,6,S
2018-04-11 13:41:42,13555.0,2,7544,0,13550.0,10,13555.0,2,S
2018-04-11 13:41:47,13550.0,12,7556,-6,13550.0,4,13555.0,17,S
2018-04-11 13:41:48,13545.0,10,7566,-4,13545.0,2,13550.0,5,S
2018-04-11 13:41:48,13545.0,4,7570,-4,13540.0,4,13545.0,1,S
2018-04-11 13:41:49,13545.0,2,7572,-2,13545.0,1,13550.0,5,S
2018-04-11 13:41:51,13545.0,12,7584,10,13540.0,5,13550.0,10,S
2018-04-11 13:41:53,13545.0,2,7586,0,13545.0,2,13550.0,5,S
2018-04-11 13:41:53,13545.0,2,7588,-2,13545.0,1,13550.0,5,S
2018-04-11 13:42:08,13545.0,14,7602,0,13540.0,7,13550.0,20,S
2018-04-11 13:42:18,13540.0,8,7610,4,13535.0,10,13540.0,1,S
2018-04-11 13:42:19,13535.0,8,7618,2,13530.0,5,13535.0,18,S
2018-04-11 13:42:19,13530.0,4,7622,0,13530.0,6,13535.0,17,S
2018-04-11 13:42:20,13530.0,18,7640,-10,13525.0,21,13530.0,3,S
2018-04-11 13:42:20,13530.0,6,7646,-4,13525.0,33,13535.0,17,S
2018-04-11 13:42:21,13530.0,6,7652,2,13525.0,19,13535.0,3,S
2018-04-11 13:42:29,13530.0,2,7654,0,13530.0,12,13535.0,1,S
2018-04-11 13:42:29,13530.0,20,7674,8,13530.0,2,13540.0,21,S
2018-04-11 13:42:31,13535.0,2,7676,0,13530.0,3,13540.0,16,B
2018-04-11 13:42:35,13535.0,2,7678,0,13530.0,22,13535.0,10,B
2018-04-11 13:42:37,13530.0,4,7682,0,13530.0,17,13535.0,10,S
2018-04-11 13:42:41,13535.0,2,7684,-2,13530.0,17,13535.0,9,B
2018-04-11 13:42:42,13535.0,2,7686,0,13530.0,17,13535.0,8,B
2018-04-11 13:42:43,13535.0,2,7688,0,13530.0,17,13535.0,7,B
2018-04-11 13:42:43,13535.0,2,7690,0,13530.0,21,13535.0,6,B
2018-04-11 13:42:48,13535.0,2,7692,-2,13530.0,1,13535.0,7,B
2018-04-11 13:42:49,13535.0,2,7694,0,13530.0,1,13535.0,6,B
2018-04-11 13:42:50,13535.0,2,7696,-2,13530.0,1,13535.0,5,B
2018-04-11 13:42:54,13535.0,2,7698,-2,13530.0,1,13535.0,2,B
2018-04-11 13:42:59,13535.0,2,7700,0,13530.0,2,13535.0,1,B
2018-04-11 13:43:00,13535.0,10,7710,4,13530.0,2,13535.0,1,B
2018-04-11 13:43:09,13535.0,2,7712,2,13530.0,7,13535.0,16,B
2018-04-11 13:43:11,13530.0,2,7714,0,13530.0,6,13535.0,16,S
2018-04-11 13:43:12,13530.0,6,7720,-2,13530.0,3,13535.0,19,S
2018-04-11 13:43:12,13530.0,2,7722,0,13530.0,2,13535.0,19,S
2018-04-11 13:43:13,13530.0,4,7726,-4,13525.0,13,13535.0,15,S
2018-04-11 13:43:16,13535.0,2,7728,0,13525.0,8,13535.0,14,B
2018-04-11 13:43:20,13535.0,10,7738,8,13525.0,7,13535.0,9,B
2018-04-11 13:43:22,13525.0,14,7752,-14,13520.0,21,13525.0,1,S
2018-04-11 13:43:23,13525.0,2,7754,0,13525.0,1,13530.0,1,S
2018-04-11 13:43:24,13525.0,2,7756,-2,13525.0,1,13530.0,1,S
2018-04-11 13:43:28,13530.0,12,7768,-2,13525.0,9,13530.0,4,B
2018-04-11 13:43:28,13530.0,8,7776,-4,13530.0,16,13535.0,8,B
2018-04-11 13:43:30,13535.0,10,7786,10,13530.0,11,13535.0,3,B
2018-04-11 13:43:32,13530.0,10,7796,2,13530.0,6,13535.0,3,S
2018-04-11 13:43:41,13530.0,12,7808,-8,13525.0,29,13530.0,4,S
2018-04-11 13:43:42,13530.0,18,7826,-4,13530.0,6,13535.0,1,S
2018-04-11 13:43:45,13540.0,10,7836,10,13530.0,6,13540.0,8,B
2018-04-11 13:44:00,13540.0,10,7846,2,13530.0,5,13535.0,6,B
2018-04-11 13:44:03,13535.0,2,7848,-2,13530.0,5,13535.0,5,S
2018-04-11 13:44:07,13530.0,4,7852,0,13530.0,2,13535.0,11,S
2018-04-11 13:44:10,13530.0,6,7858,4,13530.0,1,13535.0,6,S
2018-04-11 13:44:12,13530.0,2,7860,2,13530.0,2,13535.0,6,S
2018-04-11 13:44:14,13535.0,10,7870,0,13530.0,1,13535.0,1,B
2018-04-11 13:44:16,13530.0,4,7874,0,13530.0,1,13535.0,9,S
2018-04-11 13:44:17,13530.0,2,7876,-2,13525.0,15,13530.0,1,S
2018-04-11 13:44:19,13530.0,2,7878,0,13525.0,9,13535.0,11,S
2018-04-11 13:44:22,13525.0,10,7888,-6,13525.0,4,13535.0,12,S
2018-04-11 13:44:25,13525.0,2,7890,0,13530.0,1,13535.0,4,S
2018-04-11 13:44:26,13530.0,2,7892,0,13525.0,21,13530.0,4,B
2018-04-11 13:44:26,13530.0,4,7896,-2,13525.0,23,13530.0,2,B
2018-04-11 13:44:27,13530.0,4,7900,0,13525.0,23,13530.0,1,B
2018-04-11 13:44:27,13530.0,2,7902,0,13525.0,23,13535.0,6,B
2018-04-11 13:44:29,13530.0,2,7904,2,13530.0,1,13535.0,6,B
2018-04-11 13:44:29,13525.0,10,7914,0,13525.0,19,13535.0,6,S
2018-04-11 13:44:33,13525.0,10,7924,-2,13525.0,18,13535.0,5,S
2018-04-11 13:44:33,13535.0,12,7936,8,13525.0,7,13540.0,10,B
2018-04-11 13:44:36,13525.0,10,7946,-8,13525.0,3,13535.0,11,S
2018-04-11 13:44:49,13535.0,10,7956,10,13525.0,9,13535.0,9,B
2018-04-11 13:44:51,13535.0,2,7958,-2,13525.0,9,13535.0,8,B
2018-04-11 13:44:55,13535.0,6,7964,-6,13535.0,7,13540.0,9,B
2018-04-11 13:44:56,13535.0,14,7978,-8,13530.0,3,13540.0,9,B
2018-04-11 13:44:59,13535.0,10,7988,4,13530.0,2,13535.0,2,B
2018-04-11 13:45:01,13535.0,4,7992,-2,13535.0,8,13540.0,9,B
2018-04-11 13:45:01,13535.0,2,7994,0,13535.0,7,13540.0,9,B
2018-04-11 13:45:02,13535.0,10,8004,0,13535.0,2,13540.0,8,B
2018-04-11 13:45:02,13535.0,4,8008,-4,13530.0,4,13535.0,5,B
2018-04-11 13:45:04,13535.0,2,8010,2,13525.0,9,13535.0,3,B
2018-04-11 13:45:05,13530.0,2,8012,-2,13525.0,4,13535.0,3,S
2018-04-11 13:45:08,13525.0,10,8022,-4,13520.0,9,13525.0,9,S
2018-04-11 13:45:09,13525.0,10,8032,6,13515.0,10,13525.0,3,S
2018-04-11 13:45:09,13515.0,6,8038,0,13515.0,5,13520.0,17,S
2018-04-11 13:45:10,13510.0,14,8052,-10,13510.0,23,13515.0,15,S
2018-04-11 13:45:10,13510.0,36,8088,0,13510.0,10,13515.0,11,S
2018-04-11 13:45:11,13510.0,20,8108,12,13505.0,29,13515.0,11,S
2018-04-11 13:45:13,13510.0,4,8112,2,13505.0,31,13515.0,7,S
2018-04-11 13:45:14,13510.0,2,8114,2,13505.0,31,13515.0,7,S
2018-04-11 13:45:15,13505.0,4,8118,0,13505.0,27,13510.0,10,S
2018-04-11 13:45:16,13500.0,78,8196,6,13500.0,69,13505.0,27,S
2018-04-11 13:45:16,13500.0,56,8252,14,13500.0,43,13505.0,17,S
2018-04-11 13:45:17,13500.0,6,8258,4,13500.0,40,13505.0,14,S
2018-04-11 13:45:17,13500.0,4,8262,0,13500.0,38,13505.0,14,S
2018-04-11 13:45:18,13505.0,10,8272,10,13500.0,38,13505.0,13,B
2018-04-11 13:45:20,13500.0,10,8282,-4,13500.0,33,13505.0,15,S
2018-04-11 13:45:21,13505.0,26,8308,4,13500.0,33,13510.0,7,B
2018-04-11 13:45:22,13510.0,4,8312,-2,13505.0,1,13515.0,4,B
2018-04-11 13:45:24,13505.0,2,8314,-2,13505.0,1,13515.0,9,S
2018-04-11 13:45:26,13500.0,2,8316,0,13500.0,35,13510.0,1,S
2018-04-11 13:45:27,13505.0,2,8318,0,13505.0,2,13510.0,4,B
2018-04-11 13:45:28,13505.0,2,8320,-2,13505.0,9,13510.0,4,B
2018-04-11 13:45:30,13505.0,6,8326,0,13505.0,6,13510.0,2,B
2018-04-11 13:45:31,13510.0,6,8332,-4,13505.0,6,13510.0,3,B
2018-04-11 13:45:31,13510.0,6,8338,0,13505.0,8,13515.0,7,B
2018-04-11 13:45:35,13525.0,22,8360,12,13510.0,1,13520.0,1,B
2018-04-11 13:45:37,13510.0,10,8370,0,13515.0,1,13520.0,3,S
2018-04-11 13:45:38,13515.0,2,8372,0,13515.0,2,13525.0,5,B
2018-04-11 13:45:38,13515.0,2,8374,2,13520.0,5,13525.0,5,B
2018-04-11 13:45:39,13520.0,6,8380,2,13520.0,2,13525.0,5,B
2018-04-11 13:45:39,13520.0,4,8384,4,13515.0,4,13525.0,7,B
2018-04-11 13:45:40,13515.0,2,8386,2,13510.0,7,13520.0,3,S
2018-04-11 13:45:41,13510.0,4,8390,-4,13510.0,5,13520.0,2,S
2018-04-11 13:45:45,13520.0,20,8410,10,13510.0,5,13525.0,8,B
2018-04-11 13:45:52,13510.0,10,8420,-6,13510.0,5,13520.0,6,S
2018-04-11 13:45:56,13520.0,20,8440,16,13505.0,22,13520.0,3,B
2018-04-11 13:46:02,13510.0,2,8442,2,13505.0,22,13515.0,3,S
2018-04-11 13:46:08,13510.0,2,8444,2,13505.0,17,13510.0,10,S
2018-04-11 13:46:09,13505.0,34,8478,0,13500.0,31,13505.0,30,S
2018-04-11 13:46:10,13490.0,70,8548,8,13490.0,5,13495.0,4,S
2018-04-11 13:46:10,13500.0,4,8552,0,13495.0,12,13500.0,9,B
2018-04-11 13:46:11,13490.0,8,8560,0,13490.0,6,13500.0,8,S
2018-04-11 13:46:12,13495.0,10,8570,0,13490.0,8,13495.0,1,B
2018-04-11 13:46:12,13495.0,2,8572,0,13495.0,3,13500.0,4,B
2018-04-11 13:46:13,13500.0,2,8574,0,13495.0,3,13500.0,8,B
2018-04-11 13:46:15,13500.0,40,8614,10,13490.0,6,13500.0,1,B
2018-04-11 13:46:16,13500.0,4,8618,2,13495.0,1,13500.0,14,B
2018-04-11 13:46:19,13490.0,12,8630,0,13485.0,5,13490.0,3,S
2018-04-11 13:46:20,13490.0,52,8682,10,13475.0,2,13485.0,1,S
2018-04-11 13:46:20,13490.0,8,8690,-2,13485.0,2,13490.0,12,S
2018-04-11 13:46:21,13490.0,2,8692,0,13485.0,5,13495.0,10,S
2018-04-11 13:46:21,13495.0,4,8696,-4,13490.0,3,13495.0,4,B
2018-04-11 13:46:22,13490.0,6,8702,0,13485.0,7,13490.0,4,S
2018-04-11 13:46:23,13490.0,2,8704,-2,13485.0,4,13490.0,16,S
2018-04-11 13:46:24,13490.0,2,8706,-2,13485.0,4,13490.0,12,S
2018-04-11 13:46:25,13490.0,14,8720,-14,13485.0,6,13490.0,5,S
2018-04-11 13:46:25,13490.0,14,8734,-6,13490.0,1,13495.0,24,S
2018-04-11 13:46:26,13490.0,2,8736,0,13485.0,3,13495.0,24,S
2018-04-11 13:46:29,13490.0,4,8740,-2,13490.0,3,13495.0,23,S
2018-04-11 13:46:32,13490.0,2,8742,-2,13485.0,5,13490.0,2,S
2018-04-11 13:46:33,13490.0,4,8746,-4,13490.0,1,13495.0,23,S
2018-04-11 13:46:38,13495.0,40,8786,-6,13490.0,6,13495.0,3,B
2018-04-11 13:46:39,13495.0,6,8792,6,13490.0,10,13500.0,63,B
2018-04-11 13:46:42,13500.0,40,8832,20,13495.0,7,13500.0,40,B
2018-04-11 13:46:42,13500.0,46,8878,32,13495.0,8,13500.0,17,B
2018-04-11 13:46:43,13500.0,34,8912,34,13500.0,3,13505.0,14,B
2018-04-11 13:46:48,13505.0,6,8918,0,13500.0,4,13505.0,5,B
2018-04-11 13:46:49,13505.0,10,8928,4,13505.0,5,13510.0,3,B
2018-04-11 13:46:50,13505.0,2,8930,2,13505.0,4,13510.0,2,B
2018-04-11 13:46:54,13505.0,8,8938,8,13500.0,7,13510.0,4,B
2018-04-11 13:47:00,13505.0,4,8942,-2,13500.0,7,13510.0,7,B
2018-04-11 13:47:01,13495.0,22,8964,6,13490.0,8,13495.0,1,S
2018-04-11 13:47:02,13490.0,4,8968,0,13490.0,5,13495.0,5,S
2018-04-11 13:47:17,13490.0,2,8970,2,13490.0,2,13495.0,1,S
2018-04-11 13:47:19,13495.0,2,8972,2,13490.0,2,13500.0,12,B
2018-04-11 13:47:19,13490.0,4,8976,-4,13485.0,6,13490.0,3,S
2018-04-11 13:47:20,13485.0,4,8980,4,13480.0,11,13485.0,1,S
2018-04-11 13:47:21,13480.0,2,8982,-2,13480.0,9,13485.0,4,S
2018-04-11 13:47:21,13480.0,4,8986,-4,13480.0,5,13485.0,4,S
2018-04-11 13:47:22,13485.0,10,8996,-2,13475.0,3,13485.0,3,B
2018-04-11 13:47:22,13485.0,2,8998,0,13475.0,4,13485.0,5,B
2018-04-11 13:47:23,13470.0,14,9012,4,13465.0,4,13475.0,13,S
2018-04-11 13:47:24,13465.0,2,9014,0,13465.0,3,13475.0,6,S
2018-04-11 13:47:24,13470.0,10,9024,-6,13470.0,3,13475.0,1,B
2018-04-11 13:47:25,13475.0,2,9026,0,13475.0,9,13485.0,4,B
2018-04-11 13:47:26,13480.0,10,9036,-8,13475.0,10,13485.0,6,B
2018-04-11 13:47:30,13480.0,2,9038,0,13475.0,12,13485.0,6,B
2018-04-11 13:47:34,13485.0,2,9040,-2,13480.0,1,13485.0,1,B
2018-04-11 13:47:35,13490.0,20,9060,8,13480.0,1,13490.0,5,B
2018-04-11 13:47:37,13490.0,6,9066,2,13485.0,19,13490.0,1,B
2018-04-11 13:47:38,13490.0,2,9068,0,13490.0,4,13495.0,5,B
2018-04-11 13:47:40,13490.0,14,9082,-14,13490.0,2,13495.0,4,B
2018-04-11 13:47:40,13490.0,4,9086,-4,13485.0,9,13490.0,2,B
2018-04-11 13:47:44,13485.0,2,9088,0,13485.0,7,13495.0,4,S
2018-04-11 13:47:50,13490.0,2,9090,0,13490.0,2,13495.0,2,B
2018-04-11 13:47:52,13490.0,2,9092,0,13485.0,8,13490.0,2,B
2018-04-11 13:47:53,13490.0,4,9096,4,13490.0,2,13495.0,6,B
2018-04-11 13:47:54,13490.0,4,9100,0,13485.0,8,13495.0,6,B
2018-04-11 13:47:58,13485.0,8,9108,-6,13485.0,4,13490.0,12,S
2018-04-11 13:47:59,13485.0,2,9110,-2,13485.0,3,13490.0,7,S
2018-04-11 13:48:01,13485.0,6,9116,6,13480.0,14,13485.0,1,S
2018-04-11 13:48:04,13490.0,2,9118,0,13480.0,13,13490.0,17,B
2018-04-11 13:48:08,13490.0,8,9126,-8,13485.0,9,13490.0,6,B
2018-04-11 13:48:08,13490.0,8,9134,0,13485.0,9,13490.0,2,B
2018-04-11 13:48:09,13490.0,4,9138,4,13485.0,6,13495.0,8,B
2018-04-11 13:48:15,13490.0,4,9142,-4,13490.0,13,13495.0,2,B
2018-04-11 13:48:17,13495.0,2,9144,0,13490.0,13,13495.0,1,B
2018-04-11 13:48:17,13495.0,2,9146,0,13495.0,2,13500.0,8,B
2018-04-11 13:48:21,13495.0,2,9148,0,13490.0,4,13495.0,4,B
2018-04-11 13:48:23,13495.0,6,9154,0,13490.0,4,13495.0,1,B
2018-04-11 13:48:23,13495.0,2,9156,0,13490.0,3,13500.0,10,B
2018-04-11 13:48:31,13500.0,6,9162,-4,13495.0,6,13505.0,9,B
2018-04-11 13:48:33,13500.0,2,9164,0,13500.0,2,13505.0,9,B
2018-04-11 13:48:34,13500.0,2,9166,2,13500.0,1,13505.0,9,B
2018-04-11 13:48:42,13500.0,2,9168,0,13500.0,2,13505.0,8,B
2018-04-11 13:48:42,13510.0,18,9186,-4,13505.0,12,13510.0,7,B
2018-04-11 13:48:43,13500.0,28,9214,4,13500.0,2,13505.0,1,S
2018-04-11 13:48:48,13505.0,4,9218,0,13500.0,4,13510.0,17,B
2018-04-11 13:48:49,13505.0,16,9234,-16,13505.0,12,13515.0,6,B
2018-04-11 13:48:51,13510.0,2,9236,0,13510.0,1,13515.0,4,B
2018-04-11 13:48:53,13515.0,2,9238,0,13510.0,17,13520.0,10,B
2018-04-11 13:48:54,13520.0,2,9240,0,13510.0,17,13520.0,8,B
2018-04-11 13:48:55,13515.0,2,9242,-2,13515.0,1,13520.0,8,S
2018-04-11 13:48:56,13515.0,2,9244,0,13510.0,2,13515.0,2,S
2018-04-11 13:48:56,13515.0,4,9248,0,13515.0,4,13520.0,5,S
2018-04-11 13:48:57,13515.0,8,9256,-2,13505.0,1,13515.0,9,S
2018-04-11 13:49:06,13500.0,2,9258,0,13500.0,6,13510.0,4,S
2018-04-11 13:49:07,13510.0,2,9260,2,13500.0,6,13510.0,3,B
2018-04-11 13:49:11,13500.0,6,9266,4,13500.0,3,13510.0,5,S
2018-04-11 13:49:12,13505.0,2,9268,0,13500.0,3,13505.0,7,B
2018-04-11 13:49:16,13505.0,2,9270,0,13500.0,6,13505.0,6,B
2018-04-11 13:49:26,13500.0,2,9272,-2,13500.0,2,13505.0,7,S
2018-04-11 13:49:38,13500.0,4,9276,2,13500.0,2,13505.0,7,S
2018-04-11 13:49:40,13505.0,2,9278,-2,13500.0,4,13505.0,7,B
2018-04-11 13:49:46,13505.0,16,9294,2,13505.0,4,13510.0,8,B
2018-04-11 13:50:00,13505.0,14,9308,-2,13500.0,13,13510.0,2,B
2018-04-11 13:50:01,13500.0,2,9310,2,13500.0,8,13505.0,14,S
2018-04-11 13:50:02,13500.0,2,9312,0,13500.0,7,13505.0,12,S
2018-04-11 13:50:04,13500.0,14,9326,4,13495.0,1,13500.0,1,S
2018-04-11 13:50:14,13490.0,2,9328,0,13485.0,7,13490.0,5,S
2018-04-11 13:50:14,13495.0,2,9330,-2,13485.0,5,13490.0,1,B
2018-04-11 13:50:20,13485.0,2,9332,2,13480.0,11,13490.0,1,S
2018-04-11 13:50:21,13485.0,4,9336,-4,13480.0,12,13485.0,10,S
2018-04-11 13:50:23,13485.0,20,9356,-20,13485.0,1,13490.0,3,S
2018-04-11 13:50:25,13490.0,4,9360,0,13485.0,10,13495.0,6,B
2018-04-11 13:50:36,13495.0,2,9362,2,13490.0,7,13500.0,5,B
2018-04-11 13:50:44,13500.0,2,9364,2,13495.0,5,13505.0,9,B
2018-04-11 13:50:52,13500.0,2,9366,-2,13495.0,5,13500.0,6,B
2018-04-11 13:50:53,13500.0,6,9372,-4,13495.0,8,13500.0,3,B
2018-04-11 13:50:55,13495.0,4,9376,-4,13495.0,17,13500.0,2,S
2018-04-11 13:51:02,13495.0,4,9380,-4,13495.0,14,13505.0,3,S
2018-04-11 13:51:08,13505.0,2,9382,0,13495.0,14,13505.0,1,B
2018-04-11 13:51:15,13505.0,2,9384,-2,13495.0,11,13505.0,13,B
2018-04-11 13:51:27,13500.0,2,9386,0,13495.0,10,13500.0,1,S
2018-04-11 13:51:37,13495.0,2,9388,0,13495.0,9,13500.0,10,S
2018-04-11 13:51:38,13495.0,10,9398,-10,13495.0,4,13500.0,10,S
2018-04-11 13:51:55,13505.0,4,9402,-4,13500.0,5,13505.0,1,B
2018-04-11 13:51:56,13505.0,2,9404,0,13500.0,5,13510.0,10,B
2018-04-11 13:52:08,13500.0,2,9406,-2,13500.0,3,13510.0,8,S
2018-04-11 13:52:09,13510.0,4,9410,-2,13500.0,3,13510.0,5,B
2018-04-11 13:52:16,13505.0,2,9412,-2,13505.0,4,13510.0,2,S
2018-04-11 13:52:30,13505.0,4,9416,-4,13505.0,2,13510.0,3,S
2018-04-11 13:52:31,13505.0,4,9420,-2,13500.0,7,13510.0,5,S
2018-04-11 13:52:32,13500.0,2,9422,2,13500.0,2,13505.0,11,S
2018-04-11 13:52:33,13505.0,2,9424,0,13495.0,9,13505.0,8,B
2018-04-11 13:52:47,13500.0,2,9426,-2,13495.0,9,13500.0,5,S
2018-04-11 13:52:50,13500.0,2,9428,0,13495.0,10,13500.0,4,S
2018-04-11 13:52:59,13500.0,2,9430,0,13495.0,10,13500.0,13,S
2018-04-11 13:53:09,13495.0,2,9432,-2,13495.0,8,13500.0,13,S
2018-04-11 13:53:14,13495.0,4,9436,0,13495.0,5,13500.0,14,S
2018-04-11 13:53:16,13495.0,6,9442,-4,13495.0,2,13500.0,15,S
2018-04-11 13:53:20,13500.0,10,9452,0,13495.0,3,13500.0,10,B
2018-04-11 13:53:23,13500.0,10,9462,-6,13495.0,6,13500.0,4,B
2018-04-11 13:53:24,13500.0,2,9464,-2,13495.0,9,13500.0,3,B
2018-04-11 13:53:32,13495.0,2,9466,0,13495.0,8,13500.0,3,S
2018-04-11 13:53:41,13500.0,4,9470,-2,13495.0,9,13500.0,1,B
2018-04-11 13:53:42,13500.0,2,9472,2,13495.0,7,13505.0,8,B
2018-04-11 13:53:49,13505.0,2,9474,2,13505.0,22,13510.0,4,B
2018-04-11 13:54:03,13505.0,2,9476,2,13500.0,3,13505.0,3,B
2018-04-11 13:54:11,13510.0,2,9478,2,13505.0,1,13515.0,15,B
2018-04-11 13:54:11,13515.0,2,9480,-2,13505.0,2,13515.0,17,B
2018-04-11 13:54:12,13515.0,2,9482,0,13505.0,2,13515.0,16,B
2018-04-11 13:54:13,13505.0,2,9484,-2,13505.0,1,13510.0,1,S
2018-04-11 13:54:20,13505.0,4,9488,0,13505.0,9,13510.0,3,S
2018-04-11 13:54:22,13510.0,4,9492,2,13505.0,9,13510.0,3,B
2018-04-11 13:54:23,13510.0,2,9494,0,13500.0,3,13505.0,1,B
2018-04-11 13:54:25,13500.0,2,9496,-2,13500.0,5,13510.0,8,S
2018-04-11 13:54:27,13510.0,16,9512,0,13510.0,7,13515.0,13,B
2018-04-11 13:54:28,13510.0,14,9526,-6,13505.0,1,13510.0,6,B
2018-04-11 13:54:28,13505.0,2,9528,-2,13500.0,3,13510.0,3,S
2018-04-11 13:54:33,13505.0,2,9530,0,13500.0,4,13510.0,9,S
2018-04-11 13:54:41,13500.0,2,9532,-2,13500.0,1,13505.0,1,S
2018-04-11 13:54:43,13510.0,4,9536,0,13500.0,1,13510.0,8,B
2018-04-11 13:54:50,13495.0,2,9538,0,13490.0,8,13500.0,17,S
2018-04-11 13:55:05,13490.0,2,9540,2,13490.0,11,13495.0,2,S
2018-04-11 13:55:08,13495.0,4,9544,0,13495.0,1,13500.0,16,B
2018-04-11 13:55:18,13495.0,2,9546,-2,13490.0,27,13500.0,12,B
2018-04-11 13:55:23,13495.0,2,9548,-2,13495.0,1,13500.0,11,B
2018-04-11 13:55:46,13500.0,2,9550,2,13495.0,6,13500.0,2,B
2018-04-11 13:55:56,13500.0,4,9554,2,13495.0,10,13505.0,9,B
2018-04-11 13:56:28,13495.0,4,9558,0,13495.0,2,13500.0,7,S
2018-04-11 13:56:29,13500.0,2,9560,0,13495.0,3,13500.0,4,B
2018-04-11 13:56:59,13500.0,2,9562,2,13495.0,4,13500.0,2,B
2018-04-11 13:57:08,13495.0,4,9566,0,13490.0,12,13495.0,3,S
2018-04-11 13:57:42,13495.0,4,9570,0,13490.0,7,13495.0,2,S
2018-04-11 13:57:42,13495.0,4,9574,0,13495.0,1,13500.0,9,S
2018-04-11 13:57:59,13495.0,2,9576,2,13495.0,11,13500.0,5,S
2018-04-11 13:58:10,13500.0,2,9578,0,13495.0,11,13500.0,4,B
2018-04-11 13:58:21,13495.0,2,9580,0,13495.0,10,13500.0,3,S
2018-04-11 13:58:31,13500.0,6,9586,6,13500.0,1,13505.0,12,B
2018-04-11 13:58:59,13500.0,10,9596,0,13500.0,5,13505.0,13,B
2018-04-11 13:59:03,13500.0,18,9614,0,13495.0,2,13500.0,1,B
2018-04-11 13:59:28,13490.0,4,9618,4,13490.0,12,13495.0,10,S
2018-04-11 13:59:29,13490.0,4,9622,0,13490.0,10,13495.0,9,S
2018-04-11 13:59:30,13490.0,20,9642,2,13485.0,8,13490.0,1,S
2018-04-11 13:59:34,13485.0,10,9652,-8,13480.0,9,13490.0,7,S
2018-04-11 13:59:42,13490.0,8,9660,0,13485.0,6,13490.0,2,B
2018-04-11 13:59:46,13490.0,2,9662,-2,13485.0,2,13490.0,1,B
2018-04-11 13:59:49,13490.0,2,9664,2,13490.0,9,13495.0,12,B
2018-04-11 13:59:58,13490.0,8,9672,0,13490.0,6,13495.0,15,B
2018-04-11 13:59:59,13490.0,12,9684,2,13485.0,3,13490.0,5,B
2018-04-11 13:59:59,13490.0,6,9690,-6,13485.0,5,13490.0,3,B
2018-04-11 14:00:00,13490.0,4,9694,-2,13485.0,6,13490.0,1,B
2018-04-11 14:00:03,13490.0,2,9696,0,13485.0,2,13490.0,5,B
2018-04-11 14:00:04,13485.0,2,9698,2,13485.0,2,13490.0,6,S
2018-04-11 14:00:05,13485.0,2,9700,0,13485.0,3,13490.0,6,S
2018-04-11 14:00:06,13485.0,6,9706,-4,13480.0,22,13485.0,2,S
2018-04-11 14:00:06,13485.0,4,9710,-4,13480.0,20,13490.0,6,S
2018-04-11 14:00:07,13480.0,2,9712,-2,13480.0,7,13490.0,18,S
2018-04-11 14:00:08,13480.0,2,9714,-2,13480.0,6,13490.0,18,S
2018-04-11 14:00:10,13480.0,12,9726,-2,13475.0,6,13485.0,10,S
2018-04-11 14:00:11,13475.0,6,9732,0,13475.0,1,13480.0,21,S
2018-04-11 14:00:12,13475.0,2,9734,0,13470.0,4,13480.0,19,S
2018-04-11 14:00:14,13475.0,2,9736,0,13470.0,7,13480.0,4,S
2018-04-11 14:00:16,13470.0,2,9738,-2,13470.0,6,13475.0,11,S
2018-04-11 14:00:18,13475.0,2,9740,0,13470.0,5,13475.0,11,B
2018-04-11 14:00:19,13470.0,6,9746,0,13465.0,2,13470.0,5,S
2018-04-11 14:00:20,13470.0,4,9750,0,13470.0,4,13475.0,4,S
2018-04-11 14:00:22,13470.0,8,9758,-6,13465.0,4,13470.0,1,S
2018-04-11 14:00:23,13470.0,2,9760,-2,13470.0,2,13475.0,3,S
2018-04-11 14:00:25,13475.0,2,9762,0,13470.0,7,13480.0,6,B
2018-04-11 14:00:25,13475.0,2,9764,2,13470.0,7,13480.0,6,B
2018-04-11 14:00:31,13475.0,4,9768,-2,13470.0,5,13480.0,14,B
2018-04-11 14:00:37,13475.0,2,9770,2,13470.0,7,13480.0,14,B
2018-04-11 14:00:42,13470.0,2,9772,-2,13470.0,5,13480.0,12,S
2018-04-11 14:00:46,13480.0,6,9778,-4,13475.0,4,13480.0,4,B
2018-04-11 14:00:47,13480.0,8,9786,-2,13480.0,2,13485.0,7,B
2018-04-11 14:01:01,13480.0,6,9792,-4,13475.0,4,13485.0,24,B
2018-04-11 14:01:06,13480.0,2,9794,0,13475.0,4,13485.0,6,B
2018-04-11 14:01:44,13475.0,10,9804,4,13470.0,40,13480.0,1,S
2018-04-11 14:01:46,13480.0,2,9806,0,13475.0,14,13485.0,9,B
2018-04-11 14:01:51,13480.0,2,9808,2,13480.0,2,13485.0,4,B
2018-04-11 14:01:52,13475.0,8,9816,0,13470.0,27,13475.0,6,S
2018-04-11 14:01:53,13475.0,12,9828,6,13470.0,27,13480.0,1,S
2018-04-11 14:01:53,13485.0,22,9850,18,13475.0,6,13485.0,3,B
2018-04-11 14:01:54,13485.0,2,9852,-2,13475.0,7,13485.0,6,B
2018-04-11 14:01:59,13475.0,6,9858,0,13475.0,4,13485.0,6,S
2018-04-11 14:02:00,13480.0,2,9860,-2,13475.0,2,13485.0,7,B
2018-04-11 14:02:09,13480.0,2,9862,0,13475.0,5,13485.0,14,B
2018-04-11 14:02:13,13485.0,2,9864,0,13475.0,10,13485.0,13,B
2018-04-11 14:02:15,13480.0,2,9866,0,13475.0,5,13480.0,8,S
2018-04-11 14:02:25,13480.0,2,9868,0,13475.0,10,13485.0,7,S
2018-04-11 14:02:33,13480.0,2,9870,-2,13480.0,6,13485.0,16,S
2018-04-11 14:02:38,13480.0,2,9872,0,13475.0,39,13480.0,4,S
2018-04-11 14:02:38,13480.0,8,9880,-4,13480.0,2,13485.0,14,S
2018-04-11 14:02:45,13485.0,2,9882,2,13480.0,1,13485.0,3,B
2018-04-11 14:02:54,13480.0,2,9884,0,13475.0,27,13485.0,3,S
2018-04-11 14:02:59,13480.0,12,9896,-8,13470.0,56,13485.0,10,S
2018-04-11 14:03:13,13475.0,2,9898,2,13475.0,6,13485.0,10,S
2018-04-11 14:03:13,13475.0,2,9900,2,13475.0,5,13480.0,1,S
2018-04-11 14:03:19,13480.0,2,9902,-2,13475.0,22,13485.0,7,B
2018-04-11 14:03:44,13480.0,2,9904,-2,13480.0,3,13485.0,5,B
2018-04-11 14:03:48,13485.0,2,9906,2,13480.0,3,13485.0,3,B
2018-04-11 14:04:02,13485.0,2,9908,2,13480.0,13,13485.0,1,B
2018-04-11 14:04:06,13485.0,4,9912,0,13480.0,12,13485.0,9,B
2018-04-11 14:04:19,13485.0,18,9930,-4,13480.0,26,13490.0,7,B
2018-04-11 14:04:29,13485.0,2,9932,0,13485.0,18,13490.0,1,B
2018-04-11 14:04:31,13495.0,6,9938,2,13490.0,18,13495.0,7,B
2018-04-11 14:04:31,13495.0,2,9940,0,13490.0,5,13495.0,2,B
2018-04-11 14:04:34,13495.0,6,9946,4,13490.0,1,13495.0,4,B
2018-04-11 14:04:38,13490.0,2,9948,2,13490.0,1,13495.0,9,S
2018-04-11 14:04:40,13495.0,12,9960,-6,13495.0,2,13500.0,8,B
2018-04-11 14:05:01,13495.0,2,9962,0,13495.0,2,13500.0,8,B
2018-04-11 14:05:02,13495.0,4,9966,4,13490.0,9,13500.0,10,B
2018-04-11 14:05:03,13495.0,2,9968,0,13490.0,4,13495.0,1,B
2018-04-11 14:05:06,13495.0,2,9970,-2,13495.0,1,13500.0,12,B
2018-04-11 14:05:07,13495.0,2,9972,0,13490.0,3,13500.0,12,B
2018-04-11 14:05:32,13495.0,2,9974,-2,13490.0,4,13495.0,2,B
2018-04-11 14:06:03,13500.0,4,9978,0,13495.0,10,13500.0,4,B
2018-04-11 14:06:11,13500.0,6,9984,6,13495.0,15,13500.0,1,B
2018-04-11 14:06:19,13500.0,2,9986,0,13495.0,10,13505.0,16,B
2018-04-11 14:06:21,13505.0,2,9988,0,13495.0,10,13505.0,14,B
2018-04-11 14:06:24,13505.0,2,9990,-2,13495.0,10,13505.0,13,B
2018-04-11 14:06:30,13505.0,2,9992,0,13495.0,15,13505.0,12,B
2018-04-11 14:06:43,13505.0,4,9996,-2,13500.0,9,13505.0,5,B
2018-04-11 14:06:53,13505.0,2,9998,0,13500.0,4,13505.0,6,B
2018-04-11 14:07:15,13500.0,4,10002,0,13500.0,3,13505.0,3,S
2018-04-11 14:07:21,13500.0,20,10022,8,13500.0,1,13505.0,3,S
2018-04-11 14:07:33,13500.0,2,10024,2,13500.0,5,13505.0,3,S
2018-04-11 14:07:50,13500.0,10,10034,0,13500.0,3,13505.0,3,S
2018-04-11 14:07:55,13505.0,2,10036,0,13500.0,5,13505.0,2,B
2018-04-11 14:08:03,13505.0,2,10038,-2,13500.0,5,13505.0,1,B
2018-04-11 14:08:04,13505.0,2,10040,0,13505.0,1,13510.0,13,B
2018-04-11 14:08:05,13505.0,2,10042,0,13500.0,6,13510.0,12,B
2018-04-11 14:08:09,13500.0,6,10048,6,13500.0,3,13510.0,12,S
2018-04-11 14:08:20,13500.0,8,10056,-4,13495.0,6,13505.0,11,S
2018-04-11 14:08:26,13505.0,2,10058,0,13495.0,5,13505.0,11,B
2018-04-11 14:08:28,13505.0,2,10060,0,13495.0,5,13505.0,10,B
2018-04-11 14:08:31,13505.0,2,10062,-2,13495.0,5,13505.0,9,B
2018-04-11 14:08:34,13500.0,2,10064,2,13495.0,7,13505.0,5,S
2018-04-11 14:08:39,13495.0,4,10068,0,13495.0,5,13500.0,1,S
2018-04-11 14:08:42,13500.0,2,10070,2,13495.0,5,13505.0,7,B
2018-04-11 14:08:58,13495.0,6,10076,-6,13490.0,16,13500.0,8,S
2018-04-11 14:09:11,13495.0,4,10080,-4,13495.0,3,13500.0,10,S
2018-04-11 14:09:39,13495.0,4,10084,2,13490.0,21,13500.0,7,S
2018-04-11 14:09:57,13500.0,28,10112,8,13495.0,25,13500.0,20,B
2018-04-11 14:09:57,13500.0,18,10130,8,13495.0,25,13500.0,11,B
2018-04-11 14:10:02,13500.0,8,10138,6,13495.0,7,13500.0,7,B
2018-04-11 14:10:03,13500.0,6,10144,2,13495.0,21,13500.0,4,B
2018-04-11 14:10:03,13500.0,8,10152,2,13500.0,4,13505.0,6,B
2018-04-11 14:10:08,13505.0,2,10154,0,13500.0,10,13510.0,18,B
2018-04-11 14:10:15,13500.0,6,10160,2,13500.0,7,13510.0,15,S
2018-04-11 14:10:25,13505.0,2,10162,0,13500.0,10,13510.0,13,B
2018-04-11 14:10:33,13505.0,2,10164,2,13500.0,11,13505.0,1,B
2018-04-11 14:10:34,13505.0,2,10166,0,13500.0,12,13510.0,15,B
2018-04-11 14:10:47,13500.0,2,10168,2,13500.0,8,13510.0,15,S
2018-04-11 14:11:01,13500.0,2,10170,-2,13500.0,7,13505.0,3,S
2018-04-11 14:11:01,13495.0,16,10186,-6,13495.0,1,13500.0,1,S
2018-04-11 14:11:11,13500.0,2,10188,0,13500.0,1,13505.0,2,B
2018-04-11 14:11:55,13505.0,6,10194,-4,13505.0,2,13510.0,17,B
2018-04-11 14:11:55,13505.0,4,10198,-4,13500.0,1,13505.0,3,B
2018-04-11 14:12:30,13505.0,6,10204,-4,13500.0,4,13510.0,19,B
2018-04-11 14:13:05,13510.0,10,10214,4,13500.0,5,13510.0,9,B
2018-04-11 14:13:24,13505.0,2,10216,0,13500.0,7,13510.0,7,S
2018-04-11 14:13:28,13505.0,2,10218,2,13505.0,1,13510.0,11,S
2018-04-11 14:13:34,13505.0,2,10220,0,13505.0,1,13510.0,8,S
2018-04-11 14:13:38,13505.0,2,10222,2,13505.0,1,13510.0,8,S
2018-04-11 14:13:57,13505.0,4,10226,-2,13500.0,13,13510.0,8,S
2018-04-11 14:14:22,13500.0,2,10228,2,13500.0,14,13505.0,2,S
2018-04-11 14:14:24,13505.0,2,10230,2,13500.0,14,13505.0,1,B
2018-04-11 14:14:45,13500.0,2,10232,0,13500.0,10,13505.0,8,S
2018-04-11 14:14:50,13500.0,2,10234,0,13500.0,9,13505.0,7,S
2018-04-11 14:14:52,13500.0,2,10236,0,13500.0,8,13505.0,7,S
2018-04-11 14:16:17,13500.0,10,10246,-10,13500.0,5,13505.0,3,S
2018-04-11 14:16:25,13505.0,2,10248,0,13500.0,5,13505.0,2,B
2018-04-11 14:16:29,13505.0,2,10250,0,13500.0,6,13505.0,3,B
2018-04-11 14:16:32,13505.0,2,10252,2,13500.0,6,13505.0,2,B
2018-04-11 14:16:34,13505.0,2,10254,0,13500.0,6,13505.0,1,B
2018-04-11 14:16:48,13505.0,4,10258,-2,13505.0,3,13510.0,14,B
2018-04-11 14:16:49,13505.0,6,10264,-2,13500.0,5,13510.0,14,B
2018-04-11 14:16:57,13505.0,2,10266,0,13500.0,8,13510.0,14,B
2018-04-11 14:18:17,13510.0,2,10268,2,13500.0,7,13510.0,14,B
2018-04-11 14:18:27,13510.0,2,10270,2,13500.0,7,13510.0,13,B
2018-04-11 14:18:31,13510.0,2,10272,0,13505.0,3,13510.0,10,B
2018-04-11 14:18:45,13510.0,4,10276,4,13505.0,3,13510.0,8,B
2018-04-11 14:18:52,13505.0,2,10278,-2,13505.0,2,13510.0,8,S
2018-04-11 14:18:54,13505.0,4,10282,0,13500.0,9,13510.0,8,S
2018-04-11 14:18:55,13510.0,2,10284,0,13500.0,10,13510.0,7,B
2018-04-11 14:19:04,13500.0,16,10300,2,13500.0,3,13510.0,7,S
2018-04-11 14:19:04,13510.0,2,10302,0,13505.0,9,13510.0,6,B
2018-04-11 14:19:05,13510.0,8,10310,-2,13505.0,12,13510.0,2,B
2018-04-11 14:19:05,13515.0,26,10336,-8,13510.0,10,13520.0,14,B
2018-04-11 14:19:06,13520.0,2,10338,-2,13510.0,5,13520.0,5,B
2018-04-11 14:19:17,13510.0,10,10348,8,13505.0,11,13510.0,3,S
2018-04-11 14:19:18,13510.0,6,10354,2,13510.0,2,13515.0,1,S
2018-04-11 14:19:26,13510.0,4,10358,4,13510.0,8,13515.0,2,S
2018-04-11 14:19:31,13515.0,2,10360,-2,13510.0,8,13520.0,6,B
2018-04-11 14:19:47,13520.0,2,10362,0,13510.0,10,13520.0,4,B
2018-04-11 14:19:49,13520.0,2,10364,0,13510.0,10,13520.0,4,B
2018-04-11 14:19:50,13520.0,2,10366,2,13510.0,10,13520.0,3,B
2018-04-11 14:19:57,13520.0,4,10370,4,13515.0,2,13520.0,3,B
2018-04-11 14:20:00,13520.0,2,10372,2,13515.0,3,13520.0,1,B
2018-04-11 14:20:03,13520.0,2,10374,2,13520.0,12,13525.0,9,B
2018-04-11 14:20:04,13525.0,2,10376,0,13520.0,10,13525.0,5,B
2018-04-11 14:20:07,13520.0,20,10396,-2,13515.0,6,13525.0,5,S
2018-04-11 14:20:08,13520.0,4,10400,-2,13515.0,6,13520.0,2,S
2018-04-11 14:20:11,13520.0,2,10402,2,13520.0,4,13525.0,9,S
2018-04-11 14:20:19,13525.0,18,10420,-6,13525.0,6,13530.0,10,B
2018-04-11 14:20:19,13525.0,12,10432,-4,13520.0,4,13525.0,4,B
2018-04-11 14:20:20,13525.0,2,10434,0,13520.0,4,13525.0,3,B
2018-04-11 14:20:22,13525.0,2,10436,2,13520.0,4,13525.0,2,B
2018-04-11 14:20:28,13525.0,2,10438,2,13520.0,4,13525.0,1,B
2018-04-11 14:20:30,13520.0,8,10446,8,13515.0,3,13525.0,2,S
2018-04-11 14:20:51,13510.0,2,10448,-2,13510.0,3,13515.0,13,S
2018-04-11 14:21:12,13510.0,2,10450,-2,13510.0,2,13515.0,13,S
2018-04-11 14:21:39,13515.0,26,10476,-24,13510.0,4,13520.0,8,B
2018-04-11 14:22:26,13510.0,2,10478,0,13505.0,5,13515.0,4,S
2018-04-11 14:22:30,13505.0,10,10488,-6,13505.0,2,13515.0,5,S
2018-04-11 14:23:01,13500.0,2,10490,2,13500.0,4,13505.0,2,S
2018-04-11 14:23:07,13505.0,2,10492,2,13505.0,1,13510.0,1,B
2018-04-11 14:24:10,13505.0,2,10494,-2,13500.0,5,13505.0,1,B
2018-04-11 14:24:22,13505.0,2,10496,0,13500.0,5,13510.0,4,B
2018-04-11 14:24:27,13505.0,2,10498,2,13500.0,5,13510.0,4,B
2018-04-11 14:26:01,13500.0,2,10500,0,13500.0,3,13505.0,3,S
2018-04-11 14:26:30,13505.0,2,10502,0,13500.0,4,13505.0,1,B
2018-04-11 14:27:57,13505.0,2,10504,0,13500.0,6,13505.0,5,B
2018-04-11 14:28:10,13500.0,10,10514,-4,13500.0,1,13505.0,5,S
2018-04-11 14:28:10,13500.0,2,10516,0,13495.0,8,13505.0,5,S
2018-04-11 14:28:25,13495.0,2,10518,0,13495.0,2,13500.0,1,S
2018-04-11 14:28:27,13500.0,2,10520,0,13495.0,3,13505.0,8,B
2018-04-11 14:28:44,13500.0,2,10522,0,13495.0,8,13505.0,6,B
2018-04-11 14:29:10,13505.0,12,10534,2,13500.0,6,13510.0,5,B
2018-04-11 14:30:06,13505.0,2,10536,0,13505.0,5,13510.0,5,B
2018-04-11 14:30:18,13505.0,4,10540,-4,13505.0,3,13510.0,5,B
2018-04-11 14:30:23,13505.0,2,10542,0,13505.0,2,13510.0,3,B
2018-04-11 14:30:50,13505.0,2,10544,2,13505.0,1,13510.0,3,B
2018-04-11 14:31:24,13510.0,2,10546,0,13505.0,1,13510.0,2,B
2018-04-11 14:31:49,13505.0,2,10548,0,13500.0,5,13510.0,2,S
2018-04-11 14:32:27,13500.0,2,10550,-2,13500.0,3,13510.0,6,S
2018-04-11 14:32:58,13500.0,2,10552,0,13495.0,5,13505.0,12,S
2018-04-11 14:33:04,13505.0,12,10564,-4,13495.0,7,13510.0,13,B
2018-04-11 14:33:05,13500.0,2,10566,0,13495.0,7,13505.0,14,S
2018-04-11 14:33:06,13500.0,2,10568,0,13495.0,7,13505.0,1,S
2018-04-11 14:33:24,13500.0,2,10570,0,13495.0,7,13505.0,7,S
2018-04-11 14:33:30,13495.0,2,10572,0,13495.0,3,13505.0,7,S
2018-04-11 14:34:17,13505.0,8,10580,0,13500.0,4,13505.0,2,B
2018-04-11 14:34:18,13505.0,2,10582,-2,13500.0,6,13505.0,1,B
2018-04-11 14:34:33,13505.0,6,10588,0,13500.0,9,13510.0,10,B
2018-04-11 14:35:13,13510.0,2,10590,-2,13505.0,6,13510.0,4,B
2018-04-11 14:35:29,13505.0,2,10592,0,13505.0,5,13510.0,5,S
2018-04-11 14:35:38,13505.0,2,10594,0,13505.0,1,13510.0,5,S
2018-04-11 14:35:39,13510.0,2,10596,0,13505.0,2,13510.0,4,B
2018-04-11 14:35:54,13505.0,4,10600,0,13500.0,6,13505.0,1,S
2018-04-11 14:36:13,13505.0,2,10602,-2,13500.0,3,13505.0,5,S
2018-04-11 14:37:10,13505.0,2,10604,0,13500.0,6,13505.0,4,S
2018-04-11 14:37:39,13505.0,2,10606,0,13500.0,6,13505.0,3,S
2018-04-11 14:38:10,13505.0,8,10614,0,13505.0,3,13510.0,7,S
2018-04-11 14:38:28,13505.0,4,10618,-2,13505.0,2,13510.0,3,S
2018-04-11 14:38:34,13510.0,2,10620,2,13505.0,2,13510.0,2,B
2018-04-11 14:38:35,13510.0,2,10622,0,13505.0,6,13510.0,1,B
2018-04-11 14:38:52,13510.0,2,10624,0,13505.0,6,13510.0,5,B
2018-04-11 14:38:53,13510.0,2,10626,0,13505.0,8,13510.0,4,B
2018-04-11 14:38:53,13510.0,8,10634,-6,13510.0,2,13515.0,10,B
2018-04-11 14:38:54,13510.0,4,10638,2,13505.0,9,13515.0,4,B
2018-04-11 14:38:59,13515.0,2,10640,0,13510.0,1,13515.0,3,B
2018-04-11 14:38:59,13515.0,2,10642,2,13510.0,1,13515.0,2,B
2018-04-11 14:39:01,13515.0,2,10644,2,13510.0,1,13515.0,1,B
2018-04-11 14:39:01,13515.0,2,10646,0,13510.0,1,13520.0,10,B
2018-04-11 14:39:03,13510.0,8,10654,-8,13505.0,6,13520.0,10,S
2018-04-11 14:39:05,13515.0,2,10656,0,13510.0,3,13520.0,7,B
2018-04-11 14:39:16,13510.0,2,10658,0,13505.0,6,13510.0,1,S
2018-04-11 14:39:17,13510.0,2,10660,0,13505.0,6,13515.0,6,S
2018-04-11 14:39:18,13510.0,2,10662,2,13505.0,6,13515.0,6,S
2018-04-11 14:39:48,13500.0,8,10670,-2,13500.0,3,13505.0,1,S
2018-04-11 14:39:51,13500.0,6,10676,-2,13495.0,7,13500.0,1,S
2018-04-11 14:39:52,13500.0,2,10678,-2,13495.0,7,13505.0,2,S
2018-04-11 14:39:57,13505.0,2,10680,2,13500.0,1,13505.0,1,B
2018-04-11 14:40:00,13500.0,2,10682,-2,13495.0,6,13505.0,2,S
2018-04-11 14:40:16,13505.0,2,10684,2,13500.0,3,13505.0,8,B
2018-04-11 14:40:27,13500.0,4,10688,2,13495.0,6,13505.0,8,S
2018-04-11 14:40:33,13495.0,6,10694,0,13490.0,7,13495.0,19,S
2018-04-11 14:40:45,13485.0,10,10704,-4,13485.0,4,13490.0,10,S
2018-04-11 14:40:46,13485.0,8,10712,-6,13480.0,27,13485.0,1,S
2018-04-11 14:40:48,13485.0,4,10716,-4,13485.0,1,13490.0,3,S
2018-04-11 14:40:49,13490.0,2,10718,-2,13485.0,2,13495.0,13,B
2018-04-11 14:40:50,13485.0,6,10724,0,13480.0,26,13490.0,9,S
2018-04-11 14:40:51,13485.0,2,10726,2,13480.0,26,13490.0,9,S
2018-04-11 14:40:53,13485.0,2,10728,0,13480.0,26,13490.0,9,S
2018-04-11 14:41:07,13485.0,2,10730,-2,13480.0,24,13485.0,1,S
2018-04-11 14:41:10,13485.0,2,10732,0,13480.0,27,13490.0,4,S
2018-04-11 14:41:11,13480.0,8,10740,-6,13480.0,24,13490.0,1,S
2018-04-11 14:41:11,13480.0,2,10742,-2,13480.0,23,13490.0,2,S
2018-04-11 14:41:13,13480.0,2,10744,0,13480.0,24,13490.0,2,S
2018-04-11 14:41:23,13485.0,2,10746,0,13485.0,1,13490.0,4,B
2018-04-11 14:41:39,13490.0,2,10748,0,13485.0,2,13490.0,1,B
2018-04-11 14:41:47,13490.0,2,10750,2,13485.0,1,13490.0,4,B
2018-04-11 14:42:02,13490.0,2,10752,0,13485.0,2,13490.0,3,B
2018-04-11 14:42:12,13490.0,2,10754,0,13485.0,2,13490.0,2,B
2018-04-11 14:42:40,13490.0,2,10756,0,13490.0,3,13495.0,11,B
2018-04-11 14:42:45,13495.0,2,10758,0,13495.0,4,13500.0,8,B
2018-04-11 14:42:51,13495.0,2,10760,-2,13495.0,4,13500.0,4,B
2018-04-11 14:43:01,13500.0,2,10762,2,13490.0,3,13500.0,9,B
2018-04-11 14:43:17,13495.0,2,10764,-2,13490.0,5,13500.0,7,S
2018-04-11 14:43:22,13495.0,2,10766,0,13495.0,4,13500.0,8,S
2018-04-11 14:43:26,13495.0,2,10768,2,13495.0,3,13500.0,7,S
2018-04-11 14:43:27,13495.0,2,10770,0,13495.0,2,13500.0,7,S
2018-04-11 14:43:28,13495.0,4,10774,0,13490.0,3,13500.0,7,S
2018-04-11 14:43:49,13500.0,2,10776,0,13495.0,3,13500.0,4,B
2018-04-11 14:44:03,13500.0,2,10778,0,13495.0,6,13500.0,1,B
2018-04-11 14:44:04,13500.0,2,10780,0,13495.0,6,13505.0,7,B
2018-04-11 14:44:14,13500.0,2,10782,2,13500.0,1,13505.0,4,B
2018-04-11 14:44:17,13505.0,2,10784,0,13505.0,3,13510.0,6,B
2018-04-11 14:44:20,13505.0,2,10786,-2,13500.0,4,13510.0,4,B
2018-04-11 14:44:30,13495.0,8,10794,2,13490.0,5,13495.0,6,S
2018-04-11 14:44:31,13495.0,8,10802,4,13490.0,4,13495.0,2,S
2018-04-11 14:44:31,13495.0,2,10804,2,13490.0,4,13495.0,1,S
2018-04-11 14:44:32,13495.0,2,10806,2,13490.0,4,13500.0,3,S
2018-04-11 14:44:58,13490.0,2,10808,0,13490.0,1,13495.0,6,S
2018-04-11 14:44:58,13490.0,2,10810,0,13485.0,4,13490.0,1,S
2018-04-11 14:45:00,13490.0,2,10812,2,13485.0,4,13495.0,2,S
2018-04-11 14:45:01,13490.0,2,10814,0,13485.0,4,13495.0,2,S
2018-04-11 14:45:03,13490.0,2,10816,0,13485.0,2,13495.0,23,S
2018-04-11 14:45:06,13490.0,2,10818,2,13485.0,3,13490.0,5,S
2018-04-11 14:45:10,13485.0,4,10822,0,13480.0,28,13485.0,18,S
2018-04-11 14:45:11,13485.0,2,10824,2,13480.0,29,13485.0,17,S
2018-04-11 14:45:12,13485.0,2,10826,2,13480.0,27,13485.0,16,S
2018-04-11 14:45:12,13485.0,2,10828,2,13480.0,27,13485.0,15,S
2018-04-11 14:45:13,13485.0,2,10830,2,13480.0,27,13485.0,14,S
2018-04-11 14:45:14,13485.0,2,10832,2,13480.0,27,13485.0,13,S
2018-04-11 14:45:15,13485.0,2,10834,2,13480.0,27,13485.0,12,S
2018-04-11 14:45:16,13485.0,2,10836,2,13480.0,27,13485.0,11,S
2018-04-11 14:45:16,13485.0,2,10838,2,13480.0,27,13485.0,10,S
2018-04-11 14:45:17,13485.0,2,10840,2,13480.0,28,13485.0,9,S
2018-04-11 14:45:18,13485.0,2,10842,2,13480.0,28,13485.0,8,S
2018-04-11 14:45:19,13485.0,2,10844,2,13480.0,28,13485.0,7,S
2018-04-11 14:45:19,13485.0,2,10846,2,13480.0,26,13485.0,6,S
2018-04-11 14:45:20,13485.0,2,10848,2,13480.0,26,13485.0,5,S
2018-04-11 14:45:21,13485.0,2,10850,2,13480.0,26,13485.0,4,S
2018-04-11 14:45:21,13480.0,4,10854,0,13480.0,23,13485.0,6,S
2018-04-11 14:45:24,13485.0,2,10856,2,13480.0,23,13485.0,3,B
2018-04-11 14:45:24,13485.0,2,10858,2,13480.0,23,13485.0,2,B
2018-04-11 14:45:25,13485.0,2,10860,2,13480.0,23,13485.0,1,B
2018-04-11 14:45:26,13485.0,2,10862,2,13480.0,23,13490.0,6,B
2018-04-11 14:45:27,13485.0,2,10864,0,13480.0,23,13490.0,4,B
2018-04-11 14:45:40,13490.0,2,10866,0,13485.0,2,13490.0,1,B
2018-04-11 14:45:54,13485.0,2,10868,-2,13480.0,24,13490.0,10,S
2018-04-11 14:45:57,13485.0,4,10872,0,13480.0,25,13490.0,12,S
2018-04-11 14:46:08,13480.0,20,10892,0,13480.0,14,13485.0,25,S
2018-04-11 14:46:12,13485.0,2,10894,2,13480.0,14,13485.0,25,B
2018-04-11 14:46:12,13485.0,2,10896,2,13480.0,14,13485.0,24,B
2018-04-11 14:46:13,13485.0,2,10898,2,13480.0,14,13485.0,23,B
2018-04-11 14:46:14,13485.0,2,10900,2,13480.0,14,13485.0,22,B
2018-04-11 14:46:14,13485.0,2,10902,2,13480.0,14,13485.0,21,B
2018-04-11 14:46:15,13485.0,2,10904,2,13480.0,14,13485.0,20,B
2018-04-11 14:46:16,13485.0,4,10908,4,13480.0,14,13485.0,18,B
2018-04-11 14:46:17,13485.0,2,10910,2,13480.0,14,13485.0,17,B
2018-04-11 14:46:18,13485.0,2,10912,2,13480.0,14,13485.0,16,B
2018-04-11 14:46:19,13485.0,2,10914,2,13480.0,14,13485.0,15,B
2018-04-11 14:46:20,13480.0,30,10944,14,13475.0,5,13480.0,4,S
2018-04-11 14:46:21,13480.0,8,10952,6,13475.0,11,13485.0,15,S
2018-04-11 14:46:21,13485.0,2,10954,2,13475.0,13,13485.0,14,B
2018-04-11 14:46:22,13485.0,2,10956,2,13475.0,13,13485.0,13,B
2018-04-11 14:46:23,13485.0,2,10958,2,13475.0,13,13485.0,12,B
2018-04-11 14:46:23,13485.0,2,10960,2,13475.0,13,13485.0,11,B
2018-04-11 14:46:25,13485.0,2,10962,2,13480.0,1,13485.0,10,B
2018-04-11 14:46:26,13485.0,2,10964,2,13480.0,1,13485.0,9,B
2018-04-11 14:46:26,13485.0,2,10966,2,13475.0,13,13485.0,8,B
2018-04-11 14:46:27,13485.0,2,10968,2,13480.0,1,13485.0,7,B
2018-04-11 14:46:28,13485.0,2,10970,2,13480.0,1,13485.0,6,B
2018-04-11 14:46:29,13485.0,2,10972,0,13480.0,1,13485.0,5,B
2018-04-11 14:46:30,13485.0,2,10974,0,13480.0,1,13485.0,4,B
2018-04-11 14:46:31,13485.0,2,10976,0,13480.0,1,13485.0,3,B
2018-04-11 14:46:32,13485.0,2,10978,0,13480.0,1,13485.0,2,B
2018-04-11 14:46:32,13485.0,2,10980,0,13480.0,1,13485.0,1,B
2018-04-11 14:46:33,13485.0,2,10982,2,13480.0,1,13490.0,10,B
2018-04-11 14:46:41,13485.0,2,10984,0,13480.0,5,13490.0,8,B
2018-04-11 14:46:43,13480.0,2,10986,2,13480.0,5,13490.0,8,S
2018-04-11 14:46:45,13485.0,2,10988,0,13480.0,5,13490.0,7,B
2018-04-11 14:46:50,13485.0,2,10990,0,13480.0,5,13490.0,7,B
2018-04-11 14:47:21,13485.0,2,10992,-2,13480.0,4,13490.0,6,B
2018-04-11 14:47:28,13490.0,2,10994,0,13485.0,2,13490.0,1,B
2018-04-11 14:48:22,13490.0,4,10998,2,13490.0,3,13495.0,8,B
2018-04-11 14:49:12,13495.0,8,11006,2,13490.0,8,13495.0,2,B
2018-04-11 14:49:13,13495.0,4,11010,-4,13495.0,1,13500.0,6,B
2018-04-11 14:49:14,13500.0,4,11014,4,13490.0,5,13500.0,6,B
2018-04-11 14:49:14,13500.0,2,11016,0,13490.0,5,13500.0,6,B
2018-04-11 14:49:28,13490.0,2,11018,0,13490.0,6,13500.0,4,S
2018-04-11 14:49:42,13500.0,2,11020,0,13490.0,6,13500.0,3,B
2018-04-11 14:49:56,13495.0,2,11022,0,13490.0,5,13500.0,4,S
2018-04-11 14:49:59,13495.0,2,11024,0,13490.0,4,13495.0,1,S
2018-04-11 14:50:01,13495.0,2,11026,0,13490.0,5,13500.0,4,S
2018-04-11 14:50:03,13500.0,2,11028,0,13495.0,1,13500.0,4,B
2018-04-11 14:50:21,13495.0,2,11030,2,13490.0,4,13500.0,7,S
2018-04-11 14:50:54,13495.0,2,11032,2,13490.0,7,13500.0,4,S
2018-04-11 14:51:07,13490.0,2,11034,0,13490.0,4,13500.0,2,S
2018-04-11 14:51:07,13490.0,2,11036,2,13490.0,3,13500.0,2,S
2018-04-11 14:51:09,13500.0,2,11038,2,13495.0,3,13500.0,1,B
2018-04-11 14:51:29,13500.0,2,11040,2,13500.0,1,13505.0,4,B
2018-04-11 14:51:45,13500.0,2,11042,0,13500.0,1,13505.0,5,B
2018-04-11 14:51:45,13500.0,2,11044,0,13495.0,4,13505.0,4,B
2018-04-11 14:51:49,13500.0,2,11046,2,13495.0,4,13505.0,4,B
2018-04-11 14:52:15,13500.0,4,11050,0,13495.0,4,13505.0,4,B
2018-04-11 14:52:50,13495.0,2,11052,-2,13495.0,4,13505.0,7,S
2018-04-11 14:52:53,13505.0,2,11054,2,13495.0,4,13505.0,6,B
2018-04-11 14:53:02,13505.0,2,11056,2,13500.0,3,13505.0,3,B
2018-04-11 14:53:03,13505.0,2,11058,2,13500.0,3,13505.0,2,B
2018-04-11 14:53:03,13505.0,2,11060,2,13500.0,3,13505.0,1,B
2018-04-11 14:53:04,13505.0,2,11062,2,13505.0,1,13510.0,8,B
2018-04-11 14:53:24,13505.0,2,11064,0,13500.0,11,13510.0,2,B
2018-04-11 14:54:23,13510.0,2,11066,2,13505.0,4,13510.0,6,B
2018-04-11 14:54:24,13510.0,2,11068,2,13505.0,4,13510.0,5,B
2018-04-11 14:54:24,13510.0,2,11070,2,13505.0,4,13510.0,4,B
2018-04-11 14:54:25,13510.0,2,11072,0,13505.0,4,13510.0,3,B
2018-04-11 14:54:26,13510.0,2,11074,0,13505.0,3,13510.0,2,B
2018-04-11 14:54:26,13510.0,2,11076,0,13505.0,3,13510.0,1,B
2018-04-11 14:54:27,13510.0,2,11078,2,13505.0,3,13515.0,9,B
2018-04-11 14:54:30,13515.0,2,11080,0,13505.0,2,13515.0,9,B
2018-04-11 14:54:38,13510.0,2,11082,2,13505.0,5,13515.0,9,S
2018-04-11 14:54:50,13510.0,2,11084,0,13505.0,6,13515.0,9,S
2018-04-11 14:54:54,13515.0,4,11088,0,13505.0,4,13515.0,8,B
2018-04-11 14:54:57,13510.0,2,11090,-2,13505.0,4,13510.0,3,S
2018-04-11 14:55:02,13510.0,4,11094,-2,13505.0,5,13510.0,1,S
2018-04-11 14:55:03,13510.0,2,11096,-2,13510.0,2,13515.0,4,S
2018-04-11 14:55:05,13510.0,2,11098,0,13510.0,2,13515.0,1,S
2018-04-11 14:55:06,13515.0,2,11100,2,13515.0,1,13520.0,13,B
2018-04-11 14:55:08,13520.0,2,11102,-2,13515.0,4,13520.0,5,B
2018-04-11 14:55:10,13520.0,10,11112,8,13515.0,1,13525.0,8,B
2018-04-11 14:55:11,13525.0,2,11114,0,13520.0,10,13525.0,5,B
2018-04-11 14:55:12,13525.0,2,11116,0,13520.0,10,13525.0,4,B
2018-04-11 14:55:12,13520.0,20,11136,14,13515.0,1,13525.0,7,S
2018-04-11 14:55:13,13520.0,2,11138,-2,13515.0,3,13525.0,6,S
2018-04-11 14:55:15,13520.0,2,11140,2,13515.0,2,13525.0,5,S
2018-04-11 14:55:19,13525.0,6,11146,-6,13525.0,1,13530.0,7,B
2018-04-11 14:55:20,13525.0,2,11148,0,13520.0,4,13530.0,8,B
2018-04-11 14:55:22,13530.0,16,11164,0,13530.0,11,13535.0,10,B
2018-04-11 14:55:22,13530.0,16,11180,-6,13530.0,3,13535.0,10,B
2018-04-11 14:55:23,13530.0,6,11186,-6,13525.0,3,13535.0,10,B
2018-04-11 14:55:26,13525.0,2,11188,0,13520.0,4,13530.0,2,S
2018-04-11 14:55:26,13525.0,2,11190,0,13525.0,2,13530.0,2,S
2018-04-11 14:55:27,13525.0,4,11194,4,13520.0,4,13525.0,1,S
2018-04-11 14:55:50,13525.0,2,11196,2,13520.0,3,13525.0,1,S
2018-04-11 14:55:50,13520.0,2,11198,2,13515.0,3,13525.0,2,S
2018-04-11 14:55:53,13515.0,2,11200,2,13515.0,2,13525.0,1,S
2018-04-11 14:56:01,13520.0,4,11204,-4,13515.0,3,13525.0,1,B
2018-04-11 14:56:08,13520.0,2,11206,0,13520.0,2,13530.0,7,B
2018-04-11 14:56:18,13525.0,2,11208,0,13520.0,2,13530.0,7,B
2018-04-11 14:56:32,13525.0,2,11210,-2,13520.0,2,13525.0,1,B
2018-04-11 14:56:35,13515.0,2,11212,0,13515.0,4,13525.0,11,S
2018-04-11 14:56:37,13525.0,4,11216,-4,13515.0,4,13525.0,9,B
2018-04-11 14:56:45,13520.0,4,11220,0,13520.0,1,13525.0,2,S
2018-04-11 14:56:46,13520.0,2,11222,2,13515.0,6,13525.0,2,S
2018-04-11 14:56:50,13520.0,2,11224,0,13515.0,5,13520.0,4,S
2018-04-11 14:56:52,13515.0,2,11226,0,13515.0,2,13520.0,7,S
2018-04-11 14:56:55,13520.0,2,11228,0,13515.0,2,13520.0,6,B
2018-04-11 14:56:59,13520.0,2,11230,0,13515.0,2,13520.0,5,B
2018-04-11 14:57:00,13520.0,2,11232,0,13515.0,4,13520.0,3,B
2018-04-11 14:57:01,13520.0,2,11234,0,13515.0,4,13520.0,2,B
2018-04-11 14:57:02,13520.0,2,11236,0,13515.0,4,13520.0,1,B
2018-04-11 14:57:03,13520.0,2,11238,0,13515.0,4,13525.0,5,B
2018-04-11 14:57:19,13520.0,2,11240,2,13520.0,2,13525.0,6,B
2018-04-11 14:57:39,13520.0,2,11242,2,13520.0,4,13525.0,8,B
2018-04-11 14:57:44,13520.0,2,11244,0,13520.0,3,13525.0,8,B
2018-04-11 14:57:47,13520.0,2,11246,-2,13520.0,2,13525.0,9,B
2018-04-11 14:57:53,13520.0,2,11248,-2,13520.0,1,13525.0,9,B
2018-04-11 14:57:53,13520.0,2,11250,-2,13515.0,3,13525.0,9,B
2018-04-11 14:58:00,13520.0,6,11256,-4,13515.0,10,13520.0,1,B
2018-04-11 14:58:01,13520.0,2,11258,0,13520.0,5,13525.0,9,B
2018-04-11 14:58:09,13525.0,4,11262,0,13520.0,9,13525.0,7,B
2018-04-11 14:58:43,13520.0,4,11266,-4,13520.0,4,13525.0,7,S
2018-04-11 14:58:43,13520.0,8,11274,-2,13515.0,2,13525.0,9,S
2018-04-11 14:58:58,13520.0,2,11276,-2,13515.0,10,13525.0,7,S
2018-04-11 14:59:00,13525.0,6,11282,-4,13515.0,10,13525.0,4,B
2018-04-11 14:59:11,13525.0,2,11284,2,13520.0,5,13525.0,5,B
2018-04-11 14:59:12,13525.0,4,11288,2,13520.0,5,13525.0,3,B
2018-04-11 14:59:13,13525.0,2,11290,0,13520.0,5,13525.0,2,B
2018-04-11 14:59:13,13525.0,2,11292,0,13520.0,5,13525.0,1,B
2018-04-11 14:59:14,13525.0,2,11294,0,13520.0,5,13530.0,9,B
2018-04-11 14:59:22,13530.0,2,11296,-2,13525.0,2,13530.0,8,B
2018-04-11 14:59:25,13525.0,2,11298,0,13525.0,1,13530.0,10,S
2018-04-11 14:59:26,13525.0,2,11300,0,13520.0,2,13530.0,10,S
2018-04-11 14:59:30,13530.0,2,11302,0,13520.0,2,13530.0,12,B
2018-04-11 14:59:30,13520.0,2,11304,-2,13515.0,3,13530.0,12,S
2018-04-11 14:59:35,13520.0,2,11306,0,13520.0,2,13525.0,1,S
2018-04-11 14:59:39,13520.0,2,11308,2,13520.0,1,13525.0,1,S
2018-04-11 14:59:42,13520.0,2,11310,2,13515.0,4,13525.0,1,S
2018-04-11 14:59:42,13525.0,2,11312,-2,13515.0,3,13530.0,11,B
2018-04-11 20:59:00,13540.0,2,2,59790,0.0,0,0.0,0,B
2018-04-11 21:00:00,13535.0,2,4,2,13530.0,1,13535.0,2,S
2018-04-11 21:00:01,13535.0,6,10,6,13535.0,1,13550.0,1,S
2018-04-11 21:00:03,13550.0,2,12,0,13535.0,34,13555.0,3,B
2018-04-11 21:00:04,13550.0,2,14,0,13535.0,3,13545.0,1,B
2018-04-11 21:00:04,13535.0,6,20,2,13530.0,1,13535.0,3,S
2018-04-11 21:00:05,13535.0,2,22,0,13530.0,4,13535.0,2,S
2018-04-11 21:00:08,13530.0,2,24,-2,13515.0,1,13535.0,2,S
2018-04-11 21:00:12,13530.0,4,28,-2,13525.0,34,13535.0,2,S
2018-04-11 21:00:15,13535.0,2,30,2,13530.0,2,13535.0,1,B
2018-04-11 21:00:25,13535.0,2,32,0,13535.0,1,13545.0,1,B
2018-04-11 21:00:26,13530.0,2,34,2,13530.0,5,13540.0,1,S
2018-04-11 21:00:33,13530.0,2,36,2,13530.0,1,13540.0,2,S
2018-04-11 21:00:42,13530.0,2,38,0,13530.0,1,13540.0,2,S
2018-04-11 21:00:43,13530.0,2,40,0,13530.0,1,13540.0,3,S
2018-04-11 21:01:03,13540.0,10,50,-8,13535.0,1,13545.0,2,B
2018-04-11 21:01:05,13540.0,2,52,0,13540.0,1,13545.0,2,B
2018-04-11 21:01:06,13545.0,2,54,0,13540.0,2,13545.0,1,B
2018-04-11 21:01:08,13545.0,2,56,0,13540.0,2,13550.0,1,B
2018-04-11 21:01:11,13545.0,2,58,0,13540.0,1,13550.0,2,B
2018-04-11 21:01:21,13545.0,2,60,0,13540.0,1,13545.0,2,B
2018-04-11 21:01:29,13540.0,4,64,2,13535.0,1,13540.0,3,S
2018-04-11 21:01:30,13540.0,2,66,0,13535.0,1,13540.0,1,S
2018-04-11 21:01:36,13530.0,16,82,8,13530.0,39,13545.0,1,S
2018-04-11 21:01:44,13535.0,2,84,-2,13535.0,2,13545.0,2,B
2018-04-11 21:01:58,13525.0,2,86,2,13525.0,34,13540.0,3,S
2018-04-11 21:02:08,13520.0,26,112,12,13520.0,30,13535.0,2,S
2018-04-11 21:02:15,13530.0,2,114,0,13520.0,10,13535.0,2,B
2018-04-11 21:02:22,13520.0,4,118,0,13515.0,1,13530.0,12,S
2018-04-11 21:02:28,13515.0,2,120,-2,13515.0,4,13520.0,1,S
2018-04-11 21:02:31,13515.0,4,124,0,13505.0,2,13520.0,6,S
2018-04-11 21:02:53,13515.0,2,126,0,13515.0,7,13520.0,6,S
2018-04-11 21:02:59,13520.0,2,128,2,13515.0,7,13520.0,5,B
2018-04-11 21:03:04,13520.0,2,130,2,13515.0,10,13520.0,4,B
2018-04-11 21:03:06,13520.0,8,138,8,13515.0,11,13525.0,1,B
2018-04-11 21:03:35,13525.0,2,140,-2,13520.0,10,13530.0,8,B
2018-04-11 21:03:38,13525.0,4,144,0,13525.0,3,13530.0,8,B
2018-04-11 21:03:46,13530.0,2,146,2,13525.0,4,13530.0,7,B
2018-04-11 21:04:01,13530.0,4,150,4,13525.0,8,13530.0,5,B
2018-04-11 21:04:01,13530.0,2,152,0,13525.0,10,13530.0,4,B
2018-04-11 21:04:02,13530.0,4,156,2,13525.0,11,13530.0,2,B
2018-04-11 21:04:02,13530.0,4,160,0,13530.0,1,13540.0,15,B
2018-04-11 21:04:09,13530.0,2,162,-2,13525.0,8,13535.0,3,B
2018-04-11 21:04:11,13530.0,2,164,0,13525.0,8,13535.0,2,B
2018-04-11 21:04:17,13530.0,4,168,0,13530.0,1,13540.0,5,B
2018-04-11 21:04:35,13535.0,2,170,0,13530.0,7,13540.0,6,B
2018-04-11 21:04:50,13535.0,2,172,2,13530.0,9,13540.0,3,B
2018-04-11 21:04:54,13540.0,6,178,-6,13535.0,6,13545.0,6,B
2018-04-11 21:04:58,13545.0,2,180,2,13545.0,1,13550.0,6,B
2018-04-11 21:05:00,13545.0,4,184,0,13540.0,5,13550.0,7,B
2018-04-11 21:05:11,13540.0,2,186,-2,13535.0,2,13545.0,5,S
2018-04-11 21:05:24,13540.0,2,188,0,13535.0,6,13545.0,4,S
2018-04-11 21:05:30,13545.0,6,194,-2,13535.0,6,13545.0,1,B
2018-04-11 21:05:56,13540.0,2,196,-2,13535.0,20,13545.0,1,S
2018-04-11 21:05:59,13540.0,2,198,0,13535.0,19,13545.0,4,S
2018-04-11 21:06:38,13540.0,2,200,0,13535.0,11,13545.0,8,S
2018-04-11 21:06:56,13540.0,2,202,0,13535.0,11,13545.0,8,S
2018-04-11 21:07:28,13540.0,2,204,0,13535.0,6,13545.0,10,S
2018-04-11 21:07:29,13540.0,2,206,0,13535.0,6,13545.0,7,S
2018-04-11 21:08:07,13535.0,4,210,2,13530.0,3,13535.0,8,S
2018-04-11 21:08:26,13530.0,18,228,14,13520.0,51,13530.0,7,S
2018-04-11 21:08:30,13525.0,2,230,2,13520.0,10,13530.0,1,S
2018-04-11 21:08:48,13520.0,6,236,0,13520.0,9,13530.0,3,S
2018-04-11 21:08:48,13520.0,2,238,0,13520.0,3,13530.0,8,S
2018-04-11 21:08:53,13530.0,2,240,-2,13520.0,3,13530.0,8,B
2018-04-11 21:09:14,13520.0,14,254,12,13515.0,5,13520.0,13,S
2018-04-11 21:09:14,13520.0,2,256,2,13515.0,6,13520.0,12,S
2018-04-11 21:09:16,13520.0,2,258,0,13515.0,6,13520.0,11,S
2018-04-11 21:09:18,13515.0,4,262,4,13515.0,2,13520.0,11,S
2018-04-11 21:09:20,13515.0,2,264,0,13515.0,1,13520.0,11,S
2018-04-11 21:09:20,13515.0,2,266,0,13510.0,3,13515.0,1,S
2018-04-11 21:09:30,13515.0,4,270,4,13510.0,6,13520.0,11,S
2018-04-11 21:09:32,13515.0,2,272,2,13510.0,10,13515.0,5,S
2018-04-11 21:09:32,13515.0,4,276,4,13510.0,33,13515.0,3,S
2018-04-11 21:09:36,13515.0,2,278,2,13510.0,34,13515.0,6,S
2018-04-11 21:09:37,13515.0,2,280,2,13510.0,34,13515.0,5,S
2018-04-11 21:09:43,13510.0,2,282,2,13510.0,35,13515.0,5,S
2018-04-11 21:09:44,13510.0,4,286,2,13510.0,33,13515.0,5,S
2018-04-11 21:09:48,13510.0,2,288,0,13510.0,8,13515.0,5,S
2018-04-11 21:09:48,13510.0,2,290,0,13510.0,7,13515.0,5,S
2018-04-11 21:09:49,13510.0,2,292,2,13510.0,6,13515.0,5,S
2018-04-11 21:09:56,13515.0,2,294,0,13510.0,7,13515.0,4,B
2018-04-11 21:10:07,13515.0,2,296,0,13510.0,8,13515.0,3,B
2018-04-11 21:10:07,13515.0,4,300,0,13510.0,9,13515.0,1,B
2018-04-11 21:10:08,13515.0,2,302,2,13510.0,32,13520.0,15,B
2018-04-11 21:10:10,13520.0,2,304,2,13515.0,6,13520.0,11,B
2018-04-11 21:10:18,13520.0,2,306,2,13515.0,2,13520.0,11,B
2018-04-11 21:10:20,13520.0,2,308,0,13515.0,3,13520.0,10,B
2018-04-11 21:10:25,13515.0,12,320,8,13510.0,6,13515.0,9,S
2018-04-11 21:10:28,13510.0,6,326,0,13510.0,1,13515.0,9,S
2018-04-11 21:10:30,13515.0,2,328,0,13510.0,4,13515.0,8,B
2018-04-11 21:10:37,13515.0,10,338,0,13510.0,4,13515.0,3,B
2018-04-11 21:10:40,13515.0,2,340,0,13510.0,4,13515.0,2,B
2018-04-11 21:10:48,13515.0,2,342,2,13510.0,3,13515.0,1,B
2018-04-11 21:10:49,13515.0,2,344,2,13510.0,3,13515.0,2,B
2018-04-11 21:10:50,13515.0,2,346,0,13510.0,3,13515.0,1,B
2018-04-11 21:10:51,13515.0,2,348,2,13510.0,3,13515.0,1,B
2018-04-11 21:10:51,13515.0,2,350,0,13510.0,3,13515.0,1,B
2018-04-11 21:10:52,13515.0,2,352,0,13510.0,3,13520.0,25,B
2018-04-11 21:10:53,13515.0,2,354,2,13510.0,3,13515.0,2,B
2018-04-11 21:10:56,13515.0,2,356,0,13510.0,4,13515.0,1,B
2018-04-11 21:11:08,13520.0,2,358,2,13515.0,1,13520.0,10,B
2018-04-11 21:11:08,13515.0,2,360,-2,13510.0,22,13515.0,1,S
2018-04-11 21:11:09,13515.0,2,362,0,13510.0,22,13520.0,10,S
2018-04-11 21:11:23,13515.0,2,364,0,13510.0,5,13515.0,3,S
2018-04-11 21:11:24,13515.0,2,366,0,13510.0,5,13515.0,3,S
2018-04-11 21:11:30,13510.0,2,368,2,13510.0,3,13515.0,3,S
2018-04-11 21:11:44,13510.0,2,370,2,13510.0,7,13515.0,3,S
2018-04-11 21:11:44,13510.0,2,372,0,13510.0,6,13515.0,3,S
2018-04-11 21:11:45,13510.0,2,374,0,13510.0,5,13515.0,3,S
2018-04-11 21:11:49,13510.0,10,384,-2,13505.0,4,13515.0,6,S
2018-04-11 21:11:50,13505.0,2,386,-2,13505.0,1,13510.0,4,S
2018-04-11 21:11:50,13505.0,2,388,-2,13500.0,6,13505.0,6,S
2018-04-11 21:11:55,13500.0,12,400,-2,13495.0,1,13505.0,4,S
2018-04-11 21:11:59,13500.0,2,402,2,13495.0,6,13500.0,2,S
2018-04-11 21:12:00,13500.0,2,404,2,13495.0,6,13500.0,1,S
2018-04-11 21:12:01,13500.0,2,406,0,13500.0,1,13505.0,7,S
2018-04-11 21:12:01,13500.0,2,408,-2,13495.0,8,13505.0,7,S
2018-04-11 21:12:12,13500.0,2,410,2,13500.0,1,13505.0,7,S
2018-04-11 21:12:25,13505.0,4,414,-2,13500.0,7,13510.0,4,B
2018-04-11 21:12:26,13510.0,4,418,0,13510.0,4,13515.0,6,B
2018-04-11 21:12:33,13510.0,2,420,0,13505.0,4,13515.0,4,B
2018-04-11 21:12:39,13510.0,2,422,2,13505.0,1,13515.0,4,B
2018-04-11 21:12:48,13505.0,2,424,0,13505.0,4,13510.0,1,S
2018-04-11 21:13:06,13515.0,6,430,0,13505.0,8,13515.0,5,B
2018-04-11 21:13:07,13515.0,2,432,0,13505.0,8,13515.0,4,B
2018-04-11 21:13:13,13505.0,2,434,0,13505.0,7,13515.0,4,S
2018-04-11 21:13:30,13505.0,4,438,0,13505.0,2,13510.0,1,S
2018-04-11 21:13:31,13510.0,2,440,0,13505.0,2,13515.0,16,B
2018-04-11 21:13:45,13505.0,4,444,-2,13500.0,8,13505.0,3,S
2018-04-11 21:14:00,13500.0,2,446,-2,13500.0,10,13510.0,5,S
2018-04-11 21:14:31,13505.0,10,456,-4,13500.0,9,13505.0,1,B
2018-04-11 21:14:31,13505.0,2,458,2,13500.0,9,13510.0,6,B
2018-04-11 21:14:55,13505.0,2,460,-2,13505.0,3,13510.0,2,B
2018-04-11 21:15:10,13505.0,2,462,0,13505.0,3,13510.0,2,B
2018-04-11 21:15:11,13505.0,6,468,4,13500.0,20,13505.0,3,B
2018-04-11 21:15:12,13505.0,4,472,4,13500.0,19,13505.0,1,B
2018-04-11 21:15:12,13505.0,2,474,0,13505.0,2,13510.0,2,B
2018-04-11 21:15:24,13510.0,2,476,2,13505.0,7,13510.0,16,B
2018-04-11 21:15:24,13505.0,2,478,2,13505.0,6,13510.0,4,S
2018-04-11 21:15:27,13505.0,2,480,2,13505.0,5,13510.0,3,S
2018-04-11 21:15:29,13505.0,4,484,-2,13505.0,3,13510.0,20,S
2018-04-11 21:15:30,13510.0,4,488,-2,13505.0,2,13510.0,19,B
2018-04-11 21:15:30,13505.0,4,492,0,13500.0,7,13510.0,20,S
2018-04-11 21:15:56,13500.0,2,494,0,13500.0,4,13505.0,1,S
2018-04-11 21:15:56,13500.0,4,498,-4,13500.0,3,13505.0,4,S
2018-04-11 21:15:57,13500.0,2,500,-2,13500.0,2,13505.0,9,S
2018-04-11 21:16:01,13500.0,2,502,2,13500.0,1,13505.0,9,S
2018-04-11 21:16:01,13500.0,2,504,0,13495.0,6,13500.0,5,S
2018-04-11 21:16:03,13500.0,2,506,0,13495.0,5,13505.0,5,S
2018-04-11 21:16:05,13505.0,2,508,2,13500.0,3,13505.0,3,B
2018-04-11 21:16:06,13505.0,2,510,2,13500.0,3,13505.0,1,B
2018-04-11 21:16:07,13500.0,2,512,-2,13500.0,2,13510.0,17,S
2018-04-11 21:16:18,13505.0,2,514,2,13500.0,2,13505.0,4,B
2018-04-11 21:17:16,13505.0,6,520,6,13500.0,4,13505.0,2,B
2018-04-11 21:17:27,13500.0,2,522,2,13500.0,2,13505.0,2,S
2018-04-11 21:17:29,13505.0,2,524,2,13500.0,1,13505.0,3,B
2018-04-11 21:17:30,13505.0,6,530,2,13505.0,8,13510.0,14,B
2018-04-11 21:17:35,13510.0,2,532,2,13505.0,8,13510.0,15,B
2018-04-11 21:17:38,13510.0,10,542,10,13505.0,9,13510.0,10,B
2018-04-11 21:17:42,13510.0,10,552,4,13505.0,9,13510.0,5,B
2018-04-11 21:17:56,13510.0,2,554,-2,13505.0,12,13510.0,4,B
2018-04-11 21:17:56,13510.0,8,562,0,13510.0,2,13515.0,6,B
2018-04-11 21:17:57,13510.0,2,564,2,13510.0,1,13515.0,6,B
2018-04-11 21:18:02,13510.0,2,566,2,13505.0,4,13510.0,7,B
2018-04-11 21:18:02,13510.0,14,580,14,13510.0,1,13515.0,9,B
2018-04-11 21:18:03,13510.0,2,582,0,13505.0,4,13510.0,2,B
2018-04-11 21:18:10,13505.0,2,584,0,13505.0,3,13510.0,9,S
2018-04-11 21:18:20,13510.0,4,588,0,13505.0,3,13510.0,10,B
2018-04-11 21:18:21,13505.0,2,590,-2,13505.0,2,13510.0,11,S
2018-04-11 21:18:25,13505.0,4,594,-4,13500.0,1,13510.0,11,S
2018-04-11 21:18:29,13510.0,20,614,6,13500.0,1,13510.0,1,B
2018-04-11 21:18:34,13510.0,2,616,0,13500.0,1,13510.0,6,B
2018-04-11 21:18:43,13510.0,4,620,0,13510.0,8,13515.0,14,B
2018-04-11 21:18:44,13515.0,4,624,0,13510.0,7,13515.0,15,B
2018-04-11 21:18:45,13515.0,4,628,2,13510.0,6,13515.0,14,B
2018-04-11 21:18:45,13515.0,4,632,4,13510.0,6,13515.0,10,B
2018-04-11 21:18:46,13515.0,10,642,2,13510.0,3,13515.0,12,B
2018-04-11 21:18:46,13515.0,4,646,4,13510.0,3,13515.0,12,B
2018-04-11 21:18:47,13515.0,2,648,2,13510.0,3,13515.0,11,B
2018-04-11 21:18:47,13515.0,6,654,6,13510.0,3,13515.0,8,B
2018-04-11 21:18:48,13510.0,8,662,8,13500.0,6,13510.0,17,S
2018-04-11 21:18:49,13510.0,6,668,6,13505.0,2,13510.0,14,S
2018-04-11 21:18:50,13510.0,2,670,2,13505.0,2,13510.0,13,S
2018-04-11 21:18:50,13510.0,10,680,10,13505.0,2,13510.0,8,S
2018-04-11 21:18:51,13510.0,8,688,8,13505.0,2,13510.0,4,S
2018-04-11 21:18:52,13510.0,8,696,8,13510.0,8,13515.0,10,S
2018-04-11 21:18:58,13510.0,10,706,4,13510.0,8,13515.0,6,S
2018-04-11 21:18:59,13515.0,4,710,0,13510.0,8,13515.0,4,B
2018-04-11 21:19:00,13515.0,4,714,0,13510.0,8,13515.0,2,B
2018-04-11 21:19:00,13515.0,4,718,2,13515.0,2,13520.0,11,B
2018-04-11 21:19:01,13520.0,4,722,4,13515.0,1,13520.0,10,B
2018-04-11 21:19:01,13515.0,2,724,2,13510.0,7,13515.0,1,S
2018-04-11 21:19:04,13515.0,4,728,2,13515.0,5,13520.0,8,S
2018-04-11 21:19:05,13515.0,2,730,2,13515.0,4,13520.0,8,S
2018-04-11 21:19:08,13515.0,4,734,0,13515.0,2,13520.0,8,S
2018-04-11 21:19:08,13515.0,2,736,0,13515.0,1,13520.0,8,S
2018-04-11 21:19:11,13515.0,2,738,0,13510.0,8,13515.0,4,S
2018-04-11 21:19:12,13515.0,8,746,0,13510.0,8,13520.0,8,S
2018-04-11 21:19:27,13515.0,10,756,-2,13515.0,4,13520.0,12,S
2018-04-11 21:19:30,13520.0,12,768,12,13515.0,4,13520.0,5,B
2018-04-11 21:19:32,13520.0,10,778,6,13520.0,12,13525.0,4,B
2018-04-11 21:19:33,13525.0,6,784,0,13520.0,12,13525.0,1,B
2018-04-11 21:19:34,13525.0,2,786,-2,13520.0,12,13530.0,3,B
2018-04-11 21:19:37,13525.0,2,788,0,13520.0,12,13525.0,1,B
2018-04-11 21:19:41,13520.0,2,790,0,13520.0,11,13525.0,1,S
2018-04-11 21:20:01,13525.0,6,796,0,13525.0,1,13530.0,6,B
2018-04-11 21:20:06,13525.0,2,798,0,13520.0,12,13530.0,2,B
2018-04-11 21:20:14,13520.0,20,818,20,13520.0,5,13530.0,4,S
2018-04-11 21:20:18,13530.0,6,824,-6,13520.0,5,13530.0,1,B
2018-04-11 21:20:25,13520.0,12,836,6,13515.0,14,13520.0,4,S
2018-04-11 21:20:25,13520.0,8,844,6,13520.0,9,13525.0,1,S
2018-04-11 21:20:32,13525.0,2,846,0,13520.0,5,13525.0,1,B
2018-04-11 21:20:34,13525.0,2,848,0,13525.0,9,13530.0,4,B
2018-04-11 21:21:11,13525.0,18,866,12,13520.0,1,13525.0,4,B
2018-04-11 21:21:12,13520.0,2,868,-2,13515.0,2,13520.0,2,S
2018-04-11 21:21:15,13520.0,4,872,-4,13515.0,4,13525.0,9,S
2018-04-11 21:21:17,13520.0,2,874,0,13515.0,4,13525.0,6,S
2018-04-11 21:21:27,13520.0,12,886,2,13520.0,4,13525.0,5,S
2018-04-11 21:21:28,13520.0,2,888,0,13520.0,3,13525.0,8,S
2018-04-11 21:21:34,13520.0,2,890,2,13520.0,2,13525.0,7,S
2018-04-11 21:21:36,13520.0,2,892,0,13520.0,1,13525.0,7,S
2018-04-11 21:21:38,13520.0,2,894,0,13515.0,4,13520.0,4,S
2018-04-11 21:21:50,13520.0,8,902,0,13520.0,6,13525.0,4,S
2018-04-11 21:22:06,13520.0,8,910,0,13520.0,2,13525.0,3,S
2018-04-11 21:22:16,13520.0,4,914,0,13515.0,10,13520.0,13,S
2018-04-11 21:22:21,13515.0,8,922,-4,13515.0,6,13520.0,14,S
2018-04-11 21:22:22,13515.0,2,924,-2,13515.0,5,13520.0,14,S
2018-04-11 21:22:35,13520.0,14,938,0,13515.0,4,13520.0,7,B
2018-04-11 21:22:36,13515.0,4,942,0,13515.0,2,13520.0,7,S
2018-04-11 21:22:40,13520.0,14,956,2,13520.0,3,13525.0,5,B
2018-04-11 21:22:40,13520.0,4,960,4,13520.0,1,13525.0,7,B
2018-04-11 21:22:50,13520.0,2,962,2,13515.0,2,13525.0,4,B
2018-04-11 21:22:59,13525.0,8,970,8,13525.0,6,13530.0,11,B
2018-04-11 21:22:59,13525.0,10,980,8,13525.0,1,13530.0,15,B
2018-04-11 21:23:00,13525.0,2,982,0,13515.0,4,13530.0,13,B
2018-04-11 21:23:09,13515.0,6,988,2,13510.0,3,13525.0,2,S
2018-04-11 21:23:27,13520.0,2,990,0,13520.0,9,13525.0,3,B
2018-04-11 21:23:29,13520.0,2,992,2,13520.0,9,13525.0,3,B
2018-04-11 21:23:44,13520.0,16,1008,14,13515.0,1,13520.0,2,B
2018-04-11 21:23:58,13520.0,4,1012,0,13510.0,1,13525.0,16,B
2018-04-11 21:23:59,13515.0,4,1016,0,13510.0,1,13515.0,1,S
2018-04-11 21:24:05,13515.0,2,1018,0,13510.0,3,13520.0,1,S
2018-04-11 21:24:06,13520.0,2,1020,0,13510.0,2,13525.0,27,B
2018-04-11 21:24:08,13525.0,8,1028,6,13510.0,2,13520.0,2,B
2018-04-11 21:24:10,13510.0,2,1030,-2,13510.0,1,13520.0,3,S
2018-04-11 21:24:17,13520.0,6,1036,2,13520.0,2,13525.0,31,B
2018-04-11 21:24:18,13520.0,4,1040,4,13515.0,1,13525.0,31,B
2018-04-11 21:24:31,13520.0,4,1044,2,13520.0,3,13525.0,30,B
2018-04-11 21:24:39,13520.0,6,1050,6,13515.0,1,13520.0,5,B
2018-04-11 21:24:48,13515.0,10,1060,0,13515.0,4,13520.0,8,S
2018-04-11 21:24:49,13515.0,2,1062,0,13515.0,3,13520.0,21,S
2018-04-11 21:24:54,13520.0,10,1072,10,13515.0,3,13520.0,3,B
2018-04-11 21:24:56,13520.0,6,1078,-4,13515.0,3,13525.0,15,B
2018-04-11 21:24:57,13525.0,6,1084,6,13510.0,3,13525.0,10,B
2018-04-11 21:25:08,13520.0,2,1086,0,13520.0,2,13525.0,7,S
2018-04-11 21:25:08,13520.0,2,1088,0,13520.0,1,13525.0,7,S
2018-04-11 21:25:15,13520.0,2,1090,-2,13515.0,3,13520.0,2,S
2018-04-11 21:25:18,13520.0,4,1094,-4,13515.0,4,13525.0,7,S
2018-04-11 21:25:27,13515.0,2,1096,2,13515.0,2,13520.0,1,S
2018-04-11 21:25:29,13520.0,2,1098,2,13520.0,6,13525.0,8,B
2018-04-11 21:25:29,13520.0,2,1100,0,13520.0,5,13525.0,10,B
2018-04-11 21:25:44,13520.0,2,1102,2,13520.0,4,13525.0,7,B
2018-04-11 21:25:48,13520.0,4,1106,0,13520.0,2,13525.0,7,B
2018-04-11 21:25:55,13520.0,2,1108,0,13520.0,1,13525.0,7,B
2018-04-11 21:25:57,13520.0,2,1110,0,13515.0,3,13520.0,1,B
2018-04-11 21:26:10,13520.0,8,1118,2,13515.0,3,13525.0,7,B
2018-04-11 21:26:21,13525.0,2,1120,0,13515.0,6,13525.0,6,B
2018-04-11 21:26:22,13515.0,4,1124,0,13515.0,4,13525.0,7,S
2018-04-11 21:26:44,13520.0,6,1130,2,13520.0,1,13525.0,6,B
2018-04-11 21:27:17,13525.0,12,1142,6,13525.0,3,13530.0,7,B
2018-04-11 21:27:27,13525.0,6,1148,0,13520.0,6,13525.0,2,B
2018-04-11 21:27:27,13525.0,2,1150,-2,13520.0,6,13525.0,1,B
2018-04-11 21:27:28,13525.0,2,1152,-2,13525.0,1,13530.0,8,B
2018-04-11 21:27:31,13530.0,16,1168,12,13530.0,2,13535.0,7,B
2018-04-11 21:27:31,13535.0,12,1180,8,13520.0,6,13535.0,9,B
2018-04-11 21:27:34,13525.0,2,1182,0,13525.0,1,13530.0,1,S
2018-04-11 21:27:44,13530.0,6,1188,0,13530.0,7,13535.0,8,B
2018-04-11 21:27:49,13530.0,10,1198,0,13530.0,2,13535.0,6,B
2018-04-11 21:27:52,13530.0,2,1200,2,13530.0,1,13535.0,7,B
2018-04-11 21:27:53,13530.0,2,1202,0,13525.0,2,13535.0,7,B
2018-04-11 21:27:56,13530.0,2,1204,2,13520.0,9,13530.0,2,B
2018-04-11 21:28:02,13530.0,4,1208,2,13530.0,8,13535.0,9,B
2018-04-11 21:28:08,13530.0,10,1218,0,13530.0,3,13535.0,9,B
2018-04-11 21:28:10,13530.0,2,1220,2,13530.0,2,13535.0,9,B
2018-04-11 21:28:12,13530.0,4,1224,4,13525.0,12,13530.0,18,B
2018-04-11 21:28:23,13525.0,8,1232,0,13525.0,8,13530.0,18,S
2018-04-11 21:28:24,13530.0,36,1268,36,13530.0,6,13535.0,9,B
2018-04-11 21:28:25,13535.0,2,1270,2,13530.0,6,13535.0,8,B
2018-04-11 21:28:26,13530.0,10,1280,10,13530.0,5,13535.0,4,S
2018-04-11 21:28:27,13535.0,8,1288,8,13530.0,6,13540.0,5,B
2018-04-11 21:28:30,13530.0,12,1300,2,13530.0,4,13540.0,9,S
2018-04-11 21:28:33,13535.0,2,1302,2,13535.0,3,13540.0,7,B
2018-04-11 21:28:34,13535.0,6,1308,0,13530.0,4,13540.0,6,B
2018-04-11 21:28:35,13535.0,6,1314,6,13535.0,1,13540.0,8,B
2018-04-11 21:28:45,13535.0,4,1318,0,13530.0,4,13535.0,2,B
2018-04-11 21:28:46,13535.0,4,1322,0,13535.0,3,13540.0,3,B
2018-04-11 21:28:49,13540.0,2,1324,-2,13535.0,3,13540.0,2,B
2018-04-11 21:28:59,13540.0,2,1326,-2,13535.0,3,13540.0,7,B
2018-04-11 21:29:00,13535.0,10,1336,0,13535.0,2,13540.0,3,S
2018-04-11 21:29:03,13535.0,2,1338,0,13535.0,1,13540.0,2,S
2018-04-11 21:29:07,13540.0,4,1342,-4,13535.0,1,13545.0,5,B
2018-04-11 21:29:09,13535.0,2,1344,0,13535.0,5,13545.0,9,S
2018-04-11 21:29:10,13535.0,2,1346,0,13535.0,4,13545.0,9,S
2018-04-11 21:29:17,13545.0,6,1352,4,13535.0,4,13545.0,6,B
2018-04-11 21:29:26,13545.0,14,1366,14,13545.0,3,13550.0,20,B
2018-04-11 21:29:26,13545.0,6,1372,4,13540.0,1,13545.0,1,B
2018-04-11 21:29:29,13545.0,4,1376,2,13545.0,2,13550.0,42,B
2018-04-11 21:29:30,13545.0,4,1380,2,13540.0,1,13550.0,42,B
2018-04-11 21:29:35,13540.0,2,1382,0,13535.0,7,13545.0,1,S
2018-04-11 21:29:38,13540.0,2,1384,-2,13540.0,1,13545.0,2,S
2018-04-11 21:29:44,13545.0,6,1390,4,13545.0,2,13550.0,46,B
2018-04-11 21:29:44,13545.0,4,1394,2,13540.0,2,13550.0,42,B
2018-04-11 21:29:49,13550.0,2,1396,2,13540.0,3,13545.0,1,B
2018-04-11 21:29:51,13545.0,2,1398,2,13545.0,5,13550.0,44,S
2018-04-11 21:29:52,13545.0,4,1402,0,13545.0,3,13550.0,40,S
2018-04-11 21:29:52,13545.0,2,1404,0,13545.0,2,13550.0,40,S
2018-04-11 21:29:55,13545.0,4,1408,4,13540.0,3,13550.0,40,S
2018-04-11 21:30:03,13540.0,2,1410,2,13535.0,6,13545.0,19,S
2018-04-11 21:30:14,13535.0,4,1414,0,13535.0,4,13540.0,6,S
2018-04-11 21:30:16,13540.0,4,1418,0,13535.0,4,13540.0,4,B
2018-04-11 21:30:16,13540.0,8,1426,2,13540.0,6,13545.0,21,B
2018-04-11 21:30:17,13540.0,2,1428,2,13540.0,5,13545.0,17,B
2018-04-11 21:30:18,13540.0,2,1430,2,13540.0,4,13545.0,17,B
2018-04-11 21:30:25,13540.0,2,1432,2,13540.0,23,13545.0,7,B
2018-04-11 21:30:27,13540.0,14,1446,6,13540.0,16,13545.0,8,B
2018-04-11 21:30:27,13540.0,36,1482,0,13535.0,4,13540.0,14,B
2018-04-11 21:30:29,13535.0,2,1484,0,13535.0,3,13540.0,9,S
2018-04-11 21:30:35,13535.0,2,1486,0,13535.0,2,13540.0,20,S
2018-04-11 21:30:37,13535.0,4,1490,2,13530.0,4,13535.0,8,S
2018-04-11 21:30:38,13535.0,4,1494,4,13530.0,6,13535.0,6,S
2018-04-11 21:30:40,13530.0,2,1496,2,13530.0,5,13535.0,6,S
2018-04-11 21:30:43,13530.0,2,1498,2,13530.0,5,13535.0,6,S
2018-04-11 21:30:47,13530.0,2,1500,-2,13530.0,2,13535.0,6,S
2018-04-11 21:30:48,13535.0,12,1512,12,13535.0,4,13540.0,16,B
2018-04-11 21:30:49,13535.0,2,1514,2,13535.0,3,13540.0,17,B
2018-04-11 21:31:03,13535.0,4,1518,0,13535.0,1,13540.0,18,B
2018-04-11 21:31:19,13535.0,2,1520,2,13530.0,2,13535.0,14,B
2018-04-11 21:31:21,13535.0,2,1522,0,13530.0,19,13535.0,13,B
2018-04-11 21:31:22,13540.0,64,1586,62,13540.0,1,13545.0,9,B
2018-04-11 21:31:26,13540.0,2,1588,2,13535.0,4,13540.0,9,B
2018-04-11 21:31:44,13540.0,16,1604,16,13540.0,2,13545.0,6,B
2018-04-11 21:31:44,13540.0,4,1608,0,13535.0,1,13540.0,2,B
2018-04-11 21:31:51,13535.0,2,1610,-2,13535.0,2,13540.0,2,S
2018-04-11 21:31:55,13540.0,4,1614,0,13535.0,2,13545.0,7,B
2018-04-11 21:31:58,13540.0,2,1616,2,13540.0,3,13545.0,6,B
2018-04-11 21:32:02,13545.0,14,1630,12,13545.0,3,13550.0,61,B
2018-04-11 21:32:07,13545.0,2,1632,2,13545.0,2,13550.0,65,B
2018-04-11 21:32:11,13545.0,2,1634,2,13545.0,1,13550.0,65,B
2018-04-11 21:32:22,13550.0,6,1640,4,13545.0,4,13550.0,56,B
2018-04-11 21:32:22,13550.0,2,1642,0,13545.0,4,13550.0,55,B
2018-04-11 21:32:23,13550.0,2,1644,-2,13545.0,4,13550.0,54,B
2018-04-11 21:32:24,13550.0,2,1646,0,13545.0,4,13550.0,53,B
2018-04-11 21:32:24,13545.0,2,1648,2,13545.0,2,13550.0,53,S
2018-04-11 21:32:26,13550.0,2,1650,0,13545.0,2,13550.0,52,B
2018-04-11 21:32:27,13545.0,4,1654,-4,13545.0,1,13550.0,52,S
2018-04-11 21:32:29,13550.0,48,1702,46,13545.0,1,13550.0,28,B
2018-04-11 21:32:41,13550.0,4,1706,4,13545.0,2,13550.0,42,B
2018-04-11 21:32:41,13545.0,2,1708,2,13545.0,2,13550.0,42,S
2018-04-11 21:32:48,13550.0,6,1714,4,13540.0,5,13550.0,41,B
2018-04-11 21:32:50,13550.0,34,1748,34,13545.0,2,13550.0,24,B
2018-04-11 21:32:55,13550.0,4,1752,4,13545.0,3,13550.0,32,B
2018-04-11 21:32:58,13550.0,16,1768,14,13545.0,2,13550.0,24,B
2018-04-11 21:32:59,13550.0,24,1792,24,13545.0,5,13550.0,12,B
2018-04-11 21:32:59,13550.0,6,1798,4,13545.0,5,13550.0,9,B
2018-04-11 21:33:00,13545.0,2,1800,0,13545.0,1,13550.0,9,S
2018-04-11 21:33:01,13550.0,16,1816,-16,13545.0,3,13550.0,1,B
2018-04-11 21:33:01,13550.0,2,1818,0,13550.0,1,13555.0,29,B
2018-04-11 21:33:03,13555.0,6,1824,-4,13550.0,5,13555.0,23,B
2018-04-11 21:33:05,13550.0,22,1846,18,13550.0,4,13555.0,13,S
2018-04-11 21:33:05,13555.0,26,1872,16,13555.0,6,13560.0,24,B
2018-04-11 21:33:06,13555.0,2,1874,0,13555.0,2,13560.0,24,B
2018-04-11 21:33:09,13550.0,6,1880,-4,13550.0,1,13560.0,24,S
2018-04-11 21:33:09,13560.0,2,1882,2,13550.0,5,13555.0,2,B
2018-04-11 21:33:10,13560.0,6,1888,2,13550.0,5,13560.0,22,B
2018-04-11 21:33:10,13560.0,2,1890,0,13550.0,5,13560.0,21,B
2018-04-11 21:33:14,13555.0,2,1892,2,13550.0,5,13560.0,21,S
2018-04-11 21:33:17,13560.0,40,1932,40,13550.0,7,13560.0,1,B
2018-04-11 21:33:22,13560.0,2,1934,2,13555.0,2,13560.0,10,B
2018-04-11 21:33:24,13555.0,2,1936,0,13555.0,1,13560.0,10,S
2018-04-11 21:33:38,13555.0,2,1938,0,13555.0,11,13560.0,12,S
2018-04-11 21:33:42,13555.0,12,1950,2,13555.0,14,13560.0,7,S
2018-04-11 21:33:43,13560.0,6,1956,2,13555.0,25,13560.0,4,B
2018-04-11 21:33:43,13560.0,8,1964,4,13555.0,11,13565.0,9,B
2018-04-11 21:33:49,13560.0,2,1966,-2,13555.0,10,13560.0,3,B
2018-04-11 21:33:56,13560.0,2,1968,0,13555.0,11,13565.0,9,B
2018-04-11 21:34:05,13565.0,2,1970,-2,13555.0,16,13565.0,9,B
2018-04-11 21:34:09,13560.0,2,1972,0,13555.0,10,13560.0,4,S
2018-04-11 21:34:13,13560.0,2,1974,2,13555.0,11,13560.0,2,S
2018-04-11 21:34:16,13560.0,10,1984,6,13560.0,5,13565.0,10,S
2018-04-11 21:34:16,13560.0,2,1986,0,13560.0,4,13565.0,10,S
2018-04-11 21:34:18,13560.0,2,1988,2,13560.0,3,13565.0,9,S
2018-04-11 21:34:19,13560.0,2,1990,0,13560.0,2,13565.0,10,S
2018-04-11 21:34:21,13560.0,4,1994,0,13555.0,11,13565.0,10,S
2018-04-11 21:34:41,13560.0,8,2002,2,13560.0,6,13565.0,9,S
2018-04-11 21:34:42,13560.0,12,2014,0,13555.0,10,13560.0,2,S
2018-04-11 21:34:48,13555.0,20,2034,20,13555.0,1,13560.0,2,S
2018-04-11 21:35:00,13555.0,2,2036,2,13550.0,9,13560.0,4,S
2018-04-11 21:35:01,13560.0,8,2044,8,13560.0,6,13565.0,13,B
2018-04-11 21:35:01,13560.0,12,2056,0,13555.0,2,13565.0,12,B
2018-04-11 21:35:14,13555.0,6,2062,2,13550.0,10,13555.0,7,S
2018-04-11 21:35:23,13555.0,14,2076,14,13555.0,3,13560.0,2,S
2018-04-11 21:35:25,13555.0,2,2078,2,13555.0,2,13560.0,2,S
2018-04-11 21:35:25,13555.0,4,2082,2,13550.0,9,13555.0,4,S
2018-04-11 21:35:38,13560.0,8,2090,6,13560.0,6,13565.0,12,B
2018-04-11 21:35:38,13560.0,2,2092,2,13560.0,5,13565.0,12,B
2018-04-11 21:35:42,13560.0,2,2094,0,13560.0,4,13565.0,12,B
2018-04-11 21:36:04,13560.0,2,2096,2,13560.0,3,13565.0,17,B
2018-04-11 21:36:08,13560.0,4,2100,4,13560.0,1,13565.0,17,B
2018-04-11 21:36:09,13560.0,2,2102,2,13555.0,3,13565.0,12,B
2018-04-11 21:36:12,13560.0,10,2112,10,13560.0,5,13565.0,12,B
2018-04-11 21:36:17,13560.0,2,2114,2,13560.0,4,13565.0,12,B
2018-04-11 21:36:48,13560.0,2,2116,2,13560.0,3,13565.0,11,B
2018-04-11 21:36:52,13565.0,22,2138,16,13560.0,3,13570.0,14,B
2018-04-11 21:36:53,13565.0,2,2140,0,13565.0,1,13570.0,19,B
2018-04-11 21:36:53,13570.0,6,2146,-4,13560.0,4,13570.0,14,B
2018-04-11 21:36:54,13570.0,2,2148,-2,13560.0,4,13570.0,18,B
2018-04-11 21:36:59,13570.0,2,2150,2,13565.0,2,13570.0,11,B
2018-04-11 21:37:06,13570.0,22,2172,22,13565.0,2,13570.0,1,B
2018-04-11 21:37:11,13565.0,4,2176,0,13560.0,4,13565.0,3,S
2018-04-11 21:37:11,13565.0,2,2178,-2,13560.0,4,13565.0,2,S
2018-04-11 21:37:12,13565.0,2,2180,-2,13560.0,4,13565.0,1,S
2018-04-11 21:37:20,13565.0,4,2184,2,13560.0,8,13570.0,4,S
2018-04-11 21:37:36,13565.0,12,2196,12,13565.0,1,13570.0,6,S
2018-04-11 21:37:36,13570.0,4,2200,2,13565.0,8,13570.0,4,B
2018-04-11 21:37:54,13570.0,6,2206,-2,13570.0,12,13575.0,18,B
2018-04-11 21:37:55,13570.0,8,2214,-8,13570.0,8,13575.0,18,B
2018-04-11 21:38:00,13570.0,2,2216,-2,13570.0,7,13575.0,17,B
2018-04-11 21:38:01,13570.0,2,2218,-2,13570.0,6,13575.0,17,B
2018-04-11 21:38:21,13570.0,12,2230,-4,13565.0,6,13575.0,18,B
2018-04-11 21:38:35,13565.0,2,2232,0,13565.0,1,13570.0,8,S
2018-04-11 21:38:36,13565.0,2,2234,-2,13560.0,14,13565.0,3,S
2018-04-11 21:39:03,13565.0,2,2236,-2,13560.0,18,13565.0,5,S
2018-04-11 21:39:36,13560.0,2,2238,0,13560.0,8,13565.0,6,S
2018-04-11 21:39:49,13565.0,16,2254,8,13565.0,2,13570.0,33,B
2018-04-11 21:39:50,13565.0,4,2258,4,13560.0,5,13570.0,33,B
2018-04-11 21:39:50,13560.0,14,2272,10,13555.0,13,13560.0,3,S
2018-04-11 21:39:51,13560.0,4,2276,4,13555.0,16,13560.0,1,S
2018-04-11 21:39:52,13560.0,2,2278,2,13555.0,18,13565.0,2,S
2018-04-11 21:39:56,13560.0,6,2284,0,13560.0,2,13565.0,2,S
2018-04-11 21:40:05,13565.0,6,2290,4,13565.0,7,13570.0,34,B
2018-04-11 21:40:08,13565.0,4,2294,0,13565.0,5,13570.0,35,B
2018-04-11 21:40:11,13565.0,10,2304,0,13560.0,7,13570.0,35,B
2018-04-11 21:40:15,13565.0,6,2310,6,13565.0,7,13570.0,35,B
2018-04-11 21:40:19,13565.0,14,2324,14,13560.0,7,13565.0,3,B
2018-04-11 21:40:33,13560.0,2,2326,0,13560.0,5,13565.0,3,S
2018-04-11 21:40:38,13560.0,2,2328,0,13560.0,4,13565.0,3,S
2018-04-11 21:40:45,13560.0,2,2330,0,13560.0,3,13565.0,3,S
2018-04-11 21:40:58,13565.0,8,2338,8,13565.0,10,13570.0,36,B
2018-04-11 21:40:58,13565.0,10,2348,6,13565.0,5,13570.0,38,B
2018-04-11 21:40:59,13565.0,2,2350,0,13565.0,4,13570.0,38,B
2018-04-11 21:40:59,13565.0,8,2358,4,13560.0,4,13570.0,38,B
2018-04-11 21:41:07,13560.0,2,2360,0,13560.0,2,13565.0,1,S
2018-04-11 21:41:14,13560.0,2,2362,-2,13555.0,16,13565.0,5,S
2018-04-11 21:41:19,13565.0,12,2374,4,13565.0,9,13570.0,38,B
2018-04-11 21:41:19,13565.0,8,2382,8,13565.0,5,13570.0,38,B
2018-04-11 21:41:20,13565.0,10,2392,10,13560.0,2,13565.0,5,B
2018-04-11 21:41:25,13560.0,2,2394,0,13555.0,17,13565.0,6,S
2018-04-11 21:41:45,13565.0,20,2414,12,13555.0,17,13565.0,14,B
2018-04-11 21:42:00,13560.0,2,2416,0,13560.0,6,13565.0,15,S
2018-04-11 21:42:08,13560.0,4,2420,4,13560.0,4,13565.0,15,S
2018-04-11 21:42:14,13560.0,2,2422,2,13560.0,3,13565.0,14,S
2018-04-11 21:42:22,13560.0,6,2428,0,13555.0,12,13560.0,2,S
2018-04-11 21:42:28,13555.0,2,2430,-2,13555.0,9,13560.0,12,S
2018-04-11 21:42:29,13555.0,4,2434,0,13555.0,7,13560.0,12,S
2018-04-11 21:42:43,13555.0,2,2436,2,13555.0,6,13560.0,12,S
2018-04-11 21:43:07,13555.0,2,2438,2,13555.0,5,13560.0,12,S
2018-04-11 21:43:42,13555.0,2,2440,0,13555.0,10,13560.0,10,S
2018-04-11 21:44:28,13555.0,2,2442,2,13555.0,10,13560.0,11,S
2018-04-11 21:44:31,13555.0,2,2444,0,13555.0,9,13560.0,11,S
2018-04-11 21:44:34,13560.0,2,2446,2,13555.0,9,13560.0,10,B
2018-04-11 21:44:34,13560.0,6,2452,2,13555.0,13,13560.0,6,B
2018-04-11 21:44:35,13560.0,8,2460,0,13555.0,13,13560.0,2,B
2018-04-11 21:44:36,13560.0,4,2464,4,13555.0,13,13565.0,5,B
2018-04-11 21:44:53,13565.0,14,2478,10,13555.0,9,13570.0,36,B
2018-04-11 21:45:07,13565.0,2,2480,0,13565.0,6,13570.0,40,B
2018-04-11 21:45:11,13565.0,12,2492,12,13560.0,5,13565.0,5,B
2018-04-11 21:45:17,13560.0,2,2494,-2,13560.0,4,13565.0,4,S
2018-04-11 21:45:22,13565.0,4,2498,4,13560.0,4,13565.0,3,B
2018-04-11 21:45:59,13560.0,4,2502,-4,13560.0,2,13565.0,6,S
2018-04-11 21:46:11,13560.0,2,2504,0,13555.0,9,13565.0,6,S
2018-04-11 21:46:38,13555.0,2,2506,2,13555.0,5,13560.0,3,S
2018-04-11 21:46:42,13560.0,6,2512,0,13555.0,22,13565.0,11,B
2018-04-11 21:47:28,13555.0,2,2514,2,13555.0,5,13560.0,5,S
2018-04-11 21:47:34,13555.0,6,2520,-6,13550.0,10,13555.0,8,S
2018-04-11 21:47:49,13565.0,38,2558,32,13565.0,13,13570.0,37,B
2018-04-11 21:47:50,13565.0,52,2610,38,13555.0,2,13565.0,20,B
2018-04-11 21:47:52,13555.0,2,2612,0,13550.0,8,13560.0,2,S
2018-04-11 21:48:16,13560.0,6,2618,0,13555.0,8,13560.0,6,B
2018-04-11 21:48:17,13560.0,12,2630,4,13555.0,8,13565.0,13,B
2018-04-11 21:48:59,13570.0,94,2724,80,13555.0,7,13565.0,1,B
2018-04-11 21:48:59,13570.0,2,2726,0,13565.0,1,13575.0,3,B
2018-04-11 21:49:00,13575.0,22,2748,12,13560.0,3,13575.0,4,B
2018-04-11 21:49:00,13575.0,14,2762,10,13575.0,6,13580.0,17,B
2018-04-11 21:49:01,13570.0,14,2776,8,13565.0,2,13575.0,18,S
2018-04-11 21:49:01,13565.0,4,2780,2,13565.0,1,13575.0,9,S
2018-04-11 21:49:16,13570.0,2,2782,0,13565.0,3,13575.0,7,B
2018-04-11 21:49:20,13575.0,16,2798,-2,13565.0,3,13580.0,8,B
2018-04-11 21:49:20,13570.0,2,2800,0,13565.0,3,13580.0,7,S
2018-04-11 21:49:29,13580.0,2,2802,0,13570.0,5,13580.0,6,B
2018-04-11 21:49:30,13580.0,8,2810,4,13570.0,4,13580.0,3,B
2018-04-11 21:49:31,13570.0,2,2812,0,13575.0,1,13580.0,3,S
2018-04-11 21:49:31,13575.0,2,2814,-2,13570.0,3,13575.0,4,B
2018-04-11 21:49:33,13575.0,2,2816,-2,13570.0,3,13580.0,2,B
2018-04-11 21:49:38,13580.0,6,2822,4,13570.0,3,13580.0,2,B
2018-04-11 21:49:43,13575.0,2,2824,0,13570.0,8,13580.0,2,S
2018-04-11 21:49:43,13580.0,4,2828,0,13580.0,7,13585.0,7,B
2018-04-11 21:49:44,13580.0,8,2836,-8,13580.0,3,13585.0,6,B
2018-04-11 21:49:44,13580.0,2,2838,0,13580.0,2,13585.0,6,B
2018-04-11 21:49:46,13580.0,2,2840,0,13580.0,1,13585.0,6,B
2018-04-11 21:49:46,13580.0,2,2842,-2,13575.0,2,13580.0,3,B
2018-04-11 21:49:50,13575.0,2,2844,2,13575.0,1,13580.0,4,S
2018-04-11 21:49:53,13585.0,20,2864,10,13585.0,17,13590.0,4,B
2018-04-11 21:49:54,13585.0,20,2884,20,13585.0,7,13590.0,7,B
2018-04-11 21:49:54,13585.0,12,2896,4,13585.0,1,13590.0,7,B
2018-04-11 21:49:55,13585.0,2,2898,2,13580.0,2,13590.0,6,B
2018-04-11 21:50:00,13585.0,2,2900,0,13580.0,2,13590.0,9,B
2018-04-11 21:50:03,13590.0,2,2902,0,13580.0,3,13590.0,10,B
2018-04-11 21:50:04,13580.0,2,2904,0,13580.0,2,13585.0,1,S
2018-04-11 21:50:13,13580.0,2,2906,0,13580.0,2,13585.0,2,S
2018-04-11 21:50:18,13580.0,6,2912,4,13575.0,3,13580.0,2,S
2018-04-11 21:50:19,13580.0,2,2914,0,13575.0,5,13580.0,1,S
2018-04-11 21:50:19,13580.0,2,2916,2,13580.0,2,13585.0,17,S
2018-04-11 21:50:29,13580.0,8,2924,0,13575.0,3,13580.0,10,S
2018-04-11 21:50:34,13575.0,2,2926,2,13575.0,2,13580.0,11,S
2018-04-11 21:50:36,13575.0,2,2928,2,13575.0,2,13580.0,11,S
2018-04-11 21:50:45,13580.0,12,2940,0,13575.0,1,13580.0,7,B
2018-04-11 21:50:49,13575.0,2,2942,2,13575.0,2,13580.0,7,S
2018-04-11 21:50:51,13575.0,2,2944,2,13575.0,1,13580.0,7,S
2018-04-11 21:50:58,13575.0,2,2946,-2,13570.0,6,13580.0,18,S
2018-04-11 21:51:07,13570.0,4,2950,2,13570.0,6,13580.0,18,S
2018-04-11 21:51:09,13575.0,2,2952,0,13570.0,5,13580.0,18,B
2018-04-11 21:51:19,13575.0,2,2954,0,13570.0,7,13580.0,19,B
2018-04-11 21:51:47,13575.0,10,2964,0,13570.0,9,13575.0,5,B
2018-04-11 21:52:06,13575.0,4,2968,0,13570.0,9,13575.0,3,B
2018-04-11 21:52:16,13575.0,6,2974,-6,13575.0,3,13580.0,20,B
2018-04-11 21:52:27,13575.0,2,2976,0,13575.0,5,13580.0,17,B
2018-04-11 21:52:30,13575.0,2,2978,0,13575.0,4,13580.0,17,B
2018-04-11 21:52:33,13580.0,8,2986,6,13575.0,4,13580.0,13,B
2018-04-11 21:52:52,13575.0,2,2988,0,13575.0,3,13580.0,13,S
2018-04-11 21:53:09,13575.0,2,2990,2,13575.0,2,13580.0,16,S
2018-04-11 21:53:10,13575.0,4,2994,2,13570.0,6,13580.0,16,S
2018-04-11 21:53:41,13570.0,4,2998,0,13570.0,3,13575.0,6,S
2018-04-11 21:53:50,13575.0,6,3004,0,13570.0,5,13575.0,4,B
2018-04-11 21:54:16,13575.0,2,3006,-2,13570.0,2,13575.0,13,B
2018-04-11 21:54:21,13570.0,2,3008,0,13570.0,1,13575.0,13,S
2018-04-11 21:54:28,13570.0,2,3010,-2,13565.0,23,13575.0,14,S
2018-04-11 21:54:35,13565.0,8,3018,-6,13565.0,19,13570.0,1,S
2018-04-11 21:54:54,13570.0,2,3020,-2,13565.0,7,13570.0,2,B
2018-04-11 21:54:58,13565.0,2,3022,0,13565.0,6,13570.0,3,S
2018-04-11 21:56:08,13565.0,2,3024,0,13565.0,2,13570.0,4,S
2018-04-11 21:56:11,13565.0,2,3026,0,13565.0,1,13570.0,4,S
2018-04-11 21:56:27,13565.0,2,3028,-2,13560.0,7,13570.0,5,S
2018-04-11 21:56:49,13560.0,2,3030,2,13560.0,9,13570.0,7,S
2018-04-11 21:56:50,13560.0,14,3044,-2,13560.0,2,13570.0,7,S
2018-04-11 21:57:07,13560.0,2,3046,-2,13560.0,2,13565.0,1,S
2018-04-11 21:57:30,13560.0,2,3048,0,13560.0,3,13565.0,4,S
2018-04-11 21:57:57,13560.0,4,3052,-2,13555.0,12,13560.0,3,S
2018-04-11 21:57:57,13560.0,2,3054,-2,13555.0,11,13560.0,4,S
2018-04-11 21:58:00,13560.0,2,3056,0,13555.0,11,13560.0,1,S
2018-04-11 21:58:00,13560.0,2,3058,0,13560.0,2,13565.0,7,S
2018-04-11 21:58:21,13560.0,2,3060,2,13555.0,14,13565.0,6,S
2018-04-11 21:58:47,13560.0,2,3062,2,13555.0,12,13565.0,10,S
2018-04-11 21:59:04,13560.0,2,3064,2,13560.0,1,13565.0,10,S
2018-04-11 21:59:07,13560.0,2,3066,0,13555.0,11,13560.0,4,S
2018-04-11 21:59:53,13560.0,2,3068,-2,13555.0,13,13560.0,5,S
2018-04-11 22:00:35,13560.0,8,3076,-4,13555.0,13,13560.0,1,S
2018-04-11 22:00:35,13560.0,2,3078,0,13560.0,8,13565.0,6,S
2018-04-11 22:00:36,13565.0,6,3084,4,13560.0,6,13565.0,2,B
2018-04-11 22:00:48,13565.0,2,3086,2,13560.0,5,13565.0,1,B
2018-04-11 22:00:51,13565.0,2,3088,0,13560.0,5,13570.0,5,B
2018-04-11 22:01:07,13565.0,4,3092,-4,13560.0,20,13565.0,2,B
2018-04-11 22:01:11,13565.0,2,3094,-2,13560.0,7,13565.0,1,B
2018-04-11 22:01:20,13565.0,2,3096,0,13560.0,8,13570.0,12,B
2018-04-11 22:01:28,13565.0,2,3098,2,13560.0,8,13570.0,12,B
2018-04-11 22:01:34,13570.0,30,3128,-22,13570.0,5,13575.0,17,B
2018-04-11 22:01:34,13565.0,12,3140,0,13560.0,7,13570.0,1,S
2018-04-11 22:02:02,13570.0,2,3142,0,13565.0,3,13575.0,5,B
2018-04-11 22:02:21,13570.0,2,3144,0,13565.0,4,13570.0,8,B
2018-04-11 22:02:47,13570.0,2,3146,0,13565.0,8,13570.0,7,B
2018-04-11 22:03:24,13570.0,2,3148,0,13565.0,12,13570.0,6,B
2018-04-11 22:03:34,13565.0,2,3150,0,13565.0,11,13570.0,6,S
2018-04-11 22:03:43,13565.0,22,3172,-12,13560.0,16,13570.0,6,S
2018-04-11 22:04:18,13565.0,2,3174,0,13565.0,2,13570.0,10,S
2018-04-11 22:04:25,13570.0,2,3176,0,13565.0,2,13570.0,9,B
2018-04-11 22:06:29,13560.0,2,3178,2,13560.0,3,13565.0,15,S
2018-04-11 22:06:48,13560.0,6,3184,2,13555.0,7,13560.0,17,S
2018-04-11 22:07:02,13555.0,14,3198,-6,13550.0,10,13555.0,5,S
2018-04-11 22:07:02,13555.0,10,3208,-10,13550.0,24,13555.0,1,S
2018-04-11 22:07:03,13560.0,10,3218,0,13555.0,7,13560.0,8,B
2018-04-11 22:07:03,13560.0,2,3220,0,13555.0,9,13560.0,6,B
2018-04-11 22:07:09,13560.0,2,3222,-2,13555.0,10,13560.0,5,B
2018-04-11 22:07:17,13560.0,4,3226,0,13555.0,9,13565.0,3,B
2018-04-11 22:07:37,13555.0,2,3228,0,13555.0,8,13565.0,3,S
2018-04-11 22:07:41,13565.0,2,3230,-2,13560.0,9,13570.0,13,B
2018-04-11 22:07:42,13565.0,2,3232,-2,13560.0,10,13570.0,10,B
2018-04-11 22:08:27,13570.0,8,3240,-8,13565.0,21,13570.0,7,B
2018-04-11 22:08:28,13570.0,12,3252,6,13565.0,6,13570.0,1,B
2018-04-11 22:08:29,13570.0,2,3254,0,13565.0,37,13575.0,6,B
2018-04-11 22:08:42,13575.0,6,3260,-2,13570.0,38,13580.0,6,B
2018-04-11 22:08:43,13575.0,2,3262,-2,13575.0,1,13580.0,4,B
2018-04-11 22:09:07,13575.0,4,3266,0,13575.0,1,13580.0,19,B
2018-04-11 22:09:08,13575.0,2,3268,2,13570.0,6,13575.0,8,B
2018-04-11 22:10:57,13570.0,6,3274,2,13565.0,4,13575.0,17,S
2018-04-11 22:11:20,13570.0,2,3276,0,13565.0,7,13575.0,17,S
2018-04-11 22:11:21,13570.0,2,3278,2,13565.0,7,13575.0,18,S
2018-04-11 22:12:15,13570.0,2,3280,0,13570.0,1,13575.0,18,S
2018-04-11 22:12:29,13570.0,2,3282,-2,13565.0,8,13570.0,14,S
2018-04-11 22:15:11,13565.0,2,3284,0,13565.0,6,13570.0,5,S
2018-04-11 22:15:21,13565.0,4,3288,-2,13560.0,4,13570.0,8,S
2018-04-11 22:15:39,13560.0,2,3290,2,13560.0,3,13565.0,1,S
2018-04-11 22:16:27,13565.0,2,3292,2,13565.0,2,13570.0,6,B
2018-04-11 22:16:38,13565.0,6,3298,-2,13560.0,50,13565.0,5,B
2018-04-11 22:16:43,13565.0,2,3300,-2,13560.0,51,13565.0,4,B
2018-04-11 22:17:40,13565.0,2,3302,0,13560.0,6,13565.0,4,B
2018-04-11 22:18:05,13560.0,6,3308,-6,13560.0,1,13565.0,4,S
2018-04-11 22:19:08,13560.0,2,3310,-2,13555.0,6,13565.0,7,S
2018-04-11 22:19:57,13565.0,2,3312,-2,13555.0,8,13565.0,9,B
2018-04-11 22:21:16,13560.0,2,3314,2,13560.0,2,13565.0,7,S
2018-04-11 22:21:40,13565.0,2,3316,0,13560.0,2,13565.0,6,B
2018-04-11 22:22:14,13565.0,6,3322,2,13565.0,3,13570.0,8,B
2018-04-11 22:23:34,13575.0,18,3340,12,13575.0,1,13580.0,11,B
2018-04-11 22:23:35,13575.0,2,3342,0,13570.0,1,13575.0,10,B
2018-04-11 22:23:52,13565.0,4,3346,-2,13565.0,2,13570.0,4,S
2018-04-11 22:24:03,13570.0,2,3348,0,13565.0,1,13570.0,2,B
2018-04-11 22:24:07,13570.0,2,3350,0,13565.0,2,13570.0,2,B
2018-04-11 22:24:10,13570.0,2,3352,0,13565.0,2,13570.0,1,B
2018-04-11 22:24:38,13570.0,2,3354,0,13565.0,2,13570.0,1,B
2018-04-11 22:25:11,13565.0,2,3356,-2,13565.0,1,13570.0,1,S
2018-04-11 22:26:28,13565.0,2,3358,2,13565.0,1,13570.0,2,S
2018-04-11 22:27:53,13560.0,2,3360,2,13555.0,6,13565.0,4,S
2018-04-11 22:28:18,13560.0,2,3362,2,13560.0,1,13565.0,2,S
2018-04-11 22:29:38,13570.0,4,3366,0,13565.0,19,13570.0,3,B
2018-04-11 22:29:40,13570.0,6,3372,-4,13565.0,50,13575.0,4,B
2018-04-11 22:29:43,13570.0,2,3374,0,13570.0,1,13575.0,1,B
2018-04-11 22:30:52,13565.0,2,3376,2,13560.0,50,13570.0,4,S
2018-04-11 22:30:58,13565.0,2,3378,0,13560.0,50,13570.0,6,S
2018-04-11 22:34:26,13570.0,2,3380,2,13565.0,2,13570.0,3,B
2018-04-11 22:35:12,13570.0,8,3388,2,13570.0,1,13575.0,4,B
2018-04-11 22:35:12,13570.0,2,3390,0,13565.0,3,13570.0,1,B
2018-04-11 22:35:42,13565.0,2,3392,0,13560.0,9,13565.0,1,S
2018-04-11 22:36:09,13565.0,2,3394,-2,13560.0,7,13565.0,1,S
2018-04-11 22:36:21,13560.0,2,3396,-2,13560.0,2,13565.0,5,S
2018-04-11 22:36:27,13560.0,2,3398,0,13560.0,1,13565.0,5,S
2018-04-11 22:36:27,13560.0,2,3400,2,13555.0,5,13560.0,1,S
2018-04-11 22:36:46,13555.0,8,3408,-4,13550.0,55,13555.0,1,S
2018-04-11 22:36:47,13555.0,2,3410,-2,13555.0,1,13560.0,3,S
2018-04-11 22:37:14,13560.0,2,3412,2,13560.0,1,13565.0,5,B
2018-04-11 22:37:25,13565.0,2,3414,0,13565.0,1,13570.0,3,B
2018-04-11 22:38:39,13565.0,2,3416,0,13560.0,21,13570.0,4,B
2018-04-11 22:40:10,13560.0,4,3420,0,13555.0,3,13560.0,6,S
2018-04-11 22:40:17,13560.0,2,3422,0,13555.0,2,13560.0,1,S
2018-04-11 22:42:23,13565.0,10,3432,-4,13565.0,1,13570.0,6,B
2018-04-11 22:42:23,13565.0,2,3434,-2,13560.0,1,13565.0,3,B
2018-04-11 22:43:38,13565.0,2,3436,2,13560.0,6,13570.0,6,B
2018-04-11 22:44:53,13570.0,4,3440,0,13565.0,6,13570.0,3,B
2018-04-11 22:45:02,13570.0,6,3446,4,13570.0,8,13575.0,4,B
2018-04-11 22:45:33,13570.0,2,3448,0,13570.0,30,13575.0,3,B
2018-04-11 22:45:34,13575.0,2,3450,0,13570.0,29,13575.0,2,B
2018-04-11 22:45:34,13575.0,4,3454,-2,13570.0,41,13580.0,9,B
2018-04-11 22:45:59,13575.0,2,3456,0,13575.0,1,13580.0,9,B
2018-04-11 22:46:11,13575.0,4,3460,-4,13575.0,1,13580.0,9,B
2018-04-11 22:46:11,13575.0,2,3462,-2,13570.0,5,13580.0,9,B
2018-04-11 22:46:51,13570.0,2,3464,2,13570.0,2,13575.0,4,S
2018-04-11 22:49:26,13565.0,4,3468,-4,13560.0,2,13570.0,4,S
2018-04-11 22:51:07,13565.0,2,3470,0,13565.0,1,13570.0,3,S
2018-04-11 22:51:19,13570.0,4,3474,2,13565.0,25,13575.0,6,B
2018-04-11 22:51:28,13570.0,2,3476,0,13565.0,37,13575.0,3,B
2018-04-11 22:51:59,13575.0,4,3480,4,13570.0,19,13575.0,1,B
2018-04-11 22:51:59,13575.0,2,3482,0,13575.0,1,13580.0,9,B
2018-04-11 22:52:04,13575.0,2,3484,0,13570.0,6,13580.0,9,B
2018-04-11 22:52:40,13575.0,2,3486,-2,13570.0,27,13580.0,9,B
2018-04-11 22:52:58,13580.0,10,3496,-2,13575.0,25,13580.0,2,B
2018-04-11 22:52:59,13580.0,4,3500,-2,13580.0,2,13585.0,6,B
2018-04-11 22:53:00,13580.0,2,3502,0,13575.0,25,13585.0,5,B
2018-04-11 22:53:17,13580.0,2,3504,2,13580.0,11,13585.0,4,B
2018-04-11 22:53:30,13580.0,10,3514,0,13580.0,9,13585.0,4,B
2018-04-11 22:53:34,13580.0,18,3532,0,13575.0,24,13580.0,1,B
2018-04-11 22:53:35,13580.0,2,3534,0,13575.0,24,13585.0,4,B
2018-04-11 22:53:36,13585.0,2,3536,2,13580.0,1,13585.0,3,B
2018-04-11 22:53:46,13585.0,2,3538,2,13580.0,15,13585.0,2,B
2018-04-11 22:53:47,13585.0,4,3542,0,13585.0,3,13590.0,17,B
2018-04-11 22:53:48,13585.0,2,3544,0,13585.0,2,13590.0,13,B
2018-04-11 22:53:48,13590.0,16,3560,-4,13585.0,5,13590.0,4,B
2018-04-11 22:53:49,13590.0,4,3564,-2,13585.0,26,13590.0,2,B
2018-04-11 22:53:49,13590.0,2,3566,-2,13585.0,5,13590.0,1,B
2018-04-11 22:53:53,13585.0,4,3570,-2,13585.0,8,13595.0,2,S
2018-04-11 22:53:54,13585.0,6,3576,2,13585.0,7,13595.0,4,S
2018-04-11 22:53:56,13595.0,2,3578,2,13590.0,3,13595.0,1,B
2018-04-11 22:53:57,13595.0,2,3580,2,13595.0,1,13600.0,28,B
2018-04-11 22:53:57,13600.0,6,3586,2,13595.0,28,13600.0,24,B
2018-04-11 22:53:58,13600.0,14,3600,10,13595.0,29,13600.0,17,B
2018-04-11 22:53:59,13595.0,2,3602,-2,13595.0,6,13600.0,18,S
2018-04-11 22:53:59,13600.0,14,3616,-10,13590.0,4,13600.0,17,B
2018-04-11 22:54:01,13600.0,2,3618,2,13590.0,35,13600.0,15,B
2018-04-11 22:54:09,13590.0,2,3620,0,13590.0,1,13600.0,19,S
2018-04-11 22:54:10,13590.0,2,3622,0,13590.0,6,13600.0,15,S
2018-04-11 22:54:21,13590.0,10,3632,2,13585.0,12,13590.0,3,S
2018-04-11 22:54:26,13590.0,2,3634,2,13585.0,7,13590.0,2,S
2018-04-11 22:54:30,13585.0,14,3648,0,13580.0,34,13590.0,3,S
2018-04-11 22:54:31,13580.0,10,3658,0,13575.0,1,13590.0,4,S
2018-04-11 22:55:02,13585.0,2,3660,0,13585.0,5,13590.0,6,B
2018-04-11 22:55:16,13585.0,8,3668,-8,13585.0,1,13590.0,5,B
2018-04-11 22:55:45,13590.0,4,3672,0,13580.0,15,13590.0,1,B
2018-04-11 22:55:45,13590.0,2,3674,0,13590.0,3,13595.0,6,B
2018-04-11 22:55:49,13590.0,2,3676,-2,13590.0,1,13595.0,3,B
2018-04-11 22:55:57,13595.0,2,3678,0,13590.0,1,13595.0,1,B
2018-04-11 22:56:09,13590.0,2,3680,-2,13585.0,2,13595.0,6,S
2018-04-11 22:56:18,13595.0,2,3682,-2,13585.0,19,13595.0,1,B
2018-04-11 22:56:20,13595.0,2,3684,0,13585.0,20,13600.0,20,B
2018-04-11 22:56:23,13595.0,4,3688,-4,13595.0,6,13600.0,23,B
2018-04-11 22:56:23,13595.0,4,3692,-4,13595.0,4,13600.0,23,B
2018-04-11 22:56:28,13595.0,2,3694,-2,13595.0,3,13600.0,23,B
2018-04-11 22:56:31,13595.0,6,3700,0,13590.0,2,13600.0,23,B
2018-04-11 22:56:45,13590.0,2,3702,0,13590.0,2,13595.0,1,S
2018-04-11 22:57:16,13600.0,8,3710,8,13590.0,12,13600.0,21,B
2018-04-11 22:57:17,13600.0,2,3712,0,13590.0,12,13600.0,20,B
2018-04-11 22:57:31,13590.0,2,3714,-2,13590.0,12,13600.0,20,S
2018-04-11 22:57:34,13600.0,2,3716,2,13590.0,12,13600.0,19,B
2018-04-11 22:57:38,13600.0,36,3752,-16,13600.0,22,13605.0,19,B
2018-04-11 22:57:39,13600.0,16,3768,-6,13600.0,14,13605.0,6,B
2018-04-11 22:57:39,13600.0,2,3770,0,13600.0,13,13605.0,6,B
2018-04-11 22:57:45,13600.0,2,3772,-2,13600.0,22,13605.0,6,B
2018-04-11 22:57:47,13600.0,2,3774,-2,13600.0,21,13605.0,6,B
2018-04-11 22:57:51,13600.0,2,3776,-2,13600.0,20,13605.0,7,B
2018-04-11 22:57:54,13605.0,10,3786,2,13600.0,20,13605.0,2,B
2018-04-11 22:57:57,13600.0,10,3796,0,13600.0,15,13605.0,3,S
2018-04-11 22:57:58,13600.0,2,3798,-2,13600.0,14,13605.0,3,S
2018-04-11 22:58:00,13605.0,2,3800,2,13600.0,14,13605.0,2,B
2018-04-11 22:58:01,13605.0,2,3802,0,13600.0,14,13605.0,1,B
2018-04-11 22:58:02,13605.0,2,3804,-2,13600.0,14,13610.0,13,B
2018-04-11 22:58:02,13600.0,10,3814,0,13600.0,9,13610.0,13,S
2018-04-11 22:58:16,13600.0,2,3816,-2,13600.0,8,13610.0,13,S
2018-04-11 22:58:24,13600.0,2,3818,-2,13600.0,7,13605.0,1,S
2018-04-11 22:58:30,13600.0,2,3820,0,13600.0,6,13605.0,3,S
2018-04-11 22:58:32,13600.0,2,3822,0,13600.0,5,13605.0,3,S
2018-04-11 22:58:33,13600.0,2,3824,-2,13600.0,4,13605.0,3,S
2018-04-11 22:58:37,13605.0,2,3826,0,13600.0,4,13605.0,2,B
2018-04-11 22:58:38,13600.0,4,3830,-4,13600.0,2,13605.0,2,S
2018-04-11 22:58:52,13600.0,2,3832,-2,13600.0,4,13605.0,2,S
2018-04-11 22:58:53,13600.0,2,3834,0,13600.0,3,13605.0,2,S
2018-04-11 22:58:55,13600.0,2,3836,2,13600.0,2,13605.0,2,S
2018-04-11 22:58:55,13605.0,2,3838,0,13600.0,2,13605.0,1,B
2018-04-11 22:59:07,13605.0,2,3840,2,13605.0,1,13610.0,13,B
2018-04-11 22:59:08,13605.0,2,3842,2,13600.0,2,13610.0,13,B
2018-04-11 22:59:09,13600.0,2,3844,0,13600.0,1,13610.0,13,S
2018-04-11 22:59:09,13600.0,2,3846,0,13590.0,12,13610.0,13,S
2018-04-11 22:59:15,13595.0,2,3848,-2,13595.0,1,13610.0,13,S
2018-04-11 22:59:19,13605.0,2,3850,2,13595.0,1,13610.0,13,B
2018-04-11 22:59:21,13600.0,2,3852,0,13595.0,1,13600.0,2,S
2018-04-11 22:59:22,13600.0,4,3856,-4,13595.0,1,13610.0,13,S
2018-04-11 22:59:26,13600.0,2,3858,0,13595.0,1,13610.0,13,S
2018-04-11 22:59:36,13595.0,4,3862,4,13595.0,4,13600.0,1,S
2018-04-11 22:59:40,13595.0,2,3864,-2,13595.0,3,13600.0,11,S
2018-04-11 22:59:44,13600.0,10,3874,0,13595.0,5,13600.0,7,B
2018-04-11 22:59:44,13595.0,20,3894,-4,13590.0,3,13600.0,2,S
2018-04-11 22:59:45,13600.0,4,3898,0,13600.0,1,13605.0,1,B
2018-04-11 22:59:46,13600.0,2,3900,-2,13600.0,1,13605.0,1,B
2018-04-11 22:59:52,13595.0,2,3902,-2,13590.0,4,13605.0,1,S
2018-04-11 22:59:58,13600.0,2,3904,2,13590.0,4,13600.0,1,B
2018-04-11 22:59:59,13600.0,2,3906,0,13600.0,3,13610.0,12,B
2018-04-11 22:59:59,13600.0,4,3910,0,13600.0,1,13610.0,12,B
2018-04-12 09:00:00,13560.0,28,3938,18,13555.0,3,13560.0,9,S
2018-04-12 09:00:01,13610.0,26,3964,2,13580.0,2,13610.0,8,B
2018-04-12 09:00:01,13585.0,4,3968,-2,13585.0,2,13600.0,3,S
2018-04-12 09:00:02,13590.0,12,3980,12,13585.0,28,13590.0,2,B
2018-04-12 09:00:03,13585.0,56,4036,-10,13585.0,3,13600.0,3,S
2018-04-12 09:00:04,13590.0,2,4038,0,13585.0,3,13590.0,6,B
2018-04-12 09:00:05,13590.0,6,4044,4,13585.0,3,13590.0,3,B
2018-04-12 09:00:08,13595.0,12,4056,8,13595.0,4,13600.0,4,B
2018-04-12 09:00:09,13595.0,6,4062,0,13595.0,1,13600.0,4,B
2018-04-12 09:00:10,13595.0,2,4064,0,13585.0,3,13595.0,2,B
2018-04-12 09:00:11,13585.0,2,4066,0,13580.0,2,13595.0,2,S
2018-04-12 09:00:12,13595.0,2,4068,-2,13585.0,10,13595.0,1,B
2018-04-12 09:00:32,13580.0,4,4072,2,13575.0,1,13585.0,1,S
2018-04-12 09:00:41,13580.0,2,4074,-2,13580.0,5,13585.0,1,S
2018-04-12 09:00:43,13585.0,2,4076,-2,13580.0,5,13595.0,8,B
2018-04-12 09:00:48,13585.0,2,4078,-2,13575.0,5,13590.0,4,B
2018-04-12 09:00:59,13585.0,2,4080,-2,13580.0,6,13585.0,2,B
2018-04-12 09:01:04,13585.0,4,4084,-2,13580.0,7,13585.0,1,B
2018-04-12 09:01:05,13585.0,2,4086,2,13580.0,7,13595.0,6,B
2018-04-12 09:01:08,13590.0,4,4090,2,13590.0,1,13595.0,2,B
2018-04-12 09:01:23,13590.0,2,4092,2,13590.0,2,13595.0,3,B
2018-04-12 09:01:25,13590.0,2,4094,0,13590.0,9,13595.0,3,B
2018-04-12 09:01:27,13590.0,2,4096,0,13590.0,8,13595.0,3,B
2018-04-12 09:01:28,13590.0,2,4098,0,13590.0,7,13595.0,3,B
2018-04-12 09:01:28,13590.0,2,4100,0,13590.0,6,13595.0,2,B
2018-04-12 09:01:44,13595.0,4,4104,2,13590.0,12,13605.0,10,B
2018-04-12 09:01:45,13595.0,2,4106,2,13595.0,2,13605.0,25,B
2018-04-12 09:01:46,13600.0,6,4112,-6,13590.0,6,13600.0,1,B
2018-04-12 09:02:10,13590.0,2,4114,0,13585.0,7,13595.0,4,S
2018-04-12 09:02:14,13580.0,2,4116,-2,13580.0,8,13590.0,5,S
2018-04-12 09:02:27,13580.0,2,4118,0,13580.0,1,13585.0,7,S
2018-04-12 09:02:32,13580.0,2,4120,2,13575.0,9,13585.0,7,S
2018-04-12 09:02:48,13580.0,2,4122,-2,13580.0,1,13585.0,3,S
2018-04-12 09:02:48,13580.0,2,4124,0,13575.0,3,13580.0,7,S
2018-04-12 09:02:49,13575.0,2,4126,-2,13575.0,1,13580.0,6,S
2018-04-12 09:02:50,13575.0,2,4128,-2,13570.0,5,13580.0,2,S
2018-04-12 09:03:08,13580.0,2,4130,2,13575.0,11,13585.0,3,B
2018-04-12 09:03:15,13580.0,4,4134,-2,13575.0,9,13585.0,5,B
2018-04-12 09:03:23,13580.0,2,4136,2,13575.0,3,13585.0,17,B
2018-04-12 09:03:45,13575.0,2,4138,0,13575.0,2,13580.0,5,S
2018-04-12 09:03:58,13580.0,6,4144,4,13575.0,4,13580.0,3,B
2018-04-12 09:03:58,13580.0,2,4146,0,13575.0,5,13580.0,1,B
2018-04-12 09:03:59,13580.0,2,4148,0,13575.0,5,13585.0,4,B
2018-04-12 09:04:10,13580.0,2,4150,2,13580.0,2,13585.0,4,B
2018-04-12 09:04:11,13585.0,4,4154,-2,13585.0,1,13590.0,3,B
2018-04-12 09:04:12,13590.0,2,4156,2,13585.0,4,13590.0,2,B
2018-04-12 09:04:20,13580.0,2,4158,0,13575.0,1,13580.0,13,S
2018-04-12 09:04:21,13580.0,2,4160,2,13580.0,3,13585.0,7,S
2018-04-12 09:04:30,13585.0,6,4166,4,13585.0,17,13590.0,6,B
2018-04-12 09:04:34,13585.0,2,4168,0,13585.0,16,13590.0,5,B
2018-04-12 09:04:47,13585.0,2,4170,2,13585.0,15,13590.0,5,B
2018-04-12 09:04:47,13585.0,2,4172,2,13585.0,14,13590.0,5,B
2018-04-12 09:04:50,13590.0,4,4176,-4,13585.0,14,13590.0,3,B
2018-04-12 09:04:52,13590.0,6,4182,4,13590.0,1,13595.0,1,B
2018-04-12 09:04:56,13595.0,2,4184,2,13590.0,1,13595.0,3,B
2018-04-12 09:05:05,13595.0,2,4186,2,13585.0,18,13595.0,7,B
2018-04-12 09:05:38,13590.0,2,4188,0,13585.0,15,13595.0,19,S
2018-04-12 09:05:48,13585.0,4,4192,0,13585.0,15,13590.0,1,S
2018-04-12 09:05:50,13595.0,40,4232,34,13585.0,15,13595.0,1,B
2018-04-12 09:05:51,13590.0,2,4234,-2,13585.0,15,13595.0,3,S
2018-04-12 09:05:56,13590.0,2,4236,2,13590.0,5,13595.0,3,S
2018-04-12 09:06:01,13595.0,4,4240,-2,13590.0,5,13595.0,3,B
2018-04-12 09:06:11,13590.0,2,4242,0,13590.0,7,13595.0,5,S
2018-04-12 09:06:13,13595.0,4,4246,-4,13590.0,7,13595.0,3,B
2018-04-12 09:06:14,13595.0,2,4248,0,13590.0,7,13595.0,2,B
2018-04-12 09:06:14,13595.0,2,4250,-2,13590.0,7,13595.0,1,B
2018-04-12 09:06:15,13595.0,2,4252,0,13590.0,7,13600.0,6,B
2018-04-12 09:06:22,13600.0,2,4254,-2,13590.0,7,13600.0,3,B
2018-04-12 09:06:27,13600.0,2,4256,0,13590.0,8,13600.0,3,B
2018-04-12 09:06:28,13600.0,6,4262,6,13600.0,2,13605.0,12,B
2018-04-12 09:06:29,13605.0,8,4270,0,13600.0,2,13605.0,15,B
2018-04-12 09:06:45,13600.0,6,4276,4,13595.0,3,13600.0,47,S
2018-04-12 09:06:50,13595.0,16,4292,4,13590.0,7,13595.0,39,S
2018-04-12 09:06:51,13595.0,14,4306,4,13590.0,9,13595.0,32,S
2018-04-12 09:06:51,13595.0,12,4318,12,13590.0,6,13595.0,26,S
2018-04-12 09:06:52,13595.0,20,4338,20,13590.0,6,13595.0,16,S
2018-04-12 09:06:59,13590.0,2,4340,0,13590.0,5,13595.0,16,S
2018-04-12 09:07:02,13590.0,2,4342,2,13590.0,2,13595.0,16,S
2018-04-12 09:07:03,13590.0,2,4344,2,13590.0,2,13595.0,16,S
2018-04-12 09:07:04,13590.0,4,4348,4,13585.0,16,13590.0,14,S
2018-04-12 09:07:12,13590.0,2,4350,2,13585.0,15,13590.0,13,S
2018-04-12 09:07:24,13590.0,6,4356,0,13585.0,15,13590.0,10,S
2018-04-12 09:07:46,13590.0,4,4360,4,13585.0,17,13590.0,8,S
2018-04-12 09:07:48,13590.0,4,4364,4,13585.0,20,13590.0,6,S
2018-04-12 09:08:02,13590.0,2,4366,2,13585.0,15,13590.0,5,S
2018-04-12 09:08:10,13585.0,2,4368,2,13585.0,14,13590.0,6,S
2018-04-12 09:08:11,13585.0,2,4370,2,13585.0,13,13590.0,6,S
2018-04-12 09:08:23,13585.0,4,4374,0,13585.0,11,13590.0,11,S
2018-04-12 09:08:37,13585.0,10,4384,8,13585.0,6,13590.0,11,S
2018-04-12 09:08:38,13585.0,12,4396,10,13580.0,4,13590.0,11,S
2018-04-12 09:09:06,13580.0,4,4400,-4,13575.0,3,13580.0,1,S
2018-04-12 09:09:11,13580.0,2,4402,-2,13575.0,1,13580.0,2,S
2018-04-12 09:09:18,13575.0,8,4410,0,13575.0,1,13580.0,2,S
2018-04-12 09:09:18,13575.0,2,4412,0,13575.0,1,13580.0,2,S
2018-04-12 09:09:32,13575.0,4,4416,2,13570.0,5,13575.0,8,S
2018-04-12 09:09:32,13575.0,2,4418,2,13570.0,5,13575.0,7,S
2018-04-12 09:09:33,13575.0,14,4432,14,13570.0,8,13580.0,2,S
2018-04-12 09:09:34,13580.0,2,4434,2,13575.0,12,13585.0,6,B
2018-04-12 09:10:14,13575.0,12,4446,0,13570.0,7,13575.0,5,S
2018-04-12 09:10:15,13570.0,2,4448,0,13570.0,6,13575.0,5,S
2018-04-12 09:10:16,13570.0,2,4450,0,13570.0,5,13575.0,5,S
2018-04-12 09:10:26,13570.0,2,4452,2,13570.0,6,13575.0,5,S
2018-04-12 09:10:28,13570.0,4,4456,2,13570.0,1,13575.0,7,S
2018-04-12 09:10:29,13570.0,2,4458,0,13565.0,2,13570.0,2,S
2018-04-12 09:10:33,13570.0,4,4462,2,13565.0,9,13575.0,8,S
2018-04-12 09:10:48,13570.0,10,4472,2,13565.0,22,13575.0,6,S
2018-04-12 09:10:52,13570.0,2,4474,-2,13570.0,5,13575.0,6,S
2018-04-12 09:11:02,13570.0,4,4478,4,13565.0,11,13575.0,11,S
2018-04-12 09:11:33,13570.0,2,4480,2,13565.0,12,13575.0,11,S
2018-04-12 09:11:34,13570.0,2,4482,0,13565.0,12,13575.0,12,S
2018-04-12 09:11:42,13570.0,4,4486,-2,13565.0,8,13575.0,14,S
2018-04-12 09:12:04,13570.0,8,4494,-2,13570.0,6,13575.0,11,S
2018-04-12 09:12:04,13575.0,4,4498,0,13570.0,5,13575.0,9,B
2018-04-12 09:12:05,13575.0,6,4504,6,13570.0,5,13575.0,6,B
2018-04-12 09:12:17,13570.0,2,4506,0,13570.0,2,13575.0,6,S
2018-04-12 09:12:34,13570.0,6,4512,2,13565.0,17,13570.0,2,S
2018-04-12 09:12:35,13570.0,4,4516,0,13570.0,2,13575.0,6,S
2018-04-12 09:12:42,13570.0,2,4518,2,13570.0,1,13575.0,7,S
2018-04-12 09:12:43,13575.0,2,4520,0,13565.0,17,13575.0,6,B
2018-04-12 09:12:48,13575.0,12,4532,6,13575.0,2,13580.0,6,B
2018-04-12 09:12:48,13580.0,4,4536,2,13580.0,1,13585.0,7,B
2018-04-12 09:12:49,13580.0,2,4538,-2,13575.0,3,13580.0,2,B
2018-04-12 09:13:05,13580.0,2,4540,0,13575.0,5,13585.0,6,B
2018-04-12 09:13:11,13580.0,20,4560,2,13575.0,2,13585.0,11,B
2018-04-12 09:13:20,13580.0,2,4562,2,13575.0,5,13585.0,6,B
2018-04-12 09:13:43,13585.0,2,4564,0,13575.0,5,13585.0,7,B
2018-04-12 09:13:52,13580.0,2,4566,2,13580.0,9,13585.0,8,S
2018-04-12 09:14:13,13585.0,10,4576,0,13580.0,10,13585.0,1,B
2018-04-12 09:14:16,13585.0,4,4580,2,13580.0,1,13585.0,3,B
2018-04-12 09:14:17,13580.0,2,4582,0,13575.0,5,13585.0,3,S
2018-04-12 09:14:20,13575.0,2,4584,-2,13570.0,30,13580.0,4,S
2018-04-12 09:14:26,13580.0,2,4586,0,13570.0,35,13580.0,3,B
2018-04-12 09:14:51,13575.0,2,4588,0,13575.0,3,13580.0,4,S
2018-04-12 09:14:51,13575.0,2,4590,-2,13575.0,2,13580.0,4,S
2018-04-12 09:15:00,13575.0,2,4592,-2,13575.0,1,13580.0,3,S
2018-04-12 09:15:13,13580.0,4,4596,4,13575.0,3,13585.0,8,B
2018-04-12 09:15:42,13580.0,2,4598,0,13575.0,4,13585.0,6,B
2018-04-12 09:15:48,13580.0,2,4600,0,13580.0,2,13585.0,6,B
2018-04-12 09:15:49,13580.0,2,4602,-2,13580.0,1,13585.0,6,B
2018-04-12 09:16:01,13580.0,2,4604,0,13575.0,4,13580.0,4,B
2018-04-12 09:16:16,13575.0,4,4608,-2,13570.0,29,13575.0,4,S
2018-04-12 09:16:39,13570.0,12,4620,8,13565.0,55,13570.0,1,S
2018-04-12 09:16:54,13575.0,4,4624,0,13570.0,3,13575.0,5,B
2018-04-12 09:17:01,13565.0,6,4630,-4,13565.0,50,13575.0,12,S
2018-04-12 09:17:01,13565.0,2,4632,-2,13565.0,49,13575.0,12,S
2018-04-12 09:17:02,13565.0,2,4634,0,13565.0,47,13570.0,8,S
2018-04-12 09:17:08,13570.0,6,4640,-6,13565.0,48,13575.0,7,B
2018-04-12 09:17:11,13570.0,2,4642,-2,13565.0,49,13570.0,1,B
2018-04-12 09:17:15,13570.0,12,4654,10,13565.0,51,13570.0,3,B
2018-04-12 09:17:15,13570.0,6,4660,2,13565.0,53,13575.0,2,B
2018-04-12 09:17:27,13570.0,2,4662,-2,13570.0,7,13575.0,3,B
2018-04-12 09:17:28,13575.0,2,4664,0,13570.0,10,13575.0,1,B
2018-04-12 09:17:30,13575.0,2,4666,-2,13570.0,11,13580.0,5,B
2018-04-12 09:17:49,13580.0,4,4670,2,13580.0,1,13585.0,6,B
2018-04-12 09:17:50,13580.0,2,4672,0,13575.0,1,13580.0,3,B
2018-04-12 09:18:09,13580.0,2,4674,0,13575.0,2,13580.0,2,B
2018-04-12 09:18:09,13575.0,2,4676,0,13575.0,1,13580.0,2,S
2018-04-12 09:18:10,13575.0,2,4678,0,13570.0,3,13580.0,2,S
2018-04-12 09:18:44,13575.0,2,4680,0,13570.0,21,13580.0,8,S
2018-04-12 09:19:32,13570.0,6,4686,-6,13570.0,1,13575.0,6,S
2018-04-12 09:19:35,13570.0,2,4688,0,13565.0,47,13570.0,1,S
2018-04-12 09:19:59,13565.0,40,4728,0,13565.0,27,13570.0,10,S
2018-04-12 09:20:19,13565.0,54,4782,0,13560.0,13,13565.0,23,S
2018-04-12 09:20:35,13560.0,20,4802,2,13560.0,3,13565.0,24,S
2018-04-12 09:20:36,13560.0,8,4810,0,13555.0,5,13560.0,1,S
2018-04-12 09:20:36,13555.0,6,4816,0,13555.0,6,13565.0,25,S
2018-04-12 09:20:37,13560.0,4,4820,2,13555.0,5,13560.0,3,B
2018-04-12 09:20:44,13565.0,2,4822,0,13560.0,1,13565.0,1,B
2018-04-12 09:20:47,13560.0,2,4824,2,13555.0,5,13565.0,1,S
2018-04-12 09:20:51,13560.0,2,4826,0,13555.0,5,13565.0,2,S
2018-04-12 09:20:53,13555.0,2,4828,0,13555.0,5,13565.0,3,S
2018-04-12 09:20:58,13565.0,2,4830,-2,13555.0,5,13565.0,2,B
2018-04-12 09:21:33,13570.0,20,4850,4,13560.0,1,13565.0,1,B
2018-04-12 09:21:55,13560.0,2,4852,-2,13560.0,2,13565.0,3,S
2018-04-12 09:22:00,13560.0,2,4854,0,13560.0,2,13565.0,3,S
2018-04-12 09:22:08,13565.0,2,4856,2,13560.0,19,13565.0,1,B
2018-04-12 09:22:08,13565.0,2,4858,-2,13560.0,6,13570.0,6,B
2018-04-12 09:22:14,13560.0,2,4860,2,13560.0,5,13570.0,4,S
2018-04-12 09:22:35,13570.0,6,4866,4,13570.0,1,13575.0,7,B
2018-04-12 09:22:36,13570.0,2,4868,0,13565.0,3,13575.0,6,B
2018-04-12 09:23:24,13560.0,2,4870,2,13560.0,1,13565.0,10,S
2018-04-12 09:23:24,13560.0,2,4872,-2,13555.0,14,13565.0,10,S
2018-04-12 09:23:30,13560.0,4,4876,0,13555.0,19,13565.0,11,S
2018-04-12 09:23:44,13570.0,2,4878,0,13560.0,8,13570.0,4,B
2018-04-12 09:24:00,13560.0,4,4882,4,13555.0,5,13560.0,1,S
2018-04-12 09:24:14,13560.0,2,4884,0,13560.0,1,13565.0,39,S
2018-04-12 09:24:14,13560.0,2,4886,0,13555.0,11,13565.0,39,S
2018-04-12 09:24:49,13560.0,44,4930,-4,13555.0,10,13560.0,15,S
2018-04-12 09:24:52,13560.0,4,4934,0,13555.0,10,13560.0,13,S
2018-04-12 09:24:59,13560.0,12,4946,-12,13555.0,10,13560.0,7,S
2018-04-12 09:25:02,13560.0,6,4952,0,13555.0,10,13560.0,4,S
2018-04-12 09:25:04,13560.0,8,4960,0,13560.0,1,13565.0,2,S
2018-04-12 09:25:11,13560.0,2,4962,0,13560.0,1,13565.0,7,S
2018-04-12 09:25:12,13560.0,2,4964,2,13555.0,9,13560.0,2,S
2018-04-12 09:25:24,13560.0,6,4970,-6,13560.0,17,13565.0,9,S
2018-04-12 09:25:31,13560.0,6,4976,-6,13560.0,14,13565.0,6,S
2018-04-12 09:25:57,13560.0,2,4978,-2,13560.0,13,13565.0,7,S
2018-04-12 09:26:14,13560.0,6,4984,-2,13560.0,10,13565.0,10,S
2018-04-12 09:26:17,13560.0,2,4986,-2,13560.0,9,13565.0,10,S
2018-04-12 09:26:22,13560.0,2,4988,-2,13560.0,8,13565.0,10,S
2018-04-12 09:26:27,13560.0,2,4990,0,13560.0,7,13565.0,9,S
2018-04-12 09:26:57,13560.0,8,4998,0,13560.0,3,13565.0,14,S
2018-04-12 09:26:57,13560.0,4,5002,0,13560.0,1,13565.0,14,S
2018-04-12 09:27:02,13560.0,2,5004,0,13555.0,4,13565.0,13,S
2018-04-12 09:27:47,13560.0,2,5006,-2,13555.0,18,13565.0,6,S
2018-04-12 09:27:57,13560.0,2,5008,0,13560.0,1,13565.0,6,S
2018-04-12 09:28:01,13560.0,4,5012,4,13555.0,25,13560.0,2,S
2018-04-12 09:28:02,13560.0,4,5016,0,13555.0,24,13565.0,6,S
2018-04-12 09:28:11,13560.0,2,5018,0,13555.0,5,13560.0,1,S
2018-04-12 09:28:26,13560.0,2,5020,2,13560.0,1,13565.0,7,S
2018-04-12 09:28:26,13555.0,10,5030,2,13555.0,19,13565.0,6,S
2018-04-12 09:28:51,13565.0,2,5032,0,13555.0,7,13565.0,7,B
2018-04-12 09:29:12,13555.0,2,5034,-2,13550.0,4,13560.0,6,S
2018-04-12 09:29:22,13555.0,2,5036,-2,13550.0,4,13555.0,1,S
2018-04-12 09:29:34,13555.0,8,5044,4,13550.0,6,13555.0,1,S
2018-04-12 09:29:40,13555.0,2,5046,0,13555.0,10,13560.0,4,S
2018-04-12 09:29:40,13555.0,2,5048,-2,13555.0,9,13560.0,6,S
2018-04-12 09:29:41,13555.0,2,5050,0,13555.0,8,13560.0,6,S
2018-04-12 09:29:51,13555.0,2,5052,0,13555.0,7,13560.0,7,S
2018-04-12 09:29:54,13555.0,2,5054,0,13555.0,6,13560.0,7,S
2018-04-12 09:29:55,13555.0,10,5064,0,13555.0,2,13560.0,7,S
2018-04-12 09:29:59,13555.0,2,5066,-2,13555.0,1,13560.0,7,S
2018-04-12 09:29:59,13555.0,2,5068,-2,13550.0,6,13555.0,1,S
2018-04-12 09:30:01,13550.0,8,5076,4,13550.0,1,13555.0,3,S
2018-04-12 09:30:02,13550.0,2,5078,2,13545.0,4,13550.0,8,S
2018-04-12 09:30:02,13545.0,6,5084,6,13540.0,4,13545.0,1,S
2018-04-12 09:30:03,13540.0,2,5086,0,13540.0,3,13545.0,2,S
2018-04-12 09:30:07,13545.0,6,5092,6,13540.0,3,13550.0,12,B
2018-04-12 09:30:10,13540.0,4,5096,2,13540.0,2,13550.0,9,S
2018-04-12 09:30:12,13540.0,2,5098,-2,13540.0,2,13550.0,10,S
2018-04-12 09:30:13,13540.0,4,5102,-2,13540.0,1,13545.0,1,S
2018-04-12 09:30:15,13540.0,2,5104,-2,13540.0,2,13550.0,10,S
2018-04-12 09:30:19,13540.0,6,5110,2,13535.0,7,13540.0,3,S
2018-04-12 09:30:21,13540.0,2,5112,0,13535.0,4,13540.0,5,S
2018-04-12 09:30:28,13535.0,8,5120,8,13530.0,21,13535.0,1,S
2018-04-12 09:30:28,13530.0,8,5128,-4,13530.0,20,13540.0,5,S
2018-04-12 09:30:29,13530.0,10,5138,-10,13535.0,1,13540.0,5,S
2018-04-12 09:30:29,13535.0,2,5140,-2,13535.0,1,13540.0,5,B
2018-04-12 09:30:30,13540.0,8,5148,2,13535.0,2,13545.0,17,B
2018-04-12 09:30:31,13540.0,2,5150,0,13535.0,5,13545.0,13,B
2018-04-12 09:30:37,13530.0,2,5152,0,13530.0,19,13540.0,6,S
2018-04-12 09:30:43,13530.0,6,5158,-6,13530.0,10,13535.0,5,S
2018-04-12 09:30:44,13530.0,6,5164,0,13530.0,7,13535.0,10,S
2018-04-12 09:30:50,13530.0,2,5166,-2,13530.0,6,13540.0,9,S
2018-04-12 09:30:50,13530.0,12,5178,-10,13525.0,6,13530.0,2,S
2018-04-12 09:30:51,13530.0,4,5182,0,13525.0,8,13535.0,2,S
2018-04-12 09:30:55,13525.0,10,5192,4,13525.0,10,13535.0,3,S
2018-04-12 09:30:56,13525.0,6,5198,-2,13525.0,8,13535.0,3,S
2018-04-12 09:30:56,13525.0,2,5200,-2,13525.0,7,13535.0,2,S
2018-04-12 09:30:57,13525.0,2,5202,0,13525.0,6,13535.0,3,S
2018-04-12 09:31:03,13535.0,10,5212,-8,13535.0,5,13540.0,16,B
2018-04-12 09:31:03,13535.0,10,5222,-6,13530.0,1,13535.0,7,B
2018-04-12 09:31:05,13530.0,2,5224,-2,13525.0,9,13535.0,9,S
2018-04-12 09:31:07,13525.0,16,5240,-4,13520.0,11,13525.0,1,S
2018-04-12 09:31:07,13520.0,18,5258,6,13515.0,21,13525.0,8,S
2018-04-12 09:31:08,13525.0,24,5282,-18,13515.0,12,13525.0,4,B
2018-04-12 09:31:09,13515.0,20,5302,-20,13515.0,2,13525.0,5,S
2018-04-12 09:31:09,13515.0,4,5306,-2,13510.0,7,13515.0,1,S
2018-04-12 09:31:10,13515.0,2,5308,0,13510.0,7,13515.0,1,S
2018-04-12 09:31:10,13515.0,4,5312,-2,13510.0,7,13520.0,3,S
2018-04-12 09:31:11,13520.0,2,5314,-2,13510.0,10,13520.0,1,B
2018-04-12 09:31:12,13515.0,2,5316,0,13515.0,1,13525.0,7,S
2018-04-12 09:31:13,13520.0,2,5318,0,13515.0,1,13520.0,3,B
2018-04-12 09:31:14,13520.0,4,5322,4,13515.0,2,13525.0,7,B
2018-04-12 09:31:22,13525.0,2,5324,2,13520.0,5,13530.0,9,B
2018-04-12 09:31:25,13520.0,2,5326,0,13520.0,5,13530.0,15,S
2018-04-12 09:31:27,13530.0,2,5328,2,13530.0,1,13535.0,5,B
2018-04-12 09:31:31,13535.0,10,5338,-4,13535.0,1,13540.0,9,B
2018-04-12 09:31:32,13535.0,4,5342,2,13535.0,1,13540.0,7,B
2018-04-12 09:31:33,13535.0,2,5344,-2,13530.0,18,13540.0,9,B
2018-04-12 09:31:34,13535.0,4,5348,0,13535.0,2,13540.0,13,B
2018-04-12 09:31:35,13535.0,2,5350,0,13535.0,1,13540.0,12,B
2018-04-12 09:31:39,13535.0,2,5352,-2,13530.0,16,13540.0,13,B
2018-04-12 09:32:00,13530.0,2,5354,-2,13530.0,18,13540.0,13,S
2018-04-12 09:32:15,13530.0,2,5356,0,13525.0,5,13535.0,16,S
2018-04-12 09:32:28,13530.0,2,5358,2,13525.0,12,13530.0,9,S
2018-04-12 09:32:31,13530.0,8,5366,2,13525.0,15,13530.0,2,S
2018-04-12 09:32:31,13530.0,4,5370,0,13530.0,3,13535.0,8,S
2018-04-12 09:32:33,13535.0,2,5372,0,13530.0,10,13535.0,4,B
2018-04-12 09:32:37,13530.0,8,5380,-2,13530.0,1,13535.0,15,S
2018-04-12 09:32:42,13530.0,2,5382,0,13530.0,1,13535.0,12,S
2018-04-12 09:32:51,13530.0,10,5392,0,13530.0,1,13535.0,4,S
2018-04-12 09:32:51,13530.0,2,5394,0,13525.0,14,13530.0,1,S
2018-04-12 09:32:52,13530.0,2,5396,2,13530.0,1,13535.0,5,S
2018-04-12 09:32:59,13530.0,8,5404,2,13525.0,15,13530.0,1,S
2018-04-12 09:33:01,13530.0,2,5406,0,13525.0,15,13535.0,7,S
2018-04-12 09:33:14,13535.0,8,5414,0,13530.0,7,13540.0,6,B
2018-04-12 09:33:28,13535.0,6,5420,4,13530.0,8,13535.0,2,B
2018-04-12 09:33:28,13535.0,4,5424,4,13530.0,8,13540.0,3,B
2018-04-12 09:33:38,13535.0,2,5426,0,13535.0,1,13540.0,12,B
2018-04-12 09:33:38,13535.0,2,5428,-2,13530.0,5,13540.0,12,B
2018-04-12 09:33:59,13540.0,2,5430,0,13530.0,5,13540.0,9,B
2018-04-12 09:34:05,13540.0,10,5440,4,13530.0,6,13540.0,4,B
2018-04-12 09:34:07,13540.0,2,5442,-2,13530.0,6,13540.0,3,B
2018-04-12 09:34:44,13535.0,2,5444,0,13530.0,8,13535.0,27,S
2018-04-12 09:35:11,13535.0,2,5446,-2,13535.0,9,13540.0,6,S
2018-04-12 09:35:28,13535.0,4,5450,-4,13535.0,7,13540.0,7,S
2018-04-12 09:35:41,13535.0,2,5452,-2,13535.0,6,13540.0,6,S
2018-04-12 09:35:42,13535.0,12,5464,-12,13530.0,10,13540.0,6,S
2018-04-12 09:35:44,13530.0,10,5474,4,13525.0,15,13535.0,19,S
2018-04-12 09:35:53,13530.0,2,5476,0,13525.0,13,13530.0,3,S
2018-04-12 09:36:01,13525.0,2,5478,2,13525.0,12,13530.0,4,S
2018-04-12 09:36:05,13530.0,8,5486,-4,13530.0,4,13535.0,1,B
2018-04-12 09:36:07,13530.0,2,5488,0,13530.0,2,13535.0,11,B
2018-04-12 09:36:08,13530.0,4,5492,-2,13525.0,14,13535.0,23,B
2018-04-12 09:36:14,13525.0,2,5494,2,13525.0,12,13530.0,17,S
2018-04-12 09:36:28,13530.0,2,5496,-2,13525.0,13,13530.0,1,B
2018-04-12 09:36:33,13530.0,2,5498,0,13530.0,3,13535.0,4,B
2018-04-12 09:36:41,13535.0,20,5518,20,13530.0,5,13535.0,17,B
2018-04-12 09:37:48,13525.0,24,5542,-22,13520.0,12,13530.0,18,S
2018-04-12 09:37:54,13525.0,8,5550,-4,13520.0,12,13525.0,6,S
2018-04-12 09:37:59,13520.0,14,5564,6,13515.0,5,13520.0,1,S
2018-04-12 09:38:01,13515.0,10,5574,-2,13510.0,3,13520.0,10,S
2018-04-12 09:38:03,13510.0,6,5580,2,13505.0,13,13510.0,2,S
2018-04-12 09:38:05,13510.0,4,5584,0,13510.0,1,13515.0,4,S
2018-04-12 09:38:07,13515.0,4,5588,-4,13510.0,13,13515.0,4,B
2018-04-12 09:38:10,13515.0,8,5596,0,13515.0,2,13520.0,2,B
2018-04-12 09:38:10,13515.0,4,5600,4,13510.0,15,13515.0,8,B
2018-04-12 09:38:11,13510.0,10,5610,2,13510.0,4,13515.0,8,S
2018-04-12 09:38:15,13515.0,2,5612,0,13510.0,5,13515.0,7,B
2018-04-12 09:38:17,13515.0,2,5614,0,13510.0,8,13515.0,6,B
2018-04-12 09:38:20,13515.0,2,5616,2,13510.0,12,13515.0,6,B
2018-04-12 09:38:21,13515.0,2,5618,0,13510.0,12,13515.0,5,B
2018-04-12 09:38:22,13515.0,10,5628,0,13510.0,12,13515.0,5,B
2018-04-12 09:38:23,13515.0,12,5640,4,13510.0,12,13515.0,19,B
2018-04-12 09:38:23,13515.0,18,5658,6,13510.0,13,13515.0,10,B
2018-04-12 09:38:27,13510.0,10,5668,6,13510.0,3,13515.0,10,S
2018-04-12 09:38:30,13510.0,8,5676,6,13505.0,9,13510.0,20,S
2018-04-12 09:38:31,13510.0,4,5680,2,13505.0,12,13515.0,15,S
2018-04-12 09:38:32,13510.0,4,5684,0,13505.0,13,13515.0,14,S
2018-04-12 09:38:47,13510.0,2,5686,0,13510.0,3,13515.0,11,S
2018-04-12 09:38:47,13510.0,6,5692,-2,13505.0,16,13510.0,1,S
2018-04-12 09:38:50,13510.0,2,5694,-2,13505.0,10,13510.0,6,S
2018-04-12 09:38:53,13505.0,20,5714,-10,13500.0,37,13510.0,3,S
2018-04-12 09:38:53,13510.0,2,5716,0,13500.0,37,13510.0,2,B
2018-04-12 09:38:57,13510.0,2,5718,0,13500.0,40,13510.0,6,B
2018-04-12 09:39:04,13510.0,6,5724,2,13505.0,6,13515.0,15,B
2018-04-12 09:39:06,13515.0,2,5726,0,13505.0,7,13515.0,11,B
2018-04-12 09:39:07,13510.0,2,5728,2,13505.0,7,13515.0,12,S
2018-04-12 09:39:33,13515.0,2,5730,0,13510.0,6,13515.0,11,B
2018-04-12 09:39:34,13515.0,2,5732,0,13510.0,6,13515.0,10,B
2018-04-12 09:39:38,13515.0,2,5734,2,13510.0,5,13515.0,9,B
2018-04-12 09:39:40,13515.0,2,5736,0,13510.0,7,13515.0,7,B
2018-04-12 09:39:42,13515.0,14,5750,12,13515.0,2,13520.0,6,B
2018-04-12 09:39:44,13520.0,14,5764,2,13515.0,5,13525.0,5,B
2018-04-12 09:39:46,13520.0,2,5766,0,13520.0,1,13525.0,10,B
2018-04-12 09:39:47,13520.0,2,5768,0,13515.0,9,13525.0,10,B
2018-04-12 09:39:52,13525.0,2,5770,2,13515.0,10,13525.0,8,B
2018-04-12 09:39:59,13520.0,2,5772,2,13515.0,4,13520.0,9,S
2018-04-12 09:40:06,13515.0,8,5780,2,13510.0,13,13520.0,9,S
2018-04-12 09:40:28,13520.0,12,5792,8,13515.0,10,13520.0,4,B
2018-04-12 09:40:28,13520.0,8,5800,4,13515.0,10,13525.0,6,B
2018-04-12 09:40:30,13525.0,2,5802,2,13520.0,3,13530.0,3,B
2018-04-12 09:40:38,13520.0,2,5804,0,13515.0,3,13520.0,8,S
2018-04-12 09:40:46,13530.0,4,5808,0,13520.0,2,13530.0,4,B
2018-04-12 09:40:58,13520.0,2,5810,0,13520.0,3,13530.0,12,S
2018-04-12 09:41:01,13520.0,2,5812,-2,13515.0,7,13525.0,4,S
2018-04-12 09:41:07,13515.0,4,5816,0,13515.0,1,13520.0,4,S
2018-04-12 09:41:36,13520.0,2,5818,0,13515.0,10,13525.0,6,B
2018-04-12 09:42:42,13525.0,22,5840,-4,13520.0,3,13525.0,2,B
2018-04-12 09:42:47,13520.0,2,5842,0,13520.0,1,13525.0,12,S
2018-04-12 09:42:48,13520.0,2,5844,0,13515.0,5,13520.0,1,S
2018-04-12 09:42:49,13525.0,8,5852,-2,13515.0,4,13525.0,9,B
2018-04-12 09:43:15,13520.0,10,5862,8,13515.0,19,13520.0,5,S
2018-04-12 09:43:15,13520.0,4,5866,0,13515.0,19,13520.0,3,S
2018-04-12 09:43:16,13520.0,2,5868,2,13515.0,19,13520.0,2,S
2018-04-12 09:43:17,13520.0,2,5870,0,13515.0,19,13520.0,1,S
2018-04-12 09:43:17,13520.0,2,5872,2,13515.0,7,13525.0,3,S
2018-04-12 09:43:23,13525.0,2,5874,2,13520.0,1,13525.0,2,B
2018-04-12 09:43:44,13525.0,4,5878,4,13525.0,3,13530.0,4,B
2018-04-12 09:43:45,13530.0,10,5888,8,13520.0,3,13530.0,7,B
2018-04-12 09:43:58,13525.0,4,5892,-4,13520.0,3,13530.0,11,S
2018-04-12 09:44:19,13520.0,12,5904,2,13515.0,7,13525.0,9,S
2018-04-12 09:44:20,13525.0,20,5924,-12,13515.0,4,13525.0,2,B
2018-04-12 09:44:26,13525.0,2,5926,-2,13520.0,6,13530.0,6,B
2018-04-12 09:44:33,13525.0,2,5928,-2,13520.0,15,13525.0,2,B
2018-04-12 09:44:39,13530.0,6,5934,2,13520.0,15,13530.0,8,B
2018-04-12 09:44:41,13525.0,2,5936,2,13520.0,13,13530.0,9,S
2018-04-12 09:44:48,13525.0,2,5938,-2,13520.0,13,13525.0,1,S
2018-04-12 09:44:58,13525.0,6,5944,-2,13520.0,10,13525.0,5,S
2018-04-12 09:45:09,13520.0,10,5954,0,13520.0,5,13525.0,8,S
2018-04-12 09:45:10,13520.0,10,5964,0,13515.0,4,13525.0,8,S
2018-04-12 09:45:11,13515.0,4,5968,-2,13510.0,17,13515.0,1,S
2018-04-12 09:45:16,13515.0,2,5970,0,13515.0,3,13520.0,4,S
2018-04-12 09:45:36,13515.0,2,5972,-2,13515.0,2,13520.0,2,S
2018-04-12 09:45:37,13520.0,4,5976,-4,13520.0,8,13525.0,6,B
2018-04-12 09:45:37,13520.0,2,5978,0,13520.0,7,13525.0,6,B
2018-04-12 09:45:38,13520.0,6,5984,0,13520.0,4,13525.0,7,B
2018-04-12 09:45:40,13520.0,8,5992,0,13515.0,3,13525.0,6,B
2018-04-12 09:45:53,13520.0,4,5996,2,13515.0,2,13520.0,2,B
2018-04-12 09:46:08,13515.0,4,6000,-4,13510.0,20,13520.0,4,S
2018-04-12 09:46:32,13510.0,30,6030,2,13505.0,21,13510.0,8,S
2018-04-12 09:46:33,13505.0,2,6032,2,13505.0,16,13510.0,8,S
2018-04-12 09:46:34,13505.0,30,6062,-8,13505.0,1,13510.0,9,S
2018-04-12 09:46:34,13505.0,2,6064,-2,13500.0,38,13505.0,4,S
2018-04-12 09:46:35,13505.0,4,6068,2,13500.0,38,13510.0,8,S
2018-04-12 09:46:36,13505.0,4,6072,0,13500.0,39,13510.0,8,S
2018-04-12 09:46:48,13505.0,2,6074,2,13500.0,37,13505.0,6,S
2018-04-12 09:46:54,13500.0,18,6092,-8,13500.0,28,13505.0,10,S
2018-04-12 09:46:54,13500.0,12,6104,-2,13500.0,23,13505.0,10,S
2018-04-12 09:46:55,13500.0,2,6106,-2,13500.0,22,13505.0,10,S
2018-04-12 09:46:56,13500.0,2,6108,0,13500.0,21,13505.0,10,S
2018-04-12 09:46:57,13500.0,4,6112,0,13500.0,19,13505.0,10,S
2018-04-12 09:46:57,13500.0,14,6126,-4,13500.0,12,13505.0,10,S
2018-04-12 09:46:59,13505.0,2,6128,2,13500.0,12,13505.0,9,B
2018-04-12 09:47:01,13500.0,24,6152,12,13500.0,1,13505.0,5,S
2018-04-12 09:47:02,13495.0,12,6164,6,13490.0,11,13500.0,9,S
2018-04-12 09:47:03,13500.0,2,6166,0,13495.0,7,13505.0,8,B
2018-04-12 09:47:06,13500.0,2,6168,2,13495.0,5,13500.0,1,B
2018-04-12 09:47:07,13495.0,6,6174,0,13495.0,2,13505.0,10,S
2018-04-12 09:47:09,13505.0,2,6176,2,13495.0,2,13505.0,9,B
2018-04-12 09:47:13,13500.0,6,6182,0,13500.0,2,13505.0,5,S
2018-04-12 09:47:13,13500.0,4,6186,0,13495.0,10,13505.0,3,S
2018-04-12 09:47:20,13500.0,16,6202,-6,13495.0,21,13505.0,5,S
2018-04-12 09:47:21,13500.0,2,6204,0,13500.0,4,13505.0,3,S
2018-04-12 09:47:21,13500.0,4,6208,4,13500.0,5,13505.0,3,S
2018-04-12 09:47:24,13500.0,2,6210,2,13495.0,19,13505.0,6,S
2018-04-12 09:47:25,13500.0,2,6212,-2,13495.0,11,13500.0,8,S
2018-04-12 09:47:25,13495.0,2,6214,-2,13495.0,10,13500.0,3,S
2018-04-12 09:47:26,13500.0,2,6216,0,13500.0,1,13505.0,3,B
2018-04-12 09:47:32,13505.0,2,6218,-2,13500.0,2,13505.0,3,B
2018-04-12 09:47:35,13505.0,4,6222,-2,13500.0,1,13505.0,9,B
2018-04-12 09:47:36,13505.0,2,6224,-2,13500.0,1,13505.0,8,B
2018-04-12 09:47:37,13505.0,2,6226,0,13500.0,1,13505.0,4,B
2018-04-12 09:47:41,13500.0,2,6228,0,13500.0,6,13510.0,12,S
2018-04-12 09:47:42,13500.0,2,6230,0,13500.0,6,13510.0,12,S
2018-04-12 09:47:46,13510.0,4,6234,4,13505.0,9,13515.0,5,B
2018-04-12 09:48:04,13505.0,6,6240,-6,13505.0,1,13510.0,4,S
2018-04-12 09:48:04,13505.0,2,6242,-2,13500.0,3,13505.0,12,S
2018-04-12 09:48:05,13500.0,4,6246,4,13495.0,12,13505.0,14,S
2018-04-12 09:48:09,13500.0,2,6248,2,13495.0,11,13505.0,14,S
2018-04-12 09:48:11,13495.0,20,6268,-2,13490.0,12,13495.0,3,S
2018-04-12 09:48:12,13495.0,8,6276,6,13490.0,11,13500.0,5,S
2018-04-12 09:48:17,13495.0,2,6278,0,13490.0,15,13500.0,8,S
2018-04-12 09:48:22,13495.0,4,6282,-2,13490.0,11,13500.0,10,S
2018-04-12 09:48:26,13500.0,4,6286,0,13495.0,18,13505.0,5,B
2018-04-12 09:48:46,13495.0,2,6288,0,13495.0,2,13500.0,6,S
2018-04-12 09:48:48,13495.0,2,6290,2,13495.0,1,13500.0,8,S
2018-04-12 09:48:48,13495.0,2,6292,2,13490.0,14,13495.0,12,S
2018-04-12 09:48:56,13490.0,4,6296,0,13490.0,10,13495.0,21,S
2018-04-12 09:48:56,13490.0,20,6316,-4,13485.0,27,13490.0,3,S
2018-04-12 09:48:57,13485.0,32,6348,-2,13485.0,8,13490.0,9,S
2018-04-12 09:48:58,13485.0,104,6452,0,13470.0,1,13480.0,1,S
2018-04-12 09:48:58,13460.0,24,6476,8,13460.0,1,13470.0,11,S
2018-04-12 09:48:59,13460.0,54,6530,-38,13440.0,6,13455.0,1,S
2018-04-12 09:48:59,13455.0,48,6578,20,13455.0,17,13460.0,2,S
2018-04-12 09:49:00,13460.0,12,6590,4,13460.0,22,13470.0,4,B
2018-04-12 09:49:00,13470.0,8,6598,0,13460.0,13,13475.0,5,B
2018-04-12 09:49:01,13465.0,4,6602,2,13455.0,7,13470.0,9,S
2018-04-12 09:49:02,13460.0,2,6604,-2,13455.0,1,13465.0,3,S
2018-04-12 09:49:02,13455.0,4,6608,-2,13450.0,1,13460.0,2,S
2018-04-12 09:49:03,13460.0,4,6612,-2,13450.0,4,13460.0,1,B
2018-04-12 09:49:03,13465.0,6,6618,-2,13455.0,2,13465.0,2,B
2018-04-12 09:49:04,13455.0,10,6628,-4,13455.0,2,13460.0,1,S
2018-04-12 09:49:04,13455.0,6,6634,-2,13455.0,5,13460.0,2,S
2018-04-12 09:49:05,13460.0,4,6638,0,13450.0,10,13455.0,2,B
2018-04-12 09:49:05,13455.0,8,6646,-8,13450.0,11,13460.0,3,S
2018-04-12 09:49:06,13450.0,22,6668,-8,13445.0,2,13450.0,1,S
2018-04-12 09:49:07,13450.0,16,6684,-6,13440.0,6,13450.0,6,S
2018-04-12 09:49:07,13445.0,6,6690,-4,13440.0,3,13445.0,3,S
2018-04-12 09:49:08,13440.0,8,6698,0,13435.0,2,13445.0,5,S
2018-04-12 09:49:08,13445.0,14,6712,-4,13445.0,2,13450.0,9,B
2018-04-12 09:49:09,13450.0,18,6730,-6,13445.0,2,13450.0,1,B
2018-04-12 09:49:09,13440.0,22,6752,6,13445.0,1,13450.0,1,S
2018-04-12 09:49:10,13450.0,2,6754,0,13445.0,4,13455.0,3,B
2018-04-12 09:49:11,13455.0,2,6756,2,13450.0,2,13455.0,9,B
2018-04-12 09:49:12,13455.0,4,6760,-2,13450.0,2,13460.0,2,B
2018-04-12 09:49:12,13450.0,2,6762,-2,13450.0,1,13460.0,2,S
2018-04-12 09:49:14,13455.0,4,6766,0,13450.0,3,13465.0,4,B
2018-04-12 09:49:14,13460.0,6,6772,0,13460.0,7,13465.0,5,B
2018-04-12 09:49:16,13465.0,4,6776,0,13460.0,7,13470.0,3,B
2018-04-12 09:49:20,13470.0,10,6786,-4,13470.0,5,13475.0,5,B
2018-04-12 09:49:20,13470.0,2,6788,0,13470.0,4,13475.0,7,B
2018-04-12 09:49:21,13470.0,2,6790,-2,13470.0,13,13475.0,6,B
2018-04-12 09:49:24,13470.0,26,6816,0,13465.0,2,13470.0,37,B
2018-04-12 09:49:27,13470.0,4,6820,4,13465.0,13,13470.0,45,B
2018-04-12 09:49:28,13470.0,2,6822,0,13465.0,15,13470.0,46,B
2018-04-12 09:49:29,13470.0,32,6854,10,13465.0,17,13470.0,30,B
2018-04-12 09:49:29,13470.0,36,6890,26,13465.0,14,13470.0,12,B
2018-04-12 09:49:30,13470.0,20,6910,-20,13465.0,14,13470.0,2,B
2018-04-12 09:49:30,13470.0,6,6916,0,13470.0,1,13475.0,9,B
2018-04-12 09:49:33,13470.0,8,6924,4,13470.0,3,13475.0,3,B
2018-04-12 09:49:34,13475.0,8,6932,2,13475.0,8,13480.0,5,B
2018-04-12 09:49:38,13475.0,4,6936,4,13475.0,6,13480.0,5,B
2018-04-12 09:49:42,13475.0,12,6948,6,13470.0,14,13480.0,15,B
2018-04-12 09:49:45,13480.0,4,6952,4,13470.0,14,13480.0,2,B
2018-04-12 09:49:50,13470.0,6,6958,4,13465.0,13,13470.0,1,S
2018-04-12 09:49:53,13465.0,4,6962,-4,13465.0,8,13470.0,7,S
2018-04-12 09:49:55,13470.0,6,6968,2,13465.0,8,13475.0,5,B
2018-04-12 09:50:01,13465.0,2,6970,-2,13465.0,7,13470.0,15,S
2018-04-12 09:50:01,13465.0,14,6984,0,13460.0,19,13470.0,18,S
2018-04-12 09:50:06,13460.0,2,6986,0,13460.0,18,13470.0,18,S
2018-04-12 09:50:10,13460.0,36,7022,-30,13455.0,3,13460.0,3,S
2018-04-12 09:50:11,13455.0,2,7024,-2,13450.0,8,13460.0,19,S
2018-04-12 09:50:12,13455.0,6,7030,0,13450.0,7,13460.0,21,S
2018-04-12 09:50:14,13450.0,2,7032,-2,13455.0,1,13460.0,21,S
2018-04-12 09:50:15,13455.0,2,7034,-2,13455.0,10,13460.0,18,B
2018-04-12 09:50:19,13455.0,14,7048,8,13455.0,3,13460.0,13,B
2018-04-12 09:50:20,13455.0,2,7050,2,13455.0,2,13460.0,13,B
2018-04-12 09:50:22,13460.0,6,7056,-6,13455.0,4,13460.0,9,B
2018-04-12 09:50:25,13460.0,4,7060,0,13455.0,5,13465.0,4,B
2018-04-12 09:50:27,13465.0,2,7062,0,13460.0,11,13470.0,4,B
2018-04-12 09:50:31,13460.0,10,7072,0,13460.0,7,13470.0,8,S
2018-04-12 09:50:41,13470.0,2,7074,2,13465.0,1,13475.0,4,B
2018-04-12 09:50:53,13465.0,2,7076,-2,13460.0,11,13465.0,9,S
2018-04-12 09:50:59,13465.0,2,7078,-2,13460.0,8,13465.0,8,S
2018-04-12 09:51:02,13465.0,6,7084,-2,13460.0,4,13465.0,22,S
2018-04-12 09:51:07,13460.0,4,7088,-4,13460.0,3,13465.0,22,S
2018-04-12 09:51:08,13460.0,6,7094,4,13455.0,8,13460.0,13,S
2018-04-12 09:51:09,13460.0,4,7098,-2,13455.0,2,13460.0,12,S
2018-04-12 09:51:14,13455.0,4,7102,0,13455.0,1,13460.0,12,S
2018-04-12 09:51:20,13455.0,2,7104,-2,13455.0,1,13460.0,1,S
2018-04-12 09:51:21,13460.0,2,7106,-2,13455.0,2,13460.0,3,B
2018-04-12 09:51:21,13455.0,4,7110,-2,13450.0,13,13460.0,1,S
2018-04-12 09:51:22,13450.0,18,7128,14,13450.0,1,13455.0,6,S
2018-04-12 09:51:22,13445.0,4,7132,0,13445.0,2,13450.0,7,S
2018-04-12 09:51:23,13445.0,4,7136,2,13440.0,3,13445.0,6,S
2018-04-12 09:51:23,13440.0,6,7142,-4,13435.0,3,13445.0,3,S
2018-04-12 09:51:27,13450.0,2,7144,0,13440.0,5,13450.0,2,B
2018-04-12 09:51:28,13445.0,2,7146,0,13440.0,7,13450.0,2,S
2018-04-12 09:51:30,13450.0,2,7148,0,13450.0,1,13455.0,4,B
2018-04-12 09:51:30,13440.0,14,7162,-10,13440.0,6,13455.0,2,S
2018-04-12 09:51:31,13450.0,2,7164,2,13450.0,1,13455.0,2,B
2018-04-12 09:51:32,13450.0,2,7166,0,13445.0,8,13450.0,1,B
2018-04-12 09:51:33,13450.0,12,7178,-6,13445.0,2,13455.0,7,B
2018-04-12 09:51:33,13445.0,4,7182,-2,13445.0,4,13455.0,7,S
2018-04-12 09:51:35,13445.0,6,7188,2,13440.0,8,13450.0,2,S
2018-04-12 09:51:36,13445.0,2,7190,0,13440.0,7,13445.0,2,S
2018-04-12 09:51:38,13440.0,2,7192,2,13440.0,5,13445.0,7,S
2018-04-12 09:51:38,13445.0,14,7206,-10,13445.0,3,13450.0,7,B
2018-04-12 09:51:39,13440.0,16,7222,-12,13435.0,5,13440.0,7,S
2018-04-12 09:51:40,13440.0,26,7248,4,13435.0,6,13440.0,44,S
2018-04-12 09:51:42,13435.0,4,7252,-4,13430.0,4,13440.0,49,S
2018-04-12 09:51:43,13435.0,6,7258,0,13430.0,4,13435.0,1,S
2018-04-12 09:51:43,13430.0,6,7264,0,13425.0,9,13435.0,2,S
2018-04-12 09:51:45,13435.0,24,7288,14,13425.0,6,13430.0,1,B
2018-04-12 09:51:45,13435.0,2,7290,0,13425.0,6,13440.0,52,B
2018-04-12 09:51:47,13430.0,4,7294,0,13430.0,2,13440.0,49,S
2018-04-12 09:51:48,13430.0,14,7308,-6,13425.0,6,13430.0,9,S
2018-04-12 09:51:51,13430.0,2,7310,-2,13425.0,6,13430.0,9,S
2018-04-12 09:51:52,13430.0,2,7312,0,13425.0,8,13430.0,8,S
2018-04-12 09:51:56,13425.0,2,7314,-2,13425.0,7,13430.0,8,S
2018-04-12 09:51:56,13425.0,2,7316,0,13425.0,6,13430.0,8,S
2018-04-12 09:51:57,13430.0,16,7332,-14,13430.0,1,13435.0,46,B
2018-04-12 09:51:59,13430.0,2,7334,0,13430.0,1,13435.0,45,B
2018-04-12 09:51:59,13435.0,14,7348,8,13430.0,10,13435.0,38,B
2018-04-12 09:52:00,13430.0,32,7380,24,13430.0,8,13435.0,24,S
2018-04-12 09:52:01,13430.0,8,7388,2,13425.0,11,13430.0,1,S
2018-04-12 09:52:01,13430.0,2,7390,2,13430.0,1,13435.0,26,S
2018-04-12 09:52:02,13430.0,2,7392,2,13425.0,8,13430.0,2,S
2018-04-12 09:52:03,13425.0,12,7404,0,13420.0,5,13430.0,8,S
2018-04-12 09:52:04,13430.0,8,7412,2,13425.0,6,13435.0,29,B
2018-04-12 09:52:09,13430.0,6,7418,-6,13425.0,6,13430.0,12,B
2018-04-12 09:52:11,13430.0,14,7432,-10,13425.0,6,13430.0,5,B
2018-04-12 09:52:11,13430.0,16,7448,-10,13425.0,9,13430.0,21,B
2018-04-12 09:52:12,13430.0,24,7472,2,13425.0,9,13430.0,9,B
2018-04-12 09:52:13,13430.0,18,7490,16,13430.0,9,13435.0,2,B
2018-04-12 09:52:14,13435.0,4,7494,-2,13435.0,1,13440.0,5,B
2018-04-12 09:52:18,13440.0,6,7500,-4,13440.0,1,13445.0,1,B
2018-04-12 09:52:20,13445.0,4,7504,2,13445.0,10,13450.0,5,B
2018-04-12 09:52:25,13445.0,2,7506,2,13445.0,9,13450.0,12,B
2018-04-12 09:52:26,13445.0,22,7528,-16,13445.0,8,13450.0,2,B
2018-04-12 09:52:27,13445.0,10,7538,0,13445.0,3,13450.0,2,B
2018-04-12 09:52:28,13450.0,4,7542,0,13445.0,6,13450.0,1,B
2018-04-12 09:52:28,13450.0,2,7544,-2,13450.0,1,13455.0,5,B
2018-04-12 09:52:33,13450.0,6,7550,4,13445.0,7,13450.0,17,B
2018-04-12 09:52:34,13450.0,2,7552,0,13445.0,7,13450.0,16,B
2018-04-12 09:52:34,13450.0,30,7582,30,13445.0,17,13450.0,1,B
2018-04-12 09:52:35,13450.0,2,7584,2,13445.0,16,13455.0,3,B
2018-04-12 09:52:39,13455.0,2,7586,0,13450.0,1,13455.0,2,B
2018-04-12 09:52:41,13450.0,6,7592,2,13450.0,2,13460.0,5,S
2018-04-12 09:52:46,13460.0,2,7594,2,13450.0,5,13460.0,6,B
2018-04-12 09:52:49,13460.0,2,7596,0,13455.0,5,13460.0,1,B
2018-04-12 09:52:49,13460.0,2,7598,0,13460.0,1,13465.0,6,B
2018-04-12 09:52:51,13465.0,6,7604,6,13460.0,1,13465.0,2,B
2018-04-12 09:52:51,13460.0,2,7606,0,13455.0,4,13465.0,3,S
2018-04-12 09:52:53,13465.0,6,7612,6,13460.0,8,13465.0,1,B
2018-04-12 09:52:54,13465.0,2,7614,-2,13465.0,1,13470.0,3,B
2018-04-12 09:52:54,13465.0,2,7616,0,13460.0,2,13465.0,2,B
2018-04-12 09:52:57,13460.0,2,7618,2,13455.0,3,13460.0,2,S
2018-04-12 09:53:05,13460.0,4,7622,4,13460.0,2,13465.0,10,S
2018-04-12 09:53:05,13460.0,4,7626,0,13455.0,2,13465.0,9,S
2018-04-12 09:53:06,13455.0,8,7634,2,13450.0,7,13455.0,16,S
2018-04-12 09:53:08,13450.0,4,7638,2,13450.0,1,13455.0,16,S
2018-04-12 09:53:08,13450.0,2,7640,2,13445.0,16,13450.0,1,S
2018-04-12 09:53:09,13450.0,2,7642,0,13445.0,11,13450.0,3,S
2018-04-12 09:53:11,13450.0,2,7644,2,13445.0,11,13450.0,1,S
2018-04-12 09:53:22,13450.0,2,7646,0,13445.0,13,13450.0,2,S
2018-04-12 09:53:28,13445.0,24,7670,4,13440.0,19,13445.0,4,S
2018-04-12 09:53:33,13445.0,2,7672,0,13440.0,21,13445.0,3,S
2018-04-12 09:53:35,13445.0,2,7674,0,13440.0,21,13445.0,2,S
2018-04-12 09:53:36,13440.0,2,7676,0,13440.0,18,13445.0,7,S
2018-04-12 09:53:40,13440.0,4,7680,0,13440.0,16,13445.0,3,S
2018-04-12 09:53:43,13440.0,4,7684,-2,13440.0,14,13445.0,5,S
2018-04-12 09:53:43,13445.0,2,7686,0,13440.0,17,13445.0,4,B
2018-04-12 09:53:44,13445.0,2,7688,-2,13440.0,17,13445.0,1,B
2018-04-12 09:53:49,13445.0,2,7690,0,13445.0,2,13450.0,3,B
2018-04-12 09:53:50,13445.0,4,7694,-4,13440.0,19,13450.0,12,B
2018-04-12 09:53:55,13445.0,4,7698,4,13440.0,21,13445.0,5,B
2018-04-12 09:53:57,13445.0,2,7700,2,13440.0,21,13445.0,7,B
2018-04-12 09:53:57,13440.0,2,7702,0,13440.0,20,13445.0,6,S
2018-04-12 09:53:59,13440.0,18,7720,2,13440.0,12,13445.0,6,S
2018-04-12 09:53:59,13440.0,26,7746,8,13435.0,3,13440.0,5,S
2018-04-12 09:54:01,13435.0,2,7748,0,13430.0,13,13435.0,1,S
2018-04-12 09:54:10,13430.0,20,7768,10,13425.0,3,13435.0,11,S
2018-04-12 09:54:12,13420.0,2,7770,0,13420.0,4,13425.0,4,S
2018-04-12 09:54:12,13420.0,22,7792,-2,13410.0,22,13420.0,5,S
2018-04-12 09:54:15,13410.0,24,7816,-16,13410.0,10,13420.0,1,S
2018-04-12 09:54:15,13410.0,18,7834,-14,13420.0,1,13425.0,6,S
2018-04-12 09:54:16,13410.0,6,7840,0,13410.0,1,13420.0,11,S
2018-04-12 09:54:17,13410.0,6,7846,0,13415.0,2,13420.0,1,S
2018-04-12 09:54:18,13420.0,2,7848,0,13415.0,3,13425.0,10,B
2018-04-12 09:54:27,13420.0,2,7850,2,13410.0,4,13420.0,7,B
2018-04-12 09:54:28,13420.0,2,7852,0,13410.0,8,13420.0,4,B
2018-04-12 09:54:28,13420.0,2,7854,0,13410.0,8,13420.0,3,B
2018-04-12 09:54:32,13415.0,20,7874,4,13410.0,10,13420.0,2,S
2018-04-12 09:54:32,13420.0,4,7878,4,13415.0,9,13420.0,1,B
2018-04-12 09:54:33,13420.0,2,7880,0,13420.0,2,13425.0,5,B
2018-04-12 09:54:37,13420.0,4,7884,-4,13420.0,11,13430.0,3,B
2018-04-12 09:54:43,13435.0,2,7886,2,13430.0,1,13440.0,10,B
2018-04-12 09:54:44,13440.0,2,7888,0,13430.0,2,13440.0,9,B
2018-04-12 09:54:49,13440.0,2,7890,2,13430.0,3,13440.0,9,B
2018-04-12 09:54:51,13440.0,20,7910,14,13440.0,2,13445.0,3,B
2018-04-12 09:54:51,13430.0,6,7916,0,13430.0,1,13440.0,23,S
2018-04-12 09:54:55,13435.0,10,7926,-4,13430.0,6,13440.0,10,B
2018-04-12 09:54:56,13430.0,18,7944,12,13425.0,2,13440.0,11,S
2018-04-12 09:54:57,13430.0,4,7948,0,13430.0,3,13440.0,11,S
2018-04-12 09:54:58,13430.0,2,7950,-2,13430.0,2,13440.0,11,S
2018-04-12 09:55:00,13440.0,2,7952,2,13430.0,2,13440.0,10,B
2018-04-12 09:55:05,13435.0,2,7954,0,13430.0,2,13435.0,1,S
2018-04-12 09:55:07,13435.0,2,7956,2,13430.0,2,13435.0,3,S
2018-04-12 09:55:08,13430.0,8,7964,-2,13425.0,2,13430.0,4,S
2018-04-12 09:55:13,13425.0,2,7966,0,13420.0,4,13425.0,3,S
2018-04-12 09:55:19,13420.0,2,7968,0,13420.0,2,13425.0,6,S
2018-04-12 09:55:30,13430.0,2,7970,-2,13425.0,7,13435.0,3,B
2018-04-12 09:55:37,13435.0,2,7972,-2,13430.0,8,13440.0,6,B
2018-04-12 09:55:40,13435.0,4,7976,0,13430.0,8,13440.0,6,B
2018-04-12 09:55:43,13440.0,2,7978,0,13430.0,7,13440.0,5,B
2018-04-12 09:55:47,13435.0,2,7980,-2,13435.0,1,13440.0,5,S
2018-04-12 09:55:49,13435.0,2,7982,0,13430.0,8,13435.0,1,S
2018-04-12 09:55:49,13440.0,4,7986,-2,13435.0,10,13440.0,4,B
2018-04-12 09:55:52,13440.0,6,7992,0,13435.0,12,13445.0,5,B
2018-04-12 09:55:54,13440.0,2,7994,2,13435.0,8,13445.0,4,B
2018-04-12 09:55:56,13440.0,4,7998,-4,13435.0,2,13445.0,7,B
2018-04-12 09:55:58,13445.0,4,8002,2,13440.0,7,13445.0,3,B
2018-04-12 09:55:58,13445.0,2,8004,0,13440.0,9,13450.0,7,B
2018-04-12 09:55:59,13445.0,4,8008,-4,13435.0,10,13445.0,4,B
2018-04-12 09:56:04,13445.0,2,8010,0,13445.0,4,13450.0,15,B
2018-04-12 09:56:07,13450.0,6,8016,2,13445.0,5,13455.0,3,B
2018-04-12 09:56:14,13460.0,2,8018,0,13455.0,4,13465.0,3,B
2018-04-12 09:56:27,13455.0,2,8020,0,13450.0,2,13455.0,2,S
2018-04-12 09:56:35,13450.0,8,8028,-4,13445.0,3,13450.0,1,S
2018-04-12 09:56:36,13450.0,2,8030,-2,13445.0,5,13455.0,1,S
2018-04-12 09:56:38,13455.0,2,8032,0,13445.0,6,13455.0,1,B
2018-04-12 09:56:54,13460.0,2,8034,-2,13450.0,12,13460.0,1,B
2018-04-12 09:57:08,13455.0,2,8036,0,13445.0,7,13455.0,6,S
2018-04-12 09:57:09,13455.0,2,8038,0,13445.0,7,13455.0,5,S
2018-04-12 09:57:14,13440.0,4,8042,2,13440.0,8,13450.0,4,S
2018-04-12 09:57:17,13440.0,4,8046,-2,13435.0,3,13445.0,6,S
2018-04-12 09:57:27,13435.0,2,8048,0,13435.0,5,13445.0,4,S
2018-04-12 09:57:28,13445.0,2,8050,2,13435.0,5,13445.0,4,B
2018-04-12 09:57:53,13445.0,2,8052,-2,13445.0,3,13450.0,19,B
2018-04-12 09:57:56,13445.0,2,8054,0,13445.0,2,13450.0,20,B
2018-04-12 09:57:58,13450.0,2,8056,2,13445.0,2,13450.0,18,B
2018-04-12 09:58:00,13450.0,30,8086,-2,13445.0,2,13450.0,1,B
2018-04-12 09:58:02,13445.0,4,8090,0,13440.0,7,13445.0,9,S
2018-04-12 09:58:06,13445.0,10,8100,4,13440.0,23,13445.0,4,S
2018-04-12 09:58:06,13445.0,4,8104,4,13440.0,11,13445.0,2,S
2018-04-12 09:58:07,13445.0,4,8108,0,13440.0,9,13450.0,4,S
2018-04-12 09:58:13,13450.0,2,8110,2,13440.0,11,13450.0,3,B
2018-04-12 09:58:18,13450.0,2,8112,2,13445.0,6,13455.0,6,B
2018-04-12 09:58:41,13455.0,2,8114,0,13455.0,1,13460.0,1,B
2018-04-12 09:58:42,13455.0,2,8116,2,13455.0,2,13465.0,9,B
2018-04-12 09:58:57,13455.0,2,8118,0,13450.0,5,13460.0,3,B
2018-04-12 09:59:00,13450.0,2,8120,0,13450.0,4,13455.0,5,S
2018-04-12 09:59:03,13450.0,2,8122,2,13450.0,3,13455.0,5,S
2018-04-12 09:59:04,13450.0,2,8124,2,13450.0,1,13455.0,5,S
2018-04-12 09:59:17,13455.0,10,8134,6,13450.0,11,13460.0,6,B
2018-04-12 09:59:26,13460.0,2,8136,0,13460.0,4,13465.0,2,B
2018-04-12 09:59:26,13465.0,2,8138,2,13460.0,4,13465.0,1,B
2018-04-12 09:59:27,13465.0,2,8140,0,13460.0,6,13470.0,7,B
2018-04-12 09:59:32,13470.0,2,8142,0,13460.0,5,13470.0,9,B
2018-04-12 09:59:32,13470.0,4,8146,-2,13465.0,1,13470.0,8,B
2018-04-12 09:59:34,13465.0,2,8148,-2,13460.0,5,13470.0,7,S
2018-04-12 09:59:43,13465.0,4,8152,0,13460.0,6,13470.0,13,S
2018-04-12 09:59:53,13460.0,2,8154,-2,13460.0,2,13465.0,10,S
2018-04-12 09:59:54,13460.0,4,8158,-2,13455.0,4,13465.0,11,S
2018-04-12 10:00:01,13465.0,6,8164,0,13460.0,8,13465.0,4,B
2018-04-12 10:00:02,13460.0,4,8168,-2,13455.0,9,13465.0,2,S
2018-04-12 10:00:05,13470.0,2,8170,2,13465.0,10,13470.0,11,B
2018-04-12 10:00:07,13465.0,2,8172,0,13465.0,9,13470.0,10,S
2018-04-12 10:00:13,13470.0,2,8174,-2,13460.0,7,13470.0,13,B
2018-04-12 10:00:30,13470.0,2,8176,0,13465.0,8,13470.0,8,B
2018-04-12 10:00:40,13470.0,16,8192,-8,13470.0,16,13475.0,4,B
2018-04-12 10:00:44,13480.0,4,8196,-2,13480.0,5,13485.0,2,B
2018-04-12 10:00:44,13480.0,2,8198,0,13480.0,4,13485.0,4,B
2018-04-12 10:00:52,13480.0,2,8200,0,13475.0,3,13480.0,5,B
2018-04-12 10:00:53,13475.0,4,8204,-4,13475.0,1,13480.0,3,S
2018-04-12 10:00:53,13475.0,2,8206,-2,13475.0,1,13480.0,3,S
2018-04-12 10:00:55,13475.0,2,8208,-2,13475.0,1,13480.0,3,S
2018-04-12 10:00:56,13475.0,2,8210,0,13470.0,9,13480.0,3,S
2018-04-12 10:00:58,13480.0,2,8212,-2,13470.0,11,13480.0,2,B
2018-04-12 10:01:00,13480.0,2,8214,0,13470.0,8,13475.0,5,B
2018-04-12 10:01:05,13475.0,2,8216,0,13470.0,10,13480.0,9,S
2018-04-12 10:01:09,13475.0,4,8220,0,13470.0,11,13480.0,10,S
2018-04-12 10:01:14,13470.0,2,8222,0,13470.0,9,13475.0,1,S
2018-04-12 10:01:15,13470.0,18,8240,-16,13465.0,5,13475.0,2,S
2018-04-12 10:01:44,13470.0,6,8246,6,13470.0,4,13475.0,2,S
2018-04-12 10:01:45,13475.0,2,8248,2,13470.0,4,13475.0,1,B
2018-04-12 10:02:03,13470.0,2,8250,-2,13465.0,3,13475.0,9,S
2018-04-12 10:02:44,13470.0,2,8252,0,13465.0,5,13470.0,1,S
2018-04-12 10:02:45,13470.0,2,8254,0,13465.0,5,13475.0,15,S
2018-04-12 10:02:47,13475.0,2,8256,-2,13465.0,8,13475.0,9,B
2018-04-12 10:02:58,13465.0,6,8262,-4,13460.0,4,13470.0,1,S
2018-04-12 10:03:26,13465.0,2,8264,-2,13465.0,1,13470.0,9,S
2018-04-12 10:03:26,13465.0,2,8266,0,13460.0,4,13470.0,9,S
2018-04-12 10:03:49,13460.0,2,8268,2,13460.0,5,13470.0,5,S
2018-04-12 10:04:06,13465.0,8,8276,2,13460.0,17,13465.0,17,B
2018-04-12 10:04:08,13465.0,16,8292,0,13460.0,19,13465.0,9,B
2018-04-12 10:04:27,13460.0,4,8296,-2,13455.0,3,13465.0,10,S
2018-04-12 10:04:40,13455.0,10,8306,-8,13450.0,3,13460.0,14,S
2018-04-12 10:04:42,13450.0,2,8308,0,13445.0,5,13455.0,4,S
2018-04-12 10:04:50,13455.0,2,8310,-2,13450.0,6,13460.0,15,B
2018-04-12 10:04:56,13450.0,4,8314,-4,13450.0,5,13460.0,16,S
2018-04-12 10:05:01,13450.0,2,8316,0,13450.0,4,13460.0,17,S
2018-04-12 10:05:12,13450.0,2,8318,0,13450.0,3,13460.0,18,S
2018-04-12 10:05:18,13460.0,6,8324,2,13455.0,8,13460.0,12,B
2018-04-12 10:05:19,13460.0,10,8334,8,13455.0,25,13460.0,7,B
2018-04-12 10:05:20,13455.0,12,8346,8,13455.0,3,13460.0,7,S
2018-04-12 10:05:29,13455.0,6,8352,0,13450.0,20,13460.0,7,S
2018-04-12 10:06:03,13455.0,2,8354,0,13450.0,14,13455.0,10,S
2018-04-12 10:06:06,13450.0,4,8358,0,13450.0,12,13455.0,9,S
2018-04-12 10:06:13,13455.0,8,8366,2,13450.0,42,13460.0,16,B
2018-04-12 10:06:20,13455.0,2,8368,2,13450.0,42,13455.0,3,B
2018-04-12 10:06:29,13450.0,4,8372,4,13450.0,40,13455.0,9,S
2018-04-12 10:06:34,13450.0,28,8400,16,13450.0,26,13455.0,14,S
2018-04-12 10:06:37,13450.0,2,8402,2,13450.0,25,13455.0,11,S
2018-04-12 10:06:45,13450.0,2,8404,2,13445.0,4,13450.0,1,S
2018-04-12 10:06:48,13445.0,6,8410,-2,13445.0,1,13450.0,1,S
2018-04-12 10:06:53,13450.0,2,8412,0,13445.0,2,13450.0,5,B
2018-04-12 10:06:59,13445.0,2,8414,0,13445.0,1,13450.0,11,S
2018-04-12 10:07:00,13445.0,2,8416,0,13440.0,6,13445.0,1,S
2018-04-12 10:07:18,13440.0,4,8420,2,13440.0,6,13445.0,1,S
2018-04-12 10:07:25,13440.0,2,8422,0,13440.0,2,13445.0,1,S
2018-04-12 10:07:27,13440.0,12,8434,-8,13440.0,4,13450.0,9,S
2018-04-12 10:07:28,13450.0,12,8446,8,13445.0,21,13455.0,4,B
2018-04-12 10:07:29,13450.0,2,8448,-2,13445.0,3,13450.0,1,B
2018-04-12 10:07:30,13450.0,2,8450,0,13445.0,3,13455.0,7,B
2018-04-12 10:07:34,13450.0,4,8454,4,13445.0,3,13455.0,8,B
2018-04-12 10:08:08,13445.0,4,8458,0,13440.0,6,13445.0,2,S
2018-04-12 10:08:21,13440.0,10,8468,-4,13435.0,4,13440.0,2,S
2018-04-12 10:08:30,13435.0,4,8472,0,13430.0,5,13440.0,1,S
2018-04-12 10:08:30,13430.0,4,8476,0,13430.0,3,13440.0,1,S
2018-04-12 10:08:39,13440.0,2,8478,0,13435.0,2,13445.0,14,B
2018-04-12 10:08:40,13440.0,2,8480,0,13435.0,3,13445.0,6,B
2018-04-12 10:08:42,13435.0,2,8482,2,13435.0,22,13445.0,3,S
2018-04-12 10:08:54,13445.0,2,8484,0,13435.0,11,13445.0,5,B
2018-04-12 10:08:57,13435.0,14,8498,-12,13430.0,5,13435.0,25,S
2018-04-12 10:08:57,13435.0,6,8504,-6,13430.0,6,13435.0,22,S
2018-04-12 10:09:03,13435.0,2,8506,-2,13430.0,10,13435.0,21,S
2018-04-12 10:09:08,13430.0,2,8508,-2,13430.0,17,13435.0,21,S
2018-04-12 10:09:10,13435.0,8,8516,-6,13430.0,14,13435.0,17,B
2018-04-12 10:09:10,13435.0,12,8528,-6,13430.0,45,13435.0,11,B
2018-04-12 10:09:11,13435.0,4,8532,-4,13430.0,45,13435.0,9,B
2018-04-12 10:09:12,13435.0,10,8542,-10,13430.0,45,13435.0,4,B
2018-04-12 10:09:12,13435.0,2,8544,-2,13430.0,46,13435.0,3,B
2018-04-12 10:09:15,13430.0,20,8564,10,13430.0,36,13435.0,3,S
2018-04-12 10:09:15,13430.0,2,8566,0,13430.0,35,13435.0,3,S
2018-04-12 10:09:27,13435.0,6,8572,-6,13430.0,35,13440.0,3,B
2018-04-12 10:09:34,13435.0,20,8592,-16,13430.0,33,13435.0,40,B
2018-04-12 10:09:34,13440.0,82,8674,-72,13435.0,7,13445.0,2,B
2018-04-12 10:09:41,13445.0,2,8676,0,13440.0,10,13445.0,4,B
2018-04-12 10:09:43,13440.0,2,8678,2,13440.0,9,13445.0,3,S
2018-04-12 10:09:52,13445.0,2,8680,-2,13440.0,9,13445.0,3,B
2018-04-12 10:09:54,13445.0,6,8686,2,13445.0,7,13450.0,5,B
2018-04-12 10:09:54,13445.0,2,8688,2,13445.0,6,13450.0,6,B
2018-04-12 10:09:57,13445.0,14,8702,-2,13440.0,10,13445.0,43,B
2018-04-12 10:10:18,13445.0,16,8718,-16,13440.0,10,13445.0,36,B
2018-04-12 10:10:20,13445.0,18,8736,-18,13440.0,12,13445.0,26,B
2018-04-12 10:10:21,13445.0,4,8740,-4,13440.0,14,13445.0,24,B
2018-04-12 10:10:34,13445.0,20,8760,0,13440.0,14,13445.0,14,B
2018-04-12 10:10:35,13445.0,4,8764,-4,13440.0,14,13445.0,12,B
2018-04-12 10:10:35,13445.0,6,8770,-2,13440.0,14,13445.0,9,B
2018-04-12 10:10:36,13445.0,6,8776,-2,13440.0,14,13445.0,6,B
2018-04-12 10:10:36,13445.0,2,8778,0,13440.0,14,13445.0,5,B
2018-04-12 10:10:37,13445.0,6,8784,-6,13440.0,15,13445.0,2,B
2018-04-12 10:10:37,13445.0,2,8786,-2,13440.0,15,13445.0,1,B
2018-04-12 10:10:38,13445.0,2,8788,0,13440.0,15,13450.0,4,B
2018-04-12 10:10:41,13445.0,2,8790,0,13445.0,9,13450.0,1,B
2018-04-12 10:10:42,13450.0,2,8792,0,13445.0,9,13455.0,6,B
2018-04-12 10:10:57,13450.0,2,8794,0,13445.0,5,13450.0,49,B
2018-04-12 10:10:58,13450.0,2,8796,-2,13445.0,5,13450.0,48,B
2018-04-12 10:11:00,13450.0,2,8798,0,13445.0,1,13450.0,49,B
2018-04-12 10:11:01,13450.0,6,8804,-6,13445.0,1,13450.0,46,B
2018-04-12 10:11:13,13445.0,2,8806,-2,13445.0,2,13450.0,46,S
2018-04-12 10:11:28,13440.0,22,8828,10,13435.0,5,13440.0,39,S
2018-04-12 10:11:28,13440.0,44,8872,6,13435.0,13,13440.0,17,S
2018-04-12 10:11:31,13440.0,4,8876,4,13435.0,10,13440.0,15,S
2018-04-12 10:11:32,13440.0,22,8898,22,13435.0,10,13440.0,4,S
2018-04-12 10:11:33,13440.0,8,8906,8,13440.0,1,13445.0,3,S
2018-04-12 10:11:40,13440.0,4,8910,0,13435.0,8,13440.0,42,S
2018-04-12 10:11:41,13440.0,26,8936,-24,13435.0,3,13440.0,29,S
2018-04-12 10:11:42,13440.0,2,8938,-2,13435.0,3,13440.0,28,S
2018-04-12 10:11:42,13440.0,2,8940,-2,13435.0,3,13440.0,27,S
2018-04-12 10:11:51,13440.0,2,8942,-2,13435.0,5,13440.0,27,S
2018-04-12 10:11:55,13440.0,8,8950,-8,13435.0,5,13440.0,23,S
2018-04-12 10:11:57,13440.0,8,8958,0,13435.0,5,13440.0,20,S
2018-04-12 10:12:02,13440.0,20,8978,0,13435.0,6,13440.0,8,S
2018-04-12 10:12:04,13440.0,4,8982,0,13435.0,6,13440.0,6,S
2018-04-12 10:12:11,13435.0,2,8984,2,13435.0,5,13440.0,6,S
2018-04-12 10:12:12,13435.0,2,8986,2,13435.0,4,13440.0,6,S
2018-04-12 10:12:13,13440.0,8,8994,0,13435.0,4,13440.0,2,B
2018-04-12 10:12:14,13440.0,2,8996,0,13435.0,4,13440.0,1,B
2018-04-12 10:12:17,13440.0,2,8998,0,13435.0,4,13445.0,6,B
2018-04-12 10:12:32,13445.0,18,9016,6,13445.0,16,13450.0,5,B
2018-04-12 10:12:32,13445.0,28,9044,14,13445.0,2,13450.0,5,B
2018-04-12 10:12:33,13445.0,4,9048,4,13440.0,2,13445.0,1,B
2018-04-12 10:12:34,13445.0,2,9050,0,13440.0,2,13450.0,7,B
2018-04-12 10:12:39,13445.0,8,9058,8,13445.0,1,13450.0,6,B
2018-04-12 10:12:40,13445.0,2,9060,0,13440.0,2,13450.0,5,B
2018-04-12 10:12:45,13445.0,2,9062,0,13445.0,24,13450.0,6,B
2018-04-12 10:12:56,13450.0,10,9072,-8,13445.0,24,13455.0,5,B
2018-04-12 10:13:04,13450.0,4,9076,-2,13450.0,3,13455.0,2,B
2018-04-12 10:13:05,13450.0,2,9078,2,13450.0,2,13455.0,4,B
2018-04-12 10:13:16,13455.0,10,9088,8,13455.0,20,13460.0,13,B
2018-04-12 10:13:17,13455.0,2,9090,2,13455.0,19,13460.0,15,B
2018-04-12 10:13:24,13455.0,2,9092,2,13455.0,18,13460.0,11,B
2018-04-12 10:13:28,13460.0,20,9112,8,13460.0,1,13465.0,17,B
2018-04-12 10:13:29,13460.0,2,9114,2,13455.0,23,13460.0,1,B
2018-04-12 10:13:30,13455.0,10,9124,0,13455.0,13,13460.0,12,S
2018-04-12 10:13:31,13460.0,2,9126,-2,13455.0,13,13460.0,2,B
2018-04-12 10:13:47,13465.0,10,9136,6,13455.0,14,13460.0,2,B
2018-04-12 10:13:48,13460.0,4,9140,0,13460.0,3,13465.0,19,S
2018-04-12 10:13:50,13465.0,2,9142,0,13460.0,3,13465.0,19,B
2018-04-12 10:13:51,13460.0,6,9148,0,13455.0,15,13460.0,2,S
2018-04-12 10:14:02,13455.0,24,9172,12,13455.0,3,13460.0,1,S
2018-04-12 10:14:02,13455.0,4,9176,2,13455.0,1,13460.0,7,S
2018-04-12 10:14:03,13455.0,2,9178,2,13450.0,4,13460.0,8,S
2018-04-12 10:14:09,13455.0,2,9180,2,13450.0,3,13460.0,8,S
2018-04-12 10:14:12,13460.0,16,9196,4,13460.0,8,13465.0,19,B
2018-04-12 10:14:13,13460.0,16,9212,10,13460.0,9,13465.0,20,B
2018-04-12 10:14:13,13460.0,12,9224,0,13460.0,3,13465.0,20,B
2018-04-12 10:14:14,13460.0,2,9226,0,13460.0,2,13465.0,20,B
2018-04-12 10:14:15,13460.0,4,9230,0,13455.0,2,13460.0,2,B
2018-04-12 10:14:20,13460.0,2,9232,0,13455.0,4,13460.0,2,B
2018-04-12 10:14:21,13460.0,4,9236,0,13460.0,23,13465.0,16,B
2018-04-12 10:14:22,13460.0,2,9238,0,13460.0,22,13465.0,17,B
2018-04-12 10:14:24,13460.0,2,9240,0,13460.0,21,13465.0,17,B
2018-04-12 10:14:27,13465.0,2,9242,0,13460.0,21,13465.0,15,B
2018-04-12 10:14:29,13460.0,4,9246,4,13460.0,19,13465.0,15,S
2018-04-12 10:14:30,13460.0,4,9250,0,13460.0,17,13465.0,20,S
2018-04-12 10:14:31,13465.0,2,9252,2,13460.0,17,13465.0,19,B
2018-04-12 10:14:36,13465.0,4,9256,0,13460.0,17,13465.0,17,B
2018-04-12 10:30:00,13465.0,2,9258,2,13460.0,17,13465.0,9,B
2018-04-12 10:30:01,13465.0,10,9268,4,13460.0,17,13465.0,4,B
2018-04-12 10:30:05,13460.0,20,9288,0,13460.0,7,13465.0,8,S
2018-04-12 10:30:10,13460.0,4,9292,4,13460.0,5,13465.0,12,S
2018-04-12 10:30:10,13460.0,8,9300,8,13460.0,1,13465.0,12,S
2018-04-12 10:30:11,13460.0,2,9302,2,13455.0,4,13465.0,8,S
2018-04-12 10:30:17,13465.0,4,9306,0,13460.0,18,13465.0,2,B
2018-04-12 10:30:18,13465.0,4,9310,-4,13460.0,6,13465.0,2,B
2018-04-12 10:30:53,13470.0,18,9328,4,13470.0,1,13475.0,16,B
2018-04-12 10:30:59,13475.0,2,9330,0,13470.0,3,13475.0,11,B
2018-04-12 10:31:01,13475.0,2,9332,2,13470.0,3,13475.0,11,B
2018-04-12 10:31:14,13470.0,4,9336,2,13465.0,4,13470.0,2,S
2018-04-12 10:31:15,13465.0,4,9340,2,13465.0,7,13475.0,15,S
2018-04-12 10:31:21,13470.0,2,9342,0,13470.0,6,13475.0,10,B
2018-04-12 10:31:22,13475.0,2,9344,0,13470.0,6,13475.0,9,B
2018-04-12 10:31:23,13475.0,2,9346,2,13470.0,7,13475.0,8,B
2018-04-12 10:31:24,13475.0,16,9362,2,13475.0,1,13480.0,4,B
2018-04-12 10:31:24,13485.0,4,9366,2,13485.0,1,13490.0,5,B
2018-04-12 10:31:25,13490.0,8,9374,8,13490.0,2,13495.0,3,B
2018-04-12 10:31:25,13495.0,10,9384,6,13495.0,1,13500.0,12,B
2018-04-12 10:31:26,13500.0,4,9388,4,13495.0,10,13500.0,9,B
2018-04-12 10:31:26,13495.0,8,9396,2,13490.0,8,13495.0,2,S
2018-04-12 10:31:28,13490.0,2,9398,0,13485.0,2,13490.0,1,S
2018-04-12 10:31:29,13490.0,2,9400,0,13485.0,1,13490.0,1,S
2018-04-12 10:31:38,13475.0,2,9402,0,13475.0,6,13485.0,2,S
2018-04-12 10:31:47,13480.0,4,9406,4,13480.0,9,13485.0,8,B
2018-04-12 10:31:47,13480.0,4,9410,0,13480.0,7,13485.0,8,B
2018-04-12 10:31:53,13480.0,8,9418,8,13480.0,3,13485.0,19,B
2018-04-12 10:31:54,13480.0,6,9424,4,13475.0,3,13480.0,2,B
2018-04-12 10:32:04,13475.0,2,9426,2,13475.0,3,13480.0,4,S
2018-04-12 10:32:30,13475.0,2,9428,-2,13475.0,1,13480.0,7,S
2018-04-12 10:32:31,13475.0,2,9430,0,13470.0,3,13475.0,6,S
2018-04-12 10:32:35,13475.0,12,9442,6,13475.0,19,13480.0,6,S
2018-04-12 10:32:38,13475.0,4,9446,4,13475.0,17,13480.0,5,S
2018-04-12 10:32:38,13475.0,2,9448,0,13475.0,16,13480.0,5,S
2018-04-12 10:32:39,13475.0,2,9450,2,13475.0,15,13480.0,5,S
2018-04-12 10:32:40,13475.0,10,9460,2,13475.0,10,13480.0,12,S
2018-04-12 10:32:40,13475.0,4,9464,4,13475.0,8,13480.0,12,S
2018-04-12 10:32:41,13475.0,16,9480,16,13470.0,3,13475.0,1,S
2018-04-12 10:32:42,13470.0,2,9482,2,13465.0,2,13475.0,3,S
2018-04-12 10:32:54,13465.0,2,9484,2,13465.0,2,13470.0,13,S
2018-04-12 10:33:03,13470.0,2,9486,0,13465.0,4,13470.0,12,B
2018-04-12 10:33:05,13470.0,2,9488,-2,13465.0,4,13470.0,12,B
2018-04-12 10:33:18,13470.0,4,9492,0,13465.0,6,13470.0,13,B
2018-04-12 10:33:21,13470.0,10,9502,-4,13465.0,8,13470.0,8,B
2018-04-12 10:33:22,13470.0,18,9520,4,13470.0,5,13475.0,4,B
2018-04-12 10:33:22,13475.0,4,9524,0,13475.0,1,13480.0,4,B
2018-04-12 10:33:24,13475.0,2,9526,-2,13470.0,5,13480.0,6,B
2018-04-12 10:33:24,13470.0,2,9528,0,13470.0,4,13475.0,1,S
2018-04-12 10:33:29,13470.0,2,9530,0,13470.0,3,13475.0,3,S
2018-04-12 10:33:35,13470.0,2,9532,0,13470.0,3,13475.0,4,S
2018-04-12 10:33:35,13470.0,4,9536,-2,13465.0,5,13475.0,10,S
2018-04-12 10:33:46,13465.0,8,9544,-6,13460.0,4,13465.0,1,S
2018-04-12 10:33:47,13465.0,2,9546,-2,13460.0,4,13465.0,2,S
2018-04-12 10:33:47,13465.0,2,9548,-2,13460.0,9,13465.0,1,S
2018-04-12 10:33:51,13460.0,2,9550,0,13460.0,12,13465.0,1,S
2018-04-12 10:33:52,13480.0,40,9590,-12,13460.0,12,13480.0,3,B
2018-04-12 10:33:53,13470.0,2,9592,0,13465.0,4,13475.0,8,S
2018-04-12 10:34:12,13475.0,30,9622,-16,13465.0,6,13475.0,1,B
2018-04-12 10:34:17,13470.0,2,9624,0,13470.0,7,13475.0,4,S
2018-04-12 10:34:18,13475.0,10,9634,6,13475.0,11,13480.0,8,B
2018-04-12 10:34:19,13475.0,10,9644,10,13475.0,6,13480.0,7,B
2018-04-12 10:34:19,13475.0,4,9648,4,13475.0,4,13480.0,8,B
2018-04-12 10:34:23,13475.0,2,9650,0,13475.0,3,13480.0,6,B
2018-04-12 10:34:24,13475.0,2,9652,2,13475.0,2,13480.0,6,B
2018-04-12 10:34:24,13475.0,4,9656,2,13470.0,7,13480.0,6,B
2018-04-12 10:34:27,13475.0,4,9660,4,13475.0,21,13480.0,6,B
2018-04-12 10:34:29,13475.0,2,9662,2,13475.0,22,13480.0,11,B
2018-04-12 10:34:30,13475.0,2,9664,2,13475.0,31,13480.0,11,B
2018-04-12 10:34:34,13475.0,2,9666,2,13475.0,30,13480.0,12,B
2018-04-12 10:34:36,13475.0,2,9668,2,13475.0,29,13480.0,13,B
2018-04-12 10:34:40,13475.0,2,9670,2,13475.0,28,13480.0,12,B
2018-04-12 10:34:42,13475.0,2,9672,2,13475.0,27,13480.0,13,B
2018-04-12 10:34:44,13480.0,16,9688,-4,13475.0,27,13480.0,5,B
2018-04-12 10:34:46,13475.0,2,9690,2,13475.0,26,13480.0,4,S
2018-04-12 10:34:47,13475.0,2,9692,2,13475.0,35,13480.0,5,S
2018-04-12 10:34:49,13480.0,10,9702,-2,13480.0,15,13485.0,3,B
2018-04-12 10:34:50,13480.0,30,9732,0,13475.0,38,13480.0,3,B
2018-04-12 10:34:50,13485.0,8,9740,6,13480.0,1,13485.0,4,B
2018-04-12 10:34:51,13475.0,20,9760,0,13475.0,29,13485.0,2,S
2018-04-12 10:34:53,13475.0,2,9762,2,13475.0,26,13485.0,6,S
2018-04-12 10:34:54,13475.0,2,9764,2,13475.0,25,13480.0,1,S
2018-04-12 10:34:59,13480.0,2,9766,0,13480.0,9,13485.0,13,B
2018-04-12 10:35:00,13480.0,2,9768,0,13480.0,8,13485.0,13,B
2018-04-12 10:35:04,13490.0,20,9788,-4,13480.0,13,13490.0,2,B
2018-04-12 10:35:06,13485.0,4,9792,0,13480.0,14,13485.0,13,S
2018-04-12 10:35:07,13485.0,8,9800,0,13480.0,14,13485.0,9,S
2018-04-12 10:35:07,13485.0,18,9818,-4,13480.0,16,13490.0,8,S
2018-04-12 10:35:16,13495.0,4,9822,0,13485.0,1,13495.0,7,B
2018-04-12 10:35:28,13490.0,2,9824,2,13490.0,2,13500.0,8,S
2018-04-12 10:35:30,13490.0,2,9826,-2,13490.0,1,13495.0,3,S
2018-04-12 10:35:36,13495.0,6,9832,-2,13495.0,16,13500.0,15,B
2018-04-12 10:35:40,13500.0,26,9858,22,13500.0,7,13505.0,15,B
2018-04-12 10:35:40,13500.0,6,9864,0,13500.0,9,13505.0,14,B
2018-04-12 10:35:41,13505.0,2,9866,0,13500.0,10,13505.0,14,B
2018-04-12 10:35:45,13500.0,2,9868,2,13500.0,8,13505.0,15,S
2018-04-12 10:35:46,13505.0,2,9870,0,13500.0,8,13505.0,14,B
2018-04-12 10:35:49,13500.0,16,9886,2,13495.0,7,13500.0,4,S
2018-04-12 10:35:50,13490.0,22,9908,-4,13490.0,1,13500.0,2,S
2018-04-12 10:35:52,13495.0,2,9910,-2,13485.0,15,13495.0,3,B
2018-04-12 10:35:53,13495.0,2,9912,-2,13485.0,16,13495.0,2,B
2018-04-12 10:36:01,13490.0,8,9920,-2,13490.0,12,13495.0,13,S
2018-04-12 10:36:01,13490.0,20,9940,-14,13490.0,2,13495.0,17,S
2018-04-12 10:36:02,13490.0,4,9944,-4,13485.0,11,13495.0,17,S
2018-04-12 10:36:04,13495.0,16,9960,-2,13485.0,11,13495.0,9,B
2018-04-12 10:36:04,13495.0,10,9970,0,13485.0,11,13495.0,4,B
2018-04-12 10:36:08,13500.0,14,9984,-2,13485.0,11,13500.0,3,B
2018-04-12 10:36:09,13495.0,2,9986,-2,13490.0,8,13500.0,1,S
2018-04-12 10:36:11,13505.0,6,9992,-2,13490.0,19,13505.0,12,B
2018-04-12 10:36:25,13500.0,2,9994,2,13495.0,2,13500.0,1,S
2018-04-12 10:36:25,13500.0,2,9996,0,13500.0,9,13505.0,22,S
2018-04-12 10:36:26,13490.0,24,10020,-18,13495.0,1,13500.0,2,S
2018-04-12 10:36:26,13490.0,2,10022,0,13490.0,15,13500.0,3,S
2018-04-12 10:36:31,13500.0,2,10024,2,13495.0,5,13500.0,1,B
2018-04-12 10:36:32,13495.0,2,10026,0,13495.0,14,13500.0,1,S
2018-04-12 10:36:35,13500.0,2,10028,0,13500.0,7,13505.0,19,B
2018-04-12 10:36:36,13500.0,2,10030,-2,13500.0,6,13505.0,11,B
2018-04-12 10:36:37,13500.0,10,10040,0,13500.0,1,13505.0,10,B
2018-04-12 10:36:38,13500.0,2,10042,0,13495.0,19,13505.0,10,B
2018-04-12 10:36:39,13500.0,2,10044,-2,13495.0,19,13500.0,2,B
2018-04-12 10:36:44,13500.0,2,10046,0,13495.0,20,13500.0,2,B
2018-04-12 10:37:04,13500.0,6,10052,-2,13500.0,8,13505.0,11,B
2018-04-12 10:37:07,13500.0,16,10068,0,13495.0,16,13500.0,1,B
2018-04-12 10:37:24,13500.0,4,10072,4,13495.0,28,13505.0,14,B
2018-04-12 10:38:01,13495.0,4,10076,-4,13495.0,23,13500.0,12,S
2018-04-12 10:38:11,13495.0,2,10078,-2,13495.0,22,13500.0,12,S
2018-04-12 10:38:12,13500.0,14,10092,4,13495.0,22,13500.0,5,B
2018-04-12 10:38:29,13495.0,8,10100,2,13495.0,17,13500.0,7,S
2018-04-12 10:38:30,13495.0,34,10134,14,13490.0,17,13500.0,9,S
2018-04-12 10:38:31,13495.0,2,10136,2,13490.0,20,13500.0,10,S
2018-04-12 10:39:01,13500.0,2,10138,0,13495.0,9,13500.0,9,B
2018-04-12 10:39:13,13495.0,2,10140,0,13495.0,6,13500.0,9,S
2018-04-12 10:39:48,13500.0,12,10152,6,13500.0,3,13505.0,14,B
2018-04-12 10:40:14,13500.0,8,10160,-8,13495.0,17,13505.0,10,B
2018-04-12 10:40:26,13505.0,20,10180,18,13505.0,5,13510.0,17,B
2018-04-12 10:40:26,13505.0,10,10190,4,13500.0,2,13505.0,3,B
2018-04-12 10:40:47,13500.0,2,10192,0,13500.0,1,13505.0,3,S
2018-04-12 10:40:54,13500.0,2,10194,0,13500.0,1,13505.0,5,S
2018-04-12 10:40:59,13495.0,8,10202,-4,13495.0,28,13505.0,4,S
2018-04-12 10:40:59,13495.0,4,10206,-4,13495.0,26,13505.0,4,S
2018-04-12 10:41:09,13505.0,2,10208,2,13500.0,10,13505.0,6,B
2018-04-12 10:41:15,13505.0,2,10210,0,13500.0,10,13505.0,4,B
2018-04-12 10:41:16,13505.0,8,10218,4,13505.0,2,13510.0,15,B
2018-04-12 10:41:17,13510.0,26,10244,6,13510.0,2,13515.0,11,B
2018-04-12 10:41:18,13515.0,24,10268,8,13515.0,1,13520.0,21,B
2018-04-12 10:41:18,13520.0,14,10282,6,13515.0,6,13520.0,13,B
2018-04-12 10:41:19,13520.0,2,10284,0,13515.0,8,13520.0,13,B
2018-04-12 10:41:20,13515.0,4,10288,-2,13510.0,8,13520.0,13,S
2018-04-12 10:41:22,13510.0,2,10290,0,13510.0,4,13520.0,17,S
2018-04-12 10:41:27,13515.0,2,10292,0,13505.0,5,13515.0,4,B
2018-04-12 10:41:32,13515.0,6,10298,4,13515.0,12,13520.0,17,B
2018-04-12 10:41:32,13505.0,36,10334,2,13505.0,7,13515.0,2,S
2018-04-12 10:41:33,13505.0,8,10342,-6,13505.0,4,13515.0,6,S
2018-04-12 10:41:35,13510.0,2,10344,0,13505.0,4,13510.0,2,B
2018-04-12 10:41:44,13510.0,2,10346,0,13505.0,11,13515.0,3,B
2018-04-12 10:41:56,13505.0,2,10348,-2,13505.0,10,13515.0,4,S
2018-04-12 10:42:03,13515.0,4,10352,0,13510.0,14,13520.0,19,B
2018-04-12 10:42:19,13520.0,2,10354,2,13515.0,1,13520.0,17,B
2018-04-12 10:42:27,13520.0,2,10356,2,13515.0,2,13520.0,16,B
2018-04-12 10:42:37,13515.0,4,10360,4,13510.0,14,13520.0,18,S
2018-04-12 10:42:44,13510.0,4,10364,-2,13510.0,11,13515.0,6,S
2018-04-12 10:42:45,13510.0,2,10366,2,13510.0,5,13515.0,8,S
2018-04-12 10:42:48,13510.0,2,10368,0,13510.0,11,13515.0,3,S
2018-04-12 10:43:10,13515.0,6,10374,-4,13510.0,1,13515.0,2,B
2018-04-12 10:43:20,13510.0,2,10376,-2,13510.0,1,13515.0,5,S
2018-04-12 10:43:20,13510.0,2,10378,-2,13505.0,4,13515.0,5,S
2018-04-12 10:44:24,13510.0,4,10382,2,13505.0,19,13515.0,8,S
2018-04-12 10:44:54,13510.0,2,10384,2,13505.0,20,13515.0,5,S
2018-04-12 10:45:08,13510.0,2,10386,0,13510.0,11,13515.0,2,S
2018-04-12 10:45:11,13510.0,4,10390,2,13510.0,9,13515.0,2,S
2018-04-12 10:45:35,13510.0,2,10392,0,13510.0,16,13515.0,1,S
2018-04-12 10:45:48,13510.0,2,10394,-2,13510.0,16,13515.0,1,S
2018-04-12 10:45:50,13515.0,2,10396,2,13510.0,16,13520.0,21,B
2018-04-12 10:46:08,13510.0,2,10398,0,13510.0,13,13515.0,2,S
2018-04-12 10:46:18,13510.0,4,10402,-4,13510.0,6,13515.0,8,S
2018-04-12 10:46:19,13510.0,2,10404,-2,13510.0,5,13515.0,8,S
2018-04-12 10:46:26,13510.0,2,10406,0,13510.0,9,13515.0,2,S
2018-04-12 10:47:13,13510.0,8,10414,0,13505.0,5,13510.0,4,S
2018-04-12 10:47:16,13505.0,2,10416,2,13505.0,3,13510.0,4,S
2018-04-12 10:47:17,13505.0,4,10420,-4,13505.0,1,13510.0,4,S
2018-04-12 10:47:17,13505.0,2,10422,0,13500.0,5,13510.0,4,S
2018-04-12 10:47:37,13500.0,10,10432,-10,13500.0,4,13505.0,20,S
2018-04-12 10:47:39,13505.0,2,10434,-2,13500.0,4,13505.0,19,B
2018-04-12 10:47:41,13505.0,2,10436,-2,13500.0,4,13505.0,18,B
2018-04-12 10:47:49,13500.0,2,10438,0,13500.0,3,13505.0,18,S
2018-04-12 10:47:50,13500.0,2,10440,-2,13500.0,2,13505.0,18,S
2018-04-12 10:48:15,13500.0,4,10444,2,13495.0,14,13500.0,17,S
2018-04-12 10:48:16,13500.0,8,10452,-8,13495.0,19,13500.0,13,S
2018-04-12 10:48:18,13500.0,12,10464,0,13495.0,23,13500.0,8,S
2018-04-12 10:48:31,13495.0,2,10466,0,13495.0,9,13500.0,8,S
2018-04-12 10:49:16,13500.0,2,10468,0,13495.0,11,13500.0,8,B
2018-04-12 10:49:42,13500.0,2,10470,0,13495.0,11,13500.0,8,B
2018-04-12 10:49:43,13500.0,16,10486,-10,13500.0,3,13505.0,3,B
2018-04-12 10:49:46,13505.0,2,10488,-2,13505.0,7,13510.0,4,B
2018-04-12 10:49:46,13510.0,2,10490,0,13505.0,5,13515.0,6,B
2018-04-12 10:50:33,13515.0,6,10496,-4,13515.0,2,13520.0,23,B
2018-04-12 10:50:35,13520.0,16,10512,4,13515.0,7,13520.0,12,B
2018-04-12 10:50:35,13520.0,2,10514,0,13515.0,6,13520.0,11,B
2018-04-12 10:50:36,13520.0,4,10518,-4,13515.0,6,13520.0,9,B
2018-04-12 10:50:36,13520.0,18,10536,14,13515.0,6,13525.0,7,B
2018-04-12 10:50:37,13525.0,6,10542,-2,13525.0,2,13530.0,19,B
2018-04-12 10:50:38,13520.0,6,10548,-4,13520.0,7,13525.0,5,S
2018-04-12 10:50:43,13525.0,2,10550,0,13525.0,4,13530.0,19,B
2018-04-12 10:50:44,13530.0,2,10552,0,13525.0,3,13530.0,17,B
2018-04-12 10:50:46,13525.0,8,10560,0,13520.0,6,13530.0,18,S
2018-04-12 10:50:56,13530.0,6,10566,0,13525.0,3,13530.0,15,B
2018-04-12 10:50:56,13530.0,6,10572,6,13525.0,3,13530.0,12,B
2018-04-12 10:50:57,13530.0,16,10588,16,13525.0,3,13530.0,4,B
2018-04-12 10:51:02,13530.0,4,10592,4,13525.0,3,13530.0,4,B
2018-04-12 10:51:03,13530.0,8,10600,4,13530.0,4,13535.0,5,B
2018-04-12 10:51:04,13540.0,10,10610,8,13535.0,1,13540.0,14,B
2018-04-12 10:51:04,13540.0,4,10614,2,13535.0,10,13540.0,10,B
2018-04-12 10:51:05,13545.0,24,10638,0,13545.0,1,13550.0,21,B
2018-04-12 10:51:05,13545.0,4,10642,-2,13545.0,1,13550.0,21,B
2018-04-12 10:51:06,13550.0,30,10672,20,13545.0,2,13550.0,6,B
2018-04-12 10:51:06,13560.0,28,10700,-2,13550.0,26,13560.0,3,B
2018-04-12 10:51:07,13560.0,8,10708,0,13560.0,4,13565.0,8,B
2018-04-12 10:51:07,13550.0,16,10724,6,13550.0,1,13555.0,2,S
2018-04-12 10:51:08,13555.0,2,10726,0,13550.0,1,13560.0,6,B
2018-04-12 10:51:09,13550.0,2,10728,2,13550.0,2,13560.0,4,S
2018-04-12 10:51:13,13565.0,12,10740,4,13560.0,3,13565.0,2,B
2018-04-12 10:51:14,13555.0,10,10750,4,13555.0,2,13565.0,1,S
2018-04-12 10:51:16,13565.0,2,10752,2,13555.0,5,13565.0,1,B
2018-04-12 10:51:17,13565.0,2,10754,0,13555.0,5,13570.0,3,B
2018-04-12 10:51:20,13560.0,4,10758,0,13560.0,3,13570.0,7,S
2018-04-12 10:51:20,13565.0,2,10760,-2,13560.0,6,13570.0,3,B
2018-04-12 10:51:22,13570.0,6,10766,-2,13565.0,2,13575.0,4,B
2018-04-12 10:51:22,13570.0,2,10768,-2,13570.0,7,13575.0,3,B
2018-04-12 10:51:23,13570.0,26,10794,12,13575.0,1,13580.0,5,B
2018-04-12 10:51:23,13570.0,8,10802,4,13565.0,5,13575.0,9,B
2018-04-12 10:51:25,13570.0,2,10804,-2,13565.0,4,13575.0,7,B
2018-04-12 10:51:28,13570.0,2,10806,-2,13560.0,6,13570.0,2,B
2018-04-12 10:51:28,13575.0,8,10814,0,13565.0,2,13575.0,7,B
2018-04-12 10:51:33,13575.0,2,10816,-2,13565.0,5,13575.0,6,B
2018-04-12 10:51:35,13565.0,4,10820,4,13565.0,2,13570.0,1,S
2018-04-12 10:51:35,13565.0,4,10824,4,13560.0,1,13570.0,2,S
2018-04-12 10:51:37,13570.0,2,10826,0,13560.0,3,13575.0,10,B
2018-04-12 10:51:38,13570.0,4,10830,4,13565.0,2,13570.0,2,B
2018-04-12 10:51:41,13570.0,2,10832,0,13565.0,1,13570.0,4,B
2018-04-12 10:51:43,13565.0,2,10834,2,13560.0,2,13570.0,5,S
2018-04-12 10:51:47,13565.0,2,10836,-2,13560.0,3,13570.0,7,S
2018-04-12 10:51:48,13560.0,4,10840,-2,13555.0,2,13560.0,6,S
2018-04-12 10:51:49,13560.0,4,10844,0,13555.0,2,13560.0,5,S
2018-04-12 10:51:49,13560.0,4,10848,0,13555.0,2,13560.0,3,S
2018-04-12 10:51:50,13560.0,4,10852,0,13555.0,1,13560.0,1,S
2018-04-12 10:51:50,13560.0,2,10854,2,13555.0,1,13565.0,5,S
2018-04-12 10:51:53,13565.0,2,10856,0,13560.0,2,13565.0,3,B
2018-04-12 10:51:54,13565.0,4,10860,0,13560.0,2,13565.0,1,B
2018-04-12 10:52:01,13565.0,4,10864,-2,13560.0,10,13570.0,6,B
2018-04-12 10:52:02,13560.0,2,10866,2,13560.0,9,13570.0,5,S
2018-04-12 10:52:04,13570.0,2,10868,2,13565.0,21,13570.0,3,B
2018-04-12 10:52:04,13570.0,2,10870,0,13565.0,21,13570.0,2,B
2018-04-12 10:52:05,13570.0,8,10878,-4,13565.0,14,13575.0,32,B
2018-04-12 10:52:07,13570.0,2,10880,0,13570.0,2,13575.0,31,B
2018-04-12 10:52:08,13575.0,4,10884,0,13570.0,17,13575.0,27,B
2018-04-12 10:52:10,13575.0,2,10886,0,13570.0,17,13575.0,26,B
2018-04-12 10:52:10,13570.0,2,10888,0,13570.0,6,13575.0,26,S
2018-04-12 10:52:11,13575.0,40,10928,-12,13570.0,13,13575.0,6,B
2018-04-12 10:52:14,13570.0,2,10930,2,13570.0,7,13575.0,7,S
2018-04-12 10:52:14,13570.0,14,10944,6,13560.0,4,13575.0,9,S
2018-04-12 10:52:15,13570.0,2,10946,0,13565.0,2,13570.0,1,S
2018-04-12 10:52:16,13570.0,2,10948,2,13565.0,2,13570.0,1,S
2018-04-12 10:52:16,13570.0,2,10950,2,13565.0,2,13575.0,13,S
2018-04-12 10:52:18,13570.0,2,10952,0,13565.0,3,13575.0,12,S
2018-04-12 10:52:19,13570.0,2,10954,0,13565.0,3,13575.0,12,S
2018-04-12 10:52:19,13570.0,2,10956,2,13565.0,3,13575.0,13,S
2018-04-12 10:52:24,13570.0,4,10960,4,13565.0,3,13570.0,1,S
2018-04-12 10:52:37,13570.0,10,10970,4,13560.0,24,13570.0,3,S
2018-04-12 10:52:39,13560.0,2,10972,0,13560.0,23,13570.0,4,S
2018-04-12 10:52:40,13570.0,8,10980,2,13570.0,1,13575.0,15,B
2018-04-12 10:52:42,13570.0,2,10982,2,13570.0,1,13575.0,13,B
2018-04-12 10:52:44,13570.0,2,10984,2,13565.0,9,13575.0,15,B
2018-04-12 10:52:49,13570.0,4,10988,4,13565.0,10,13570.0,1,B
2018-04-12 10:52:49,13570.0,2,10990,2,13570.0,1,13575.0,16,B
2018-04-12 10:52:50,13570.0,4,10994,2,13565.0,10,13575.0,16,B
2018-04-12 10:52:59,13570.0,2,10996,-2,13570.0,3,13575.0,15,B
2018-04-12 10:53:02,13575.0,4,11000,4,13570.0,8,13575.0,10,B
2018-04-12 10:53:02,13570.0,2,11002,0,13570.0,7,13575.0,10,S
2018-04-12 10:53:03,13575.0,4,11006,4,13570.0,4,13575.0,8,B
2018-04-12 10:53:04,13575.0,4,11010,4,13570.0,4,13575.0,6,B
2018-04-12 10:53:05,13575.0,4,11014,4,13570.0,4,13575.0,4,B
2018-04-12 10:53:05,13575.0,2,11016,2,13570.0,3,13575.0,3,B
2018-04-12 10:53:06,13575.0,4,11020,4,13570.0,2,13575.0,1,B
2018-04-12 10:53:07,13575.0,2,11022,0,13570.0,11,13580.0,32,B
2018-04-12 10:53:10,13575.0,2,11024,0,13575.0,7,13580.0,31,B
2018-04-12 10:53:11,13575.0,4,11028,4,13570.0,4,13580.0,32,B
2018-04-12 10:53:12,13575.0,2,11030,0,13570.0,9,13580.0,33,B
2018-04-12 10:53:13,13575.0,4,11034,2,13570.0,9,13580.0,33,B
2018-04-12 10:53:20,13580.0,2,11036,2,13575.0,2,13580.0,31,B
2018-04-12 10:53:20,13575.0,2,11038,2,13575.0,1,13580.0,31,S
2018-04-12 10:53:21,13575.0,2,11040,2,13570.0,3,13575.0,2,S
2018-04-12 10:53:31,13570.0,4,11044,0,13565.0,3,13575.0,19,S
2018-04-12 10:53:43,13570.0,2,11046,2,13570.0,1,13575.0,18,S
2018-04-12 10:53:44,13570.0,2,11048,0,13570.0,1,13575.0,18,S
2018-04-12 10:53:44,13570.0,2,11050,0,13565.0,5,13575.0,18,S
2018-04-12 10:53:46,13570.0,2,11052,0,13570.0,1,13575.0,18,S
2018-04-12 10:53:46,13570.0,2,11054,0,13565.0,5,13570.0,1,S
2018-04-12 10:53:49,13565.0,14,11068,0,13560.0,20,13565.0,3,S
2018-04-12 10:53:50,13575.0,10,11078,-2,13565.0,5,13575.0,17,B
2018-04-12 10:53:51,13575.0,4,11082,4,13565.0,5,13575.0,16,B
2018-04-12 10:54:01,13570.0,2,11084,2,13570.0,13,13575.0,17,S
2018-04-12 10:54:03,13575.0,2,11086,2,13570.0,13,13575.0,14,B
2018-04-12 10:54:03,13575.0,2,11088,2,13570.0,13,13575.0,13,B
2018-04-12 10:54:04,13575.0,2,11090,2,13570.0,13,13575.0,12,B
2018-04-12 10:54:05,13575.0,2,11092,2,13570.0,13,13575.0,11,B
2018-04-12 10:54:06,13575.0,2,11094,2,13570.0,13,13575.0,10,B
2018-04-12 10:54:06,13575.0,6,11100,2,13570.0,13,13575.0,7,B
2018-04-12 10:54:07,13575.0,14,11114,14,13575.0,5,13580.0,37,B
2018-04-12 10:54:07,13575.0,2,11116,2,13575.0,4,13580.0,37,B
2018-04-12 10:54:12,13575.0,16,11132,4,13575.0,5,13580.0,25,B
2018-04-12 10:54:13,13580.0,36,11168,22,13575.0,6,13580.0,7,B
2018-04-12 10:54:13,13580.0,14,11182,8,13580.0,1,13585.0,6,B
2018-04-12 10:54:14,13585.0,2,11184,2,13580.0,8,13585.0,4,B
2018-04-12 10:54:15,13580.0,4,11188,2,13580.0,9,13585.0,2,S
2018-04-12 10:54:16,13585.0,2,11190,2,13580.0,11,13585.0,1,B
2018-04-12 10:54:16,13585.0,2,11192,0,13580.0,8,13585.0,3,B
2018-04-12 10:54:17,13585.0,4,11196,0,13580.0,7,13585.0,4,B
2018-04-12 10:54:17,13585.0,4,11200,0,13580.0,6,13585.0,3,B
2018-04-12 10:54:18,13575.0,6,11206,2,13570.0,2,13580.0,4,S
2018-04-12 10:54:19,13580.0,2,11208,0,13570.0,2,13580.0,4,B
2018-04-12 10:54:20,13580.0,4,11212,0,13570.0,8,13580.0,2,B
2018-04-12 10:54:21,13580.0,4,11216,0,13570.0,13,13580.0,1,B
2018-04-12 10:54:22,13580.0,4,11220,0,13570.0,14,13585.0,8,B
2018-04-12 10:54:27,13585.0,4,11224,2,13575.0,10,13585.0,1,B
2018-04-12 10:54:27,13585.0,4,11228,2,13575.0,15,13590.0,6,B
2018-04-12 10:54:28,13575.0,2,11230,0,13575.0,6,13585.0,4,S
2018-04-12 10:54:36,13585.0,2,11232,0,13585.0,1,13590.0,6,B
2018-04-12 10:54:37,13585.0,2,11234,0,13580.0,5,13590.0,4,B
2018-04-12 10:54:38,13585.0,2,11236,2,13580.0,5,13585.0,6,B
2018-04-12 10:54:39,13585.0,4,11240,2,13580.0,5,13590.0,5,B
2018-04-12 10:54:44,13585.0,2,11242,2,13585.0,4,13590.0,3,B
2018-04-12 10:54:45,13590.0,4,11246,2,13585.0,6,13590.0,1,B
2018-04-12 10:54:47,13590.0,2,11248,0,13585.0,7,13590.0,1,B
2018-04-12 10:54:47,13590.0,2,11250,2,13590.0,2,13595.0,19,B
2018-04-12 10:54:48,13595.0,16,11266,10,13590.0,2,13595.0,9,B
2018-04-12 10:54:48,13590.0,4,11270,-2,13585.0,6,13595.0,9,S
2018-04-12 10:54:49,13590.0,2,11272,2,13585.0,6,13595.0,9,S
2018-04-12 10:54:50,13595.0,4,11276,4,13585.0,8,13595.0,7,B
2018-04-12 10:54:51,13595.0,10,11286,10,13585.0,7,13595.0,2,B
2018-04-12 10:54:52,13595.0,4,11290,4,13585.0,9,13595.0,1,B
2018-04-12 10:54:52,13595.0,2,11292,0,13595.0,1,13600.0,17,B
2018-04-12 10:54:53,13595.0,2,11294,2,13590.0,1,13600.0,17,B
2018-04-12 10:54:56,13600.0,16,11310,-8,13595.0,1,13600.0,9,B
2018-04-12 10:54:56,13600.0,4,11314,0,13595.0,1,13600.0,7,B
2018-04-12 10:54:59,13600.0,4,11318,0,13595.0,6,13600.0,3,B
2018-04-12 10:55:01,13600.0,6,11324,4,13595.0,6,13600.0,3,B
2018-04-12 10:55:01,13600.0,6,11330,0,13600.0,4,13605.0,3,B
2018-04-12 10:55:02,13605.0,4,11334,4,13605.0,1,13610.0,15,B
2018-04-12 10:55:02,13605.0,2,11336,2,13600.0,8,13610.0,14,B
2018-04-12 10:55:04,13605.0,2,11338,0,13605.0,3,13610.0,14,B
2018-04-12 10:55:05,13605.0,6,11344,0,13605.0,5,13610.0,16,B
2018-04-12 10:55:05,13605.0,10,11354,4,13600.0,4,13605.0,4,B
2018-04-12 10:55:06,13600.0,2,11356,0,13600.0,3,13605.0,7,S
2018-04-12 10:55:07,13605.0,6,11362,6,13600.0,3,13605.0,1,B
2018-04-12 10:55:08,13605.0,2,11364,2,13600.0,3,13610.0,33,B
2018-04-12 10:55:09,13610.0,4,11368,4,13600.0,6,13610.0,27,B
2018-04-12 10:55:10,13600.0,10,11378,8,13600.0,3,13610.0,25,S
2018-04-12 10:55:12,13605.0,2,11380,2,13605.0,1,13610.0,25,B
2018-04-12 10:55:12,13605.0,2,11382,0,13600.0,3,13610.0,25,B
2018-04-12 10:55:14,13605.0,2,11384,2,13605.0,1,13610.0,25,B
2018-04-12 10:55:14,13605.0,2,11386,0,13600.0,4,13610.0,25,B
2018-04-12 10:55:15,13605.0,2,11388,0,13600.0,11,13610.0,25,B
2018-04-12 10:55:16,13600.0,4,11392,4,13600.0,10,13610.0,26,S
2018-04-12 10:55:19,13610.0,4,11396,4,13600.0,13,13610.0,22,B
2018-04-12 10:55:20,13610.0,4,11400,4,13600.0,13,13610.0,20,B
2018-04-12 10:55:20,13610.0,6,11406,2,13600.0,14,13610.0,17,B
2018-04-12 10:55:21,13610.0,4,11410,4,13600.0,14,13610.0,15,B
2018-04-12 10:55:21,13610.0,8,11418,8,13605.0,13,13610.0,11,B
2018-04-12 10:55:22,13610.0,2,11420,2,13605.0,13,13610.0,10,B
2018-04-12 10:55:23,13610.0,4,11424,4,13600.0,22,13610.0,9,B
2018-04-12 10:55:24,13610.0,4,11428,4,13600.0,22,13610.0,7,B
2018-04-12 10:55:24,13610.0,2,11430,2,13600.0,22,13610.0,6,B
2018-04-12 10:55:25,13610.0,2,11432,0,13600.0,11,13605.0,2,B
2018-04-12 10:55:29,13605.0,2,11434,2,13605.0,1,13610.0,8,S
2018-04-12 10:55:30,13605.0,2,11436,0,13600.0,12,13610.0,8,S
2018-04-12 10:55:31,13610.0,4,11440,4,13600.0,22,13610.0,5,B
2018-04-12 10:55:32,13610.0,4,11444,4,13600.0,12,13610.0,5,B
2018-04-12 10:55:33,13610.0,2,11446,0,13600.0,22,13610.0,1,B
2018-04-12 10:55:34,13610.0,2,11448,2,13605.0,1,13610.0,1,B
2018-04-12 10:55:35,13610.0,4,11452,0,13605.0,3,13615.0,12,B
2018-04-12 10:55:35,13605.0,6,11458,0,13605.0,1,13610.0,35,S
2018-04-12 10:55:36,13610.0,2,11460,0,13605.0,4,13610.0,34,B
2018-04-12 10:55:36,13610.0,4,11464,4,13605.0,4,13610.0,32,B
2018-04-12 10:55:37,13610.0,10,11474,4,13605.0,4,13610.0,28,B
2018-04-12 10:55:38,13610.0,56,11530,46,13610.0,3,13615.0,9,B
2018-04-12 10:55:39,13610.0,16,11546,-10,13605.0,3,13610.0,1,B
2018-04-12 10:55:40,13610.0,2,11548,2,13600.0,12,13610.0,5,B
2018-04-12 10:55:40,13610.0,2,11550,0,13605.0,2,13610.0,1,B
2018-04-12 10:55:41,13610.0,2,11552,0,13610.0,1,13615.0,13,B
2018-04-12 10:55:42,13610.0,4,11556,4,13605.0,3,13610.0,8,B
2018-04-12 10:55:43,13610.0,2,11558,2,13605.0,2,13610.0,7,B
2018-04-12 10:55:44,13605.0,2,11560,-2,13600.0,11,13605.0,15,S
2018-04-12 10:55:44,13600.0,12,11572,8,13600.0,5,13605.0,12,S
2018-04-12 10:55:45,13605.0,6,11578,2,13600.0,5,13605.0,9,B
2018-04-12 10:55:45,13600.0,2,11580,2,13600.0,4,13605.0,8,S
2018-04-12 10:55:46,13605.0,4,11584,4,13600.0,4,13605.0,6,B
2018-04-12 10:55:47,13600.0,2,11586,0,13600.0,3,13605.0,6,S
2018-04-12 10:55:48,13600.0,4,11590,-2,13600.0,1,13605.0,5,S
2018-04-12 10:55:48,13600.0,2,11592,0,13595.0,2,13600.0,3,S
2018-04-12 10:55:50,13590.0,4,11596,4,13585.0,2,13590.0,3,S
2018-04-12 10:55:50,13595.0,4,11600,0,13590.0,1,13595.0,8,B
2018-04-12 10:55:51,13590.0,4,11604,0,13585.0,3,13590.0,3,S
2018-04-12 10:55:51,13590.0,4,11608,2,13585.0,1,13590.0,1,S
2018-04-12 10:55:52,13590.0,8,11616,0,13585.0,1,13590.0,2,S
2018-04-12 10:55:53,13595.0,4,11620,0,13580.0,5,13595.0,6,B
2018-04-12 10:55:53,13590.0,2,11622,2,13580.0,9,13590.0,2,S
2018-04-12 10:55:58,13590.0,2,11624,0,13590.0,1,13595.0,8,S
2018-04-12 10:55:59,13595.0,2,11626,0,13590.0,1,13595.0,5,B
2018-04-12 10:55:59,13595.0,2,11628,0,13590.0,1,13595.0,4,B
2018-04-12 10:56:01,13590.0,2,11630,0,13585.0,5,13595.0,4,S
2018-04-12 10:56:03,13595.0,14,11644,-6,13580.0,6,13595.0,4,B
2018-04-12 10:56:04,13595.0,6,11650,2,13585.0,5,13595.0,1,B
2018-04-12 10:56:04,13595.0,4,11654,0,13585.0,7,13595.0,2,B
2018-04-12 10:56:07,13595.0,4,11658,0,13590.0,1,13600.0,4,B
2018-04-12 10:56:08,13595.0,4,11662,0,13585.0,3,13600.0,4,B
2018-04-12 10:56:10,13595.0,2,11664,0,13590.0,7,13600.0,3,B
2018-04-12 10:56:10,13600.0,2,11666,0,13600.0,1,13605.0,6,B
2018-04-12 10:56:12,13600.0,2,11668,0,13595.0,4,13605.0,4,B
2018-04-12 10:56:13,13605.0,2,11670,0,13595.0,4,13605.0,3,B
2018-04-12 10:56:14,13605.0,4,11674,-4,13600.0,1,13605.0,2,B
2018-04-12 10:56:15,13600.0,2,11676,2,13600.0,1,13605.0,3,S
2018-04-12 10:56:16,13600.0,2,11678,0,13595.0,4,13600.0,1,S
2018-04-12 10:56:17,13600.0,2,11680,2,13600.0,1,13605.0,4,S
2018-04-12 10:56:18,13600.0,2,11682,2,13595.0,2,13600.0,7,S
2018-04-12 10:56:21,13600.0,2,11684,0,13600.0,1,13605.0,9,S
2018-04-12 10:56:22,13600.0,2,11686,0,13595.0,5,13600.0,1,S
2018-04-12 10:56:23,13605.0,2,11688,2,13600.0,1,13605.0,7,B
2018-04-12 10:56:23,13600.0,2,11690,2,13595.0,4,13600.0,5,S
2018-04-12 10:56:24,13600.0,2,11692,2,13595.0,5,13600.0,4,S
2018-04-12 10:56:25,13600.0,2,11694,2,13595.0,5,13600.0,3,S
2018-04-12 10:56:26,13600.0,2,11696,2,13595.0,4,13600.0,2,S
2018-04-12 10:56:27,13600.0,2,11698,2,13595.0,4,13600.0,1,S
2018-04-12 10:56:27,13600.0,2,11700,2,13595.0,4,13605.0,7,S
2018-04-12 10:56:29,13600.0,2,11702,2,13595.0,5,13605.0,7,S
2018-04-12 10:56:34,13595.0,8,11710,0,13590.0,5,13595.0,1,S
2018-04-12 10:56:35,13600.0,12,11722,12,13600.0,5,13605.0,7,B
2018-04-12 10:56:35,13600.0,6,11728,2,13600.0,2,13605.0,7,B
2018-04-12 10:56:36,13600.0,4,11732,0,13595.0,3,13600.0,1,B
2018-04-12 10:56:38,13595.0,2,11734,2,13590.0,4,13600.0,8,S
2018-04-12 10:56:41,13600.0,2,11736,2,13590.0,4,13600.0,7,B
2018-04-12 10:56:49,13600.0,2,11738,2,13590.0,1,13600.0,6,B
2018-04-12 10:56:57,13585.0,4,11742,0,13585.0,1,13590.0,10,S
2018-04-12 10:56:57,13585.0,2,11744,2,13580.0,6,13585.0,6,S
2018-04-12 10:56:58,13585.0,4,11748,0,13580.0,5,13585.0,3,S
2018-04-12 10:56:59,13585.0,6,11754,4,13585.0,1,13590.0,2,S
2018-04-12 10:57:06,13580.0,2,11756,0,13580.0,6,13590.0,6,S
2018-04-12 10:57:06,13580.0,4,11760,-2,13585.0,1,13595.0,5,S
2018-04-12 10:57:08,13585.0,8,11768,6,13585.0,8,13595.0,7,B
2018-04-12 10:57:10,13580.0,2,11770,0,13580.0,8,13590.0,6,S
2018-04-12 10:57:13,13580.0,2,11772,-2,13580.0,5,13590.0,4,S
2018-04-12 10:57:18,13585.0,2,11774,0,13585.0,4,13590.0,1,B
2018-04-12 10:57:18,13590.0,2,11776,2,13590.0,9,13595.0,6,B
2018-04-12 10:57:19,13590.0,4,11780,0,13590.0,7,13595.0,6,B
2018-04-12 10:57:26,13585.0,2,11782,-2,13580.0,6,13590.0,10,S
2018-04-12 10:57:30,13590.0,2,11784,2,13580.0,7,13590.0,7,B
2018-04-12 10:57:31,13585.0,2,11786,0,13580.0,7,13590.0,9,S
2018-04-12 10:57:34,13585.0,2,11788,0,13580.0,7,13590.0,9,S
2018-04-12 10:57:40,13590.0,4,11792,4,13590.0,8,13595.0,8,B
2018-04-12 10:57:40,13590.0,4,11796,4,13590.0,6,13595.0,7,B
2018-04-12 10:57:54,13585.0,2,11798,2,13580.0,7,13590.0,9,S
2018-04-12 10:57:55,13580.0,2,11800,2,13580.0,6,13590.0,9,S
2018-04-12 10:58:04,13585.0,2,11802,2,13580.0,7,13590.0,10,B
2018-04-12 10:58:11,13585.0,6,11808,4,13585.0,7,13590.0,2,B
2018-04-12 10:58:11,13590.0,4,11812,0,13590.0,2,13595.0,4,B
2018-04-12 10:58:13,13585.0,2,11814,0,13585.0,6,13595.0,4,S
2018-04-12 10:58:14,13590.0,2,11816,0,13585.0,5,13595.0,3,B
2018-04-12 10:58:27,13595.0,2,11818,2,13585.0,6,13595.0,3,B
2018-04-12 10:58:32,13590.0,2,11820,0,13590.0,1,13595.0,3,S
2018-04-12 10:58:33,13595.0,4,11824,0,13590.0,1,13595.0,1,B
2018-04-12 10:58:42,13590.0,10,11834,2,13585.0,4,13595.0,5,S
2018-04-12 10:58:42,13600.0,20,11854,8,13595.0,13,13600.0,12,B
2018-04-12 10:58:43,13600.0,30,11884,16,13590.0,1,13600.0,14,B
2018-04-12 10:58:50,13600.0,4,11888,4,13585.0,5,13595.0,10,B
2018-04-12 10:58:55,13595.0,4,11892,0,13585.0,7,13595.0,10,S
2018-04-12 10:59:17,13585.0,16,11908,10,13580.0,9,13585.0,11,S
2018-04-12 10:59:18,13585.0,18,11926,4,13580.0,9,13585.0,2,S
2018-04-12 10:59:18,13585.0,4,11930,4,13580.0,10,13590.0,2,S
2018-04-12 10:59:27,13585.0,2,11932,0,13585.0,1,13590.0,4,S
2018-04-12 10:59:35,13585.0,2,11934,0,13580.0,10,13590.0,4,S
2018-04-12 10:59:43,13585.0,2,11936,-2,13585.0,2,13590.0,6,S
2018-04-12 10:59:53,13590.0,2,11938,0,13585.0,2,13590.0,5,B
2018-04-12 10:59:58,13590.0,4,11942,0,13585.0,5,13590.0,1,B
2018-04-12 10:59:59,13590.0,2,11944,2,13590.0,1,13595.0,7,B
2018-04-12 11:00:00,13590.0,2,11946,0,13585.0,5,13595.0,6,B
2018-04-12 11:00:02,13590.0,2,11948,0,13585.0,1,13590.0,3,B
2018-04-12 11:00:06,13585.0,2,11950,-2,13585.0,1,13590.0,1,S
2018-04-12 11:00:10,13585.0,2,11952,0,13585.0,1,13590.0,1,S
2018-04-12 11:00:16,13585.0,2,11954,0,13585.0,1,13590.0,2,S
2018-04-12 11:00:21,13585.0,2,11956,0,13585.0,1,13590.0,2,S
2018-04-12 11:00:25,13590.0,4,11960,0,13590.0,1,13595.0,6,B
2018-04-12 11:00:30,13590.0,2,11962,2,13585.0,8,13595.0,4,B
2018-04-12 11:00:32,13590.0,2,11964,0,13585.0,8,13595.0,9,B
2018-04-12 11:00:32,13590.0,2,11966,0,13590.0,1,13595.0,9,B
2018-04-12 11:00:44,13590.0,2,11968,2,13590.0,1,13595.0,9,B
2018-04-12 11:00:46,13590.0,2,11970,2,13585.0,8,13595.0,9,B
2018-04-12 11:00:47,13590.0,2,11972,2,13585.0,8,13595.0,9,B
2018-04-12 11:00:54,13595.0,4,11976,4,13590.0,6,13595.0,6,B
2018-04-12 11:00:55,13595.0,4,11980,2,13590.0,6,13595.0,4,B
2018-04-12 11:00:55,13595.0,4,11984,0,13590.0,6,13595.0,2,B
2018-04-12 11:00:56,13595.0,4,11988,-4,13595.0,2,13600.0,20,B
2018-04-12 11:01:03,13595.0,2,11990,0,13595.0,4,13600.0,14,B
2018-04-12 11:01:04,13600.0,10,12000,8,13595.0,8,13600.0,9,B
2018-04-12 11:01:04,13600.0,6,12006,2,13595.0,9,13600.0,6,B
2018-04-12 11:01:05,13600.0,2,12008,2,13595.0,9,13600.0,5,B
2018-04-12 11:01:06,13595.0,2,12010,2,13590.0,5,13600.0,7,S
2018-04-12 11:01:17,13590.0,2,12012,0,13590.0,2,13595.0,2,S
2018-04-12 11:01:24,13590.0,2,12014,0,13585.0,5,13595.0,3,S
2018-04-12 11:01:25,13590.0,2,12016,2,13590.0,1,13595.0,4,S
2018-04-12 11:01:28,13590.0,4,12020,0,13585.0,9,13595.0,4,S
2018-04-12 11:01:37,13590.0,10,12030,10,13590.0,8,13595.0,7,S
2018-04-12 11:01:37,13590.0,6,12036,6,13590.0,5,13595.0,8,S
2018-04-12 11:01:38,13590.0,10,12046,8,13585.0,3,13595.0,8,S
2018-04-12 11:01:42,13590.0,2,12048,2,13585.0,3,13590.0,1,S
2018-04-12 11:01:52,13585.0,2,12050,2,13585.0,1,13590.0,2,S
2018-04-12 11:01:56,13585.0,2,12052,0,13580.0,4,13585.0,1,S
2018-04-12 11:02:26,13585.0,2,12054,0,13580.0,5,13585.0,4,S
2018-04-12 11:02:28,13585.0,2,12056,0,13580.0,5,13585.0,3,S
2018-04-12 11:02:43,13580.0,6,12062,6,13580.0,4,13585.0,6,S
2018-04-12 11:02:44,13580.0,2,12064,-2,13580.0,3,13585.0,6,S
2018-04-12 11:02:45,13585.0,4,12068,2,13580.0,3,13585.0,4,B
2018-04-12 11:02:45,13585.0,4,12072,2,13580.0,3,13585.0,2,B
2018-04-12 11:02:46,13585.0,4,12076,2,13580.0,3,13590.0,3,B
2018-04-12 11:03:00,13585.0,2,12078,0,13585.0,1,13590.0,2,B
2018-04-12 11:03:10,13585.0,2,12080,0,13585.0,1,13590.0,2,B
2018-04-12 11:03:48,13585.0,2,12082,-2,13580.0,4,13590.0,4,B
2018-04-12 11:03:59,13585.0,2,12084,2,13580.0,3,13585.0,1,B
2018-04-12 11:04:16,13580.0,2,12086,0,13580.0,1,13585.0,1,S
2018-04-12 11:04:23,13580.0,4,12090,-2,13575.0,21,13585.0,4,S
2018-04-12 11:05:07,13580.0,2,12092,0,13580.0,1,13585.0,4,S
2018-04-12 11:05:08,13580.0,2,12094,2,13580.0,1,13585.0,4,S
2018-04-12 11:05:09,13580.0,2,12096,-2,13580.0,1,13585.0,4,S
2018-04-12 11:05:23,13580.0,2,12098,-2,13580.0,1,13585.0,4,S
2018-04-12 11:05:28,13585.0,4,12102,4,13585.0,12,13590.0,6,B
2018-04-12 11:05:28,13590.0,4,12106,-2,13585.0,11,13590.0,3,B
2018-04-12 11:05:29,13590.0,4,12110,2,13585.0,12,13590.0,1,B
2018-04-12 11:05:35,13590.0,2,12112,-2,13585.0,8,13595.0,7,B
2018-04-12 11:05:44,13590.0,2,12114,0,13585.0,2,13590.0,2,B
2018-04-12 11:06:03,13590.0,2,12116,2,13590.0,2,13595.0,5,B
2018-04-12 11:06:04,13590.0,4,12120,0,13585.0,4,13595.0,5,B
2018-04-12 11:06:06,13585.0,2,12122,0,13585.0,1,13590.0,2,S
2018-04-12 11:06:09,13585.0,4,12126,2,13580.0,8,13590.0,2,S
2018-04-12 11:06:17,13590.0,2,12128,-2,13590.0,4,13595.0,7,B
2018-04-12 11:06:28,13590.0,2,12130,0,13590.0,1,13595.0,8,B
2018-04-12 11:06:28,13590.0,2,12132,2,13585.0,3,13595.0,8,B
2018-04-12 11:06:49,13590.0,2,12134,2,13585.0,2,13590.0,2,B
2018-04-12 11:07:04,13585.0,2,12136,2,13585.0,1,13590.0,10,S
2018-04-12 11:07:35,13580.0,6,12142,-4,13580.0,4,13585.0,2,S
2018-04-12 11:07:36,13585.0,4,12146,4,13580.0,4,13590.0,9,B
2018-04-12 11:07:51,13590.0,4,12150,0,13585.0,3,13590.0,6,B
2018-04-12 11:07:52,13590.0,4,12154,4,13585.0,3,13590.0,4,B
2018-04-12 11:07:53,13590.0,4,12158,4,13585.0,3,13590.0,2,B
2018-04-12 11:07:53,13590.0,4,12162,2,13585.0,3,13595.0,8,B
2018-04-12 11:08:05,13590.0,4,12166,0,13585.0,3,13590.0,8,B
2018-04-12 11:08:06,13590.0,4,12170,0,13585.0,3,13590.0,6,B
2018-04-12 11:08:07,13590.0,4,12174,0,13585.0,3,13590.0,4,B
2018-04-12 11:08:08,13590.0,4,12178,0,13585.0,3,13590.0,2,B
2018-04-12 11:08:09,13590.0,4,12182,0,13585.0,2,13595.0,6,B
2018-04-12 11:08:14,13590.0,2,12184,0,13590.0,1,13595.0,7,B
2018-04-12 11:08:41,13590.0,2,12186,0,13585.0,3,13590.0,9,B
2018-04-12 11:08:42,13590.0,4,12190,0,13585.0,4,13590.0,7,B
2018-04-12 11:08:43,13590.0,4,12194,0,13585.0,4,13590.0,5,B
2018-04-12 11:08:44,13590.0,4,12198,0,13585.0,4,13590.0,3,B
2018-04-12 11:08:44,13590.0,4,12202,0,13585.0,4,13590.0,1,B
2018-04-12 11:08:45,13585.0,6,12208,2,13585.0,2,13595.0,7,S
2018-04-12 11:08:51,13590.0,2,12210,2,13590.0,1,13595.0,7,B
2018-04-12 11:09:04,13590.0,2,12212,0,13585.0,3,13590.0,1,B
2018-04-12 11:09:46,13585.0,2,12214,0,13580.0,2,13585.0,1,S
2018-04-12 11:09:55,13580.0,2,12216,2,13580.0,1,13585.0,11,S
2018-04-12 11:09:56,13580.0,2,12218,2,13575.0,8,13585.0,11,S
2018-04-12 11:10:02,13585.0,4,12222,0,13580.0,1,13585.0,8,B
2018-04-12 11:10:03,13585.0,4,12226,0,13580.0,3,13585.0,6,B
2018-04-12 11:10:04,13585.0,4,12230,0,13580.0,3,13585.0,4,B
2018-04-12 11:10:05,13585.0,4,12234,0,13580.0,3,13585.0,2,B
2018-04-12 11:10:05,13585.0,4,12238,0,13580.0,3,13590.0,6,B
2018-04-12 11:10:08,13580.0,2,12240,-2,13580.0,2,13590.0,4,S
2018-04-12 11:10:12,13590.0,6,12246,2,13590.0,5,13595.0,7,B
2018-04-12 11:10:13,13590.0,4,12250,4,13585.0,9,13590.0,1,B
2018-04-12 11:10:14,13590.0,2,12252,0,13585.0,7,13595.0,8,B
2018-04-12 11:10:27,13590.0,2,12254,2,13590.0,1,13595.0,5,B
2018-04-12 11:10:29,13595.0,2,12256,2,13590.0,2,13595.0,4,B
2018-04-12 11:10:40,13595.0,2,12258,2,13590.0,3,13595.0,3,B
2018-04-12 11:10:41,13595.0,2,12260,2,13590.0,5,13595.0,2,B
2018-04-12 11:10:42,13595.0,2,12262,2,13590.0,5,13595.0,1,B
2018-04-12 11:10:43,13595.0,2,12264,2,13590.0,5,13600.0,17,B
2018-04-12 11:10:44,13595.0,2,12266,0,13590.0,3,13600.0,16,B
2018-04-12 11:10:48,13600.0,4,12270,4,13595.0,12,13600.0,12,B
2018-04-12 11:10:49,13600.0,4,12274,4,13595.0,11,13600.0,10,B
2018-04-12 11:10:50,13600.0,4,12278,4,13595.0,5,13600.0,8,B
2018-04-12 11:10:51,13600.0,2,12280,0,13590.0,4,13600.0,7,B
2018-04-12 11:10:54,13600.0,4,12284,4,13595.0,6,13600.0,5,B
2018-04-12 11:10:55,13600.0,2,12286,2,13595.0,7,13600.0,4,B
2018-04-12 11:10:55,13600.0,2,12288,2,13595.0,7,13600.0,3,B
2018-04-12 11:10:56,13600.0,4,12292,4,13595.0,4,13600.0,1,B
2018-04-12 11:10:57,13600.0,4,12296,2,13595.0,4,13605.0,10,B
2018-04-12 11:11:04,13605.0,4,12300,4,13600.0,2,13605.0,4,B
2018-04-12 11:11:06,13600.0,2,12302,2,13595.0,4,13605.0,4,S
2018-04-12 11:11:08,13605.0,4,12306,4,13600.0,7,13605.0,2,B
2018-04-12 11:11:09,13605.0,4,12310,4,13600.0,6,13610.0,15,B
2018-04-12 11:11:10,13600.0,2,12312,2,13600.0,4,13610.0,13,S
2018-04-12 11:11:23,13600.0,4,12316,2,13595.0,2,13605.0,7,S
2018-04-12 11:11:25,13600.0,2,12318,0,13600.0,1,13605.0,7,S
2018-04-12 11:11:26,13600.0,2,12320,0,13595.0,4,13605.0,7,S
2018-04-12 11:11:41,13600.0,2,12322,0,13595.0,2,13605.0,8,S
2018-04-12 11:11:47,13595.0,2,12324,2,13590.0,2,13600.0,13,S
2018-04-12 11:11:56,13590.0,2,12326,0,13585.0,3,13595.0,14,S
2018-04-12 11:12:04,13590.0,4,12330,0,13585.0,5,13590.0,8,S
2018-04-12 11:12:11,13585.0,2,12332,2,13585.0,1,13590.0,11,S
2018-04-12 11:12:11,13585.0,4,12336,4,13580.0,6,13590.0,11,S
2018-04-12 11:12:18,13590.0,2,12338,0,13580.0,7,13590.0,4,B
2018-04-12 11:12:19,13590.0,2,12340,2,13580.0,7,13590.0,3,B
2018-04-12 11:12:25,13580.0,18,12358,-10,13575.0,8,13580.0,18,S
2018-04-12 11:12:26,13580.0,18,12376,-6,13575.0,8,13580.0,9,S
2018-04-12 11:12:26,13580.0,8,12384,0,13575.0,10,13580.0,5,S
2018-04-12 11:12:27,13580.0,4,12388,0,13575.0,10,13580.0,3,S
2018-04-12 11:12:28,13580.0,4,12392,0,13575.0,9,13580.0,1,S
2018-04-12 11:12:29,13580.0,2,12394,0,13580.0,1,13585.0,2,S
2018-04-12 11:12:29,13580.0,2,12396,2,13575.0,8,13580.0,1,S
2018-04-12 11:12:30,13580.0,2,12398,0,13575.0,7,13585.0,3,S
2018-04-12 11:12:30,13585.0,2,12400,0,13580.0,5,13585.0,1,B
2018-04-12 11:12:31,13585.0,2,12402,0,13580.0,5,13590.0,7,B
2018-04-12 11:12:32,13580.0,8,12410,6,13580.0,1,13590.0,6,S
2018-04-12 11:12:37,13580.0,10,12420,6,13580.0,1,13590.0,6,S
2018-04-12 11:12:42,13580.0,2,12422,-2,13575.0,8,13580.0,1,S
2018-04-12 11:12:42,13580.0,2,12424,-2,13575.0,7,13585.0,3,S
2018-04-12 11:12:58,13580.0,2,12426,2,13580.0,2,13585.0,4,S
2018-04-12 11:13:02,13585.0,2,12428,-2,13580.0,3,13585.0,3,B
2018-04-12 11:13:05,13585.0,2,12430,0,13585.0,2,13590.0,5,B
2018-04-12 11:13:12,13585.0,2,12432,0,13580.0,2,13585.0,1,B
2018-04-12 11:13:18,13585.0,2,12434,0,13585.0,2,13590.0,6,B
2018-04-12 11:13:21,13585.0,4,12438,0,13580.0,4,13590.0,6,B
2018-04-12 11:13:27,13580.0,6,12444,4,13575.0,6,13580.0,2,S
2018-04-12 11:13:27,13580.0,4,12448,0,13575.0,6,13585.0,1,S
2018-04-12 11:13:31,13585.0,4,12452,0,13580.0,3,13590.0,8,B
2018-04-12 11:13:47,13590.0,4,12456,2,13585.0,2,13595.0,7,B
2018-04-12 11:13:55,13590.0,4,12460,2,13585.0,2,13590.0,10,B
2018-04-12 11:14:48,13590.0,2,12462,0,13580.0,5,13590.0,8,B
2018-04-12 11:15:11,13585.0,4,12466,-4,13580.0,5,13590.0,6,S
2018-04-12 11:15:16,13590.0,2,12468,2,13585.0,2,13590.0,6,B
2018-04-12 11:15:22,13590.0,4,12472,-4,13585.0,3,13590.0,5,B
2018-04-12 11:15:26,13585.0,2,12474,-2,13580.0,5,13590.0,6,S
2018-04-12 11:15:43,13580.0,10,12484,8,13575.0,5,13590.0,7,S
2018-04-12 11:15:51,13580.0,8,12492,4,13575.0,5,13585.0,2,S
2018-04-12 11:15:55,13575.0,4,12496,-2,13575.0,1,13580.0,6,S
2018-04-12 11:15:55,13575.0,2,12498,-2,13570.0,3,13575.0,27,S
2018-04-12 11:15:58,13570.0,4,12502,4,13565.0,18,13570.0,6,S
2018-04-12 11:15:58,13565.0,2,12504,0,13565.0,17,13570.0,4,S
2018-04-12 11:15:59,13565.0,10,12514,2,13565.0,17,13575.0,31,S
2018-04-12 11:16:03,13565.0,2,12516,2,13565.0,16,13570.0,1,S
2018-04-12 11:16:04,13570.0,2,12518,-2,13565.0,16,13575.0,31,B
2018-04-12 11:16:04,13565.0,2,12520,0,13565.0,16,13575.0,32,S
2018-04-12 11:16:05,13570.0,4,12524,0,13565.0,17,13575.0,30,B
2018-04-12 11:16:08,13570.0,2,12526,-2,13565.0,17,13575.0,29,B
2018-04-12 11:16:08,13565.0,2,12528,0,13565.0,16,13575.0,29,S
2018-04-12 11:16:15,13570.0,2,12530,-2,13565.0,19,13575.0,28,B
2018-04-12 11:16:44,13575.0,4,12534,2,13570.0,1,13575.0,4,B
2018-04-12 11:16:53,13570.0,2,12536,0,13565.0,19,13575.0,3,S
2018-04-12 11:17:00,13570.0,2,12538,0,13565.0,19,13575.0,6,S
2018-04-12 11:17:05,13570.0,4,12542,0,13565.0,19,13575.0,5,S
2018-04-12 11:17:12,13575.0,6,12548,-2,13570.0,5,13580.0,6,B
2018-04-12 11:17:28,13570.0,2,12550,0,13570.0,3,13580.0,4,S
2018-04-12 11:17:32,13575.0,2,12552,0,13570.0,7,13580.0,3,B
2018-04-12 11:17:37,13580.0,2,12554,0,13575.0,5,13585.0,6,B
2018-04-12 11:17:51,13585.0,2,12556,-2,13580.0,3,13585.0,4,B
2018-04-12 11:17:52,13580.0,4,12560,0,13580.0,1,13585.0,7,S
2018-04-12 11:17:53,13580.0,2,12562,2,13575.0,2,13585.0,8,S
2018-04-12 11:17:54,13580.0,2,12564,0,13575.0,2,13580.0,1,S
2018-04-12 11:17:58,13580.0,2,12566,-2,13580.0,1,13585.0,6,S
2018-04-12 11:18:16,13585.0,8,12574,0,13580.0,6,13585.0,1,B
2018-04-12 11:18:16,13585.0,2,12576,-2,13580.0,6,13590.0,4,B
2018-04-12 11:18:26,13585.0,4,12580,0,13585.0,1,13590.0,4,B
2018-04-12 11:18:34,13590.0,8,12588,-4,13585.0,4,13595.0,6,B
2018-04-12 11:18:40,13595.0,6,12594,0,13595.0,4,13600.0,17,B
2018-04-12 11:18:44,13600.0,10,12604,10,13595.0,4,13600.0,9,B
2018-04-12 11:19:09,13595.0,2,12606,2,13595.0,3,13600.0,11,S
2018-04-12 11:19:09,13595.0,6,12612,6,13590.0,4,13600.0,11,S
2018-04-12 11:19:11,13595.0,4,12616,4,13590.0,4,13600.0,11,S
2018-04-12 11:19:41,13595.0,2,12618,2,13585.0,6,13595.0,13,S
2018-04-12 11:20:01,13585.0,2,12620,2,13585.0,2,13590.0,1,S
2018-04-12 11:20:01,13590.0,2,12622,0,13590.0,1,13595.0,11,B
2018-04-12 11:20:02,13590.0,2,12624,0,13585.0,5,13590.0,1,B
2018-04-12 11:20:02,13585.0,2,12626,0,13585.0,4,13595.0,10,S
2018-04-12 11:20:16,13590.0,2,12628,0,13590.0,1,13595.0,10,B
2018-04-12 11:20:20,13590.0,2,12630,0,13585.0,4,13595.0,10,B
2018-04-12 11:20:29,13585.0,4,12634,-2,13580.0,6,13590.0,1,S
2018-04-12 11:20:41,13590.0,4,12638,0,13585.0,4,13590.0,1,B
2018-04-12 11:20:42,13590.0,2,12640,0,13590.0,1,13595.0,10,B
2018-04-12 11:21:02,13590.0,2,12642,2,13590.0,1,13595.0,8,B
2018-04-12 11:21:03,13590.0,2,12644,2,13585.0,3,13590.0,1,B
2018-04-12 11:21:06,13590.0,4,12648,4,13580.0,8,13595.0,8,B
2018-04-12 11:21:36,13595.0,2,12650,0,13595.0,1,13600.0,12,B
2018-04-12 11:22:05,13595.0,2,12652,0,13595.0,1,13600.0,11,B
2018-04-12 11:22:28,13595.0,2,12654,-2,13590.0,4,13600.0,11,B
2018-04-12 11:22:36,13595.0,4,12658,2,13590.0,4,13600.0,13,B
2018-04-12 11:22:47,13600.0,4,12662,4,13595.0,5,13600.0,8,B
2018-04-12 11:22:48,13600.0,4,12666,4,13595.0,5,13600.0,6,B
2018-04-12 11:22:49,13600.0,12,12678,-2,13600.0,10,13605.0,9,B
2018-04-12 11:22:49,13600.0,6,12684,-6,13600.0,6,13605.0,7,B
2018-04-12 11:22:51,13605.0,2,12686,0,13600.0,4,13605.0,5,B
2018-04-12 11:22:53,13605.0,2,12688,2,13600.0,4,13605.0,4,B
2018-04-12 11:22:53,13605.0,10,12698,-2,13605.0,5,13610.0,21,B
2018-04-12 11:22:55,13610.0,6,12704,4,13605.0,11,13610.0,18,B
2018-04-12 11:22:55,13610.0,10,12714,10,13605.0,10,13610.0,13,B
2018-04-12 11:22:56,13610.0,16,12730,0,13605.0,11,13610.0,6,B
2018-04-12 11:22:56,13610.0,10,12740,8,13605.0,10,13610.0,1,B
2018-04-12 11:22:57,13610.0,2,12742,0,13610.0,4,13615.0,9,B
2018-04-12 11:23:00,13610.0,4,12746,4,13605.0,9,13610.0,3,B
2018-04-12 11:23:01,13610.0,2,12748,2,13605.0,7,13610.0,2,B
2018-04-12 11:23:01,13610.0,6,12754,2,13610.0,2,13615.0,10,B
2018-04-12 11:23:02,13615.0,6,12760,6,13610.0,1,13615.0,9,B
2018-04-12 11:23:02,13615.0,6,12766,-2,13605.0,6,13615.0,7,B
2018-04-12 11:23:03,13615.0,2,12768,-2,13605.0,6,13615.0,6,B
2018-04-12 11:23:03,13615.0,2,12770,0,13610.0,1,13615.0,5,B
2018-04-12 11:23:04,13610.0,2,12772,0,13605.0,5,13610.0,1,S
2018-04-12 11:23:05,13610.0,2,12774,2,13605.0,5,13615.0,5,S
2018-04-12 11:23:09,13610.0,2,12776,2,13605.0,6,13615.0,5,S
2018-04-12 11:23:21,13605.0,2,12778,2,13605.0,1,13610.0,6,S
2018-04-12 11:23:22,13605.0,2,12780,0,13600.0,2,13610.0,6,S
2018-04-12 11:23:25,13605.0,4,12784,-2,13595.0,7,13605.0,5,S
2018-04-12 11:23:38,13595.0,2,12786,2,13595.0,4,13605.0,5,S
2018-04-12 11:23:44,13595.0,2,12788,2,13590.0,6,13600.0,3,S
2018-04-12 11:23:51,13600.0,4,12792,4,13595.0,2,13600.0,1,B
2018-04-12 11:23:52,13600.0,2,12794,2,13600.0,1,13605.0,5,B
2018-04-12 11:23:53,13600.0,2,12796,2,13600.0,1,13605.0,5,B
2018-04-12 11:23:55,13600.0,2,12798,2,13595.0,3,13605.0,5,B
2018-04-12 11:23:59,13600.0,2,12800,2,13600.0,1,13605.0,6,B
2018-04-12 11:24:01,13600.0,2,12802,2,13600.0,4,13605.0,6,B
2018-04-12 11:24:02,13600.0,2,12804,0,13600.0,3,13605.0,6,B
2018-04-12 11:24:02,13600.0,2,12806,-2,13600.0,2,13605.0,6,B
2018-04-12 11:24:04,13600.0,4,12810,-4,13595.0,1,13600.0,1,B
2018-04-12 11:24:07,13600.0,4,12814,2,13595.0,4,13605.0,6,B
2018-04-12 11:24:12,13605.0,4,12818,2,13600.0,1,13605.0,3,B
2018-04-12 11:24:18,13595.0,2,12820,0,13590.0,9,13600.0,7,S
2018-04-12 11:24:25,13600.0,8,12828,0,13595.0,5,13600.0,2,B
2018-04-12 11:24:25,13600.0,4,12832,2,13595.0,8,13605.0,7,B
2018-04-12 11:24:27,13605.0,2,12834,2,13600.0,1,13605.0,3,B
2018-04-12 11:24:27,13605.0,2,12836,2,13600.0,1,13605.0,2,B
2018-04-12 11:24:28,13605.0,4,12840,4,13595.0,7,13605.0,2,B
2018-04-12 11:24:29,13605.0,2,12842,0,13605.0,1,13610.0,4,B
2018-04-12 11:24:42,13605.0,2,12844,2,13605.0,4,13610.0,1,B
2018-04-12 11:24:43,13610.0,2,12846,2,13605.0,4,13615.0,7,B
2018-04-12 11:24:52,13605.0,2,12848,0,13600.0,5,13610.0,1,S
2018-04-12 11:25:17,13610.0,2,12850,2,13600.0,5,13610.0,15,B
2018-04-12 11:25:18,13610.0,4,12854,4,13600.0,3,13610.0,16,B
2018-04-12 11:25:20,13600.0,2,12856,-2,13600.0,1,13605.0,5,S
2018-04-12 11:25:23,13600.0,2,12858,-2,13595.0,5,13605.0,5,S
2018-04-12 11:25:28,13605.0,20,12878,10,13590.0,10,13605.0,1,B
2018-04-12 11:25:33,13600.0,6,12884,6,13600.0,7,13605.0,4,S
2018-04-12 11:25:34,13600.0,10,12894,4,13600.0,2,13605.0,5,S
2018-04-12 11:25:34,13600.0,4,12898,2,13595.0,2,13600.0,4,S
2018-04-12 11:25:44,13600.0,8,12906,0,13600.0,1,13605.0,5,S
2018-04-12 11:25:45,13600.0,2,12908,0,13595.0,2,13600.0,2,S
2018-04-12 11:26:07,13600.0,2,12910,-2,13595.0,11,13600.0,7,S
2018-04-12 11:26:07,13600.0,4,12914,0,13595.0,11,13600.0,2,S
2018-04-12 11:26:14,13600.0,2,12916,0,13595.0,11,13600.0,1,S
2018-04-12 11:26:21,13600.0,2,12918,0,13595.0,10,13605.0,6,S
2018-04-12 11:26:33,13600.0,4,12922,4,13600.0,8,13605.0,15,S
2018-04-12 11:26:33,13600.0,16,12938,12,13595.0,2,13605.0,17,S
2018-04-12 11:26:43,13600.0,10,12948,0,13595.0,3,13600.0,3,S
2018-04-12 11:26:47,13595.0,2,12950,-2,13590.0,10,13600.0,9,S
2018-04-12 11:26:54,13590.0,2,12952,2,13590.0,9,13595.0,4,S
2018-04-12 11:27:09,13595.0,2,12954,-2,13590.0,10,13595.0,3,B
2018-04-12 11:27:10,13595.0,2,12956,0,13590.0,10,13595.0,2,B
2018-04-12 11:27:14,13595.0,2,12958,0,13590.0,11,13595.0,2,B
2018-04-12 11:27:15,13595.0,2,12960,-2,13590.0,11,13595.0,1,B
2018-04-12 11:27:16,13595.0,2,12962,0,13595.0,4,13600.0,9,B
2018-04-12 11:27:38,13595.0,2,12964,0,13595.0,4,13600.0,10,B
2018-04-12 11:27:39,13595.0,4,12968,4,13595.0,2,13600.0,10,B
2018-04-12 11:27:39,13595.0,4,12972,0,13590.0,10,13600.0,11,B
2018-04-12 11:27:44,13595.0,6,12978,0,13595.0,2,13600.0,11,B
2018-04-12 11:27:44,13595.0,2,12980,2,13595.0,1,13600.0,11,B
2018-04-12 11:27:47,13595.0,2,12982,0,13590.0,10,13600.0,11,B
2018-04-12 11:27:50,13590.0,4,12986,0,13590.0,7,13595.0,1,S
2018-04-12 11:27:57,13595.0,2,12988,0,13590.0,7,13600.0,21,B
2018-04-12 11:27:58,13590.0,2,12990,-2,13590.0,6,13600.0,21,S
2018-04-12 11:28:05,13590.0,4,12994,-2,13590.0,3,13595.0,2,S
2018-04-12 11:28:08,13590.0,4,12998,0,13590.0,1,13595.0,7,S
2018-04-12 11:28:09,13590.0,2,13000,0,13585.0,4,13590.0,1,S
2018-04-12 11:28:56,13585.0,2,13002,0,13585.0,3,13590.0,6,S
2018-04-12 11:29:00,13590.0,6,13008,-2,13585.0,3,13590.0,4,B
2018-04-12 11:29:10,13590.0,4,13012,-4,13585.0,3,13590.0,1,B
2018-04-12 11:29:13,13590.0,2,13014,0,13585.0,3,13595.0,3,B
2018-04-12 11:29:30,13595.0,2,13016,-2,13590.0,5,13600.0,20,B
2018-04-12 11:29:34,13600.0,2,13018,0,13590.0,5,13600.0,19,B
2018-04-12 11:29:42,13590.0,2,13020,-2,13590.0,2,13595.0,2,S
2018-04-12 11:29:48,13590.0,2,13022,-2,13585.0,5,13590.0,1,S
2018-04-12 11:29:52,13585.0,2,13024,-2,13585.0,3,13590.0,7,S
2018-04-12 11:29:55,13585.0,4,13028,2,13585.0,1,13590.0,1,S
2018-04-12 11:29:55,13585.0,2,13030,0,13585.0,1,13595.0,4,S
2018-04-12 13:30:00,13575.0,20,13050,14,13570.0,4,13575.0,1,S
2018-04-12 13:30:01,13580.0,4,13054,2,13570.0,4,13580.0,2,B
2018-04-12 13:30:02,13575.0,2,13056,0,13570.0,5,13575.0,3,S
2018-04-12 13:30:03,13570.0,8,13064,6,13565.0,14,13575.0,3,S
2018-04-12 13:30:04,13570.0,2,13066,0,13570.0,1,13575.0,3,S
2018-04-12 13:30:07,13570.0,2,13068,0,13570.0,1,13575.0,3,S
2018-04-12 13:30:12,13570.0,4,13072,0,13565.0,15,13575.0,3,S
2018-04-12 13:30:26,13570.0,2,13074,0,13570.0,2,13575.0,4,S
2018-04-12 13:30:29,13575.0,6,13080,4,13570.0,8,13575.0,1,B
2018-04-12 13:30:30,13580.0,4,13084,2,13575.0,5,13580.0,2,B
2018-04-12 13:30:30,13580.0,4,13088,4,13580.0,1,13585.0,3,B
2018-04-12 13:30:31,13585.0,4,13092,2,13580.0,4,13585.0,3,B
2018-04-12 13:30:33,13585.0,4,13096,0,13575.0,2,13585.0,4,B
2018-04-12 13:30:39,13575.0,2,13098,2,13575.0,4,13580.0,2,S
2018-04-12 13:31:01,13580.0,2,13100,0,13575.0,9,13580.0,1,B
2018-04-12 13:31:04,13585.0,6,13106,0,13580.0,1,13590.0,4,B
2018-04-12 13:31:04,13590.0,2,13108,-2,13580.0,3,13590.0,4,B
2018-04-12 13:31:13,13585.0,2,13110,0,13585.0,1,13590.0,3,S
2018-04-12 13:31:22,13590.0,2,13112,0,13585.0,2,13590.0,3,B
2018-04-12 13:31:37,13585.0,2,13114,0,13585.0,4,13590.0,3,S
2018-04-12 13:31:37,13585.0,2,13116,0,13585.0,3,13590.0,3,S
2018-04-12 13:31:45,13585.0,2,13118,-2,13585.0,2,13590.0,2,S
2018-04-12 13:31:45,13585.0,4,13122,-2,13580.0,8,13590.0,2,S
2018-04-12 13:31:57,13580.0,8,13130,0,13575.0,4,13580.0,6,S
2018-04-12 13:32:03,13575.0,4,13134,4,13570.0,6,13580.0,6,S
2018-04-12 13:32:12,13570.0,2,13136,0,13570.0,7,13580.0,7,S
2018-04-12 13:32:22,13575.0,2,13138,0,13570.0,13,13575.0,7,B
2018-04-12 13:32:24,13570.0,12,13150,-8,13570.0,7,13575.0,7,S
2018-04-12 13:32:31,13570.0,14,13164,-14,13565.0,16,13575.0,11,S
2018-04-12 13:32:33,13565.0,12,13176,-8,13565.0,7,13570.0,9,S
2018-04-12 13:32:33,13570.0,14,13190,-14,13565.0,2,13570.0,7,B
2018-04-12 13:32:34,13565.0,4,13194,0,13560.0,11,13565.0,6,S
2018-04-12 13:32:37,13560.0,8,13202,-2,13560.0,7,13565.0,5,S
2018-04-12 13:32:39,13565.0,4,13206,2,13560.0,6,13565.0,4,B
2018-04-12 13:32:42,13560.0,6,13212,-2,13560.0,3,13565.0,2,S
2018-04-12 13:32:43,13560.0,2,13214,0,13560.0,2,13565.0,1,S
2018-04-12 13:32:45,13560.0,2,13216,0,13560.0,1,13565.0,1,S
2018-04-12 13:32:53,13560.0,2,13218,0,13560.0,1,13565.0,11,S
2018-04-12 13:32:55,13565.0,2,13220,0,13560.0,14,13565.0,10,B
2018-04-12 13:32:58,13565.0,2,13222,-2,13560.0,11,13565.0,9,B
2018-04-12 13:33:00,13560.0,6,13228,0,13560.0,8,13565.0,9,S
2018-04-12 13:33:10,13560.0,2,13230,0,13560.0,2,13565.0,9,S
2018-04-12 13:33:13,13560.0,4,13234,-2,13555.0,7,13565.0,10,S
2018-04-12 13:33:20,13555.0,2,13236,2,13555.0,10,13565.0,11,S
2018-04-12 13:33:26,13555.0,4,13240,-4,13555.0,8,13560.0,1,S
2018-04-12 13:33:35,13560.0,4,13244,4,13560.0,1,13565.0,16,B
2018-04-12 13:33:35,13560.0,2,13246,0,13555.0,8,13565.0,16,B
2018-04-12 13:33:44,13560.0,2,13248,0,13555.0,6,13560.0,4,B
2018-04-12 13:33:47,13560.0,2,13250,0,13555.0,5,13560.0,3,B
2018-04-12 13:33:50,13560.0,4,13254,-2,13555.0,4,13560.0,1,B
2018-04-12 13:33:51,13555.0,2,13256,0,13555.0,3,13560.0,1,S
2018-04-12 13:33:52,13560.0,2,13258,0,13560.0,2,13565.0,14,B
2018-04-12 13:33:54,13560.0,2,13260,2,13560.0,3,13565.0,12,B
2018-04-12 13:34:11,13560.0,2,13262,0,13560.0,1,13565.0,12,B
2018-04-12 13:34:12,13560.0,2,13264,0,13560.0,1,13565.0,12,B
2018-04-12 13:34:13,13560.0,2,13266,-2,13560.0,1,13565.0,12,B
2018-04-12 13:34:24,13565.0,2,13268,-2,13560.0,9,13565.0,11,B
2018-04-12 13:34:24,13560.0,4,13272,-4,13560.0,8,13565.0,10,S
2018-04-12 13:34:25,13560.0,2,13274,2,13560.0,3,13565.0,3,S
2018-04-12 13:34:25,13565.0,2,13276,2,13560.0,4,13565.0,2,B
2018-04-12 13:34:26,13565.0,2,13278,0,13560.0,4,13565.0,1,B
2018-04-12 13:34:26,13565.0,2,13280,2,13560.0,4,13570.0,6,B
2018-04-12 13:34:34,13565.0,6,13286,0,13560.0,5,13565.0,27,B
2018-04-12 13:34:41,13560.0,6,13292,-2,13560.0,2,13565.0,27,S
2018-04-12 13:34:46,13565.0,2,13294,0,13560.0,3,13565.0,26,B
2018-04-12 13:34:51,13565.0,2,13296,-2,13560.0,12,13565.0,25,B
2018-04-12 13:34:52,13565.0,2,13298,0,13560.0,13,13565.0,24,B
2018-04-12 13:34:52,13565.0,6,13304,-6,13560.0,13,13565.0,21,B
2018-04-12 13:34:53,13560.0,8,13312,-6,13560.0,11,13565.0,19,S
2018-04-12 13:35:20,13560.0,6,13318,-6,13560.0,2,13565.0,19,S
2018-04-12 13:35:21,13560.0,2,13320,2,13560.0,1,13565.0,19,S
2018-04-12 13:35:58,13565.0,2,13322,0,13560.0,3,13565.0,18,B
2018-04-12 13:35:59,13560.0,2,13324,2,13560.0,2,13565.0,18,S
2018-04-12 13:36:12,13560.0,6,13330,0,13555.0,7,13560.0,7,S
2018-04-12 13:36:24,13560.0,4,13334,4,13555.0,4,13560.0,6,S
2018-04-12 13:36:24,13560.0,12,13346,2,13555.0,14,13565.0,19,S
2018-04-12 13:36:40,13560.0,2,13348,2,13555.0,13,13560.0,3,S
2018-04-12 13:37:17,13555.0,12,13360,-10,13555.0,4,13560.0,4,S
2018-04-12 13:37:17,13555.0,10,13370,-8,13550.0,10,13560.0,12,S
2018-04-12 13:37:28,13550.0,2,13372,2,13550.0,9,13555.0,1,S
2018-04-12 13:37:29,13555.0,2,13374,0,13550.0,9,13560.0,12,B
2018-04-12 13:37:38,13550.0,2,13376,2,13550.0,6,13555.0,3,S
2018-04-12 13:37:38,13550.0,4,13380,-2,13550.0,4,13555.0,9,S
2018-04-12 13:37:55,13550.0,2,13382,0,13550.0,8,13555.0,18,S
2018-04-12 13:37:58,13550.0,16,13398,-4,13545.0,20,13550.0,2,S
2018-04-12 13:37:59,13550.0,4,13402,-4,13545.0,20,13555.0,18,S
2018-04-12 13:38:05,13550.0,2,13404,2,13550.0,1,13555.0,18,S
2018-04-12 13:38:12,13550.0,2,13406,0,13550.0,1,13555.0,18,S
2018-04-12 13:38:15,13550.0,2,13408,0,13545.0,18,13555.0,18,S
2018-04-12 13:38:19,13550.0,2,13410,0,13550.0,1,13555.0,19,S
2018-04-12 13:38:50,13560.0,4,13414,2,13555.0,3,13560.0,2,B
2018-04-12 13:38:53,13560.0,2,13416,0,13555.0,5,13560.0,1,B
2018-04-12 13:38:53,13560.0,2,13418,0,13555.0,5,13565.0,22,B
2018-04-12 13:39:03,13560.0,4,13422,-4,13560.0,1,13565.0,22,B
2018-04-12 13:39:03,13560.0,2,13424,-2,13555.0,4,13560.0,2,B
2018-04-12 13:39:05,13560.0,2,13426,0,13555.0,3,13560.0,1,B
2018-04-12 13:39:06,13555.0,2,13428,2,13555.0,2,13560.0,1,S
2018-04-12 13:39:22,13560.0,2,13430,-2,13555.0,2,13560.0,1,B
2018-04-12 13:39:38,13565.0,2,13432,-2,13560.0,6,13565.0,18,B
2018-04-12 13:39:39,13560.0,2,13434,2,13560.0,5,13565.0,18,S
2018-04-12 13:39:47,13560.0,2,13436,2,13560.0,3,13565.0,18,S
2018-04-12 13:39:51,13560.0,4,13440,0,13555.0,6,13565.0,18,S
2018-04-12 13:40:11,13560.0,2,13442,2,13560.0,19,13565.0,19,S
2018-04-12 13:40:18,13565.0,2,13444,-2,13560.0,19,13565.0,18,B
2018-04-12 13:40:25,13565.0,6,13450,-4,13560.0,18,13565.0,15,B
2018-04-12 13:40:26,13565.0,2,13452,0,13560.0,19,13565.0,14,B
2018-04-12 13:40:27,13565.0,20,13472,-8,13560.0,20,13565.0,4,B
2018-04-12 13:40:28,13565.0,8,13480,2,13565.0,10,13570.0,3,B
2018-04-12 13:40:37,13570.0,6,13486,2,13570.0,17,13575.0,6,B
2018-04-12 13:40:42,13575.0,8,13494,4,13570.0,17,13580.0,7,B
2018-04-12 13:40:43,13575.0,2,13496,0,13575.0,1,13580.0,11,B
2018-04-12 13:40:44,13575.0,2,13498,2,13570.0,17,13580.0,11,B
2018-04-12 13:40:49,13580.0,2,13500,-2,13570.0,17,13580.0,13,B
2018-04-12 13:41:00,13575.0,2,13502,0,13575.0,1,13580.0,13,S
2018-04-12 13:41:19,13580.0,4,13506,2,13575.0,7,13580.0,1,B
2018-04-12 13:41:20,13580.0,2,13508,0,13580.0,3,13585.0,8,B
2018-04-12 13:41:25,13585.0,2,13510,0,13580.0,2,13585.0,7,B
2018-04-12 13:41:27,13580.0,2,13512,2,13580.0,1,13585.0,7,S
2018-04-12 13:41:28,13585.0,14,13526,-6,13585.0,33,13590.0,15,B
2018-04-12 13:41:30,13590.0,16,13542,-4,13585.0,33,13590.0,1,B
2018-04-12 13:41:31,13590.0,2,13544,0,13585.0,33,13595.0,6,B
2018-04-12 13:41:32,13590.0,6,13550,2,13585.0,34,13595.0,6,B
2018-04-12 13:41:34,13590.0,4,13554,0,13585.0,36,13590.0,7,B
2018-04-12 13:41:35,13590.0,6,13560,-2,13585.0,36,13590.0,4,B
2018-04-12 13:41:35,13590.0,2,13562,-2,13585.0,36,13590.0,3,B
2018-04-12 13:41:37,13585.0,2,13564,0,13585.0,35,13590.0,4,S
2018-04-12 13:41:40,13590.0,2,13566,0,13585.0,36,13590.0,3,B
2018-04-12 13:41:47,13590.0,10,13576,4,13585.0,42,13595.0,4,B
2018-04-12 13:41:48,13590.0,2,13578,-2,13585.0,39,13595.0,6,B
2018-04-12 13:41:53,13595.0,4,13582,-2,13590.0,1,13595.0,3,B
2018-04-12 13:41:54,13590.0,4,13586,0,13585.0,34,13590.0,6,S
2018-04-12 13:41:54,13585.0,2,13588,0,13585.0,33,13590.0,6,S
2018-04-12 13:41:56,13590.0,4,13592,0,13585.0,33,13590.0,2,B
2018-04-12 13:42:04,13595.0,2,13594,0,13585.0,35,13595.0,21,B
2018-04-12 13:42:12,13595.0,4,13598,4,13590.0,1,13595.0,17,B
2018-04-12 13:42:15,13595.0,16,13614,0,13590.0,1,13595.0,7,B
2018-04-12 13:42:15,13595.0,2,13616,0,13590.0,1,13595.0,6,B
2018-04-12 13:42:23,13595.0,2,13618,0,13590.0,1,13595.0,8,B
2018-04-12 13:42:37,13595.0,8,13626,8,13590.0,2,13595.0,1,B
2018-04-12 13:42:39,13595.0,2,13628,2,13590.0,2,13600.0,32,B
2018-04-12 13:42:41,13595.0,2,13630,0,13590.0,3,13595.0,3,B
2018-04-12 13:42:42,13590.0,2,13632,2,13590.0,2,13595.0,3,S
2018-04-12 13:42:48,13590.0,2,13634,0,13590.0,3,13595.0,6,S
2018-04-12 13:42:52,13590.0,2,13636,2,13590.0,2,13595.0,6,S
2018-04-12 13:43:00,13590.0,4,13640,2,13590.0,12,13595.0,6,S
2018-04-12 13:43:19,13595.0,8,13648,4,13590.0,13,13595.0,3,B
2018-04-12 13:43:40,13595.0,8,13656,8,13595.0,1,13600.0,34,B
2018-04-12 13:43:40,13595.0,2,13658,0,13590.0,13,13595.0,5,B
2018-04-12 13:43:50,13595.0,10,13668,2,13590.0,13,13595.0,1,B
2018-04-12 13:44:20,13590.0,24,13692,-6,13585.0,35,13590.0,2,S
2018-04-12 13:44:24,13590.0,2,13694,0,13585.0,37,13590.0,1,S
2018-04-12 13:44:31,13595.0,2,13696,2,13585.0,37,13595.0,9,B
2018-04-12 13:44:37,13590.0,2,13698,0,13585.0,37,13595.0,9,S
2018-04-12 13:44:41,13590.0,2,13700,0,13585.0,37,13595.0,10,S
2018-04-12 13:45:41,13590.0,2,13702,-2,13590.0,1,13595.0,8,S
2018-04-12 13:45:42,13590.0,2,13704,0,13585.0,37,13590.0,3,S
2018-04-12 13:45:44,13590.0,2,13706,0,13585.0,37,13595.0,9,S
2018-04-12 13:45:48,13595.0,2,13708,0,13590.0,1,13595.0,7,B
2018-04-12 13:45:56,13590.0,2,13710,0,13590.0,1,13595.0,7,S
2018-04-12 13:46:10,13590.0,2,13712,2,13590.0,1,13595.0,8,S
2018-04-12 13:47:22,13590.0,2,13714,0,13590.0,2,13595.0,9,S
2018-04-12 13:47:41,13590.0,6,13720,4,13585.0,38,13590.0,3,S
2018-04-12 13:47:42,13590.0,6,13726,2,13585.0,40,13595.0,9,S
2018-04-12 13:47:43,13595.0,2,13728,0,13590.0,2,13595.0,8,B
2018-04-12 13:47:46,13595.0,2,13730,2,13590.0,23,13595.0,6,B
2018-04-12 13:47:54,13590.0,12,13742,6,13590.0,16,13595.0,7,S
2018-04-12 13:47:54,13590.0,6,13748,4,13590.0,13,13595.0,7,S
2018-04-12 13:47:55,13590.0,2,13750,0,13590.0,12,13595.0,7,S
2018-04-12 13:48:00,13595.0,22,13772,-10,13595.0,20,13600.0,46,B
2018-04-12 13:48:01,13595.0,4,13776,-2,13595.0,18,13600.0,46,B
2018-04-12 13:48:01,13595.0,6,13782,0,13595.0,15,13600.0,48,B
2018-04-12 13:48:05,13600.0,2,13784,2,13595.0,15,13600.0,48,B
2018-04-12 13:48:06,13595.0,2,13786,-2,13595.0,14,13600.0,43,S
2018-04-12 13:48:13,13595.0,4,13790,0,13595.0,12,13600.0,43,S
2018-04-12 13:48:16,13595.0,2,13792,0,13595.0,11,13600.0,43,S
2018-04-12 13:48:28,13595.0,2,13794,0,13595.0,10,13600.0,41,S
2018-04-12 13:48:31,13595.0,20,13814,-20,13590.0,18,13600.0,41,S
2018-04-12 13:48:36,13590.0,2,13816,2,13590.0,17,13600.0,44,S
2018-04-12 13:49:02,13595.0,2,13818,-2,13590.0,19,13600.0,41,B
2018-04-12 13:49:17,13595.0,2,13820,-2,13595.0,4,13600.0,40,B
2018-04-12 13:49:18,13595.0,6,13826,-4,13590.0,21,13595.0,1,B
2018-04-12 13:49:27,13590.0,2,13828,2,13590.0,20,13600.0,43,S
2018-04-12 13:49:41,13595.0,4,13832,0,13590.0,20,13600.0,41,B
2018-04-12 13:49:42,13600.0,2,13834,2,13595.0,1,13600.0,40,B
2018-04-12 13:49:51,13600.0,6,13840,6,13595.0,1,13600.0,37,B
2018-04-12 13:50:00,13600.0,2,13842,2,13595.0,11,13600.0,36,B
2018-04-12 13:50:16,13595.0,2,13844,2,13595.0,7,13600.0,36,S
2018-04-12 13:50:18,13595.0,6,13850,0,13595.0,1,13600.0,36,S
2018-04-12 13:50:31,13595.0,2,13852,0,13590.0,16,13600.0,36,S
2018-04-12 13:50:54,13595.0,2,13854,0,13590.0,19,13595.0,4,S
2018-04-12 13:51:21,13595.0,2,13856,0,13590.0,21,13595.0,5,S
2018-04-12 13:51:22,13595.0,4,13860,4,13590.0,21,13595.0,3,S
2018-04-12 13:51:28,13595.0,2,13862,2,13590.0,21,13595.0,2,S
2018-04-12 13:51:29,13595.0,4,13866,4,13590.0,21,13600.0,42,S
2018-04-12 13:52:17,13590.0,30,13896,22,13585.0,9,13595.0,10,S
2018-04-12 13:52:23,13590.0,4,13900,0,13590.0,1,13595.0,10,S
2018-04-12 13:52:23,13590.0,2,13902,-2,13585.0,10,13595.0,10,S
2018-04-12 13:52:30,13585.0,6,13908,-2,13585.0,8,13595.0,10,S
2018-04-12 13:52:40,13585.0,6,13914,-2,13585.0,8,13595.0,10,S
2018-04-12 13:52:43,13595.0,2,13916,0,13585.0,8,13595.0,12,B
2018-04-12 13:52:49,13585.0,2,13918,0,13585.0,12,13595.0,12,S
2018-04-12 13:53:28,13585.0,8,13926,0,13580.0,7,13585.0,1,S
2018-04-12 13:53:32,13585.0,2,13928,2,13585.0,4,13590.0,4,S
2018-04-12 13:53:34,13585.0,8,13936,8,13580.0,13,13585.0,15,S
2018-04-12 13:53:34,13580.0,22,13958,14,13575.0,7,13585.0,11,S
2018-04-12 13:53:48,13575.0,6,13964,0,13570.0,5,13575.0,1,S
2018-04-12 13:53:49,13575.0,2,13966,2,13575.0,1,13580.0,3,S
2018-04-12 13:53:51,13575.0,2,13968,0,13570.0,7,13580.0,3,S
2018-04-12 13:53:52,13570.0,10,13978,-8,13570.0,5,13580.0,3,S
2018-04-12 13:53:58,13575.0,2,13980,0,13570.0,2,13575.0,5,B
2018-04-12 13:54:01,13575.0,12,13992,0,13575.0,19,13580.0,9,B
2018-04-12 13:54:10,13575.0,2,13994,0,13575.0,18,13580.0,6,B
2018-04-12 13:54:11,13580.0,2,13996,-2,13575.0,18,13580.0,5,B
2018-04-12 13:54:14,13580.0,2,13998,0,13575.0,20,13585.0,5,B
2018-04-12 13:54:16,13575.0,2,14000,-2,13575.0,19,13585.0,10,S
2018-04-12 13:54:23,13580.0,2,14002,0,13575.0,19,13585.0,15,B
2018-04-12 13:55:10,13575.0,2,14004,-2,13575.0,1,13580.0,9,S
2018-04-12 13:55:11,13575.0,2,14006,0,13570.0,4,13580.0,14,S
2018-04-12 13:55:19,13575.0,10,14016,0,13575.0,11,13580.0,10,S
2018-04-12 13:55:21,13575.0,6,14022,-6,13575.0,8,13580.0,10,S
2018-04-12 13:55:28,13575.0,16,14038,-2,13570.0,4,13575.0,1,S
2018-04-12 13:56:05,13575.0,2,14040,0,13570.0,7,13575.0,4,S
2018-04-12 13:56:11,13570.0,6,14046,2,13570.0,4,13575.0,9,S
2018-04-12 13:56:24,13575.0,2,14048,0,13570.0,4,13575.0,8,B
2018-04-12 13:56:28,13570.0,8,14056,6,13565.0,8,13570.0,1,S
2018-04-12 13:56:29,13570.0,2,14058,0,13570.0,4,13575.0,3,S
2018-04-12 13:56:33,13570.0,8,14066,0,13565.0,10,13570.0,1,S
2018-04-12 13:56:33,13570.0,2,14068,2,13565.0,10,13575.0,8,S
2018-04-12 13:56:40,13565.0,2,14070,2,13565.0,8,13570.0,9,S
2018-04-12 13:56:43,13570.0,10,14080,-10,13565.0,8,13570.0,4,B
2018-04-12 13:56:44,13570.0,8,14088,-4,13570.0,6,13575.0,3,B
2018-04-12 13:56:49,13570.0,2,14090,0,13570.0,4,13575.0,2,B
2018-04-12 13:57:16,13570.0,2,14092,-2,13570.0,2,13575.0,2,B
2018-04-12 13:57:21,13570.0,4,14096,-2,13570.0,1,13575.0,2,B
2018-04-12 13:57:25,13570.0,2,14098,0,13570.0,1,13575.0,2,B
2018-04-12 13:58:06,13575.0,2,14100,0,13570.0,1,13575.0,1,B
2018-04-12 13:58:09,13575.0,2,14102,0,13570.0,6,13580.0,6,B
2018-04-12 13:58:18,13575.0,2,14104,0,13570.0,4,13575.0,1,B
2018-04-12 13:58:33,13575.0,2,14106,0,13570.0,6,13580.0,6,B
2018-04-12 13:59:04,13575.0,2,14108,0,13570.0,5,13580.0,8,B
2018-04-12 13:59:26,13575.0,2,14110,0,13570.0,3,13575.0,4,B
2018-04-12 13:59:50,13570.0,6,14116,2,13565.0,21,13570.0,2,S
2018-04-12 13:59:50,13570.0,4,14120,0,13565.0,10,13575.0,4,S
2018-04-12 13:59:51,13575.0,4,14124,0,13565.0,9,13575.0,3,B
2018-04-12 14:00:01,13565.0,10,14134,8,13560.0,11,13570.0,11,S
2018-04-12 14:00:05,13565.0,2,14136,2,13560.0,10,13570.0,11,S
2018-04-12 14:00:10,13570.0,20,14156,0,13565.0,1,13570.0,1,B
2018-04-12 14:00:31,13570.0,2,14158,-2,13570.0,6,13575.0,2,B
2018-04-12 14:01:03,13565.0,2,14160,-2,13565.0,3,13570.0,4,S
2018-04-12 14:01:08,13570.0,2,14162,0,13565.0,3,13570.0,3,B
2018-04-12 14:01:08,13565.0,2,14164,0,13565.0,2,13570.0,3,S
2018-04-12 14:01:14,13565.0,2,14166,-2,13565.0,1,13570.0,3,S
2018-04-12 14:01:23,13565.0,2,14168,-2,13565.0,2,13570.0,6,S
2018-04-12 14:01:56,13570.0,4,14172,0,13565.0,10,13570.0,3,B
2018-04-12 14:01:56,13570.0,6,14178,0,13565.0,10,13575.0,4,B
2018-04-12 14:02:04,13575.0,6,14184,4,13575.0,7,13580.0,10,B
2018-04-12 14:02:04,13575.0,14,14198,6,13570.0,1,13580.0,12,B
2018-04-12 14:02:05,13570.0,10,14208,0,13565.0,4,13575.0,2,S
2018-04-12 14:02:09,13570.0,2,14210,0,13565.0,5,13570.0,4,S
2018-04-12 14:02:10,13570.0,2,14212,0,13565.0,5,13570.0,3,S
2018-04-12 14:02:14,13570.0,4,14216,4,13565.0,5,13570.0,1,S
2018-04-12 14:02:16,13570.0,2,14218,0,13565.0,5,13575.0,4,S
2018-04-12 14:02:29,13570.0,2,14220,0,13570.0,1,13575.0,2,S
2018-04-12 14:02:43,13575.0,2,14222,0,13570.0,1,13575.0,3,B
2018-04-12 14:02:44,13575.0,2,14224,2,13565.0,5,13575.0,3,B
2018-04-12 14:03:19,13575.0,4,14228,2,13570.0,7,13575.0,3,B
2018-04-12 14:03:19,13575.0,6,14234,0,13575.0,1,13580.0,8,B
2018-04-12 14:04:53,13580.0,2,14236,2,13575.0,9,13580.0,10,B
2018-04-12 14:04:54,13575.0,4,14240,0,13575.0,7,13580.0,10,S
2018-04-12 14:04:54,13575.0,14,14254,8,13570.0,2,13575.0,15,S
2018-04-12 14:04:55,13570.0,4,14258,-4,13565.0,3,13575.0,17,S
2018-04-12 14:05:05,13565.0,2,14260,2,13565.0,4,13570.0,10,S
2018-04-12 14:05:17,13570.0,2,14262,2,13570.0,2,13575.0,6,B
2018-04-12 14:05:27,13575.0,2,14264,2,13565.0,7,13575.0,1,B
2018-04-12 14:06:01,13570.0,2,14266,0,13565.0,4,13570.0,2,S
2018-04-12 14:06:33,13565.0,2,14268,0,13560.0,13,13570.0,11,S
2018-04-12 14:06:40,13560.0,10,14278,4,13560.0,8,13565.0,1,S
2018-04-12 14:06:42,13560.0,10,14288,2,13560.0,1,13565.0,1,S
2018-04-12 14:06:50,13560.0,2,14290,-2,13560.0,1,13565.0,6,S
2018-04-12 14:08:15,13565.0,2,14292,-2,13565.0,1,13570.0,3,B
2018-04-12 14:08:15,13565.0,2,14294,0,13560.0,14,13570.0,3,B
2018-04-12 14:08:26,13565.0,2,14296,0,13560.0,8,13570.0,12,B
2018-04-12 14:08:56,13565.0,2,14298,2,13560.0,7,13565.0,1,B
2018-04-12 14:09:15,13560.0,2,14300,0,13560.0,8,13565.0,17,S
2018-04-12 14:09:16,13560.0,16,14316,-8,13555.0,4,13560.0,3,S
2018-04-12 14:09:45,13560.0,4,14320,0,13555.0,7,13560.0,10,S
2018-04-12 14:09:46,13560.0,4,14324,-4,13555.0,7,13560.0,8,S
2018-04-12 14:09:46,13560.0,10,14334,6,13555.0,7,13560.0,3,S
2018-04-12 14:09:47,13560.0,4,14338,4,13555.0,7,13560.0,1,S
2018-04-12 14:09:55,13560.0,2,14340,0,13555.0,5,13565.0,7,S
2018-04-12 14:10:04,13570.0,2,14342,-2,13560.0,2,13570.0,8,B
2018-04-12 14:11:11,13560.0,2,14344,0,13560.0,1,13565.0,7,S
2018-04-12 14:11:12,13560.0,2,14346,0,13555.0,8,13565.0,7,S
2018-04-12 14:11:13,13555.0,4,14350,-4,13555.0,1,13560.0,8,S
2018-04-12 14:11:18,13555.0,2,14352,2,13550.0,9,13555.0,4,S
2018-04-12 14:11:23,13550.0,6,14358,0,13545.0,18,13550.0,6,S
2018-04-12 14:11:24,13550.0,14,14372,6,13550.0,1,13555.0,11,S
2018-04-12 14:11:24,13555.0,14,14386,8,13555.0,3,13560.0,6,B
2018-04-12 14:11:41,13555.0,2,14388,0,13550.0,10,13555.0,1,B
2018-04-12 14:11:52,13550.0,4,14392,0,13545.0,22,13555.0,8,S
2018-04-12 14:12:12,13555.0,4,14396,0,13550.0,1,13555.0,12,B
2018-04-12 14:12:18,13555.0,2,14398,0,13550.0,1,13555.0,11,B
2018-04-12 14:12:35,13555.0,2,14400,0,13550.0,10,13555.0,1,B
2018-04-12 14:12:44,13555.0,10,14410,-10,13550.0,3,13555.0,3,B
2018-04-12 14:13:03,13550.0,4,14414,2,13545.0,23,13550.0,3,S
2018-04-12 14:13:03,13550.0,6,14420,0,13550.0,3,13555.0,6,S
2018-04-12 14:13:05,13550.0,4,14424,0,13545.0,23,13550.0,8,S
2018-04-12 14:13:06,13550.0,2,14426,2,13545.0,23,13550.0,7,S
2018-04-12 14:13:11,13545.0,2,14428,0,13545.0,21,13550.0,7,S
2018-04-12 14:13:12,13545.0,12,14440,-10,13545.0,16,13550.0,6,S
2018-04-12 14:13:18,13550.0,2,14442,0,13545.0,12,13550.0,9,B
2018-04-12 14:13:20,13545.0,6,14448,-6,13545.0,9,13550.0,12,S
2018-04-12 14:13:20,13545.0,18,14466,6,13540.0,10,13545.0,1,S
2018-04-12 14:13:24,13540.0,12,14478,-6,13535.0,6,13545.0,15,S
2018-04-12 14:13:25,13540.0,6,14484,0,13535.0,7,13545.0,6,S
2018-04-12 14:13:26,13540.0,4,14488,2,13540.0,2,13545.0,2,S
2018-04-12 14:13:29,13540.0,2,14490,0,13535.0,3,13540.0,6,S
2018-04-12 14:13:30,13535.0,2,14492,2,13535.0,2,13540.0,6,S
2018-04-12 14:13:31,13535.0,2,14494,0,13535.0,1,13540.0,6,S
2018-04-12 14:13:33,13540.0,10,14504,0,13535.0,2,13540.0,1,B
2018-04-12 14:13:34,13540.0,2,14506,0,13540.0,2,13545.0,5,B
2018-04-12 14:13:48,13540.0,4,14510,-2,13535.0,6,13540.0,1,B
2018-04-12 14:13:58,13540.0,4,14514,-2,13540.0,6,13545.0,22,B
2018-04-12 14:13:59,13540.0,8,14522,-6,13540.0,2,13545.0,30,B
2018-04-12 14:13:59,13540.0,2,14524,-2,13540.0,1,13545.0,30,B
2018-04-12 14:14:02,13545.0,2,14526,0,13540.0,2,13545.0,22,B
2018-04-12 14:14:10,13540.0,2,14528,-2,13540.0,5,13545.0,17,S
2018-04-12 14:14:18,13540.0,4,14532,0,13535.0,8,13540.0,3,S
2018-04-12 14:14:25,13540.0,2,14534,2,13535.0,8,13540.0,2,S
2018-04-12 14:15:02,13535.0,2,14536,0,13530.0,43,13540.0,8,S
2018-04-12 14:15:16,13535.0,2,14538,0,13530.0,43,13540.0,21,S
2018-04-12 14:15:24,13535.0,16,14554,-16,13530.0,46,13535.0,9,S
2018-04-12 14:15:26,13535.0,2,14556,0,13530.0,46,13535.0,8,S
2018-04-12 14:15:36,13530.0,2,14558,0,13530.0,41,13535.0,13,S
2018-04-12 14:15:36,13530.0,16,14574,-6,13530.0,35,13535.0,19,S
2018-04-12 14:15:37,13530.0,2,14576,-2,13530.0,34,13535.0,23,S
2018-04-12 14:15:43,13530.0,4,14580,0,13530.0,32,13535.0,14,S
2018-04-12 14:15:45,13530.0,34,14614,0,13530.0,15,13535.0,9,S
2018-04-12 14:15:58,13530.0,20,14634,2,13530.0,6,13535.0,9,S
2018-04-12 14:16:00,13535.0,2,14636,-2,13530.0,6,13535.0,8,B
2018-04-12 14:16:01,13530.0,12,14648,2,13525.0,6,13530.0,4,S
2018-04-12 14:16:25,13530.0,10,14658,4,13530.0,13,13535.0,11,S
2018-04-12 14:16:29,13535.0,2,14660,-2,13530.0,13,13535.0,8,B
2018-04-12 14:16:38,13535.0,2,14662,-2,13530.0,15,13535.0,5,B
2018-04-12 14:16:38,13535.0,10,14672,-4,13535.0,1,13540.0,17,B
2018-04-12 14:16:39,13540.0,22,14694,8,13540.0,5,13545.0,4,B
2018-04-12 14:16:40,13545.0,2,14696,2,13540.0,2,13550.0,12,B
2018-04-12 14:16:53,13550.0,8,14704,4,13545.0,7,13550.0,2,B
2018-04-12 14:16:54,13550.0,2,14706,0,13545.0,7,13550.0,1,B
2018-04-12 14:16:55,13550.0,2,14708,2,13545.0,7,13555.0,8,B
2018-04-12 14:17:19,13550.0,6,14714,-2,13545.0,7,13550.0,2,B
2018-04-12 14:17:29,13550.0,4,14718,0,13550.0,3,13555.0,12,B
2018-04-12 14:17:38,13550.0,6,14724,4,13545.0,7,13550.0,3,B
2018-04-12 14:17:45,13550.0,2,14726,2,13545.0,5,13555.0,14,B
2018-04-12 14:18:00,13550.0,2,14728,2,13545.0,6,13555.0,15,B
2018-04-12 14:19:25,13550.0,2,14730,0,13550.0,1,13555.0,14,B
2018-04-12 14:20:14,13550.0,4,14734,2,13545.0,8,13550.0,3,B
2018-04-12 14:20:15,13545.0,2,14736,0,13545.0,3,13550.0,8,S
2018-04-12 14:20:26,13545.0,6,14742,-4,13540.0,2,13545.0,3,S
2018-04-12 14:20:26,13545.0,2,14744,0,13535.0,6,13545.0,8,S
2018-04-12 14:20:46,13545.0,2,14746,2,13540.0,18,13545.0,3,S
2018-04-12 14:20:46,13545.0,6,14752,6,13545.0,1,13550.0,3,S
2018-04-12 14:20:56,13545.0,2,14754,-2,13540.0,18,13550.0,11,S
2018-04-12 14:20:57,13545.0,2,14756,-2,13540.0,2,13545.0,3,S
2018-04-12 14:20:58,13545.0,2,14758,2,13540.0,19,13550.0,4,S
2018-04-12 14:21:34,13545.0,4,14762,0,13540.0,3,13545.0,2,S
2018-04-12 14:22:03,13545.0,2,14764,-2,13540.0,6,13550.0,3,S
2018-04-12 14:22:25,13545.0,2,14766,2,13545.0,13,13555.0,5,S
2018-04-12 14:22:57,13555.0,2,14768,-2,13555.0,2,13560.0,7,B
2018-04-12 14:22:58,13555.0,2,14770,0,13550.0,5,13560.0,4,B
2018-04-12 14:23:24,13555.0,2,14772,2,13555.0,4,13560.0,5,B
2018-04-12 14:23:25,13560.0,2,14774,-2,13555.0,4,13560.0,4,B
2018-04-12 14:23:26,13560.0,2,14776,0,13555.0,4,13560.0,1,B
2018-04-12 14:23:58,13555.0,6,14782,6,13555.0,2,13560.0,8,S
2018-04-12 14:23:59,13555.0,4,14786,-2,13550.0,15,13555.0,2,S
2018-04-12 14:24:23,13555.0,2,14788,2,13555.0,2,13560.0,5,S
2018-04-12 14:24:41,13560.0,34,14822,30,13560.0,52,13565.0,27,B
2018-04-12 14:24:41,13560.0,22,14844,20,13560.0,41,13565.0,32,B
2018-04-12 14:24:52,13560.0,2,14846,2,13560.0,40,13565.0,22,B
2018-04-12 14:25:05,13560.0,2,14848,2,13560.0,39,13565.0,37,B
2018-04-12 14:25:28,13560.0,2,14850,2,13560.0,38,13565.0,38,B
2018-04-12 14:25:45,13565.0,8,14858,2,13560.0,42,13565.0,15,B
2018-04-12 14:26:04,13565.0,10,14868,10,13560.0,42,13565.0,6,B
2018-04-12 14:26:06,13565.0,8,14876,6,13560.0,42,13565.0,2,B
2018-04-12 14:26:07,13565.0,4,14880,-2,13560.0,42,13570.0,12,B
2018-04-12 14:26:14,13560.0,2,14882,2,13560.0,38,13565.0,19,S
2018-04-12 14:26:28,13565.0,2,14884,0,13560.0,38,13565.0,11,B
2018-04-12 14:26:36,13565.0,2,14886,0,13560.0,44,13565.0,8,B
2018-04-12 14:26:48,13560.0,2,14888,0,13560.0,43,13565.0,8,S
2018-04-12 14:27:23,13565.0,2,14890,2,13560.0,38,13565.0,11,B
2018-04-12 14:28:00,13565.0,46,14936,46,13565.0,6,13570.0,9,B
2018-04-12 14:28:01,13570.0,14,14950,10,13570.0,13,13575.0,2,B
2018-04-12 14:28:08,13575.0,4,14954,2,13570.0,5,13580.0,8,B
2018-04-12 14:28:08,13580.0,2,14956,-2,13570.0,5,13580.0,8,B
2018-04-12 14:28:09,13580.0,2,14958,-2,13570.0,17,13580.0,7,B
2018-04-12 14:28:21,13570.0,2,14960,-2,13570.0,3,13580.0,15,S
2018-04-12 14:28:46,13570.0,2,14962,-2,13570.0,4,13575.0,3,S
2018-04-12 14:28:52,13575.0,2,14964,0,13570.0,7,13575.0,1,B
2018-04-12 14:28:56,13575.0,6,14970,-4,13570.0,2,13575.0,1,B
2018-04-12 14:29:08,13570.0,4,14974,-2,13570.0,1,13575.0,16,S
2018-04-12 14:29:08,13570.0,4,14978,-2,13565.0,5,13575.0,16,S
2018-04-12 14:29:10,13570.0,4,14982,0,13565.0,10,13575.0,16,S
2018-04-12 14:29:36,13575.0,2,14984,0,13570.0,3,13575.0,14,B
2018-04-12 14:29:51,13570.0,2,14986,-2,13570.0,2,13575.0,14,S
2018-04-12 14:30:06,13570.0,2,14988,0,13565.0,8,13575.0,6,S
2018-04-12 14:31:07,13565.0,14,15002,-10,13560.0,43,13570.0,8,S
2018-04-12 14:31:16,13565.0,10,15012,0,13560.0,42,13570.0,6,S
2018-04-12 14:31:48,13565.0,6,15018,-2,13560.0,39,13570.0,9,S
2018-04-12 14:32:05,13565.0,6,15024,-6,13565.0,2,13570.0,10,S
2018-04-12 14:32:05,13565.0,4,15028,-4,13560.0,41,13570.0,10,S
2018-04-12 14:32:13,13565.0,6,15034,4,13565.0,2,13570.0,13,S
2018-04-12 14:32:13,13565.0,4,15038,4,13560.0,38,13565.0,1,S
2018-04-12 14:32:25,13560.0,16,15054,16,13560.0,30,13565.0,2,S
2018-04-12 14:32:37,13565.0,2,15056,2,13560.0,30,13565.0,2,B
2018-04-12 14:32:51,13565.0,6,15062,2,13565.0,5,13570.0,4,B
2018-04-12 14:32:54,13565.0,8,15070,8,13560.0,35,13565.0,1,B
2018-04-12 14:32:55,13565.0,2,15072,2,13565.0,1,13570.0,4,B
2018-04-12 14:33:02,13565.0,2,15074,0,13565.0,1,13570.0,3,B
2018-04-12 14:33:05,13570.0,2,15076,2,13565.0,1,13570.0,2,B
2018-04-12 14:33:19,13565.0,4,15080,0,13560.0,47,13570.0,1,S
2018-04-12 14:33:26,13570.0,2,15082,0,13565.0,10,13575.0,3,B
2018-04-12 14:33:45,13565.0,24,15106,-12,13560.0,45,13565.0,23,S
2018-04-12 14:33:46,13565.0,4,15110,-4,13560.0,46,13565.0,21,S
2018-04-12 14:34:02,13565.0,2,15112,0,13560.0,33,13565.0,20,S
2018-04-12 14:34:17,13565.0,2,15114,0,13560.0,35,13565.0,19,S
2018-04-12 14:34:55,13565.0,14,15128,-10,13560.0,37,13565.0,12,S
2018-04-12 14:34:56,13565.0,12,15140,-6,13560.0,39,13565.0,6,S
2018-04-12 14:34:56,13565.0,12,15152,-8,13560.0,39,13570.0,4,S
2018-04-12 14:35:22,13570.0,2,15154,0,13565.0,14,13575.0,8,B
2018-04-12 14:35:50,13570.0,2,15156,0,13565.0,16,13575.0,7,B
2018-04-12 14:36:28,13570.0,2,15158,0,13570.0,4,13575.0,7,B
2018-04-12 14:36:28,13570.0,8,15166,-4,13560.0,46,13570.0,8,B
2018-04-12 14:36:31,13570.0,2,15168,0,13560.0,38,13570.0,5,B
2018-04-12 14:37:27,13565.0,2,15170,0,13565.0,3,13570.0,7,S
2018-04-12 14:37:49,13570.0,2,15172,0,13565.0,3,13570.0,3,B
2018-04-12 14:38:02,13565.0,6,15178,0,13560.0,32,13565.0,2,S
2018-04-12 14:38:08,13560.0,4,15182,2,13560.0,27,13565.0,8,S
2018-04-12 14:38:09,13560.0,2,15184,0,13560.0,26,13565.0,8,S
2018-04-12 14:40:35,13565.0,4,15188,4,13560.0,26,13570.0,10,B
2018-04-12 14:40:35,13560.0,40,15228,38,13560.0,30,13570.0,4,S
2018-04-12 14:40:52,13560.0,20,15248,20,13560.0,17,13565.0,1,S
2018-04-12 14:41:30,13560.0,8,15256,8,13560.0,8,13565.0,9,S
2018-04-12 14:41:35,13560.0,2,15258,0,13560.0,7,13565.0,9,S
2018-04-12 14:41:46,13565.0,10,15268,-4,13560.0,7,13565.0,4,B
2018-04-12 14:43:27,13565.0,10,15278,-10,13560.0,13,13565.0,7,B
2018-04-12 14:44:06,13565.0,2,15280,-2,13560.0,21,13565.0,15,B
2018-04-12 14:44:07,13565.0,6,15286,-4,13560.0,33,13565.0,10,B
2018-04-12 14:44:07,13565.0,6,15292,4,13560.0,33,13565.0,7,B
2018-04-12 14:44:08,13565.0,2,15294,0,13560.0,33,13565.0,6,B
2018-04-12 14:44:11,13565.0,2,15296,2,13560.0,33,13565.0,5,B
2018-04-12 14:44:18,13565.0,2,15298,2,13560.0,19,13565.0,4,B
2018-04-12 14:44:39,13565.0,2,15300,2,13560.0,12,13565.0,3,B
2018-04-12 14:44:50,13565.0,4,15304,4,13560.0,12,13565.0,1,B
2018-04-12 14:44:55,13560.0,2,15306,2,13560.0,11,13565.0,1,S
2018-04-12 14:45:10,13560.0,2,15308,0,13560.0,9,13565.0,9,S
2018-04-12 14:45:11,13560.0,4,15312,4,13560.0,5,13565.0,9,S
2018-04-12 14:45:29,13560.0,2,15314,0,13560.0,4,13565.0,6,S
2018-04-12 14:45:30,13560.0,8,15322,4,13555.0,5,13565.0,6,S
2018-04-12 14:45:35,13560.0,2,15324,0,13555.0,2,13560.0,3,S
2018-04-12 14:45:35,13560.0,2,15326,0,13555.0,4,13560.0,2,S
2018-04-12 14:45:37,13560.0,2,15328,0,13555.0,4,13560.0,1,S
2018-04-12 14:45:47,13555.0,2,15330,0,13550.0,22,13560.0,5,S
2018-04-12 14:46:06,13550.0,2,15332,0,13550.0,19,13555.0,2,S
2018-04-12 14:46:14,13550.0,2,15334,-2,13550.0,18,13555.0,4,S
2018-04-12 14:46:28,13550.0,2,15336,0,13550.0,17,13555.0,5,S
2018-04-12 14:46:49,13550.0,4,15340,0,13550.0,15,13555.0,4,S
2018-04-12 14:46:53,13550.0,2,15342,-2,13550.0,14,13555.0,6,S
2018-04-12 14:46:56,13550.0,2,15344,0,13550.0,13,13555.0,6,S
2018-04-12 14:47:17,13555.0,8,15352,-2,13550.0,13,13560.0,5,B
2018-04-12 14:47:54,13560.0,2,15354,2,13555.0,12,13565.0,17,B
2018-04-12 14:48:12,13560.0,2,15356,0,13560.0,3,13565.0,17,B
2018-04-12 14:48:12,13560.0,6,15362,-6,13555.0,3,13565.0,18,B
2018-04-12 14:48:38,13565.0,2,15364,0,13560.0,10,13565.0,3,B
2018-04-12 14:49:14,13560.0,2,15366,-2,13555.0,1,13560.0,1,S
2018-04-12 14:49:16,13565.0,2,15368,-2,13550.0,16,13565.0,12,B
2018-04-12 14:49:26,13560.0,4,15372,-4,13555.0,3,13560.0,1,S
2018-04-12 14:49:53,13555.0,6,15378,-2,13550.0,15,13560.0,12,S
2018-04-12 14:49:56,13555.0,2,15380,2,13550.0,16,13560.0,12,S
2018-04-12 14:50:34,13550.0,2,15382,-2,13550.0,17,13560.0,13,S
2018-04-12 14:51:11,13550.0,2,15384,-2,13550.0,15,13560.0,22,S
2018-04-12 14:51:53,13550.0,2,15386,0,13550.0,16,13560.0,42,S
2018-04-12 14:52:12,13550.0,2,15388,0,13550.0,13,13560.0,47,S
2018-04-12 14:52:43,13550.0,4,15392,0,13550.0,20,13555.0,5,S
2018-04-12 14:52:43,13550.0,4,15396,0,13550.0,18,13555.0,5,S
2018-04-12 14:52:44,13550.0,4,15400,2,13550.0,16,13555.0,5,S
2018-04-12 14:52:55,13550.0,6,15406,-4,13550.0,13,13555.0,35,S
2018-04-12 14:52:55,13550.0,26,15432,-2,13545.0,16,13550.0,1,S
2018-04-12 14:53:25,13540.0,2,15434,-2,13540.0,7,13550.0,10,S
2018-04-12 14:53:38,13545.0,2,15436,0,13540.0,18,13545.0,4,B
2018-04-12 14:53:38,13540.0,8,15444,-8,13540.0,15,13545.0,3,S
2018-04-12 14:53:39,13545.0,2,15446,0,13540.0,15,13545.0,2,B
2018-04-12 14:53:39,13545.0,2,15448,0,13540.0,14,13545.0,1,B
2018-04-12 14:53:40,13545.0,2,15450,0,13540.0,13,13550.0,7,B
2018-04-12 14:53:46,13545.0,2,15452,2,13540.0,14,13550.0,6,B
2018-04-12 14:53:50,13550.0,2,15454,-2,13540.0,14,13550.0,6,B
2018-04-12 14:54:03,13550.0,4,15458,-2,13550.0,2,13555.0,43,B
2018-04-12 14:54:29,13555.0,2,15460,0,13545.0,7,13555.0,39,B
2018-04-12 14:55:15,13545.0,10,15470,4,13545.0,32,13555.0,37,S
2018-04-12 14:55:19,13550.0,2,15472,2,13540.0,33,13550.0,4,B
2018-04-12 14:55:20,13550.0,2,15474,2,13545.0,9,13550.0,3,B
2018-04-12 14:55:20,13550.0,2,15476,2,13545.0,9,13550.0,2,B
2018-04-12 14:55:21,13550.0,2,15478,2,13545.0,9,13550.0,1,B
2018-04-12 14:55:22,13550.0,2,15480,2,13545.0,14,13555.0,39,B
2018-04-12 14:55:30,13550.0,2,15482,2,13540.0,7,13550.0,7,B
2018-04-12 14:55:43,13550.0,2,15484,2,13545.0,2,13550.0,8,B
2018-04-12 14:55:43,13550.0,2,15486,2,13545.0,7,13550.0,7,B
2018-04-12 14:55:44,13550.0,2,15488,2,13545.0,7,13550.0,6,B
2018-04-12 14:55:44,13550.0,2,15490,2,13545.0,7,13550.0,5,B
2018-04-12 14:55:45,13550.0,2,15492,0,13545.0,7,13550.0,4,B
2018-04-12 14:55:46,13550.0,2,15494,0,13545.0,7,13550.0,3,B
2018-04-12 14:55:46,13550.0,4,15498,0,13545.0,7,13550.0,1,B
2018-04-12 14:55:47,13550.0,2,15500,0,13545.0,7,13555.0,36,B
2018-04-12 14:55:58,13550.0,2,15502,0,13545.0,6,13555.0,38,B
2018-04-12 14:56:07,13555.0,2,15504,2,13550.0,2,13555.0,34,B
2018-04-12 14:56:07,13555.0,2,15506,2,13550.0,2,13555.0,33,B
2018-04-12 14:56:08,13555.0,2,15508,2,13550.0,2,13555.0,32,B
2018-04-12 14:56:09,13555.0,2,15510,2,13550.0,2,13555.0,31,B
2018-04-12 14:56:10,13555.0,2,15512,2,13550.0,2,13555.0,30,B
2018-04-12 14:56:10,13555.0,2,15514,2,13550.0,2,13555.0,29,B
2018-04-12 14:56:11,13555.0,2,15516,2,13550.0,2,13555.0,28,B
2018-04-12 14:56:11,13555.0,2,15518,2,13550.0,2,13555.0,27,B
2018-04-12 14:56:12,13555.0,2,15520,2,13550.0,2,13555.0,26,B
2018-04-12 14:56:12,13550.0,4,15524,2,13545.0,47,13550.0,98,S
2018-04-12 14:56:13,13550.0,10,15534,6,13545.0,48,13550.0,93,S
2018-04-12 14:56:14,13550.0,4,15538,4,13545.0,48,13550.0,91,S
2018-04-12 14:56:15,13550.0,4,15542,4,13545.0,36,13550.0,89,S
2018-04-12 14:56:15,13550.0,4,15546,4,13545.0,36,13550.0,87,S
2018-04-12 14:56:16,13550.0,4,15550,4,13545.0,36,13550.0,85,S
2018-04-12 14:56:17,13550.0,4,15554,4,13545.0,36,13550.0,84,S
2018-04-12 14:56:18,13550.0,4,15558,4,13545.0,36,13550.0,82,S
2018-04-12 14:56:18,13550.0,4,15562,4,13545.0,36,13550.0,80,S
2018-04-12 14:56:19,13550.0,4,15566,4,13545.0,36,13550.0,78,S
2018-04-12 14:56:20,13550.0,4,15570,4,13545.0,24,13550.0,76,S
2018-04-12 14:56:20,13550.0,4,15574,4,13545.0,24,13550.0,75,S
2018-04-12 14:56:21,13550.0,2,15576,2,13545.0,24,13550.0,74,S
2018-04-12 14:56:22,13550.0,2,15578,2,13545.0,24,13550.0,73,S
2018-04-12 14:56:23,13550.0,2,15580,2,13545.0,25,13550.0,72,S
2018-04-12 14:56:24,13550.0,2,15582,2,13545.0,25,13550.0,71,S
2018-04-12 14:56:24,13550.0,2,15584,2,13545.0,25,13550.0,70,S
2018-04-12 14:56:25,13550.0,2,15586,2,13545.0,25,13550.0,69,S
2018-04-12 14:56:26,13550.0,2,15588,2,13545.0,25,13550.0,68,S
2018-04-12 14:56:27,13550.0,2,15590,2,13545.0,25,13550.0,67,S
2018-04-12 14:56:28,13550.0,2,15592,2,13545.0,25,13550.0,66,S
2018-04-12 14:56:29,13550.0,2,15594,2,13545.0,25,13550.0,65,S
2018-04-12 14:56:29,13550.0,2,15596,2,13545.0,11,13550.0,64,S
2018-04-12 14:56:30,13550.0,2,15598,2,13545.0,11,13550.0,63,S
2018-04-12 14:56:31,13550.0,2,15600,2,13545.0,11,13550.0,62,S
2018-04-12 14:56:32,13550.0,2,15602,2,13545.0,11,13550.0,61,S
2018-04-12 14:56:32,13545.0,20,15622,2,13540.0,7,13550.0,62,S
2018-04-12 14:56:46,13540.0,4,15626,-4,13540.0,10,13550.0,62,S
2018-04-12 14:56:48,13550.0,2,15628,2,13540.0,10,13550.0,61,B
2018-04-12 14:56:49,13550.0,2,15630,2,13540.0,10,13550.0,60,B
2018-04-12 14:56:50,13550.0,2,15632,2,13540.0,10,13550.0,59,B
2018-04-12 14:56:51,13550.0,2,15634,2,13540.0,10,13550.0,60,B
2018-04-12 14:56:51,13550.0,2,15636,2,13540.0,10,13550.0,59,B
2018-04-12 14:56:52,13550.0,2,15638,2,13540.0,10,13550.0,58,B
2018-04-12 14:56:53,13550.0,2,15640,2,13540.0,10,13550.0,57,B
2018-04-12 14:56:53,13550.0,2,15642,2,13540.0,10,13550.0,56,B
2018-04-12 14:56:54,13550.0,2,15644,2,13540.0,10,13550.0,55,B
2018-04-12 14:56:55,13550.0,2,15646,2,13540.0,10,13550.0,54,B
2018-04-12 14:56:55,13550.0,2,15648,2,13540.0,10,13550.0,53,B
2018-04-12 14:56:56,13550.0,2,15650,2,13540.0,10,13550.0,52,B
2018-04-12 14:56:57,13550.0,2,15652,2,13540.0,10,13550.0,52,B
2018-04-12 14:56:58,13550.0,2,15654,2,13540.0,10,13550.0,51,B
2018-04-12 14:56:59,13550.0,2,15656,2,13540.0,10,13550.0,50,B
2018-04-12 14:56:59,13550.0,2,15658,2,13540.0,10,13550.0,50,B
2018-04-12 14:57:00,13550.0,2,15660,2,13540.0,10,13550.0,49,B
2018-04-12 14:57:00,13550.0,2,15662,2,13540.0,10,13550.0,48,B
2018-04-12 14:57:01,13550.0,2,15664,2,13540.0,10,13550.0,47,B
2018-04-12 14:57:02,13550.0,2,15666,2,13545.0,18,13550.0,43,B
2018-04-12 14:57:03,13550.0,2,15668,2,13545.0,18,13550.0,41,B
2018-04-12 14:57:03,13550.0,2,15670,2,13545.0,18,13550.0,40,B
2018-04-12 14:57:04,13550.0,2,15672,2,13545.0,18,13550.0,39,B
2018-04-12 14:57:04,13550.0,2,15674,2,13545.0,18,13550.0,38,B
2018-04-12 14:57:05,13550.0,2,15676,2,13545.0,18,13550.0,37,B
2018-04-12 14:57:06,13550.0,2,15678,2,13545.0,18,13550.0,37,B
2018-04-12 14:57:06,13550.0,2,15680,2,13545.0,18,13550.0,36,B
2018-04-12 14:57:07,13550.0,2,15682,2,13545.0,18,13550.0,35,B
2018-04-12 14:57:08,13550.0,2,15684,2,13545.0,18,13550.0,34,B
2018-04-12 14:57:49,13545.0,2,15686,-2,13545.0,16,13550.0,34,S
2018-04-12 14:57:57,13550.0,4,15690,0,13545.0,16,13550.0,32,B
2018-04-12 14:57:58,13550.0,4,15694,4,13545.0,16,13550.0,31,B
2018-04-12 14:58:17,13550.0,2,15696,0,13545.0,23,13550.0,40,B
2018-04-12 14:58:22,13550.0,14,15710,0,13545.0,13,13550.0,32,B
2018-04-12 14:58:23,13550.0,10,15720,0,13545.0,13,13550.0,28,B
2018-04-12 14:58:27,13550.0,2,15722,2,13545.0,13,13550.0,27,B
2018-04-12 14:58:27,13550.0,4,15726,0,13545.0,13,13550.0,25,B
2018-04-12 14:58:38,13550.0,2,15728,0,13545.0,13,13550.0,24,B
2018-04-12 14:58:40,13545.0,2,15730,-2,13545.0,12,13550.0,14,S
2018-04-12 14:58:43,13550.0,4,15734,-2,13545.0,13,13550.0,12,B
2018-04-12 14:58:44,13550.0,10,15744,-2,13545.0,13,13550.0,7,B
2018-04-12 14:58:46,13550.0,4,15748,4,13545.0,42,13550.0,5,B
2018-04-12 14:58:46,13550.0,10,15758,2,13550.0,6,13555.0,26,B
2018-04-12 14:58:57,13550.0,2,15760,-2,13550.0,6,13555.0,26,B
2018-04-12 14:58:58,13550.0,2,15762,-2,13550.0,5,13555.0,26,B
2018-04-12 14:59:00,13555.0,2,15764,0,13550.0,5,13555.0,25,B
2018-04-12 14:59:27,13550.0,2,15766,-2,13550.0,10,13555.0,26,S
2018-04-12 14:59:30,13555.0,6,15772,0,13550.0,6,13555.0,23,B
2018-04-12 14:59:30,13550.0,12,15784,-12,13545.0,31,13555.0,23,S
2018-04-12 14:59:31,13545.0,4,15788,-4,13545.0,1,13550.0,2,S
2018-04-12 14:59:32,13545.0,2,15790,-2,13545.0,1,13550.0,2,S
2018-04-12 14:59:32,13545.0,2,15792,-2,13540.0,6,13550.0,2,S
2018-04-12 14:59:34,13550.0,2,15794,-2,13545.0,6,13550.0,1,B
2018-04-12 14:59:37,13550.0,2,15796,-2,13545.0,6,13555.0,21,B
2018-04-12 14:59:42,13545.0,2,15798,-2,13545.0,6,13550.0,3,S
2018-04-12 14:59:49,13550.0,2,15800,0,13545.0,6,13550.0,2,B
2018-04-12 14:59:53,13545.0,4,15804,-4,13545.0,4,13550.0,11,S
2018-04-12 14:59:56,13545.0,8,15812,-8,13545.0,3,13550.0,9,S
2018-04-12 14:59:56,13545.0,2,15814,-2,13545.0,2,13550.0,9,S
2018-04-12 20:59:00,13510.0,8,8,62178,0.0,0,0.0,0,B
2018-04-12 21:00:00,13520.0,4,12,0,13510.0,7,13520.0,3,B
2018-04-12 21:00:01,13520.0,6,18,0,13515.0,2,13535.0,1,B
2018-04-12 21:00:02,13515.0,34,52,10,13515.0,14,13535.0,1,S
2018-04-12 21:00:04,13525.0,2,54,-2,13515.0,4,13520.0,1,B
2018-04-12 21:00:05,13515.0,6,60,0,13515.0,1,13520.0,1,S
2018-04-12 21:00:06,13520.0,2,62,-2,13510.0,7,13530.0,3,B
2018-04-12 21:00:07,13510.0,2,64,0,13510.0,6,13525.0,8,S
2018-04-12 21:00:07,13525.0,2,66,2,13510.0,6,13525.0,9,B
2018-04-12 21:00:16,13525.0,8,74,2,13520.0,1,13535.0,13,B
2018-04-12 21:00:23,13535.0,2,76,0,13520.0,9,13545.0,2,B
2018-04-12 21:00:24,13540.0,2,78,0,13525.0,1,13540.0,7,B
2018-04-12 21:00:34,13540.0,2,80,0,13535.0,1,13540.0,4,B
2018-04-12 21:00:35,13535.0,2,82,-2,13530.0,5,13540.0,6,S
2018-04-12 21:00:36,13530.0,14,96,6,13525.0,3,13535.0,2,S
2018-04-12 21:00:58,13535.0,2,98,0,13520.0,2,13535.0,3,B
2018-04-12 21:01:04,13520.0,2,100,0,13520.0,6,13525.0,1,S
2018-04-12 21:01:05,13520.0,2,102,2,13520.0,5,13525.0,4,S
2018-04-12 21:01:05,13520.0,10,112,10,13515.0,2,13520.0,2,S
2018-04-12 21:01:06,13515.0,4,116,-4,13510.0,7,13525.0,1,S
2018-04-12 21:01:08,13515.0,4,120,0,13510.0,7,13520.0,1,S
2018-04-12 21:01:11,13510.0,2,122,0,13510.0,3,13520.0,11,S
2018-04-12 21:01:11,13510.0,6,128,-2,13505.0,15,13515.0,2,S
2018-04-12 21:01:13,13505.0,12,140,-6,13505.0,9,13510.0,4,S
2018-04-12 21:01:13,13505.0,12,152,-4,13505.0,4,13510.0,5,S
2018-04-12 21:01:14,13505.0,8,160,-8,13500.0,18,13510.0,5,S
2018-04-12 21:01:15,13500.0,16,176,0,13500.0,10,13505.0,8,S
2018-04-12 21:01:15,13500.0,22,198,2,13485.0,1,13500.0,1,S
2018-04-12 21:01:18,13500.0,2,200,-2,13495.0,4,13500.0,1,S
2018-04-12 21:01:19,13500.0,2,202,0,13495.0,3,13505.0,1,S
2018-04-12 21:01:21,13505.0,2,204,0,13500.0,1,13515.0,12,B
2018-04-12 21:01:22,13500.0,2,206,0,13495.0,3,13500.0,1,S
2018-04-12 21:01:23,13500.0,2,208,-2,13500.0,7,13520.0,14,S
2018-04-12 21:01:26,13510.0,8,216,0,13500.0,4,13515.0,12,B
2018-04-12 21:01:29,13515.0,4,220,-2,13500.0,3,13515.0,10,B
2018-04-12 21:01:30,13515.0,2,222,0,13505.0,6,13515.0,3,B
2018-04-12 21:01:32,13515.0,6,228,6,13515.0,7,13520.0,2,B
2018-04-12 21:01:33,13520.0,4,232,0,13515.0,7,13535.0,2,B
2018-04-12 21:01:40,13520.0,8,240,-6,13520.0,1,13530.0,3,B
2018-04-12 21:02:03,13520.0,6,246,6,13510.0,17,13525.0,13,B
2018-04-12 21:02:15,13525.0,6,252,0,13525.0,2,13530.0,2,B
2018-04-12 21:02:18,13530.0,4,256,-4,13525.0,4,13535.0,2,B
2018-04-12 21:02:44,13530.0,2,258,0,13525.0,3,13530.0,9,B
2018-04-12 21:02:55,13530.0,10,268,10,13525.0,7,13535.0,10,B
2018-04-12 21:03:10,13525.0,2,270,2,13525.0,7,13535.0,9,S
2018-04-12 21:03:16,13535.0,4,274,2,13530.0,6,13535.0,1,B
2018-04-12 21:03:16,13535.0,2,276,-2,13535.0,2,13540.0,1,B
2018-04-12 21:03:25,13540.0,2,278,2,13530.0,6,13545.0,15,B
2018-04-12 21:03:29,13535.0,2,280,0,13535.0,1,13540.0,6,S
2018-04-12 21:03:33,13535.0,4,284,0,13530.0,6,13540.0,8,S
2018-04-12 21:03:36,13540.0,10,294,0,13530.0,6,13540.0,5,B
2018-04-12 21:03:37,13540.0,4,298,0,13535.0,3,13545.0,3,B
2018-04-12 21:03:38,13535.0,2,300,-2,13535.0,5,13545.0,3,S
2018-04-12 21:03:43,13535.0,2,302,0,13535.0,5,13545.0,3,S
2018-04-12 21:03:44,13545.0,4,306,4,13540.0,1,13545.0,1,B
2018-04-12 21:03:45,13545.0,4,310,0,13540.0,2,13550.0,24,B
2018-04-12 21:03:46,13545.0,4,314,4,13545.0,10,13550.0,25,B
2018-04-12 21:03:48,13545.0,2,316,2,13545.0,9,13550.0,25,B
2018-04-12 21:03:50,13545.0,6,322,4,13545.0,4,13550.0,25,B
2018-04-12 21:03:51,13545.0,8,330,6,13540.0,1,13545.0,8,B
2018-04-12 21:03:56,13545.0,8,338,2,13540.0,1,13545.0,3,B
2018-04-12 21:03:56,13540.0,2,340,2,13535.0,5,13545.0,3,S
2018-04-12 21:03:59,13545.0,2,342,-2,13535.0,9,13545.0,2,B
2018-04-12 21:04:13,13535.0,8,350,0,13530.0,1,13540.0,16,S
2018-04-12 21:04:25,13540.0,2,352,0,13530.0,6,13540.0,3,B
2018-04-12 21:04:31,13540.0,2,354,0,13530.0,7,13540.0,2,B
2018-04-12 21:04:36,13540.0,2,356,0,13530.0,7,13540.0,1,B
2018-04-12 21:04:37,13540.0,2,358,0,13530.0,7,13545.0,16,B
2018-04-12 21:04:43,13540.0,2,360,2,13540.0,5,13545.0,1,B
2018-04-12 21:04:49,13545.0,2,362,0,13545.0,1,13550.0,36,B
2018-04-12 21:04:50,13545.0,2,364,-2,13540.0,4,13545.0,2,B
2018-04-12 21:04:53,13540.0,2,366,2,13540.0,3,13545.0,4,S
2018-04-12 21:04:58,13545.0,4,370,4,13545.0,18,13550.0,40,B
2018-04-12 21:04:58,13545.0,40,410,18,13540.0,2,13550.0,42,B
2018-04-12 21:05:06,13545.0,2,412,2,13540.0,2,13545.0,8,B
2018-04-12 21:05:08,13545.0,6,418,-4,13540.0,2,13550.0,34,B
2018-04-12 21:05:14,13540.0,4,422,4,13535.0,6,13540.0,8,S
2018-04-12 21:05:14,13540.0,16,438,16,13540.0,5,13550.0,30,S
2018-04-12 21:05:21,13550.0,24,462,22,13545.0,1,13550.0,14,B
2018-04-12 21:05:35,13545.0,2,464,0,13540.0,5,13550.0,14,S
2018-04-12 21:05:44,13550.0,6,470,6,13545.0,4,13550.0,11,B
2018-04-12 21:05:45,13550.0,16,486,16,13545.0,7,13550.0,3,B
2018-04-12 21:05:45,13550.0,6,492,4,13550.0,2,13555.0,1,B
2018-04-12 21:05:49,13550.0,10,502,10,13545.0,8,13550.0,5,B
2018-04-12 21:05:49,13550.0,2,504,2,13545.0,8,13550.0,4,B
2018-04-12 21:05:52,13550.0,8,512,8,13545.0,4,13560.0,14,B
2018-04-12 21:06:00,13545.0,2,514,2,13545.0,4,13555.0,6,S
2018-04-12 21:06:19,13550.0,2,516,0,13550.0,4,13555.0,1,B
2018-04-12 21:06:24,13555.0,2,518,0,13555.0,4,13560.0,18,B
2018-04-12 21:06:26,13560.0,2,520,2,13555.0,4,13560.0,11,B
2018-04-12 21:06:27,13560.0,12,532,12,13555.0,4,13560.0,5,B
2018-04-12 21:06:27,13560.0,10,542,4,13555.0,4,13565.0,3,B
2018-04-12 21:06:28,13555.0,2,544,0,13555.0,3,13565.0,1,S
2018-04-12 21:06:35,13560.0,6,550,0,13560.0,3,13565.0,5,B
2018-04-12 21:06:41,13555.0,2,552,0,13555.0,1,13565.0,5,S
2018-04-12 21:06:44,13560.0,4,556,4,13560.0,1,13565.0,5,B
2018-04-12 21:06:45,13560.0,2,558,0,13555.0,1,13565.0,4,B
2018-04-12 21:06:51,13560.0,2,560,0,13560.0,1,13565.0,13,B
2018-04-12 21:06:53,13560.0,4,564,0,13555.0,3,13560.0,8,B
2018-04-12 21:06:54,13560.0,4,568,4,13555.0,3,13560.0,6,B
2018-04-12 21:06:55,13560.0,4,572,4,13555.0,3,13560.0,4,B
2018-04-12 21:06:57,13560.0,4,576,4,13555.0,3,13560.0,2,B
2018-04-12 21:06:57,13560.0,4,580,4,13555.0,3,13565.0,13,B
2018-04-12 21:07:05,13560.0,2,582,0,13550.0,2,13560.0,3,B
2018-04-12 21:07:07,13555.0,4,586,2,13550.0,3,13555.0,2,S
2018-04-12 21:07:09,13555.0,4,590,-4,13555.0,4,13560.0,3,S
2018-04-12 21:07:10,13560.0,2,592,2,13555.0,5,13560.0,2,B
2018-04-12 21:07:15,13560.0,10,602,-2,13555.0,5,13560.0,8,B
2018-04-12 21:07:17,13555.0,2,604,0,13555.0,2,13560.0,10,S
2018-04-12 21:07:18,13555.0,4,608,0,13550.0,3,13555.0,3,S
2018-04-12 21:07:40,13555.0,2,610,0,13550.0,7,13560.0,11,S
2018-04-12 21:07:42,13555.0,6,616,-6,13555.0,14,13560.0,11,S
2018-04-12 21:07:51,13555.0,6,622,-6,13555.0,11,13560.0,7,S
2018-04-12 21:08:20,13560.0,14,636,0,13560.0,4,13565.0,13,B
2018-04-12 21:08:23,13560.0,8,644,0,13555.0,1,13560.0,6,B
2018-04-12 21:08:30,13560.0,18,662,18,13555.0,3,13565.0,17,B
2018-04-12 21:08:52,13565.0,2,664,0,13555.0,3,13565.0,17,B
2018-04-12 21:08:59,13560.0,2,666,2,13560.0,3,13565.0,5,S
2018-04-12 21:09:12,13560.0,2,668,2,13560.0,3,13565.0,5,S
2018-04-12 21:09:12,13560.0,6,674,0,13555.0,3,13565.0,5,S
2018-04-12 21:09:24,13560.0,2,676,0,13555.0,10,13560.0,1,S
2018-04-12 21:09:29,13560.0,2,678,-2,13555.0,10,13565.0,5,S
2018-04-12 21:09:38,13560.0,4,682,4,13555.0,6,13560.0,11,S
2018-04-12 21:09:44,13560.0,8,690,0,13555.0,6,13560.0,7,S
2018-04-12 21:10:01,13555.0,2,692,-2,13550.0,5,13560.0,9,S
2018-04-12 21:10:13,13555.0,2,694,0,13550.0,7,13560.0,9,S
2018-04-12 21:10:16,13550.0,2,696,0,13545.0,2,13555.0,7,S
2018-04-12 21:10:20,13550.0,2,698,0,13545.0,5,13555.0,6,S
2018-04-12 21:11:07,13555.0,4,702,-4,13545.0,4,13555.0,1,B
2018-04-12 21:11:35,13555.0,2,704,2,13545.0,5,13555.0,2,B
2018-04-12 21:11:38,13555.0,2,706,0,13545.0,5,13555.0,5,B
2018-04-12 21:12:11,13545.0,4,710,4,13540.0,10,13545.0,2,S
2018-04-12 21:12:15,13540.0,14,724,4,13535.0,3,13540.0,5,S
2018-04-12 21:12:23,13540.0,16,740,-2,13540.0,6,13550.0,30,S
2018-04-12 21:12:46,13545.0,6,746,0,13540.0,3,13550.0,8,B
2018-04-12 21:13:03,13545.0,2,748,0,13540.0,6,13545.0,4,B
2018-04-12 21:13:04,13545.0,2,750,-2,13540.0,6,13545.0,3,B
2018-04-12 21:13:28,13545.0,10,760,-4,13545.0,2,13550.0,9,B
2018-04-12 21:13:31,13540.0,34,794,26,13540.0,2,13550.0,9,S
2018-04-12 21:13:46,13545.0,4,798,2,13545.0,1,13550.0,12,B
2018-04-12 21:14:04,13545.0,2,800,-2,13545.0,1,13550.0,11,B
2018-04-12 21:14:05,13550.0,4,804,0,13545.0,2,13550.0,9,B
2018-04-12 21:14:06,13550.0,2,806,0,13545.0,4,13550.0,8,B
2018-04-12 21:14:06,13550.0,2,808,0,13545.0,4,13550.0,7,B
2018-04-12 21:14:07,13550.0,4,812,0,13545.0,4,13550.0,5,B
2018-04-12 21:14:08,13550.0,8,820,6,13545.0,4,13550.0,1,B
2018-04-12 21:14:08,13550.0,2,822,0,13550.0,2,13555.0,2,B
2018-04-12 21:14:32,13555.0,2,824,0,13555.0,2,13560.0,6,B
2018-04-12 21:15:04,13560.0,4,828,4,13555.0,1,13560.0,5,B
2018-04-12 21:15:07,13550.0,4,832,4,13545.0,16,13560.0,6,S
2018-04-12 21:15:12,13560.0,4,836,4,13550.0,2,13555.0,1,B
2018-04-12 21:15:14,13550.0,2,838,2,13550.0,2,13555.0,1,S
2018-04-12 21:15:19,13555.0,2,840,2,13550.0,1,13555.0,3,B
2018-04-12 21:15:37,13555.0,4,844,-4,13545.0,10,13555.0,2,B
2018-04-12 21:15:45,13555.0,2,846,-2,13545.0,10,13555.0,2,B
2018-04-12 21:15:52,13555.0,2,848,0,13545.0,10,13560.0,6,B
2018-04-12 21:16:12,13560.0,2,850,0,13555.0,4,13560.0,5,B
2018-04-12 21:16:24,13560.0,10,860,6,13560.0,4,13565.0,22,B
2018-04-12 21:16:25,13560.0,4,864,0,13560.0,2,13565.0,23,B
2018-04-12 21:16:25,13560.0,4,868,0,13555.0,4,13565.0,26,B
2018-04-12 21:16:26,13560.0,2,870,2,13555.0,4,13565.0,26,B
2018-04-12 21:16:56,13560.0,2,872,0,13555.0,1,13560.0,11,B
2018-04-12 21:17:12,13555.0,2,874,2,13555.0,1,13560.0,11,S
2018-04-12 21:17:51,13545.0,4,878,4,13540.0,5,13555.0,9,S
2018-04-12 21:17:53,13550.0,2,880,-2,13540.0,6,13555.0,8,B
2018-04-12 21:18:15,13550.0,2,882,0,13545.0,2,13550.0,4,B
2018-04-12 21:18:24,13550.0,2,884,2,13545.0,3,13550.0,3,B
2018-04-12 21:18:35,13550.0,6,890,0,13545.0,3,13555.0,31,B
2018-04-12 21:18:35,13555.0,14,904,8,13550.0,2,13560.0,46,B
2018-04-12 21:18:38,13555.0,2,906,0,13550.0,9,13560.0,11,B
2018-04-12 21:19:06,13555.0,4,910,2,13550.0,3,13560.0,23,B
2018-04-12 21:19:24,13555.0,2,912,2,13550.0,3,13560.0,35,B
2018-04-12 21:20:48,13550.0,4,916,-2,13545.0,7,13555.0,1,S
2018-04-12 21:20:50,13555.0,2,918,0,13545.0,7,13560.0,34,B
2018-04-12 21:20:55,13555.0,2,920,2,13545.0,9,13555.0,2,B
2018-04-12 21:20:58,13550.0,2,922,-2,13545.0,9,13555.0,2,S
2018-04-12 21:22:06,13550.0,2,924,-2,13545.0,8,13550.0,1,S
2018-04-12 21:22:14,13545.0,10,934,4,13545.0,2,13550.0,1,S
2018-04-12 21:22:16,13545.0,4,938,2,13540.0,6,13545.0,5,S
2018-04-12 21:22:18,13540.0,12,950,-4,13535.0,3,13540.0,14,S
2018-04-12 21:22:18,13540.0,4,954,-4,13535.0,6,13540.0,12,S
2018-04-12 21:22:27,13530.0,2,956,0,13530.0,9,13540.0,13,S
2018-04-12 21:22:30,13530.0,2,958,0,13530.0,8,13540.0,13,S
2018-04-12 21:22:33,13535.0,2,960,-2,13530.0,8,13540.0,13,B
2018-04-12 21:22:38,13535.0,2,962,0,13535.0,2,13540.0,13,B
2018-04-12 21:22:40,13540.0,2,964,0,13535.0,4,13540.0,12,B
2018-04-12 21:22:49,13535.0,2,966,0,13535.0,3,13540.0,12,S
2018-04-12 21:22:52,13540.0,20,986,-8,13535.0,7,13540.0,2,B
2018-04-12 21:22:52,13545.0,10,996,-4,13540.0,8,13550.0,30,B
2018-04-12 21:22:53,13545.0,4,1000,0,13540.0,3,13550.0,3,B
2018-04-12 21:23:02,13545.0,2,1002,0,13540.0,3,13550.0,6,B
2018-04-12 21:23:06,13540.0,2,1004,0,13540.0,5,13550.0,6,S
2018-04-12 21:23:38,13550.0,2,1006,2,13545.0,7,13550.0,2,B
2018-04-12 21:23:38,13550.0,2,1008,-2,13545.0,7,13550.0,1,B
2018-04-12 21:23:50,13545.0,2,1010,0,13545.0,5,13550.0,3,S
2018-04-12 21:23:56,13550.0,6,1016,0,13550.0,17,13555.0,14,B
2018-04-12 21:23:58,13550.0,2,1018,2,13550.0,16,13555.0,3,B
2018-04-12 21:24:01,13550.0,2,1020,2,13550.0,15,13555.0,3,B
2018-04-12 21:24:02,13550.0,30,1050,18,13545.0,4,13550.0,10,B
2018-04-12 21:24:02,13545.0,8,1058,8,13540.0,10,13550.0,9,S
2018-04-12 21:24:12,13545.0,2,1060,0,13545.0,1,13550.0,5,S
2018-04-12 21:25:16,13540.0,2,1062,0,13540.0,4,13545.0,22,S
2018-04-12 21:25:16,13540.0,8,1070,0,13535.0,5,13540.0,1,S
2018-04-12 21:25:27,13535.0,4,1074,-2,13530.0,5,13535.0,2,S
2018-04-12 21:25:28,13535.0,2,1076,-2,13530.0,7,13535.0,1,S
2018-04-12 21:25:52,13535.0,2,1078,0,13530.0,10,13540.0,2,S
2018-04-12 21:25:55,13530.0,2,1080,0,13530.0,10,13540.0,2,S
2018-04-12 21:26:03,13535.0,2,1082,0,13530.0,10,13540.0,3,B
2018-04-12 21:26:04,13530.0,18,1100,-10,13525.0,9,13535.0,24,S
2018-04-12 21:26:05,13530.0,2,1102,0,13525.0,8,13530.0,6,S
2018-04-12 21:26:06,13525.0,6,1108,0,13525.0,3,13530.0,13,S
2018-04-12 21:26:06,13520.0,12,1120,2,13515.0,4,13520.0,3,S
2018-04-12 21:26:07,13520.0,8,1128,2,13515.0,3,13525.0,4,S
2018-04-12 21:26:07,13525.0,4,1132,-4,13520.0,3,13530.0,9,B
2018-04-12 21:26:09,13520.0,2,1134,-2,13520.0,3,13530.0,9,S
2018-04-12 21:26:21,13515.0,16,1150,-16,13510.0,40,13515.0,12,S
2018-04-12 21:26:21,13515.0,24,1174,-24,13515.0,6,13525.0,4,S
2018-04-12 21:26:22,13520.0,8,1182,-2,13520.0,1,13525.0,3,B
2018-04-12 21:26:23,13525.0,2,1184,0,13515.0,7,13525.0,2,B
2018-04-12 21:26:24,13525.0,2,1186,-2,13520.0,2,13530.0,6,B
2018-04-12 21:26:26,13525.0,2,1188,0,13525.0,1,13530.0,1,B
2018-04-12 21:26:36,13525.0,4,1192,-4,13520.0,6,13525.0,1,B
2018-04-12 21:26:46,13530.0,2,1194,0,13525.0,2,13535.0,3,B
2018-04-12 21:27:16,13540.0,4,1198,2,13535.0,2,13545.0,5,B
2018-04-12 21:27:30,13540.0,2,1200,-2,13535.0,5,13545.0,7,B
2018-04-12 21:27:33,13545.0,12,1212,4,13535.0,5,13545.0,2,B
2018-04-12 21:27:38,13545.0,2,1214,0,13535.0,5,13545.0,8,B
2018-04-12 21:28:50,13545.0,2,1216,2,13535.0,10,13545.0,5,B
2018-04-12 21:28:50,13545.0,2,1218,0,13535.0,10,13545.0,4,B
2018-04-12 21:28:51,13545.0,4,1222,2,13535.0,10,13545.0,2,B
2018-04-12 21:28:51,13545.0,4,1226,2,13535.0,10,13545.0,2,B
2018-04-12 21:28:53,13545.0,4,1230,0,13535.0,10,13545.0,1,B
2018-04-12 21:28:53,13545.0,4,1234,4,13535.0,10,13550.0,6,B
2018-04-12 21:28:55,13545.0,4,1238,4,13535.0,10,13550.0,10,B
2018-04-12 21:28:58,13545.0,2,1240,2,13545.0,1,13550.0,10,B
2018-04-12 21:28:58,13545.0,2,1242,2,13540.0,2,13550.0,10,B
2018-04-12 21:29:17,13545.0,2,1244,2,13545.0,1,13550.0,14,B
2018-04-12 21:29:43,13540.0,6,1250,-6,13535.0,13,13550.0,19,S
2018-04-12 21:30:01,13535.0,10,1260,-4,13535.0,1,13540.0,22,S
2018-04-12 21:30:01,13535.0,2,1262,0,13530.0,8,13540.0,22,S
2018-04-12 21:30:03,13535.0,2,1264,0,13535.0,1,13540.0,23,S
2018-04-12 21:30:03,13535.0,2,1266,0,13530.0,2,13535.0,1,S
2018-04-12 21:30:04,13535.0,4,1270,0,13530.0,2,13535.0,1,S
2018-04-12 21:30:05,13530.0,8,1278,6,13530.0,1,13535.0,6,S
2018-04-12 21:30:07,13535.0,2,1280,2,13525.0,13,13535.0,4,B
2018-04-12 21:30:10,13540.0,2,1282,-2,13540.0,2,13545.0,7,B
2018-04-12 21:30:17,13540.0,4,1286,4,13530.0,13,13540.0,3,B
2018-04-12 21:30:18,13540.0,2,1288,2,13535.0,2,13540.0,2,B
2018-04-12 21:30:19,13540.0,2,1290,2,13540.0,1,13545.0,18,B
2018-04-12 21:30:19,13540.0,2,1292,0,13535.0,6,13545.0,18,B
2018-04-12 21:30:31,13540.0,6,1298,6,13535.0,3,13540.0,3,B
2018-04-12 21:30:32,13540.0,6,1304,0,13535.0,7,13545.0,22,B
2018-04-12 21:30:34,13545.0,4,1308,0,13540.0,2,13545.0,1,B
2018-04-12 21:30:35,13545.0,2,1310,0,13540.0,3,13550.0,9,B
2018-04-12 21:30:43,13545.0,2,1312,0,13540.0,4,13550.0,17,B
2018-04-12 21:31:17,13545.0,2,1314,0,13545.0,2,13550.0,19,B
2018-04-12 21:31:21,13540.0,2,1316,-2,13540.0,4,13545.0,1,S
2018-04-12 21:31:22,13545.0,2,1318,2,13545.0,1,13550.0,26,B
2018-04-12 21:31:41,13545.0,2,1320,0,13540.0,23,13545.0,3,B
2018-04-12 21:32:01,13545.0,16,1336,16,13545.0,32,13550.0,28,B
2018-04-12 21:32:02,13545.0,18,1354,18,13545.0,24,13550.0,31,B
2018-04-12 21:32:12,13550.0,18,1372,12,13545.0,24,13550.0,6,B
2018-04-12 21:32:13,13550.0,12,1384,12,13545.0,24,13550.0,1,B
2018-04-12 21:32:13,13550.0,8,1392,4,13545.0,24,13555.0,5,B
2018-04-12 21:32:31,13555.0,26,1418,20,13555.0,10,13560.0,31,B
2018-04-12 21:32:32,13555.0,20,1438,20,13550.0,2,13555.0,10,B
2018-04-12 21:32:52,13550.0,4,1442,4,13545.0,35,13550.0,8,S
2018-04-12 21:33:09,13545.0,4,1446,2,13545.0,35,13550.0,8,S
2018-04-12 21:33:10,13545.0,6,1452,0,13545.0,30,13550.0,12,S
2018-04-12 21:33:11,13545.0,8,1460,0,13545.0,26,13550.0,12,S
2018-04-12 21:33:11,13545.0,8,1468,-4,13545.0,22,13550.0,12,S
2018-04-12 21:33:25,13545.0,2,1470,0,13545.0,21,13550.0,12,S
2018-04-12 21:33:32,13545.0,2,1472,-2,13545.0,20,13550.0,12,S
2018-04-12 21:33:33,13550.0,24,1496,10,13545.0,20,13555.0,5,B
2018-04-12 21:33:46,13550.0,2,1498,2,13545.0,20,13550.0,7,B
2018-04-12 21:33:47,13550.0,8,1506,4,13545.0,20,13550.0,2,B
2018-04-12 21:33:48,13550.0,4,1510,0,13550.0,4,13555.0,7,B
2018-04-12 21:33:57,13550.0,2,1512,2,13545.0,25,13555.0,6,B
2018-04-12 21:34:11,13550.0,2,1514,2,13545.0,25,13555.0,6,B
2018-04-12 21:34:41,13555.0,4,1518,0,13545.0,25,13555.0,8,B
2018-04-12 21:34:41,13550.0,2,1520,-2,13545.0,25,13555.0,11,S
2018-04-12 21:34:51,13555.0,12,1532,8,13550.0,6,13560.0,29,B
2018-04-12 21:34:58,13550.0,2,1534,-2,13550.0,5,13560.0,27,S
2018-04-12 21:35:18,13550.0,2,1536,2,13550.0,4,13560.0,28,S
2018-04-12 21:35:23,13550.0,6,1542,2,13545.0,23,13550.0,2,S
2018-04-12 21:35:51,13550.0,2,1544,0,13550.0,2,13555.0,10,S
2018-04-12 21:35:52,13550.0,4,1548,-4,13545.0,25,13555.0,8,S
2018-04-12 21:35:58,13545.0,4,1552,0,13545.0,23,13555.0,10,S
2018-04-12 21:35:59,13555.0,4,1556,0,13545.0,23,13555.0,8,B
2018-04-12 21:36:13,13555.0,2,1558,0,13545.0,25,13555.0,7,B
2018-04-12 21:36:24,13555.0,10,1568,8,13545.0,26,13555.0,3,B
2018-04-12 21:36:32,13555.0,2,1570,2,13555.0,2,13560.0,31,B
2018-04-12 21:36:54,13555.0,2,1572,2,13550.0,4,13555.0,4,B
2018-04-12 21:36:58,13555.0,6,1578,-4,13550.0,4,13555.0,1,B
2018-04-12 21:37:06,13555.0,2,1580,-2,13550.0,4,13560.0,37,B
2018-04-12 21:37:45,13550.0,4,1584,-2,13545.0,23,13550.0,8,S
2018-04-12 21:38:25,13550.0,2,1586,-2,13550.0,2,13555.0,4,S
2018-04-12 21:38:25,13550.0,4,1590,0,13545.0,23,13550.0,4,S
2018-04-12 21:38:49,13545.0,30,1620,-18,13545.0,8,13550.0,1,S
2018-04-12 21:38:50,13545.0,10,1630,-6,13545.0,3,13550.0,2,S
2018-04-12 21:39:16,13545.0,2,1632,0,13545.0,6,13555.0,11,S
2018-04-12 21:39:18,13550.0,2,1634,2,13545.0,6,13550.0,3,B
2018-04-12 21:39:23,13550.0,2,1636,0,13550.0,1,13555.0,10,B
2018-04-12 21:40:03,13550.0,6,1642,4,13545.0,6,13555.0,12,B
2018-04-12 21:40:06,13545.0,4,1646,0,13540.0,30,13550.0,4,S
2018-04-12 21:40:10,13540.0,2,1648,0,13540.0,21,13550.0,14,S
2018-04-12 21:40:16,13540.0,10,1658,-10,13540.0,20,13550.0,8,S
2018-04-12 21:41:02,13540.0,2,1660,-2,13540.0,16,13545.0,4,S
2018-04-12 21:41:11,13545.0,6,1666,0,13545.0,3,13550.0,7,B
2018-04-12 21:41:41,13540.0,4,1670,0,13540.0,15,13545.0,3,S
2018-04-12 21:42:20,13550.0,6,1676,4,13545.0,16,13550.0,6,B
2018-04-12 21:42:21,13550.0,12,1688,12,13545.0,19,13550.0,1,B
2018-04-12 21:42:21,13550.0,4,1692,4,13545.0,19,13555.0,8,B
2018-04-12 21:42:31,13550.0,4,1696,2,13545.0,11,13555.0,8,B
2018-04-12 21:42:57,13555.0,4,1700,2,13550.0,1,13555.0,10,B
2018-04-12 21:43:11,13555.0,2,1702,2,13545.0,11,13555.0,9,B
2018-04-12 21:43:17,13545.0,6,1708,-4,13540.0,20,13545.0,2,S
2018-04-12 21:43:20,13540.0,4,1712,0,13540.0,15,13545.0,3,S
2018-04-12 21:44:08,13545.0,2,1714,-2,13540.0,32,13550.0,10,B
2018-04-12 21:44:11,13550.0,4,1718,0,13540.0,32,13550.0,11,B
2018-04-12 21:45:01,13545.0,4,1722,-2,13545.0,5,13550.0,1,S
2018-04-12 21:45:02,13550.0,4,1726,-2,13545.0,3,13555.0,17,B
2018-04-12 21:45:08,13550.0,6,1732,0,13550.0,2,13555.0,17,B
2018-04-12 21:45:08,13550.0,2,1734,0,13550.0,1,13555.0,13,B
2018-04-12 21:45:17,13550.0,2,1736,2,13545.0,6,13555.0,12,B
2018-04-12 21:45:26,13550.0,2,1738,0,13545.0,12,13555.0,10,B
2018-04-12 21:45:29,13550.0,2,1740,0,13545.0,12,13550.0,8,B
2018-04-12 21:46:05,13545.0,2,1742,2,13545.0,11,13550.0,8,S
2018-04-12 21:46:09,13545.0,2,1744,2,13545.0,10,13550.0,8,S
2018-04-12 21:46:21,13550.0,2,1746,2,13545.0,7,13550.0,7,B
2018-04-12 21:46:26,13545.0,8,1754,-6,13540.0,21,13550.0,12,S
2018-04-12 21:46:31,13545.0,2,1756,0,13540.0,23,13550.0,12,S
2018-04-12 21:46:47,13545.0,2,1758,2,13545.0,2,13550.0,13,S
2018-04-12 21:46:55,13545.0,2,1760,2,13545.0,1,13550.0,13,S
2018-04-12 21:47:07,13545.0,2,1762,2,13540.0,23,13550.0,10,S
2018-04-12 21:47:19,13550.0,14,1776,14,13545.0,4,13550.0,1,B
2018-04-12 21:47:20,13550.0,2,1778,2,13550.0,8,13555.0,7,B
2018-04-12 21:48:50,13555.0,2,1780,-2,13555.0,9,13560.0,33,B
2018-04-12 21:48:57,13560.0,2,1782,2,13555.0,4,13560.0,21,B
2018-04-12 21:48:58,13560.0,2,1784,2,13555.0,3,13560.0,20,B
2018-04-12 21:48:58,13560.0,2,1786,2,13555.0,3,13560.0,19,B
2018-04-12 21:48:59,13560.0,2,1788,2,13555.0,3,13560.0,18,B
2018-04-12 21:48:59,13560.0,2,1790,2,13555.0,3,13560.0,17,B
2018-04-12 21:49:00,13560.0,2,1792,2,13555.0,3,13560.0,16,B
2018-04-12 21:49:00,13560.0,2,1794,2,13555.0,3,13560.0,15,B
2018-04-12 21:49:01,13560.0,2,1796,2,13555.0,3,13560.0,14,B
2018-04-12 21:49:01,13560.0,2,1798,2,13555.0,4,13560.0,13,B
2018-04-12 21:49:02,13560.0,2,1800,2,13555.0,4,13560.0,12,B
2018-04-12 21:49:02,13560.0,2,1802,2,13555.0,4,13560.0,11,B
2018-04-12 21:49:03,13560.0,2,1804,2,13555.0,4,13560.0,10,B
2018-04-12 21:49:03,13560.0,2,1806,2,13555.0,4,13560.0,9,B
2018-04-12 21:49:04,13560.0,2,1808,2,13555.0,3,13560.0,8,B
2018-04-12 21:49:04,13560.0,2,1810,2,13555.0,3,13560.0,7,B
2018-04-12 21:49:05,13560.0,2,1812,0,13555.0,4,13560.0,6,B
2018-04-12 21:49:05,13560.0,2,1814,0,13555.0,4,13560.0,5,B
2018-04-12 21:49:06,13560.0,2,1816,0,13555.0,4,13560.0,4,B
2018-04-12 21:49:06,13560.0,8,1824,8,13560.0,1,13565.0,12,B
2018-04-12 21:49:07,13560.0,2,1826,0,13555.0,8,13565.0,19,B
2018-04-12 21:49:08,13565.0,2,1828,2,13555.0,20,13565.0,14,B
2018-04-12 21:49:08,13565.0,2,1830,2,13555.0,20,13565.0,10,B
2018-04-12 21:49:09,13565.0,2,1832,2,13555.0,20,13565.0,8,B
2018-04-12 21:49:09,13565.0,4,1836,0,13555.0,20,13565.0,3,B
2018-04-12 21:49:10,13565.0,4,1840,2,13555.0,20,13565.0,2,B
2018-04-12 21:49:12,13565.0,4,1844,2,13555.0,20,13565.0,3,B
2018-04-12 21:49:12,13565.0,4,1848,4,13555.0,20,13565.0,4,B
2018-04-12 21:49:13,13565.0,4,1852,2,13555.0,20,13565.0,2,B
2018-04-12 21:49:14,13565.0,4,1856,0,13555.0,20,13565.0,1,B
2018-04-12 21:49:15,13565.0,4,1860,4,13560.0,1,13570.0,29,B
2018-04-12 21:49:18,13570.0,4,1864,4,13560.0,17,13570.0,15,B
2018-04-12 21:49:18,13570.0,4,1868,4,13565.0,1,13570.0,14,B
2018-04-12 21:49:19,13570.0,6,1874,4,13565.0,4,13570.0,11,B
2018-04-12 21:49:21,13570.0,4,1878,4,13565.0,7,13570.0,9,B
2018-04-12 21:49:22,13570.0,4,1882,4,13565.0,7,13570.0,7,B
2018-04-12 21:49:23,13570.0,4,1886,4,13565.0,8,13570.0,5,B
2018-04-12 21:49:23,13570.0,4,1890,4,13565.0,8,13570.0,3,B
2018-04-12 21:49:24,13570.0,6,1896,4,13565.0,8,13575.0,13,B
2018-04-12 21:49:25,13565.0,2,1898,-2,13565.0,7,13570.0,1,S
2018-04-12 21:49:26,13570.0,2,1900,2,13570.0,1,13575.0,22,B
2018-04-12 21:49:34,13570.0,4,1904,2,13565.0,9,13570.0,2,B
2018-04-12 21:49:35,13570.0,4,1908,0,13565.0,9,13575.0,16,B
2018-04-12 21:49:37,13570.0,4,1912,4,13565.0,5,13570.0,21,B
2018-04-12 21:49:38,13570.0,4,1916,4,13565.0,5,13570.0,19,B
2018-04-12 21:49:39,13570.0,4,1920,4,13565.0,5,13570.0,17,B
2018-04-12 21:49:39,13570.0,4,1924,4,13565.0,5,13570.0,15,B
2018-04-12 21:49:40,13570.0,4,1928,4,13565.0,5,13570.0,13,B
2018-04-12 21:49:40,13560.0,24,1952,12,13560.0,10,13570.0,5,S
2018-04-12 21:49:41,13570.0,4,1956,4,13565.0,1,13570.0,3,B
2018-04-12 21:49:41,13570.0,4,1960,0,13565.0,1,13570.0,2,B
2018-04-12 21:49:42,13570.0,2,1962,0,13565.0,1,13570.0,1,B
2018-04-12 21:49:42,13570.0,2,1964,2,13565.0,2,13575.0,14,B
2018-04-12 21:49:43,13575.0,16,1980,0,13565.0,2,13575.0,16,B
2018-04-12 21:49:43,13575.0,2,1982,0,13570.0,2,13575.0,14,B
2018-04-12 21:49:45,13570.0,4,1986,0,13565.0,5,13575.0,8,S
2018-04-12 21:49:48,13575.0,2,1988,0,13575.0,1,13580.0,18,B
2018-04-12 21:49:48,13575.0,2,1990,0,13570.0,4,13575.0,1,B
2018-04-12 21:49:49,13575.0,2,1992,0,13570.0,4,13580.0,29,B
2018-04-12 21:49:50,13575.0,2,1994,2,13570.0,4,13575.0,2,B
2018-04-12 21:49:50,13575.0,4,1998,0,13570.0,4,13580.0,27,B
2018-04-12 21:49:51,13570.0,4,2002,2,13575.0,1,13580.0,33,S
2018-04-12 21:49:51,13570.0,6,2008,2,13570.0,3,13575.0,22,S
2018-04-12 21:49:53,13570.0,2,2010,2,13570.0,1,13575.0,34,S
2018-04-12 21:49:53,13570.0,2,2012,2,13565.0,6,13575.0,36,S
2018-04-12 21:50:25,13570.0,2,2014,2,13570.0,4,13575.0,39,S
2018-04-12 21:50:27,13570.0,8,2022,8,13565.0,6,13575.0,39,S
2018-04-12 21:50:27,13565.0,4,2026,2,13565.0,3,13575.0,46,S
2018-04-12 21:50:28,13565.0,2,2028,0,13560.0,10,13570.0,3,S
2018-04-12 21:50:42,13570.0,4,2032,2,13565.0,2,13570.0,1,B
2018-04-12 21:50:42,13570.0,2,2034,0,13570.0,1,13575.0,19,B
2018-04-12 21:50:53,13570.0,2,2036,0,13570.0,2,13575.0,22,B
2018-04-12 21:50:54,13570.0,2,2038,0,13570.0,1,13575.0,22,B
2018-04-12 21:51:41,13570.0,4,2042,2,13565.0,5,13575.0,21,B
2018-04-12 21:51:42,13570.0,2,2044,2,13570.0,1,13575.0,23,B
2018-04-12 21:51:43,13570.0,2,2046,0,13565.0,5,13575.0,21,B
2018-04-12 21:51:49,13565.0,4,2050,0,13565.0,2,13575.0,25,S
2018-04-12 21:51:49,13565.0,4,2054,0,13565.0,1,13570.0,23,S
2018-04-12 21:51:50,13565.0,2,2056,2,13560.0,12,13570.0,35,S
2018-04-12 21:51:56,13565.0,4,2060,0,13560.0,3,13570.0,37,S
2018-04-12 21:52:04,13570.0,4,2064,0,13560.0,7,13570.0,39,B
2018-04-12 21:52:05,13560.0,14,2078,8,13555.0,12,13560.0,13,S
2018-04-12 21:52:05,13560.0,26,2104,20,13555.0,12,13565.0,1,S
2018-04-12 21:52:07,13565.0,4,2108,0,13560.0,7,13570.0,33,B
2018-04-12 21:52:10,13565.0,4,2112,0,13560.0,7,13565.0,2,B
2018-04-12 21:52:26,13560.0,18,2130,4,13555.0,7,13560.0,11,S
2018-04-12 21:52:27,13560.0,22,2152,22,13560.0,1,13565.0,10,S
2018-04-12 21:52:32,13560.0,2,2154,2,13560.0,3,13565.0,10,S
2018-04-12 21:53:04,13560.0,10,2164,4,13555.0,13,13560.0,5,S
2018-04-12 21:53:24,13560.0,2,2166,0,13555.0,6,13560.0,4,S
2018-04-12 21:53:44,13560.0,6,2172,2,13555.0,13,13560.0,1,S
2018-04-12 21:53:45,13560.0,2,2174,0,13560.0,6,13565.0,10,S
2018-04-12 21:53:52,13565.0,2,2176,2,13560.0,4,13565.0,9,B
2018-04-12 21:53:52,13565.0,2,2178,2,13560.0,3,13565.0,8,B
2018-04-12 21:53:53,13565.0,2,2180,2,13560.0,3,13565.0,7,B
2018-04-12 21:53:53,13565.0,2,2182,2,13560.0,3,13565.0,6,B
2018-04-12 21:53:54,13565.0,2,2184,2,13560.0,3,13565.0,5,B
2018-04-12 21:53:54,13565.0,2,2186,2,13560.0,3,13565.0,4,B
2018-04-12 21:53:55,13565.0,2,2188,2,13560.0,3,13565.0,3,B
2018-04-12 21:53:56,13565.0,2,2190,0,13560.0,3,13565.0,2,B
2018-04-12 21:53:56,13565.0,2,2192,0,13560.0,3,13565.0,1,B
2018-04-12 21:53:57,13565.0,2,2194,0,13560.0,3,13570.0,11,B
2018-04-12 21:54:09,13565.0,2,2196,0,13560.0,6,13565.0,4,B
2018-04-12 21:54:10,13565.0,2,2198,0,13560.0,6,13565.0,3,B
2018-04-12 21:54:10,13565.0,2,2200,0,13560.0,6,13565.0,2,B
2018-04-12 21:54:11,13565.0,2,2202,0,13560.0,3,13565.0,1,B
2018-04-12 21:54:11,13565.0,2,2204,0,13560.0,3,13570.0,7,B
2018-04-12 21:54:30,13560.0,2,2206,0,13555.0,9,13560.0,1,S
2018-04-12 21:54:31,13560.0,2,2208,0,13555.0,11,13565.0,5,S
2018-04-12 21:54:54,13560.0,2,2210,0,13555.0,7,13560.0,1,S
2018-04-12 21:54:55,13560.0,2,2212,0,13555.0,7,13565.0,7,S
2018-04-12 21:55:18,13555.0,4,2216,2,13555.0,5,13565.0,6,S
2018-04-12 21:55:20,13555.0,6,2222,-4,13550.0,10,13560.0,8,S
2018-04-12 21:55:47,13560.0,4,2226,2,13550.0,10,13560.0,6,B
2018-04-12 21:56:32,13565.0,2,2228,2,13560.0,7,13565.0,1,B
2018-04-12 21:56:33,13565.0,2,2230,2,13565.0,2,13570.0,6,B
2018-04-12 21:56:37,13570.0,2,2232,0,13565.0,1,13570.0,6,B
2018-04-12 21:57:12,13575.0,2,2234,-2,13570.0,7,13575.0,4,B
2018-04-12 21:57:13,13575.0,8,2242,-4,13575.0,1,13580.0,19,B
2018-04-12 21:57:13,13570.0,12,2254,0,13570.0,2,13575.0,3,S
2018-04-12 21:57:14,13575.0,2,2256,0,13570.0,3,13575.0,2,B
2018-04-12 21:57:14,13575.0,2,2258,0,13570.0,3,13575.0,1,B
2018-04-12 21:57:15,13570.0,10,2268,0,13565.0,46,13570.0,2,S
2018-04-12 21:57:15,13570.0,10,2278,-6,13570.0,1,13580.0,18,S
2018-04-12 21:57:16,13570.0,12,2290,-6,13570.0,5,13580.0,17,S
2018-04-12 21:57:16,13570.0,6,2296,0,13570.0,4,13580.0,17,S
2018-04-12 21:57:17,13580.0,2,2298,2,13570.0,44,13580.0,14,B
2018-04-12 21:57:18,13580.0,2,2300,2,13570.0,44,13580.0,13,B
2018-04-12 21:57:18,13580.0,2,2302,2,13570.0,44,13580.0,12,B
2018-04-12 21:57:19,13580.0,2,2304,2,13570.0,44,13580.0,12,B
2018-04-12 21:57:19,13580.0,2,2306,2,13570.0,44,13580.0,11,B
2018-04-12 21:57:20,13580.0,4,2310,4,13570.0,38,13580.0,9,B
2018-04-12 21:57:20,13580.0,2,2312,2,13570.0,10,13580.0,8,B
2018-04-12 21:57:21,13570.0,8,2320,2,13570.0,10,13580.0,7,S
2018-04-12 21:57:21,13570.0,14,2334,-6,13570.0,4,13580.0,6,S
2018-04-12 21:57:22,13570.0,16,2350,-4,13570.0,5,13575.0,1,S
2018-04-12 21:57:22,13570.0,14,2364,-10,13565.0,14,13580.0,5,S
2018-04-12 21:57:23,13570.0,6,2370,-2,13565.0,24,13570.0,3,S
2018-04-12 21:57:23,13570.0,12,2382,-6,13565.0,23,13575.0,4,S
2018-04-12 21:57:24,13575.0,2,2384,0,13570.0,2,13575.0,3,B
2018-04-12 21:57:24,13575.0,2,2386,0,13570.0,2,13575.0,2,B
2018-04-12 21:57:25,13575.0,2,2388,0,13570.0,7,13575.0,1,B
2018-04-12 21:57:25,13575.0,2,2390,0,13570.0,7,13580.0,5,B
2018-04-12 21:57:26,13580.0,2,2392,2,13570.0,7,13580.0,4,B
2018-04-12 21:57:26,13580.0,2,2394,0,13570.0,7,13580.0,3,B
2018-04-12 21:57:27,13580.0,2,2396,0,13570.0,10,13580.0,4,B
2018-04-12 21:57:27,13580.0,2,2398,2,13570.0,11,13580.0,3,B
2018-04-12 21:57:28,13580.0,2,2400,2,13570.0,11,13575.0,1,B
2018-04-12 21:57:28,13575.0,2,2402,0,13575.0,1,13580.0,2,S
2018-04-12 21:57:29,13580.0,2,2404,2,13570.0,11,13580.0,1,B
2018-04-12 21:57:30,13580.0,2,2406,2,13570.0,11,13580.0,3,B
2018-04-12 21:57:30,13580.0,2,2408,0,13570.0,11,13580.0,2,B
2018-04-12 21:57:31,13580.0,2,2410,0,13570.0,9,13580.0,1,B
2018-04-12 21:57:33,13575.0,2,2412,2,13570.0,1,13580.0,6,S
2018-04-12 21:57:38,13580.0,2,2414,0,13570.0,10,13580.0,2,B
2018-04-12 21:57:39,13580.0,2,2416,0,13570.0,11,13580.0,1,B
2018-04-12 21:57:39,13580.0,2,2418,0,13570.0,11,13580.0,1,B
2018-04-12 21:57:40,13580.0,2,2420,0,13570.0,11,13585.0,10,B
2018-04-12 21:57:50,13575.0,6,2426,-2,13575.0,1,13585.0,16,S
2018-04-12 21:57:51,13575.0,2,2428,-2,13570.0,10,13575.0,2,S
2018-04-12 21:57:51,13570.0,16,2444,-10,13565.0,9,13575.0,2,S
2018-04-12 21:57:52,13570.0,2,2446,2,13565.0,4,13570.0,3,S
2018-04-12 21:57:53,13570.0,2,2448,2,13565.0,1,13570.0,2,S
2018-04-12 21:57:53,13570.0,2,2450,2,13565.0,1,13570.0,1,S
2018-04-12 21:57:54,13570.0,2,2452,2,13565.0,1,13575.0,8,S
2018-04-12 21:58:10,13575.0,28,2480,16,13575.0,12,13580.0,7,B
2018-04-12 21:58:10,13575.0,24,2504,16,13570.0,1,13575.0,8,B
2018-04-12 21:59:22,13570.0,2,2506,0,13565.0,9,13575.0,8,S
2018-04-12 21:59:51,13565.0,4,2510,4,13565.0,10,13575.0,9,S
2018-04-12 22:00:21,13570.0,2,2512,2,13565.0,9,13570.0,1,B
2018-04-12 22:00:21,13570.0,2,2514,2,13565.0,9,13575.0,9,B
2018-04-12 22:00:28,13570.0,2,2516,0,13565.0,3,13570.0,3,B
2018-04-12 22:00:33,13570.0,4,2520,0,13570.0,1,13575.0,14,B
2018-04-12 22:00:44,13570.0,2,2522,0,13570.0,1,13575.0,8,B
2018-04-12 22:01:09,13570.0,2,2524,-2,13565.0,10,13570.0,1,B
2018-04-12 22:01:41,13575.0,2,2526,0,13570.0,7,13575.0,3,B
2018-04-12 22:01:41,13575.0,6,2532,-6,13575.0,1,13580.0,9,B
2018-04-12 22:01:42,13575.0,6,2538,-4,13570.0,10,13575.0,1,B
2018-04-12 22:01:43,13575.0,2,2540,0,13570.0,10,13580.0,11,B
2018-04-12 22:01:46,13580.0,2,2542,0,13570.0,10,13580.0,8,B
2018-04-12 22:01:55,13580.0,10,2552,8,13570.0,11,13580.0,3,B
2018-04-12 22:02:21,13570.0,4,2556,2,13570.0,8,13580.0,13,S
2018-04-12 22:02:27,13575.0,2,2558,-2,13565.0,13,13575.0,5,B
2018-04-12 22:02:43,13570.0,2,2560,2,13570.0,1,13575.0,6,S
2018-04-12 22:02:56,13570.0,2,2562,0,13565.0,13,13575.0,6,S
2018-04-12 22:03:23,13565.0,16,2578,-4,13565.0,1,13570.0,7,S
2018-04-12 22:03:26,13565.0,2,2580,2,13560.0,7,13570.0,12,S
2018-04-12 22:03:30,13560.0,2,2582,0,13560.0,6,13570.0,12,S
2018-04-12 22:04:10,13570.0,12,2594,6,13565.0,6,13575.0,5,B
2018-04-12 22:04:29,13570.0,2,2596,2,13565.0,23,13575.0,7,B
2018-04-12 22:05:12,13570.0,2,2598,0,13565.0,8,13575.0,12,B
2018-04-12 22:05:13,13565.0,2,2600,2,13565.0,7,13575.0,10,S
2018-04-12 22:05:17,13570.0,2,2602,-2,13565.0,7,13575.0,14,B
2018-04-12 22:05:46,13575.0,2,2604,2,13570.0,1,13575.0,10,B
2018-04-12 22:06:14,13575.0,2,2606,-2,13570.0,2,13575.0,14,B
2018-04-12 22:06:50,13570.0,2,2608,0,13570.0,1,13575.0,5,S
2018-04-12 22:06:51,13570.0,2,2610,0,13565.0,7,13570.0,3,S
2018-04-12 22:07:50,13565.0,4,2614,2,13565.0,5,13570.0,11,S
2018-04-12 22:07:51,13560.0,12,2626,-8,13560.0,7,13570.0,15,S
2018-04-12 22:08:10,13565.0,16,2642,10,13565.0,1,13570.0,12,B
2018-04-12 22:08:10,13565.0,2,2644,0,13565.0,5,13570.0,9,B
2018-04-12 22:08:26,13570.0,2,2646,0,13565.0,11,13570.0,6,B
2018-04-12 22:08:26,13570.0,12,2658,12,13570.0,1,13575.0,8,B
2018-04-12 22:08:27,13565.0,2,2660,0,13565.0,22,13575.0,4,S
2018-04-12 22:08:44,13575.0,2,2662,2,13570.0,3,13575.0,2,B
2018-04-12 22:08:45,13575.0,4,2666,-2,13575.0,3,13580.0,12,B
2018-04-12 22:08:50,13575.0,6,2672,0,13570.0,10,13580.0,10,B
2018-04-12 22:09:04,13575.0,4,2676,-4,13575.0,1,13580.0,15,B
2018-04-12 22:09:52,13570.0,2,2678,2,13565.0,12,13570.0,1,S
2018-04-12 22:09:52,13570.0,2,2680,2,13565.0,12,13575.0,36,S
2018-04-12 22:10:22,13565.0,22,2702,-14,13560.0,10,13570.0,1,S
2018-04-12 22:11:16,13560.0,10,2712,-8,13560.0,6,13570.0,11,S
2018-04-12 22:11:46,13570.0,2,2714,2,13560.0,6,13570.0,10,B
2018-04-12 22:12:07,13570.0,8,2722,-4,13560.0,8,13570.0,13,B
2018-04-12 22:13:21,13560.0,2,2724,2,13560.0,4,13565.0,14,S
2018-04-12 22:13:21,13560.0,8,2732,0,13555.0,8,13560.0,2,S
2018-04-12 22:13:22,13560.0,10,2742,-8,13560.0,4,13565.0,12,S
2018-04-12 22:13:22,13560.0,8,2750,0,13555.0,5,13560.0,3,S
2018-04-12 22:13:23,13555.0,4,2754,-2,13555.0,1,13560.0,5,S
2018-04-12 22:13:26,13555.0,2,2756,-2,13550.0,6,13560.0,5,S
2018-04-12 22:13:31,13550.0,2,2758,2,13550.0,8,13560.0,6,S
2018-04-12 22:13:40,13560.0,2,2760,-2,13550.0,8,13560.0,5,B
2018-04-12 22:14:25,13555.0,4,2764,-2,13555.0,3,13560.0,9,S
2018-04-12 22:14:28,13560.0,4,2768,-4,13555.0,9,13560.0,1,B
2018-04-12 22:14:29,13560.0,2,2770,0,13560.0,1,13565.0,5,B
2018-04-12 22:14:59,13560.0,6,2776,6,13555.0,22,13565.0,6,B
2018-04-12 22:15:15,13555.0,2,2778,2,13550.0,24,13560.0,8,S
2018-04-12 22:15:48,13560.0,2,2780,2,13555.0,7,13565.0,11,B
2018-04-12 22:16:03,13565.0,2,2782,2,13560.0,7,13565.0,2,B
2018-04-12 22:16:03,13565.0,2,2784,2,13560.0,7,13565.0,1,B
2018-04-12 22:17:10,13560.0,4,2788,-2,13555.0,8,13565.0,7,S
2018-04-12 22:17:22,13565.0,2,2790,0,13555.0,9,13565.0,6,B
2018-04-12 22:17:30,13565.0,2,2792,2,13560.0,9,13570.0,7,B
2018-04-12 22:18:51,13565.0,2,2794,-2,13565.0,2,13570.0,8,B
2018-04-12 22:19:02,13570.0,2,2796,0,13570.0,1,13575.0,7,B
2018-04-12 22:19:07,13570.0,2,2798,0,13565.0,6,13575.0,9,B
2018-04-12 22:19:13,13565.0,4,2802,-2,13565.0,1,13570.0,6,S
2018-04-12 22:19:44,13565.0,2,2804,0,13560.0,6,13570.0,13,S
2018-04-12 22:20:12,13565.0,6,2810,-6,13565.0,1,13570.0,11,S
2018-04-12 22:20:37,13565.0,6,2816,0,13560.0,4,13570.0,13,S
2018-04-12 22:21:21,13565.0,2,2818,-2,13565.0,1,13570.0,5,S
2018-04-12 22:21:38,13570.0,4,2822,0,13560.0,7,13570.0,6,B
2018-04-12 22:21:54,13565.0,2,2824,0,13565.0,1,13570.0,3,S
2018-04-12 22:22:38,13560.0,10,2834,-8,13560.0,5,13570.0,8,S
2018-04-12 22:23:10,13560.0,6,2840,4,13555.0,5,13560.0,1,S
2018-04-12 22:23:12,13560.0,2,2842,0,13555.0,3,13565.0,7,S
2018-04-12 22:23:53,13560.0,2,2844,2,13555.0,4,13565.0,6,S
2018-04-12 22:24:27,13565.0,4,2848,2,13555.0,5,13565.0,4,B
2018-04-12 22:24:41,13560.0,2,2850,0,13555.0,5,13565.0,4,S
2018-04-12 22:24:56,13555.0,2,2852,0,13555.0,3,13565.0,6,S
2018-04-12 22:25:12,13555.0,4,2856,0,13555.0,1,13565.0,8,S
2018-04-12 22:25:30,13565.0,4,2860,-4,13560.0,18,13570.0,14,B
2018-04-12 22:25:35,13565.0,2,2862,2,13565.0,2,13570.0,7,B
2018-04-12 22:25:40,13565.0,2,2864,-2,13565.0,1,13570.0,7,B
2018-04-12 22:26:14,13560.0,2,2866,0,13555.0,5,13560.0,1,S
2018-04-12 22:26:21,13565.0,6,2872,-6,13560.0,2,13570.0,12,B
2018-04-12 22:26:31,13560.0,2,2874,0,13560.0,2,13565.0,3,S
2018-04-12 22:27:09,13565.0,2,2876,0,13565.0,1,13570.0,6,B
2018-04-12 22:27:33,13565.0,2,2878,0,13560.0,4,13565.0,3,B
2018-04-12 22:29:14,13565.0,4,2882,0,13560.0,7,13565.0,2,B
2018-04-12 22:29:40,13565.0,2,2884,2,13560.0,4,13565.0,2,B
2018-04-12 22:29:41,13565.0,2,2886,2,13560.0,4,13565.0,1,B
2018-04-12 22:29:41,13565.0,2,2888,0,13560.0,4,13570.0,10,B
2018-04-12 22:29:45,13565.0,2,2890,0,13560.0,5,13570.0,12,B
2018-04-12 22:29:48,13565.0,2,2892,2,13560.0,5,13570.0,12,B
2018-04-12 22:29:58,13570.0,2,2894,2,13560.0,38,13570.0,8,B
2018-04-12 22:29:59,13570.0,2,2896,0,13560.0,38,13570.0,7,B
2018-04-12 22:29:59,13570.0,2,2898,2,13560.0,38,13570.0,6,B
2018-04-12 22:30:00,13570.0,2,2900,2,13560.0,38,13570.0,5,B
2018-04-12 22:30:00,13570.0,2,2902,2,13560.0,38,13570.0,4,B
2018-04-12 22:30:01,13570.0,2,2904,0,13565.0,1,13570.0,2,B
2018-04-12 22:30:01,13570.0,2,2906,0,13565.0,5,13570.0,2,B
2018-04-12 22:30:02,13570.0,4,2910,2,13565.0,5,13575.0,8,B
2018-04-12 22:30:10,13575.0,2,2912,0,13565.0,5,13575.0,8,B
2018-04-12 22:30:23,13565.0,6,2918,6,13565.0,1,13570.0,7,S
2018-04-12 22:32:36,13560.0,10,2928,-6,13555.0,5,13560.0,22,S
2018-04-12 22:32:37,13560.0,4,2932,0,13555.0,5,13560.0,20,S
2018-04-12 22:32:37,13560.0,4,2936,0,13555.0,4,13560.0,18,S
2018-04-12 22:32:38,13560.0,4,2940,0,13555.0,4,13560.0,16,S
2018-04-12 22:32:38,13560.0,4,2944,0,13555.0,18,13560.0,14,S
2018-04-12 22:32:39,13560.0,4,2948,0,13555.0,18,13560.0,12,S
2018-04-12 22:32:39,13560.0,4,2952,0,13555.0,18,13560.0,10,S
2018-04-12 22:32:40,13560.0,4,2956,0,13555.0,18,13560.0,8,S
2018-04-12 22:32:40,13560.0,4,2960,0,13555.0,4,13560.0,6,S
2018-04-12 22:32:41,13560.0,4,2964,0,13555.0,4,13560.0,4,S
2018-04-12 22:32:41,13560.0,4,2968,0,13555.0,4,13560.0,2,S
2018-04-12 22:32:42,13560.0,4,2972,0,13555.0,4,13565.0,10,S
2018-04-12 22:32:47,13555.0,4,2976,-2,13550.0,21,13555.0,3,S
2018-04-12 22:32:48,13555.0,4,2980,0,13550.0,19,13555.0,1,S
2018-04-12 22:32:49,13555.0,2,2982,0,13555.0,1,13560.0,7,S
2018-04-12 22:33:36,13560.0,4,2986,2,13555.0,4,13560.0,1,B
2018-04-12 22:33:36,13560.0,2,2988,2,13560.0,2,13565.0,9,B
2018-04-12 22:33:51,13565.0,2,2990,-2,13555.0,4,13565.0,9,B
2018-04-12 22:34:30,13565.0,4,2994,0,13565.0,1,13570.0,3,B
2018-04-12 22:36:16,13565.0,2,2996,0,13560.0,6,13565.0,1,B
2018-04-12 22:36:17,13565.0,2,2998,2,13565.0,1,13570.0,27,B
2018-04-12 22:36:17,13565.0,2,3000,0,13560.0,6,13570.0,27,B
2018-04-12 22:36:24,13555.0,2,3002,-2,13555.0,6,13565.0,11,S
2018-04-12 22:37:06,13555.0,8,3010,-2,13550.0,8,13555.0,11,S
2018-04-12 22:37:07,13555.0,4,3014,0,13550.0,8,13555.0,9,S
2018-04-12 22:37:08,13555.0,4,3018,0,13550.0,8,13555.0,7,S
2018-04-12 22:37:08,13555.0,4,3022,0,13550.0,8,13555.0,5,S
2018-04-12 22:37:09,13555.0,4,3026,0,13550.0,8,13555.0,3,S
2018-04-12 22:37:09,13555.0,4,3030,0,13550.0,8,13555.0,1,S
2018-04-12 22:37:10,13555.0,2,3032,0,13555.0,1,13560.0,8,S
2018-04-12 22:37:45,13560.0,4,3036,4,13550.0,38,13560.0,1,B
2018-04-12 22:37:46,13560.0,4,3040,0,13555.0,1,13565.0,10,B
2018-04-12 22:40:17,13550.0,6,3046,0,13550.0,4,13555.0,9,S
2018-04-12 22:40:18,13550.0,8,3054,-6,13545.0,7,13555.0,11,S
2018-04-12 22:40:26,13545.0,6,3060,0,13540.0,8,13550.0,5,S
2018-04-12 22:40:26,13540.0,10,3070,-4,13535.0,4,13545.0,43,S
2018-04-12 22:40:31,13540.0,2,3072,-2,13535.0,5,13545.0,11,S
2018-04-12 22:40:32,13540.0,2,3074,2,13535.0,4,13545.0,13,S
2018-04-12 22:40:34,13540.0,2,3076,0,13535.0,6,13545.0,8,S
2018-04-12 22:40:35,13545.0,4,3080,-4,13540.0,3,13545.0,2,B
2018-04-12 22:41:08,13545.0,2,3082,0,13540.0,3,13545.0,4,B
2018-04-12 22:41:21,13545.0,8,3090,-6,13545.0,8,13550.0,1,B
2018-04-12 22:42:12,13540.0,2,3092,2,13540.0,6,13545.0,1,S
2018-04-12 22:42:23,13545.0,2,3094,0,13545.0,9,13550.0,7,B
2018-04-12 22:42:23,13550.0,8,3102,6,13550.0,3,13555.0,9,B
2018-04-12 22:42:24,13550.0,2,3104,2,13550.0,1,13555.0,4,B
2018-04-12 22:42:29,13550.0,2,3106,2,13545.0,8,13550.0,2,B
2018-04-12 22:42:46,13545.0,2,3108,-2,13545.0,2,13550.0,6,S
2018-04-12 22:42:46,13545.0,2,3110,2,13545.0,1,13550.0,6,S
2018-04-12 22:43:43,13550.0,2,3112,-2,13545.0,3,13550.0,1,B
2018-04-12 22:44:07,13550.0,2,3114,2,13545.0,5,13550.0,23,B
2018-04-12 22:44:08,13545.0,10,3124,2,13540.0,17,13550.0,23,S
2018-04-12 22:44:22,13540.0,2,3126,0,13540.0,11,13545.0,27,S
2018-04-12 22:44:22,13540.0,22,3148,-8,13535.0,11,13540.0,3,S
2018-04-12 22:44:23,13535.0,16,3164,6,13530.0,20,13535.0,6,S
2018-04-12 22:44:24,13530.0,2,3166,0,13530.0,14,13535.0,17,S
2018-04-12 22:44:24,13530.0,10,3176,2,13530.0,9,13535.0,12,S
2018-04-12 22:44:25,13530.0,18,3194,-2,13525.0,19,13535.0,11,S
2018-04-12 22:44:25,13525.0,2,3196,0,13525.0,3,13530.0,23,S
2018-04-12 22:44:34,13530.0,4,3200,0,13525.0,7,13530.0,20,B
2018-04-12 22:44:38,13530.0,52,3252,38,13530.0,2,13535.0,8,B
2018-04-12 22:44:41,13530.0,10,3262,-10,13525.0,22,13535.0,8,B
2018-04-12 22:44:41,13525.0,2,3264,0,13525.0,2,13530.0,9,S
2018-04-12 22:44:46,13530.0,10,3274,8,13525.0,9,13535.0,7,B
2018-04-12 22:44:48,13525.0,2,3276,-2,13525.0,8,13535.0,7,S
2018-04-12 22:44:51,13535.0,4,3280,-4,13530.0,8,13535.0,1,B
2018-04-12 22:44:52,13535.0,2,3282,0,13530.0,8,13540.0,5,B
2018-04-12 22:44:59,13530.0,2,3284,0,13530.0,7,13535.0,1,S
2018-04-12 22:45:12,13535.0,2,3286,0,13535.0,6,13540.0,3,B
2018-04-12 22:45:22,13535.0,2,3288,0,13535.0,5,13545.0,6,B
2018-04-12 22:45:33,13540.0,2,3290,0,13540.0,3,13545.0,3,B
2018-04-12 22:45:39,13545.0,2,3292,0,13540.0,1,13545.0,1,B
2018-04-12 22:45:44,13545.0,2,3294,0,13540.0,3,13550.0,9,B
2018-04-12 22:45:52,13540.0,2,3296,0,13540.0,5,13550.0,14,S
2018-04-12 22:46:31,13540.0,2,3298,0,13540.0,4,13550.0,14,S
2018-04-12 22:46:52,13535.0,2,3300,0,13535.0,1,13540.0,7,S
2018-04-12 22:46:52,13535.0,2,3302,-2,13530.0,7,13535.0,1,S
2018-04-12 22:46:53,13535.0,2,3304,-2,13530.0,6,13540.0,12,S
2018-04-12 22:47:23,13540.0,2,3306,2,13535.0,9,13540.0,4,B
2018-04-12 22:47:26,13540.0,8,3314,0,13540.0,16,13545.0,10,B
2018-04-12 22:49:13,13540.0,34,3348,-14,13535.0,6,13540.0,19,B
2018-04-12 22:49:16,13540.0,4,3352,4,13535.0,5,13540.0,12,B
2018-04-12 22:49:36,13540.0,2,3354,0,13535.0,6,13540.0,9,B
2018-04-12 22:49:44,13540.0,10,3364,0,13535.0,6,13540.0,4,B
2018-04-12 22:49:47,13540.0,2,3366,0,13535.0,6,13540.0,3,B
2018-04-12 22:49:48,13540.0,6,3372,-4,13540.0,16,13545.0,7,B
2018-04-12 22:49:48,13540.0,14,3386,0,13540.0,9,13545.0,12,B
2018-04-12 22:49:49,13540.0,4,3390,0,13540.0,7,13545.0,12,B
2018-04-12 22:49:49,13540.0,10,3400,0,13540.0,2,13545.0,12,B
2018-04-12 22:49:50,13540.0,4,3404,0,13535.0,9,13540.0,1,B
2018-04-12 22:50:01,13535.0,12,3416,0,13530.0,11,13540.0,15,S
2018-04-12 22:50:08,13530.0,2,3418,0,13530.0,6,13535.0,7,S
2018-04-12 22:50:09,13530.0,4,3422,2,13530.0,4,13535.0,12,S
2018-04-12 22:50:09,13530.0,6,3428,6,13530.0,1,13535.0,15,S
2018-04-12 22:50:10,13530.0,2,3430,0,13525.0,19,13535.0,13,S
2018-04-12 22:50:11,13525.0,2,3432,0,13525.0,6,13535.0,19,S
2018-04-12 22:50:13,13525.0,4,3436,0,13520.0,8,13525.0,1,S
2018-04-12 22:50:14,13525.0,12,3448,2,13520.0,8,13530.0,8,S
2018-04-12 22:50:20,13525.0,6,3454,6,13520.0,8,13525.0,1,S
2018-04-12 22:50:21,13525.0,4,3458,2,13520.0,5,13525.0,2,S
2018-04-12 22:50:22,13520.0,10,3468,0,13515.0,2,13520.0,7,S
2018-04-12 22:50:23,13515.0,4,3472,2,13510.0,17,13520.0,17,S
2018-04-12 22:50:23,13515.0,2,3474,0,13510.0,14,13515.0,5,S
2018-04-12 22:50:24,13515.0,4,3478,2,13510.0,13,13515.0,7,S
2018-04-12 22:50:25,13520.0,42,3520,-6,13515.0,2,13525.0,8,B
2018-04-12 22:50:27,13515.0,2,3522,0,13515.0,7,13525.0,9,S
2018-04-12 22:50:29,13515.0,2,3524,0,13515.0,6,13525.0,10,S
2018-04-12 22:50:35,13520.0,2,3526,0,13515.0,9,13525.0,6,B
2018-04-12 22:50:36,13515.0,2,3528,2,13515.0,8,13525.0,8,S
2018-04-12 22:50:37,13525.0,4,3532,4,13520.0,11,13525.0,4,B
2018-04-12 22:50:42,13520.0,10,3542,0,13520.0,6,13525.0,1,S
2018-04-12 22:50:51,13520.0,2,3544,0,13515.0,5,13520.0,1,S
2018-04-12 22:50:56,13520.0,8,3552,8,13515.0,7,13525.0,6,S
2018-04-12 22:51:06,13525.0,6,3558,0,13525.0,1,13530.0,5,B
2018-04-12 22:51:12,13530.0,2,3560,2,13530.0,1,13535.0,2,B
2018-04-12 22:51:23,13525.0,2,3562,0,13525.0,5,13535.0,4,S
2018-04-12 22:51:25,13520.0,2,3564,0,13520.0,7,13525.0,1,S
2018-04-12 22:51:29,13525.0,2,3566,2,13520.0,4,13525.0,1,B
2018-04-12 22:51:32,13520.0,6,3572,0,13515.0,4,13520.0,1,S
2018-04-12 22:51:35,13525.0,4,3576,0,13515.0,4,13525.0,2,B
2018-04-12 22:51:37,13525.0,16,3592,14,13525.0,7,13530.0,14,B
2018-04-12 22:51:38,13525.0,14,3606,2,13520.0,1,13525.0,11,B
2018-04-12 22:51:39,13515.0,2,3608,0,13515.0,3,13525.0,12,S
2018-04-12 22:51:45,13515.0,2,3610,0,13515.0,3,13520.0,3,S
2018-04-12 22:51:46,13520.0,2,3612,2,13515.0,3,13520.0,2,B
2018-04-12 22:51:47,13515.0,2,3614,-2,13515.0,2,13520.0,2,S
2018-04-12 22:51:48,13520.0,2,3616,2,13515.0,3,13520.0,1,B
2018-04-12 22:51:49,13520.0,2,3618,2,13515.0,2,13520.0,1,B
2018-04-12 22:51:52,13515.0,6,3624,2,13510.0,28,13515.0,2,S
2018-04-12 22:51:53,13515.0,4,3628,0,13515.0,1,13520.0,2,S
2018-04-12 22:51:57,13515.0,6,3634,0,13510.0,29,13515.0,2,S
2018-04-12 22:51:57,13515.0,4,3638,2,13510.0,29,13520.0,1,S
2018-04-12 22:52:09,13515.0,4,3642,-2,13510.0,18,13520.0,3,S
2018-04-12 22:52:09,13510.0,2,3644,0,13510.0,15,13515.0,3,S
2018-04-12 22:52:10,13515.0,2,3646,0,13510.0,16,13515.0,1,B
2018-04-12 22:52:11,13515.0,2,3648,0,13510.0,16,13520.0,4,B
2018-04-12 22:52:13,13510.0,18,3666,-10,13510.0,7,13515.0,4,S
2018-04-12 22:52:14,13510.0,6,3672,-6,13510.0,6,13515.0,2,S
2018-04-12 22:52:17,13520.0,2,3674,2,13510.0,7,13520.0,3,B
2018-04-12 22:52:22,13515.0,4,3678,0,13510.0,7,13515.0,2,S
2018-04-12 22:52:26,13515.0,2,3680,0,13510.0,6,13515.0,1,S
2018-04-12 22:52:29,13515.0,2,3682,0,13510.0,6,13520.0,3,S
2018-04-12 22:52:57,13520.0,2,3684,2,13515.0,3,13520.0,1,B
2018-04-12 22:52:59,13520.0,2,3686,0,13515.0,3,13525.0,4,B
2018-04-12 22:53:07,13525.0,2,3688,2,13520.0,1,13525.0,1,B
2018-04-12 22:53:08,13525.0,2,3690,0,13520.0,4,13530.0,9,B
2018-04-12 22:53:09,13530.0,6,3696,0,13530.0,2,13535.0,17,B
2018-04-12 22:53:09,13530.0,4,3700,2,13525.0,1,13530.0,2,B
2018-04-12 22:53:10,13520.0,2,3702,0,13520.0,5,13530.0,2,S
2018-04-12 22:53:13,13535.0,10,3712,6,13530.0,1,13535.0,5,B
2018-04-12 22:53:18,13530.0,2,3714,0,13530.0,3,13535.0,1,S
2018-04-12 22:53:20,13530.0,2,3716,2,13520.0,7,13530.0,2,S
2018-04-12 22:53:38,13525.0,2,3718,0,13520.0,7,13530.0,2,S
2018-04-12 22:53:44,13530.0,2,3720,0,13520.0,7,13530.0,2,B
2018-04-12 22:53:58,13530.0,4,3724,0,13525.0,1,13535.0,9,B
2018-04-12 22:54:02,13525.0,2,3726,0,13525.0,1,13535.0,13,S
2018-04-12 22:54:11,13520.0,2,3728,-2,13520.0,2,13525.0,4,S
2018-04-12 22:54:11,13520.0,2,3730,0,13520.0,1,13525.0,19,S
2018-04-12 22:54:15,13520.0,2,3732,0,13515.0,2,13520.0,1,S
2018-04-12 22:54:21,13520.0,2,3734,0,13515.0,6,13520.0,1,S
2018-04-12 22:54:21,13520.0,2,3736,0,13520.0,2,13525.0,4,S
2018-04-12 22:54:30,13520.0,6,3742,-6,13515.0,7,13530.0,6,S
2018-04-12 22:54:31,13515.0,2,3744,0,13515.0,6,13530.0,15,S
2018-04-12 22:54:41,13520.0,2,3746,-2,13515.0,3,13525.0,13,B
2018-04-12 22:54:54,13510.0,18,3764,8,13505.0,25,13515.0,26,S
2018-04-12 22:54:55,13505.0,2,3766,0,13500.0,11,13515.0,27,S
2018-04-12 22:54:57,13515.0,2,3768,0,13505.0,2,13515.0,26,B
2018-04-12 22:55:07,13505.0,8,3776,2,13505.0,2,13510.0,1,S
2018-04-12 22:55:18,13510.0,2,3778,0,13500.0,13,13510.0,3,B
2018-04-12 22:55:21,13505.0,14,3792,2,13500.0,14,13505.0,3,S
2018-04-12 22:55:22,13505.0,4,3796,2,13500.0,24,13505.0,1,S
2018-04-12 22:55:23,13505.0,2,3798,0,13505.0,4,13515.0,6,S
2018-04-12 22:55:28,13510.0,4,3802,4,13505.0,8,13515.0,11,B
2018-04-12 22:55:34,13510.0,2,3804,-2,13510.0,1,13515.0,13,B
2018-04-12 22:55:39,13510.0,2,3806,2,13505.0,8,13515.0,13,B
2018-04-12 22:56:12,13505.0,6,3812,-4,13505.0,7,13515.0,16,S
2018-04-12 22:56:21,13515.0,4,3816,4,13505.0,7,13515.0,14,B
2018-04-12 22:56:28,13515.0,2,3818,0,13510.0,2,13520.0,8,B
2018-04-12 22:56:37,13520.0,2,3820,0,13510.0,2,13520.0,11,B
2018-04-12 22:57:00,13520.0,2,3822,0,13510.0,2,13520.0,10,B
2018-04-12 22:57:02,13520.0,4,3826,-2,13505.0,7,13515.0,10,B
2018-04-12 22:57:04,13515.0,2,3828,0,13505.0,9,13515.0,9,S
2018-04-12 22:57:14,13510.0,2,3830,-2,13505.0,8,13515.0,10,S
2018-04-12 22:57:27,13520.0,2,3832,0,13520.0,2,13525.0,1,B
2018-04-12 22:57:30,13520.0,4,3836,-4,13515.0,3,13525.0,6,B
2018-04-12 22:57:55,13520.0,2,3838,2,13510.0,4,13520.0,10,B
2018-04-12 22:57:55,13510.0,2,3840,-2,13510.0,3,13520.0,10,S
2018-04-12 22:57:57,13520.0,2,3842,2,13510.0,4,13520.0,11,B
2018-04-12 22:58:12,13515.0,2,3844,0,13510.0,9,13520.0,8,S
2018-04-12 22:58:27,13515.0,4,3848,4,13510.0,9,13515.0,18,S
2018-04-12 22:58:29,13515.0,2,3850,2,13510.0,9,13515.0,17,S
2018-04-12 22:58:29,13515.0,2,3852,2,13510.0,9,13515.0,16,S
2018-04-12 22:58:30,13515.0,2,3854,2,13510.0,9,13515.0,15,S
2018-04-12 22:58:30,13515.0,2,3856,2,13510.0,9,13515.0,14,S
2018-04-12 22:58:31,13515.0,2,3858,2,13510.0,9,13515.0,14,S
2018-04-12 22:58:31,13515.0,2,3860,2,13510.0,9,13515.0,13,S
2018-04-12 22:58:32,13515.0,2,3862,2,13510.0,9,13515.0,12,S
2018-04-12 22:58:32,13515.0,2,3864,2,13510.0,8,13515.0,11,S
2018-04-12 22:58:33,13515.0,2,3866,2,13510.0,8,13515.0,10,S
2018-04-12 22:58:33,13515.0,2,3868,2,13510.0,8,13515.0,9,S
2018-04-12 22:58:34,13515.0,2,3870,2,13510.0,8,13515.0,8,S
2018-04-12 22:58:34,13515.0,2,3872,2,13510.0,8,13515.0,7,S
2018-04-12 22:58:35,13515.0,2,3874,2,13510.0,8,13515.0,6,S
2018-04-12 22:58:35,13515.0,2,3876,2,13510.0,8,13515.0,5,S
2018-04-12 22:58:36,13515.0,2,3878,2,13510.0,8,13515.0,4,S
2018-04-12 22:58:36,13515.0,2,3880,2,13510.0,8,13515.0,3,S
2018-04-12 22:58:37,13515.0,2,3882,2,13510.0,8,13515.0,2,S
2018-04-12 22:58:37,13515.0,2,3884,2,13510.0,8,13515.0,1,S
2018-04-12 22:58:38,13515.0,2,3886,0,13510.0,8,13520.0,3,S
2018-04-12 22:58:40,13520.0,2,3888,0,13510.0,8,13520.0,4,B
2018-04-12 22:59:00,13520.0,4,3892,0,13510.0,7,13520.0,2,B
2018-04-12 22:59:01,13520.0,2,3894,2,13510.0,7,13520.0,1,B
2018-04-12 22:59:01,13520.0,2,3896,2,13510.0,7,13525.0,18,B
2018-04-12 22:59:02,13520.0,2,3898,2,13510.0,7,13520.0,6,B
2018-04-12 22:59:03,13520.0,2,3900,2,13510.0,7,13520.0,5,B
2018-04-12 22:59:03,13520.0,2,3902,2,13510.0,7,13520.0,4,B
2018-04-12 22:59:04,13520.0,2,3904,2,13510.0,7,13520.0,3,B
2018-04-12 22:59:04,13520.0,2,3906,2,13510.0,7,13520.0,2,B
2018-04-12 22:59:05,13520.0,2,3908,2,13510.0,7,13520.0,2,B
2018-04-12 22:59:05,13520.0,2,3910,2,13510.0,7,13520.0,1,B
2018-04-12 22:59:06,13520.0,2,3912,2,13510.0,7,13525.0,23,B
2018-04-12 22:59:07,13520.0,2,3914,2,13510.0,7,13520.0,2,B
2018-04-12 22:59:08,13520.0,2,3916,2,13510.0,7,13520.0,1,B
2018-04-12 22:59:08,13520.0,2,3918,2,13510.0,7,13525.0,23,B
2018-04-12 22:59:11,13525.0,2,3920,2,13515.0,2,13525.0,4,B
2018-04-12 22:59:11,13525.0,2,3922,2,13520.0,1,13525.0,1,B
2018-04-12 22:59:12,13525.0,2,3924,-2,13525.0,5,13530.0,21,B
2018-04-12 22:59:12,13525.0,12,3936,-6,13515.0,5,13525.0,1,B
2018-04-12 22:59:13,13525.0,2,3938,0,13515.0,5,13525.0,3,B
2018-04-12 22:59:13,13525.0,2,3940,2,13520.0,1,13530.0,21,B
2018-04-12 22:59:14,13525.0,2,3942,2,13520.0,1,13525.0,4,B
2018-04-12 22:59:15,13525.0,2,3944,2,13520.0,1,13525.0,3,B
2018-04-12 22:59:20,13520.0,2,3946,0,13515.0,5,13525.0,1,S
2018-04-12 22:59:21,13515.0,2,3948,-2,13515.0,4,13520.0,3,S
2018-04-12 22:59:22,13520.0,2,3950,2,13515.0,4,13520.0,2,B
2018-04-12 22:59:22,13520.0,2,3952,2,13515.0,4,13520.0,1,B
2018-04-12 22:59:23,13520.0,2,3954,2,13515.0,3,13525.0,5,B
2018-04-12 22:59:31,13525.0,2,3956,0,13515.0,3,13525.0,11,B
2018-04-12 22:59:40,13515.0,2,3958,-2,13515.0,2,13525.0,11,S
2018-04-12 22:59:42,13525.0,2,3960,-2,13515.0,2,13525.0,10,B
2018-04-13 09:00:00,13525.0,2,3962,0,13515.0,2,13525.0,3,B
2018-04-13 09:00:01,13520.0,16,3978,14,13515.0,6,13525.0,3,S
2018-04-13 09:00:03,13525.0,6,3984,2,13520.0,12,13525.0,1,B
2018-04-13 09:00:03,13520.0,4,3988,4,13520.0,5,13525.0,1,S
2018-04-13 09:00:04,13520.0,8,3996,-2,13520.0,1,13530.0,6,S
2018-04-13 09:00:05,13520.0,2,3998,-2,13515.0,7,13525.0,6,S
2018-04-13 09:00:07,13525.0,2,4000,0,13515.0,7,13530.0,11,B
2018-04-13 09:00:12,13530.0,2,4002,0,13525.0,1,13530.0,7,B
2018-04-13 09:00:12,13530.0,2,4004,-2,13525.0,4,13530.0,6,B
2018-04-13 09:00:13,13530.0,8,4012,-6,13525.0,9,13530.0,2,B
2018-04-13 09:00:14,13530.0,4,4016,4,13525.0,9,13535.0,1,B
2018-04-13 09:00:15,13540.0,4,4020,-4,13535.0,1,13545.0,1,B
2018-04-13 09:00:23,13535.0,10,4030,0,13530.0,7,13540.0,3,S
2018-04-13 09:00:24,13540.0,4,4034,0,13530.0,4,13545.0,1,B
2018-04-13 09:00:28,13535.0,2,4036,0,13530.0,2,13540.0,7,S
2018-04-13 09:00:32,13535.0,2,4038,2,13530.0,2,13540.0,8,S
2018-04-13 09:00:32,13530.0,4,4042,-2,13525.0,1,13530.0,23,S
2018-04-13 09:00:33,13530.0,26,4068,-2,13525.0,1,13530.0,10,S
2018-04-13 09:00:33,13530.0,20,4088,-8,13530.0,1,13540.0,5,S
2018-04-13 09:00:34,13540.0,6,4094,4,13530.0,9,13540.0,3,B
2018-04-13 09:00:47,13530.0,30,4124,-12,13525.0,7,13530.0,35,S
2018-04-13 09:00:48,13525.0,16,4140,-2,13520.0,15,13525.0,10,S
2018-04-13 09:00:49,13525.0,20,4160,0,13525.0,13,13530.0,35,S
2018-04-13 09:00:52,13530.0,2,4162,0,13525.0,10,13530.0,34,B
2018-04-13 09:01:00,13525.0,26,4188,-14,13520.0,7,13525.0,22,S
2018-04-13 09:01:02,13525.0,2,4190,-2,13520.0,7,13525.0,21,S
2018-04-13 09:01:03,13525.0,2,4192,0,13520.0,7,13525.0,20,S
2018-04-13 09:01:03,13525.0,24,4216,0,13520.0,7,13525.0,8,S
2018-04-13 09:01:04,13525.0,16,4232,-12,13525.0,3,13530.0,34,S
2018-04-13 09:01:11,13525.0,18,4250,-8,13520.0,26,13525.0,25,S
2018-04-13 09:01:15,13520.0,2,4252,0,13520.0,13,13525.0,26,S
2018-04-13 09:01:18,13520.0,4,4256,-4,13520.0,17,13525.0,26,S
2018-04-13 09:01:21,13525.0,8,4264,-8,13520.0,29,13525.0,22,B
2018-04-13 09:01:21,13520.0,2,4266,0,13520.0,30,13525.0,22,S
2018-04-13 09:01:22,13525.0,2,4268,0,13520.0,30,13525.0,21,B
2018-04-13 09:01:24,13525.0,2,4270,0,13520.0,30,13525.0,20,B
2018-04-13 09:01:25,13525.0,4,4274,0,13520.0,30,13525.0,18,B
2018-04-13 09:01:26,13525.0,2,4276,0,13520.0,30,13525.0,17,B
2018-04-13 09:01:27,13525.0,2,4278,0,13520.0,30,13525.0,16,B
2018-04-13 09:01:28,13525.0,2,4280,0,13520.0,30,13525.0,15,B
2018-04-13 09:01:33,13525.0,2,4282,0,13520.0,30,13525.0,14,B
2018-04-13 09:01:36,13525.0,18,4300,0,13520.0,30,13525.0,4,B
2018-04-13 09:01:37,13525.0,8,4308,0,13525.0,6,13530.0,2,B
2018-04-13 09:01:37,13530.0,4,4312,-2,13530.0,2,13535.0,2,B
2018-04-13 09:01:43,13535.0,2,4314,2,13530.0,27,13540.0,2,B
2018-04-13 09:01:47,13540.0,8,4322,-6,13535.0,28,13540.0,2,B
2018-04-13 09:01:49,13540.0,2,4324,-2,13535.0,28,13540.0,1,B
2018-04-13 09:01:56,13540.0,2,4326,0,13535.0,17,13545.0,1,B
2018-04-13 09:01:57,13540.0,2,4328,0,13540.0,4,13545.0,4,B
2018-04-13 09:01:58,13540.0,2,4330,0,13540.0,3,13545.0,4,B
2018-04-13 09:02:00,13540.0,2,4332,2,13540.0,3,13545.0,4,B
2018-04-13 09:02:00,13540.0,6,4338,0,13535.0,15,13545.0,4,B
2018-04-13 09:02:03,13545.0,2,4340,0,13535.0,16,13545.0,3,B
2018-04-13 09:02:03,13545.0,2,4342,0,13540.0,2,13545.0,2,B
2018-04-13 09:02:08,13535.0,6,4348,4,13535.0,12,13540.0,9,S
2018-04-13 09:02:08,13540.0,2,4350,0,13535.0,5,13540.0,9,B
2018-04-13 09:02:15,13535.0,8,4358,-2,13530.0,11,13535.0,12,S
2018-04-13 09:02:20,13535.0,6,4364,-6,13535.0,2,13540.0,5,S
2018-04-13 09:02:21,13535.0,4,4368,-4,13530.0,13,13535.0,1,S
2018-04-13 09:02:23,13535.0,2,4370,0,13530.0,13,13540.0,8,S
2018-04-13 09:02:29,13535.0,2,4372,0,13535.0,15,13545.0,3,S
2018-04-13 09:02:38,13535.0,8,4380,0,13530.0,7,13540.0,11,S
2018-04-13 09:02:39,13540.0,2,4382,-2,13530.0,16,13540.0,2,B
2018-04-13 09:03:02,13545.0,6,4388,-6,13535.0,13,13545.0,6,B
2018-04-13 09:03:05,13545.0,12,4400,-6,13545.0,4,13550.0,21,B
2018-04-13 09:03:06,13545.0,8,4408,-8,13540.0,1,13545.0,11,B
2018-04-13 09:03:13,13540.0,2,4410,2,13535.0,7,13540.0,3,S
2018-04-13 09:03:13,13535.0,2,4412,-2,13535.0,7,13540.0,3,S
2018-04-13 09:03:14,13535.0,6,4418,-6,13535.0,4,13540.0,3,S
2018-04-13 09:03:18,13540.0,2,4420,0,13535.0,6,13545.0,6,B
2018-04-13 09:03:28,13540.0,6,4426,2,13535.0,2,13540.0,1,B
2018-04-13 09:04:01,13535.0,4,4430,2,13535.0,1,13540.0,3,S
2018-04-13 09:04:14,13535.0,2,4432,0,13535.0,9,13540.0,2,S
2018-04-13 09:04:20,13540.0,4,4436,4,13535.0,9,13545.0,14,B
2018-04-13 09:04:22,13545.0,8,4444,0,13540.0,17,13545.0,2,B
2018-04-13 09:04:22,13545.0,4,4448,-4,13540.0,17,13550.0,8,B
2018-04-13 09:04:28,13550.0,2,4450,2,13540.0,17,13550.0,9,B
2018-04-13 09:04:41,13540.0,4,4454,0,13540.0,17,13550.0,8,S
2018-04-13 09:04:42,13550.0,4,4458,4,13545.0,20,13550.0,4,B
2018-04-13 09:04:43,13550.0,8,4466,8,13545.0,30,13555.0,9,B
2018-04-13 09:04:49,13550.0,12,4478,-10,13540.0,5,13550.0,2,B
2018-04-13 09:05:03,13550.0,2,4480,-2,13545.0,4,13550.0,3,B
2018-04-13 09:05:13,13545.0,10,4490,10,13540.0,20,13550.0,3,S
2018-04-13 09:05:17,13550.0,2,4492,0,13540.0,20,13550.0,2,B
2018-04-13 09:05:18,13540.0,10,4502,-8,13540.0,5,13545.0,11,S
2018-04-13 09:05:19,13540.0,12,4514,-8,13535.0,3,13545.0,13,S
2018-04-13 09:05:20,13535.0,2,4516,2,13530.0,3,13540.0,22,S
2018-04-13 09:05:21,13535.0,2,4518,-2,13535.0,1,13540.0,19,S
2018-04-13 09:05:26,13540.0,2,4520,0,13535.0,12,13540.0,6,B
2018-04-13 09:05:53,13540.0,16,4536,4,13540.0,12,13545.0,24,B
2018-04-13 09:05:54,13540.0,24,4560,20,13535.0,1,13540.0,17,B
2018-04-13 09:05:59,13535.0,4,4564,-4,13530.0,15,13540.0,18,S
2018-04-13 09:06:05,13540.0,4,4568,0,13535.0,19,13540.0,8,B
2018-04-13 09:06:13,13540.0,6,4574,0,13535.0,19,13540.0,5,B
2018-04-13 09:07:23,13540.0,2,4576,0,13535.0,15,13540.0,14,B
2018-04-13 09:07:24,13540.0,12,4588,0,13535.0,22,13540.0,8,B
2018-04-13 09:07:24,13540.0,16,4604,12,13540.0,8,13545.0,6,B
2018-04-13 09:07:59,13545.0,2,4606,0,13545.0,8,13550.0,6,B
2018-04-13 09:07:59,13545.0,2,4608,-2,13545.0,6,13550.0,2,B
2018-04-13 09:08:11,13550.0,2,4610,2,13545.0,17,13550.0,1,B
2018-04-13 09:08:35,13545.0,2,4612,0,13540.0,9,13545.0,2,S
2018-04-13 09:08:46,13545.0,2,4614,-2,13540.0,14,13550.0,19,S
2018-04-13 09:08:50,13545.0,2,4616,0,13540.0,12,13550.0,19,S
2018-04-13 09:08:54,13545.0,2,4618,0,13540.0,12,13550.0,19,S
2018-04-13 09:09:07,13545.0,10,4628,0,13540.0,10,13545.0,1,S
2018-04-13 09:09:20,13540.0,2,4630,-2,13540.0,7,13550.0,20,S
2018-04-13 09:09:43,13545.0,6,4636,-4,13540.0,10,13550.0,21,B
2018-04-13 09:10:21,13545.0,2,4638,2,13540.0,3,13545.0,6,B
2018-04-13 09:10:34,13540.0,2,4640,0,13540.0,1,13545.0,3,S
2018-04-13 09:10:49,13540.0,2,4642,0,13535.0,8,13545.0,3,S
2018-04-13 09:11:14,13545.0,4,4646,4,13545.0,15,13550.0,19,B
2018-04-13 09:11:15,13550.0,6,4652,0,13545.0,12,13550.0,14,B
2018-04-13 09:11:16,13550.0,18,4670,6,13545.0,16,13550.0,5,B
2018-04-13 09:11:16,13550.0,10,4680,2,13550.0,3,13555.0,10,B
2018-04-13 09:11:30,13550.0,10,4690,4,13545.0,21,13555.0,9,B
2018-04-13 09:11:40,13555.0,2,4692,-2,13550.0,4,13555.0,8,B
2018-04-13 09:11:42,13550.0,6,4698,6,13545.0,14,13550.0,1,S
2018-04-13 09:11:52,13550.0,6,4704,-2,13545.0,13,13555.0,10,S
2018-04-13 09:11:53,13555.0,6,4710,-6,13550.0,4,13555.0,6,B
2018-04-13 09:11:54,13555.0,4,4714,0,13550.0,5,13555.0,4,B
2018-04-13 09:11:54,13555.0,8,4722,2,13555.0,3,13560.0,8,B
2018-04-13 09:11:56,13555.0,14,4736,6,13550.0,7,13560.0,11,B
2018-04-13 09:12:17,13560.0,8,4744,-8,13555.0,7,13565.0,6,B
2018-04-13 09:12:21,13555.0,2,4746,-2,13550.0,6,13555.0,1,S
2018-04-13 09:12:24,13555.0,2,4748,0,13550.0,3,13555.0,3,S
2018-04-13 09:12:28,13555.0,2,4750,0,13550.0,7,13560.0,12,S
2018-04-13 09:12:41,13550.0,2,4752,0,13550.0,11,13560.0,13,S
2018-04-13 09:12:56,13555.0,2,4754,0,13555.0,1,13560.0,10,B
2018-04-13 09:12:57,13560.0,2,4756,-2,13560.0,1,13565.0,8,B
2018-04-13 09:13:04,13560.0,2,4758,2,13560.0,5,13565.0,2,B
2018-04-13 09:13:06,13560.0,2,4760,0,13560.0,4,13565.0,2,B
2018-04-13 09:13:07,13560.0,6,4766,-4,13555.0,24,13565.0,2,B
2018-04-13 09:13:08,13560.0,22,4788,14,13555.0,2,13560.0,1,B
2018-04-13 09:13:21,13565.0,6,4794,-4,13560.0,1,13565.0,1,B
2018-04-13 09:13:22,13560.0,2,4796,0,13560.0,1,13565.0,1,S
2018-04-13 09:13:26,13560.0,2,4798,0,13560.0,1,13565.0,2,S
2018-04-13 09:13:27,13565.0,4,4802,0,13565.0,1,13570.0,19,B
2018-04-13 09:13:27,13565.0,2,4804,0,13560.0,2,13565.0,1,B
2018-04-13 09:13:38,13565.0,2,4806,0,13560.0,23,13570.0,11,B
2018-04-13 09:13:49,13565.0,2,4808,2,13565.0,1,13570.0,12,B
2018-04-13 09:13:51,13570.0,2,4810,-2,13565.0,1,13570.0,11,B
2018-04-13 09:13:53,13565.0,4,4814,2,13565.0,5,13570.0,2,S
2018-04-13 09:14:20,13575.0,4,4818,0,13575.0,4,13580.0,9,B
2018-04-13 09:14:22,13580.0,2,4820,0,13575.0,3,13580.0,6,B
2018-04-13 09:14:22,13580.0,6,4826,2,13575.0,30,13580.0,3,B
2018-04-13 09:14:23,13580.0,6,4832,-4,13575.0,30,13585.0,6,B
2018-04-13 09:14:29,13585.0,8,4840,6,13585.0,1,13590.0,32,B
2018-04-13 09:14:30,13585.0,2,4842,0,13580.0,2,13585.0,9,B
2018-04-13 09:14:32,13580.0,2,4844,0,13575.0,8,13585.0,11,S
2018-04-13 09:14:35,13580.0,2,4846,-2,13580.0,1,13585.0,5,S
2018-04-13 09:14:35,13580.0,2,4848,-2,13575.0,4,13580.0,3,S
2018-04-13 09:14:40,13585.0,10,4858,8,13580.0,9,13590.0,24,B
2018-04-13 09:14:41,13585.0,8,4866,0,13580.0,28,13590.0,14,B
2018-04-13 09:14:46,13580.0,2,4868,2,13580.0,16,13585.0,3,S
2018-04-13 09:14:47,13585.0,2,4870,0,13580.0,12,13585.0,3,B
2018-04-13 09:14:54,13585.0,4,4874,0,13580.0,8,13590.0,20,B
2018-04-13 09:14:57,13580.0,4,4878,-2,13580.0,22,13590.0,13,S
2018-04-13 09:15:03,13590.0,2,4880,0,13585.0,5,13590.0,12,B
2018-04-13 09:15:04,13590.0,12,4892,10,13585.0,25,13590.0,6,B
2018-04-13 09:15:04,13590.0,12,4904,12,13590.0,3,13595.0,6,B
2018-04-13 09:15:05,13595.0,4,4908,0,13595.0,2,13600.0,32,B
2018-04-13 09:15:06,13595.0,10,4918,-8,13590.0,1,13595.0,5,B
2018-04-13 09:15:06,13590.0,2,4920,0,13585.0,23,13595.0,8,S
2018-04-13 09:15:24,13580.0,2,4922,2,13580.0,1,13585.0,5,S
2018-04-13 09:15:24,13580.0,2,4924,2,13575.0,2,13580.0,17,S
2018-04-13 09:15:29,13580.0,2,4926,0,13575.0,3,13580.0,15,S
2018-04-13 09:15:33,13575.0,2,4928,0,13570.0,19,13580.0,15,S
2018-04-13 09:15:37,13575.0,2,4930,2,13570.0,26,13580.0,16,S
2018-04-13 09:15:40,13570.0,2,4932,2,13570.0,27,13580.0,15,S
2018-04-13 09:15:44,13580.0,6,4938,0,13570.0,27,13580.0,13,B
2018-04-13 09:15:52,13570.0,6,4944,-4,13570.0,2,13575.0,4,S
2018-04-13 09:15:52,13575.0,2,4946,2,13570.0,2,13575.0,3,B
2018-04-13 09:16:00,13570.0,2,4948,2,13570.0,20,13580.0,3,S
2018-04-13 09:16:04,13575.0,4,4952,0,13570.0,20,13575.0,4,B
2018-04-13 09:16:13,13570.0,2,4954,2,13570.0,7,13575.0,4,S
2018-04-13 09:16:14,13570.0,2,4956,0,13565.0,2,13575.0,7,S
2018-04-13 09:16:19,13565.0,8,4964,-2,13560.0,8,13570.0,7,S
2018-04-13 09:16:37,13570.0,12,4976,4,13565.0,7,13570.0,1,B
2018-04-13 09:17:15,13570.0,2,4978,2,13565.0,9,13570.0,2,B
2018-04-13 09:17:32,13570.0,2,4980,0,13565.0,6,13575.0,6,B
2018-04-13 09:17:33,13575.0,2,4982,0,13565.0,6,13575.0,5,B
2018-04-13 09:17:42,13575.0,6,4988,2,13570.0,5,13575.0,2,B
2018-04-13 09:17:44,13575.0,2,4990,2,13570.0,13,13580.0,7,B
2018-04-13 09:17:48,13580.0,4,4994,4,13575.0,11,13585.0,11,B
2018-04-13 09:17:49,13580.0,10,5004,0,13575.0,18,13585.0,5,B
2018-04-13 09:17:55,13575.0,2,5006,2,13575.0,7,13585.0,6,S
2018-04-13 09:18:13,13575.0,2,5008,-2,13575.0,11,13585.0,6,S
2018-04-13 09:18:41,13575.0,2,5010,0,13575.0,12,13585.0,11,S
2018-04-13 09:18:56,13580.0,2,5012,2,13580.0,3,13585.0,7,B
2018-04-13 09:19:03,13585.0,14,5026,14,13580.0,10,13590.0,11,B
2018-04-13 09:19:07,13590.0,6,5032,-6,13585.0,21,13590.0,2,B
2018-04-13 09:19:07,13590.0,2,5034,-2,13585.0,26,13590.0,1,B
2018-04-13 09:19:08,13590.0,2,5036,-2,13585.0,26,13595.0,12,B
2018-04-13 09:19:11,13585.0,2,5038,0,13585.0,25,13595.0,8,S
2018-04-13 09:19:17,13585.0,2,5040,2,13585.0,23,13595.0,8,S
2018-04-13 09:19:28,13595.0,12,5052,-2,13590.0,20,13600.0,35,B
2018-04-13 09:19:29,13595.0,4,5056,0,13590.0,3,13595.0,13,B
2018-04-13 09:19:31,13595.0,4,5060,2,13590.0,10,13600.0,42,B
2018-04-13 09:19:32,13595.0,2,5062,0,13590.0,9,13600.0,39,B
2018-04-13 09:19:34,13595.0,2,5064,0,13590.0,9,13600.0,38,B
2018-04-13 09:19:35,13595.0,2,5066,0,13590.0,8,13595.0,11,B
2018-04-13 09:19:45,13595.0,2,5068,-2,13590.0,11,13600.0,42,B
2018-04-13 09:19:48,13590.0,4,5072,0,13590.0,11,13600.0,40,S
2018-04-13 09:19:57,13600.0,2,5074,0,13595.0,11,13600.0,33,B
2018-04-13 09:19:57,13600.0,4,5078,0,13595.0,10,13600.0,32,B
2018-04-13 09:20:01,13600.0,30,5108,30,13595.0,6,13600.0,17,B
2018-04-13 09:20:02,13600.0,18,5126,10,13595.0,21,13600.0,8,B
2018-04-13 09:20:02,13600.0,16,5142,-6,13600.0,1,13605.0,5,B
2018-04-13 09:20:05,13600.0,2,5144,0,13600.0,1,13605.0,4,B
2018-04-13 09:20:06,13595.0,2,5146,2,13595.0,4,13600.0,2,S
2018-04-13 09:20:06,13600.0,2,5148,0,13595.0,4,13600.0,4,B
2018-04-13 09:20:10,13600.0,4,5152,0,13595.0,1,13600.0,15,B
2018-04-13 09:20:11,13600.0,20,5172,-10,13590.0,16,13600.0,6,B
2018-04-13 09:20:13,13595.0,4,5176,-4,13590.0,18,13600.0,11,S
2018-04-13 09:20:13,13590.0,2,5178,-2,13590.0,9,13600.0,11,S
2018-04-13 09:20:20,13595.0,2,5180,0,13590.0,8,13595.0,6,B
2018-04-13 09:20:25,13590.0,16,5196,-4,13585.0,4,13590.0,2,S
2018-04-13 09:20:30,13590.0,2,5198,-2,13585.0,6,13590.0,1,S
2018-04-13 09:20:38,13585.0,2,5200,2,13585.0,8,13590.0,1,S
2018-04-13 09:20:39,13585.0,2,5202,2,13585.0,7,13590.0,1,S
2018-04-13 09:20:49,13585.0,2,5204,0,13585.0,6,13590.0,2,S
2018-04-13 09:20:50,13585.0,2,5206,-2,13585.0,5,13590.0,1,S
2018-04-13 09:21:03,13590.0,2,5208,2,13590.0,11,13595.0,6,B
2018-04-13 09:21:08,13595.0,4,5212,-2,13590.0,36,13595.0,2,B
2018-04-13 09:21:08,13595.0,4,5216,-2,13595.0,13,13600.0,11,B
2018-04-13 09:21:09,13595.0,6,5222,0,13590.0,35,13600.0,11,B
2018-04-13 09:21:09,13595.0,10,5232,10,13590.0,10,13595.0,9,B
2018-04-13 09:21:10,13590.0,4,5236,4,13590.0,8,13595.0,23,S
2018-04-13 09:21:14,13585.0,8,5244,-8,13580.0,19,13595.0,25,S
2018-04-13 09:21:16,13585.0,4,5248,0,13585.0,1,13590.0,2,S
2018-04-13 09:21:23,13590.0,2,5250,0,13585.0,1,13590.0,1,B
2018-04-13 09:21:35,13590.0,2,5252,0,13585.0,16,13590.0,41,B
2018-04-13 09:21:36,13585.0,2,5254,2,13580.0,23,13585.0,1,S
2018-04-13 09:21:38,13585.0,2,5256,-2,13580.0,22,13590.0,40,S
2018-04-13 09:21:43,13585.0,6,5262,6,13585.0,7,13590.0,40,S
2018-04-13 09:21:44,13585.0,14,5276,10,13585.0,1,13590.0,40,S
2018-04-13 09:21:44,13585.0,2,5278,0,13580.0,22,13590.0,41,S
2018-04-13 09:21:59,13585.0,2,5280,-2,13585.0,1,13590.0,44,S
2018-04-13 09:22:04,13585.0,12,5292,8,13585.0,19,13590.0,36,S
2018-04-13 09:22:04,13590.0,12,5304,-12,13585.0,19,13590.0,30,B
2018-04-13 09:22:05,13590.0,14,5318,-2,13585.0,22,13590.0,23,B
2018-04-13 09:22:05,13595.0,62,5380,-46,13590.0,12,13600.0,27,B
2018-04-13 09:22:06,13595.0,2,5382,0,13590.0,3,13595.0,1,B
2018-04-13 09:22:11,13595.0,4,5386,0,13590.0,2,13595.0,3,B
2018-04-13 09:22:12,13595.0,4,5390,-4,13590.0,5,13595.0,2,B
2018-04-13 09:22:13,13590.0,2,5392,-2,13590.0,4,13595.0,2,S
2018-04-13 09:22:35,13590.0,2,5394,0,13590.0,2,13595.0,7,S
2018-04-13 09:22:41,13590.0,2,5396,0,13590.0,1,13595.0,7,S
2018-04-13 09:22:51,13595.0,2,5398,0,13590.0,2,13595.0,5,B
2018-04-13 09:23:22,13590.0,4,5402,4,13585.0,3,13595.0,14,S
2018-04-13 09:23:58,13590.0,2,5404,-2,13590.0,3,13595.0,2,S
2018-04-13 09:24:12,13595.0,2,5406,0,13595.0,2,13600.0,34,B
2018-04-13 09:24:17,13595.0,2,5408,2,13595.0,3,13600.0,17,B
2018-04-13 09:24:17,13595.0,4,5412,0,13590.0,23,13600.0,17,B
2018-04-13 09:24:38,13590.0,4,5416,4,13585.0,21,13595.0,4,S
2018-04-13 09:24:44,13590.0,2,5418,0,13590.0,2,13595.0,4,S
2018-04-13 09:24:55,13590.0,2,5420,0,13585.0,20,13590.0,1,S
2018-04-13 09:24:56,13590.0,2,5422,0,13585.0,20,13595.0,4,S
2018-04-13 09:25:13,13590.0,2,5424,2,13590.0,3,13595.0,20,S
2018-04-13 09:25:35,13590.0,4,5428,-4,13590.0,1,13595.0,21,S
2018-04-13 09:25:57,13585.0,4,5432,-2,13585.0,1,13590.0,3,S
2018-04-13 09:25:59,13585.0,2,5434,-2,13580.0,5,13585.0,2,S
2018-04-13 09:26:40,13585.0,6,5440,0,13580.0,3,13590.0,24,S
2018-04-13 09:26:43,13580.0,2,5442,0,13575.0,19,13585.0,7,S
2018-04-13 09:26:53,13580.0,4,5446,4,13575.0,24,13580.0,1,S
2018-04-13 09:26:53,13580.0,4,5450,-2,13575.0,24,13585.0,2,S
2018-04-13 09:27:06,13580.0,4,5454,2,13580.0,2,13585.0,3,S
2018-04-13 09:27:30,13580.0,4,5458,-4,13575.0,25,13580.0,1,S
2018-04-13 09:27:31,13580.0,2,5460,0,13575.0,25,13585.0,4,S
2018-04-13 09:27:38,13585.0,2,5462,2,13580.0,37,13585.0,2,B
2018-04-13 09:27:39,13585.0,2,5464,2,13580.0,37,13590.0,9,B
2018-04-13 09:27:57,13580.0,2,5466,0,13575.0,25,13585.0,6,S
2018-04-13 09:28:03,13580.0,2,5468,2,13575.0,5,13585.0,26,S
2018-04-13 09:28:06,13580.0,2,5470,0,13575.0,5,13580.0,9,S
2018-04-13 09:28:09,13575.0,2,5472,0,13575.0,4,13580.0,8,S
2018-04-13 09:28:17,13575.0,8,5480,4,13570.0,6,13580.0,10,S
2018-04-13 09:28:22,13575.0,2,5482,2,13570.0,8,13580.0,6,S
2018-04-13 09:28:26,13575.0,6,5488,6,13570.0,7,13580.0,11,S
2018-04-13 09:28:44,13575.0,2,5490,0,13570.0,8,13575.0,4,S
2018-04-13 09:28:45,13575.0,2,5492,0,13570.0,8,13575.0,3,S
2018-04-13 09:28:45,13575.0,2,5494,0,13570.0,7,13575.0,2,S
2018-04-13 09:28:46,13575.0,2,5496,2,13570.0,7,13575.0,1,S
2018-04-13 09:28:46,13575.0,2,5498,2,13570.0,7,13580.0,9,S
2018-04-13 09:29:20,13575.0,2,5500,0,13575.0,2,13580.0,8,S
2018-04-13 09:29:22,13580.0,12,5512,-8,13580.0,8,13585.0,5,B
2018-04-13 09:29:23,13585.0,2,5514,0,13580.0,28,13585.0,3,B
2018-04-13 09:29:23,13585.0,4,5518,-2,13580.0,29,13585.0,1,B
2018-04-13 09:29:24,13585.0,2,5520,-2,13580.0,29,13590.0,8,B
2018-04-13 09:29:31,13585.0,2,5522,2,13580.0,15,13590.0,15,B
2018-04-13 09:29:46,13585.0,4,5526,2,13585.0,1,13590.0,17,B
2018-04-13 09:30:01,13590.0,4,5530,-4,13585.0,4,13590.0,6,B
2018-04-13 09:30:06,13590.0,8,5538,-4,13590.0,1,13595.0,26,B
2018-04-13 09:30:18,13595.0,2,5540,-2,13590.0,16,13595.0,14,B
2018-04-13 09:30:19,13595.0,2,5542,0,13590.0,10,13595.0,13,B
2018-04-13 09:30:19,13595.0,2,5544,0,13590.0,10,13595.0,12,B
2018-04-13 09:30:21,13595.0,2,5546,0,13590.0,7,13595.0,11,B
2018-04-13 09:30:21,13595.0,2,5548,0,13590.0,8,13595.0,10,B
2018-04-13 09:30:22,13595.0,2,5550,0,13590.0,8,13595.0,9,B
2018-04-13 09:30:22,13595.0,2,5552,0,13590.0,8,13595.0,8,B
2018-04-13 09:30:23,13595.0,2,5554,0,13590.0,8,13595.0,7,B
2018-04-13 09:30:23,13595.0,2,5556,0,13590.0,8,13595.0,6,B
2018-04-13 09:30:24,13595.0,2,5558,0,13590.0,8,13595.0,5,B
2018-04-13 09:30:24,13595.0,2,5560,0,13590.0,8,13595.0,4,B
2018-04-13 09:30:25,13595.0,2,5562,0,13590.0,8,13595.0,5,B
2018-04-13 09:30:25,13595.0,2,5564,0,13590.0,8,13595.0,4,B
2018-04-13 09:30:26,13595.0,2,5566,0,13590.0,8,13595.0,3,B
2018-04-13 09:30:26,13595.0,2,5568,0,13590.0,8,13595.0,2,B
2018-04-13 09:30:27,13595.0,2,5570,2,13590.0,8,13595.0,1,B
2018-04-13 09:30:27,13595.0,2,5572,2,13590.0,8,13600.0,21,B
2018-04-13 09:30:35,13600.0,2,5574,0,13595.0,1,13600.0,20,B
2018-04-13 09:30:36,13600.0,2,5576,0,13595.0,3,13600.0,17,B
2018-04-13 09:30:39,13600.0,8,5584,8,13595.0,21,13600.0,11,B
2018-04-13 09:30:39,13600.0,22,5606,10,13600.0,15,13605.0,2,B
2018-04-13 09:30:40,13610.0,4,5610,0,13600.0,22,13610.0,22,B
2018-04-13 09:30:40,13610.0,2,5612,2,13605.0,8,13610.0,19,B
2018-04-13 09:30:41,13600.0,8,5620,2,13600.0,20,13605.0,1,S
2018-04-13 09:30:41,13610.0,14,5634,10,13600.0,19,13610.0,13,B
2018-04-13 09:30:44,13610.0,2,5636,0,13600.0,9,13605.0,1,B
2018-04-13 09:30:45,13605.0,2,5638,0,13600.0,13,13610.0,13,S
2018-04-13 09:30:48,13605.0,2,5640,0,13600.0,13,13610.0,15,S
2018-04-13 09:30:49,13610.0,2,5642,0,13600.0,12,13610.0,14,B
2018-04-13 09:30:51,13600.0,2,5644,2,13600.0,8,13605.0,4,S
2018-04-13 09:30:52,13605.0,6,5650,0,13605.0,3,13610.0,14,B
2018-04-13 09:30:53,13605.0,6,5656,0,13600.0,10,13605.0,3,B
2018-04-13 09:30:54,13605.0,2,5658,0,13600.0,12,13605.0,2,B
2018-04-13 09:30:55,13605.0,2,5660,0,13600.0,12,13610.0,14,B
2018-04-13 09:30:56,13610.0,2,5662,0,13600.0,12,13610.0,13,B
2018-04-13 09:31:01,13610.0,2,5664,0,13600.0,12,13610.0,10,B
2018-04-13 09:31:06,13605.0,6,5670,4,13605.0,1,13610.0,17,S
2018-04-13 09:31:07,13605.0,2,5672,0,13600.0,12,13610.0,17,S
2018-04-13 09:31:13,13600.0,22,5694,6,13595.0,5,13600.0,1,S
2018-04-13 09:31:21,13595.0,2,5696,0,13590.0,3,13595.0,2,S
2018-04-13 09:31:26,13590.0,4,5700,0,13585.0,5,13595.0,4,S
2018-04-13 09:31:34,13595.0,10,5710,2,13585.0,7,13600.0,15,B
2018-04-13 09:31:59,13590.0,6,5716,-6,13585.0,4,13590.0,1,S
2018-04-13 09:32:01,13590.0,2,5718,2,13590.0,2,13595.0,8,S
2018-04-13 09:32:18,13590.0,2,5720,2,13590.0,1,13595.0,2,S
2018-04-13 09:32:18,13590.0,2,5722,-2,13585.0,6,13590.0,1,S
2018-04-13 09:32:51,13590.0,6,5728,2,13585.0,14,13590.0,2,S
2018-04-13 09:32:51,13590.0,4,5732,0,13590.0,2,13595.0,1,S
2018-04-13 09:32:53,13595.0,2,5734,2,13590.0,1,13595.0,1,B
2018-04-13 09:32:54,13595.0,2,5736,2,13590.0,1,13600.0,23,B
2018-04-13 09:33:02,13600.0,2,5738,0,13595.0,1,13605.0,15,B
2018-04-13 09:33:08,13600.0,2,5740,2,13595.0,8,13600.0,9,B
2018-04-13 09:33:09,13600.0,2,5742,2,13595.0,8,13600.0,8,B
2018-04-13 09:33:09,13600.0,2,5744,2,13595.0,8,13600.0,7,B
2018-04-13 09:33:16,13600.0,2,5746,2,13595.0,11,13600.0,6,B
2018-04-13 09:33:16,13600.0,2,5748,2,13595.0,11,13600.0,5,B
2018-04-13 09:33:17,13600.0,2,5750,2,13595.0,11,13600.0,4,B
2018-04-13 09:33:17,13600.0,2,5752,2,13595.0,11,13600.0,3,B
2018-04-13 09:33:18,13600.0,2,5754,2,13595.0,11,13600.0,2,B
2018-04-13 09:33:18,13600.0,2,5756,2,13595.0,10,13600.0,1,B
2018-04-13 09:33:19,13600.0,2,5758,2,13595.0,10,13605.0,7,B
2018-04-13 09:33:28,13600.0,2,5760,2,13595.0,8,13605.0,5,B
2018-04-13 09:33:29,13600.0,4,5764,4,13595.0,8,13600.0,13,B
2018-04-13 09:33:29,13600.0,2,5766,2,13595.0,8,13600.0,12,B
2018-04-13 09:33:30,13600.0,24,5790,10,13595.0,8,13605.0,6,B
2018-04-13 09:33:36,13605.0,2,5792,2,13600.0,11,13605.0,2,B
2018-04-13 09:33:37,13605.0,2,5794,2,13600.0,8,13605.0,2,B
2018-04-13 09:33:42,13605.0,2,5796,2,13600.0,1,13605.0,2,B
2018-04-13 09:33:48,13605.0,6,5802,0,13605.0,1,13610.0,12,B
2018-04-13 09:33:48,13605.0,2,5804,0,13600.0,4,13605.0,1,B
2018-04-13 09:34:02,13605.0,2,5806,2,13600.0,9,13610.0,13,B
2018-04-13 09:34:16,13605.0,2,5808,0,13600.0,3,13605.0,6,B
2018-04-13 09:34:17,13605.0,6,5814,4,13600.0,3,13605.0,3,B
2018-04-13 09:34:40,13600.0,4,5818,2,13595.0,2,13600.0,2,S
2018-04-13 09:35:08,13605.0,2,5820,0,13600.0,5,13610.0,14,B
2018-04-13 09:35:44,13605.0,2,5822,0,13605.0,3,13610.0,9,B
2018-04-13 09:35:52,13610.0,2,5824,0,13605.0,3,13610.0,6,B
2018-04-13 09:35:56,13610.0,2,5826,-2,13605.0,16,13610.0,7,B
2018-04-13 09:36:03,13610.0,2,5828,0,13605.0,13,13610.0,6,B
2018-04-13 09:36:03,13610.0,4,5832,-4,13605.0,13,13610.0,4,B
2018-04-13 09:36:04,13610.0,2,5834,2,13605.0,2,13610.0,5,B
2018-04-13 09:36:05,13605.0,4,5838,0,13600.0,15,13610.0,7,S
2018-04-13 09:36:05,13600.0,16,5854,-2,13595.0,5,13605.0,4,S
2018-04-13 09:36:18,13605.0,2,5856,0,13600.0,13,13605.0,2,B
2018-04-13 09:36:22,13605.0,2,5858,2,13605.0,1,13610.0,3,B
2018-04-13 09:36:58,13605.0,2,5860,0,13600.0,23,13605.0,2,B
2018-04-13 09:36:58,13605.0,2,5862,0,13600.0,23,13605.0,1,B
2018-04-13 09:36:59,13605.0,2,5864,2,13600.0,23,13610.0,14,B
2018-04-13 09:37:04,13600.0,4,5868,0,13600.0,21,13610.0,11,S
2018-04-13 09:37:09,13600.0,2,5870,0,13600.0,2,13605.0,1,S
2018-04-13 09:37:11,13600.0,2,5872,-2,13600.0,2,13605.0,5,S
2018-04-13 09:37:16,13605.0,2,5874,-2,13600.0,2,13605.0,4,B
2018-04-13 09:37:45,13605.0,2,5876,2,13600.0,6,13605.0,3,B
2018-04-13 09:37:46,13605.0,2,5878,0,13600.0,12,13605.0,2,B
2018-04-13 09:37:46,13605.0,2,5880,0,13600.0,6,13605.0,1,B
2018-04-13 09:37:47,13605.0,2,5882,0,13600.0,6,13610.0,14,B
2018-04-13 09:37:53,13605.0,2,5884,2,13600.0,6,13610.0,14,B
2018-04-13 09:38:06,13610.0,2,5886,2,13605.0,24,13610.0,6,B
2018-04-13 09:38:06,13610.0,2,5888,2,13605.0,23,13610.0,5,B
2018-04-13 09:38:07,13610.0,6,5894,0,13605.0,23,13610.0,2,B
2018-04-13 09:38:07,13610.0,4,5898,0,13610.0,1,13615.0,8,B
2018-04-13 09:38:12,13610.0,2,5900,0,13605.0,18,13615.0,7,B
2018-04-13 09:38:19,13615.0,2,5902,2,13610.0,6,13615.0,2,B
2018-04-13 09:38:20,13615.0,2,5904,0,13610.0,8,13615.0,1,B
2018-04-13 09:38:20,13615.0,2,5906,2,13615.0,1,13620.0,22,B
2018-04-13 09:38:26,13615.0,2,5908,0,13610.0,3,13615.0,2,B
2018-04-13 09:38:27,13615.0,2,5910,2,13610.0,1,13615.0,1,B
2018-04-13 09:38:29,13610.0,2,5912,2,13605.0,11,13610.0,4,S
2018-04-13 09:38:30,13610.0,4,5916,2,13605.0,13,13610.0,2,S
2018-04-13 09:38:42,13610.0,4,5920,4,13610.0,1,13615.0,4,S
2018-04-13 09:38:43,13610.0,2,5922,0,13605.0,13,13615.0,4,S
2018-04-13 09:38:58,13605.0,2,5924,0,13605.0,15,13615.0,6,S
2018-04-13 09:39:00,13610.0,2,5926,0,13605.0,15,13610.0,1,B
2018-04-13 09:39:00,13610.0,2,5928,0,13605.0,15,13615.0,6,B
2018-04-13 09:39:02,13610.0,2,5930,-2,13610.0,12,13615.0,3,B
2018-04-13 09:39:03,13615.0,2,5932,0,13610.0,18,13615.0,1,B
2018-04-13 09:39:11,13615.0,2,5934,0,13610.0,17,13620.0,22,B
2018-04-13 09:39:13,13620.0,2,5936,2,13615.0,5,13620.0,16,B
2018-04-13 09:39:14,13620.0,6,5942,2,13615.0,10,13620.0,13,B
2018-04-13 09:39:14,13620.0,6,5948,6,13615.0,10,13620.0,10,B
2018-04-13 09:39:15,13620.0,2,5950,2,13615.0,10,13620.0,9,B
2018-04-13 09:39:15,13620.0,2,5952,2,13615.0,15,13620.0,8,B
2018-04-13 09:39:16,13620.0,2,5954,2,13615.0,15,13620.0,7,B
2018-04-13 09:39:16,13620.0,14,5968,4,13620.0,8,13625.0,6,B
2018-04-13 09:39:17,13620.0,2,5970,2,13620.0,3,13625.0,7,B
2018-04-13 09:39:18,13620.0,2,5972,0,13615.0,7,13625.0,6,B
2018-04-13 09:39:21,13620.0,2,5974,0,13615.0,9,13625.0,7,B
2018-04-13 09:39:25,13620.0,2,5976,0,13615.0,11,13620.0,2,B
2018-04-13 09:39:26,13620.0,2,5978,0,13615.0,13,13620.0,1,B
2018-04-13 09:39:27,13620.0,2,5980,0,13615.0,6,13625.0,11,B
2018-04-13 09:39:29,13620.0,2,5982,2,13615.0,4,13620.0,7,B
2018-04-13 09:39:30,13620.0,2,5984,2,13615.0,9,13625.0,6,B
2018-04-13 09:39:44,13625.0,2,5986,0,13620.0,18,13625.0,2,B
2018-04-13 09:39:45,13625.0,4,5990,2,13625.0,2,13630.0,32,B
2018-04-13 09:39:45,13625.0,4,5994,-2,13620.0,15,13630.0,30,B
2018-04-13 09:39:47,13630.0,2,5996,2,13625.0,21,13630.0,25,B
2018-04-13 09:39:47,13630.0,2,5998,2,13625.0,21,13630.0,24,B
2018-04-13 09:39:48,13630.0,24,6022,22,13625.0,21,13630.0,12,B
2018-04-13 09:39:48,13625.0,4,6026,-2,13625.0,20,13630.0,11,S
2018-04-13 09:39:49,13630.0,22,6048,16,13630.0,9,13635.0,7,B
2018-04-13 09:39:50,13630.0,2,6050,2,13630.0,10,13635.0,6,B
2018-04-13 09:39:51,13630.0,2,6052,0,13630.0,3,13635.0,8,B
2018-04-13 09:39:51,13635.0,2,6054,-2,13630.0,3,13635.0,7,B
2018-04-13 09:39:52,13635.0,4,6058,-2,13630.0,1,13635.0,5,B
2018-04-13 09:39:53,13630.0,4,6062,4,13630.0,6,13635.0,4,S
2018-04-13 09:39:59,13630.0,2,6064,2,13630.0,2,13635.0,4,S
2018-04-13 09:40:00,13630.0,4,6068,0,13625.0,12,13635.0,7,S
2018-04-13 09:40:01,13635.0,2,6070,2,13630.0,10,13635.0,9,B
2018-04-13 09:40:01,13635.0,2,6072,2,13630.0,12,13635.0,3,B
2018-04-13 09:40:02,13635.0,2,6074,2,13630.0,12,13635.0,2,B
2018-04-13 09:40:02,13635.0,4,6078,4,13635.0,5,13640.0,22,B
2018-04-13 09:40:03,13640.0,2,6080,0,13635.0,14,13640.0,15,B
2018-04-13 09:40:04,13640.0,30,6110,16,13640.0,9,13650.0,52,B
2018-04-13 09:40:05,13650.0,32,6142,18,13645.0,4,13650.0,41,B
2018-04-13 09:40:05,13640.0,16,6158,2,13640.0,16,13645.0,6,S
2018-04-13 09:40:06,13645.0,18,6176,-2,13635.0,7,13640.0,5,B
2018-04-13 09:40:07,13640.0,2,6178,0,13635.0,6,13640.0,1,S
2018-04-13 09:40:07,13640.0,2,6180,0,13635.0,6,13645.0,15,S
2018-04-13 09:40:08,13640.0,2,6182,2,13635.0,4,13640.0,3,S
2018-04-13 09:40:09,13640.0,2,6184,0,13635.0,4,13640.0,2,S
2018-04-13 09:40:09,13640.0,2,6186,0,13635.0,1,13640.0,1,S
2018-04-13 09:40:10,13640.0,2,6188,0,13635.0,1,13645.0,18,S
2018-04-13 09:40:12,13640.0,4,6192,0,13640.0,6,13645.0,6,S
2018-04-13 09:40:12,13645.0,2,6194,0,13640.0,6,13645.0,5,B
2018-04-13 09:40:13,13645.0,2,6196,0,13640.0,6,13645.0,4,B
2018-04-13 09:40:13,13645.0,2,6198,0,13640.0,6,13645.0,3,B
2018-04-13 09:40:14,13645.0,6,6204,-2,13645.0,1,13650.0,45,B
2018-04-13 09:40:14,13645.0,4,6208,0,13640.0,12,13645.0,3,B
2018-04-13 09:40:15,13645.0,2,6210,2,13640.0,11,13650.0,42,B
2018-04-13 09:40:15,13650.0,2,6212,2,13640.0,11,13650.0,42,B
2018-04-13 09:40:16,13645.0,4,6216,-2,13640.0,2,13645.0,4,S
2018-04-13 09:40:16,13640.0,4,6220,0,13635.0,3,13645.0,5,S
2018-04-13 09:40:17,13645.0,2,6222,0,13635.0,4,13645.0,5,B
2018-04-13 09:40:18,13645.0,2,6224,0,13635.0,4,13645.0,4,B
2018-04-13 09:40:20,13640.0,2,6226,2,13635.0,3,13645.0,11,S
2018-04-13 09:40:21,13645.0,2,6228,0,13640.0,2,13645.0,2,B
2018-04-13 09:40:22,13645.0,2,6230,2,13640.0,2,13645.0,1,B
2018-04-13 09:40:22,13645.0,2,6232,0,13640.0,2,13650.0,48,B
2018-04-13 09:40:23,13640.0,4,6236,0,13635.0,4,13645.0,5,S
2018-04-13 09:40:25,13645.0,2,6238,0,13635.0,30,13640.0,1,B
2018-04-13 09:40:26,13640.0,2,6240,2,13635.0,30,13645.0,6,S
2018-04-13 09:40:29,13640.0,2,6242,2,13635.0,5,13640.0,9,S
2018-04-13 09:40:29,13640.0,2,6244,2,13635.0,5,13640.0,8,S
2018-04-13 09:40:30,13640.0,2,6246,2,13635.0,5,13640.0,7,S
2018-04-13 09:40:30,13640.0,2,6248,2,13635.0,5,13640.0,6,S
2018-04-13 09:40:31,13640.0,2,6250,2,13635.0,5,13640.0,5,S
2018-04-13 09:40:31,13640.0,2,6252,2,13635.0,5,13640.0,4,S
2018-04-13 09:40:32,13640.0,10,6262,10,13630.0,5,13640.0,3,S
2018-04-13 09:40:34,13630.0,2,6264,0,13625.0,3,13635.0,12,S
2018-04-13 09:40:34,13635.0,2,6266,0,13625.0,2,13635.0,11,B
2018-04-13 09:40:35,13635.0,2,6268,2,13625.0,3,13635.0,8,B
2018-04-13 09:40:36,13635.0,2,6270,0,13625.0,3,13635.0,7,B
2018-04-13 09:40:36,13635.0,2,6272,2,13625.0,3,13635.0,6,B
2018-04-13 09:40:41,13630.0,2,6274,2,13625.0,2,13630.0,10,S
2018-04-13 09:40:41,13625.0,2,6276,0,13625.0,1,13630.0,10,S
2018-04-13 09:40:42,13630.0,2,6278,2,13620.0,4,13630.0,2,B
2018-04-13 09:40:43,13630.0,2,6280,2,13625.0,1,13635.0,13,B
2018-04-13 09:40:44,13630.0,4,6284,-4,13630.0,1,13635.0,15,B
2018-04-13 09:40:45,13630.0,2,6286,2,13625.0,3,13635.0,11,B
2018-04-13 09:40:55,13630.0,2,6288,2,13630.0,1,13635.0,11,B
2018-04-13 09:40:55,13630.0,2,6290,2,13625.0,4,13635.0,11,B
2018-04-13 09:41:01,13630.0,2,6292,0,13625.0,4,13635.0,12,B
2018-04-13 09:41:03,13635.0,2,6294,2,13625.0,18,13635.0,4,B
2018-04-13 09:41:07,13635.0,2,6296,2,13625.0,3,13630.0,1,B
2018-04-13 09:41:12,13625.0,2,6298,0,13625.0,1,13630.0,9,S
2018-04-13 09:41:13,13625.0,2,6300,0,13620.0,5,13630.0,12,S
2018-04-13 09:41:14,13630.0,2,6302,0,13625.0,1,13630.0,4,B
2018-04-13 09:41:14,13630.0,2,6304,0,13625.0,1,13630.0,3,B
2018-04-13 09:41:15,13630.0,2,6306,0,13625.0,1,13630.0,2,B
2018-04-13 09:41:15,13630.0,2,6308,0,13625.0,1,13630.0,1,B
2018-04-13 09:41:16,13630.0,2,6310,0,13620.0,21,13635.0,11,B
2018-04-13 09:41:19,13625.0,2,6312,-2,13625.0,2,13630.0,7,S
2018-04-13 09:41:21,13625.0,2,6314,2,13620.0,4,13630.0,8,S
2018-04-13 09:41:23,13620.0,2,6316,0,13620.0,4,13630.0,10,S
2018-04-13 09:41:24,13620.0,2,6318,2,13620.0,2,13625.0,7,S
2018-04-13 09:41:24,13620.0,4,6322,-2,13615.0,3,13625.0,8,S
2018-04-13 09:41:26,13620.0,2,6324,2,13615.0,3,13620.0,2,S
2018-04-13 09:41:28,13620.0,2,6326,0,13615.0,3,13620.0,1,S
2018-04-13 09:41:29,13620.0,2,6328,2,13615.0,2,13620.0,13,S
2018-04-13 09:41:30,13620.0,2,6330,0,13615.0,3,13625.0,11,S
2018-04-13 09:41:34,13620.0,2,6332,0,13615.0,3,13620.0,1,S
2018-04-13 09:41:34,13620.0,2,6334,2,13615.0,3,13625.0,11,S
2018-04-13 09:41:35,13620.0,2,6336,0,13615.0,1,13620.0,6,S
2018-04-13 09:41:38,13615.0,6,6342,-4,13610.0,3,13620.0,9,S
2018-04-13 09:41:42,13610.0,2,6344,0,13610.0,1,13615.0,1,S
2018-04-13 09:41:54,13615.0,4,6348,4,13610.0,5,13620.0,9,B
2018-04-13 09:41:57,13615.0,2,6350,0,13615.0,3,13620.0,5,B
2018-04-13 09:41:57,13620.0,10,6360,2,13620.0,14,13625.0,9,B
2018-04-13 09:41:58,13625.0,4,6364,-4,13620.0,14,13625.0,1,B
2018-04-13 09:42:02,13625.0,4,6368,2,13625.0,8,13630.0,10,B
2018-04-13 09:42:03,13630.0,2,6370,-2,13625.0,11,13635.0,7,B
2018-04-13 09:42:08,13630.0,16,6386,0,13630.0,29,13635.0,7,B
2018-04-13 09:42:11,13630.0,26,6412,6,13630.0,2,13635.0,20,B
2018-04-13 09:42:11,13630.0,4,6416,4,13625.0,2,13630.0,2,B
2018-04-13 09:42:13,13625.0,4,6420,2,13625.0,2,13630.0,5,S
2018-04-13 09:42:18,13630.0,2,6422,0,13630.0,5,13635.0,15,B
2018-04-13 09:42:22,13630.0,4,6426,-4,13630.0,2,13635.0,2,B
2018-04-13 09:42:41,13630.0,2,6428,2,13630.0,12,13635.0,7,B
2018-04-13 09:43:01,13630.0,2,6430,2,13630.0,11,13635.0,14,B
2018-04-13 09:43:10,13635.0,2,6432,-2,13630.0,13,13640.0,10,B
2018-04-13 09:43:20,13630.0,2,6434,2,13630.0,10,13640.0,17,S
2018-04-13 09:43:22,13630.0,4,6438,4,13630.0,8,13635.0,15,S
2018-04-13 09:43:32,13630.0,16,6454,16,13625.0,5,13635.0,12,S
2018-04-13 09:43:34,13625.0,2,6456,0,13620.0,8,13630.0,16,S
2018-04-13 09:43:35,13630.0,2,6458,2,13620.0,8,13630.0,18,B
2018-04-13 09:43:39,13620.0,6,6464,0,13620.0,5,13630.0,21,S
2018-04-13 09:43:43,13620.0,2,6466,0,13620.0,4,13625.0,12,S
2018-04-13 09:43:43,13620.0,8,6474,-2,13615.0,5,13625.0,12,S
2018-04-13 09:43:46,13615.0,2,6476,0,13615.0,3,13620.0,1,S
2018-04-13 09:43:47,13615.0,2,6478,0,13615.0,2,13620.0,2,S
2018-04-13 09:43:47,13615.0,4,6482,-4,13610.0,4,13620.0,8,S
2018-04-13 09:44:01,13620.0,4,6486,-2,13615.0,3,13625.0,16,B
2018-04-13 09:44:07,13620.0,2,6488,-2,13615.0,6,13625.0,17,B
2018-04-13 09:44:14,13625.0,8,6496,2,13620.0,13,13625.0,1,B
2018-04-13 09:44:14,13625.0,2,6498,0,13620.0,19,13630.0,9,B
2018-04-13 09:45:10,13625.0,2,6500,0,13625.0,1,13630.0,13,B
2018-04-13 09:45:10,13630.0,4,6504,2,13625.0,3,13630.0,6,B
2018-04-13 09:45:16,13625.0,2,6506,-2,13620.0,9,13625.0,1,S
2018-04-13 09:45:17,13620.0,10,6516,4,13620.0,2,13625.0,6,S
2018-04-13 09:45:18,13620.0,4,6520,0,13615.0,6,13625.0,14,S
2018-04-13 09:45:24,13620.0,4,6524,-4,13615.0,8,13625.0,14,S
2018-04-13 09:45:39,13615.0,4,6528,-4,13610.0,4,13620.0,14,S
2018-04-13 09:45:48,13615.0,2,6530,-2,13610.0,22,13620.0,13,S
2018-04-13 09:46:10,13610.0,10,6540,6,13610.0,1,13615.0,3,S
2018-04-13 09:46:11,13610.0,2,6542,2,13605.0,1,13610.0,2,S
2018-04-13 09:46:13,13610.0,4,6546,4,13605.0,1,13610.0,2,S
2018-04-13 09:46:17,13605.0,4,6550,2,13600.0,19,13610.0,3,S
2018-04-13 09:46:19,13610.0,2,6552,0,13605.0,1,13610.0,2,B
2018-04-13 09:46:21,13610.0,2,6554,2,13610.0,11,13615.0,16,B
2018-04-13 09:46:22,13610.0,6,6560,4,13610.0,12,13615.0,14,B
2018-04-13 09:46:33,13615.0,4,6564,0,13610.0,7,13615.0,13,B
2018-04-13 09:46:36,13610.0,4,6568,4,13610.0,5,13615.0,14,S
2018-04-13 09:46:37,13610.0,2,6570,0,13610.0,4,13615.0,14,S
2018-04-13 09:46:46,13610.0,4,6574,4,13610.0,2,13615.0,12,S
2018-04-13 09:46:47,13610.0,2,6576,2,13610.0,1,13615.0,12,S
2018-04-13 09:46:50,13615.0,2,6578,-2,13610.0,1,13615.0,11,B
2018-04-13 09:46:53,13610.0,2,6580,2,13605.0,5,13610.0,1,S
2018-04-13 09:46:54,13605.0,6,6586,-2,13600.0,18,13610.0,9,S
2018-04-13 09:46:55,13600.0,2,6588,0,13600.0,3,13605.0,1,S
2018-04-13 09:47:00,13600.0,2,6590,-2,13595.0,3,13600.0,2,S
2018-04-13 09:47:03,13600.0,2,6592,0,13595.0,4,13600.0,1,S
2018-04-13 09:47:03,13595.0,14,6606,-6,13600.0,9,13605.0,4,S
2018-04-13 09:47:06,13600.0,10,6616,10,13595.0,1,13600.0,2,B
2018-04-13 09:47:30,13600.0,6,6622,4,13600.0,15,13605.0,4,B
2018-04-13 09:47:31,13605.0,4,6626,-2,13600.0,33,13610.0,14,B
2018-04-13 09:47:44,13605.0,2,6628,2,13605.0,4,13610.0,3,B
2018-04-13 09:47:47,13610.0,2,6630,2,13605.0,4,13610.0,1,B
2018-04-13 09:48:01,13605.0,2,6632,0,13605.0,3,13610.0,15,S
2018-04-13 09:48:18,13605.0,2,6634,0,13605.0,1,13610.0,15,S
2018-04-13 09:48:25,13605.0,2,6636,2,13600.0,19,13610.0,17,S
2018-04-13 09:48:27,13605.0,2,6638,0,13600.0,19,13610.0,17,S
2018-04-13 09:48:47,13605.0,6,6644,4,13605.0,3,13610.0,12,S
2018-04-13 09:48:50,13605.0,2,6646,0,13605.0,6,13610.0,9,S
2018-04-13 09:48:51,13610.0,2,6648,-2,13605.0,6,13610.0,8,B
2018-04-13 09:48:57,13610.0,4,6652,-4,13605.0,6,13610.0,2,B
2018-04-13 09:49:16,13605.0,2,6654,2,13605.0,2,13610.0,8,S
2018-04-13 09:49:21,13605.0,2,6656,0,13605.0,7,13610.0,4,S
2018-04-13 09:49:26,13605.0,10,6666,6,13605.0,2,13610.0,1,S
2018-04-13 09:49:38,13605.0,6,6672,2,13600.0,27,13605.0,7,S
2018-04-13 09:49:38,13605.0,14,6686,8,13605.0,4,13610.0,2,S
2018-04-13 09:49:44,13605.0,8,6694,8,13600.0,28,13605.0,1,S
2018-04-13 09:49:45,13605.0,2,6696,2,13600.0,12,13610.0,10,S
2018-04-13 09:50:04,13600.0,2,6698,2,13600.0,7,13605.0,11,S
2018-04-13 09:50:05,13605.0,22,6720,22,13600.0,21,13610.0,13,B
2018-04-13 09:50:10,13605.0,2,6722,2,13600.0,21,13605.0,9,B
2018-04-13 09:50:10,13605.0,2,6724,2,13600.0,21,13605.0,8,B
2018-04-13 09:50:11,13605.0,2,6726,2,13600.0,21,13605.0,7,B
2018-04-13 09:50:12,13605.0,4,6730,4,13600.0,21,13605.0,5,B
2018-04-13 09:50:12,13605.0,2,6732,2,13600.0,7,13605.0,4,B
2018-04-13 09:50:21,13605.0,2,6734,2,13600.0,7,13605.0,3,B
2018-04-13 09:50:21,13605.0,6,6740,6,13605.0,1,13610.0,31,B
2018-04-13 09:50:26,13605.0,2,6742,2,13600.0,9,13605.0,4,B
2018-04-13 09:50:38,13600.0,2,6744,2,13600.0,7,13605.0,14,S
2018-04-13 09:50:38,13605.0,2,6746,0,13600.0,7,13605.0,13,B
2018-04-13 09:51:09,13600.0,2,6748,2,13600.0,7,13605.0,15,S
2018-04-13 09:51:53,13600.0,2,6750,2,13600.0,6,13605.0,13,S
2018-04-13 09:52:00,13595.0,20,6770,10,13595.0,15,13600.0,11,S
2018-04-13 09:52:01,13600.0,28,6798,28,13600.0,7,13605.0,5,B
2018-04-13 09:52:16,13600.0,4,6802,0,13600.0,16,13605.0,15,B
2018-04-13 09:52:25,13600.0,2,6804,0,13600.0,15,13605.0,15,B
2018-04-13 09:52:29,13600.0,2,6806,2,13600.0,14,13605.0,15,B
2018-04-13 09:52:29,13600.0,6,6812,0,13600.0,11,13605.0,15,B
2018-04-13 09:52:51,13600.0,2,6814,2,13600.0,10,13605.0,15,B
2018-04-13 09:52:51,13600.0,6,6820,0,13600.0,7,13605.0,15,B
2018-04-13 09:52:52,13600.0,14,6834,14,13595.0,2,13600.0,1,B
2018-04-13 09:52:52,13595.0,2,6836,0,13590.0,10,13595.0,4,S
2018-04-13 09:52:53,13590.0,8,6844,0,13590.0,6,13600.0,26,S
2018-04-13 09:53:23,13600.0,14,6858,-6,13595.0,2,13600.0,4,B
2018-04-13 09:53:36,13600.0,6,6864,-2,13595.0,5,13605.0,15,B
2018-04-13 09:53:47,13605.0,2,6866,2,13600.0,1,13605.0,3,B
2018-04-13 09:53:47,13605.0,2,6868,2,13600.0,1,13605.0,2,B
2018-04-13 09:54:11,13605.0,2,6870,0,13600.0,2,13605.0,2,B
2018-04-13 09:54:40,13605.0,2,6872,0,13600.0,2,13605.0,1,B
2018-04-13 09:55:22,13605.0,2,6874,-2,13600.0,5,13605.0,2,B
2018-04-13 09:56:29,13600.0,2,6876,2,13600.0,5,13605.0,2,S
2018-04-13 09:56:45,13610.0,10,6886,4,13600.0,3,13610.0,35,B
2018-04-13 09:56:55,13605.0,2,6888,0,13605.0,2,13610.0,33,S
2018-04-13 09:56:58,13605.0,6,6894,-4,13600.0,33,13605.0,2,S
2018-04-13 09:56:59,13605.0,4,6898,0,13605.0,1,13610.0,33,S
2018-04-13 09:57:49,13605.0,2,6900,0,13600.0,8,13610.0,36,S
2018-04-13 09:58:08,13600.0,2,6902,0,13595.0,6,13605.0,14,S
2018-04-13 09:58:23,13595.0,2,6904,0,13590.0,6,13600.0,16,S
2018-04-13 09:59:10,13590.0,8,6912,0,13585.0,30,13595.0,7,S
2018-04-13 09:59:20,13595.0,10,6922,0,13590.0,7,13595.0,2,B
2018-04-13 09:59:21,13595.0,2,6924,2,13595.0,3,13600.0,10,B
2018-04-13 10:00:02,13600.0,4,6928,-2,13600.0,1,13605.0,9,B
2018-04-13 10:00:03,13605.0,4,6932,2,13600.0,19,13610.0,33,B
2018-04-13 10:00:06,13605.0,2,6934,0,13605.0,3,13610.0,38,B
2018-04-13 10:00:13,13605.0,4,6938,-4,13600.0,12,13605.0,2,B
2018-04-13 10:00:14,13605.0,4,6942,-4,13600.0,12,13610.0,38,B
2018-04-13 10:00:15,13600.0,2,6944,-2,13595.0,1,13605.0,9,S
2018-04-13 10:00:16,13600.0,2,6946,0,13595.0,1,13600.0,4,S
2018-04-13 10:00:16,13600.0,6,6952,0,13590.0,2,13600.0,1,S
2018-04-13 10:00:26,13600.0,2,6954,0,13595.0,7,13605.0,10,S
2018-04-13 10:00:29,13600.0,2,6956,0,13595.0,7,13605.0,8,S
2018-04-13 10:02:40,13600.0,2,6958,2,13595.0,4,13600.0,10,S
2018-04-13 10:02:49,13600.0,2,6960,2,13595.0,4,13600.0,9,S
2018-04-13 10:02:51,13595.0,2,6962,0,13595.0,3,13600.0,9,S
2018-04-13 10:03:16,13600.0,6,6968,-4,13595.0,4,13600.0,4,B
2018-04-13 10:03:16,13600.0,2,6970,-2,13595.0,7,13600.0,1,B
2018-04-13 10:03:25,13600.0,2,6972,0,13595.0,6,13605.0,7,B
2018-04-13 10:04:14,13600.0,2,6974,-2,13600.0,3,13605.0,8,B
2018-04-13 10:04:15,13600.0,2,6976,-2,13600.0,2,13605.0,7,B
2018-04-13 10:05:05,13605.0,4,6980,0,13605.0,6,13610.0,35,B
2018-04-13 10:05:30,13605.0,2,6982,0,13605.0,3,13610.0,35,B
2018-04-13 10:06:18,13610.0,64,7046,64,13610.0,74,13615.0,7,B
2018-04-13 10:06:18,13610.0,2,7048,2,13610.0,73,13615.0,15,B
2018-04-13 10:06:21,13610.0,4,7052,4,13610.0,71,13615.0,16,B
2018-04-13 10:06:23,13610.0,2,7054,0,13610.0,70,13615.0,16,B
2018-04-13 10:06:24,13610.0,2,7056,0,13610.0,69,13615.0,16,B
2018-04-13 10:06:37,13615.0,2,7058,0,13610.0,69,13615.0,15,B
2018-04-13 10:06:42,13615.0,2,7060,0,13610.0,69,13620.0,10,B
2018-04-13 10:06:44,13615.0,4,7064,-4,13610.0,69,13620.0,16,B
2018-04-13 10:06:44,13610.0,2,7066,0,13610.0,68,13620.0,16,S
2018-04-13 10:06:49,13615.0,2,7068,-2,13610.0,68,13615.0,1,B
2018-04-13 10:06:50,13615.0,2,7070,-2,13610.0,68,13620.0,14,B
2018-04-13 10:07:00,13615.0,2,7072,0,13610.0,68,13615.0,12,B
2018-04-13 10:07:09,13615.0,4,7076,-4,13610.0,68,13615.0,1,B
2018-04-13 10:07:09,13615.0,2,7078,-2,13610.0,68,13620.0,15,B
2018-04-13 10:07:12,13615.0,2,7080,0,13610.0,68,13615.0,1,B
2018-04-13 10:07:31,13610.0,20,7100,20,13610.0,58,13615.0,6,S
2018-04-13 10:07:32,13610.0,20,7120,20,13610.0,48,13615.0,6,S
2018-04-13 10:07:57,13610.0,28,7148,4,13610.0,34,13615.0,34,S
2018-04-13 10:07:57,13610.0,26,7174,22,13610.0,21,13615.0,37,S
2018-04-13 10:07:58,13610.0,8,7182,8,13610.0,17,13615.0,36,S
2018-04-13 10:07:58,13610.0,8,7190,2,13610.0,13,13615.0,34,S
2018-04-13 10:07:59,13610.0,4,7194,4,13610.0,11,13615.0,34,S
2018-04-13 10:08:00,13610.0,22,7216,22,13605.0,4,13615.0,34,S
2018-04-13 10:08:01,13605.0,2,7218,0,13605.0,1,13610.0,5,S
2018-04-13 10:08:02,13610.0,4,7222,0,13605.0,4,13610.0,3,B
2018-04-13 10:08:14,13605.0,2,7224,2,13605.0,3,13610.0,5,S
2018-04-13 10:08:15,13605.0,2,7226,2,13605.0,2,13610.0,4,S
2018-04-13 10:08:16,13605.0,4,7230,4,13600.0,5,13610.0,4,S
2018-04-13 10:08:17,13600.0,2,7232,-2,13600.0,4,13610.0,4,S
2018-04-13 10:08:47,13605.0,2,7234,0,13600.0,5,13605.0,6,B
2018-04-13 10:08:59,13600.0,2,7236,2,13600.0,4,13605.0,6,S
2018-04-13 10:09:12,13600.0,10,7246,8,13595.0,2,13600.0,5,S
2018-04-13 10:09:12,13600.0,4,7250,2,13595.0,8,13600.0,3,S
2018-04-13 10:09:13,13600.0,6,7256,6,13595.0,10,13605.0,7,S
2018-04-13 10:09:13,13605.0,2,7258,0,13600.0,1,13605.0,6,B
2018-04-13 10:09:39,13605.0,10,7268,0,13600.0,2,13610.0,8,B
2018-04-13 10:09:43,13605.0,4,7272,0,13605.0,2,13610.0,6,B
2018-04-13 10:09:49,13605.0,4,7276,0,13605.0,1,13610.0,6,B
2018-04-13 10:10:02,13610.0,2,7278,2,13605.0,2,13610.0,2,B
2018-04-13 10:10:38,13605.0,2,7280,-2,13605.0,1,13610.0,4,S
2018-04-13 10:10:39,13605.0,2,7282,0,13600.0,16,13610.0,4,S
2018-04-13 10:10:41,13605.0,2,7284,0,13600.0,2,13605.0,1,S
2018-04-13 10:11:06,13605.0,6,7290,-4,13605.0,7,13610.0,12,S
2018-04-13 10:11:08,13605.0,4,7294,-4,13605.0,5,13610.0,11,S
2018-04-13 10:11:09,13605.0,2,7296,0,13605.0,4,13610.0,11,S
2018-04-13 10:11:09,13605.0,6,7302,0,13605.0,1,13610.0,11,S
2018-04-13 10:11:10,13605.0,2,7304,0,13600.0,2,13610.0,11,S
2018-04-13 10:12:27,13605.0,10,7314,6,13600.0,2,13610.0,13,S
2018-04-13 10:13:01,13600.0,4,7318,-4,13600.0,1,13610.0,9,S
2018-04-13 10:13:07,13600.0,2,7320,2,13600.0,8,13610.0,5,S
2018-04-13 10:14:27,13595.0,6,7326,-4,13590.0,7,13600.0,4,S
2018-04-13 10:14:54,13590.0,2,7328,2,13590.0,3,13595.0,2,S
2018-04-13 10:30:10,13595.0,2,7330,0,13595.0,3,13600.0,4,B
2018-04-13 10:30:12,13600.0,4,7334,-4,13595.0,3,13600.0,2,B
2018-04-13 10:30:19,13600.0,2,7336,0,13595.0,3,13600.0,1,B
2018-04-13 10:30:39,13595.0,2,7338,0,13595.0,2,13600.0,1,S
2018-04-13 10:30:59,13600.0,2,7340,0,13600.0,2,13605.0,9,B
2018-04-13 10:31:09,13600.0,4,7344,0,13595.0,18,13605.0,7,B
2018-04-13 10:31:27,13595.0,2,7346,0,13595.0,1,13600.0,3,S
2018-04-13 10:31:41,13600.0,2,7348,2,13595.0,2,13600.0,2,B
2018-04-13 10:31:48,13595.0,2,7350,-2,13595.0,3,13600.0,3,S
2018-04-13 10:31:48,13595.0,4,7354,-4,13595.0,1,13600.0,3,S
2018-04-13 10:32:13,13595.0,4,7358,-2,13595.0,1,13600.0,11,S
2018-04-13 10:32:28,13595.0,2,7360,0,13590.0,7,13595.0,2,S
2018-04-13 10:32:34,13595.0,2,7362,2,13590.0,8,13600.0,11,S
2018-04-13 10:32:46,13595.0,2,7364,2,13595.0,1,13600.0,11,S
2018-04-13 10:32:47,13595.0,2,7366,2,13590.0,8,13600.0,10,S
2018-04-13 10:33:08,13595.0,2,7368,0,13595.0,2,13600.0,12,S
2018-04-13 10:33:42,13595.0,2,7370,0,13595.0,1,13600.0,12,S
2018-04-13 10:34:38,13595.0,6,7376,-4,13590.0,9,13600.0,8,S
2018-04-13 10:34:39,13590.0,6,7382,-2,13590.0,6,13600.0,8,S
2018-04-13 10:35:20,13590.0,10,7392,8,13585.0,4,13595.0,5,S
2018-04-13 10:35:21,13590.0,2,7394,0,13585.0,4,13590.0,3,S
2018-04-13 10:35:22,13590.0,8,7402,-4,13580.0,21,13590.0,7,S
2018-04-13 10:35:23,13585.0,2,7404,-2,13585.0,6,13590.0,7,S
2018-04-13 10:35:24,13585.0,2,7406,-2,13585.0,5,13590.0,7,S
2018-04-13 10:35:25,13585.0,10,7416,0,13580.0,10,13590.0,7,S
2018-04-13 10:35:25,13585.0,10,7426,0,13580.0,10,13590.0,7,S
2018-04-13 10:35:27,13585.0,8,7434,0,13580.0,10,13585.0,1,S
2018-04-13 10:35:28,13585.0,12,7446,12,13585.0,2,13590.0,8,S
2018-04-13 10:35:30,13585.0,6,7452,2,13580.0,12,13585.0,2,S
2018-04-13 10:35:30,13585.0,10,7462,4,13580.0,12,13585.0,2,S
2018-04-13 10:35:35,13585.0,6,7468,4,13580.0,11,13590.0,8,S
2018-04-13 10:35:36,13585.0,4,7472,4,13580.0,11,13590.0,8,S
2018-04-13 10:36:19,13580.0,16,7488,4,13580.0,1,13585.0,5,S
2018-04-13 10:36:20,13580.0,2,7490,0,13575.0,11,13580.0,2,S
2018-04-13 10:36:20,13575.0,2,7492,-2,13575.0,10,13580.0,2,S
2018-04-13 10:36:24,13575.0,2,7494,-2,13575.0,9,13580.0,5,S
2018-04-13 10:36:25,13580.0,2,7496,-2,13575.0,9,13580.0,4,B
2018-04-13 10:36:28,13575.0,14,7510,-10,13575.0,2,13580.0,12,S
2018-04-13 10:36:29,13575.0,4,7514,2,13570.0,8,13575.0,1,S
2018-04-13 10:36:34,13570.0,2,7516,0,13570.0,6,13575.0,8,S
2018-04-13 10:36:35,13570.0,2,7518,-2,13570.0,5,13575.0,8,S
2018-04-13 10:36:36,13570.0,2,7520,-2,13570.0,4,13575.0,8,S
2018-04-13 10:36:37,13575.0,2,7522,0,13570.0,4,13580.0,4,B
2018-04-13 10:36:44,13570.0,2,7524,-2,13570.0,3,13575.0,7,S
2018-04-13 10:36:50,13570.0,2,7526,-2,13570.0,2,13575.0,17,S
2018-04-13 10:36:51,13570.0,4,7530,2,13565.0,7,13575.0,17,S
2018-04-13 10:36:53,13570.0,10,7540,4,13565.0,7,13570.0,3,S
2018-04-13 10:36:54,13570.0,4,7544,2,13565.0,7,13570.0,1,S
2018-04-13 10:36:54,13570.0,2,7546,0,13565.0,6,13575.0,3,S
2018-04-13 10:37:01,13575.0,2,7548,0,13565.0,6,13575.0,4,B
2018-04-13 10:37:16,13575.0,2,7550,0,13575.0,1,13580.0,8,B
2018-04-13 10:37:21,13570.0,2,7552,-2,13570.0,4,13575.0,3,S
2018-04-13 10:37:22,13575.0,2,7554,0,13570.0,4,13575.0,2,B
2018-04-13 10:37:27,13575.0,6,7560,4,13570.0,6,13580.0,6,B
2018-04-13 10:37:32,13575.0,6,7566,2,13570.0,6,13575.0,2,B
2018-04-13 10:37:32,13575.0,4,7570,0,13570.0,5,13580.0,5,B
2018-04-13 10:37:37,13570.0,4,7574,4,13570.0,2,13575.0,10,S
2018-04-13 10:37:38,13570.0,6,7580,2,13565.0,7,13575.0,13,S
2018-04-13 10:37:49,13575.0,2,7582,2,13570.0,9,13575.0,9,B
2018-04-13 10:37:49,13570.0,2,7584,0,13570.0,8,13575.0,9,S
2018-04-13 10:38:08,13570.0,10,7594,-4,13565.0,28,13575.0,9,S
2018-04-13 10:38:11,13565.0,4,7598,-4,13565.0,4,13570.0,8,S
2018-04-13 10:38:12,13565.0,8,7606,2,13560.0,8,13565.0,2,S
2018-04-13 10:38:12,13565.0,4,7610,4,13560.0,8,13570.0,12,S
2018-04-13 10:38:15,13565.0,2,7612,0,13560.0,8,13565.0,2,S
2018-04-13 10:38:16,13565.0,4,7616,4,13560.0,8,13570.0,12,S
2018-04-13 10:38:18,13560.0,8,7624,-6,13560.0,26,13570.0,1,S
2018-04-13 10:38:20,13560.0,4,7628,2,13560.0,38,13570.0,2,S
2018-04-13 10:38:26,13570.0,2,7630,0,13565.0,2,13575.0,15,B
2018-04-13 10:38:32,13565.0,2,7632,2,13565.0,3,13570.0,4,S
2018-04-13 10:38:35,13565.0,2,7634,0,13560.0,9,13570.0,5,S
2018-04-13 10:39:06,13570.0,2,7636,0,13565.0,6,13570.0,7,B
2018-04-13 10:39:21,13570.0,6,7642,-6,13565.0,10,13575.0,15,B
2018-04-13 10:39:44,13570.0,4,7646,0,13570.0,2,13575.0,16,B
2018-04-13 10:39:46,13570.0,2,7648,2,13570.0,1,13575.0,18,B
2018-04-13 10:39:47,13570.0,2,7650,0,13565.0,10,13570.0,3,B
2018-04-13 10:39:52,13570.0,6,7656,-2,13570.0,5,13575.0,16,B
2018-04-13 10:40:10,13575.0,4,7660,4,13570.0,1,13575.0,12,B
2018-04-13 10:40:11,13570.0,2,7662,-2,13565.0,13,13575.0,12,S
2018-04-13 10:40:24,13575.0,4,7666,0,13570.0,9,13575.0,6,B
2018-04-13 10:40:24,13575.0,12,7678,4,13570.0,9,13580.0,18,B
2018-04-13 10:40:26,13575.0,2,7680,-2,13570.0,10,13580.0,17,B
2018-04-13 10:41:03,13580.0,2,7682,0,13575.0,7,13580.0,12,B
2018-04-13 10:41:06,13575.0,4,7686,4,13570.0,5,13580.0,15,S
2018-04-13 10:41:39,13575.0,2,7688,0,13570.0,10,13575.0,1,S
2018-04-13 10:43:12,13575.0,2,7690,0,13570.0,11,13575.0,9,S
2018-04-13 10:43:12,13575.0,4,7694,0,13570.0,12,13575.0,7,S
2018-04-13 10:43:13,13575.0,2,7696,0,13570.0,12,13575.0,6,S
2018-04-13 10:43:15,13575.0,12,7708,12,13575.0,3,13580.0,18,S
2018-04-13 10:44:05,13580.0,2,7710,2,13575.0,4,13580.0,17,B
2018-04-13 10:44:12,13580.0,2,7712,2,13575.0,4,13580.0,16,B
2018-04-13 10:44:30,13575.0,6,7718,0,13570.0,5,13575.0,4,S
2018-04-13 10:44:37,13575.0,8,7726,0,13575.0,1,13580.0,18,S
2018-04-13 10:44:55,13580.0,12,7738,12,13575.0,5,13580.0,9,B
2018-04-13 10:44:58,13580.0,2,7740,0,13575.0,10,13580.0,8,B
2018-04-13 10:45:09,13580.0,16,7756,0,13580.0,2,13585.0,24,B
2018-04-13 10:45:10,13580.0,4,7760,-4,13575.0,5,13580.0,1,B
2018-04-13 10:45:12,13580.0,4,7764,4,13580.0,5,13585.0,23,B
2018-04-13 10:45:39,13585.0,8,7772,2,13580.0,5,13585.0,19,B
2018-04-13 10:46:04,13585.0,34,7806,0,13585.0,3,13590.0,44,B
2018-04-13 10:46:24,13585.0,2,7808,-2,13585.0,2,13590.0,44,B
2018-04-13 10:46:40,13590.0,30,7838,20,13585.0,3,13590.0,28,B
2018-04-13 10:46:50,13590.0,4,7842,4,13585.0,4,13590.0,26,B
2018-04-13 10:46:53,13585.0,2,7844,-2,13585.0,8,13590.0,26,S
2018-04-13 10:46:55,13590.0,20,7864,20,13585.0,7,13590.0,16,B
2018-04-13 10:46:56,13590.0,12,7876,0,13585.0,7,13590.0,10,B
2018-04-13 10:46:56,13590.0,12,7888,4,13585.0,11,13590.0,4,B
2018-04-13 10:46:57,13590.0,8,7896,-2,13585.0,11,13595.0,17,B
2018-04-13 10:47:27,13590.0,4,7900,-4,13590.0,1,13595.0,16,B
2018-04-13 10:47:27,13590.0,4,7904,0,13585.0,25,13590.0,1,B
2018-04-13 10:47:28,13590.0,2,7906,-2,13590.0,1,13595.0,16,B
2018-04-13 10:47:49,13590.0,2,7908,2,13590.0,6,13595.0,16,B
2018-04-13 10:48:42,13590.0,6,7914,-2,13590.0,3,13595.0,18,B
2018-04-13 10:48:44,13590.0,2,7916,0,13590.0,2,13595.0,18,B
2018-04-13 10:48:44,13590.0,4,7920,0,13585.0,2,13595.0,18,B
2018-04-13 10:48:54,13590.0,8,7928,-8,13590.0,15,13595.0,18,B
2018-04-13 10:48:55,13590.0,24,7952,-16,13590.0,3,13595.0,22,B
2018-04-13 10:48:55,13590.0,6,7958,0,13585.0,2,13595.0,26,B
2018-04-13 10:49:35,13590.0,2,7960,0,13585.0,7,13595.0,17,B
2018-04-13 10:49:47,13590.0,2,7962,0,13590.0,2,13595.0,17,B
2018-04-13 10:49:59,13590.0,8,7970,4,13590.0,1,13595.0,17,B
2018-04-13 10:49:59,13590.0,2,7972,2,13585.0,3,13595.0,17,B
2018-04-13 10:50:15,13590.0,2,7974,0,13585.0,6,13595.0,23,B
2018-04-13 10:50:32,13590.0,2,7976,-2,13590.0,2,13595.0,24,B
2018-04-13 10:50:33,13590.0,4,7980,-4,13585.0,5,13595.0,24,B
2018-04-13 10:50:49,13590.0,12,7992,0,13590.0,24,13595.0,28,B
2018-04-13 10:51:08,13590.0,2,7994,2,13590.0,23,13595.0,27,B
2018-04-13 10:51:27,13590.0,2,7996,2,13590.0,22,13595.0,27,B
2018-04-13 10:52:46,13595.0,2,7998,2,13590.0,25,13595.0,18,B
2018-04-13 10:52:46,13595.0,14,8012,2,13590.0,25,13595.0,11,B
2018-04-13 10:53:22,13595.0,6,8018,6,13590.0,25,13595.0,11,B
2018-04-13 10:54:00,13590.0,18,8036,12,13590.0,22,13595.0,9,S
2018-04-13 10:54:01,13590.0,24,8060,6,13590.0,15,13595.0,4,S
2018-04-13 10:54:01,13590.0,6,8066,0,13590.0,12,13595.0,4,S
2018-04-13 10:54:19,13595.0,2,8068,-2,13590.0,12,13595.0,3,B
2018-04-13 10:54:19,13595.0,2,8070,-2,13590.0,12,13600.0,33,B
2018-04-13 10:54:21,13595.0,2,8072,-2,13595.0,9,13600.0,34,B
2018-04-13 10:54:22,13595.0,10,8082,0,13590.0,17,13600.0,34,B
2018-04-13 10:54:23,13595.0,2,8084,0,13590.0,17,13595.0,4,B
2018-04-13 10:54:24,13595.0,8,8092,0,13595.0,2,13600.0,35,B
2018-04-13 10:55:03,13595.0,10,8102,4,13595.0,1,13600.0,40,B
2018-04-13 10:55:36,13595.0,2,8104,0,13595.0,6,13600.0,39,B
2018-04-13 10:55:51,13595.0,4,8108,0,13595.0,3,13600.0,38,B
2018-04-13 10:55:52,13595.0,6,8114,6,13590.0,13,13600.0,40,B
2018-04-13 10:56:25,13590.0,2,8116,0,13590.0,13,13595.0,2,S
2018-04-13 10:56:57,13590.0,8,8124,0,13590.0,10,13595.0,2,S
2018-04-13 10:57:48,13590.0,4,8128,0,13590.0,7,13595.0,6,S
2018-04-13 10:57:49,13590.0,12,8140,12,13590.0,1,13595.0,6,S
2018-04-13 10:57:50,13590.0,2,8142,0,13585.0,6,13590.0,1,S
2018-04-13 10:58:02,13590.0,4,8146,0,13585.0,7,13595.0,6,S
2018-04-13 10:58:02,13595.0,10,8156,-6,13590.0,3,13600.0,46,B
2018-04-13 10:58:22,13590.0,6,8162,2,13585.0,11,13590.0,2,S
2018-04-13 10:58:22,13590.0,4,8166,4,13590.0,2,13595.0,2,S
2018-04-13 10:58:40,13595.0,2,8168,0,13590.0,4,13600.0,42,B
2018-04-13 10:59:42,13595.0,4,8172,-4,13590.0,2,13595.0,1,B
2018-04-13 11:00:03,13595.0,2,8174,0,13590.0,23,13600.0,58,B
2018-04-13 11:00:57,13600.0,2,8176,2,13595.0,9,13600.0,40,B
2018-04-13 11:01:11,13595.0,14,8190,12,13590.0,38,13600.0,41,S
2018-04-13 11:01:11,13600.0,2,8192,2,13595.0,2,13600.0,40,B
2018-04-13 11:01:52,13600.0,2,8194,2,13595.0,8,13600.0,39,B
2018-04-13 11:01:53,13600.0,6,8200,4,13595.0,22,13600.0,36,B
2018-04-13 11:02:51,13595.0,6,8206,0,13595.0,4,13600.0,36,S
2018-04-13 11:03:03,13600.0,6,8212,4,13595.0,5,13600.0,33,B
2018-04-13 11:03:04,13600.0,26,8238,10,13595.0,6,13600.0,20,B
2018-04-13 11:03:04,13600.0,14,8252,10,13595.0,8,13600.0,13,B
2018-04-13 11:03:05,13600.0,4,8256,4,13595.0,8,13600.0,11,B
2018-04-13 11:03:05,13600.0,4,8260,4,13595.0,8,13600.0,9,B
2018-04-13 11:03:06,13600.0,4,8264,4,13595.0,8,13600.0,7,B
2018-04-13 11:03:06,13600.0,4,8268,4,13595.0,8,13600.0,5,B
2018-04-13 11:03:07,13600.0,4,8272,2,13595.0,8,13600.0,3,B
2018-04-13 11:03:07,13600.0,6,8278,6,13595.0,8,13605.0,36,B
2018-04-13 11:03:14,13605.0,4,8282,4,13600.0,6,13605.0,30,B
2018-04-13 11:03:15,13605.0,4,8286,4,13600.0,9,13605.0,13,B
2018-04-13 11:03:15,13605.0,8,8294,4,13600.0,10,13605.0,9,B
2018-04-13 11:03:16,13605.0,4,8298,4,13600.0,10,13605.0,7,B
2018-04-13 11:03:16,13605.0,4,8302,4,13600.0,13,13605.0,5,B
2018-04-13 11:03:17,13605.0,4,8306,4,13600.0,13,13605.0,3,B
2018-04-13 11:03:17,13605.0,6,8312,4,13605.0,7,13610.0,32,B
2018-04-13 11:03:25,13610.0,12,8324,0,13605.0,13,13610.0,25,B
2018-04-13 11:03:25,13610.0,12,8336,0,13605.0,14,13610.0,19,B
2018-04-13 11:03:26,13610.0,2,8338,2,13605.0,15,13610.0,18,B
2018-04-13 11:03:30,13610.0,4,8342,4,13605.0,6,13610.0,17,B
2018-04-13 11:03:30,13605.0,6,8348,0,13605.0,3,13610.0,17,S
2018-04-13 11:03:31,13605.0,6,8354,-2,13600.0,6,13610.0,20,S
2018-04-13 11:03:34,13610.0,4,8358,4,13600.0,13,13610.0,17,B
2018-04-13 11:03:35,13610.0,4,8362,4,13605.0,2,13610.0,12,B
2018-04-13 11:03:36,13610.0,4,8366,4,13605.0,2,13610.0,10,B
2018-04-13 11:03:36,13610.0,4,8370,4,13605.0,2,13610.0,8,B
2018-04-13 11:03:37,13610.0,4,8374,4,13605.0,2,13610.0,6,B
2018-04-13 11:03:37,13610.0,4,8378,4,13605.0,6,13610.0,5,B
2018-04-13 11:03:38,13605.0,4,8382,-2,13600.0,8,13610.0,11,S
2018-04-13 11:03:49,13610.0,2,8384,0,13605.0,5,13610.0,6,B
2018-04-13 11:03:50,13610.0,4,8388,4,13605.0,9,13610.0,1,B
2018-04-13 11:03:50,13610.0,2,8390,2,13610.0,1,13615.0,10,B
2018-04-13 11:03:54,13610.0,2,8392,2,13605.0,9,13610.0,6,B
2018-04-13 11:03:54,13610.0,4,8396,4,13605.0,9,13610.0,4,B
2018-04-13 11:03:55,13610.0,4,8400,0,13605.0,9,13610.0,2,B
2018-04-13 11:03:55,13610.0,4,8404,4,13610.0,1,13615.0,26,B
2018-04-13 11:03:56,13615.0,6,8410,2,13610.0,8,13615.0,19,B
2018-04-13 11:04:02,13615.0,4,8414,4,13610.0,5,13615.0,17,B
2018-04-13 11:04:03,13615.0,4,8418,4,13610.0,5,13615.0,15,B
2018-04-13 11:04:03,13615.0,4,8422,0,13610.0,4,13615.0,13,B
2018-04-13 11:04:04,13615.0,4,8426,0,13610.0,4,13615.0,11,B
2018-04-13 11:04:04,13615.0,4,8430,0,13610.0,4,13615.0,9,B
2018-04-13 11:04:11,13610.0,2,8432,0,13605.0,11,13610.0,2,S
2018-04-13 11:04:12,13610.0,4,8436,4,13605.0,10,13615.0,12,S
2018-04-13 11:04:14,13610.0,4,8440,4,13605.0,10,13615.0,12,S
2018-04-13 11:04:20,13610.0,4,8444,4,13605.0,9,13610.0,3,S
2018-04-13 11:04:22,13610.0,4,8448,4,13605.0,9,13610.0,1,S
2018-04-13 11:04:22,13610.0,2,8450,2,13610.0,1,13615.0,12,S
2018-04-13 11:04:24,13610.0,12,8462,10,13605.0,11,13615.0,12,S
2018-04-13 11:04:26,13610.0,2,8464,2,13605.0,5,13610.0,3,S
2018-04-13 11:04:29,13610.0,2,8466,2,13610.0,1,13615.0,12,S
2018-04-13 11:04:29,13610.0,2,8468,0,13605.0,3,13615.0,15,S
2018-04-13 11:04:36,13605.0,2,8470,2,13605.0,2,13615.0,15,S
2018-04-13 11:04:46,13610.0,2,8472,-2,13605.0,4,13610.0,2,B
2018-04-13 11:04:52,13610.0,4,8476,0,13605.0,6,13610.0,10,B
2018-04-13 11:04:53,13610.0,4,8480,4,13605.0,6,13610.0,8,B
2018-04-13 11:04:53,13610.0,4,8484,4,13605.0,6,13610.0,6,B
2018-04-13 11:04:54,13610.0,4,8488,2,13605.0,6,13610.0,4,B
2018-04-13 11:04:54,13610.0,4,8492,0,13605.0,6,13610.0,2,B
2018-04-13 11:04:55,13610.0,4,8496,0,13605.0,6,13615.0,15,B
2018-04-13 11:05:00,13610.0,4,8500,4,13605.0,6,13610.0,3,B
2018-04-13 11:05:01,13610.0,6,8506,0,13610.0,2,13615.0,16,B
2018-04-13 11:05:04,13610.0,2,8508,2,13610.0,5,13615.0,14,B
2018-04-13 11:05:05,13615.0,2,8510,0,13610.0,8,13615.0,13,B
2018-04-13 11:05:05,13615.0,2,8512,0,13610.0,8,13615.0,12,B
2018-04-13 11:05:06,13615.0,2,8514,0,13610.0,8,13615.0,11,B
2018-04-13 11:05:06,13615.0,2,8516,0,13610.0,8,13615.0,10,B
2018-04-13 11:05:07,13615.0,2,8518,0,13610.0,8,13615.0,9,B
2018-04-13 11:05:07,13615.0,2,8520,0,13610.0,4,13615.0,8,B
2018-04-13 11:05:08,13610.0,6,8526,0,13605.0,6,13615.0,10,S
2018-04-13 11:05:14,13610.0,2,8528,2,13605.0,2,13610.0,6,S
2018-04-13 11:05:23,13600.0,2,8530,2,13600.0,5,13610.0,10,S
2018-04-13 11:05:27,13600.0,2,8532,2,13600.0,4,13610.0,10,S
2018-04-13 11:05:32,13600.0,2,8534,0,13600.0,3,13610.0,10,S
2018-04-13 11:05:34,13600.0,2,8536,0,13600.0,2,13610.0,10,S
2018-04-13 11:05:36,13600.0,2,8538,2,13600.0,1,13610.0,10,S
2018-04-13 11:05:39,13600.0,2,8540,0,13600.0,3,13610.0,10,S
2018-04-13 11:06:13,13600.0,2,8542,0,13600.0,4,13610.0,19,S
2018-04-13 11:06:39,13600.0,2,8544,0,13595.0,7,13605.0,8,S
2018-04-13 11:06:41,13595.0,2,8546,2,13595.0,6,13605.0,8,S
2018-04-13 11:07:20,13600.0,4,8550,0,13595.0,9,13605.0,13,B
2018-04-13 11:07:34,13595.0,2,8552,0,13595.0,2,13600.0,11,S
2018-04-13 11:07:35,13595.0,2,8554,-2,13595.0,1,13600.0,11,S
2018-04-13 11:07:35,13595.0,2,8556,0,13590.0,5,13600.0,11,S
2018-04-13 11:07:38,13595.0,2,8558,2,13590.0,4,13600.0,7,S
2018-04-13 11:07:50,13595.0,4,8562,0,13590.0,6,13600.0,5,S
2018-04-13 11:07:57,13600.0,4,8566,4,13595.0,1,13600.0,3,B
2018-04-13 11:07:57,13600.0,4,8570,4,13595.0,1,13600.0,1,B
2018-04-13 11:07:58,13600.0,2,8572,2,13595.0,2,13605.0,13,B
2018-04-13 11:08:12,13595.0,4,8576,0,13595.0,1,13600.0,6,S
2018-04-13 11:08:30,13585.0,14,8590,0,13585.0,2,13590.0,7,S
2018-04-13 11:08:31,13585.0,2,8592,0,13580.0,36,13590.0,3,S
2018-04-13 11:08:46,13580.0,2,8594,-2,13580.0,33,13585.0,4,S
2018-04-13 11:08:47,13580.0,8,8602,-8,13580.0,29,13585.0,4,S
2018-04-13 11:08:49,13580.0,34,8636,0,13580.0,12,13585.0,10,S
2018-04-13 11:08:49,13580.0,24,8660,-8,13575.0,5,13585.0,10,S
2018-04-13 11:09:11,13580.0,4,8664,0,13575.0,5,13585.0,9,S
2018-04-13 11:09:15,13585.0,2,8666,2,13575.0,5,13585.0,10,B
2018-04-13 11:09:15,13575.0,2,8668,-2,13575.0,4,13585.0,10,S
2018-04-13 11:09:32,13585.0,2,8670,0,13575.0,5,13580.0,1,B
2018-04-13 11:09:33,13580.0,2,8672,0,13575.0,4,13580.0,1,S
2018-04-13 11:09:36,13575.0,8,8680,-4,13570.0,7,13580.0,4,S
2018-04-13 11:09:52,13575.0,2,8682,2,13570.0,5,13575.0,7,S
2018-04-13 11:09:53,13570.0,2,8684,0,13570.0,4,13575.0,3,S
2018-04-13 11:10:05,13580.0,16,8700,8,13570.0,5,13580.0,5,B
2018-04-13 11:10:06,13580.0,10,8710,0,13575.0,1,13585.0,22,B
2018-04-13 11:10:13,13580.0,2,8712,0,13575.0,2,13580.0,2,B
2018-04-13 11:10:19,13580.0,2,8714,0,13575.0,2,13580.0,1,B
2018-04-13 11:10:38,13575.0,6,8720,-6,13570.0,27,13580.0,9,S
2018-04-13 11:10:47,13575.0,10,8730,6,13575.0,2,13580.0,3,S
2018-04-13 11:10:54,13575.0,6,8736,0,13575.0,1,13580.0,3,S
2018-04-13 11:11:10,13575.0,6,8742,0,13570.0,20,13580.0,3,S
2018-04-13 11:11:14,13580.0,16,8758,-6,13580.0,2,13585.0,12,B
2018-04-13 11:11:14,13580.0,4,8762,-2,13575.0,1,13580.0,4,B
2018-04-13 11:11:16,13570.0,6,8768,6,13570.0,12,13580.0,4,S
2018-04-13 11:11:18,13575.0,2,8770,2,13570.0,12,13580.0,13,B
2018-04-13 11:11:36,13575.0,2,8772,2,13570.0,12,13580.0,16,B
2018-04-13 11:11:51,13575.0,8,8780,0,13575.0,6,13580.0,16,B
2018-04-13 11:11:52,13575.0,12,8792,-10,13570.0,12,13580.0,16,B
2018-04-13 11:11:59,13570.0,20,8812,4,13565.0,11,13575.0,2,S
2018-04-13 11:11:59,13575.0,2,8814,0,13565.0,10,13575.0,2,B
2018-04-13 11:12:04,13565.0,2,8816,-2,13565.0,6,13575.0,5,S
2018-04-13 11:12:07,13575.0,4,8820,-4,13575.0,6,13580.0,17,B
2018-04-13 11:12:08,13575.0,12,8832,-12,13570.0,1,13580.0,20,B
2018-04-13 11:12:15,13570.0,2,8834,0,13570.0,5,13580.0,16,S
2018-04-13 11:12:20,13580.0,2,8836,0,13570.0,5,13580.0,15,B
2018-04-13 11:13:07,13580.0,2,8838,-2,13575.0,5,13580.0,5,B
2018-04-13 11:13:07,13580.0,2,8840,0,13575.0,5,13580.0,4,B
2018-04-13 11:13:11,13580.0,2,8842,-2,13575.0,7,13580.0,3,B
2018-04-13 11:13:11,13580.0,6,8848,-6,13575.0,7,13585.0,10,B
2018-04-13 11:14:42,13580.0,2,8850,-2,13575.0,18,13585.0,11,B
2018-04-13 11:15:05,13585.0,22,8872,4,13585.0,3,13590.0,5,B
2018-04-13 11:15:06,13590.0,10,8882,8,13590.0,2,13595.0,4,B
2018-04-13 11:15:23,13595.0,4,8886,-2,13590.0,5,13600.0,19,B
2018-04-13 11:15:35,13595.0,4,8890,4,13590.0,7,13600.0,16,B
2018-04-13 11:15:36,13590.0,12,8902,8,13585.0,4,13590.0,1,S
2018-04-13 11:15:37,13590.0,2,8904,-2,13590.0,3,13600.0,19,S
2018-04-13 11:16:02,13600.0,2,8906,-2,13595.0,5,13600.0,15,B
2018-04-13 11:16:02,13595.0,2,8908,0,13595.0,4,13600.0,15,S
2018-04-13 11:16:22,13595.0,2,8910,0,13590.0,18,13600.0,16,S
2018-04-13 11:16:36,13600.0,24,8934,4,13595.0,3,13600.0,4,B
2018-04-13 11:16:37,13600.0,8,8942,0,13600.0,2,13605.0,8,B
2018-04-13 11:16:39,13600.0,4,8946,0,13595.0,3,13605.0,6,B
2018-04-13 11:16:56,13600.0,2,8948,-2,13600.0,1,13605.0,5,B
2018-04-13 11:16:56,13600.0,4,8952,4,13595.0,16,13605.0,5,B
2018-04-13 11:17:08,13600.0,8,8960,-6,13595.0,3,13605.0,14,B
2018-04-13 11:18:28,13595.0,12,8972,-2,13590.0,31,13600.0,24,S
2018-04-13 11:18:50,13595.0,2,8974,0,13595.0,1,13600.0,23,S
2018-04-13 11:18:55,13600.0,4,8978,2,13595.0,15,13600.0,21,B
2018-04-13 11:18:56,13600.0,40,9018,32,13595.0,15,13600.0,1,B
2018-04-13 11:18:56,13600.0,2,9020,2,13600.0,2,13605.0,10,B
2018-04-13 11:19:23,13600.0,2,9022,0,13600.0,1,13605.0,7,B
2018-04-13 11:19:24,13600.0,2,9024,0,13595.0,13,13600.0,1,B
2018-04-13 11:19:30,13595.0,12,9036,0,13590.0,8,13600.0,6,S
2018-04-13 11:19:33,13595.0,4,9040,4,13590.0,20,13595.0,1,S
2018-04-13 11:19:33,13595.0,2,9042,2,13595.0,1,13600.0,7,S
2018-04-13 11:19:34,13595.0,2,9044,2,13590.0,7,13600.0,7,S
2018-04-13 11:19:36,13595.0,2,9046,0,13590.0,7,13600.0,6,S
2018-04-13 11:20:04,13600.0,2,9048,0,13595.0,4,13600.0,4,B
2018-04-13 11:20:04,13600.0,8,9056,4,13595.0,17,13605.0,11,B
2018-04-13 11:20:08,13600.0,4,9060,4,13595.0,17,13605.0,7,B
2018-04-13 11:20:13,13600.0,6,9066,-6,13595.0,3,13605.0,11,B
2018-04-13 11:20:19,13600.0,2,9068,0,13595.0,6,13605.0,8,B
2018-04-13 11:20:44,13595.0,2,9070,0,13595.0,2,13600.0,4,S
2018-04-13 11:20:44,13595.0,4,9074,-4,13590.0,13,13600.0,4,S
2018-04-13 11:21:04,13595.0,2,9076,0,13590.0,12,13600.0,9,S
2018-04-13 11:21:35,13590.0,2,9078,2,13590.0,11,13595.0,6,S
2018-04-13 11:21:35,13590.0,8,9086,4,13590.0,7,13595.0,6,S
2018-04-13 11:21:36,13590.0,2,9088,0,13590.0,6,13595.0,9,S
2018-04-13 11:21:39,13590.0,2,9090,-2,13590.0,5,13595.0,9,S
2018-04-13 11:21:42,13590.0,2,9092,0,13590.0,4,13595.0,9,S
2018-04-13 11:21:43,13590.0,8,9100,-6,13585.0,3,13590.0,1,S
2018-04-13 11:21:58,13590.0,2,9102,-2,13590.0,1,13595.0,10,S
2018-04-13 11:21:59,13595.0,8,9110,-6,13590.0,4,13600.0,12,B
2018-04-13 11:22:06,13595.0,2,9112,2,13595.0,2,13600.0,4,B
2018-04-13 11:22:31,13595.0,2,9114,0,13595.0,1,13600.0,13,B
2018-04-13 11:22:31,13595.0,2,9116,0,13590.0,6,13600.0,13,B
2018-04-13 11:22:35,13590.0,12,9128,4,13585.0,8,13590.0,14,S
2018-04-13 11:22:35,13590.0,8,9136,4,13585.0,8,13590.0,10,S
2018-04-13 11:22:36,13590.0,2,9138,0,13585.0,8,13590.0,9,S
2018-04-13 11:22:36,13590.0,4,9142,0,13585.0,6,13590.0,7,S
2018-04-13 11:23:36,13590.0,14,9156,6,13590.0,1,13595.0,5,S
2018-04-13 11:23:37,13595.0,10,9166,8,13595.0,3,13600.0,12,B
2018-04-13 11:23:38,13595.0,8,9174,0,13590.0,22,13600.0,9,B
2018-04-13 11:23:39,13595.0,6,9180,0,13590.0,20,13600.0,9,B
2018-04-13 11:23:56,13590.0,10,9190,-8,13590.0,6,13600.0,11,S
2018-04-13 11:24:06,13600.0,2,9192,0,13595.0,6,13600.0,8,B
2018-04-13 11:24:06,13600.0,16,9208,-6,13595.0,6,13605.0,10,B
2018-04-13 11:24:07,13600.0,2,9210,2,13595.0,3,13605.0,9,B
2018-04-13 11:24:14,13605.0,4,9214,-2,13595.0,5,13605.0,7,B
2018-04-13 11:25:26,13600.0,2,9216,-2,13595.0,15,13600.0,3,S
2018-04-13 11:25:26,13600.0,2,9218,0,13600.0,1,13605.0,8,S
2018-04-13 11:25:27,13600.0,2,9220,2,13595.0,3,13600.0,2,S
2018-04-13 11:25:38,13600.0,2,9222,0,13595.0,3,13600.0,2,S
2018-04-13 11:25:51,13595.0,4,9226,4,13590.0,8,13595.0,2,S
2018-04-13 11:26:21,13595.0,4,9230,0,13590.0,4,13595.0,2,S
2018-04-13 11:26:21,13590.0,8,9238,-4,13585.0,19,13595.0,1,S
2018-04-13 11:26:41,13590.0,4,9242,0,13585.0,6,13590.0,1,S
2018-04-13 11:26:41,13590.0,2,9244,0,13590.0,1,13595.0,6,S
2018-04-13 11:26:42,13590.0,2,9246,0,13585.0,6,13595.0,6,S
2018-04-13 11:26:43,13585.0,2,9248,2,13580.0,4,13590.0,5,S
2018-04-13 11:26:43,13590.0,4,9252,2,13580.0,4,13590.0,3,B
2018-04-13 11:26:44,13590.0,4,9256,0,13585.0,3,13590.0,3,B
2018-04-13 11:26:44,13590.0,4,9260,0,13585.0,3,13590.0,1,B
2018-04-13 11:26:47,13590.0,4,9264,-4,13590.0,2,13595.0,7,B
2018-04-13 11:27:33,13595.0,2,9266,0,13590.0,3,13595.0,2,B
2018-04-13 11:27:37,13595.0,2,9268,2,13590.0,4,13595.0,1,B
2018-04-13 11:27:38,13595.0,2,9270,0,13590.0,3,13600.0,9,B
2018-04-13 11:27:39,13595.0,4,9274,4,13590.0,2,13595.0,1,B
2018-04-13 11:27:45,13595.0,2,9276,2,13595.0,2,13600.0,11,B
2018-04-13 11:27:50,13595.0,2,9278,0,13595.0,3,13600.0,9,B
2018-04-13 11:28:04,13600.0,8,9286,2,13595.0,5,13600.0,2,B
2018-04-13 11:28:07,13600.0,2,9288,2,13595.0,4,13600.0,1,B
2018-04-13 11:28:09,13595.0,8,9296,0,13590.0,5,13600.0,6,S
2018-04-13 11:28:23,13595.0,4,9300,4,13590.0,9,13595.0,1,S
2018-04-13 11:29:00,13600.0,6,9306,0,13595.0,3,13605.0,9,B
2018-04-13 11:29:05,13600.0,2,9308,-2,13595.0,1,13605.0,6,B
2018-04-13 11:29:06,13595.0,4,9312,2,13590.0,6,13595.0,1,S
2018-04-13 11:29:06,13595.0,2,9314,2,13590.0,6,13600.0,4,S
2018-04-13 11:29:30,13595.0,2,9316,-2,13595.0,1,13605.0,6,S
2018-04-13 13:30:01,13605.0,2,9318,-2,13595.0,4,13605.0,7,B
2018-04-13 13:30:05,13605.0,6,9324,-2,13600.0,5,13605.0,3,B
2018-04-13 13:30:05,13605.0,4,9328,4,13600.0,6,13605.0,1,B
2018-04-13 13:30:06,13605.0,2,9330,0,13600.0,6,13610.0,17,B
2018-04-13 13:30:07,13605.0,4,9334,0,13600.0,6,13605.0,3,B
2018-04-13 13:30:07,13605.0,4,9338,0,13600.0,6,13605.0,1,B
2018-04-13 13:30:08,13605.0,2,9340,-2,13600.0,8,13610.0,16,B
2018-04-13 13:30:13,13610.0,2,9342,2,13605.0,8,13610.0,14,B
2018-04-13 13:30:14,13605.0,4,9346,4,13605.0,6,13610.0,14,S
2018-04-13 13:30:15,13610.0,4,9350,4,13605.0,6,13610.0,12,B
2018-04-13 13:30:15,13605.0,16,9366,12,13600.0,54,13605.0,2,S
2018-04-13 13:30:16,13610.0,8,9374,6,13605.0,18,13610.0,13,B
2018-04-13 13:30:20,13610.0,20,9394,20,13605.0,26,13615.0,17,B
2018-04-13 13:30:21,13615.0,2,9396,0,13610.0,5,13615.0,14,B
2018-04-13 13:30:21,13615.0,16,9412,-10,13610.0,10,13615.0,6,B
2018-04-13 13:30:22,13615.0,10,9422,-10,13610.0,10,13615.0,1,B
2018-04-13 13:30:22,13615.0,2,9424,-2,13615.0,4,13620.0,26,B
2018-04-13 13:30:24,13620.0,4,9428,4,13615.0,8,13620.0,23,B
2018-04-13 13:30:24,13615.0,4,9432,2,13615.0,2,13620.0,24,S
2018-04-13 13:30:25,13615.0,4,9436,0,13610.0,16,13615.0,1,S
2018-04-13 13:30:25,13615.0,2,9438,0,13615.0,2,13620.0,24,S
2018-04-13 13:30:26,13615.0,4,9442,4,13610.0,11,13620.0,24,S
2018-04-13 13:30:28,13615.0,2,9444,2,13615.0,1,13620.0,24,S
2018-04-13 13:30:30,13615.0,4,9448,0,13610.0,7,13620.0,24,S
2018-04-13 13:30:56,13610.0,4,9452,2,13605.0,2,13615.0,10,S
2018-04-13 13:31:04,13610.0,2,9454,-2,13605.0,3,13610.0,1,S
2018-04-13 13:31:05,13615.0,8,9462,-4,13605.0,2,13615.0,4,B
2018-04-13 13:31:23,13615.0,2,9464,-2,13605.0,7,13615.0,4,B
2018-04-13 13:31:24,13615.0,4,9468,2,13615.0,2,13620.0,33,B
2018-04-13 13:31:25,13615.0,4,9472,4,13610.0,11,13620.0,29,B
2018-04-13 13:31:35,13610.0,20,9492,18,13610.0,1,13620.0,28,S
2018-04-13 13:31:40,13615.0,8,9500,-8,13615.0,2,13620.0,31,B
2018-04-13 13:31:41,13615.0,4,9504,-4,13605.0,7,13615.0,18,B
2018-04-13 13:31:59,13610.0,8,9512,0,13605.0,7,13615.0,2,S
2018-04-13 13:32:11,13610.0,4,9516,2,13605.0,3,13610.0,2,S
2018-04-13 13:32:12,13610.0,4,9520,0,13605.0,2,13610.0,5,S
2018-04-13 13:32:14,13610.0,2,9522,0,13605.0,2,13610.0,4,S
2018-04-13 13:32:34,13610.0,4,9526,0,13605.0,5,13610.0,1,S
2018-04-13 13:32:41,13610.0,2,9528,2,13610.0,1,13615.0,5,S
2018-04-13 13:32:46,13610.0,2,9530,2,13610.0,1,13615.0,4,S
2018-04-13 13:32:55,13610.0,2,9532,0,13610.0,1,13615.0,4,S
2018-04-13 13:32:56,13610.0,2,9534,2,13605.0,4,13615.0,4,S
2018-04-13 13:33:00,13605.0,2,9536,2,13605.0,2,13615.0,5,S
2018-04-13 13:33:01,13605.0,4,9540,4,13605.0,3,13615.0,4,S
2018-04-13 13:33:16,13610.0,2,9542,0,13605.0,4,13610.0,9,B
2018-04-13 13:33:17,13610.0,4,9546,4,13605.0,4,13610.0,7,B
2018-04-13 13:33:17,13610.0,4,9550,4,13605.0,4,13610.0,5,B
2018-04-13 13:33:18,13610.0,2,9552,2,13605.0,3,13610.0,4,B
2018-04-13 13:33:18,13610.0,4,9556,4,13605.0,3,13610.0,2,B
2018-04-13 13:33:19,13610.0,4,9560,4,13605.0,3,13615.0,3,B
2018-04-13 13:33:28,13605.0,2,9562,0,13600.0,15,13610.0,2,S
2018-04-13 13:33:33,13610.0,2,9564,0,13600.0,11,13610.0,3,B
2018-04-13 13:33:45,13610.0,2,9566,0,13605.0,1,13610.0,2,B
2018-04-13 13:34:00,13605.0,2,9568,0,13600.0,13,13610.0,3,S
2018-04-13 13:34:14,13600.0,2,9570,-2,13600.0,6,13605.0,3,S
2018-04-13 13:34:20,13600.0,8,9578,-8,13600.0,2,13605.0,1,S
2018-04-13 13:34:23,13600.0,2,9580,2,13600.0,1,13605.0,2,S
2018-04-13 13:34:30,13605.0,4,9584,2,13600.0,1,13610.0,7,B
2018-04-13 13:34:47,13595.0,2,9586,0,13590.0,21,13600.0,20,S
2018-04-13 13:35:02,13600.0,4,9590,4,13595.0,16,13605.0,6,B
2018-04-13 13:35:16,13600.0,4,9594,0,13595.0,4,13605.0,7,B
2018-04-13 13:35:34,13600.0,12,9606,12,13595.0,6,13600.0,1,B
2018-04-13 13:35:50,13600.0,2,9608,0,13600.0,2,13605.0,1,B
2018-04-13 13:35:59,13600.0,2,9610,0,13595.0,1,13605.0,7,B
2018-04-13 13:36:27,13595.0,2,9612,0,13590.0,20,13600.0,3,S
2018-04-13 13:36:44,13595.0,4,9616,-4,13590.0,8,13600.0,5,S
2018-04-13 13:36:45,13595.0,4,9620,4,13590.0,7,13595.0,3,S
2018-04-13 13:36:50,13590.0,2,9622,0,13590.0,6,13595.0,3,S
2018-04-13 13:36:51,13590.0,2,9624,-2,13590.0,5,13595.0,3,S
2018-04-13 13:36:59,13590.0,4,9628,2,13590.0,3,13595.0,6,S
2018-04-13 13:37:00,13590.0,6,9634,-2,13585.0,2,13590.0,1,S
2018-04-13 13:37:07,13590.0,4,9638,2,13585.0,3,13590.0,2,S
2018-04-13 13:37:11,13590.0,4,9642,0,13585.0,15,13595.0,5,S
2018-04-13 13:37:13,13595.0,4,9646,-4,13590.0,6,13600.0,10,B
2018-04-13 13:37:15,13595.0,4,9650,-4,13590.0,5,13600.0,2,B
2018-04-13 13:37:15,13600.0,4,9654,2,13590.0,5,13600.0,2,B
2018-04-13 13:37:18,13600.0,4,9658,0,13590.0,9,13600.0,6,B
2018-04-13 13:38:16,13600.0,8,9666,8,13595.0,5,13605.0,9,B
2018-04-13 13:38:51,13610.0,6,9672,0,13605.0,5,13615.0,8,B
2018-04-13 13:39:28,13610.0,8,9680,-2,13605.0,9,13615.0,6,B
2018-04-13 13:40:07,13615.0,4,9684,4,13610.0,6,13615.0,8,B
2018-04-13 13:40:20,13610.0,2,9686,2,13610.0,5,13615.0,9,S
2018-04-13 13:40:25,13610.0,2,9688,0,13605.0,7,13615.0,12,S
2018-04-13 13:40:50,13605.0,2,9690,-2,13605.0,3,13610.0,4,S
2018-04-13 13:41:07,13610.0,4,9694,0,13605.0,29,13615.0,11,B
2018-04-13 13:41:11,13610.0,2,9696,0,13610.0,5,13615.0,11,B
2018-04-13 13:41:18,13615.0,4,9700,0,13610.0,17,13615.0,6,B
2018-04-13 13:41:19,13615.0,4,9704,0,13610.0,17,13615.0,4,B
2018-04-13 13:41:19,13615.0,8,9712,6,13615.0,2,13620.0,32,B
2018-04-13 13:41:20,13615.0,4,9716,4,13615.0,6,13620.0,27,B
2018-04-13 13:41:20,13615.0,4,9720,4,13615.0,2,13620.0,27,B
2018-04-13 13:41:21,13615.0,4,9724,4,13615.0,1,13620.0,27,B
2018-04-13 13:41:22,13620.0,2,9726,2,13615.0,5,13620.0,26,B
2018-04-13 13:41:23,13620.0,4,9730,4,13615.0,5,13620.0,24,B
2018-04-13 13:41:24,13620.0,38,9768,20,13615.0,5,13620.0,5,B
2018-04-13 13:41:24,13620.0,10,9778,2,13620.0,10,13625.0,8,B
2018-04-13 13:41:32,13620.0,8,9786,-2,13620.0,2,13625.0,6,B
2018-04-13 13:41:32,13620.0,2,9788,0,13620.0,2,13625.0,7,B
2018-04-13 13:41:33,13620.0,4,9792,-2,13620.0,1,13625.0,7,B
2018-04-13 13:41:33,13620.0,4,9796,0,13615.0,6,13625.0,7,B
2018-04-13 13:41:34,13620.0,2,9798,2,13615.0,2,13625.0,8,B
2018-04-13 13:41:37,13620.0,2,9800,0,13615.0,3,13620.0,2,B
2018-04-13 13:41:37,13620.0,4,9804,0,13620.0,6,13625.0,5,B
2018-04-13 13:41:43,13620.0,12,9816,0,13615.0,2,13620.0,2,B
2018-04-13 13:41:49,13615.0,2,9818,-2,13610.0,7,13615.0,1,S
2018-04-13 13:41:50,13615.0,4,9822,2,13610.0,5,13615.0,2,S
2018-04-13 13:41:50,13615.0,2,9824,-2,13610.0,5,13620.0,4,S
2018-04-13 13:41:54,13620.0,2,9826,0,13610.0,5,13620.0,7,B
2018-04-13 13:42:01,13620.0,2,9828,-2,13615.0,5,13625.0,7,B
2018-04-13 13:42:27,13620.0,12,9840,10,13615.0,2,13620.0,3,B
2018-04-13 13:42:41,13620.0,2,9842,0,13620.0,1,13625.0,6,B
2018-04-13 13:42:43,13625.0,2,9844,0,13620.0,1,13625.0,5,B
2018-04-13 13:42:50,13620.0,2,9846,-2,13615.0,6,13625.0,8,S
2018-04-13 13:43:01,13620.0,8,9854,2,13615.0,24,13625.0,6,S
2018-04-13 13:43:09,13625.0,4,9858,4,13620.0,45,13625.0,13,B
2018-04-13 13:43:10,13625.0,4,9862,4,13620.0,3,13625.0,11,B
2018-04-13 13:43:11,13620.0,6,9868,0,13615.0,22,13620.0,1,S
2018-04-13 13:43:48,13620.0,2,9870,0,13615.0,29,13620.0,1,S
2018-04-13 13:43:48,13620.0,2,9872,2,13615.0,29,13625.0,14,S
2018-04-13 13:43:55,13615.0,2,9874,2,13615.0,1,13620.0,17,S
2018-04-13 13:43:56,13615.0,2,9876,0,13610.0,7,13620.0,16,S
2018-04-13 13:44:05,13615.0,2,9878,2,13610.0,8,13620.0,4,S
2018-04-13 13:44:06,13610.0,4,9882,0,13610.0,6,13620.0,4,S
2018-04-13 13:44:23,13610.0,2,9884,0,13605.0,9,13610.0,1,S
2018-04-13 13:44:23,13610.0,2,9886,0,13605.0,12,13615.0,4,S
2018-04-13 13:44:43,13610.0,4,9890,4,13610.0,4,13615.0,3,S
2018-04-13 13:44:48,13610.0,4,9894,4,13610.0,2,13615.0,3,S
2018-04-13 13:45:02,13615.0,4,9898,-4,13610.0,2,13615.0,12,B
2018-04-13 13:45:12,13615.0,4,9902,-2,13610.0,2,13615.0,11,B
2018-04-13 13:45:13,13610.0,4,9906,4,13605.0,9,13615.0,12,S
2018-04-13 13:45:16,13610.0,2,9908,2,13605.0,12,13610.0,2,S
2018-04-13 13:45:16,13610.0,2,9910,2,13605.0,12,13610.0,1,S
2018-04-13 13:45:17,13610.0,2,9912,2,13605.0,12,13615.0,13,S
2018-04-13 13:45:24,13610.0,4,9916,4,13610.0,3,13615.0,13,S
2018-04-13 13:45:25,13610.0,6,9922,6,13605.0,12,13615.0,13,S
2018-04-13 13:45:37,13610.0,4,9926,4,13610.0,3,13615.0,13,S
2018-04-13 13:45:39,13610.0,4,9930,4,13610.0,1,13615.0,13,S
2018-04-13 13:45:39,13610.0,2,9932,0,13605.0,11,13615.0,13,S
2018-04-13 13:45:42,13610.0,2,9934,2,13605.0,12,13610.0,4,S
2018-04-13 13:45:43,13610.0,2,9936,2,13605.0,12,13610.0,3,S
2018-04-13 13:45:44,13610.0,2,9938,2,13605.0,11,13610.0,2,S
2018-04-13 13:45:44,13610.0,2,9940,2,13605.0,11,13610.0,3,S
2018-04-13 13:45:45,13610.0,4,9944,4,13605.0,11,13610.0,1,S
2018-04-13 13:45:46,13610.0,2,9946,2,13605.0,11,13615.0,14,S
2018-04-13 13:45:47,13605.0,2,9948,0,13605.0,11,13615.0,14,S
2018-04-13 13:45:48,13610.0,2,9950,2,13605.0,10,13610.0,1,B
2018-04-13 13:45:49,13610.0,2,9952,2,13605.0,10,13610.0,2,B
2018-04-13 13:45:50,13610.0,2,9954,2,13605.0,10,13610.0,1,B
2018-04-13 13:45:51,13610.0,2,9956,2,13610.0,1,13615.0,14,B
2018-04-13 13:45:52,13610.0,2,9958,0,13605.0,10,13615.0,14,B
2018-04-13 13:45:53,13610.0,2,9960,2,13605.0,11,13610.0,1,B
2018-04-13 13:45:54,13610.0,2,9962,2,13605.0,10,13615.0,14,B
2018-04-13 13:45:58,13610.0,4,9966,4,13610.0,1,13615.0,14,B
2018-04-13 13:46:00,13610.0,2,9968,2,13605.0,11,13610.0,1,B
2018-04-13 13:46:00,13610.0,2,9970,2,13605.0,11,13615.0,14,B
2018-04-13 13:46:03,13610.0,2,9972,2,13605.0,11,13610.0,1,B
2018-04-13 13:46:04,13610.0,2,9974,2,13605.0,11,13615.0,14,B
2018-04-13 13:46:07,13610.0,2,9976,2,13605.0,11,13610.0,1,B
2018-04-13 13:46:08,13610.0,2,9978,2,13605.0,11,13615.0,16,B
2018-04-13 13:46:09,13610.0,2,9980,2,13605.0,11,13610.0,1,B
2018-04-13 13:46:10,13610.0,2,9982,2,13605.0,11,13615.0,16,B
2018-04-13 13:46:12,13605.0,4,9986,0,13605.0,9,13610.0,2,S
2018-04-13 13:46:13,13610.0,4,9990,0,13610.0,1,13615.0,16,B
2018-04-13 13:46:13,13610.0,2,9992,2,13605.0,8,13615.0,16,B
2018-04-13 13:46:15,13610.0,2,9994,2,13605.0,9,13610.0,1,B
2018-04-13 13:46:15,13610.0,2,9996,2,13605.0,9,13615.0,17,B
2018-04-13 13:46:16,13610.0,2,9998,0,13610.0,1,13615.0,17,B
2018-04-13 13:46:17,13610.0,2,10000,2,13605.0,10,13610.0,1,B
2018-04-13 13:46:18,13610.0,2,10002,2,13605.0,10,13615.0,17,B
2018-04-13 13:46:21,13610.0,2,10004,2,13605.0,9,13610.0,1,B
2018-04-13 13:46:21,13610.0,2,10006,2,13605.0,9,13615.0,17,B
2018-04-13 13:46:22,13610.0,2,10008,2,13605.0,10,13615.0,17,B
2018-04-13 13:46:23,13610.0,2,10010,2,13605.0,10,13610.0,1,B
2018-04-13 13:46:24,13610.0,2,10012,2,13605.0,10,13615.0,17,B
2018-04-13 13:46:26,13610.0,2,10014,2,13605.0,11,13610.0,1,B
2018-04-13 13:46:27,13610.0,2,10016,2,13605.0,10,13615.0,17,B
2018-04-13 13:46:28,13610.0,4,10020,4,13610.0,3,13615.0,17,B
2018-04-13 13:46:30,13610.0,4,10024,4,13610.0,1,13615.0,17,B
2018-04-13 13:46:32,13610.0,2,10026,2,13605.0,9,13610.0,1,B
2018-04-13 13:46:33,13610.0,2,10028,2,13605.0,8,13615.0,16,B
2018-04-13 13:46:37,13610.0,2,10030,2,13605.0,9,13610.0,1,B
2018-04-13 13:46:37,13610.0,2,10032,2,13605.0,9,13615.0,17,B
2018-04-13 13:46:40,13610.0,2,10034,2,13605.0,8,13610.0,1,B
2018-04-13 13:46:41,13610.0,2,10036,2,13605.0,8,13610.0,1,B
2018-04-13 13:46:41,13610.0,2,10038,0,13605.0,8,13610.0,2,B
2018-04-13 13:46:42,13610.0,2,10040,2,13605.0,8,13610.0,1,B
2018-04-13 13:46:43,13610.0,2,10042,2,13605.0,8,13615.0,17,B
2018-04-13 13:46:46,13610.0,4,10046,4,13605.0,5,13615.0,17,B
2018-04-13 13:46:54,13610.0,10,10056,0,13605.0,6,13610.0,5,B
2018-04-13 13:46:55,13610.0,2,10058,0,13605.0,6,13610.0,4,B
2018-04-13 13:46:56,13610.0,2,10060,0,13605.0,8,13610.0,3,B
2018-04-13 13:46:57,13610.0,2,10062,0,13605.0,7,13610.0,2,B
2018-04-13 13:46:58,13610.0,2,10064,0,13605.0,7,13610.0,1,B
2018-04-13 13:46:59,13610.0,2,10066,0,13605.0,7,13615.0,17,B
2018-04-13 13:47:02,13610.0,2,10068,-2,13605.0,8,13615.0,17,B
2018-04-13 13:47:36,13605.0,2,10070,0,13605.0,1,13610.0,9,S
2018-04-13 13:47:37,13605.0,2,10072,0,13600.0,8,13610.0,9,S
2018-04-13 13:47:48,13600.0,14,10086,-12,13595.0,1,13600.0,3,S
2018-04-13 13:47:49,13600.0,2,10088,0,13595.0,3,13600.0,2,S
2018-04-13 13:47:50,13600.0,2,10090,0,13595.0,3,13600.0,1,S
2018-04-13 13:47:51,13600.0,2,10092,0,13595.0,2,13605.0,3,S
2018-04-13 13:47:55,13605.0,2,10094,-2,13600.0,1,13605.0,2,B
2018-04-13 13:48:02,13605.0,4,10098,0,13600.0,1,13610.0,8,B
2018-04-13 13:48:21,13600.0,8,10106,2,13595.0,21,13605.0,5,S
2018-04-13 13:48:39,13595.0,2,10108,0,13595.0,23,13605.0,5,S
2018-04-13 13:48:45,13595.0,40,10148,6,13595.0,7,13605.0,3,S
2018-04-13 13:48:48,13605.0,2,10150,2,13600.0,13,13605.0,1,B
2018-04-13 13:48:50,13605.0,2,10152,0,13600.0,13,13610.0,8,B
2018-04-13 13:49:05,13600.0,10,10162,0,13600.0,13,13610.0,3,S
2018-04-13 13:49:29,13610.0,2,10164,2,13600.0,17,13610.0,5,B
2018-04-13 13:49:31,13610.0,2,10166,0,13600.0,17,13610.0,4,B
2018-04-13 13:49:36,13610.0,4,10170,2,13600.0,17,13610.0,1,B
2018-04-13 13:49:42,13610.0,6,10176,4,13610.0,5,13615.0,8,B
2018-04-13 13:49:42,13610.0,10,10186,0,13605.0,1,13615.0,8,B
2018-04-13 13:49:55,13610.0,2,10188,0,13610.0,1,13615.0,13,B
2018-04-13 13:49:55,13610.0,2,10190,0,13605.0,2,13615.0,13,B
2018-04-13 13:50:18,13615.0,2,10192,2,13605.0,4,13615.0,12,B
2018-04-13 13:50:50,13610.0,2,10194,-2,13605.0,4,13615.0,10,S
2018-04-13 13:51:15,13605.0,4,10198,0,13600.0,20,13610.0,26,S
2018-04-13 13:51:19,13605.0,2,10200,0,13600.0,18,13610.0,11,S
2018-04-13 13:52:02,13605.0,2,10202,2,13600.0,16,13605.0,1,S
2018-04-13 13:52:03,13605.0,2,10204,2,13600.0,17,13610.0,9,S
2018-04-13 13:52:07,13600.0,2,10206,0,13600.0,14,13605.0,5,S
2018-04-13 13:52:08,13600.0,4,10210,4,13600.0,12,13605.0,5,S
2018-04-13 13:52:09,13605.0,4,10214,-4,13600.0,12,13605.0,1,B
2018-04-13 13:52:12,13600.0,2,10216,2,13600.0,11,13605.0,3,S
2018-04-13 13:52:15,13600.0,4,10220,2,13600.0,9,13605.0,6,S
2018-04-13 13:52:16,13605.0,4,10224,-4,13600.0,9,13605.0,5,B
2018-04-13 13:52:22,13605.0,4,10228,0,13600.0,10,13605.0,3,B
2018-04-13 13:53:15,13600.0,2,10230,0,13600.0,12,13605.0,2,S
2018-04-13 13:53:16,13605.0,4,10234,0,13605.0,2,13610.0,18,B
2018-04-13 13:53:23,13610.0,4,10238,0,13605.0,9,13610.0,14,B
2018-04-13 13:53:28,13605.0,4,10242,4,13605.0,7,13610.0,14,S
2018-04-13 13:53:34,13610.0,4,10246,-2,13605.0,7,13610.0,12,B
2018-04-13 13:53:37,13610.0,2,10248,0,13605.0,7,13610.0,11,B
2018-04-13 13:53:38,13610.0,10,10258,4,13605.0,10,13610.0,6,B
2018-04-13 13:53:38,13610.0,2,10260,2,13605.0,10,13610.0,5,B
2018-04-13 13:53:39,13610.0,8,10268,8,13605.0,10,13610.0,1,B
2018-04-13 13:53:39,13610.0,2,10270,2,13610.0,1,13615.0,10,B
2018-04-13 13:53:40,13610.0,2,10272,0,13605.0,7,13615.0,9,B
2018-04-13 13:54:10,13610.0,6,10278,0,13605.0,10,13615.0,5,B
2018-04-13 13:54:14,13610.0,2,10280,-2,13605.0,7,13610.0,5,B
2018-04-13 13:54:18,13605.0,4,10284,2,13605.0,5,13610.0,5,S
2018-04-13 13:54:26,13610.0,2,10286,-2,13605.0,5,13610.0,3,B
2018-04-13 13:54:30,13610.0,6,10292,6,13610.0,2,13615.0,8,B
2018-04-13 13:54:31,13610.0,4,10296,0,13605.0,6,13615.0,7,B
2018-04-13 13:55:23,13610.0,4,10300,2,13605.0,15,13615.0,9,B
2018-04-13 13:55:25,13610.0,2,10302,0,13605.0,13,13615.0,9,B
2018-04-13 13:55:35,13605.0,6,10308,2,13600.0,11,13610.0,7,S
2018-04-13 13:55:39,13600.0,12,10320,0,13600.0,3,13605.0,3,S
2018-04-13 13:55:45,13600.0,6,10326,0,13595.0,6,13600.0,4,S
2018-04-13 13:56:02,13595.0,4,10330,-4,13590.0,4,13600.0,4,S
2018-04-13 13:56:06,13590.0,2,10332,-2,13590.0,6,13600.0,18,S
2018-04-13 13:56:08,13595.0,2,10334,-2,13590.0,6,13600.0,18,B
2018-04-13 13:56:18,13595.0,2,10336,-2,13595.0,1,13600.0,2,B
2018-04-13 13:56:22,13595.0,2,10338,-2,13590.0,6,13600.0,2,B
2018-04-13 13:56:23,13600.0,2,10340,-2,13590.0,6,13600.0,1,B
2018-04-13 13:56:45,13590.0,2,10342,0,13590.0,2,13595.0,7,S
2018-04-13 13:56:46,13590.0,2,10344,0,13590.0,1,13595.0,7,S
2018-04-13 13:56:50,13590.0,2,10346,-2,13585.0,6,13595.0,9,S
2018-04-13 13:57:02,13585.0,10,10356,-6,13580.0,6,13590.0,13,S
2018-04-13 13:57:05,13580.0,2,10358,0,13580.0,6,13590.0,2,S
2018-04-13 13:57:06,13580.0,2,10360,-2,13580.0,5,13595.0,7,S
2018-04-13 13:57:08,13580.0,12,10372,-8,13575.0,8,13580.0,44,S
2018-04-13 13:57:09,13580.0,16,10388,-14,13575.0,8,13580.0,36,S
2018-04-13 13:57:09,13580.0,2,10390,0,13575.0,13,13580.0,35,S
2018-04-13 13:57:10,13580.0,4,10394,-2,13575.0,11,13580.0,33,S
2018-04-13 13:57:10,13580.0,2,10396,0,13575.0,11,13580.0,32,S
2018-04-13 13:57:11,13580.0,2,10398,0,13575.0,9,13580.0,31,S
2018-04-13 13:57:11,13575.0,2,10400,-2,13575.0,8,13580.0,31,S
2018-04-13 13:57:12,13580.0,2,10402,0,13575.0,8,13580.0,30,B
2018-04-13 13:57:13,13580.0,2,10404,0,13575.0,9,13580.0,29,B
2018-04-13 13:57:13,13580.0,2,10406,0,13575.0,9,13580.0,28,B
2018-04-13 13:57:14,13580.0,4,10410,0,13575.0,9,13580.0,26,B
2018-04-13 13:57:14,13580.0,10,10420,0,13575.0,9,13580.0,21,B
2018-04-13 13:57:15,13580.0,2,10422,0,13575.0,14,13580.0,20,B
2018-04-13 13:57:15,13575.0,8,10430,-8,13575.0,11,13580.0,19,S
2018-04-13 13:57:16,13580.0,2,10432,0,13575.0,11,13580.0,18,B
2018-04-13 13:57:18,13580.0,2,10434,0,13575.0,11,13580.0,17,B
2018-04-13 13:57:20,13580.0,2,10436,0,13575.0,16,13580.0,16,B
2018-04-13 13:57:21,13580.0,2,10438,0,13575.0,16,13580.0,15,B
2018-04-13 13:57:22,13580.0,2,10440,0,13575.0,16,13580.0,14,B
2018-04-13 13:57:23,13580.0,6,10446,-2,13575.0,16,13580.0,11,B
2018-04-13 13:57:23,13580.0,2,10448,0,13575.0,16,13580.0,10,B
2018-04-13 13:57:25,13580.0,2,10450,0,13575.0,16,13580.0,9,B
2018-04-13 13:57:25,13580.0,6,10456,0,13575.0,16,13580.0,6,B
2018-04-13 13:57:26,13580.0,2,10458,0,13575.0,16,13580.0,5,B
2018-04-13 13:57:26,13580.0,10,10468,-8,13580.0,2,13585.0,2,B
2018-04-13 13:57:28,13585.0,2,10470,2,13585.0,1,13590.0,2,B
2018-04-13 13:57:29,13585.0,2,10472,2,13580.0,9,13590.0,2,B
2018-04-13 13:57:30,13585.0,2,10474,2,13580.0,8,13590.0,3,B
2018-04-13 13:57:45,13590.0,2,10476,-2,13585.0,5,13590.0,6,B
2018-04-13 13:57:49,13590.0,2,10478,0,13585.0,5,13590.0,4,B
2018-04-13 13:57:53,13590.0,2,10480,0,13585.0,5,13590.0,3,B
2018-04-13 13:58:03,13590.0,2,10482,0,13585.0,5,13590.0,1,B
2018-04-13 13:58:03,13590.0,2,10484,0,13585.0,5,13595.0,10,B
2018-04-13 13:58:38,13585.0,4,10488,4,13585.0,6,13595.0,4,S
2018-04-13 14:00:13,13590.0,2,10490,0,13585.0,5,13590.0,1,B
2018-04-13 14:00:30,13590.0,2,10492,-2,13585.0,9,13590.0,68,B
2018-04-13 14:00:31,13590.0,4,10496,-4,13585.0,9,13590.0,66,B
2018-04-13 14:00:42,13585.0,4,10500,4,13585.0,6,13590.0,67,S
2018-04-13 14:00:51,13585.0,2,10502,0,13585.0,6,13590.0,67,S
2018-04-13 14:01:07,13585.0,2,10504,0,13585.0,4,13590.0,67,S
2018-04-13 14:01:17,13590.0,2,10506,0,13585.0,4,13590.0,66,B
2018-04-13 14:01:35,13590.0,4,10510,-4,13585.0,4,13590.0,64,B
2018-04-13 14:01:52,13585.0,4,10514,4,13585.0,12,13590.0,64,S
2018-04-13 14:01:52,13590.0,4,10518,-4,13585.0,12,13590.0,62,B
2018-04-13 14:02:11,13585.0,4,10522,-2,13585.0,11,13590.0,62,S
2018-04-13 14:02:26,13585.0,2,10524,-2,13585.0,10,13590.0,61,S
2018-04-13 14:03:05,13585.0,20,10544,0,13580.0,6,13585.0,20,S
2018-04-13 14:03:06,13585.0,4,10548,2,13580.0,5,13585.0,18,S
2018-04-13 14:03:06,13585.0,2,10550,2,13580.0,10,13585.0,17,S
2018-04-13 14:03:07,13585.0,2,10552,2,13580.0,10,13585.0,16,S
2018-04-13 14:03:08,13585.0,2,10554,2,13580.0,10,13585.0,15,S
2018-04-13 14:03:09,13585.0,2,10556,2,13580.0,9,13585.0,14,S
2018-04-13 14:03:09,13585.0,2,10558,2,13580.0,9,13585.0,13,S
2018-04-13 14:03:10,13585.0,4,10562,2,13580.0,8,13585.0,11,S
2018-04-13 14:03:10,13585.0,2,10564,2,13580.0,8,13585.0,10,S
2018-04-13 14:03:11,13585.0,2,10566,2,13580.0,8,13585.0,9,S
2018-04-13 14:03:12,13585.0,2,10568,2,13580.0,8,13585.0,8,S
2018-04-13 14:03:13,13585.0,2,10570,2,13580.0,8,13585.0,7,S
2018-04-13 14:03:13,13585.0,2,10572,2,13580.0,8,13585.0,6,S
2018-04-13 14:03:15,13585.0,2,10574,2,13580.0,8,13585.0,5,S
2018-04-13 14:03:15,13585.0,2,10576,2,13580.0,8,13585.0,4,S
2018-04-13 14:03:16,13585.0,14,10590,0,13585.0,4,13590.0,62,S
2018-04-13 14:03:17,13585.0,2,10592,-2,13585.0,3,13590.0,63,S
2018-04-13 14:03:35,13585.0,2,10594,-2,13585.0,2,13590.0,62,S
2018-04-13 14:03:40,13585.0,2,10596,-2,13585.0,1,13590.0,62,S
2018-04-13 14:03:40,13585.0,2,10598,2,13585.0,1,13590.0,63,S
2018-04-13 14:03:41,13585.0,2,10600,2,13580.0,9,13590.0,63,S
2018-04-13 14:04:01,13580.0,36,10636,12,13575.0,6,13580.0,2,S
2018-04-13 14:04:02,13580.0,4,10640,2,13580.0,4,13585.0,1,S
2018-04-13 14:04:02,13590.0,4,10644,-4,13585.0,1,13590.0,63,B
2018-04-13 14:04:03,13585.0,6,10650,-2,13575.0,7,13585.0,3,S
2018-04-13 14:04:04,13585.0,4,10654,2,13580.0,2,13585.0,4,S
2018-04-13 14:04:10,13585.0,4,10658,2,13575.0,2,13585.0,6,S
2018-04-13 14:04:56,13575.0,2,10660,-2,13570.0,12,13575.0,4,S
2018-04-13 14:04:58,13570.0,2,10662,-2,13570.0,11,13575.0,4,S
2018-04-13 14:04:59,13575.0,2,10664,0,13570.0,11,13575.0,3,B
2018-04-13 14:05:09,13575.0,2,10666,-2,13570.0,11,13575.0,8,B
2018-04-13 14:05:14,13575.0,2,10668,0,13575.0,4,13580.0,8,B
2018-04-13 14:05:20,13575.0,2,10670,0,13575.0,1,13580.0,5,B
2018-04-13 14:05:27,13575.0,2,10672,0,13570.0,11,13575.0,1,B
2018-04-13 14:05:29,13575.0,2,10674,-2,13570.0,11,13580.0,12,B
2018-04-13 14:05:58,13575.0,2,10676,-2,13575.0,2,13580.0,17,B
2018-04-13 14:05:59,13575.0,4,10680,-4,13570.0,12,13580.0,19,B
2018-04-13 14:06:43,13575.0,4,10684,4,13575.0,3,13580.0,15,B
2018-04-13 14:07:32,13580.0,2,10686,0,13575.0,13,13580.0,11,B
2018-04-13 14:07:32,13580.0,12,10698,12,13575.0,14,13580.0,5,B
2018-04-13 14:07:33,13580.0,10,10708,0,13575.0,14,13585.0,8,B
2018-04-13 14:08:11,13585.0,2,10710,0,13580.0,6,13585.0,2,B
2018-04-13 14:08:43,13585.0,2,10712,2,13580.0,5,13585.0,2,B
2018-04-13 14:08:59,13585.0,4,10716,0,13580.0,6,13585.0,1,B
2018-04-13 14:09:05,13580.0,4,10720,4,13580.0,4,13585.0,2,S
2018-04-13 14:09:06,13585.0,2,10722,0,13580.0,4,13590.0,75,B
2018-04-13 14:09:55,13585.0,8,10730,-2,13580.0,11,13590.0,68,B
2018-04-13 14:10:36,13580.0,24,10754,6,13575.0,14,13580.0,8,S
2018-04-13 14:10:38,13580.0,6,10760,6,13575.0,11,13580.0,5,S
2018-04-13 14:11:17,13580.0,2,10762,0,13575.0,14,13580.0,14,S
2018-04-13 14:11:24,13580.0,2,10764,2,13575.0,16,13580.0,13,S
2018-04-13 14:11:37,13580.0,10,10774,10,13575.0,17,13580.0,10,S
2018-04-13 14:11:53,13580.0,2,10776,2,13575.0,17,13580.0,9,S
2018-04-13 14:12:40,13580.0,2,10778,2,13575.0,14,13580.0,8,S
2018-04-13 14:12:46,13580.0,2,10780,2,13575.0,16,13580.0,7,S
2018-04-13 14:12:46,13580.0,2,10782,0,13575.0,16,13580.0,6,S
2018-04-13 14:12:56,13580.0,10,10792,8,13575.0,11,13580.0,1,S
2018-04-13 14:12:56,13580.0,2,10794,-2,13575.0,11,13585.0,9,S
2018-04-13 14:13:19,13585.0,2,10796,0,13580.0,8,13590.0,8,B
2018-04-13 14:14:58,13585.0,2,10798,2,13580.0,9,13585.0,2,B
2018-04-13 14:15:13,13580.0,12,10810,-12,13575.0,13,13585.0,21,S
2018-04-13 14:15:56,13580.0,2,10812,0,13575.0,13,13580.0,1,S
2018-04-13 14:17:55,13580.0,8,10820,0,13575.0,14,13585.0,10,S
2018-04-13 14:18:34,13585.0,2,10822,-2,13580.0,5,13585.0,4,B
2018-04-13 14:18:39,13585.0,2,10824,-2,13580.0,5,13585.0,3,B
2018-04-13 14:18:41,13585.0,2,10826,0,13580.0,7,13585.0,2,B
2018-04-13 14:18:48,13585.0,4,10830,-4,13580.0,10,13590.0,6,B
2018-04-13 14:18:49,13580.0,4,10834,0,13585.0,1,13590.0,6,S
2018-04-13 14:18:49,13585.0,2,10836,2,13580.0,8,13590.0,6,B
2018-04-13 14:19:11,13590.0,2,10838,0,13585.0,9,13595.0,8,B
2018-04-13 14:19:11,13590.0,2,10840,2,13585.0,10,13595.0,8,B
2018-04-13 14:19:26,13585.0,4,10844,4,13585.0,6,13595.0,14,S
2018-04-13 14:19:38,13595.0,4,10848,-4,13585.0,7,13595.0,10,B
2018-04-13 14:20:26,13595.0,2,10850,0,13585.0,6,13595.0,11,B
2018-04-13 14:20:27,13590.0,2,10852,2,13585.0,6,13590.0,1,S
2018-04-13 14:20:35,13585.0,12,10864,-4,13580.0,10,13585.0,1,S
2018-04-13 14:20:36,13585.0,6,10870,-2,13580.0,9,13585.0,3,S
2018-04-13 14:20:36,13585.0,6,10876,-2,13580.0,9,13590.0,3,S
2018-04-13 14:22:17,13580.0,2,10878,-2,13575.0,13,13585.0,4,S
2018-04-13 14:22:17,13585.0,2,10880,0,13575.0,14,13585.0,1,B
2018-04-13 14:22:54,13580.0,2,10882,-2,13575.0,20,13585.0,5,S
2018-04-13 14:23:37,13580.0,2,10884,0,13580.0,6,13585.0,7,S
2018-04-13 14:23:40,13585.0,2,10886,-2,13580.0,6,13585.0,5,B
2018-04-13 14:23:43,13585.0,4,10890,4,13580.0,6,13585.0,3,B
2018-04-13 14:24:02,13585.0,2,10892,-2,13580.0,6,13590.0,24,B
2018-04-13 14:24:17,13580.0,4,10896,-4,13580.0,8,13590.0,17,S
2018-04-13 14:24:46,13590.0,2,10898,0,13580.0,17,13590.0,16,B
2018-04-13 14:25:07,13580.0,2,10900,0,13580.0,22,13590.0,12,S
2018-04-13 14:25:59,13585.0,2,10902,0,13580.0,24,13590.0,13,B
2018-04-13 14:26:17,13590.0,2,10904,-2,13580.0,24,13590.0,13,B
2018-04-13 14:26:27,13590.0,2,10906,0,13580.0,24,13590.0,12,B
2018-04-13 14:27:01,13590.0,2,10908,-2,13585.0,5,13590.0,7,B
2018-04-13 14:27:02,13590.0,2,10910,-2,13585.0,5,13590.0,6,B
2018-04-13 14:27:03,13590.0,2,10912,-2,13585.0,6,13590.0,5,B
2018-04-13 14:27:39,13585.0,2,10914,-2,13585.0,8,13590.0,5,S
2018-04-13 14:27:54,13590.0,2,10916,0,13585.0,9,13590.0,4,B
2018-04-13 14:28:09,13590.0,8,10924,0,13585.0,8,13595.0,9,B
2018-04-13 14:28:38,13595.0,12,10936,4,13585.0,18,13595.0,3,B
2018-04-13 14:29:01,13595.0,2,10938,0,13590.0,3,13595.0,1,B
2018-04-13 14:30:17,13590.0,6,10944,-2,13585.0,10,13590.0,1,S
2018-04-13 14:30:50,13595.0,2,10946,0,13590.0,18,13600.0,19,B
2018-04-13 14:31:06,13590.0,2,10948,0,13590.0,14,13600.0,22,S
2018-04-13 14:31:35,13600.0,10,10958,-2,13590.0,15,13600.0,17,B
2018-04-13 14:31:58,13600.0,2,10960,2,13595.0,8,13600.0,18,B
2018-04-13 14:31:58,13595.0,4,10964,-4,13595.0,6,13600.0,18,S
2018-04-13 14:32:17,13595.0,8,10972,-8,13595.0,3,13600.0,18,S
2018-04-13 14:32:18,13595.0,6,10978,-6,13590.0,3,13600.0,19,S
2018-04-13 14:33:23,13590.0,2,10980,0,13585.0,13,13595.0,9,S
2018-04-13 14:33:38,13595.0,2,10982,-2,13585.0,12,13595.0,9,B
2018-04-13 14:34:16,13585.0,2,10984,0,13585.0,8,13590.0,12,S
2018-04-13 14:34:16,13585.0,14,10998,-4,13580.0,17,13585.0,1,S
2018-04-13 14:34:17,13585.0,2,11000,-2,13580.0,12,13590.0,12,S
2018-04-13 14:34:36,13585.0,4,11004,-4,13580.0,11,13585.0,1,S
2018-04-13 14:34:38,13590.0,2,11006,0,13580.0,13,13590.0,9,B
2018-04-13 14:35:06,13585.0,2,11008,0,13580.0,9,13585.0,3,S
2018-04-13 14:35:11,13580.0,18,11026,8,13575.0,20,13585.0,3,S
2018-04-13 14:35:15,13580.0,2,11028,0,13575.0,17,13585.0,8,S
2018-04-13 14:35:17,13580.0,2,11030,0,13580.0,1,13585.0,2,S
2018-04-13 14:35:20,13575.0,4,11034,2,13575.0,19,13585.0,1,S
2018-04-13 14:36:00,13580.0,2,11036,0,13575.0,21,13585.0,4,B
2018-04-13 14:36:20,13580.0,2,11038,-2,13575.0,21,13580.0,19,B
2018-04-13 14:36:24,13580.0,14,11052,-14,13575.0,21,13580.0,12,B
2018-04-13 14:36:24,13580.0,14,11066,0,13575.0,21,13580.0,5,B
2018-04-13 14:36:32,13580.0,2,11068,-2,13575.0,21,13580.0,5,B
2018-04-13 14:37:01,13580.0,4,11072,-2,13575.0,17,13580.0,3,B
2018-04-13 14:37:10,13580.0,2,11074,-2,13575.0,17,13580.0,2,B
2018-04-13 14:37:20,13580.0,4,11078,0,13575.0,18,13585.0,6,B
2018-04-13 14:37:29,13585.0,2,11080,0,13575.0,19,13585.0,5,B
2018-04-13 14:37:36,13585.0,8,11088,0,13585.0,2,13590.0,9,B
2018-04-13 14:37:37,13585.0,4,11092,-4,13580.0,1,13585.0,3,B
2018-04-13 14:37:38,13580.0,2,11094,0,13575.0,20,13585.0,1,S
2018-04-13 14:37:56,13580.0,2,11096,0,13575.0,18,13585.0,7,S
2018-04-13 14:37:57,13580.0,2,11098,2,13575.0,18,13585.0,7,S
2018-04-13 14:38:04,13575.0,2,11100,0,13575.0,17,13585.0,12,S
2018-04-13 14:38:21,13580.0,2,11102,-2,13580.0,1,13585.0,2,B
2018-04-13 14:38:30,13580.0,2,11104,-2,13575.0,18,13585.0,2,B
2018-04-13 14:38:34,13580.0,2,11106,0,13575.0,18,13585.0,2,B
2018-04-13 14:39:41,13580.0,12,11118,8,13580.0,4,13585.0,2,B
2018-04-13 14:40:15,13580.0,2,11120,2,13580.0,3,13585.0,3,B
2018-04-13 14:40:17,13580.0,2,11122,2,13580.0,2,13585.0,4,B
2018-04-13 14:40:18,13580.0,4,11126,4,13575.0,16,13585.0,6,B
2018-04-13 14:40:34,13580.0,8,11134,0,13580.0,6,13585.0,7,B
2018-04-13 14:40:34,13580.0,2,11136,2,13580.0,5,13585.0,7,B
2018-04-13 14:40:38,13580.0,2,11138,0,13580.0,4,13585.0,7,B
2018-04-13 14:40:41,13580.0,2,11140,2,13580.0,3,13585.0,7,B
2018-04-13 14:40:44,13580.0,6,11146,6,13575.0,15,13585.0,7,B
2018-04-13 14:40:49,13580.0,10,11156,2,13580.0,4,13585.0,9,B
2018-04-13 14:40:49,13575.0,30,11186,8,13575.0,2,13580.0,19,S
2018-04-13 14:40:50,13575.0,4,11190,0,13570.0,16,13575.0,2,S
2018-04-13 14:41:04,13575.0,8,11198,-8,13575.0,1,13580.0,5,S
2018-04-13 14:41:10,13575.0,2,11200,2,13575.0,4,13580.0,12,S
2018-04-13 14:41:11,13575.0,8,11208,8,13570.0,18,13580.0,12,S
2018-04-13 14:41:12,13580.0,4,11212,0,13575.0,4,13580.0,2,B
2018-04-13 14:41:13,13575.0,6,11218,-4,13575.0,1,13585.0,5,S
2018-04-13 14:41:20,13575.0,2,11220,0,13575.0,7,13585.0,14,S
2018-04-13 14:41:24,13575.0,6,11226,4,13575.0,4,13580.0,4,S
2018-04-13 14:41:25,13575.0,2,11228,0,13575.0,5,13580.0,4,S
2018-04-13 14:41:29,13580.0,8,11236,-2,13575.0,5,13585.0,11,B
2018-04-13 14:41:36,13580.0,2,11238,-2,13575.0,18,13585.0,7,B
2018-04-13 14:41:40,13580.0,2,11240,-2,13575.0,19,13585.0,7,B
2018-04-13 14:42:08,13580.0,2,11242,-2,13580.0,2,13585.0,8,B
2018-04-13 14:42:19,13580.0,4,11246,0,13575.0,19,13585.0,8,B
2018-04-13 14:42:48,13580.0,2,11248,0,13580.0,2,13585.0,8,B
2018-04-13 14:42:53,13580.0,2,11250,-2,13580.0,1,13585.0,8,B
2018-04-13 14:43:14,13585.0,12,11262,12,13580.0,15,13585.0,2,B
2018-04-13 14:43:15,13585.0,6,11268,4,13580.0,15,13590.0,29,B
2018-04-13 14:43:25,13590.0,16,11284,0,13585.0,14,13590.0,18,B
2018-04-13 14:43:26,13590.0,36,11320,0,13590.0,3,13595.0,4,B
2018-04-13 14:43:31,13590.0,2,11322,0,13590.0,2,13595.0,5,B
2018-04-13 14:43:36,13590.0,2,11324,0,13590.0,1,13595.0,5,B
2018-04-13 14:44:17,13590.0,2,11326,-2,13590.0,3,13595.0,5,B
2018-04-13 14:44:21,13590.0,4,11330,2,13590.0,1,13595.0,10,B
2018-04-13 14:44:22,13590.0,2,11332,0,13585.0,7,13595.0,15,B
2018-04-13 14:44:43,13590.0,2,11334,2,13590.0,4,13595.0,12,B
2018-04-13 14:44:48,13595.0,2,11336,2,13590.0,4,13595.0,5,B
2018-04-13 14:44:58,13590.0,2,11338,2,13590.0,3,13595.0,2,S
2018-04-13 14:45:05,13595.0,2,11340,-2,13590.0,3,13595.0,2,B
2018-04-13 14:45:22,13595.0,2,11342,-2,13590.0,3,13600.0,28,B
2018-04-13 14:45:46,13600.0,2,11344,0,13590.0,5,13600.0,29,B
2018-04-13 14:45:53,13590.0,12,11356,-2,13585.0,6,13590.0,1,S
2018-04-13 14:45:58,13590.0,8,11364,8,13590.0,1,13595.0,12,S
2018-04-13 14:46:03,13590.0,2,11366,0,13585.0,6,13595.0,15,S
2018-04-13 14:46:28,13585.0,4,11370,-4,13585.0,2,13590.0,4,S
2018-04-13 14:46:28,13585.0,4,11374,-4,13580.0,9,13590.0,9,S
2018-04-13 14:46:33,13580.0,2,11376,2,13580.0,5,13590.0,11,S
2018-04-13 14:46:45,13580.0,2,11378,-2,13580.0,3,13585.0,1,S
2018-04-13 14:46:49,13585.0,2,11380,0,13580.0,3,13585.0,1,B
2018-04-13 14:47:14,13585.0,2,11382,0,13580.0,10,13590.0,2,B
2018-04-13 14:47:59,13585.0,2,11384,-2,13585.0,1,13590.0,4,B
2018-04-13 14:48:43,13590.0,4,11388,-2,13585.0,2,13595.0,14,B
2018-04-13 14:49:13,13590.0,2,11390,0,13585.0,3,13590.0,3,B
2018-04-13 14:49:14,13590.0,6,11396,0,13590.0,3,13595.0,15,B
2018-04-13 14:49:14,13595.0,12,11408,-4,13585.0,2,13595.0,15,B
2018-04-13 14:49:15,13590.0,2,11410,0,13590.0,1,13595.0,15,S
2018-04-13 14:49:16,13590.0,4,11414,-4,13585.0,2,13595.0,15,S
2018-04-13 14:49:17,13590.0,2,11416,0,13585.0,2,13590.0,1,S
2018-04-13 14:49:20,13590.0,2,11418,2,13585.0,3,13595.0,14,S
2018-04-13 14:49:21,13595.0,28,11446,12,13585.0,4,13595.0,3,B
2018-04-13 14:49:21,13590.0,2,11448,0,13585.0,5,13595.0,3,S
2018-04-13 14:49:33,13595.0,6,11454,6,13590.0,9,13595.0,1,B
2018-04-13 14:49:33,13595.0,2,11456,0,13595.0,1,13600.0,27,B
2018-04-13 14:49:34,13595.0,2,11458,0,13590.0,7,13600.0,24,B
2018-04-13 14:49:36,13595.0,2,11460,-2,13590.0,8,13600.0,24,B
2018-04-13 14:49:39,13595.0,2,11462,0,13590.0,8,13600.0,24,B
2018-04-13 14:50:27,13595.0,2,11464,-2,13590.0,16,13595.0,32,B
2018-04-13 14:50:28,13595.0,16,11480,-14,13590.0,16,13595.0,24,B
2018-04-13 14:50:30,13595.0,10,11490,-6,13590.0,16,13595.0,19,B
2018-04-13 14:50:30,13595.0,16,11506,-8,13590.0,16,13595.0,11,B
2018-04-13 14:50:31,13595.0,6,11512,0,13590.0,15,13595.0,8,B
2018-04-13 14:50:40,13590.0,2,11514,-2,13590.0,12,13595.0,8,S
2018-04-13 14:50:47,13590.0,2,11516,2,13590.0,9,13595.0,8,S
2018-04-13 14:50:50,13590.0,2,11518,0,13590.0,11,13595.0,8,S
2018-04-13 14:50:50,13595.0,10,11528,-10,13590.0,11,13595.0,3,B
2018-04-13 14:50:51,13595.0,6,11534,-6,13595.0,4,13600.0,27,B
2018-04-13 14:50:51,13600.0,2,11536,0,13595.0,8,13600.0,23,B
2018-04-13 14:50:52,13595.0,16,11552,2,13590.0,7,13595.0,1,S
2018-04-13 14:50:56,13595.0,2,11554,0,13590.0,6,13595.0,2,S
2018-04-13 14:51:22,13595.0,2,11556,0,13590.0,13,13595.0,1,S
2018-04-13 14:51:23,13595.0,2,11558,-2,13595.0,2,13600.0,24,S
2018-04-13 14:51:23,13595.0,4,11562,0,13590.0,15,13600.0,26,S
2018-04-13 14:51:33,13600.0,2,11564,0,13590.0,12,13600.0,24,B
2018-04-13 14:51:57,13595.0,10,11574,0,13595.0,1,13600.0,23,S
2018-04-13 14:52:05,13595.0,2,11576,2,13595.0,1,13600.0,22,S
2018-04-13 14:52:05,13595.0,2,11578,0,13590.0,11,13600.0,22,S
2018-04-13 14:52:30,13600.0,20,11598,-4,13590.0,14,13600.0,16,B
2018-04-13 14:53:09,13600.0,6,11604,0,13595.0,4,13600.0,10,B
2018-04-13 14:53:15,13595.0,6,11610,-2,13590.0,16,13600.0,10,S
2018-04-13 14:54:16,13600.0,2,11612,2,13595.0,1,13600.0,11,B
2018-04-13 14:54:16,13595.0,2,11614,2,13590.0,16,13600.0,11,S
2018-04-13 14:54:35,13590.0,8,11622,8,13590.0,10,13600.0,14,S
2018-04-13 14:54:48,13590.0,8,11630,2,13590.0,6,13600.0,10,S
2018-04-13 14:55:02,13590.0,8,11638,-6,13590.0,2,13600.0,14,S
2018-04-13 14:55:16,13595.0,2,11640,-2,13590.0,2,13595.0,5,B
2018-04-13 14:55:16,13595.0,2,11642,0,13590.0,2,13595.0,4,B
2018-04-13 14:56:02,13595.0,16,11658,-6,13590.0,5,13600.0,25,B
2018-04-13 14:56:06,13600.0,8,11666,2,13590.0,5,13600.0,21,B
2018-04-13 14:56:18,13590.0,2,11668,-2,13590.0,1,13600.0,24,S
2018-04-13 14:56:32,13590.0,2,11670,0,13585.0,23,13590.0,2,S
2018-04-13 14:57:01,13590.0,4,11674,0,13585.0,22,13590.0,1,S
2018-04-13 14:57:02,13585.0,4,11678,0,13585.0,20,13590.0,1,S
2018-04-13 14:57:03,13590.0,2,11680,-2,13585.0,20,13595.0,4,B
2018-04-13 14:57:20,13590.0,2,11682,-2,13585.0,20,13590.0,4,B
2018-04-13 14:57:41,13590.0,2,11684,2,13585.0,20,13590.0,10,B
2018-04-13 14:57:59,13585.0,18,11702,0,13585.0,14,13590.0,31,S
2018-04-13 14:57:59,13585.0,2,11704,0,13585.0,13,13590.0,31,S
2018-04-13 14:58:00,13585.0,2,11706,0,13585.0,10,13590.0,31,S
2018-04-13 14:58:04,13585.0,20,11726,6,13580.0,10,13590.0,31,S
2018-04-13 14:58:11,13585.0,6,11732,-2,13580.0,12,13585.0,2,S
2018-04-13 14:58:11,13585.0,4,11736,0,13585.0,2,13590.0,31,S
2018-04-13 14:58:12,13585.0,4,11740,-4,13580.0,12,13590.0,31,S
2018-04-13 14:58:22,13585.0,2,11742,-2,13580.0,12,13590.0,31,S
2018-04-13 14:58:38,13585.0,2,11744,2,13585.0,1,13590.0,31,S
2018-04-13 14:58:44,13590.0,10,11754,0,13585.0,4,13590.0,25,B
2018-04-13 14:59:00,13590.0,6,11760,-6,13585.0,4,13590.0,23,B
2018-04-13 14:59:01,13585.0,4,11764,-2,13585.0,1,13590.0,23,S
2018-04-13 14:59:01,13585.0,8,11772,-2,13580.0,11,13590.0,20,S
2018-04-13 14:59:07,13585.0,2,11774,-2,13580.0,14,13590.0,19,S
2018-04-13 14:59:15,13585.0,2,11776,-2,13585.0,2,13590.0,19,S
2018-04-13 14:59:17,13585.0,4,11780,-4,13580.0,13,13590.0,19,S
2018-04-13 14:59:25,13585.0,4,11784,-2,13580.0,18,13590.0,21,S
2018-04-13 14:59:26,13590.0,2,11786,0,13580.0,14,13590.0,20,B
2018-04-13 14:59:27,13590.0,10,11796,10,13580.0,14,13590.0,15,B
2018-04-13 14:59:32,13580.0,18,11814,-6,13585.0,1,13590.0,15,S
2018-04-13 14:59:33,13590.0,8,11822,0,13585.0,1,13590.0,11,B
2018-04-13 14:59:33,13580.0,10,11832,0,13580.0,3,13590.0,11,S
2018-04-13 14:59:42,13580.0,2,11834,-2,13580.0,24,13590.0,11,S
2018-04-13 14:59:57,13590.0,2,11836,2,13580.0,22,13590.0,40,B
2018-04-13 20:59:00,13585.0,6,6,64114,0.0,0,0.0,0,B
2018-04-13 21:00:01,13585.0,20,26,-6,13585.0,4,13595.0,40,B
2018-04-13 21:00:01,13585.0,16,42,2,13585.0,1,13595.0,40,B
2018-04-13 21:00:02,13575.0,8,50,6,13575.0,4,13595.0,42,S
2018-04-13 21:00:04,13595.0,2,52,0,13590.0,2,13595.0,39,B
2018-04-13 21:00:07,13595.0,30,82,26,13590.0,39,13595.0,24,B
2018-04-13 21:00:07,13590.0,52,134,0,13590.0,15,13610.0,15,S
2018-04-13 21:00:11,13590.0,4,138,4,13590.0,10,13610.0,15,S
2018-04-13 21:00:14,13590.0,6,144,6,13595.0,3,13610.0,15,S
2018-04-13 21:00:15,13590.0,2,146,2,13600.0,1,13610.0,15,S
2018-04-13 21:00:18,13605.0,2,148,-2,13595.0,13,13605.0,1,B
2018-04-13 21:00:25,13605.0,2,150,0,13605.0,2,13610.0,15,B
2018-04-13 21:00:25,13595.0,16,166,14,13590.0,12,13610.0,15,S
2018-04-13 21:00:41,13605.0,4,170,0,13595.0,1,13605.0,4,B
2018-04-13 21:00:48,13600.0,2,172,0,13600.0,7,13605.0,2,S
2018-04-13 21:00:53,13605.0,6,178,2,13600.0,1,13605.0,1,B
2018-04-13 21:00:54,13605.0,2,180,0,13605.0,4,13610.0,15,B
2018-04-13 21:00:55,13610.0,2,182,2,13605.0,8,13610.0,14,B
2018-04-13 21:00:55,13605.0,2,184,-2,13605.0,1,13610.0,15,S
2018-04-13 21:00:59,13605.0,2,186,2,13605.0,2,13610.0,15,S
2018-04-13 21:01:01,13610.0,2,188,2,13605.0,2,13610.0,14,B
2018-04-13 21:01:03,13610.0,2,190,2,13605.0,2,13610.0,13,B
2018-04-13 21:01:04,13600.0,8,198,6,13600.0,1,13610.0,13,S
2018-04-13 21:01:05,13600.0,2,200,2,13595.0,27,13605.0,2,S
2018-04-13 21:01:09,13600.0,2,202,2,13595.0,28,13600.0,1,S
2018-04-13 21:01:10,13595.0,2,204,2,13595.0,27,13605.0,3,S
2018-04-13 21:01:12,13600.0,2,206,2,13595.0,1,13600.0,1,B
2018-04-13 21:01:14,13600.0,2,208,2,13595.0,1,13605.0,2,B
2018-04-13 21:01:17,13605.0,4,212,0,13605.0,4,13610.0,27,B
2018-04-13 21:01:18,13590.0,12,224,10,13590.0,6,13605.0,11,S
2018-04-13 21:01:27,13590.0,2,226,2,13590.0,2,13600.0,3,S
2018-04-13 21:01:32,13595.0,2,228,0,13595.0,1,13605.0,5,B
2018-04-13 21:01:35,13585.0,4,232,2,13585.0,1,13600.0,1,S
2018-04-13 21:01:41,13595.0,2,234,2,13585.0,12,13600.0,4,B
2018-04-13 21:01:49,13595.0,2,236,0,13585.0,12,13600.0,4,B
2018-04-13 21:02:01,13595.0,2,238,2,13590.0,6,13600.0,2,B
2018-04-13 21:02:02,13590.0,4,242,4,13590.0,7,13600.0,2,S
2018-04-13 21:02:15,13595.0,2,244,0,13590.0,8,13600.0,2,B
2018-04-13 21:02:30,13590.0,4,248,4,13585.0,5,13600.0,4,S
2018-04-13 21:02:34,13590.0,2,250,2,13585.0,10,13600.0,4,S
2018-04-13 21:02:50,13585.0,2,252,-2,13585.0,8,13595.0,1,S
2018-04-13 21:02:53,13595.0,2,254,0,13590.0,7,13600.0,3,B
2018-04-13 21:03:00,13600.0,6,260,6,13600.0,8,13605.0,3,B
2018-04-13 21:03:01,13605.0,6,266,-6,13605.0,3,13610.0,14,B
2018-04-13 21:03:01,13600.0,6,272,0,13600.0,10,13610.0,14,S
2018-04-13 21:03:12,13610.0,12,284,0,13605.0,13,13610.0,7,B
2018-04-13 21:03:14,13610.0,10,294,-8,13605.0,4,13610.0,4,B
2018-04-13 21:03:15,13610.0,6,300,0,13605.0,1,13610.0,2,B
2018-04-13 21:03:15,13610.0,2,302,-2,13605.0,4,13610.0,1,B
2018-04-13 21:03:16,13610.0,2,304,-2,13610.0,1,13615.0,11,B
2018-04-13 21:03:16,13605.0,4,308,2,13610.0,1,13615.0,11,S
2018-04-13 21:03:18,13610.0,2,310,-2,13605.0,3,13610.0,1,B
2018-04-13 21:03:18,13610.0,6,316,0,13600.0,28,13605.0,1,B
2018-04-13 21:03:19,13605.0,2,318,0,13600.0,30,13610.0,1,S
2018-04-13 21:03:19,13610.0,2,320,-2,13610.0,3,13615.0,12,B
2018-04-13 21:03:20,13605.0,14,334,4,13605.0,11,13610.0,2,S
2018-04-13 21:03:20,13610.0,10,344,-2,13600.0,28,13610.0,10,B
2018-04-13 21:03:21,13610.0,2,346,0,13600.0,30,13610.0,9,B
2018-04-13 21:03:23,13610.0,8,354,8,13600.0,28,13610.0,5,B
2018-04-13 21:03:24,13610.0,2,356,2,13600.0,30,13610.0,4,B
2018-04-13 21:03:25,13605.0,2,358,0,13600.0,31,13610.0,4,S
2018-04-13 21:03:28,13610.0,8,366,0,13605.0,12,13615.0,17,B
2018-04-13 21:03:29,13615.0,2,368,0,13605.0,13,13615.0,16,B
2018-04-13 21:03:30,13605.0,2,370,0,13605.0,4,13615.0,28,S
2018-04-13 21:03:31,13605.0,8,378,8,13600.0,27,13615.0,28,S
2018-04-13 21:03:32,13605.0,2,380,0,13605.0,2,13615.0,28,S
2018-04-13 21:03:33,13600.0,4,384,2,13600.0,28,13615.0,28,S
2018-04-13 21:03:35,13600.0,2,386,2,13600.0,7,13615.0,16,S
2018-04-13 21:03:43,13610.0,2,388,-2,13605.0,9,13615.0,16,B
2018-04-13 21:03:43,13615.0,2,390,0,13605.0,9,13615.0,15,B
2018-04-13 21:03:48,13610.0,10,400,0,13610.0,8,13615.0,10,S
2018-04-13 21:03:49,13615.0,20,420,2,13615.0,5,13620.0,11,B
2018-04-13 21:03:50,13615.0,16,436,6,13615.0,4,13620.0,8,B
2018-04-13 21:03:50,13620.0,16,452,-2,13615.0,6,13625.0,12,B
2018-04-13 21:03:51,13620.0,4,456,4,13615.0,8,13625.0,12,B
2018-04-13 21:03:52,13615.0,2,458,0,13615.0,6,13625.0,12,S
2018-04-13 21:03:52,13625.0,4,462,4,13615.0,6,13625.0,10,B
2018-04-13 21:03:53,13615.0,18,480,4,13615.0,3,13625.0,11,S
2018-04-13 21:03:59,13610.0,4,484,2,13610.0,1,13620.0,5,S
2018-04-13 21:04:00,13610.0,2,486,-2,13605.0,1,13615.0,4,S
2018-04-13 21:04:00,13605.0,2,488,0,13605.0,2,13615.0,5,S
2018-04-13 21:04:03,13600.0,6,494,2,13600.0,2,13610.0,7,S
2018-04-13 21:04:04,13600.0,4,498,0,13600.0,4,13610.0,7,S
2018-04-13 21:04:07,13600.0,2,500,2,13605.0,2,13610.0,2,S
2018-04-13 21:04:18,13610.0,4,504,2,13600.0,9,13610.0,6,B
2018-04-13 21:04:18,13600.0,4,508,4,13600.0,5,13610.0,6,S
2018-04-13 21:04:21,13600.0,2,510,0,13600.0,11,13610.0,12,S
2018-04-13 21:04:27,13605.0,2,512,-2,13600.0,18,13610.0,12,B
2018-04-13 21:04:30,13610.0,2,514,2,13600.0,23,13610.0,12,B
2018-04-13 21:04:32,13610.0,4,518,4,13600.0,23,13610.0,10,B
2018-04-13 21:04:40,13610.0,6,524,6,13600.0,15,13610.0,10,B
2018-04-13 21:04:44,13610.0,2,526,2,13600.0,23,13610.0,6,B
2018-04-13 21:04:49,13610.0,4,530,4,13605.0,10,13610.0,4,B
2018-04-13 21:04:50,13610.0,8,538,4,13610.0,1,13615.0,1,B
2018-04-13 21:04:50,13610.0,2,540,2,13605.0,11,13620.0,13,B
2018-04-13 21:04:52,13620.0,8,548,-2,13610.0,1,13620.0,11,B
2018-04-13 21:04:53,13615.0,2,550,2,13615.0,2,13620.0,8,S
2018-04-13 21:04:56,13620.0,2,552,2,13615.0,12,13620.0,7,B
2018-04-13 21:04:57,13620.0,2,554,2,13615.0,14,13620.0,6,B
2018-04-13 21:05:02,13615.0,2,556,-2,13615.0,1,13620.0,8,S
2018-04-13 21:05:02,13620.0,4,560,0,13610.0,11,13620.0,6,B
2018-04-13 21:05:05,13615.0,2,562,2,13615.0,1,13620.0,8,S
2018-04-13 21:05:06,13615.0,2,564,2,13610.0,14,13620.0,8,S
2018-04-13 21:05:12,13610.0,2,566,2,13610.0,5,13615.0,3,S
2018-04-13 21:05:15,13605.0,12,578,4,13605.0,1,13615.0,4,S
2018-04-13 21:05:17,13600.0,14,592,10,13600.0,3,13610.0,4,S
2018-04-13 21:05:23,13610.0,2,594,0,13605.0,3,13615.0,4,B
2018-04-13 21:05:29,13615.0,4,598,-4,13605.0,6,13615.0,3,B
2018-04-13 21:05:31,13615.0,2,600,2,13610.0,4,13620.0,10,B
2018-04-13 21:05:41,13620.0,4,604,0,13610.0,7,13620.0,7,B
2018-04-13 21:05:45,13620.0,6,610,0,13620.0,2,13625.0,14,B
2018-04-13 21:05:45,13625.0,6,616,2,13620.0,7,13625.0,8,B
2018-04-13 21:05:46,13625.0,16,632,6,13625.0,5,13630.0,15,B
2018-04-13 21:05:46,13630.0,2,634,0,13625.0,7,13630.0,14,B
2018-04-13 21:05:47,13625.0,2,636,2,13625.0,7,13630.0,14,S
2018-04-13 21:05:51,13625.0,4,640,0,13625.0,3,13630.0,18,S
2018-04-13 21:05:51,13630.0,4,644,0,13625.0,1,13630.0,16,B
2018-04-13 21:05:52,13625.0,2,646,2,13620.0,29,13630.0,15,S
2018-04-13 21:06:04,13625.0,2,648,0,13620.0,30,13630.0,16,S
2018-04-13 21:06:07,13620.0,2,650,2,13620.0,2,13625.0,6,S
2018-04-13 21:06:09,13625.0,2,652,-2,13620.0,3,13625.0,5,B
2018-04-13 21:06:11,13620.0,2,654,2,13620.0,5,13625.0,1,S
2018-04-13 21:06:25,13620.0,2,656,2,13615.0,24,13625.0,6,S
2018-04-13 21:06:30,13625.0,2,658,-2,13620.0,1,13625.0,4,B
2018-04-13 21:06:31,13625.0,4,662,-2,13620.0,1,13630.0,31,B
2018-04-13 21:06:33,13630.0,8,670,8,13625.0,1,13630.0,14,B
2018-04-13 21:06:34,13625.0,2,672,2,13620.0,4,13630.0,14,S
2018-04-13 21:06:38,13620.0,8,680,4,13620.0,1,13630.0,14,S
2018-04-13 21:06:45,13620.0,2,682,2,13615.0,25,13625.0,5,S
2018-04-13 21:06:55,13615.0,2,684,-2,13615.0,23,13625.0,6,S
2018-04-13 21:07:03,13615.0,2,686,0,13615.0,31,13625.0,6,S
2018-04-13 21:07:04,13615.0,2,688,0,13615.0,8,13620.0,3,S
2018-04-13 21:07:05,13620.0,2,690,-2,13615.0,8,13620.0,4,B
2018-04-13 21:07:24,13620.0,2,692,0,13615.0,9,13625.0,3,B
2018-04-13 21:07:26,13620.0,2,694,0,13615.0,9,13625.0,6,B
2018-04-13 21:07:28,13625.0,4,698,-4,13615.0,9,13625.0,3,B
2018-04-13 21:07:29,13625.0,2,700,2,13620.0,1,13625.0,2,B
2018-04-13 21:07:39,13630.0,4,704,0,13620.0,4,13630.0,13,B
2018-04-13 21:07:40,13625.0,12,716,6,13620.0,29,13630.0,9,S
2018-04-13 21:07:41,13630.0,4,720,-2,13620.0,28,13630.0,7,B
2018-04-13 21:07:44,13620.0,4,724,4,13620.0,20,13630.0,10,S
2018-04-13 21:07:53,13620.0,8,732,4,13615.0,16,13625.0,3,S
2018-04-13 21:08:02,13605.0,26,758,8,13605.0,32,13620.0,8,S
2018-04-13 21:08:03,13615.0,4,762,0,13605.0,4,13615.0,4,B
2018-04-13 21:08:15,13615.0,4,766,-4,13605.0,9,13620.0,8,B
2018-04-13 21:08:16,13605.0,4,770,0,13605.0,8,13620.0,7,S
2018-04-13 21:08:37,13610.0,2,772,2,13605.0,9,13610.0,1,B
2018-04-13 21:08:37,13610.0,2,774,0,13605.0,7,13615.0,1,B
2018-04-13 21:08:41,13615.0,2,776,-2,13615.0,1,13620.0,4,B
2018-04-13 21:08:42,13620.0,4,780,0,13615.0,1,13620.0,1,B
2018-04-13 21:08:42,13610.0,4,784,-4,13610.0,3,13625.0,7,S
2018-04-13 21:08:47,13625.0,4,788,-4,13615.0,2,13625.0,3,B
2018-04-13 21:08:57,13615.0,2,790,-2,13610.0,3,13620.0,5,S
2018-04-13 21:08:57,13610.0,2,792,2,13610.0,2,13620.0,6,S
2018-04-13 21:09:10,13615.0,2,794,2,13610.0,3,13620.0,6,B
2018-04-13 21:09:13,13605.0,8,802,8,13600.0,13,13610.0,2,S
2018-04-13 21:09:14,13600.0,4,806,2,13600.0,8,13605.0,1,S
2018-04-13 21:09:16,13600.0,2,808,0,13600.0,7,13605.0,6,S
2018-04-13 21:09:17,13600.0,4,812,4,13600.0,5,13605.0,6,S
2018-04-13 21:09:18,13605.0,8,820,8,13600.0,2,13605.0,5,B
2018-04-13 21:09:26,13600.0,4,824,4,13595.0,2,13605.0,7,S
2018-04-13 21:09:35,13600.0,4,828,0,13595.0,5,13600.0,1,S
2018-04-13 21:09:36,13600.0,2,830,0,13600.0,1,13605.0,4,S
2018-04-13 21:09:37,13600.0,2,832,2,13595.0,5,13600.0,4,S
2018-04-13 21:09:40,13600.0,4,836,4,13595.0,5,13600.0,2,S
2018-04-13 21:09:41,13600.0,4,840,4,13595.0,5,13605.0,5,S
2018-04-13 21:09:48,13605.0,4,844,2,13595.0,5,13605.0,3,B
2018-04-13 21:10:07,13605.0,2,846,2,13600.0,5,13605.0,3,B
2018-04-13 21:10:08,13600.0,2,848,-2,13600.0,6,13605.0,3,S
2018-04-13 21:10:11,13600.0,2,850,0,13600.0,5,13605.0,6,S
2018-04-13 21:10:12,13600.0,2,852,0,13600.0,4,13605.0,6,S
2018-04-13 21:10:12,13600.0,6,858,2,13600.0,1,13605.0,6,S
2018-04-13 21:10:13,13600.0,2,860,2,13595.0,25,13600.0,1,S
2018-04-13 21:10:14,13595.0,4,864,-2,13595.0,2,13600.0,8,S
2018-04-13 21:10:14,13595.0,4,868,0,13590.0,4,13600.0,8,S
2018-04-13 21:10:19,13600.0,2,870,0,13590.0,6,13600.0,6,B
2018-04-13 21:10:24,13600.0,2,872,0,13590.0,6,13600.0,3,B
2018-04-13 21:10:38,13595.0,2,874,0,13590.0,23,13600.0,5,S
2018-04-13 21:10:44,13590.0,2,876,0,13590.0,4,13595.0,3,S
2018-04-13 21:10:45,13590.0,2,878,0,13590.0,3,13595.0,3,S
2018-04-13 21:10:45,13585.0,8,886,-2,13585.0,21,13595.0,10,S
2018-04-13 21:10:47,13585.0,2,888,0,13585.0,4,13590.0,2,S
2018-04-13 21:10:48,13585.0,8,896,0,13580.0,5,13590.0,2,S
2018-04-13 21:10:51,13585.0,2,898,0,13580.0,7,13590.0,9,S
2018-04-13 21:10:56,13580.0,4,902,4,13580.0,6,13585.0,21,S
2018-04-13 21:10:57,13580.0,14,916,-6,13575.0,2,13580.0,3,S
2018-04-13 21:10:57,13580.0,6,922,0,13565.0,3,13580.0,4,S
2018-04-13 21:11:05,13580.0,2,924,0,13580.0,1,13585.0,1,S
2018-04-13 21:11:06,13585.0,4,928,0,13580.0,4,13590.0,1,B
2018-04-13 21:11:12,13585.0,2,930,0,13580.0,12,13590.0,3,B
2018-04-13 21:11:22,13585.0,6,936,0,13580.0,6,13590.0,6,B
2018-04-13 21:11:36,13580.0,8,944,8,13580.0,7,13590.0,9,S
2018-04-13 21:11:37,13580.0,4,948,0,13580.0,2,13590.0,9,S
2018-04-13 21:11:54,13580.0,6,954,0,13575.0,5,13585.0,2,S
2018-04-13 21:11:55,13575.0,2,956,-2,13575.0,1,13580.0,4,S
2018-04-13 21:11:56,13575.0,4,960,0,13570.0,19,13580.0,4,S
2018-04-13 21:11:58,13575.0,2,962,2,13570.0,24,13580.0,4,S
2018-04-13 21:12:02,13575.0,8,970,-4,13570.0,25,13585.0,10,S
2018-04-13 21:12:03,13575.0,2,972,-2,13575.0,1,13585.0,9,S
2018-04-13 21:12:09,13570.0,2,974,0,13570.0,24,13580.0,3,S
2018-04-13 21:12:11,13580.0,2,976,0,13575.0,1,13585.0,10,B
2018-04-13 21:12:16,13585.0,4,980,0,13575.0,2,13585.0,7,B
2018-04-13 21:12:18,13575.0,2,982,0,13575.0,8,13585.0,2,S
2018-04-13 21:12:20,13580.0,6,988,4,13575.0,23,13590.0,4,B
2018-04-13 21:12:22,13575.0,4,992,2,13575.0,22,13590.0,10,S
2018-04-13 21:12:28,13585.0,2,994,0,13575.0,21,13585.0,4,B
2018-04-13 21:12:36,13585.0,2,996,-2,13575.0,21,13585.0,6,B
2018-04-13 21:12:39,13570.0,10,1006,8,13570.0,21,13580.0,2,S
2018-04-13 21:12:40,13575.0,4,1010,-4,13570.0,9,13575.0,1,B
2018-04-13 21:12:52,13575.0,2,1012,0,13575.0,1,13580.0,3,B
2018-04-13 21:12:54,13575.0,2,1014,2,13575.0,3,13585.0,9,B
2018-04-13 21:12:58,13585.0,4,1018,0,13575.0,4,13585.0,5,B
2018-04-13 21:13:04,13585.0,2,1020,2,13575.0,5,13585.0,2,B
2018-04-13 21:13:20,13575.0,2,1022,2,13575.0,5,13585.0,7,S
2018-04-13 21:13:21,13575.0,4,1026,0,13575.0,3,13585.0,8,S
2018-04-13 21:13:21,13575.0,4,1030,4,13575.0,2,13585.0,9,S
2018-04-13 21:13:31,13575.0,2,1032,2,13575.0,3,13585.0,11,S
2018-04-13 21:13:32,13575.0,4,1036,2,13575.0,1,13580.0,1,S
2018-04-13 21:13:32,13575.0,4,1040,4,13570.0,11,13580.0,1,S
2018-04-13 21:13:33,13570.0,2,1042,0,13570.0,13,13580.0,1,S
2018-04-13 21:13:40,13580.0,2,1044,-2,13570.0,14,13580.0,1,B
2018-04-13 21:13:43,13570.0,4,1048,4,13570.0,13,13580.0,2,S
2018-04-13 21:13:44,13570.0,2,1050,2,13570.0,12,13580.0,2,S
2018-04-13 21:13:46,13575.0,4,1054,0,13570.0,11,13580.0,3,B
2018-04-13 21:13:49,13570.0,10,1064,6,13570.0,8,13580.0,3,S
2018-04-13 21:13:53,13570.0,2,1066,0,13570.0,7,13580.0,4,S
2018-04-13 21:13:55,13580.0,4,1070,0,13575.0,1,13580.0,3,B
2018-04-13 21:13:56,13575.0,2,1072,2,13570.0,6,13580.0,3,S
2018-04-13 21:13:56,13570.0,2,1074,2,13570.0,5,13575.0,1,S
2018-04-13 21:14:08,13575.0,2,1076,0,13575.0,1,13580.0,3,B
2018-04-13 21:14:08,13575.0,8,1084,2,13570.0,6,13580.0,1,B
2018-04-13 21:14:09,13570.0,6,1090,4,13580.0,2,13585.0,13,S
2018-04-13 21:14:09,13575.0,6,1096,4,13570.0,18,13575.0,1,B
2018-04-13 21:14:10,13575.0,6,1102,4,13575.0,7,13580.0,1,B
2018-04-13 21:14:26,13580.0,2,1104,0,13575.0,7,13585.0,11,B
2018-04-13 21:14:44,13585.0,2,1106,0,13575.0,8,13585.0,10,B
2018-04-13 21:14:51,13575.0,4,1110,2,13575.0,3,13580.0,2,S
2018-04-13 21:14:51,13570.0,4,1114,4,13570.0,36,13580.0,3,S
2018-04-13 21:14:52,13570.0,2,1116,2,13570.0,26,13580.0,3,S
2018-04-13 21:14:53,13570.0,2,1118,2,13570.0,26,13580.0,4,S
2018-04-13 21:14:58,13580.0,4,1122,2,13570.0,26,13580.0,3,B
2018-04-13 21:15:09,13570.0,8,1130,0,13565.0,22,13570.0,1,S
2018-04-13 21:15:09,13570.0,4,1134,2,13570.0,1,13575.0,2,S
2018-04-13 21:15:10,13565.0,2,1136,2,13565.0,25,13575.0,2,S
2018-04-13 21:15:10,13565.0,2,1138,2,13565.0,24,13575.0,2,S
2018-04-13 21:15:13,13575.0,4,1142,4,13575.0,2,13580.0,24,B
2018-04-13 21:15:14,13575.0,2,1144,2,13575.0,3,13580.0,9,B
2018-04-13 21:15:14,13575.0,4,1148,4,13575.0,1,13580.0,4,B
2018-04-13 21:15:15,13580.0,10,1158,4,13580.0,3,13585.0,18,B
2018-04-13 21:15:15,13580.0,2,1160,2,13580.0,2,13585.0,6,B
2018-04-13 21:15:16,13580.0,4,1164,4,13575.0,3,13585.0,4,B
2018-04-13 21:15:16,13575.0,2,1166,0,13575.0,2,13585.0,4,S
2018-04-13 21:15:18,13570.0,4,1170,2,13570.0,16,13580.0,3,S
2018-04-13 21:15:19,13570.0,2,1172,0,13570.0,16,13580.0,4,S
2018-04-13 21:15:21,13570.0,2,1174,0,13570.0,16,13580.0,4,S
2018-04-13 21:15:34,13570.0,2,1176,2,13570.0,5,13580.0,6,S
2018-04-13 21:15:44,13570.0,6,1182,4,13570.0,12,13580.0,6,S
2018-04-13 21:15:49,13575.0,2,1184,0,13575.0,1,13580.0,5,B
2018-04-13 21:15:50,13575.0,2,1186,2,13570.0,13,13580.0,5,B
2018-04-13 21:15:50,13570.0,2,1188,2,13570.0,12,13580.0,4,S
2018-04-13 21:15:55,13570.0,2,1190,0,13570.0,11,13580.0,5,S
2018-04-13 21:16:02,13575.0,4,1194,0,13575.0,1,13580.0,2,B
2018-04-13 21:16:13,13575.0,2,1196,0,13575.0,2,13580.0,2,B
2018-04-13 21:16:15,13570.0,4,1200,0,13570.0,26,13580.0,6,S
2018-04-13 21:16:16,13570.0,2,1202,0,13570.0,15,13580.0,5,S
2018-04-13 21:16:35,13570.0,2,1204,0,13570.0,19,13580.0,7,S
2018-04-13 21:16:35,13570.0,2,1206,0,13570.0,18,13580.0,7,S
2018-04-13 21:16:43,13570.0,2,1208,2,13570.0,18,13580.0,7,S
2018-04-13 21:16:44,13570.0,2,1210,0,13570.0,15,13580.0,7,S
2018-04-13 21:16:59,13570.0,2,1212,-2,13570.0,31,13580.0,4,S
2018-04-13 21:17:20,13575.0,2,1214,2,13570.0,29,13580.0,5,B
2018-04-13 21:17:55,13570.0,4,1218,0,13570.0,41,13575.0,3,S
2018-04-13 21:17:55,13570.0,4,1222,0,13570.0,25,13575.0,3,S
2018-04-13 21:17:56,13570.0,2,1224,0,13570.0,7,13575.0,17,S
2018-04-13 21:18:00,13570.0,4,1228,-2,13570.0,4,13575.0,7,S
2018-04-13 21:18:01,13570.0,8,1236,2,13565.0,19,13575.0,7,S
2018-04-13 21:18:04,13570.0,2,1238,0,13565.0,2,13570.0,6,S
2018-04-13 21:18:05,13565.0,4,1242,2,13560.0,25,13570.0,6,S
2018-04-13 21:18:12,13565.0,2,1244,2,13560.0,5,13565.0,4,S
2018-04-13 21:18:12,13560.0,8,1252,-4,13560.0,1,13565.0,6,S
2018-04-13 21:18:13,13555.0,4,1256,-4,13555.0,2,13560.0,4,S
2018-04-13 21:18:13,13550.0,2,1258,-2,13550.0,16,13560.0,3,S
2018-04-13 21:18:14,13550.0,2,1260,-2,13550.0,19,13560.0,5,S
2018-04-13 21:18:14,13550.0,2,1262,-2,13550.0,18,13560.0,6,S
2018-04-13 21:18:15,13550.0,4,1266,-2,13550.0,10,13555.0,7,S
2018-04-13 21:18:16,13550.0,20,1286,-10,13545.0,19,13555.0,8,S
2018-04-13 21:18:17,13540.0,10,1296,-4,13535.0,6,13545.0,5,S
2018-04-13 21:18:18,13540.0,10,1306,-2,13535.0,1,13540.0,3,S
2018-04-13 21:18:18,13535.0,2,1308,-2,13530.0,13,13535.0,1,S
2018-04-13 21:18:19,13535.0,6,1314,-2,13535.0,19,13545.0,8,S
2018-04-13 21:18:19,13545.0,8,1322,4,13535.0,12,13550.0,13,B
2018-04-13 21:18:20,13535.0,6,1328,-2,13535.0,13,13545.0,1,S
2018-04-13 21:18:20,13535.0,2,1330,2,13535.0,6,13545.0,9,S
2018-04-13 21:18:21,13535.0,8,1338,6,13535.0,2,13545.0,13,S
2018-04-13 21:18:23,13535.0,4,1342,2,13530.0,10,13535.0,5,S
2018-04-13 21:18:24,13535.0,24,1366,-2,13525.0,3,13530.0,5,S
2018-04-13 21:18:24,13525.0,2,1368,0,13525.0,2,13530.0,4,S
2018-04-13 21:18:25,13530.0,4,1372,-4,13525.0,3,13535.0,12,B
2018-04-13 21:18:25,13530.0,6,1378,0,13525.0,1,13530.0,8,B
2018-04-13 21:18:27,13525.0,2,1380,0,13520.0,7,13530.0,8,S
2018-04-13 21:18:27,13510.0,18,1398,4,13510.0,5,13520.0,3,S
2018-04-13 21:18:28,13500.0,26,1424,18,13490.0,3,13495.0,1,S
2018-04-13 21:18:28,13510.0,12,1436,2,13500.0,1,13510.0,2,B
2018-04-13 21:18:29,13515.0,10,1446,-4,13505.0,3,13515.0,9,B
2018-04-13 21:18:29,13515.0,14,1460,8,13505.0,3,13515.0,3,B
2018-04-13 21:18:31,13505.0,10,1470,-10,13500.0,18,13505.0,10,S
2018-04-13 21:18:31,13500.0,12,1482,-6,13500.0,8,13505.0,5,S
2018-04-13 21:18:32,13505.0,10,1492,-10,13500.0,20,13515.0,9,B
2018-04-13 21:18:32,13515.0,8,1500,6,13505.0,8,13515.0,2,B
2018-04-13 21:18:33,13510.0,4,1504,-4,13505.0,11,13520.0,3,S
2018-04-13 21:18:36,13525.0,2,1506,0,13520.0,6,13530.0,2,B
2018-04-13 21:18:37,13530.0,2,1508,0,13530.0,9,13535.0,2,B
2018-04-13 21:18:38,13530.0,6,1514,-2,13530.0,6,13535.0,9,B
2018-04-13 21:18:40,13535.0,4,1518,0,13535.0,2,13540.0,3,B
2018-04-13 21:18:44,13535.0,2,1520,0,13530.0,9,13540.0,6,B
2018-04-13 21:18:44,13530.0,2,1522,-2,13530.0,9,13540.0,6,S
2018-04-13 21:18:50,13530.0,2,1524,0,13530.0,4,13535.0,5,S
2018-04-13 21:18:50,13535.0,8,1532,-4,13530.0,2,13535.0,8,B
2018-04-13 21:18:51,13530.0,4,1536,-4,13525.0,9,13535.0,8,S
2018-04-13 21:18:52,13525.0,4,1540,4,13520.0,9,13530.0,4,S
2018-04-13 21:18:53,13525.0,2,1542,0,13520.0,6,13525.0,1,S
2018-04-13 21:18:55,13520.0,2,1544,0,13520.0,6,13530.0,9,S
2018-04-13 21:18:56,13525.0,4,1548,0,13520.0,3,13525.0,2,B
2018-04-13 21:18:57,13520.0,6,1554,-4,13515.0,4,13525.0,4,S
2018-04-13 21:18:59,13525.0,2,1556,0,13515.0,8,13525.0,2,B
2018-04-13 21:18:59,13520.0,2,1558,0,13520.0,1,13530.0,3,S
2018-04-13 21:19:10,13535.0,4,1562,0,13530.0,5,13540.0,5,B
2018-04-13 21:19:11,13530.0,8,1570,-4,13530.0,1,13535.0,4,S
2018-04-13 21:19:12,13525.0,2,1572,2,13525.0,5,13535.0,3,S
2018-04-13 21:19:19,13535.0,2,1574,-2,13525.0,5,13535.0,7,B
2018-04-13 21:19:20,13535.0,2,1576,-2,13525.0,5,13535.0,6,B
2018-04-13 21:19:21,13535.0,2,1578,0,13525.0,5,13535.0,5,B
2018-04-13 21:19:27,13530.0,2,1580,2,13525.0,6,13535.0,2,S
2018-04-13 21:19:34,13520.0,14,1594,8,13525.0,1,13530.0,16,S
2018-04-13 21:19:34,13525.0,2,1596,-2,13520.0,8,13525.0,3,B
2018-04-13 21:19:36,13525.0,2,1598,2,13520.0,6,13525.0,7,B
2018-04-13 21:19:38,13525.0,2,1600,2,13520.0,6,13525.0,6,B
2018-04-13 21:19:38,13525.0,2,1602,0,13520.0,6,13525.0,5,B
2018-04-13 21:19:39,13525.0,4,1606,0,13520.0,6,13525.0,3,B
2018-04-13 21:19:40,13520.0,12,1618,6,13515.0,5,13525.0,3,S
2018-04-13 21:19:44,13520.0,4,1622,0,13520.0,5,13525.0,10,S
2018-04-13 21:19:46,13520.0,4,1626,-2,13520.0,1,13525.0,6,S
2018-04-13 21:19:46,13525.0,26,1652,-18,13525.0,2,13530.0,13,B
2018-04-13 21:19:47,13525.0,4,1656,0,13520.0,3,13525.0,1,B
2018-04-13 21:19:47,13520.0,4,1660,0,13520.0,1,13525.0,1,S
2018-04-13 21:19:48,13525.0,2,1662,2,13525.0,3,13530.0,9,B
2018-04-13 21:19:48,13525.0,6,1668,4,13520.0,1,13530.0,11,B
2018-04-13 21:19:49,13515.0,8,1676,2,13515.0,3,13520.0,2,S
2018-04-13 21:19:49,13520.0,8,1684,2,13520.0,2,13525.0,1,B
2018-04-13 21:19:50,13520.0,4,1688,0,13515.0,6,13530.0,11,B
2018-04-13 21:19:50,13515.0,4,1692,2,13515.0,4,13530.0,13,S
2018-04-13 21:19:51,13515.0,4,1696,2,13515.0,2,13530.0,15,S
2018-04-13 21:19:51,13515.0,4,1700,4,13520.0,1,13525.0,1,S
2018-04-13 21:19:52,13525.0,4,1704,0,13520.0,8,13530.0,8,B
2018-04-13 21:19:52,13520.0,4,1708,2,13520.0,7,13530.0,3,S
2018-04-13 21:19:53,13530.0,6,1714,2,13520.0,6,13530.0,2,B
2018-04-13 21:19:53,13520.0,4,1718,0,13520.0,4,13530.0,3,S
2018-04-13 21:19:54,13520.0,6,1724,2,13520.0,1,13530.0,3,S
2018-04-13 21:19:54,13520.0,4,1728,0,13520.0,4,13530.0,5,S
2018-04-13 21:19:55,13520.0,4,1732,0,13520.0,2,13530.0,5,S
2018-04-13 21:19:56,13520.0,12,1744,2,13515.0,7,13530.0,5,S
2018-04-13 21:19:56,13520.0,2,1746,2,13515.0,6,13530.0,4,S
2018-04-13 21:19:57,13520.0,2,1748,2,13515.0,9,13530.0,6,S
2018-04-13 21:19:58,13530.0,4,1752,2,13520.0,1,13530.0,6,B
2018-04-13 21:20:01,13530.0,2,1754,0,13525.0,1,13530.0,6,B
2018-04-13 21:20:05,13530.0,2,1756,2,13525.0,4,13530.0,1,B
2018-04-13 21:20:05,13530.0,2,1758,2,13525.0,7,13535.0,7,B
2018-04-13 21:20:06,13530.0,2,1760,2,13530.0,1,13535.0,4,B
2018-04-13 21:20:07,13525.0,4,1764,2,13525.0,6,13535.0,4,S
2018-04-13 21:20:07,13525.0,2,1766,0,13525.0,5,13535.0,7,S
2018-04-13 21:20:11,13525.0,4,1770,0,13525.0,11,13535.0,6,S
2018-04-13 21:20:11,13525.0,2,1772,0,13525.0,5,13535.0,9,S
2018-04-13 21:20:17,13525.0,8,1780,6,13525.0,8,13535.0,8,S
2018-04-13 21:20:18,13525.0,2,1782,2,13525.0,4,13535.0,8,S
2018-04-13 21:20:21,13525.0,2,1784,0,13520.0,3,13530.0,4,S
2018-04-13 21:20:22,13520.0,2,1786,2,13520.0,3,13525.0,3,S
2018-04-13 21:20:29,13525.0,6,1792,0,13525.0,1,13530.0,8,B
2018-04-13 21:20:30,13525.0,2,1794,2,13520.0,4,13530.0,10,B
2018-04-13 21:20:30,13520.0,2,1796,2,13520.0,3,13530.0,10,S
2018-04-13 21:20:33,13525.0,2,1798,0,13525.0,14,13530.0,10,B
2018-04-13 21:20:34,13525.0,2,1800,2,13525.0,13,13530.0,10,B
2018-04-13 21:20:34,13525.0,8,1808,8,13525.0,9,13530.0,11,B
2018-04-13 21:20:35,13525.0,4,1812,4,13525.0,7,13530.0,10,B
2018-04-13 21:20:44,13530.0,4,1816,-2,13525.0,9,13535.0,10,B
2018-04-13 21:20:58,13525.0,2,1818,2,13525.0,6,13530.0,12,S
2018-04-13 21:20:58,13525.0,8,1826,4,13525.0,2,13530.0,12,S
2018-04-13 21:20:59,13525.0,4,1830,4,13520.0,23,13530.0,12,S
2018-04-13 21:20:59,13520.0,2,1832,2,13520.0,22,13530.0,12,S
2018-04-13 21:21:00,13520.0,8,1840,8,13520.0,2,13530.0,12,S
2018-04-13 21:21:03,13515.0,2,1842,2,13515.0,37,13525.0,4,S
2018-04-13 21:21:10,13515.0,4,1846,0,13515.0,17,13525.0,10,S
2018-04-13 21:21:11,13515.0,2,1848,2,13515.0,6,13520.0,1,S
2018-04-13 21:21:11,13515.0,4,1852,4,13515.0,4,13520.0,5,S
2018-04-13 21:21:15,13515.0,2,1854,2,13515.0,8,13520.0,7,S
2018-04-13 21:21:21,13515.0,2,1856,2,13515.0,8,13520.0,7,S
2018-04-13 21:21:24,13520.0,10,1866,4,13520.0,9,13525.0,7,B
2018-04-13 21:21:32,13530.0,4,1870,0,13525.0,6,13530.0,2,B
2018-04-13 21:21:34,13525.0,4,1874,2,13520.0,23,13530.0,11,S
2018-04-13 21:21:41,13530.0,2,1876,2,13520.0,5,13530.0,14,B
2018-04-13 21:21:48,13530.0,2,1878,0,13525.0,4,13535.0,10,B
2018-04-13 21:22:04,13530.0,8,1886,0,13530.0,1,13535.0,4,B
2018-04-13 21:22:08,13530.0,2,1888,0,13525.0,18,13535.0,7,B
2018-04-13 21:22:12,13535.0,4,1892,2,13530.0,5,13535.0,2,B
2018-04-13 21:22:12,13535.0,4,1896,4,13530.0,5,13540.0,6,B
2018-04-13 21:22:17,13545.0,4,1900,-2,13540.0,9,13545.0,3,B
2018-04-13 21:22:17,13545.0,6,1906,0,13540.0,13,13550.0,5,B
2018-04-13 21:22:18,13550.0,2,1908,2,13550.0,3,13555.0,5,B
2018-04-13 21:22:20,13550.0,2,1910,0,13550.0,4,13555.0,2,B
2018-04-13 21:22:20,13555.0,4,1914,2,13550.0,4,13560.0,6,B
2018-04-13 21:22:22,13555.0,4,1918,4,13550.0,5,13555.0,2,B
2018-04-13 21:22:24,13555.0,2,1920,0,13550.0,5,13560.0,11,B
2018-04-13 21:22:25,13550.0,2,1922,0,13550.0,1,13555.0,3,S
2018-04-13 21:22:27,13550.0,2,1924,-2,13545.0,8,13555.0,10,S
2018-04-13 21:22:29,13545.0,6,1930,-2,13545.0,5,13555.0,10,S
2018-04-13 21:22:31,13555.0,2,1932,-2,13545.0,6,13555.0,7,B
2018-04-13 21:22:33,13555.0,2,1934,0,13545.0,5,13555.0,6,B
2018-04-13 21:22:42,13555.0,2,1936,0,13550.0,1,13555.0,5,B
2018-04-13 21:22:46,13550.0,2,1938,0,13545.0,4,13555.0,3,S
2018-04-13 21:22:59,13555.0,8,1946,4,13545.0,5,13555.0,2,B
2018-04-13 21:23:02,13545.0,2,1948,0,13545.0,6,13555.0,6,S
2018-04-13 21:23:11,13555.0,4,1952,-2,13555.0,4,13560.0,8,B
2018-04-13 21:23:13,13555.0,6,1958,6,13555.0,1,13560.0,8,B
2018-04-13 21:23:13,13560.0,2,1960,-2,13555.0,2,13560.0,7,B
2018-04-13 21:23:14,13555.0,4,1964,-2,13550.0,12,13560.0,8,S
2018-04-13 21:23:20,13550.0,2,1966,-2,13550.0,1,13555.0,5,S
2018-04-13 21:23:22,13550.0,2,1968,-2,13545.0,5,13555.0,6,S
2018-04-13 21:23:27,13545.0,2,1970,2,13545.0,2,13550.0,3,S
2018-04-13 21:23:47,13545.0,2,1972,0,13540.0,21,13550.0,3,S
2018-04-13 21:23:51,13545.0,4,1976,-4,13535.0,23,13545.0,4,S
2018-04-13 21:23:52,13535.0,2,1978,2,13535.0,6,13545.0,8,S
2018-04-13 21:24:02,13530.0,4,1982,4,13530.0,8,13540.0,7,S
2018-04-13 21:24:02,13530.0,2,1984,2,13530.0,9,13540.0,10,S
2018-04-13 21:24:10,13535.0,2,1986,0,13530.0,6,13540.0,11,B
2018-04-13 21:24:11,13530.0,4,1990,-2,13530.0,7,13540.0,11,S
2018-04-13 21:24:33,13535.0,4,1994,2,13530.0,24,13540.0,2,B
2018-04-13 21:24:39,13535.0,4,1998,4,13530.0,30,13540.0,3,B
2018-04-13 21:25:08,13540.0,2,2000,2,13540.0,3,13545.0,18,B
2018-04-13 21:25:11,13545.0,4,2004,2,13540.0,1,13545.0,1,B
2018-04-13 21:25:28,13545.0,4,2008,0,13540.0,3,13550.0,19,B
2018-04-13 21:25:34,13550.0,8,2016,-6,13545.0,1,13550.0,2,B
2018-04-13 21:25:46,13545.0,2,2018,2,13540.0,5,13550.0,5,S
2018-04-13 21:26:10,13540.0,6,2024,6,13540.0,4,13550.0,4,S
2018-04-13 21:26:51,13540.0,8,2032,-6,13540.0,3,13550.0,6,S
2018-04-13 21:26:53,13540.0,6,2038,0,13535.0,18,13540.0,3,S
2018-04-13 21:26:54,13540.0,6,2044,0,13535.0,23,13545.0,4,S
2018-04-13 21:27:16,13530.0,8,2052,-4,13530.0,8,13535.0,2,S
2018-04-13 21:27:22,13530.0,4,2056,0,13530.0,3,13535.0,6,S
2018-04-13 21:27:31,13540.0,2,2058,0,13535.0,1,13540.0,4,B
2018-04-13 21:27:51,13535.0,2,2060,0,13535.0,3,13540.0,4,S
2018-04-13 21:27:56,13540.0,4,2064,2,13540.0,2,13545.0,21,B
2018-04-13 21:27:56,13540.0,4,2068,4,13535.0,3,13545.0,23,B
2018-04-13 21:28:16,13540.0,2,2070,0,13535.0,1,13540.0,4,B
2018-04-13 21:28:18,13540.0,2,2072,0,13535.0,1,13540.0,3,B
2018-04-13 21:28:25,13540.0,2,2074,-2,13535.0,2,13540.0,2,B
2018-04-13 21:28:35,13540.0,2,2076,-2,13535.0,2,13540.0,2,B
2018-04-13 21:28:41,13535.0,2,2078,0,13535.0,2,13540.0,2,S
2018-04-13 21:28:41,13535.0,4,2082,0,13535.0,1,13540.0,2,S
2018-04-13 21:28:43,13530.0,2,2084,0,13530.0,5,13540.0,21,S
2018-04-13 21:28:48,13530.0,2,2086,2,13530.0,4,13540.0,20,S
2018-04-13 21:28:49,13530.0,4,2090,2,13530.0,2,13540.0,20,S
2018-04-13 21:28:49,13530.0,2,2092,0,13530.0,2,13535.0,1,S
2018-04-13 21:28:50,13530.0,2,2094,2,13530.0,2,13535.0,1,S
2018-04-13 21:28:52,13530.0,2,2096,0,13530.0,2,13540.0,20,S
2018-04-13 21:28:56,13530.0,2,2098,2,13530.0,1,13535.0,1,S
2018-04-13 21:28:56,13525.0,4,2102,2,13525.0,4,13535.0,1,S
2018-04-13 21:28:57,13535.0,4,2106,0,13530.0,1,13535.0,4,B
2018-04-13 21:28:57,13530.0,2,2108,2,13525.0,18,13535.0,4,S
2018-04-13 21:29:03,13535.0,2,2110,0,13525.0,21,13535.0,5,B
2018-04-13 21:29:11,13535.0,4,2114,2,13530.0,20,13535.0,1,B
2018-04-13 21:29:15,13535.0,2,2116,2,13530.0,24,13540.0,6,B
2018-04-13 21:29:42,13540.0,4,2120,-2,13530.0,25,13540.0,3,B
2018-04-13 21:29:44,13535.0,2,2122,0,13530.0,24,13540.0,2,S
2018-04-13 21:29:45,13530.0,2,2124,0,13530.0,23,13540.0,3,S
2018-04-13 21:29:48,13530.0,2,2126,0,13530.0,3,13540.0,20,S
2018-04-13 21:29:49,13530.0,4,2130,0,13525.0,35,13540.0,20,S
2018-04-13 21:29:55,13530.0,10,2140,-2,13530.0,23,13535.0,7,S
2018-04-13 21:29:55,13535.0,4,2144,-4,13530.0,31,13535.0,3,B
2018-04-13 21:30:02,13535.0,6,2150,0,13535.0,1,13540.0,8,B
2018-04-13 21:30:29,13540.0,4,2154,2,13535.0,3,13540.0,4,B
2018-04-13 21:30:37,13540.0,8,2162,2,13535.0,4,13545.0,10,B
2018-04-13 21:30:41,13540.0,2,2164,0,13535.0,4,13540.0,1,B
2018-04-13 21:30:57,13535.0,2,2166,2,13535.0,3,13540.0,1,S
2018-04-13 21:30:57,13540.0,4,2170,-2,13535.0,3,13545.0,22,B
2018-04-13 21:31:21,13535.0,6,2176,-2,13535.0,5,13540.0,1,S
2018-04-13 21:31:22,13535.0,2,2178,2,13530.0,20,13540.0,2,S
2018-04-13 21:31:29,13535.0,10,2188,6,13535.0,1,13540.0,1,S
2018-04-13 21:31:39,13535.0,2,2190,0,13530.0,21,13540.0,4,S
2018-04-13 21:31:44,13530.0,4,2194,0,13530.0,22,13540.0,4,S
2018-04-13 21:32:06,13530.0,2,2196,0,13530.0,19,13535.0,1,S
2018-04-13 21:32:16,13535.0,2,2198,0,13530.0,18,13535.0,1,B
2018-04-13 21:32:40,13540.0,8,2206,2,13530.0,22,13540.0,2,B
2018-04-13 21:32:42,13540.0,2,2208,-2,13535.0,9,13540.0,2,B
2018-04-13 21:32:47,13535.0,2,2210,0,13535.0,8,13540.0,2,S
2018-04-13 21:33:32,13545.0,8,2218,4,13540.0,1,13545.0,4,B
2018-04-13 21:33:33,13545.0,8,2226,6,13540.0,8,13550.0,4,B
2018-04-13 21:33:40,13550.0,2,2228,0,13540.0,15,13550.0,2,B
2018-04-13 21:33:42,13550.0,2,2230,2,13550.0,3,13555.0,2,B
2018-04-13 21:33:42,13550.0,4,2234,4,13550.0,1,13555.0,3,B
2018-04-13 21:33:43,13550.0,2,2236,2,13545.0,12,13555.0,5,B
2018-04-13 21:33:43,13545.0,4,2240,4,13545.0,13,13555.0,5,S
2018-04-13 21:33:49,13545.0,6,2246,2,13545.0,9,13555.0,2,S
2018-04-13 21:33:50,13545.0,2,2248,2,13545.0,11,13555.0,2,S
2018-04-13 21:33:53,13545.0,2,2250,0,13540.0,9,13550.0,15,S
2018-04-13 21:33:54,13540.0,4,2254,0,13540.0,9,13550.0,3,S
2018-04-13 21:35:41,13540.0,2,2256,0,13540.0,12,13545.0,5,S
2018-04-13 21:35:52,13545.0,2,2258,0,13540.0,12,13545.0,4,B
2018-04-13 21:35:53,13545.0,4,2262,0,13540.0,10,13545.0,2,B
2018-04-13 21:36:09,13540.0,2,2264,0,13540.0,12,13545.0,3,S
2018-04-13 21:36:19,13545.0,6,2270,0,13540.0,12,13550.0,7,B
2018-04-13 21:36:23,13550.0,4,2274,4,13540.0,12,13550.0,3,B
2018-04-13 21:36:35,13550.0,4,2278,-2,13540.0,13,13550.0,15,B
2018-04-13 21:36:41,13550.0,4,2282,0,13540.0,13,13550.0,2,B
2018-04-13 21:36:46,13540.0,2,2284,0,13540.0,5,13545.0,1,S
2018-04-13 21:36:46,13540.0,2,2286,0,13540.0,2,13545.0,2,S
2018-04-13 21:36:47,13535.0,8,2294,2,13535.0,10,13545.0,2,S
2018-04-13 21:36:49,13535.0,2,2296,2,13535.0,14,13545.0,3,S
2018-04-13 21:36:53,13535.0,10,2306,2,13535.0,7,13545.0,3,S
2018-04-13 21:36:54,13535.0,2,2308,0,13535.0,9,13545.0,3,S
2018-04-13 21:37:45,13545.0,2,2310,0,13535.0,12,13545.0,4,B
2018-04-13 21:38:13,13540.0,2,2312,0,13535.0,11,13545.0,4,S
2018-04-13 21:38:13,13540.0,2,2314,2,13535.0,11,13545.0,4,S
2018-04-13 21:38:19,13535.0,2,2316,0,13535.0,13,13545.0,4,S
2018-04-13 21:38:52,13535.0,10,2326,2,13535.0,6,13545.0,8,S
2018-04-13 21:38:53,13535.0,8,2334,4,13535.0,7,13545.0,8,S
2018-04-13 21:38:54,13535.0,2,2336,2,13535.0,7,13545.0,11,S
2018-04-13 21:39:24,13540.0,2,2338,0,13535.0,6,13540.0,1,B
2018-04-13 21:39:24,13540.0,2,2340,2,13540.0,8,13545.0,6,B
2018-04-13 21:39:30,13540.0,2,2342,2,13540.0,15,13545.0,2,B
2018-04-13 21:39:49,13545.0,8,2350,4,13540.0,15,13545.0,4,B
2018-04-13 21:39:49,13545.0,8,2358,-2,13545.0,3,13550.0,6,B
2018-04-13 21:39:55,13545.0,2,2360,0,13545.0,11,13550.0,3,B
2018-04-13 21:40:07,13540.0,4,2364,4,13540.0,12,13550.0,17,S
2018-04-13 21:40:07,13540.0,2,2366,2,13540.0,12,13550.0,20,S
2018-04-13 21:40:22,13545.0,4,2370,-4,13540.0,19,13545.0,3,B
2018-04-13 21:40:45,13535.0,26,2396,-8,13535.0,5,13540.0,3,S
2018-04-13 21:40:46,13535.0,2,2398,0,13535.0,3,13540.0,2,S
2018-04-13 21:40:57,13540.0,2,2400,-2,13535.0,3,13540.0,1,B
2018-04-13 21:41:00,13540.0,2,2402,-2,13535.0,3,13545.0,22,B
2018-04-13 21:41:51,13540.0,2,2404,-2,13535.0,3,13540.0,7,B
2018-04-13 21:41:55,13535.0,4,2408,0,13535.0,1,13540.0,7,S
2018-04-13 21:42:16,13540.0,2,2410,0,13535.0,1,13540.0,9,B
2018-04-13 21:42:28,13540.0,2,2412,-2,13535.0,3,13540.0,8,B
2018-04-13 21:42:41,13540.0,4,2416,0,13535.0,16,13540.0,4,B
2018-04-13 21:42:55,13540.0,4,2420,-4,13535.0,18,13540.0,2,B
2018-04-13 21:43:09,13535.0,2,2422,2,13535.0,17,13540.0,4,S
2018-04-13 21:43:22,13540.0,4,2426,-2,13535.0,17,13540.0,1,B
2018-04-13 21:43:25,13535.0,2,2428,0,13535.0,16,13540.0,8,S
2018-04-13 21:43:25,13535.0,2,2430,0,13535.0,15,13540.0,10,S
2018-04-13 21:43:32,13540.0,4,2434,0,13535.0,15,13540.0,11,B
2018-04-13 21:43:44,13540.0,2,2436,-2,13535.0,15,13540.0,10,B
2018-04-13 21:44:07,13535.0,2,2438,0,13535.0,15,13540.0,7,S
2018-04-13 21:44:09,13535.0,8,2446,-4,13535.0,11,13540.0,10,S
2018-04-13 21:44:10,13535.0,4,2450,0,13535.0,9,13540.0,23,S
2018-04-13 21:44:11,13535.0,8,2458,0,13535.0,5,13540.0,24,S
2018-04-13 21:44:11,13535.0,10,2468,4,13530.0,13,13535.0,3,S
2018-04-13 21:44:12,13530.0,2,2470,0,13530.0,12,13535.0,1,S
2018-04-13 21:44:19,13530.0,2,2472,2,13530.0,8,13535.0,5,S
2018-04-13 21:44:39,13535.0,2,2474,0,13530.0,9,13535.0,3,B
2018-04-13 21:45:16,13530.0,2,2476,2,13530.0,8,13535.0,3,S
2018-04-13 21:45:17,13530.0,4,2480,4,13530.0,6,13535.0,3,S
2018-04-13 21:45:18,13530.0,8,2488,2,13530.0,2,13535.0,3,S
2018-04-13 21:45:18,13530.0,2,2490,2,13530.0,2,13535.0,3,S
2018-04-13 21:45:20,13525.0,12,2502,6,13525.0,3,13535.0,3,S
2018-04-13 21:45:21,13525.0,2,2504,0,13530.0,6,13540.0,4,S
2018-04-13 21:46:03,13535.0,2,2506,0,13530.0,5,13535.0,1,B
2018-04-13 21:46:14,13535.0,2,2508,0,13530.0,3,13540.0,5,B
2018-04-13 21:46:29,13535.0,2,2510,0,13535.0,4,13540.0,6,B
2018-04-13 21:46:29,13535.0,2,2512,0,13535.0,3,13540.0,6,B
2018-04-13 21:46:30,13535.0,6,2518,0,13530.0,5,13540.0,6,B
2018-04-13 21:46:30,13530.0,2,2520,0,13530.0,4,13540.0,6,S
2018-04-13 21:46:46,13540.0,2,2522,-2,13535.0,6,13540.0,1,B
2018-04-13 21:47:16,13540.0,2,2524,-2,13540.0,4,13545.0,21,B
2018-04-13 21:47:16,13540.0,2,2526,0,13540.0,3,13545.0,20,B
2018-04-13 21:47:17,13540.0,4,2530,0,13540.0,1,13545.0,23,B
2018-04-13 21:47:17,13535.0,4,2534,2,13535.0,7,13545.0,11,S
2018-04-13 21:47:18,13535.0,2,2536,0,13535.0,6,13545.0,12,S
2018-04-13 21:47:44,13535.0,4,2540,2,13535.0,7,13540.0,2,S
2018-04-13 21:47:45,13535.0,2,2542,0,13535.0,6,13545.0,12,S
2018-04-13 21:48:06,13535.0,2,2544,0,13535.0,5,13540.0,1,S
2018-04-13 21:48:22,13535.0,8,2552,-8,13535.0,2,13540.0,10,S
2018-04-13 21:48:22,13535.0,4,2556,-4,13530.0,1,13535.0,6,S
2018-04-13 21:48:23,13530.0,2,2558,-2,13525.0,6,13535.0,3,S
2018-04-13 21:48:30,13530.0,2,2560,-2,13530.0,4,13535.0,7,S
2018-04-13 21:48:34,13535.0,2,2562,-2,13530.0,6,13540.0,8,B
2018-04-13 21:49:10,13535.0,2,2564,-2,13535.0,4,13540.0,10,B
2018-04-13 21:49:11,13535.0,6,2570,0,13535.0,1,13540.0,10,B
2018-04-13 21:49:12,13530.0,6,2576,0,13530.0,9,13540.0,10,S
2018-04-13 21:49:14,13530.0,2,2578,0,13530.0,8,13540.0,10,S
2018-04-13 21:49:38,13540.0,20,2598,10,13530.0,13,13540.0,2,B
2018-04-13 21:49:54,13535.0,2,2600,0,13530.0,16,13535.0,1,S
2018-04-13 21:49:56,13535.0,2,2602,2,13530.0,16,13540.0,5,S
2018-04-13 21:50:00,13530.0,2,2604,0,13530.0,15,13540.0,5,S
2018-04-13 21:50:06,13530.0,2,2606,2,13530.0,15,13540.0,5,S
2018-04-13 21:50:06,13530.0,4,2610,0,13530.0,13,13540.0,5,S
2018-04-13 21:50:10,13540.0,4,2614,4,13535.0,5,13545.0,10,B
2018-04-13 21:52:44,13530.0,6,2620,2,13530.0,20,13540.0,6,S
2018-04-13 21:52:44,13530.0,6,2626,0,13530.0,16,13540.0,6,S
2018-04-13 21:53:14,13535.0,2,2628,0,13530.0,16,13540.0,6,B
2018-04-13 21:53:25,13535.0,2,2630,0,13535.0,4,13540.0,6,B
2018-04-13 21:53:28,13535.0,2,2632,0,13535.0,3,13540.0,6,B
2018-04-13 21:53:29,13535.0,8,2640,0,13535.0,1,13540.0,3,B
2018-04-13 21:53:30,13530.0,6,2646,2,13530.0,13,13540.0,3,S
2018-04-13 21:53:37,13530.0,2,2648,0,13535.0,4,13540.0,7,S
2018-04-13 21:55:04,13540.0,4,2652,0,13535.0,5,13540.0,1,B
2018-04-13 21:55:19,13540.0,2,2654,0,13540.0,10,13545.0,9,B
2018-04-13 21:55:31,13540.0,2,2656,0,13535.0,23,13545.0,4,B
2018-04-13 21:55:48,13540.0,2,2658,0,13540.0,5,13545.0,4,B
2018-04-13 21:55:59,13545.0,2,2660,0,13540.0,5,13545.0,3,B
2018-04-13 21:56:08,13545.0,2,2662,-2,13540.0,5,13545.0,2,B
2018-04-13 21:56:11,13545.0,6,2668,-6,13540.0,5,13550.0,10,B
2018-04-13 21:56:11,13550.0,4,2672,2,13545.0,9,13550.0,6,B
2018-04-13 21:56:12,13545.0,2,2674,0,13545.0,6,13550.0,4,S
2018-04-13 21:56:16,13550.0,8,2682,4,13550.0,2,13555.0,7,B
2018-04-13 21:56:42,13555.0,4,2686,0,13550.0,2,13555.0,3,B
2018-04-13 21:56:42,13555.0,4,2690,4,13550.0,2,13555.0,1,B
2018-04-13 21:56:47,13555.0,2,2692,0,13555.0,6,13560.0,7,B
2018-04-13 21:56:48,13560.0,6,2698,0,13560.0,1,13565.0,4,B
2018-04-13 21:56:49,13565.0,4,2702,2,13565.0,1,13570.0,4,B
2018-04-13 21:56:49,13565.0,14,2716,2,13565.0,4,13575.0,3,B
2018-04-13 21:56:50,13560.0,6,2722,4,13560.0,1,13570.0,2,S
2018-04-13 21:56:51,13560.0,2,2724,0,13560.0,20,13570.0,2,S
2018-04-13 21:56:51,13570.0,2,2726,2,13565.0,1,13570.0,2,B
2018-04-13 21:56:53,13560.0,2,2728,2,13560.0,6,13570.0,9,S
2018-04-13 21:56:55,13560.0,2,2730,2,13565.0,1,13570.0,5,S
2018-04-13 21:56:58,13565.0,2,2732,-2,13560.0,6,13570.0,9,B
2018-04-13 21:57:01,13565.0,2,2734,-2,13560.0,6,13570.0,9,B
2018-04-13 21:57:05,13570.0,6,2740,-4,13570.0,3,13575.0,6,B
2018-04-13 21:57:05,13570.0,6,2746,0,13565.0,36,13570.0,7,B
2018-04-13 21:57:06,13570.0,4,2750,0,13565.0,35,13570.0,5,B
2018-04-13 21:57:07,13565.0,2,2752,0,13560.0,19,13565.0,7,S
2018-04-13 21:57:08,13560.0,2,2754,2,13555.0,19,13565.0,6,S
2018-04-13 21:57:11,13560.0,2,2756,2,13560.0,2,13565.0,6,S
2018-04-13 21:57:16,13560.0,2,2758,0,13560.0,2,13565.0,4,S
2018-04-13 21:57:19,13560.0,2,2760,2,13560.0,3,13565.0,4,S
2018-04-13 21:57:20,13560.0,2,2762,2,13555.0,23,13565.0,4,S
2018-04-13 21:57:31,13560.0,2,2764,-2,13555.0,21,13560.0,4,S
2018-04-13 21:57:32,13560.0,2,2766,-2,13555.0,9,13560.0,3,S
2018-04-13 21:57:37,13555.0,4,2770,-2,13555.0,7,13560.0,3,S
2018-04-13 21:57:40,13560.0,2,2772,-2,13555.0,4,13560.0,2,B
2018-04-13 21:57:49,13555.0,2,2774,0,13555.0,3,13560.0,2,S
2018-04-13 21:57:52,13555.0,2,2776,2,13555.0,2,13560.0,2,S
2018-04-13 21:58:05,13560.0,10,2786,6,13560.0,5,13565.0,6,B
2018-04-13 21:58:09,13560.0,2,2788,0,13560.0,4,13565.0,7,B
2018-04-13 21:58:12,13560.0,8,2796,2,13555.0,4,13565.0,7,B
2018-04-13 21:58:23,13560.0,2,2798,0,13555.0,1,13560.0,2,B
2018-04-13 21:58:25,13560.0,2,2800,2,13550.0,8,13560.0,1,B
2018-04-13 21:58:28,13555.0,2,2802,2,13555.0,1,13560.0,2,S
2018-04-13 22:00:00,13550.0,4,2806,4,13550.0,11,13560.0,8,S
2018-04-13 22:00:32,13555.0,2,2808,2,13555.0,1,13560.0,9,B
2018-04-13 22:01:22,13560.0,14,2822,-8,13560.0,4,13565.0,10,B
2018-04-13 22:01:25,13565.0,12,2834,0,13560.0,1,13565.0,4,B
2018-04-13 22:01:29,13565.0,2,2836,0,13560.0,2,13570.0,5,B
2018-04-13 22:01:31,13570.0,6,2842,-6,13570.0,1,13575.0,6,B
2018-04-13 22:01:31,13570.0,2,2844,0,13565.0,2,13570.0,1,B
2018-04-13 22:01:55,13565.0,2,2846,-2,13560.0,20,13570.0,10,S
2018-04-13 22:02:06,13570.0,2,2848,2,13570.0,1,13575.0,6,B
2018-04-13 22:02:07,13565.0,4,2852,4,13565.0,1,13575.0,6,S
2018-04-13 22:02:07,13565.0,2,2854,0,13565.0,4,13570.0,1,S
2018-04-13 22:03:07,13565.0,4,2858,0,13560.0,6,13570.0,20,S
2018-04-13 22:03:35,13560.0,2,2860,-2,13560.0,1,13565.0,2,S
2018-04-13 22:03:40,13560.0,2,2862,0,13555.0,26,13565.0,5,S
2018-04-13 22:03:45,13555.0,2,2864,2,13555.0,6,13560.0,2,S
2018-04-13 22:03:46,13555.0,2,2866,0,13550.0,21,13560.0,5,S
2018-04-13 22:05:04,13550.0,4,2870,2,13550.0,8,13560.0,9,S
2018-04-13 22:05:29,13550.0,2,2872,2,13550.0,7,13560.0,9,S
2018-04-13 22:05:39,13560.0,2,2874,0,13550.0,21,13560.0,8,B
2018-04-13 22:07:20,13550.0,2,2876,2,13545.0,5,13555.0,2,S
2018-04-13 22:08:08,13545.0,2,2878,2,13545.0,7,13550.0,1,S
2018-04-13 22:08:29,13545.0,4,2882,2,13545.0,3,13550.0,1,S
2018-04-13 22:08:30,13550.0,2,2884,0,13545.0,3,13555.0,5,B
2018-04-13 22:09:00,13550.0,2,2886,2,13550.0,4,13555.0,5,B
2018-04-13 22:10:16,13555.0,2,2888,0,13550.0,10,13560.0,9,B
2018-04-13 22:10:59,13555.0,2,2890,2,13555.0,2,13560.0,8,B
2018-04-13 22:11:46,13555.0,2,2892,0,13555.0,1,13560.0,7,B
2018-04-13 22:11:46,13550.0,10,2902,8,13545.0,29,13555.0,6,S
2018-04-13 22:11:47,13550.0,2,2904,2,13545.0,4,13555.0,3,S
2018-04-13 22:12:41,13555.0,8,2912,6,13555.0,1,13560.0,4,B
2018-04-13 22:12:42,13555.0,2,2914,0,13550.0,3,13555.0,1,B
2018-04-13 22:12:42,13555.0,2,2916,-2,13550.0,2,13560.0,5,B
2018-04-13 22:13:37,13545.0,4,2920,-2,13545.0,7,13555.0,4,S
2018-04-13 22:13:47,13550.0,2,2922,0,13550.0,4,13560.0,8,B
2018-04-13 22:14:00,13555.0,2,2924,0,13555.0,4,13560.0,8,B
2018-04-13 22:14:04,13555.0,2,2926,2,13555.0,3,13560.0,8,B
2018-04-13 22:15:03,13560.0,8,2934,-6,13555.0,22,13565.0,6,B
2018-04-13 22:15:44,13560.0,2,2936,0,13560.0,1,13565.0,2,B
2018-04-13 22:15:48,13560.0,2,2938,0,13555.0,17,13565.0,6,B
2018-04-13 22:16:02,13555.0,4,2942,0,13550.0,5,13560.0,7,S
2018-04-13 22:16:05,13560.0,18,2960,-6,13560.0,1,13565.0,23,B
2018-04-13 22:16:06,13550.0,6,2966,2,13550.0,10,13555.0,3,S
2018-04-13 22:16:07,13550.0,2,2968,2,13550.0,7,13555.0,4,S
2018-04-13 22:16:18,13550.0,2,2970,2,13545.0,12,13555.0,3,S
2018-04-13 22:16:21,13555.0,2,2972,2,13550.0,1,13555.0,1,B
2018-04-13 22:16:25,13550.0,2,2974,2,13550.0,1,13555.0,2,S
2018-04-13 22:16:38,13550.0,2,2976,0,13550.0,1,13555.0,1,S
2018-04-13 22:17:08,13555.0,2,2978,-2,13550.0,7,13560.0,4,B
2018-04-13 22:17:38,13555.0,2,2980,-2,13550.0,6,13560.0,17,B
2018-04-13 22:17:45,13550.0,2,2982,0,13550.0,5,13560.0,17,S
2018-04-13 22:18:02,13555.0,2,2984,0,13550.0,3,13560.0,17,B
2018-04-13 22:19:02,13550.0,58,3042,-16,13545.0,18,13550.0,122,S
2018-04-13 22:19:02,13550.0,12,3054,-6,13545.0,7,13550.0,116,S
2018-04-13 22:19:03,13550.0,2,3056,0,13545.0,11,13550.0,115,S
2018-04-13 22:19:16,13550.0,2,3058,-2,13545.0,9,13550.0,114,S
2018-04-13 22:19:25,13550.0,2,3060,0,13545.0,9,13550.0,113,S
2018-04-13 22:19:27,13545.0,16,3076,12,13545.0,1,13550.0,113,S
2018-04-13 22:19:27,13545.0,4,3080,-4,13545.0,1,13550.0,113,S
2018-04-13 22:19:28,13545.0,2,3082,2,13545.0,3,13550.0,113,S
2018-04-13 22:19:54,13545.0,8,3090,-6,13545.0,14,13550.0,112,S
2018-04-13 22:19:55,13550.0,6,3096,-6,13545.0,14,13550.0,109,B
2018-04-13 22:19:59,13550.0,2,3098,0,13545.0,14,13550.0,108,B
2018-04-13 22:20:01,13550.0,2,3100,0,13545.0,14,13550.0,107,B
2018-04-13 22:20:12,13545.0,2,3102,0,13545.0,14,13550.0,107,S
2018-04-13 22:20:15,13550.0,2,3104,-2,13545.0,14,13550.0,106,B
2018-04-13 22:20:25,13550.0,4,3108,-4,13545.0,3,13550.0,104,B
2018-04-13 22:20:35,13550.0,4,3112,0,13545.0,4,13550.0,102,B
2018-04-13 22:20:37,13550.0,2,3114,-2,13545.0,4,13550.0,101,B
2018-04-13 22:20:54,13545.0,10,3124,-8,13540.0,15,13545.0,1,S
2018-04-13 22:20:54,13545.0,10,3134,4,13545.0,5,13550.0,104,S
2018-04-13 22:20:55,13545.0,10,3144,10,13540.0,1,13545.0,6,S
2018-04-13 22:21:28,13540.0,10,3154,6,13535.0,2,13540.0,6,S
2018-04-13 22:21:37,13540.0,4,3158,0,13540.0,2,13545.0,21,S
2018-04-13 22:21:37,13545.0,4,3162,-2,13540.0,12,13545.0,5,B
2018-04-13 22:21:40,13545.0,2,3164,2,13545.0,1,13550.0,116,B
2018-04-13 22:21:40,13550.0,4,3168,0,13545.0,1,13550.0,117,B
2018-04-13 22:21:41,13545.0,4,3172,2,13540.0,8,13545.0,2,S
2018-04-13 22:21:43,13545.0,2,3174,-2,13540.0,6,13545.0,1,S
2018-04-13 22:22:09,13540.0,2,3176,0,13535.0,7,13540.0,1,S
2018-04-13 22:22:28,13540.0,2,3178,0,13540.0,4,13545.0,7,S
2018-04-13 22:22:29,13540.0,2,3180,0,13540.0,3,13545.0,7,S
2018-04-13 22:22:34,13540.0,8,3188,-2,13535.0,6,13540.0,2,S
2018-04-13 22:22:40,13535.0,2,3190,0,13535.0,2,13540.0,6,S
2018-04-13 22:22:40,13535.0,4,3194,-2,13530.0,11,13535.0,1,S
2018-04-13 22:22:41,13530.0,4,3198,0,13530.0,7,13535.0,1,S
2018-04-13 22:22:45,13530.0,12,3210,2,13530.0,1,13535.0,7,S
2018-04-13 22:22:45,13530.0,2,3212,0,13525.0,10,13530.0,2,S
2018-04-13 22:22:48,13535.0,2,3214,-2,13525.0,12,13535.0,6,B
2018-04-13 22:22:49,13530.0,4,3218,4,13525.0,12,13535.0,7,S
2018-04-13 22:22:50,13525.0,20,3238,18,13520.0,32,13525.0,30,S
2018-04-13 22:22:50,13525.0,16,3254,0,13520.0,9,13525.0,22,S
2018-04-13 22:22:51,13525.0,16,3270,16,13520.0,24,13525.0,14,S
2018-04-13 22:22:51,13525.0,6,3276,4,13520.0,13,13525.0,11,S
2018-04-13 22:22:52,13525.0,12,3288,12,13520.0,25,13525.0,5,S
2018-04-13 22:22:52,13525.0,6,3294,6,13520.0,25,13525.0,2,S
2018-04-13 22:22:53,13525.0,4,3298,4,13520.0,12,13530.0,1,S
2018-04-13 22:22:53,13520.0,28,3326,18,13515.0,32,13520.0,5,S
2018-04-13 22:22:54,13520.0,10,3336,8,13520.0,9,13530.0,3,S
2018-04-13 22:22:54,13530.0,4,3340,-2,13525.0,1,13530.0,3,B
2018-04-13 22:23:16,13525.0,4,3344,2,13520.0,1,13530.0,8,S
2018-04-13 22:23:32,13520.0,2,3346,-2,13520.0,1,13525.0,4,S
2018-04-13 22:23:39,13525.0,6,3352,-6,13525.0,2,13530.0,12,B
2018-04-13 22:23:40,13525.0,4,3356,0,13520.0,7,13525.0,1,B
2018-04-13 22:23:40,13520.0,2,3358,2,13520.0,6,13530.0,13,S
2018-04-13 22:24:00,13525.0,2,3360,0,13525.0,4,13530.0,8,B
2018-04-13 22:24:02,13525.0,2,3362,0,13525.0,3,13530.0,8,B
2018-04-13 22:24:33,13530.0,4,3366,-2,13525.0,6,13530.0,3,B
2018-04-13 22:24:34,13525.0,2,3368,0,13525.0,5,13530.0,3,S
2018-04-13 22:24:37,13530.0,4,3372,-4,13525.0,9,13530.0,1,B
2018-04-13 22:24:49,13530.0,2,3374,2,13525.0,9,13530.0,2,B
2018-04-13 22:24:59,13530.0,4,3378,0,13525.0,9,13535.0,14,B
2018-04-13 22:25:02,13530.0,2,3380,0,13525.0,9,13535.0,11,B
2018-04-13 22:25:13,13525.0,2,3382,0,13525.0,8,13530.0,20,S
2018-04-13 22:25:27,13525.0,4,3386,-4,13525.0,5,13530.0,8,S
2018-04-13 22:25:28,13525.0,8,3394,-6,13525.0,1,13530.0,8,S
2018-04-13 22:25:54,13525.0,4,3398,2,13520.0,19,13525.0,3,S
2018-04-13 22:26:18,13525.0,2,3400,2,13520.0,20,13530.0,8,S
2018-04-13 22:26:36,13530.0,2,3402,-2,13525.0,2,13530.0,4,B
2018-04-13 22:27:10,13525.0,6,3408,-4,13520.0,21,13525.0,4,S
2018-04-13 22:27:11,13525.0,8,3416,0,13520.0,22,13530.0,6,S
2018-04-13 22:27:24,13525.0,12,3428,0,13520.0,19,13530.0,10,S
2018-04-13 22:27:25,13520.0,6,3434,0,13520.0,16,13525.0,5,S
2018-04-13 22:27:35,13525.0,10,3444,-10,13520.0,19,13525.0,1,B
2018-04-13 22:27:36,13525.0,2,3446,0,13520.0,19,13530.0,5,B
2018-04-13 22:27:39,13530.0,4,3450,-4,13525.0,9,13535.0,8,B
2018-04-13 22:27:42,13535.0,14,3464,-14,13535.0,1,13540.0,6,B
2018-04-13 22:27:44,13535.0,2,3466,-2,13530.0,10,13540.0,6,B
2018-04-13 22:27:50,13540.0,10,3476,0,13530.0,5,13540.0,21,B
2018-04-13 22:27:59,13525.0,6,3482,2,13525.0,2,13535.0,10,S
2018-04-13 22:28:03,13530.0,2,3484,-2,13525.0,7,13535.0,6,B
2018-04-13 22:28:06,13525.0,6,3490,-6,13525.0,7,13535.0,6,S
2018-04-13 22:28:16,13530.0,4,3494,2,13525.0,6,13535.0,7,B
2018-04-13 22:28:36,13530.0,8,3502,-4,13525.0,18,13530.0,95,B
2018-04-13 22:28:36,13530.0,24,3526,-4,13525.0,17,13530.0,83,B
2018-04-13 22:28:37,13530.0,2,3528,-2,13525.0,2,13530.0,82,B
2018-04-13 22:28:41,13530.0,8,3536,-8,13525.0,3,13530.0,78,B
2018-04-13 22:28:57,13530.0,2,3538,0,13525.0,7,13530.0,77,B
2018-04-13 22:28:59,13525.0,2,3540,-2,13525.0,5,13530.0,77,S
2018-04-13 22:28:59,13525.0,10,3550,-4,13520.0,20,13525.0,7,S
2018-04-13 22:29:03,13525.0,10,3560,-10,13520.0,17,13525.0,3,S
2018-04-13 22:29:05,13525.0,2,3562,-2,13520.0,17,13525.0,2,S
2018-04-13 22:29:05,13525.0,4,3566,-4,13520.0,17,13530.0,82,S
2018-04-13 22:29:06,13525.0,8,3574,-4,13525.0,2,13530.0,81,S
2018-04-13 22:29:17,13525.0,8,3582,-4,13520.0,19,13525.0,1,S
2018-04-13 22:29:17,13525.0,2,3584,-2,13520.0,19,13530.0,80,S
2018-04-13 22:29:31,13525.0,2,3586,0,13525.0,4,13530.0,86,S
2018-04-13 22:29:32,13525.0,8,3594,-8,13520.0,19,13530.0,84,S
2018-04-13 22:29:39,13530.0,4,3598,-4,13520.0,19,13525.0,1,B
2018-04-13 22:29:49,13525.0,2,3600,0,13520.0,31,13525.0,4,S
2018-04-13 22:29:50,13525.0,8,3608,0,13520.0,31,13530.0,80,S
2018-04-13 22:30:02,13520.0,2,3610,-2,13520.0,15,13525.0,8,S
2018-04-13 22:30:07,13525.0,2,3612,-2,13520.0,15,13530.0,81,B
2018-04-13 22:30:08,13525.0,2,3614,-2,13520.0,18,13530.0,83,B
2018-04-13 22:30:12,13525.0,8,3622,0,13525.0,1,13530.0,8,B
2018-04-13 22:30:14,13520.0,12,3634,-12,13520.0,13,13530.0,9,S
2018-04-13 22:30:21,13520.0,10,3644,-8,13520.0,5,13525.0,1,S
2018-04-13 22:30:48,13520.0,28,3672,-12,13515.0,23,13520.0,62,S
2018-04-13 22:30:49,13520.0,28,3700,-8,13515.0,14,13520.0,48,S
2018-04-13 22:30:50,13520.0,8,3708,0,13515.0,13,13520.0,44,S
2018-04-13 22:30:50,13515.0,10,3718,-6,13515.0,8,13520.0,44,S
2018-04-13 22:30:51,13520.0,6,3724,0,13515.0,20,13520.0,41,B
2018-04-13 22:30:51,13520.0,18,3742,-2,13515.0,32,13520.0,32,B
2018-04-13 22:30:52,13520.0,4,3746,0,13515.0,32,13520.0,30,B
2018-04-13 22:30:52,13520.0,4,3750,0,13515.0,20,13520.0,28,B
2018-04-13 22:30:53,13515.0,8,3758,-2,13515.0,18,13520.0,26,S
2018-04-13 22:30:55,13520.0,10,3768,-10,13515.0,8,13520.0,21,B
2018-04-13 22:30:56,13520.0,4,3772,0,13515.0,8,13520.0,19,B
2018-04-13 22:30:57,13520.0,4,3776,0,13515.0,10,13520.0,17,B
2018-04-13 22:30:58,13520.0,16,3792,-10,13515.0,22,13520.0,9,B
2018-04-13 22:30:58,13520.0,18,3810,-18,13520.0,1,13525.0,5,B
2018-04-13 22:31:00,13525.0,4,3814,0,13520.0,4,13525.0,2,B
2018-04-13 22:31:03,13520.0,2,3816,0,13520.0,7,13525.0,2,S
2018-04-13 22:31:05,13525.0,4,3820,2,13525.0,3,13530.0,9,B
2018-04-13 22:31:11,13530.0,2,3822,2,13525.0,5,13530.0,11,B
2018-04-13 22:31:16,13530.0,2,3824,0,13525.0,5,13530.0,8,B
2018-04-13 22:31:18,13525.0,12,3836,0,13520.0,9,13525.0,1,S
2018-04-13 22:31:19,13525.0,2,3838,-2,13520.0,9,13530.0,8,S
2018-04-13 22:31:26,13530.0,8,3846,-2,13525.0,5,13535.0,5,B
2018-04-13 22:31:34,13525.0,2,3848,0,13520.0,12,13525.0,2,S
2018-04-13 22:31:49,13525.0,2,3850,-2,13520.0,13,13525.0,1,S
2018-04-13 22:32:01,13520.0,6,3856,-4,13520.0,7,13525.0,4,S
2018-04-13 22:32:02,13525.0,2,3858,0,13520.0,9,13530.0,5,B
2018-04-13 22:32:04,13525.0,2,3860,0,13520.0,12,13530.0,8,B
2018-04-13 22:32:36,13520.0,6,3866,-6,13520.0,14,13530.0,7,S
2018-04-13 22:32:52,13525.0,2,3868,2,13520.0,14,13530.0,7,B
2018-04-13 22:33:02,13525.0,2,3870,0,13520.0,15,13530.0,7,B
2018-04-13 22:33:57,13525.0,2,3872,0,13525.0,3,13530.0,3,B
2018-04-13 22:34:46,13530.0,6,3878,-6,13530.0,37,13535.0,8,B
2018-04-13 22:35:15,13535.0,12,3890,-8,13530.0,37,13535.0,1,B
2018-04-13 22:35:36,13535.0,8,3898,-6,13535.0,1,13540.0,6,B
2018-04-13 22:35:36,13530.0,4,3902,-2,13530.0,39,13535.0,2,S
2018-04-13 22:35:41,13535.0,8,3910,-4,13535.0,1,13540.0,4,B
2018-04-13 22:35:42,13530.0,4,3914,0,13530.0,38,13535.0,1,S
2018-04-13 22:35:42,13535.0,2,3916,0,13530.0,38,13535.0,1,B
2018-04-13 22:35:47,13535.0,2,3918,0,13535.0,4,13540.0,7,B
2018-04-13 22:35:48,13535.0,8,3926,0,13530.0,39,13540.0,6,B
2018-04-13 22:35:54,13535.0,2,3928,0,13535.0,4,13540.0,8,B
2018-04-13 22:36:04,13530.0,14,3942,-6,13530.0,38,13535.0,3,S
2018-04-13 22:36:05,13530.0,4,3946,0,13530.0,34,13535.0,2,S
2018-04-13 22:36:13,13535.0,4,3950,0,13535.0,3,13540.0,15,B
2018-04-13 22:36:14,13535.0,6,3956,0,13530.0,36,13540.0,15,B
2018-04-13 22:36:14,13530.0,2,3958,0,13530.0,35,13540.0,15,S
2018-04-13 22:36:19,13530.0,2,3960,0,13530.0,34,13540.0,15,S
2018-04-13 22:36:39,13530.0,10,3970,0,13530.0,35,13540.0,15,S
2018-04-13 22:37:28,13530.0,2,3972,0,13535.0,5,13540.0,18,S
2018-04-13 22:37:28,13530.0,4,3976,0,13535.0,3,13540.0,18,S
2018-04-13 22:37:29,13530.0,4,3980,0,13535.0,1,13540.0,18,S
2018-04-13 22:37:34,13530.0,8,3988,0,13530.0,30,13535.0,14,S
2018-04-13 22:37:35,13530.0,4,3992,0,13530.0,28,13535.0,12,S
2018-04-13 22:37:49,13535.0,2,3994,-2,13530.0,6,13535.0,9,B
2018-04-13 22:38:13,13530.0,4,3998,2,13530.0,1,13535.0,13,S
2018-04-13 22:38:14,13525.0,6,4004,4,13525.0,5,13535.0,13,S
2018-04-13 22:38:14,13525.0,2,4006,2,13525.0,8,13535.0,17,S
2018-04-13 22:39:16,13535.0,2,4008,0,13530.0,7,13540.0,10,B
2018-04-13 22:39:37,13525.0,2,4010,0,13520.0,9,13530.0,9,S
2018-04-13 22:39:46,13520.0,4,4014,-4,13520.0,5,13525.0,12,S
2018-04-13 22:39:48,13520.0,8,4022,-2,13520.0,1,13525.0,14,S
2018-04-13 22:39:48,13520.0,2,4024,0,13515.0,5,13525.0,14,S
2018-04-13 22:39:49,13515.0,2,4026,2,13515.0,7,13525.0,14,S
2018-04-13 22:39:51,13515.0,2,4028,2,13515.0,8,13525.0,13,S
2018-04-13 22:39:52,13515.0,2,4030,2,13520.0,5,13525.0,13,S
2018-04-13 22:39:54,13515.0,10,4040,0,13515.0,7,13525.0,13,S
2018-04-13 22:39:54,13515.0,2,4042,0,13510.0,4,13520.0,15,S
2018-04-13 22:39:59,13510.0,2,4044,2,13505.0,6,13515.0,17,S
2018-04-13 22:39:59,13515.0,12,4056,-6,13505.0,7,13510.0,1,B
2018-04-13 22:40:00,13505.0,6,4062,4,13505.0,2,13510.0,6,S
2018-04-13 22:40:01,13505.0,4,4066,0,13500.0,19,13505.0,5,S
2018-04-13 22:40:01,13500.0,8,4074,-4,13500.0,17,13505.0,5,S
2018-04-13 22:40:02,13500.0,8,4082,-2,13500.0,15,13505.0,5,S
2018-04-13 22:40:03,13505.0,8,4090,2,13500.0,25,13505.0,1,B
2018-04-13 22:40:07,13500.0,14,4104,4,13500.0,5,13505.0,3,S
2018-04-13 22:40:12,13500.0,2,4106,0,13500.0,8,13505.0,3,S
2018-04-13 22:40:12,13505.0,6,4112,2,13505.0,1,13510.0,1,B
2018-04-13 22:40:13,13505.0,2,4114,-2,13505.0,1,13515.0,7,B
2018-04-13 22:40:31,13515.0,2,4116,0,13510.0,1,13515.0,1,B
2018-04-13 22:40:32,13510.0,2,4118,0,13510.0,1,13515.0,1,S
2018-04-13 22:40:33,13510.0,6,4124,-4,13505.0,7,13510.0,17,S
2018-04-13 22:40:34,13510.0,4,4128,0,13505.0,7,13510.0,15,S
2018-04-13 22:40:34,13510.0,2,4130,0,13505.0,7,13510.0,14,S
2018-04-13 22:40:37,13510.0,2,4132,-2,13505.0,28,13510.0,13,S
2018-04-13 22:40:37,13510.0,6,4138,-6,13505.0,16,13510.0,10,S
2018-04-13 22:40:40,13505.0,2,4140,-2,13505.0,16,13510.0,10,S
2018-04-13 22:40:41,13505.0,2,4142,-2,13505.0,16,13510.0,10,S
2018-04-13 22:40:43,13510.0,2,4144,-2,13505.0,16,13510.0,9,B
2018-04-13 22:40:51,13510.0,2,4146,-2,13505.0,16,13510.0,9,B
2018-04-13 22:40:55,13510.0,2,4148,0,13505.0,16,13510.0,8,B
2018-04-13 22:41:06,13510.0,2,4150,-2,13505.0,16,13510.0,7,B
2018-04-13 22:41:07,13510.0,14,4164,0,13510.0,12,13515.0,1,B
2018-04-13 22:41:19,13510.0,6,4170,2,13515.0,1,13525.0,9,B
2018-04-13 22:41:19,13515.0,2,4172,0,13510.0,9,13520.0,2,B
2018-04-13 22:41:20,13510.0,2,4174,0,13510.0,4,13515.0,1,S
2018-04-13 22:41:26,13515.0,2,4176,0,13510.0,4,13515.0,1,B
2018-04-13 22:41:29,13515.0,2,4178,-2,13510.0,7,13520.0,6,B
2018-04-13 22:41:39,13520.0,2,4180,0,13510.0,5,13520.0,5,B
2018-04-13 22:41:40,13515.0,2,4182,-2,13510.0,5,13520.0,5,S
2018-04-13 22:42:03,13515.0,2,4184,0,13510.0,7,13520.0,7,S
2018-04-13 22:42:15,13520.0,10,4194,6,13520.0,3,13525.0,5,B
2018-04-13 22:42:19,13515.0,2,4196,0,13515.0,3,13525.0,5,S
2018-04-13 22:42:23,13525.0,12,4208,-10,13525.0,2,13530.0,2,B
2018-04-13 22:42:23,13515.0,8,4216,0,13515.0,6,13525.0,11,S
2018-04-13 22:42:31,13515.0,2,4218,2,13515.0,19,13525.0,3,S
2018-04-13 22:42:39,13515.0,6,4224,-6,13515.0,3,13520.0,5,S
2018-04-13 22:42:40,13515.0,4,4228,-4,13515.0,1,13520.0,5,S
2018-04-13 22:42:41,13515.0,2,4230,-2,13510.0,8,13520.0,5,S
2018-04-13 22:43:08,13520.0,4,4234,2,13520.0,4,13525.0,8,B
2018-04-13 22:43:39,13520.0,2,4236,2,13520.0,4,13525.0,3,B
2018-04-13 22:44:10,13520.0,2,4238,0,13520.0,4,13525.0,3,B
2018-04-13 22:44:28,13520.0,2,4240,0,13520.0,3,13525.0,4,B
2018-04-13 22:45:29,13520.0,2,4242,2,13520.0,3,13525.0,2,B
2018-04-13 22:46:01,13520.0,2,4244,2,13520.0,2,13525.0,11,B
2018-04-13 22:46:05,13520.0,2,4246,2,13520.0,1,13525.0,11,B
2018-04-13 22:46:06,13520.0,2,4248,0,13515.0,5,13525.0,11,B
2018-04-13 22:46:35,13520.0,4,4252,4,13520.0,18,13525.0,9,B
2018-04-13 22:46:35,13520.0,12,4264,2,13520.0,12,13525.0,9,B
2018-04-13 22:46:36,13520.0,16,4280,6,13520.0,4,13525.0,11,B
2018-04-13 22:46:36,13520.0,2,4282,2,13520.0,3,13525.0,11,B
2018-04-13 22:46:38,13520.0,2,4284,2,13520.0,3,13525.0,11,B
2018-04-13 22:46:39,13520.0,2,4286,2,13520.0,2,13525.0,8,B
2018-04-13 22:46:44,13520.0,4,4290,4,13515.0,5,13520.0,1,B
2018-04-13 22:46:53,13520.0,4,4294,-4,13515.0,6,13520.0,2,B
2018-04-13 22:47:18,13515.0,2,4296,0,13515.0,2,13520.0,2,S
2018-04-13 22:48:54,13515.0,8,4304,-8,13510.0,7,13520.0,2,S
2018-04-13 22:49:08,13515.0,2,4306,0,13515.0,2,13520.0,2,S
2018-04-13 22:49:16,13515.0,6,4312,2,13510.0,8,13515.0,7,S
2018-04-13 22:49:19,13515.0,14,4326,14,13515.0,5,13520.0,5,S
2018-04-13 22:49:20,13520.0,2,4328,0,13515.0,18,13525.0,6,B
2018-04-13 22:49:24,13525.0,2,4330,-2,13520.0,1,13525.0,2,B
2018-04-13 22:49:50,13525.0,4,4334,0,13520.0,17,13525.0,2,B
2018-04-13 22:49:51,13525.0,4,4338,2,13520.0,5,13530.0,6,B
2018-04-13 22:50:13,13525.0,2,4340,0,13520.0,4,13525.0,9,B
2018-04-13 22:50:20,13525.0,18,4358,18,13525.0,21,13530.0,7,B
2018-04-13 22:50:26,13530.0,22,4380,-18,13530.0,13,13535.0,23,B
2018-04-13 22:50:26,13530.0,8,4388,-6,13530.0,9,13535.0,16,B
2018-04-13 22:50:27,13530.0,8,4396,0,13530.0,5,13535.0,16,B
2018-04-13 22:50:28,13530.0,8,4404,-8,13530.0,1,13535.0,16,B
2018-04-13 22:50:28,13530.0,2,4406,0,13525.0,24,13535.0,16,B
2018-04-13 22:50:31,13525.0,2,4408,0,13525.0,23,13530.0,2,S
2018-04-13 22:51:00,13530.0,4,4412,2,13525.0,23,13530.0,7,B
2018-04-13 22:51:23,13525.0,2,4414,2,13525.0,19,13530.0,4,S
2018-04-13 22:51:47,13520.0,2,4416,-2,13520.0,3,13525.0,3,S
2018-04-13 22:51:53,13520.0,4,4420,0,13520.0,2,13525.0,3,S
2018-04-13 22:52:00,13515.0,6,4426,4,13510.0,6,13520.0,6,S
2018-04-13 22:52:02,13510.0,2,4428,2,13510.0,2,13515.0,3,S
2018-04-13 22:52:03,13515.0,6,4434,0,13510.0,3,13520.0,6,B
2018-04-13 22:52:05,13520.0,2,4436,0,13515.0,2,13520.0,2,B
2018-04-13 22:52:10,13515.0,4,4440,-4,13510.0,7,13520.0,3,S
2018-04-13 22:52:18,13520.0,2,4442,-2,13515.0,4,13520.0,1,B
2018-04-13 22:52:25,13515.0,4,4446,2,13510.0,6,13515.0,1,S
2018-04-13 22:52:26,13515.0,4,4450,2,13510.0,2,13520.0,10,S
2018-04-13 22:52:31,13515.0,2,4452,0,13510.0,4,13515.0,1,S
2018-04-13 22:52:31,13515.0,2,4454,0,13510.0,4,13515.0,1,S
2018-04-13 22:52:35,13510.0,2,4456,-2,13510.0,1,13515.0,1,S
2018-04-13 22:52:44,13515.0,4,4460,-2,13510.0,5,13515.0,1,B
2018-04-13 22:52:51,13505.0,2,4462,0,13500.0,12,13510.0,4,S
2018-04-13 22:52:55,13505.0,2,4464,0,13500.0,10,13505.0,3,S
2018-04-13 22:52:55,13500.0,4,4468,2,13500.0,8,13505.0,4,S
2018-04-13 22:52:56,13505.0,20,4488,4,13495.0,4,13505.0,8,B
2018-04-13 22:52:56,13490.0,10,4498,8,13490.0,9,13495.0,9,S
2018-04-13 22:52:57,13490.0,2,4500,0,13490.0,7,13495.0,2,S
2018-04-13 22:52:57,13495.0,2,4502,0,13490.0,7,13500.0,9,B
2018-04-13 22:53:02,13495.0,2,4504,-2,13500.0,3,13505.0,1,B
2018-04-13 22:53:05,13500.0,2,4506,0,13495.0,5,13510.0,6,B
2018-04-13 22:53:07,13500.0,8,4514,-4,13500.0,2,13510.0,4,B
2018-04-13 22:53:11,13500.0,2,4516,0,13500.0,2,13510.0,3,B
2018-04-13 22:53:27,13505.0,2,4518,0,13500.0,25,13510.0,3,B
2018-04-13 22:53:33,13505.0,2,4520,2,13505.0,4,13510.0,3,B
2018-04-13 22:53:36,13510.0,2,4522,-2,13510.0,2,13515.0,10,B
2018-04-13 22:53:45,13515.0,2,4524,-2,13505.0,2,13515.0,6,B
2018-04-13 22:53:47,13510.0,2,4526,-2,13500.0,24,13510.0,3,S
2018-04-13 22:53:49,13505.0,4,4530,0,13500.0,23,13510.0,6,S
2018-04-13 22:53:57,13505.0,2,4532,-2,13505.0,4,13510.0,2,S
2018-04-13 22:53:58,13510.0,4,4536,0,13505.0,4,13515.0,8,B
2018-04-13 22:54:00,13510.0,14,4550,-2,13510.0,1,13515.0,1,B
2018-04-13 22:54:02,13510.0,2,4552,0,13510.0,2,13515.0,1,B
2018-04-13 22:54:02,13515.0,2,4554,-2,13510.0,16,13520.0,4,B
2018-04-13 22:54:04,13515.0,2,4556,0,13515.0,1,13520.0,2,B
2018-04-13 22:54:09,13515.0,2,4558,0,13510.0,1,13515.0,1,B
2018-04-13 22:54:13,13505.0,2,4560,2,13505.0,2,13515.0,3,S
2018-04-13 22:54:15,13515.0,2,4562,2,13505.0,5,13515.0,2,B
2018-04-13 22:54:30,13520.0,14,4576,-10,13510.0,2,13525.0,8,B
2018-04-13 22:54:34,13515.0,2,4578,0,13510.0,1,13520.0,4,S
2018-04-13 22:54:34,13520.0,2,4580,-2,13510.0,1,13520.0,3,B
2018-04-13 22:54:37,13515.0,2,4582,0,13510.0,2,13515.0,1,S
2018-04-13 22:54:51,13515.0,2,4584,0,13515.0,1,13520.0,4,S
2018-04-13 22:54:53,13515.0,2,4586,0,13510.0,1,13515.0,1,S
2018-04-13 22:55:28,13515.0,2,4588,-2,13510.0,1,13515.0,2,S
2018-04-13 22:55:57,13515.0,4,4592,4,13510.0,1,13520.0,5,S
2018-04-13 22:56:38,13520.0,2,4594,-2,13510.0,2,13520.0,2,B
2018-04-13 22:56:43,13510.0,2,4596,0,13510.0,1,13520.0,2,S
2018-04-13 22:56:46,13510.0,4,4600,4,13505.0,25,13510.0,3,S
2018-04-13 22:56:47,13510.0,6,4606,6,13505.0,22,13520.0,2,S
2018-04-13 22:57:01,13530.0,14,4620,-8,13505.0,22,13530.0,18,B
2018-04-13 22:57:09,13505.0,2,4622,0,13505.0,21,13515.0,2,S
2018-04-13 22:57:13,13505.0,4,4626,0,13505.0,20,13520.0,2,S
2018-04-13 22:57:29,13510.0,6,4632,0,13505.0,44,13515.0,6,B
2018-04-13 22:57:45,13505.0,2,4634,-2,13505.0,18,13510.0,1,S
2018-04-13 22:57:49,13510.0,4,4638,2,13505.0,18,13515.0,6,B
2018-04-13 22:58:02,13505.0,2,4640,-2,13505.0,19,13515.0,3,S
2018-04-13 22:58:18,13505.0,2,4642,-2,13505.0,18,13510.0,4,S
2018-04-13 22:58:24,13510.0,2,4644,0,13505.0,18,13510.0,3,B
2018-04-13 22:58:32,13505.0,2,4646,0,13505.0,17,13510.0,4,S
2018-04-13 22:58:32,13505.0,4,4650,-4,13505.0,15,13510.0,4,S
2018-04-13 22:58:43,13505.0,30,4680,-14,13500.0,28,13510.0,4,S
2018-04-13 22:58:43,13510.0,2,4682,0,13500.0,28,13510.0,5,B
2018-04-13 22:58:58,13505.0,4,4686,-2,13500.0,28,13510.0,6,S
2018-04-13 22:59:00,13500.0,2,4688,0,13500.0,27,13510.0,6,S
2018-04-13 22:59:14,13500.0,2,4690,0,13500.0,26,13505.0,9,S
2018-04-13 22:59:14,13500.0,2,4692,-2,13500.0,25,13505.0,9,S
2018-04-13 22:59:15,13505.0,2,4694,0,13500.0,25,13505.0,8,B
2018-04-13 22:59:16,13500.0,4,4698,-4,13500.0,23,13505.0,2,S
2018-04-13 22:59:17,13500.0,8,4706,0,13500.0,19,13505.0,8,S
2018-04-13 22:59:19,13500.0,4,4710,-4,13500.0,17,13505.0,8,S
2018-04-13 22:59:20,13500.0,12,4722,0,13500.0,11,13505.0,6,S
2018-04-13 22:59:20,13500.0,22,4744,-20,13490.0,10,13505.0,5,S
2018-04-13 22:59:28,13500.0,2,4746,0,13490.0,10,13500.0,2,S
2018-04-13 22:59:29,13500.0,6,4752,0,13490.0,10,13500.0,5,S
2018-04-13 22:59:29,13490.0,2,4754,-2,13490.0,9,13500.0,5,S
2018-04-13 22:59:30,13500.0,4,4758,-4,13490.0,9,13505.0,5,B
2018-04-13 22:59:36,13500.0,2,4760,0,13500.0,2,13505.0,1,B
2018-04-13 22:59:37,13500.0,4,4764,-4,13490.0,10,13505.0,4,B
2018-04-13 22:59:40,13505.0,2,4766,0,13495.0,3,13510.0,2,B
2018-04-13 22:59:46,13505.0,2,4768,0,13495.0,3,13505.0,2,B
2018-04-13 22:59:54,13495.0,2,4770,0,13490.0,8,13510.0,8,S
2018-04-16 09:00:01,13495.0,6,4776,-2,13495.0,1,13500.0,3,S
2018-04-16 09:00:01,13495.0,2,4778,0,13490.0,8,13495.0,6,S
2018-04-16 09:00:02,13495.0,2,4780,2,13490.0,8,13495.0,7,S
2018-04-16 09:00:03,13490.0,2,4782,0,13490.0,17,13495.0,23,S
2018-04-16 09:00:03,13485.0,38,4820,-2,13480.0,5,13490.0,2,S
2018-04-16 09:00:05,13485.0,2,4822,2,13480.0,5,13485.0,2,S
2018-04-16 09:00:06,13480.0,4,4826,4,13480.0,3,13485.0,2,S
2018-04-16 09:00:07,13485.0,14,4840,0,13485.0,3,13490.0,7,B
2018-04-16 09:00:07,13485.0,6,4846,0,13480.0,3,13485.0,1,B
2018-04-16 09:00:08,13480.0,6,4852,2,13475.0,9,13485.0,3,S
2018-04-16 09:00:10,13475.0,18,4870,-12,13470.0,3,13475.0,1,S
2018-04-16 09:00:10,13475.0,2,4872,-2,13470.0,2,13480.0,2,S
2018-04-16 09:00:11,13470.0,2,4874,0,13470.0,1,13475.0,1,S
2018-04-16 09:00:12,13470.0,2,4876,-2,13470.0,1,13475.0,4,S
2018-04-16 09:00:14,13470.0,2,4878,0,13465.0,1,13475.0,2,S
2018-04-16 09:00:15,13475.0,2,4880,2,13465.0,4,13475.0,1,B
2018-04-16 09:00:17,13475.0,2,4882,2,13465.0,1,13475.0,13,B
2018-04-16 09:00:17,13475.0,20,4902,-6,13465.0,1,13475.0,6,B
2018-04-16 09:00:20,13475.0,2,4904,0,13465.0,2,13475.0,5,B
2018-04-16 09:00:21,13465.0,2,4906,0,13465.0,1,13475.0,5,S
2018-04-16 09:00:23,13465.0,4,4910,0,13465.0,1,13470.0,2,S
2018-04-16 09:00:26,13465.0,2,4912,2,13460.0,3,13465.0,1,S
2018-04-16 09:00:28,13465.0,2,4914,0,13460.0,3,13470.0,3,S
2018-04-16 09:00:29,13465.0,2,4916,-2,13460.0,3,13470.0,1,S
2018-04-16 09:00:30,13470.0,2,4918,0,13465.0,5,13475.0,5,B
2018-04-16 09:00:31,13465.0,2,4920,2,13465.0,4,13475.0,5,S
2018-04-16 09:00:34,13470.0,4,4924,-4,13470.0,1,13475.0,3,B
2018-04-16 09:00:35,13470.0,2,4926,0,13465.0,4,13475.0,5,B
2018-04-16 09:00:36,13465.0,2,4928,2,13465.0,3,13475.0,5,S
2018-04-16 09:00:38,13465.0,2,4930,2,13465.0,3,13475.0,2,S
2018-04-16 09:00:39,13475.0,8,4938,0,13465.0,2,13475.0,3,B
2018-04-16 09:00:42,13475.0,4,4942,4,13470.0,2,13480.0,2,B
2018-04-16 09:00:42,13470.0,2,4944,2,13470.0,1,13480.0,2,S
2018-04-16 09:00:45,13470.0,2,4946,2,13465.0,4,13470.0,5,S
2018-04-16 09:00:45,13465.0,28,4974,8,13460.0,3,13470.0,10,S
2018-04-16 09:00:46,13460.0,6,4980,6,13455.0,9,13460.0,1,S
2018-04-16 09:00:46,13460.0,4,4984,2,13455.0,8,13460.0,5,S
2018-04-16 09:00:47,13450.0,30,5014,10,13445.0,6,13455.0,11,S
2018-04-16 09:00:47,13450.0,4,5018,0,13445.0,6,13455.0,8,S
2018-04-16 09:00:49,13445.0,4,5022,4,13445.0,5,13455.0,10,S
2018-04-16 09:00:50,13450.0,4,5026,2,13445.0,5,13450.0,5,B
2018-04-16 09:00:50,13450.0,2,5028,2,13445.0,5,13450.0,4,B
2018-04-16 09:00:51,13450.0,8,5036,8,13445.0,5,13455.0,25,B
2018-04-16 09:00:53,13450.0,2,5038,-2,13445.0,5,13450.0,1,B
2018-04-16 09:00:53,13450.0,2,5040,-2,13450.0,10,13455.0,2,B
2018-04-16 09:00:54,13450.0,10,5050,-10,13450.0,5,13455.0,1,B
2018-04-16 09:00:54,13455.0,2,5052,0,13455.0,9,13460.0,4,B
2018-04-16 09:00:55,13455.0,10,5062,-10,13455.0,4,13460.0,4,B
2018-04-16 09:00:55,13455.0,6,5068,-4,13455.0,1,13460.0,4,B
2018-04-16 09:00:57,13460.0,6,5074,0,13455.0,2,13460.0,4,B
2018-04-16 09:00:59,13460.0,4,5078,-4,13460.0,3,13465.0,1,B
2018-04-16 09:01:01,13460.0,8,5086,0,13455.0,2,13460.0,8,B
2018-04-16 09:01:02,13455.0,4,5090,0,13450.0,5,13460.0,12,S
2018-04-16 09:01:03,13445.0,22,5112,8,13440.0,2,13450.0,5,S
2018-04-16 09:01:03,13450.0,10,5122,0,13450.0,5,13455.0,13,B
2018-04-16 09:01:04,13455.0,6,5128,0,13450.0,3,13455.0,15,B
2018-04-16 09:01:04,13455.0,10,5138,0,13450.0,3,13455.0,13,B
2018-04-16 09:01:05,13450.0,2,5140,-2,13450.0,3,13455.0,8,S
2018-04-16 09:01:07,13450.0,4,5144,-4,13450.0,2,13455.0,1,S
2018-04-16 09:01:07,13450.0,6,5150,-2,13445.0,1,13455.0,1,S
2018-04-16 09:01:08,13445.0,2,5152,-2,13440.0,2,13445.0,1,S
2018-04-16 09:01:08,13445.0,4,5156,-2,13445.0,1,13450.0,1,S
2018-04-16 09:01:09,13445.0,6,5162,2,13450.0,10,13455.0,4,S
2018-04-16 09:01:09,13450.0,6,5168,-4,13450.0,7,13455.0,3,B
2018-04-16 09:01:10,13450.0,4,5172,-4,13450.0,5,13460.0,8,B
2018-04-16 09:01:11,13450.0,2,5174,0,13450.0,4,13460.0,8,B
2018-04-16 09:01:12,13450.0,2,5176,0,13450.0,3,13460.0,8,B
2018-04-16 09:01:14,13450.0,6,5182,0,13445.0,1,13455.0,4,B
2018-04-16 09:01:16,13445.0,16,5198,14,13435.0,5,13445.0,7,S
2018-04-16 09:01:18,13435.0,10,5208,-6,13435.0,1,13445.0,16,S
2018-04-16 09:01:18,13440.0,2,5210,0,13435.0,1,13440.0,3,B
2018-04-16 09:01:20,13435.0,4,5214,2,13430.0,3,13435.0,6,S
2018-04-16 09:01:20,13430.0,6,5220,-2,13425.0,2,13430.0,1,S
2018-04-16 09:01:21,13425.0,2,5222,0,13420.0,2,13425.0,1,S
2018-04-16 09:01:21,13425.0,4,5226,4,13420.0,2,13430.0,6,S
2018-04-16 09:01:22,13430.0,2,5228,0,13425.0,7,13435.0,10,B
2018-04-16 09:01:22,13435.0,22,5250,2,13435.0,1,13440.0,5,B
2018-04-16 09:01:23,13435.0,2,5252,0,13430.0,1,13435.0,1,B
2018-04-16 09:01:23,13435.0,2,5254,0,13435.0,2,13440.0,3,B
2018-04-16 09:01:26,13435.0,2,5256,-2,13435.0,9,13440.0,3,B
2018-04-16 09:01:27,13440.0,4,5260,0,13435.0,11,13450.0,3,B
2018-04-16 09:01:28,13440.0,2,5262,0,13435.0,9,13445.0,7,B
2018-04-16 09:01:28,13435.0,6,5268,-4,13435.0,6,13440.0,2,S
2018-04-16 09:01:29,13440.0,2,5270,0,13430.0,6,13445.0,12,B
2018-04-16 09:01:31,13445.0,8,5278,-2,13445.0,8,13450.0,6,B
2018-04-16 09:01:32,13450.0,2,5280,0,13445.0,8,13455.0,3,B
2018-04-16 09:01:35,13455.0,2,5282,2,13445.0,7,13455.0,9,B
2018-04-16 09:01:38,13450.0,4,5286,0,13450.0,1,13460.0,9,S
2018-04-16 09:01:43,13450.0,2,5288,0,13450.0,13,13460.0,11,S
2018-04-16 09:01:46,13460.0,10,5298,8,13460.0,12,13470.0,14,B
2018-04-16 09:01:48,13470.0,2,5300,0,13460.0,3,13470.0,11,B
2018-04-16 09:01:50,13460.0,6,5306,0,13455.0,2,13465.0,8,S
2018-04-16 09:01:51,13465.0,2,5308,2,13455.0,2,13465.0,13,B
2018-04-16 09:01:52,13455.0,4,5312,-4,13450.0,12,13455.0,2,S
2018-04-16 09:01:52,13455.0,2,5314,-2,13450.0,12,13455.0,9,S
2018-04-16 09:01:56,13455.0,6,5320,-4,13450.0,12,13455.0,6,S
2018-04-16 09:01:57,13455.0,12,5332,0,13450.0,12,13460.0,2,S
2018-04-16 09:01:58,13455.0,2,5334,0,13450.0,14,13460.0,2,S
2018-04-16 09:02:02,13460.0,6,5340,6,13450.0,13,13460.0,7,B
2018-04-16 09:02:03,13450.0,16,5356,-6,13450.0,5,13455.0,12,S
2018-04-16 09:02:03,13450.0,10,5366,0,13445.0,1,13450.0,6,S
2018-04-16 09:02:04,13440.0,4,5370,2,13435.0,1,13445.0,11,S
2018-04-16 09:02:05,13445.0,2,5372,0,13435.0,2,13445.0,10,B
2018-04-16 09:02:09,13440.0,4,5376,0,13440.0,1,13445.0,10,S
2018-04-16 09:02:10,13435.0,2,5378,-2,13430.0,3,13440.0,4,S
2018-04-16 09:02:12,13430.0,6,5384,2,13425.0,3,13435.0,15,S
2018-04-16 09:02:13,13425.0,4,5388,0,13420.0,3,13425.0,8,S
2018-04-16 09:02:14,13420.0,2,5390,2,13420.0,1,13425.0,20,S
2018-04-16 09:02:14,13410.0,20,5410,-4,13410.0,1,13420.0,10,S
2018-04-16 09:02:15,13420.0,12,5422,12,13410.0,4,13415.0,1,B
2018-04-16 09:02:15,13410.0,12,5434,8,13405.0,4,13415.0,5,S
2018-04-16 09:02:16,13405.0,8,5442,2,13400.0,20,13405.0,10,S
2018-04-16 09:02:17,13405.0,12,5454,-8,13400.0,16,13405.0,8,S
2018-04-16 09:02:17,13395.0,38,5492,-20,13390.0,3,13405.0,8,S
2018-04-16 09:02:18,13395.0,32,5524,-26,13395.0,4,13410.0,6,S
2018-04-16 09:02:18,13395.0,2,5526,-2,13400.0,6,13405.0,1,S
2018-04-16 09:02:19,13410.0,6,5532,2,13410.0,3,13415.0,3,B
2018-04-16 09:02:19,13415.0,12,5544,-4,13405.0,12,13420.0,1,B
2018-04-16 09:02:22,13405.0,12,5556,-6,13405.0,10,13415.0,3,S
2018-04-16 09:02:23,13405.0,6,5562,2,13405.0,9,13415.0,1,S
2018-04-16 09:02:25,13405.0,6,5568,0,13410.0,6,13420.0,1,S
2018-04-16 09:02:26,13420.0,6,5574,0,13415.0,8,13420.0,5,B
2018-04-16 09:02:29,13420.0,12,5586,2,13420.0,5,13425.0,7,B
2018-04-16 09:02:34,13425.0,12,5598,10,13425.0,17,13435.0,1,B
2018-04-16 09:02:36,13435.0,2,5600,2,13435.0,5,13440.0,3,B
2018-04-16 09:02:37,13435.0,4,5604,4,13435.0,4,13440.0,3,B
2018-04-16 09:02:38,13435.0,8,5612,-2,13430.0,6,13440.0,3,B
2018-04-16 09:02:42,13440.0,2,5614,-2,13430.0,1,13440.0,5,B
2018-04-16 09:02:44,13430.0,2,5616,2,13430.0,2,13440.0,5,S
2018-04-16 09:02:45,13440.0,4,5620,2,13430.0,5,13440.0,3,B
2018-04-16 09:02:48,13435.0,40,5660,14,13430.0,7,13445.0,4,S
2018-04-16 09:02:49,13435.0,12,5672,12,13435.0,1,13445.0,4,S
2018-04-16 09:02:51,13435.0,2,5674,2,13430.0,7,13440.0,5,S
2018-04-16 09:02:53,13435.0,4,5678,4,13430.0,12,13440.0,1,S
2018-04-16 09:02:54,13430.0,6,5684,2,13430.0,11,13445.0,6,S
2018-04-16 09:02:56,13440.0,2,5686,-2,13430.0,8,13440.0,5,B
2018-04-16 09:02:58,13425.0,16,5702,8,13430.0,5,13435.0,1,S
2018-04-16 09:02:59,13430.0,10,5712,10,13425.0,1,13435.0,1,B
2018-04-16 09:02:59,13430.0,2,5714,-2,13425.0,3,13430.0,8,B
2018-04-16 09:03:00,13425.0,2,5716,2,13420.0,7,13430.0,8,S
2018-04-16 09:03:01,13420.0,14,5730,2,13415.0,3,13420.0,4,S
2018-04-16 09:03:01,13410.0,14,5744,12,13410.0,3,13420.0,5,S
2018-04-16 09:03:02,13420.0,4,5748,0,13410.0,3,13420.0,3,B
2018-04-16 09:03:04,13410.0,4,5752,2,13410.0,2,13420.0,1,S
2018-04-16 09:03:05,13415.0,4,5756,2,13410.0,1,13420.0,3,B
2018-04-16 09:03:05,13405.0,6,5762,0,13405.0,4,13415.0,12,S
2018-04-16 09:03:09,13405.0,2,5764,0,13410.0,3,13415.0,11,S
2018-04-16 09:03:10,13410.0,2,5766,-2,13410.0,3,13415.0,11,B
2018-04-16 09:03:13,13415.0,2,5768,-2,13410.0,3,13415.0,10,B
2018-04-16 09:03:14,13410.0,2,5770,2,13410.0,2,13415.0,10,S
2018-04-16 09:03:18,13415.0,2,5772,-2,13415.0,3,13420.0,1,B
2018-04-16 09:03:20,13420.0,22,5794,-14,13410.0,13,13420.0,8,B
2018-04-16 09:03:23,13420.0,2,5796,-2,13410.0,14,13420.0,6,B
2018-04-16 09:03:24,13420.0,2,5798,-2,13410.0,12,13425.0,5,B
2018-04-16 09:03:25,13420.0,2,5800,0,13410.0,14,13420.0,16,B
2018-04-16 09:03:27,13415.0,2,5802,-2,13415.0,4,13420.0,8,S
2018-04-16 09:03:33,13415.0,10,5812,-8,13415.0,5,13420.0,3,S
2018-04-16 09:03:33,13420.0,16,5828,-8,13410.0,12,13420.0,6,B
2018-04-16 09:03:34,13410.0,8,5836,2,13410.0,8,13415.0,8,S
2018-04-16 09:03:35,13410.0,16,5852,0,13405.0,4,13415.0,8,S
2018-04-16 09:03:35,13405.0,2,5854,0,13405.0,3,13410.0,7,S
2018-04-16 09:03:36,13405.0,6,5860,-2,13400.0,15,13405.0,2,S
2018-04-16 09:03:39,13405.0,2,5862,2,13400.0,15,13405.0,4,S
2018-04-16 09:03:40,13390.0,38,5900,24,13390.0,3,13405.0,10,S
2018-04-16 09:03:40,13400.0,10,5910,0,13385.0,1,13400.0,11,B
2018-04-16 09:03:41,13400.0,6,5916,2,13395.0,4,13405.0,3,B
2018-04-16 09:03:41,13390.0,6,5922,0,13390.0,3,13400.0,1,S
2018-04-16 09:03:42,13385.0,10,5932,-10,13385.0,2,13400.0,5,S
2018-04-16 09:03:43,13390.0,4,5936,-4,13385.0,4,13390.0,2,B
2018-04-16 09:03:44,13385.0,24,5960,14,13385.0,1,13395.0,3,S
2018-04-16 09:03:45,13385.0,4,5964,0,13380.0,11,13385.0,21,S
2018-04-16 09:03:45,13365.0,38,6002,8,13360.0,4,13370.0,1,S
2018-04-16 09:03:46,13350.0,62,6064,8,13335.0,4,13355.0,1,S
2018-04-16 09:03:46,13355.0,12,6076,2,13350.0,2,13365.0,1,B
2018-04-16 09:03:47,13355.0,4,6080,2,13365.0,1,13375.0,2,B
2018-04-16 09:03:47,13370.0,12,6092,-6,13370.0,9,13380.0,7,B
2018-04-16 09:03:48,13380.0,14,6106,-6,13375.0,2,13380.0,2,B
2018-04-16 09:03:48,13375.0,4,6110,0,13370.0,3,13375.0,2,S
2018-04-16 09:03:49,13370.0,4,6114,-2,13365.0,2,13375.0,4,S
2018-04-16 09:03:50,13365.0,2,6116,2,13360.0,2,13365.0,6,S
2018-04-16 09:03:51,13355.0,6,6122,-4,13350.0,19,13355.0,3,S
2018-04-16 09:03:52,13360.0,10,6132,8,13355.0,4,13360.0,6,B
2018-04-16 09:03:53,13355.0,24,6156,-6,13340.0,16,13355.0,26,S
2018-04-16 09:03:53,13340.0,20,6176,4,13330.0,6,13340.0,24,S
2018-04-16 09:03:54,13315.0,16,6192,6,13310.0,7,13315.0,1,S
2018-04-16 09:03:54,13305.0,26,6218,14,13305.0,10,13310.0,34,S
2018-04-16 09:03:55,13310.0,106,6324,64,13305.0,4,13310.0,8,B
2018-04-16 09:03:55,13315.0,28,6352,0,13305.0,5,13320.0,3,B
2018-04-16 09:03:56,13315.0,8,6360,2,13315.0,8,13325.0,1,B
2018-04-16 09:03:56,13310.0,20,6380,6,13310.0,4,13325.0,3,S
2018-04-16 09:03:57,13325.0,2,6382,0,13315.0,17,13325.0,3,B
2018-04-16 09:03:57,13325.0,4,6386,-2,13320.0,8,13330.0,1,B
2018-04-16 09:03:58,13330.0,2,6388,-2,13325.0,3,13335.0,11,B
2018-04-16 09:03:59,13335.0,20,6408,-2,13330.0,2,13335.0,3,B
2018-04-16 09:04:00,13330.0,6,6414,-2,13325.0,7,13330.0,1,S
2018-04-16 09:04:00,13330.0,18,6432,2,13330.0,1,13340.0,3,S
2018-04-16 09:04:01,13330.0,6,6438,-2,13325.0,7,13330.0,6,S
2018-04-16 09:04:01,13320.0,12,6450,-4,13315.0,4,13325.0,13,S
2018-04-16 09:04:04,13325.0,2,6452,-2,13320.0,11,13330.0,7,B
2018-04-16 09:04:04,13330.0,10,6462,-10,13320.0,11,13330.0,3,B
2018-04-16 09:04:05,13320.0,2,6464,-2,13320.0,9,13325.0,2,S
2018-04-16 09:04:06,13320.0,60,6524,4,13300.0,34,13325.0,6,S
2018-04-16 09:04:06,13325.0,2,6526,-2,13310.0,5,13315.0,1,B
2018-04-16 09:04:07,13320.0,4,6530,2,13320.0,1,13325.0,4,S
2018-04-16 09:04:07,13315.0,6,6536,-2,13315.0,7,13320.0,4,S
2018-04-16 09:04:08,13325.0,18,6554,0,13315.0,8,13320.0,9,B
2018-04-16 09:04:08,13320.0,18,6572,18,13315.0,8,13325.0,1,S
2018-04-16 09:04:09,13330.0,4,6576,-4,13330.0,3,13335.0,3,B
2018-04-16 09:04:10,13320.0,12,6588,-4,13315.0,5,13330.0,12,S
2018-04-16 09:04:11,13320.0,12,6600,-8,13320.0,15,13330.0,1,S
2018-04-16 09:04:14,13335.0,6,6606,-4,13335.0,2,13340.0,5,B
2018-04-16 09:04:14,13325.0,8,6614,0,13325.0,5,13335.0,5,S
2018-04-16 09:04:17,13325.0,2,6616,0,13330.0,13,13340.0,3,S
2018-04-16 09:04:18,13330.0,24,6640,2,13330.0,20,13340.0,2,B
2018-04-16 09:04:18,13330.0,6,6646,-6,13330.0,19,13335.0,3,B
2018-04-16 09:04:19,13335.0,6,6652,-2,13330.0,17,13335.0,2,B
2018-04-16 09:04:20,13330.0,16,6668,-16,13330.0,7,13335.0,5,S
2018-04-16 09:04:20,13330.0,30,6698,-4,13320.0,3,13325.0,1,S
2018-04-16 09:04:21,13330.0,24,6722,8,13320.0,3,13330.0,5,S
2018-04-16 09:04:22,13320.0,6,6728,0,13315.0,1,13320.0,1,S
2018-04-16 09:04:23,13315.0,10,6738,2,13310.0,4,13315.0,4,S
2018-04-16 09:04:24,13315.0,8,6746,-8,13315.0,14,13320.0,1,S
2018-04-16 09:04:24,13320.0,2,6748,0,13320.0,12,13325.0,3,B
2018-04-16 09:04:25,13320.0,14,6762,0,13315.0,6,13320.0,2,B
2018-04-16 09:04:26,13325.0,10,6772,-2,13315.0,8,13325.0,2,B
2018-04-16 09:04:26,13315.0,8,6780,0,13315.0,2,13320.0,4,S
2018-04-16 09:04:27,13320.0,4,6784,4,13315.0,2,13320.0,3,B
2018-04-16 09:04:27,13315.0,4,6788,0,13310.0,4,13315.0,11,S
2018-04-16 09:04:28,13315.0,2,6790,2,13310.0,4,13315.0,4,S
2018-04-16 09:04:29,13315.0,4,6794,0,13310.0,4,13315.0,2,S
2018-04-16 09:04:29,13310.0,2,6796,-2,13310.0,3,13315.0,3,S
2018-04-16 09:04:30,13310.0,4,6800,-2,13310.0,7,13320.0,1,S
2018-04-16 09:04:32,13320.0,4,6804,4,13320.0,7,13325.0,3,B
2018-04-16 09:04:32,13320.0,14,6818,14,13315.0,1,13325.0,2,B
2018-04-16 09:04:33,13315.0,2,6820,-2,13310.0,12,13315.0,1,S
2018-04-16 09:04:33,13320.0,8,6828,0,13315.0,14,13325.0,1,B
2018-04-16 09:04:34,13315.0,4,6832,0,13315.0,7,13325.0,3,S
2018-04-16 09:04:36,13330.0,2,6834,0,13325.0,6,13330.0,3,B
2018-04-16 09:04:37,13330.0,6,6840,-4,13330.0,2,13335.0,5,B
2018-04-16 09:04:37,13325.0,4,6844,4,13325.0,9,13340.0,2,S
2018-04-16 09:04:38,13335.0,10,6854,0,13335.0,1,13340.0,4,B
2018-04-16 09:04:39,13310.0,42,6896,14,13325.0,1,13335.0,6,S
2018-04-16 09:04:39,13330.0,4,6900,0,13325.0,3,13335.0,7,B
2018-04-16 09:04:40,13325.0,8,6908,8,13325.0,6,13330.0,2,S
2018-04-16 09:04:41,13330.0,2,6910,0,13325.0,6,13335.0,7,B
2018-04-16 09:04:43,13335.0,8,6918,0,13335.0,1,13340.0,7,B
2018-04-16 09:04:43,13340.0,14,6932,10,13340.0,2,13345.0,1,B
2018-04-16 09:04:45,13340.0,2,6934,0,13345.0,25,13355.0,3,B
2018-04-16 09:04:46,13345.0,4,6938,-2,13350.0,1,13355.0,5,B
2018-04-16 09:04:47,13365.0,10,6948,-2,13350.0,17,13370.0,2,B
2018-04-16 09:04:48,13360.0,10,6958,-2,13355.0,3,13365.0,2,S
2018-04-16 09:04:48,13365.0,2,6960,0,13360.0,8,13365.0,1,B
2018-04-16 09:04:49,13365.0,4,6964,2,13365.0,3,13370.0,4,B
2018-04-16 09:04:49,13375.0,12,6976,0,13365.0,8,13375.0,1,B
2018-04-16 09:04:50,13350.0,94,7070,38,13345.0,2,13350.0,3,S
2018-04-16 09:04:50,13400.0,32,7102,16,13375.0,1,13395.0,1,B
2018-04-16 09:04:51,13440.0,30,7132,0,13420.0,2,13445.0,4,B
2018-04-16 09:04:51,13470.0,30,7162,10,13450.0,1,13470.0,2,B
2018-04-16 09:04:52,13470.0,18,7180,-4,13460.0,8,13480.0,2,B
2018-04-16 09:04:52,13485.0,12,7192,4,13470.0,3,13490.0,1,B
2018-04-16 09:04:53,13495.0,6,7198,2,13480.0,5,13490.0,1,B
2018-04-16 09:04:53,13485.0,14,7212,2,13485.0,9,13500.0,2,S
2018-04-16 09:04:54,13505.0,6,7218,-2,13505.0,1,13510.0,3,B
2018-04-16 09:04:54,13510.0,38,7256,30,13510.0,2,13520.0,1,B
2018-04-16 09:04:55,13510.0,16,7272,-2,13510.0,1,13515.0,3,B
2018-04-16 09:04:55,13515.0,14,7286,4,13495.0,1,13505.0,4,B
2018-04-16 09:04:56,13500.0,14,7300,4,13490.0,9,13495.0,1,S
2018-04-16 09:04:56,13485.0,8,7308,-6,13485.0,3,13495.0,1,S
2018-04-16 09:04:57,13490.0,12,7320,2,13480.0,1,13495.0,2,B
2018-04-16 09:04:57,13485.0,2,7322,0,13465.0,21,13490.0,8,S
2018-04-16 09:04:58,13485.0,2,7324,-2,13470.0,3,13485.0,9,S
2018-04-16 09:04:59,13470.0,58,7382,-32,13460.0,1,13475.0,5,S
2018-04-16 09:05:00,13475.0,10,7392,-4,13465.0,1,13470.0,4,B
2018-04-16 09:05:00,13460.0,10,7402,8,13465.0,1,13470.0,4,S
2018-04-16 09:05:01,13470.0,14,7416,-6,13470.0,12,13475.0,1,B
2018-04-16 09:05:01,13475.0,2,7418,2,13475.0,15,13480.0,2,B
2018-04-16 09:05:02,13480.0,4,7422,0,13480.0,8,13485.0,2,B
2018-04-16 09:05:02,13480.0,14,7436,-6,13475.0,4,13485.0,4,B
2018-04-16 09:05:03,13480.0,2,7438,2,13475.0,1,13485.0,4,B
2018-04-16 09:05:04,13480.0,8,7446,2,13475.0,9,13485.0,1,B
2018-04-16 09:05:05,13485.0,10,7456,-8,13470.0,3,13485.0,5,B
2018-04-16 09:05:06,13480.0,2,7458,2,13470.0,9,13475.0,1,S
2018-04-16 09:05:06,13475.0,4,7462,0,13475.0,5,13480.0,2,S
2018-04-16 09:05:07,13480.0,4,7466,0,13470.0,10,13480.0,3,B
2018-04-16 09:05:07,13480.0,2,7468,0,13470.0,6,13475.0,2,B
2018-04-16 09:05:08,13475.0,4,7472,0,13475.0,2,13480.0,3,S
2018-04-16 09:05:09,13480.0,4,7476,0,13475.0,3,13485.0,4,B
2018-04-16 09:05:09,13475.0,2,7478,0,13475.0,7,13485.0,1,S
2018-04-16 09:05:12,13475.0,4,7482,0,13475.0,5,13480.0,1,S
2018-04-16 09:05:12,13480.0,8,7490,-6,13485.0,49,13490.0,13,B
2018-04-16 09:05:13,13485.0,24,7514,-16,13485.0,37,13490.0,13,B
2018-04-16 09:05:13,13480.0,76,7590,-38,13475.0,1,13485.0,4,S
2018-04-16 09:05:14,13475.0,2,7592,0,13470.0,1,13475.0,1,S
2018-04-16 09:05:15,13475.0,4,7596,4,13470.0,1,13480.0,9,S
2018-04-16 09:05:15,13475.0,4,7600,2,13465.0,2,13475.0,18,S
2018-04-16 09:05:20,13465.0,2,7602,0,13465.0,2,13470.0,6,S
2018-04-16 09:05:20,13460.0,6,7608,-4,13460.0,3,13470.0,4,S
2018-04-16 09:05:22,13455.0,10,7618,-2,13450.0,12,13465.0,1,S
2018-04-16 09:05:23,13455.0,2,7620,2,13445.0,3,13455.0,8,S
2018-04-16 09:05:24,13450.0,10,7630,-8,13450.0,1,13455.0,2,S
2018-04-16 09:05:26,13450.0,2,7632,0,13450.0,2,13460.0,6,S
2018-04-16 09:05:28,13450.0,4,7636,-2,13445.0,9,13455.0,9,S
2018-04-16 09:05:28,13440.0,4,7640,2,13435.0,1,13445.0,2,S
2018-04-16 09:05:29,13445.0,4,7644,-2,13435.0,1,13450.0,3,B
2018-04-16 09:05:30,13445.0,2,7646,2,13435.0,3,13445.0,9,B
2018-04-16 09:05:33,13445.0,2,7648,0,13440.0,2,13445.0,9,B
2018-04-16 09:05:34,13440.0,4,7652,4,13440.0,3,13445.0,9,S
2018-04-16 09:05:35,13440.0,8,7660,0,13435.0,5,13445.0,9,S
2018-04-16 09:05:36,13435.0,8,7668,0,13435.0,4,13445.0,11,S
2018-04-16 09:05:36,13440.0,2,7670,0,13435.0,4,13445.0,11,B
2018-04-16 09:05:39,13430.0,4,7674,-2,13425.0,2,13440.0,2,S
2018-04-16 09:05:39,13435.0,2,7676,0,13420.0,1,13435.0,9,B
2018-04-16 09:05:40,13420.0,26,7702,-8,13425.0,3,13435.0,12,S
2018-04-16 09:05:42,13430.0,2,7704,-2,13430.0,6,13435.0,16,B
2018-04-16 09:05:43,13430.0,2,7706,0,13430.0,5,13435.0,16,B
2018-04-16 09:05:43,13435.0,2,7708,0,13430.0,5,13435.0,15,B
2018-04-16 09:05:44,13435.0,2,7710,-2,13430.0,5,13435.0,14,B
2018-04-16 09:05:44,13430.0,8,7718,2,13425.0,6,13435.0,14,S
2018-04-16 09:05:45,13435.0,10,7728,6,13425.0,6,13430.0,1,B
2018-04-16 09:05:45,13430.0,2,7730,0,13425.0,8,13435.0,5,S
2018-04-16 09:05:47,13425.0,2,7732,0,13425.0,1,13430.0,4,S
2018-04-16 09:05:47,13425.0,2,7734,0,13420.0,2,13425.0,7,S
2018-04-16 09:05:48,13425.0,6,7740,0,13420.0,2,13430.0,1,S
2018-04-16 09:05:49,13430.0,2,7742,0,13430.0,1,13435.0,5,B
2018-04-16 09:05:50,13435.0,6,7748,2,13430.0,4,13435.0,2,B
2018-04-16 09:05:50,13435.0,4,7752,2,13435.0,5,13440.0,3,B
2018-04-16 09:05:53,13440.0,4,7756,4,13435.0,2,13445.0,6,B
2018-04-16 09:05:54,13445.0,2,7758,2,13440.0,3,13445.0,1,B
2018-04-16 09:05:57,13445.0,4,7762,0,13435.0,2,13445.0,7,B
2018-04-16 09:06:01,13420.0,32,7794,20,13415.0,2,13440.0,10,S
2018-04-16 09:06:01,13430.0,2,7796,-2,13430.0,2,13435.0,13,B
2018-04-16 09:06:02,13435.0,2,7798,2,13430.0,2,13435.0,1,B
2018-04-16 09:06:04,13430.0,10,7808,0,13425.0,3,13430.0,1,S
2018-04-16 09:06:07,13430.0,2,7810,0,13425.0,2,13430.0,1,S
2018-04-16 09:06:09,13430.0,2,7812,0,13430.0,1,13435.0,2,S
2018-04-16 09:06:10,13435.0,2,7814,2,13435.0,11,13440.0,3,B
2018-04-16 09:06:11,13440.0,2,7816,0,13440.0,1,13445.0,5,B
2018-04-16 09:06:11,13445.0,8,7824,-4,13440.0,1,13445.0,1,B
2018-04-16 09:06:12,13450.0,4,7828,-2,13440.0,13,13450.0,6,B
2018-04-16 09:06:14,13450.0,4,7832,0,13445.0,1,13450.0,3,B
2018-04-16 09:06:18,13450.0,6,7838,-2,13445.0,1,13455.0,2,B
2018-04-16 09:06:19,13450.0,2,7840,2,13450.0,14,13460.0,4,B
2018-04-16 09:06:23,13455.0,2,7842,0,13455.0,3,13460.0,3,B
2018-04-16 09:06:26,13455.0,20,7862,20,13450.0,4,13460.0,3,B
2018-04-16 09:06:27,13455.0,6,7868,0,13450.0,3,13460.0,4,B
2018-04-16 09:06:27,13460.0,10,7878,8,13460.0,10,13465.0,9,B
2018-04-16 09:06:28,13455.0,22,7900,18,13450.0,1,13455.0,3,S
2018-04-16 09:06:30,13450.0,2,7902,0,13440.0,3,13450.0,3,S
2018-04-16 09:06:30,13455.0,6,7908,2,13440.0,1,13455.0,4,B
2018-04-16 09:06:31,13455.0,2,7910,-2,13440.0,1,13450.0,17,B
2018-04-16 09:06:38,13450.0,10,7920,0,13440.0,1,13445.0,3,S
2018-04-16 09:06:39,13445.0,2,7922,0,13435.0,3,13445.0,30,S
2018-04-16 09:06:40,13440.0,2,7924,0,13440.0,2,13445.0,1,S
2018-04-16 09:06:47,13435.0,2,7926,0,13435.0,2,13445.0,5,S
2018-04-16 09:06:47,13435.0,2,7928,-2,13430.0,5,13440.0,19,S
2018-04-16 09:06:49,13440.0,2,7930,2,13430.0,5,13440.0,20,B
2018-04-16 09:06:51,13430.0,4,7934,0,13430.0,3,13435.0,9,S
2018-04-16 09:06:51,13430.0,6,7940,0,13425.0,1,13430.0,4,S
2018-04-16 09:06:55,13420.0,2,7942,2,13420.0,4,13425.0,5,S
2018-04-16 09:06:59,13425.0,10,7952,0,13420.0,4,13430.0,10,B
2018-04-16 09:06:59,13425.0,6,7958,-6,13425.0,1,13430.0,10,B
2018-04-16 09:07:00,13430.0,2,7960,2,13425.0,6,13430.0,9,B
2018-04-16 09:07:01,13430.0,18,7978,12,13430.0,1,13435.0,4,B
2018-04-16 09:07:03,13430.0,4,7982,2,13425.0,8,13435.0,5,B
2018-04-16 09:07:03,13430.0,2,7984,-2,13425.0,4,13435.0,4,B
2018-04-16 09:07:11,13435.0,2,7986,-2,13425.0,12,13435.0,4,B
2018-04-16 09:07:15,13435.0,8,7994,2,13425.0,13,13435.0,11,B
2018-04-16 09:07:16,13430.0,4,7998,-4,13425.0,14,13435.0,11,S
2018-04-16 09:07:19,13435.0,12,8010,10,13430.0,14,13435.0,4,B
2018-04-16 09:07:20,13435.0,8,8018,6,13430.0,12,13440.0,7,B
2018-04-16 09:07:21,13435.0,2,8020,0,13430.0,12,13440.0,3,B
2018-04-16 09:07:28,13440.0,4,8024,0,13435.0,11,13445.0,7,B
2018-04-16 09:07:35,13440.0,6,8030,6,13440.0,2,13445.0,7,B
2018-04-16 09:07:36,13440.0,4,8034,2,13430.0,12,13440.0,1,B
2018-04-16 09:07:52,13435.0,2,8036,0,13430.0,5,13440.0,74,S
2018-04-16 09:07:56,13430.0,4,8040,0,13430.0,1,13435.0,18,S
2018-04-16 09:08:04,13435.0,4,8044,2,13430.0,1,13435.0,17,B
2018-04-16 09:08:04,13435.0,10,8054,10,13430.0,1,13435.0,12,B
2018-04-16 09:08:12,13430.0,2,8056,0,13430.0,4,13435.0,22,S
2018-04-16 09:08:12,13430.0,2,8058,0,13430.0,3,13435.0,22,S
2018-04-16 09:08:13,13435.0,8,8066,0,13425.0,2,13435.0,23,B
2018-04-16 09:08:18,13425.0,2,8068,-2,13420.0,4,13425.0,5,S
2018-04-16 09:08:19,13420.0,10,8078,-10,13420.0,4,13425.0,1,S
2018-04-16 09:08:21,13430.0,2,8080,0,13430.0,1,13435.0,16,B
2018-04-16 09:08:24,13430.0,2,8082,0,13425.0,6,13440.0,74,B
2018-04-16 09:08:29,13430.0,2,8084,0,13425.0,6,13430.0,15,B
2018-04-16 09:08:32,13430.0,22,8106,22,13425.0,7,13430.0,4,B
2018-04-16 09:08:33,13430.0,8,8114,6,13430.0,22,13435.0,1,B
2018-04-16 09:08:36,13435.0,2,8116,0,13435.0,1,13440.0,71,B
2018-04-16 09:08:40,13435.0,2,8118,2,13430.0,18,13440.0,69,B
2018-04-16 09:08:44,13435.0,4,8122,-4,13435.0,4,13440.0,71,B
2018-04-16 09:08:44,13435.0,8,8130,0,13430.0,4,13440.0,71,B
2018-04-16 09:08:50,13435.0,4,8134,-2,13430.0,5,13435.0,1,B
2018-04-16 09:08:50,13435.0,4,8138,0,13430.0,21,13440.0,69,B
2018-04-16 09:08:54,13435.0,2,8140,0,13435.0,2,13440.0,72,B
2018-04-16 09:09:00,13440.0,4,8144,-4,13435.0,2,13440.0,70,B
2018-04-16 09:09:03,13435.0,2,8146,0,13435.0,1,13440.0,70,S
2018-04-16 09:09:04,13435.0,12,8158,-10,13430.0,5,13440.0,65,S
2018-04-16 09:09:12,13435.0,2,8160,-2,13435.0,1,13440.0,60,S
2018-04-16 09:09:14,13435.0,4,8164,0,13435.0,4,13440.0,63,S
2018-04-16 09:09:15,13440.0,4,8168,0,13435.0,2,13440.0,61,B
2018-04-16 09:09:26,13435.0,2,8170,0,13435.0,1,13440.0,59,S
2018-04-16 09:09:26,13435.0,2,8172,0,13430.0,20,13440.0,61,S
2018-04-16 09:09:29,13440.0,2,8174,-2,13430.0,27,13440.0,60,B
2018-04-16 09:09:33,13435.0,4,8178,4,13435.0,5,13440.0,58,S
2018-04-16 09:09:34,13440.0,4,8182,0,13435.0,5,13440.0,56,B
2018-04-16 09:09:35,13440.0,2,8184,-2,13435.0,5,13440.0,55,B
2018-04-16 09:09:36,13440.0,58,8242,-44,13435.0,8,13440.0,25,B
2018-04-16 09:09:37,13440.0,36,8278,-22,13435.0,13,13440.0,7,B
2018-04-16 09:09:37,13440.0,12,8290,-12,13435.0,13,13440.0,1,B
2018-04-16 09:09:38,13440.0,2,8292,0,13440.0,7,13445.0,6,B
2018-04-16 09:09:40,13445.0,4,8296,-2,13440.0,9,13445.0,3,B
2018-04-16 09:09:41,13445.0,2,8298,0,13440.0,9,13450.0,11,B
2018-04-16 09:09:42,13450.0,4,8302,0,13440.0,9,13450.0,9,B
2018-04-16 09:09:44,13450.0,8,8310,6,13450.0,4,13455.0,5,B
2018-04-16 09:09:47,13455.0,2,8312,0,13450.0,8,13460.0,6,B
2018-04-16 09:09:51,13460.0,4,8316,-4,13455.0,9,13465.0,9,B
2018-04-16 09:09:54,13465.0,10,8326,-6,13460.0,4,13465.0,5,B
2018-04-16 09:09:55,13465.0,6,8332,2,13465.0,3,13470.0,3,B
2018-04-16 09:09:56,13465.0,2,8334,0,13465.0,2,13470.0,5,B
2018-04-16 09:10:00,13470.0,24,8358,14,13460.0,3,13470.0,9,B
2018-04-16 09:10:00,13470.0,2,8360,2,13460.0,3,13470.0,9,B
2018-04-16 09:10:01,13465.0,2,8362,0,13460.0,8,13470.0,6,S
2018-04-16 09:10:09,13460.0,4,8366,0,13455.0,3,13465.0,2,S
2018-04-16 09:10:12,13455.0,2,8368,-2,13455.0,9,13465.0,2,S
2018-04-16 09:10:12,13465.0,4,8372,-2,13465.0,1,13470.0,14,B
2018-04-16 09:10:13,13465.0,2,8374,0,13460.0,1,13465.0,2,B
2018-04-16 09:10:21,13465.0,2,8376,-2,13460.0,6,13465.0,5,B
2018-04-16 09:10:22,13460.0,2,8378,2,13460.0,5,13465.0,14,S
2018-04-16 09:10:23,13460.0,10,8388,10,13455.0,2,13465.0,14,S
2018-04-16 09:10:25,13460.0,40,8428,-12,13450.0,1,13460.0,7,S
2018-04-16 09:10:56,13455.0,2,8430,-2,13450.0,6,13455.0,2,S
2018-04-16 09:11:00,13455.0,2,8432,0,13450.0,6,13460.0,7,S
2018-04-16 09:11:06,13455.0,2,8434,0,13445.0,4,13455.0,6,S
2018-04-16 09:11:09,13455.0,2,8436,0,13445.0,8,13455.0,5,S
2018-04-16 09:11:11,13455.0,8,8444,-8,13450.0,13,13460.0,9,S
2018-04-16 09:11:16,13455.0,2,8446,0,13450.0,7,13460.0,7,S
2018-04-16 09:11:20,13450.0,2,8448,2,13445.0,13,13450.0,3,S
2018-04-16 09:11:23,13450.0,2,8450,0,13450.0,4,13455.0,5,S
2018-04-16 09:11:30,13450.0,6,8456,6,13450.0,1,13455.0,6,S
2018-04-16 09:11:30,13450.0,2,8458,0,13445.0,9,13455.0,21,S
2018-04-16 09:11:45,13445.0,20,8478,-12,13445.0,6,13455.0,4,S
2018-04-16 09:11:58,13445.0,6,8484,4,13445.0,10,13455.0,5,S
2018-04-16 09:12:08,13445.0,2,8486,2,13445.0,1,13450.0,15,S
2018-04-16 09:12:08,13445.0,2,8488,0,13440.0,3,13450.0,15,S
2018-04-16 09:12:10,13445.0,2,8490,0,13440.0,11,13450.0,15,S
2018-04-16 09:12:13,13440.0,10,8500,4,13440.0,6,13450.0,15,S
2018-04-16 09:12:31,13440.0,8,8508,0,13435.0,8,13440.0,4,S
2018-04-16 09:12:32,13440.0,8,8516,4,13440.0,6,13445.0,9,S
2018-04-16 09:12:37,13440.0,2,8518,0,13440.0,5,13445.0,9,S
2018-04-16 09:12:59,13445.0,2,8520,0,13440.0,5,13445.0,8,B
2018-04-16 09:13:00,13445.0,2,8522,-2,13440.0,5,13445.0,6,B
2018-04-16 09:13:02,13440.0,2,8524,0,13440.0,5,13445.0,27,S
2018-04-16 09:13:03,13440.0,2,8526,2,13440.0,4,13445.0,27,S
2018-04-16 09:13:03,13440.0,8,8534,6,13435.0,3,13445.0,27,S
2018-04-16 09:13:10,13435.0,4,8538,4,13430.0,8,13440.0,15,S
2018-04-16 09:13:12,13430.0,10,8548,-4,13425.0,4,13435.0,11,S
2018-04-16 09:13:16,13430.0,2,8550,2,13425.0,2,13430.0,6,S
2018-04-16 09:13:20,13425.0,2,8552,0,13425.0,4,13430.0,6,S
2018-04-16 09:13:21,13430.0,12,8564,12,13430.0,4,13435.0,22,B
2018-04-16 09:13:22,13430.0,8,8572,0,13425.0,1,13430.0,4,B
2018-04-16 09:13:30,13435.0,4,8576,0,13430.0,14,13440.0,3,B
2018-04-16 09:13:37,13435.0,12,8588,-2,13430.0,4,13440.0,21,B
2018-04-16 09:13:46,13440.0,2,8590,0,13435.0,14,13445.0,25,B
2018-04-16 09:13:51,13440.0,2,8592,0,13435.0,9,13445.0,26,B
2018-04-16 09:13:53,13435.0,8,8600,-8,13435.0,8,13440.0,1,S
2018-04-16 09:13:54,13435.0,2,8602,0,13435.0,4,13440.0,2,S
2018-04-16 09:13:54,13445.0,18,8620,14,13430.0,5,13445.0,19,B
2018-04-16 09:13:55,13435.0,2,8622,0,13435.0,4,13445.0,19,S
2018-04-16 09:14:01,13440.0,2,8624,0,13435.0,4,13440.0,1,B
2018-04-16 09:14:21,13435.0,2,8626,0,13435.0,3,13440.0,2,S
2018-04-16 09:14:22,13440.0,2,8628,2,13430.0,7,13440.0,6,B
2018-04-16 09:14:32,13435.0,2,8630,2,13435.0,14,13440.0,16,S
2018-04-16 09:14:32,13435.0,14,8644,2,13435.0,7,13440.0,37,S
2018-04-16 09:14:33,13435.0,4,8648,0,13435.0,5,13440.0,37,S
2018-04-16 09:14:40,13435.0,2,8650,2,13435.0,4,13440.0,23,S
2018-04-16 09:14:44,13430.0,16,8666,10,13425.0,2,13435.0,8,S
2018-04-16 09:14:45,13425.0,2,8668,-2,13420.0,2,13425.0,3,S
2018-04-16 09:14:46,13420.0,4,8672,2,13415.0,2,13420.0,17,S
2018-04-16 09:14:54,13415.0,2,8674,0,13410.0,5,13420.0,8,S
2018-04-16 09:14:54,13415.0,4,8678,0,13410.0,5,13420.0,10,S
2018-04-16 09:14:57,13420.0,2,8680,2,13415.0,2,13420.0,3,B
2018-04-16 09:14:57,13420.0,2,8682,-2,13415.0,2,13420.0,1,B
2018-04-16 09:14:58,13420.0,2,8684,-2,13420.0,2,13425.0,8,B
2018-04-16 09:15:00,13420.0,2,8686,-2,13420.0,1,13425.0,1,B
2018-04-16 09:15:01,13410.0,2,8688,0,13410.0,7,13420.0,16,S
2018-04-16 09:15:02,13415.0,2,8690,-2,13410.0,3,13415.0,9,B
2018-04-16 09:15:03,13415.0,2,8692,0,13410.0,7,13415.0,1,B
2018-04-16 09:15:03,13415.0,2,8694,-2,13415.0,4,13420.0,6,B
2018-04-16 09:15:04,13420.0,4,8698,4,13415.0,1,13420.0,3,B
2018-04-16 09:15:09,13420.0,20,8718,18,13410.0,10,13420.0,2,B
2018-04-16 09:15:10,13415.0,2,8720,0,13410.0,5,13415.0,3,S
2018-04-16 09:15:11,13415.0,8,8728,0,13410.0,5,13415.0,1,S
2018-04-16 09:15:14,13400.0,18,8746,10,13400.0,5,13410.0,1,S
2018-04-16 09:15:15,13410.0,2,8748,-2,13405.0,37,13415.0,8,B
2018-04-16 09:15:16,13405.0,4,8752,-4,13405.0,35,13415.0,9,S
2018-04-16 09:15:21,13405.0,18,8770,14,13405.0,13,13410.0,13,S
2018-04-16 09:15:22,13405.0,14,8784,12,13405.0,6,13410.0,13,S
2018-04-16 09:15:23,13405.0,4,8788,4,13405.0,4,13410.0,13,S
2018-04-16 09:15:24,13400.0,10,8798,8,13400.0,5,13405.0,3,S
2018-04-16 09:15:24,13400.0,2,8800,-2,13400.0,4,13405.0,2,S
2018-04-16 09:15:25,13410.0,20,8820,10,13400.0,7,13410.0,3,B
2018-04-16 09:15:26,13400.0,2,8822,0,13400.0,6,13410.0,3,S
2018-04-16 09:15:27,13410.0,2,8824,-2,13400.0,8,13410.0,1,B
2018-04-16 09:15:29,13405.0,2,8826,0,13405.0,3,13410.0,1,S
2018-04-16 09:15:30,13400.0,2,8828,2,13400.0,9,13410.0,1,S
2018-04-16 09:15:30,13400.0,2,8830,0,13405.0,4,13410.0,1,S
2018-04-16 09:15:31,13410.0,4,8834,-2,13405.0,6,13410.0,2,B
2018-04-16 09:15:33,13410.0,2,8836,0,13405.0,7,13410.0,1,B
2018-04-16 09:15:34,13410.0,2,8838,0,13410.0,1,13415.0,5,B
2018-04-16 09:15:38,13420.0,4,8842,2,13410.0,6,13420.0,3,B
2018-04-16 09:15:40,13410.0,8,8850,2,13405.0,6,13410.0,1,S
2018-04-16 09:15:40,13410.0,2,8852,0,13410.0,8,13420.0,24,S
2018-04-16 09:15:44,13410.0,2,8854,0,13410.0,5,13420.0,24,S
2018-04-16 09:15:55,13410.0,2,8856,0,13415.0,7,13420.0,23,S
2018-04-16 09:15:56,13415.0,2,8858,-2,13415.0,6,13420.0,23,B
2018-04-16 09:15:58,13415.0,4,8862,0,13415.0,3,13420.0,24,B
2018-04-16 09:16:01,13415.0,2,8864,0,13410.0,6,13420.0,24,B
2018-04-16 09:16:07,13420.0,18,8882,-8,13415.0,11,13420.0,14,B
2018-04-16 09:16:08,13420.0,28,8910,-16,13420.0,4,13425.0,2,B
2018-04-16 09:16:08,13425.0,2,8912,0,13420.0,8,13430.0,4,B
2018-04-16 09:16:09,13425.0,2,8914,-2,13420.0,7,13430.0,7,B
2018-04-16 09:16:12,13430.0,2,8916,2,13420.0,4,13430.0,8,B
2018-04-16 09:16:15,13425.0,2,8918,0,13420.0,4,13430.0,8,S
2018-04-16 09:16:16,13430.0,2,8920,2,13425.0,2,13430.0,7,B
2018-04-16 09:16:17,13425.0,2,8922,0,13420.0,2,13430.0,6,S
2018-04-16 09:16:18,13420.0,4,8926,-2,13420.0,1,13425.0,2,S
2018-04-16 09:16:24,13430.0,2,8928,0,13430.0,1,13435.0,5,B
2018-04-16 09:16:26,13430.0,2,8930,0,13430.0,3,13435.0,3,B
2018-04-16 09:16:28,13435.0,2,8932,2,13430.0,3,13435.0,3,B
2018-04-16 09:16:29,13435.0,2,8934,2,13425.0,15,13435.0,9,B
2018-04-16 09:16:34,13430.0,4,8938,-2,13430.0,8,13435.0,8,S
2018-04-16 09:16:35,13430.0,16,8954,0,13425.0,14,13430.0,2,S
2018-04-16 09:16:35,13425.0,16,8970,2,13425.0,4,13430.0,4,S
2018-04-16 09:16:39,13430.0,2,8972,-2,13425.0,4,13430.0,1,B
2018-04-16 09:16:40,13430.0,2,8974,0,13425.0,4,13430.0,3,B
2018-04-16 09:16:44,13420.0,12,8986,0,13420.0,2,13425.0,1,S
2018-04-16 09:16:44,13425.0,2,8988,0,13420.0,2,13430.0,7,B
2018-04-16 09:16:45,13430.0,2,8990,0,13420.0,2,13430.0,5,B
2018-04-16 09:16:47,13420.0,6,8996,4,13415.0,6,13420.0,2,S
2018-04-16 09:16:47,13420.0,4,9000,4,13420.0,1,13430.0,5,S
2018-04-16 09:16:52,13425.0,2,9002,2,13420.0,1,13425.0,5,B
2018-04-16 09:17:04,13430.0,2,9004,0,13425.0,1,13435.0,9,B
2018-04-16 09:17:11,13435.0,2,9006,0,13430.0,9,13440.0,7,B
2018-04-16 09:17:11,13430.0,2,9008,0,13430.0,9,13440.0,4,S
2018-04-16 09:17:13,13430.0,2,9010,2,13430.0,12,13440.0,3,S
2018-04-16 09:17:19,13430.0,2,9012,2,13430.0,11,13440.0,3,S
2018-04-16 09:17:32,13440.0,6,9018,0,13440.0,3,13445.0,19,B
2018-04-16 09:17:34,13445.0,2,9020,2,13440.0,3,13445.0,14,B
2018-04-16 09:17:39,13445.0,4,9024,0,13440.0,3,13445.0,11,B
2018-04-16 09:17:41,13445.0,6,9030,0,13440.0,3,13445.0,8,B
2018-04-16 09:17:43,13445.0,2,9032,2,13440.0,3,13445.0,7,B
2018-04-16 09:17:48,13445.0,14,9046,14,13445.0,1,13450.0,6,B
2018-04-16 09:17:49,13450.0,2,9048,0,13445.0,1,13450.0,1,B
2018-04-16 09:18:01,13445.0,2,9050,2,13445.0,6,13450.0,3,S
2018-04-16 09:18:02,13450.0,4,9054,-4,13445.0,6,13450.0,1,B
2018-04-16 09:18:02,13450.0,2,9056,-2,13445.0,6,13455.0,16,B
2018-04-16 09:18:10,13450.0,8,9064,-8,13450.0,1,13455.0,18,B
2018-04-16 09:18:10,13445.0,4,9068,0,13440.0,5,13455.0,18,S
2018-04-16 09:18:11,13435.0,2,9070,2,13435.0,5,13450.0,27,S
2018-04-16 09:18:12,13435.0,4,9074,0,13430.0,5,13440.0,3,S
2018-04-16 09:18:29,13430.0,2,9076,0,13425.0,22,13435.0,5,S
2018-04-16 09:18:35,13435.0,2,9078,-2,13425.0,17,13440.0,4,B
2018-04-16 09:18:53,13435.0,2,9080,0,13430.0,4,13435.0,1,B
2018-04-16 09:18:54,13430.0,2,9082,-2,13425.0,11,13435.0,4,S
2018-04-16 09:19:02,13435.0,2,9084,-2,13435.0,1,13440.0,7,B
2018-04-16 09:19:02,13435.0,2,9086,0,13430.0,8,13440.0,4,B
2018-04-16 09:19:21,13440.0,2,9088,-2,13440.0,2,13445.0,9,B
2018-04-16 09:19:32,13440.0,2,9090,2,13440.0,15,13445.0,3,B
2018-04-16 09:19:33,13440.0,2,9092,2,13440.0,14,13445.0,3,B
2018-04-16 09:19:36,13435.0,4,9096,0,13430.0,7,13440.0,6,S
2018-04-16 09:19:42,13430.0,4,9100,0,13430.0,10,13435.0,1,S
2018-04-16 09:19:47,13435.0,2,9102,0,13435.0,1,13440.0,6,B
2018-04-16 09:19:48,13430.0,4,9106,2,13430.0,9,13440.0,4,S
2018-04-16 09:19:53,13440.0,2,9108,-2,13435.0,17,13445.0,6,B
2018-04-16 09:19:55,13430.0,8,9116,2,13430.0,8,13440.0,27,S
2018-04-16 09:19:56,13430.0,2,9118,2,13430.0,8,13440.0,16,S
2018-04-16 09:20:04,13435.0,2,9120,-2,13435.0,1,13440.0,14,B
2018-04-16 09:20:05,13430.0,6,9126,2,13430.0,6,13435.0,1,S
2018-04-16 09:20:18,13420.0,14,9140,4,13420.0,26,13430.0,18,S
2018-04-16 09:20:19,13430.0,22,9162,-10,13420.0,30,13430.0,1,B
2018-04-16 09:20:20,13420.0,2,9164,0,13420.0,26,13425.0,1,S
2018-04-16 09:20:21,13425.0,2,9166,0,13420.0,24,13425.0,2,B
2018-04-16 09:20:22,13420.0,2,9168,2,13420.0,23,13425.0,6,S
2018-04-16 09:20:23,13420.0,2,9170,0,13420.0,22,13425.0,6,S
2018-04-16 09:20:23,13420.0,14,9184,0,13420.0,15,13425.0,6,S
2018-04-16 09:20:24,13420.0,4,9188,-4,13420.0,13,13425.0,6,S
2018-04-16 09:20:24,13420.0,4,9192,-2,13420.0,11,13425.0,6,S
2018-04-16 09:20:25,13420.0,2,9194,-2,13420.0,10,13425.0,6,S
2018-04-16 09:20:26,13425.0,4,9198,4,13420.0,20,13430.0,6,B
2018-04-16 09:20:28,13425.0,2,9200,2,13420.0,22,13430.0,4,B
2018-04-16 09:20:33,13420.0,4,9204,0,13420.0,23,13430.0,2,S
2018-04-16 09:20:39,13420.0,20,9224,0,13420.0,12,13430.0,5,S
2018-04-16 09:20:42,13420.0,16,9240,0,13420.0,3,13430.0,5,S
2018-04-16 09:20:59,13410.0,24,9264,10,13410.0,1,13425.0,7,S
2018-04-16 09:21:02,13415.0,6,9270,2,13410.0,2,13415.0,2,B
2018-04-16 09:21:03,13410.0,2,9272,2,13410.0,2,13415.0,4,S
2018-04-16 09:21:06,13415.0,8,9280,-2,13415.0,1,13420.0,5,B
2018-04-16 09:21:08,13415.0,2,9282,0,13415.0,1,13420.0,5,B
2018-04-16 09:21:12,13415.0,10,9292,10,13410.0,2,13415.0,1,B
2018-04-16 09:21:21,13415.0,8,9300,0,13415.0,1,13420.0,9,B
2018-04-16 09:21:22,13410.0,20,9320,2,13410.0,1,13420.0,9,S
2018-04-16 09:21:23,13420.0,2,9322,2,13410.0,6,13420.0,7,B
2018-04-16 09:21:28,13420.0,4,9326,-2,13415.0,3,13420.0,1,B
2018-04-16 09:21:29,13420.0,2,9328,2,13420.0,1,13425.0,7,B
2018-04-16 09:21:29,13425.0,2,9330,2,13420.0,2,13430.0,9,B
2018-04-16 09:21:34,13430.0,2,9332,2,13420.0,4,13430.0,7,B
2018-04-16 09:21:52,13415.0,20,9352,0,13415.0,6,13430.0,18,S
2018-04-16 09:22:00,13425.0,2,9354,2,13425.0,2,13435.0,7,B
2018-04-16 09:22:13,13435.0,2,9356,2,13430.0,8,13440.0,7,B
2018-04-16 09:22:14,13435.0,2,9358,0,13430.0,4,13435.0,1,B
2018-04-16 09:22:18,13435.0,2,9360,0,13430.0,4,13440.0,9,B
2018-04-16 09:22:22,13430.0,2,9362,0,13425.0,3,13430.0,1,S
2018-04-16 09:22:52,13430.0,2,9364,2,13425.0,11,13435.0,6,S
2018-04-16 09:23:50,13430.0,2,9366,-2,13425.0,10,13430.0,1,S
2018-04-16 09:24:14,13430.0,4,9370,-4,13425.0,13,13435.0,10,S
2018-04-16 09:24:24,13435.0,4,9374,2,13430.0,14,13435.0,4,B
2018-04-16 09:24:32,13435.0,8,9382,-4,13430.0,46,13440.0,7,B
2018-04-16 09:24:56,13435.0,2,9384,0,13430.0,7,13440.0,6,B
2018-04-16 09:25:03,13435.0,38,9422,34,13425.0,3,13440.0,20,B
2018-04-16 09:26:33,13425.0,2,9424,0,13420.0,5,13425.0,1,S
2018-04-16 09:27:00,13430.0,4,9428,0,13425.0,13,13430.0,3,B
2018-04-16 09:27:11,13420.0,4,9432,4,13415.0,5,13425.0,1,S
2018-04-16 09:27:52,13425.0,2,9434,-2,13425.0,4,13430.0,5,B
2018-04-16 09:27:53,13425.0,8,9442,0,13415.0,8,13430.0,12,B
2018-04-16 09:28:29,13425.0,4,9446,0,13420.0,20,13425.0,5,B
2018-04-16 09:28:31,13425.0,10,9456,0,13425.0,15,13430.0,10,B
2018-04-16 09:28:41,13425.0,10,9466,0,13425.0,10,13430.0,9,B
2018-04-16 09:28:56,13430.0,4,9470,0,13425.0,11,13435.0,7,B
2018-04-16 09:29:03,13425.0,8,9478,-8,13425.0,6,13430.0,8,S
2018-04-16 09:29:03,13425.0,2,9480,0,13425.0,5,13430.0,8,S
2018-04-16 09:29:21,13425.0,10,9490,-10,13420.0,20,13430.0,4,S
2018-04-16 09:29:28,13425.0,2,9492,0,13420.0,20,13425.0,7,S
2018-04-16 09:29:29,13425.0,4,9496,0,13420.0,23,13425.0,2,S
2018-04-16 09:29:36,13420.0,4,9500,0,13420.0,18,13425.0,7,S
2018-04-16 09:29:38,13420.0,8,9508,-4,13420.0,14,13425.0,7,S
2018-04-16 09:29:39,13420.0,4,9512,0,13420.0,12,13425.0,18,S
2018-04-16 09:29:40,13420.0,12,9524,-6,13420.0,6,13425.0,18,S
2018-04-16 09:29:40,13420.0,12,9536,-4,13415.0,13,13425.0,19,S
2018-04-16 09:29:41,13415.0,2,9538,0,13415.0,11,13420.0,19,S
2018-04-16 09:29:42,13415.0,2,9540,0,13415.0,10,13420.0,21,S
2018-04-16 09:29:53,13420.0,8,9548,2,13415.0,10,13425.0,18,B
2018-04-16 09:30:05,13415.0,2,9550,0,13415.0,9,13420.0,12,S
2018-04-16 09:30:06,13415.0,8,9558,8,13415.0,5,13420.0,13,S
2018-04-16 09:30:07,13410.0,18,9576,-8,13405.0,4,13415.0,4,S
2018-04-16 09:30:07,13405.0,4,9580,2,13405.0,2,13415.0,2,S
2018-04-16 09:30:08,13405.0,4,9584,0,13410.0,8,13415.0,4,S
2018-04-16 09:30:09,13415.0,4,9588,2,13410.0,8,13420.0,5,B
2018-04-16 09:30:12,13410.0,2,9590,0,13410.0,9,13420.0,4,S
2018-04-16 09:30:31,13410.0,6,9596,-4,13405.0,8,13415.0,3,S
2018-04-16 09:30:42,13410.0,2,9598,0,13410.0,7,13420.0,6,S
2018-04-16 09:30:47,13405.0,8,9606,-4,13405.0,1,13410.0,2,S
2018-04-16 09:30:50,13405.0,2,9608,2,13400.0,4,13405.0,2,S
2018-04-16 09:30:50,13410.0,6,9614,6,13400.0,4,13410.0,4,B
2018-04-16 09:30:51,13400.0,2,9616,0,13400.0,2,13405.0,16,S
2018-04-16 09:30:52,13400.0,4,9620,0,13395.0,3,13400.0,2,S
2018-04-16 09:30:53,13395.0,2,9622,0,13395.0,1,13400.0,9,S
2018-04-16 09:30:54,13400.0,2,9624,0,13395.0,1,13400.0,5,B
2018-04-16 09:30:59,13400.0,2,9626,2,13395.0,5,13405.0,6,B
2018-04-16 09:31:00,13400.0,2,9628,-2,13395.0,5,13405.0,6,B
2018-04-16 09:31:07,13395.0,2,9630,2,13395.0,1,13400.0,12,S
2018-04-16 09:31:08,13395.0,2,9632,0,13390.0,3,13395.0,4,S
2018-04-16 09:31:13,13390.0,2,9634,0,13385.0,4,13390.0,8,S
2018-04-16 09:31:13,13380.0,10,9644,8,13380.0,7,13385.0,1,S
2018-04-16 09:31:14,13375.0,16,9660,4,13370.0,5,13380.0,8,S
2018-04-16 09:31:14,13370.0,4,9664,2,13370.0,5,13380.0,10,S
2018-04-16 09:31:15,13370.0,4,9668,4,13370.0,5,13380.0,10,S
2018-04-16 09:31:16,13375.0,2,9670,0,13375.0,6,13380.0,11,B
2018-04-16 09:31:17,13380.0,4,9674,0,13375.0,6,13380.0,9,B
2018-04-16 09:31:19,13375.0,4,9678,-2,13375.0,5,13380.0,5,S
2018-04-16 09:31:19,13375.0,8,9686,-4,13375.0,3,13380.0,3,S
2018-04-16 09:31:21,13380.0,4,9690,0,13375.0,5,13385.0,3,B
2018-04-16 09:31:22,13385.0,4,9694,-2,13385.0,5,13390.0,3,B
2018-04-16 09:31:25,13385.0,10,9704,2,13380.0,6,13385.0,15,B
2018-04-16 09:31:25,13390.0,32,9736,26,13385.0,17,13395.0,2,B
2018-04-16 09:31:26,13390.0,4,9740,-4,13390.0,1,13395.0,3,B
2018-04-16 09:31:27,13385.0,4,9744,2,13385.0,2,13395.0,6,S
2018-04-16 09:31:32,13395.0,2,9746,2,13395.0,3,13400.0,6,B
2018-04-16 09:31:35,13395.0,2,9748,-2,13395.0,6,13400.0,5,B
2018-04-16 09:31:37,13400.0,2,9750,2,13395.0,6,13400.0,2,B
2018-04-16 09:31:40,13400.0,2,9752,0,13395.0,7,13405.0,5,B
2018-04-16 09:31:41,13400.0,4,9756,-4,13400.0,1,13405.0,7,B
2018-04-16 09:31:45,13400.0,6,9762,2,13400.0,3,13405.0,2,B
2018-04-16 09:31:52,13400.0,2,9764,0,13400.0,2,13405.0,2,B
2018-04-16 09:32:07,13405.0,2,9766,0,13400.0,5,13410.0,4,B
2018-04-16 09:32:13,13410.0,2,9768,-2,13405.0,3,13410.0,1,B
2018-04-16 09:32:13,13405.0,4,9772,0,13405.0,1,13410.0,1,S
2018-04-16 09:32:14,13405.0,4,9776,2,13400.0,8,13405.0,1,S
2018-04-16 09:32:14,13405.0,2,9778,2,13405.0,3,13410.0,2,S
2018-04-16 09:32:27,13410.0,2,9780,2,13405.0,4,13415.0,5,B
2018-04-16 09:32:31,13405.0,4,9784,0,13405.0,2,13410.0,4,S
2018-04-16 09:32:31,13405.0,2,9786,-2,13400.0,4,13410.0,6,S
2018-04-16 09:32:37,13410.0,4,9790,-4,13400.0,3,13410.0,8,B
2018-04-16 09:32:44,13405.0,2,9792,0,13400.0,3,13410.0,8,S
2018-04-16 09:33:07,13405.0,2,9794,2,13400.0,3,13405.0,1,S
2018-04-16 09:33:09,13400.0,4,9798,2,13395.0,2,13405.0,7,S
2018-04-16 09:33:09,13400.0,2,9800,2,13395.0,2,13400.0,4,S
2018-04-16 09:33:13,13395.0,2,9802,-2,13390.0,5,13400.0,9,S
2018-04-16 09:33:15,13400.0,10,9812,0,13390.0,3,13400.0,7,B
2018-04-16 09:33:21,13390.0,2,9814,0,13385.0,2,13395.0,1,S
2018-04-16 09:33:23,13380.0,2,9816,2,13380.0,1,13385.0,3,S
2018-04-16 09:33:25,13380.0,2,9818,2,13375.0,5,13385.0,11,S
2018-04-16 09:33:28,13385.0,4,9822,4,13375.0,3,13385.0,9,B
2018-04-16 09:33:31,13375.0,4,9826,4,13375.0,1,13385.0,9,S
2018-04-16 09:33:33,13375.0,10,9836,2,13370.0,14,13375.0,5,S
2018-04-16 09:33:33,13375.0,2,9838,0,13370.0,13,13375.0,4,S
2018-04-16 09:33:36,13375.0,10,9848,10,13375.0,1,13380.0,1,S
2018-04-16 09:33:43,13375.0,2,9850,2,13375.0,4,13380.0,5,S
2018-04-16 09:33:43,13375.0,2,9852,-2,13375.0,3,13380.0,5,S
2018-04-16 09:33:46,13375.0,10,9862,4,13370.0,13,13375.0,14,S
2018-04-16 09:33:46,13370.0,10,9872,-4,13370.0,8,13375.0,11,S
2018-04-16 09:33:47,13370.0,16,9888,-14,13365.0,4,13375.0,12,S
2018-04-16 09:33:48,13365.0,4,9892,2,13360.0,4,13365.0,7,S
2018-04-16 09:33:49,13360.0,8,9900,-4,13355.0,3,13365.0,7,S
2018-04-16 09:33:51,13355.0,2,9902,2,13355.0,3,13365.0,9,S
2018-04-16 09:33:59,13365.0,2,9904,2,13365.0,1,13370.0,12,B
2018-04-16 09:34:01,13370.0,14,9918,-10,13370.0,3,13375.0,14,B
2018-04-16 09:34:01,13375.0,4,9922,-2,13370.0,2,13375.0,9,B
2018-04-16 09:34:02,13370.0,4,9926,-4,13370.0,3,13375.0,2,S
2018-04-16 09:34:04,13375.0,2,9928,0,13370.0,3,13380.0,5,B
2018-04-16 09:34:05,13380.0,2,9930,2,13365.0,5,13380.0,9,B
2018-04-16 09:34:08,13370.0,2,9932,0,13365.0,5,13375.0,4,S
2018-04-16 09:34:12,13375.0,4,9936,0,13375.0,3,13385.0,27,B
2018-04-16 09:34:16,13375.0,2,9938,0,13375.0,2,13385.0,6,B
2018-04-16 09:34:19,13385.0,2,9940,0,13375.0,2,13385.0,5,B
2018-04-16 09:34:19,13385.0,2,9942,0,13375.0,2,13385.0,5,B
2018-04-16 09:34:26,13385.0,2,9944,2,13385.0,12,13390.0,3,B
2018-04-16 09:34:27,13390.0,2,9946,0,13385.0,8,13395.0,2,B
2018-04-16 09:34:28,13390.0,2,9948,0,13390.0,3,13395.0,3,B
2018-04-16 09:34:34,13390.0,2,9950,0,13390.0,6,13395.0,2,B
2018-04-16 09:34:37,13395.0,2,9952,0,13390.0,6,13395.0,3,B
2018-04-16 09:34:37,13395.0,6,9958,0,13390.0,6,13400.0,2,B
2018-04-16 09:34:48,13395.0,2,9960,0,13395.0,2,13400.0,6,B
2018-04-16 09:34:53,13395.0,6,9966,-4,13390.0,2,13400.0,5,B
2018-04-16 09:34:58,13390.0,4,9970,-4,13385.0,7,13395.0,1,S
2018-04-16 09:35:02,13390.0,8,9978,0,13385.0,2,13390.0,4,S
2018-04-16 09:35:05,13380.0,4,9982,0,13380.0,2,13390.0,4,S
2018-04-16 09:35:19,13375.0,6,9988,2,13370.0,4,13385.0,5,S
2018-04-16 09:35:29,13380.0,10,9998,4,13375.0,8,13380.0,15,B
2018-04-16 09:35:30,13380.0,2,10000,0,13375.0,7,13380.0,14,B
2018-04-16 09:35:33,13375.0,10,10010,8,13375.0,6,13380.0,10,S
2018-04-16 09:35:37,13380.0,20,10030,8,13375.0,7,13385.0,1,B
2018-04-16 09:35:39,13385.0,2,10032,0,13385.0,4,13390.0,2,B
2018-04-16 09:35:50,13395.0,2,10034,2,13395.0,4,13400.0,3,B
2018-04-16 09:36:01,13395.0,8,10042,0,13390.0,9,13400.0,7,B
2018-04-16 09:36:03,13390.0,2,10044,2,13385.0,4,13395.0,5,S
2018-04-16 09:36:06,13395.0,2,10046,0,13385.0,2,13395.0,4,B
2018-04-16 09:36:12,13395.0,2,10048,0,13390.0,1,13400.0,9,B
2018-04-16 09:36:16,13395.0,6,10054,-6,13395.0,2,13400.0,8,B
2018-04-16 09:36:16,13395.0,2,10056,0,13395.0,1,13400.0,8,B
2018-04-16 09:36:25,13400.0,8,10064,2,13400.0,2,13405.0,5,B
2018-04-16 09:36:26,13400.0,4,10068,4,13390.0,2,13400.0,4,B
2018-04-16 09:36:34,13405.0,4,10072,-2,13405.0,1,13410.0,3,B
2018-04-16 09:36:38,13410.0,4,10076,0,13405.0,3,13415.0,16,B
2018-04-16 09:36:39,13410.0,6,10082,0,13410.0,5,13415.0,4,B
2018-04-16 09:36:42,13415.0,2,10084,2,13410.0,5,13420.0,15,B
2018-04-16 09:36:43,13420.0,2,10086,0,13410.0,5,13420.0,14,B
2018-04-16 09:36:45,13420.0,2,10088,0,13410.0,5,13420.0,14,B
2018-04-16 09:36:48,13420.0,2,10090,2,13410.0,5,13420.0,13,B
2018-04-16 09:36:59,13415.0,2,10092,2,13410.0,6,13420.0,4,S
2018-04-16 09:37:03,13415.0,4,10096,-4,13410.0,6,13415.0,7,S
2018-04-16 09:37:12,13415.0,4,10100,0,13410.0,6,13415.0,5,S
2018-04-16 09:37:13,13410.0,8,10108,0,13410.0,2,13415.0,9,S
2018-04-16 09:37:13,13410.0,4,10112,-2,13405.0,4,13415.0,10,S
2018-04-16 09:37:21,13405.0,4,10116,-2,13405.0,1,13410.0,1,S
2018-04-16 09:37:22,13400.0,4,10120,-2,13400.0,1,13405.0,6,S
2018-04-16 09:37:22,13400.0,2,10122,-2,13395.0,4,13400.0,1,S
2018-04-16 09:37:24,13400.0,2,10124,0,13395.0,4,13405.0,3,S
2018-04-16 09:37:32,13395.0,4,10128,0,13390.0,2,13400.0,4,S
2018-04-16 09:37:32,13395.0,2,10130,0,13390.0,1,13395.0,4,S
2018-04-16 09:37:33,13390.0,2,10132,-2,13385.0,2,13390.0,3,S
2018-04-16 09:37:34,13390.0,4,10136,-4,13385.0,6,13395.0,2,S
2018-04-16 09:37:44,13385.0,4,10140,0,13380.0,3,13390.0,9,S
2018-04-16 09:37:45,13380.0,4,10144,2,13380.0,2,13385.0,4,S
2018-04-16 09:37:49,13380.0,4,10148,-2,13375.0,3,13385.0,9,S
2018-04-16 09:37:53,13385.0,2,10150,0,13380.0,3,13385.0,6,B
2018-04-16 09:37:55,13380.0,4,10154,0,13380.0,1,13385.0,6,S
2018-04-16 09:37:55,13380.0,4,10158,-4,13375.0,8,13385.0,6,S
2018-04-16 09:37:57,13380.0,2,10160,-2,13375.0,8,13385.0,7,S
2018-04-16 09:37:58,13385.0,16,10176,-4,13385.0,3,13390.0,6,B
2018-04-16 09:37:58,13385.0,6,10182,-4,13380.0,2,13390.0,4,B
2018-04-16 09:38:03,13380.0,2,10184,2,13380.0,10,13385.0,4,S
2018-04-16 09:38:04,13380.0,6,10190,-6,13380.0,7,13385.0,4,S
2018-04-16 09:38:04,13380.0,14,10204,-8,13375.0,3,13380.0,3,S
2018-04-16 09:38:05,13375.0,4,10208,0,13370.0,6,13375.0,1,S
2018-04-16 09:38:07,13370.0,2,10210,-2,13370.0,5,13375.0,2,S
2018-04-16 09:38:08,13375.0,2,10212,0,13375.0,3,13380.0,2,B
2018-04-16 09:38:09,13380.0,4,10216,-2,13375.0,2,13385.0,5,B
2018-04-16 09:38:14,13380.0,2,10218,2,13375.0,2,13380.0,1,B
2018-04-16 09:38:16,13380.0,2,10220,0,13380.0,4,13385.0,6,B
2018-04-16 09:38:17,13380.0,8,10228,0,13375.0,2,13385.0,7,B
2018-04-16 09:38:21,13375.0,2,10230,2,13375.0,14,13380.0,1,S
2018-04-16 09:38:24,13375.0,4,10234,-4,13375.0,12,13380.0,3,S
2018-04-16 09:38:25,13380.0,2,10236,-2,13375.0,13,13380.0,2,B
2018-04-16 09:38:28,13375.0,2,10238,0,13375.0,22,13380.0,5,S
2018-04-16 09:38:31,13380.0,4,10242,4,13380.0,1,13385.0,7,B
2018-04-16 09:38:35,13380.0,2,10244,0,13375.0,22,13380.0,1,B
2018-04-16 09:38:36,13380.0,2,10246,0,13375.0,22,13385.0,3,B
2018-04-16 09:38:42,13385.0,6,10252,-4,13375.0,23,13390.0,4,B
2018-04-16 09:38:45,13390.0,2,10254,2,13380.0,9,13390.0,2,B
2018-04-16 09:38:45,13380.0,10,10264,0,13380.0,4,13390.0,2,S
2018-04-16 09:38:59,13390.0,4,10268,0,13380.0,6,13390.0,1,B
2018-04-16 09:39:04,13385.0,14,10282,-2,13385.0,1,13395.0,8,S
2018-04-16 09:39:06,13395.0,4,10286,0,13390.0,10,13400.0,8,B
2018-04-16 09:39:13,13395.0,2,10288,2,13390.0,3,13400.0,3,B
2018-04-16 09:39:20,13390.0,4,10292,0,13390.0,2,13395.0,2,S
2018-04-16 09:39:25,13390.0,4,10296,2,13385.0,2,13395.0,1,S
2018-04-16 09:39:45,13395.0,2,10298,0,13395.0,1,13400.0,11,B
2018-04-16 09:39:53,13395.0,2,10300,-2,13390.0,7,13395.0,9,B
2018-04-16 09:39:54,13390.0,4,10304,0,13390.0,5,13395.0,9,S
2018-04-16 09:40:01,13385.0,4,10308,0,13380.0,3,13395.0,9,S
2018-04-16 09:40:05,13390.0,2,10310,2,13380.0,4,13390.0,11,B
2018-04-16 09:40:23,13380.0,6,10316,4,13380.0,1,13390.0,7,S
2018-04-16 09:40:31,13380.0,2,10318,2,13380.0,4,13385.0,9,S
2018-04-16 09:40:31,13380.0,10,10328,-2,13380.0,5,13385.0,6,S
2018-04-16 09:40:38,13380.0,2,10330,2,13380.0,4,13390.0,7,S
2018-04-16 09:40:40,13385.0,6,10336,-6,13380.0,9,13385.0,2,B
2018-04-16 09:40:56,13385.0,6,10342,2,13380.0,8,13390.0,6,B
2018-04-16 09:41:00,13390.0,4,10346,2,13390.0,1,13395.0,4,B
2018-04-16 09:41:11,13395.0,2,10348,2,13390.0,8,13400.0,11,B
2018-04-16 09:41:15,13395.0,2,10350,2,13395.0,1,13400.0,8,B
2018-04-16 09:41:17,13395.0,2,10352,2,13395.0,1,13400.0,8,B
2018-04-16 09:41:18,13395.0,2,10354,0,13390.0,8,13400.0,7,B
2018-04-16 09:41:20,13395.0,12,10366,0,13390.0,6,13400.0,7,B
2018-04-16 09:41:26,13400.0,2,10368,2,13395.0,10,13400.0,6,B
2018-04-16 09:41:28,13400.0,2,10370,0,13395.0,10,13400.0,5,B
2018-04-16 09:41:31,13395.0,2,10372,0,13395.0,2,13400.0,5,S
2018-04-16 09:41:32,13395.0,4,10376,0,13390.0,4,13400.0,5,S
2018-04-16 09:41:43,13395.0,2,10378,2,13395.0,8,13400.0,5,S
2018-04-16 09:41:50,13400.0,2,10380,2,13395.0,13,13400.0,4,B
2018-04-16 09:41:52,13400.0,2,10382,2,13395.0,13,13400.0,3,B
2018-04-16 09:41:52,13400.0,4,10386,4,13395.0,13,13400.0,1,B
2018-04-16 09:41:53,13400.0,2,10388,0,13395.0,13,13405.0,5,B
2018-04-16 09:41:57,13400.0,2,10390,0,13395.0,13,13400.0,4,B
2018-04-16 09:42:10,13400.0,6,10396,-6,13395.0,11,13400.0,1,B
2018-04-16 09:42:38,13395.0,2,10398,0,13390.0,6,13400.0,3,S
2018-04-16 09:42:40,13395.0,2,10400,-2,13390.0,14,13400.0,2,S
2018-04-16 09:43:16,13400.0,2,10402,0,13395.0,11,13400.0,12,B
2018-04-16 09:43:39,13395.0,2,10404,-2,13390.0,10,13400.0,27,S
2018-04-16 09:43:48,13395.0,4,10408,0,13395.0,9,13400.0,14,S
2018-04-16 09:43:58,13395.0,10,10418,0,13395.0,7,13400.0,14,S
2018-04-16 09:44:00,13395.0,2,10420,-2,13395.0,5,13400.0,14,S
2018-04-16 09:44:01,13395.0,6,10426,-4,13395.0,2,13400.0,14,S
2018-04-16 09:44:01,13395.0,4,10430,0,13390.0,8,13395.0,10,S
2018-04-16 09:44:03,13395.0,2,10432,0,13390.0,9,13395.0,9,S
2018-04-16 09:44:09,13395.0,4,10436,4,13390.0,4,13395.0,7,S
2018-04-16 09:44:17,13395.0,2,10438,0,13390.0,6,13395.0,6,S
2018-04-16 09:44:28,13390.0,6,10444,2,13390.0,3,13395.0,6,S
2018-04-16 09:44:28,13390.0,6,10450,-6,13385.0,5,13390.0,10,S
2018-04-16 09:44:43,13390.0,2,10452,0,13380.0,11,13390.0,3,S
2018-04-16 09:44:47,13390.0,2,10454,2,13380.0,12,13390.0,2,S
2018-04-16 09:44:49,13385.0,4,10458,0,13380.0,7,13385.0,4,S
2018-04-16 09:44:58,13380.0,8,10466,0,13380.0,3,13385.0,16,S
2018-04-16 09:45:00,13380.0,4,10470,2,13380.0,1,13385.0,4,S
2018-04-16 09:45:01,13380.0,2,10472,2,13375.0,20,13385.0,4,S
2018-04-16 09:45:06,13385.0,4,10476,-4,13375.0,19,13385.0,2,B
2018-04-16 09:45:09,13385.0,4,10480,-2,13385.0,4,13390.0,8,B
2018-04-16 09:45:13,13390.0,2,10482,2,13390.0,1,13395.0,8,B
2018-04-16 09:45:14,13390.0,2,10484,2,13385.0,9,13395.0,9,B
2018-04-16 09:45:16,13390.0,2,10486,2,13390.0,1,13395.0,8,B
2018-04-16 09:45:22,13390.0,2,10488,0,13385.0,4,13390.0,2,B
2018-04-16 09:45:26,13390.0,2,10490,0,13385.0,4,13395.0,10,B
2018-04-16 09:45:34,13395.0,12,10502,12,13390.0,12,13395.0,3,B
2018-04-16 09:45:34,13395.0,6,10508,2,13390.0,12,13400.0,7,B
2018-04-16 09:45:37,13400.0,6,10514,6,13395.0,11,13405.0,7,B
2018-04-16 09:45:39,13395.0,6,10520,4,13395.0,7,13405.0,2,S
2018-04-16 09:45:42,13405.0,2,10522,2,13400.0,37,13410.0,7,B
2018-04-16 09:45:43,13405.0,2,10524,0,13405.0,3,13410.0,6,B
2018-04-16 09:45:44,13405.0,6,10530,-2,13405.0,1,13410.0,6,B
2018-04-16 09:45:44,13405.0,2,10532,-2,13400.0,30,13410.0,4,B
2018-04-16 09:45:45,13405.0,2,10534,0,13400.0,30,13410.0,4,B
2018-04-16 09:45:47,13410.0,2,10536,0,13405.0,3,13410.0,3,B
2018-04-16 09:45:52,13410.0,6,10542,-2,13400.0,7,13415.0,18,B
2018-04-16 09:45:54,13410.0,4,10546,-4,13410.0,28,13415.0,11,B
2018-04-16 09:45:54,13410.0,2,10548,0,13410.0,27,13415.0,10,B
2018-04-16 09:45:56,13415.0,2,10550,-2,13410.0,27,13415.0,4,B
2018-04-16 09:45:57,13415.0,14,10564,12,13415.0,4,13420.0,9,B
2018-04-16 09:45:57,13415.0,8,10572,0,13410.0,26,13415.0,3,B
2018-04-16 09:45:58,13415.0,10,10582,6,13410.0,26,13420.0,14,B
2018-04-16 09:46:05,13415.0,2,10584,2,13410.0,26,13420.0,10,B
2018-04-16 09:46:09,13420.0,14,10598,6,13420.0,2,13425.0,7,B
2018-04-16 09:46:10,13420.0,6,10604,2,13420.0,2,13425.0,3,B
2018-04-16 09:46:11,13425.0,6,10610,-4,13420.0,8,13430.0,5,B
2018-04-16 09:46:17,13425.0,2,10612,0,13425.0,3,13430.0,5,B
2018-04-16 09:46:20,13430.0,2,10614,2,13420.0,9,13430.0,5,B
2018-04-16 09:46:26,13430.0,2,10616,0,13425.0,35,13430.0,5,B
2018-04-16 09:46:26,13430.0,4,10620,-4,13425.0,35,13430.0,3,B
2018-04-16 09:46:28,13430.0,2,10622,2,13425.0,34,13430.0,2,B
2018-04-16 09:46:33,13430.0,2,10624,0,13425.0,32,13430.0,1,B
2018-04-16 09:46:34,13430.0,2,10626,2,13425.0,32,13435.0,6,B
2018-04-16 09:46:40,13425.0,2,10628,2,13425.0,29,13435.0,9,S
2018-04-16 09:46:43,13430.0,2,10630,-2,13425.0,26,13435.0,10,B
2018-04-16 09:46:48,13425.0,20,10650,-20,13425.0,16,13435.0,11,S
2018-04-16 09:47:03,13425.0,32,10682,-4,13420.0,2,13430.0,10,S
2018-04-16 09:47:03,13420.0,4,10686,4,13415.0,4,13420.0,2,S
2018-04-16 09:47:04,13415.0,4,10690,-2,13410.0,4,13420.0,2,S
2018-04-16 09:47:05,13415.0,4,10694,0,13410.0,8,13420.0,4,S
2018-04-16 09:47:07,13415.0,4,10698,2,13410.0,8,13420.0,2,S
2018-04-16 09:47:16,13420.0,4,10702,2,13415.0,9,13425.0,7,B
2018-04-16 09:47:24,13420.0,2,10704,2,13415.0,2,13425.0,8,B
2018-04-16 09:47:25,13415.0,4,10708,2,13410.0,13,13425.0,8,S
2018-04-16 09:47:37,13415.0,2,10710,-2,13415.0,1,13420.0,6,S
2018-04-16 09:47:47,13415.0,2,10712,-2,13415.0,1,13420.0,4,S
2018-04-16 09:48:49,13415.0,2,10714,-2,13415.0,2,13420.0,10,S
2018-04-16 09:48:50,13415.0,4,10718,-4,13410.0,10,13420.0,10,S
2018-04-16 09:50:04,13420.0,6,10724,4,13420.0,4,13425.0,6,B
2018-04-16 09:50:05,13420.0,10,10734,2,13420.0,1,13425.0,5,B
2018-04-16 09:50:36,13420.0,2,10736,2,13415.0,6,13425.0,6,B
2018-04-16 09:50:36,13425.0,2,10738,2,13415.0,6,13425.0,5,B
2018-04-16 09:50:50,13420.0,2,10740,-2,13415.0,1,13420.0,1,S
2018-04-16 09:51:09,13420.0,18,10758,18,13415.0,8,13420.0,1,S
2018-04-16 09:51:20,13415.0,2,10760,0,13410.0,5,13420.0,6,S
2018-04-16 09:51:21,13410.0,2,10762,2,13410.0,3,13415.0,13,S
2018-04-16 09:51:22,13410.0,4,10766,-2,13410.0,1,13415.0,13,S
2018-04-16 09:51:28,13410.0,2,10768,2,13405.0,6,13415.0,14,S
2018-04-16 09:51:30,13410.0,2,10770,0,13405.0,4,13415.0,3,S
2018-04-16 09:51:30,13415.0,6,10776,6,13415.0,5,13420.0,12,B
2018-04-16 09:51:31,13415.0,10,10786,4,13410.0,1,13415.0,4,B
2018-04-16 09:51:38,13415.0,4,10790,2,13405.0,7,13420.0,25,B
2018-04-16 09:51:43,13405.0,4,10794,0,13405.0,9,13415.0,7,S
2018-04-16 09:51:47,13415.0,8,10802,8,13405.0,7,13415.0,3,B
2018-04-16 09:51:55,13415.0,6,10808,6,13415.0,1,13420.0,21,B
2018-04-16 09:51:55,13415.0,2,10810,0,13410.0,1,13420.0,23,B
2018-04-16 09:52:06,13420.0,2,10812,2,13410.0,1,13420.0,11,B
2018-04-16 09:52:10,13420.0,4,10816,2,13405.0,10,13420.0,9,B
2018-04-16 09:52:31,13415.0,2,10818,0,13410.0,1,13415.0,1,S
2018-04-16 09:52:36,13415.0,2,10820,2,13410.0,7,13420.0,9,S
2018-04-16 09:52:56,13410.0,4,10824,0,13410.0,5,13415.0,1,S
2018-04-16 09:53:01,13410.0,2,10826,0,13405.0,6,13410.0,1,S
2018-04-16 09:53:27,13405.0,4,10830,0,13405.0,3,13410.0,1,S
2018-04-16 09:53:33,13410.0,2,10832,2,13405.0,3,13410.0,4,B
2018-04-16 09:53:40,13410.0,4,10836,2,13405.0,3,13410.0,1,B
2018-04-16 09:53:52,13410.0,2,10838,-2,13410.0,4,13415.0,1,B
2018-04-16 09:54:07,13415.0,2,10840,-2,13410.0,1,13415.0,1,B
2018-04-16 09:54:18,13415.0,2,10842,-2,13415.0,3,13420.0,4,B
2018-04-16 09:54:24,13420.0,6,10848,0,13415.0,2,13420.0,1,B
2018-04-16 09:54:24,13420.0,2,10850,0,13415.0,6,13425.0,6,B
2018-04-16 09:54:40,13425.0,2,10852,0,13420.0,1,13425.0,2,B
2018-04-16 09:54:42,13425.0,2,10854,0,13420.0,1,13425.0,1,B
2018-04-16 09:55:09,13410.0,2,10856,0,13405.0,8,13410.0,4,S
2018-04-16 09:55:14,13405.0,2,10858,-2,13405.0,2,13410.0,5,S
2018-04-16 09:55:40,13405.0,6,10864,-6,13400.0,5,13405.0,3,S
2018-04-16 09:55:46,13400.0,4,10868,0,13395.0,5,13405.0,3,S
2018-04-16 09:56:14,13395.0,6,10874,-4,13400.0,1,13405.0,4,S
2018-04-16 09:56:20,13405.0,6,10880,2,13405.0,5,13410.0,8,B
2018-04-16 09:56:21,13410.0,2,10882,2,13405.0,16,13410.0,4,B
2018-04-16 09:56:34,13410.0,2,10884,0,13405.0,12,13410.0,3,B
2018-04-16 09:57:17,13405.0,2,10886,-2,13400.0,6,13410.0,3,S
2018-04-16 09:57:21,13400.0,4,10890,2,13395.0,6,13405.0,1,S
2018-04-16 09:58:25,13400.0,6,10896,2,13395.0,5,13400.0,2,S
2018-04-16 09:58:26,13400.0,4,10900,0,13400.0,3,13405.0,3,S
2018-04-16 09:59:15,13400.0,8,10908,0,13395.0,5,13400.0,2,S
2018-04-16 09:59:16,13400.0,2,10910,0,13395.0,7,13400.0,1,S
2018-04-16 09:59:18,13400.0,2,10912,2,13395.0,7,13405.0,2,S
2018-04-16 09:59:22,13400.0,2,10914,-2,13395.0,7,13405.0,5,S
2018-04-16 09:59:23,13395.0,2,10916,2,13395.0,2,13400.0,6,S
2018-04-16 09:59:38,13395.0,4,10920,4,13390.0,3,13400.0,5,S
2018-04-16 09:59:44,13390.0,2,10922,-2,13390.0,3,13395.0,1,S
2018-04-16 10:00:03,13380.0,2,10924,0,13380.0,1,13385.0,3,S
2018-04-16 10:00:10,13385.0,2,10926,0,13380.0,1,13385.0,2,B
2018-04-16 10:00:12,13380.0,4,10930,0,13375.0,33,13380.0,1,S
2018-04-16 10:00:12,13380.0,2,10932,2,13380.0,5,13385.0,1,S
2018-04-16 10:00:13,13390.0,2,10934,0,13380.0,8,13395.0,16,B
2018-04-16 10:00:21,13390.0,2,10936,0,13385.0,2,13390.0,3,B
2018-04-16 10:00:24,13390.0,2,10938,2,13385.0,2,13390.0,3,B
2018-04-16 10:00:34,13385.0,4,10942,-2,13380.0,11,13385.0,10,S
2018-04-16 10:00:35,13385.0,6,10948,0,13380.0,7,13385.0,1,S
2018-04-16 10:00:36,13390.0,4,10952,4,13385.0,1,13390.0,2,B
2018-04-16 10:00:39,13385.0,2,10954,0,13380.0,7,13385.0,1,S
2018-04-16 10:00:51,13385.0,2,10956,-2,13385.0,18,13395.0,4,S
2018-04-16 10:01:31,13380.0,4,10960,2,13380.0,7,13390.0,5,S
2018-04-16 10:01:38,13380.0,2,10962,0,13380.0,6,13390.0,5,S
2018-04-16 10:02:23,13395.0,2,10964,0,13390.0,3,13400.0,5,B
2018-04-16 10:02:28,13390.0,4,10968,0,13390.0,1,13400.0,5,S
2018-04-16 10:02:40,13395.0,2,10970,-2,13390.0,3,13395.0,1,B
2018-04-16 10:03:03,13390.0,4,10974,0,13390.0,2,13395.0,1,S
2018-04-16 10:03:05,13390.0,2,10976,0,13390.0,1,13395.0,6,S
2018-04-16 10:03:08,13395.0,2,10978,2,13390.0,1,13395.0,4,B
2018-04-16 10:03:28,13395.0,2,10980,0,13390.0,1,13395.0,3,B
2018-04-16 10:03:49,13395.0,2,10982,2,13385.0,6,13395.0,4,B
2018-04-16 10:04:07,13385.0,4,10986,2,13380.0,20,13395.0,5,S
2018-04-16 10:04:38,13385.0,2,10988,-2,13380.0,12,13390.0,7,S
2018-04-16 10:04:46,13380.0,2,10990,0,13380.0,11,13390.0,7,S
2018-04-16 10:05:06,13380.0,14,11004,8,13375.0,21,13385.0,9,S
2018-04-16 10:05:10,13375.0,4,11008,0,13375.0,16,13380.0,1,S
2018-04-16 10:05:11,13375.0,20,11028,0,13375.0,6,13380.0,1,S
2018-04-16 10:05:11,13375.0,6,11034,0,13375.0,3,13380.0,22,S
2018-04-16 10:06:00,13390.0,4,11038,0,13380.0,7,13390.0,4,B
2018-04-16 10:06:08,13385.0,2,11040,2,13380.0,5,13390.0,6,S
2018-04-16 10:06:12,13385.0,4,11044,0,13380.0,9,13385.0,2,S
2018-04-16 10:06:13,13385.0,4,11048,4,13380.0,21,13395.0,10,S
2018-04-16 10:06:21,13385.0,2,11050,2,13385.0,11,13395.0,7,S
2018-04-16 10:06:32,13395.0,2,11052,2,13390.0,3,13400.0,4,B
2018-04-16 10:06:40,13405.0,2,11054,0,13395.0,5,13405.0,5,B
2018-04-16 10:07:07,13390.0,10,11064,-8,13390.0,5,13395.0,1,S
2018-04-16 10:07:09,13395.0,2,11066,2,13385.0,2,13395.0,3,B
2018-04-16 10:07:11,13400.0,6,11072,2,13385.0,5,13400.0,11,B
2018-04-16 10:07:13,13385.0,6,11078,-4,13385.0,3,13395.0,5,S
2018-04-16 10:07:17,13395.0,4,11082,-2,13385.0,4,13395.0,4,B
2018-04-16 10:07:19,13395.0,4,11086,-4,13390.0,3,13400.0,5,B
2018-04-16 10:07:20,13400.0,2,11088,0,13400.0,1,13405.0,6,B
2018-04-16 10:07:21,13400.0,2,11090,0,13395.0,2,13405.0,2,B
2018-04-16 10:07:29,13395.0,2,11092,-2,13395.0,1,13400.0,1,S
2018-04-16 10:07:32,13395.0,4,11096,0,13390.0,4,13395.0,7,S
2018-04-16 10:07:33,13390.0,2,11098,0,13390.0,3,13395.0,4,S
2018-04-16 10:07:46,13400.0,4,11102,0,13395.0,9,13400.0,2,B
2018-04-16 10:07:58,13400.0,4,11106,-2,13395.0,9,13405.0,4,B
2018-04-16 10:08:02,13400.0,2,11108,0,13395.0,9,13405.0,25,B
2018-04-16 10:08:16,13395.0,2,11110,0,13395.0,8,13400.0,1,S
2018-04-16 10:08:21,13400.0,2,11112,0,13395.0,8,13405.0,26,B
2018-04-16 10:09:08,13395.0,18,11130,0,13390.0,18,13400.0,2,S
2018-04-16 10:09:33,13395.0,2,11132,-2,13390.0,18,13400.0,6,S
2018-04-16 10:09:35,13395.0,6,11138,6,13395.0,6,13400.0,7,S
2018-04-16 10:09:35,13400.0,8,11146,6,13395.0,29,13405.0,3,B
2018-04-16 10:09:41,13395.0,2,11148,-2,13390.0,5,13400.0,5,S
2018-04-16 10:09:49,13395.0,2,11150,-2,13390.0,5,13395.0,6,S
2018-04-16 10:09:56,13390.0,2,11152,0,13390.0,3,13395.0,1,S
2018-04-16 10:09:57,13390.0,8,11160,6,13385.0,4,13390.0,3,S
2018-04-16 10:09:59,13385.0,4,11164,0,13385.0,1,13390.0,12,S
2018-04-16 10:10:00,13385.0,2,11166,-2,13385.0,1,13390.0,12,S
2018-04-16 10:10:00,13385.0,2,11168,2,13385.0,1,13390.0,12,S
2018-04-16 10:10:01,13385.0,2,11170,0,13385.0,1,13390.0,12,S
2018-04-16 10:10:01,13385.0,2,11172,2,13380.0,5,13390.0,12,S
2018-04-16 10:10:03,13385.0,2,11174,2,13380.0,6,13390.0,12,S
2018-04-16 10:11:13,13385.0,2,11176,0,13385.0,4,13390.0,7,S
2018-04-16 10:11:19,13385.0,2,11178,-2,13385.0,3,13390.0,3,S
2018-04-16 10:11:20,13390.0,6,11184,0,13390.0,3,13395.0,5,B
2018-04-16 10:11:29,13390.0,6,11190,-6,13385.0,7,13395.0,6,B
2018-04-16 10:11:31,13390.0,2,11192,0,13390.0,1,13395.0,7,B
2018-04-16 10:12:06,13390.0,2,11194,0,13385.0,4,13390.0,1,B
2018-04-16 10:12:12,13390.0,4,11198,0,13385.0,4,13395.0,21,B
2018-04-16 10:12:59,13390.0,4,11202,2,13390.0,1,13395.0,4,B
2018-04-16 10:13:23,13385.0,2,11204,2,13385.0,4,13390.0,2,S
2018-04-16 10:13:25,13390.0,4,11208,2,13385.0,4,13390.0,1,B
2018-04-16 10:13:35,13390.0,2,11210,0,13390.0,4,13395.0,20,B
2018-04-16 10:13:51,13395.0,4,11214,-4,13390.0,4,13395.0,8,B
2018-04-16 10:14:16,13395.0,4,11218,-2,13390.0,4,13395.0,5,B
2018-04-16 10:14:27,13395.0,6,11224,6,13390.0,5,13400.0,5,B
2018-04-16 10:14:36,13400.0,4,11228,2,13395.0,3,13405.0,5,B
2018-04-16 10:14:55,13405.0,6,11234,-2,13395.0,3,13405.0,3,B
2018-04-16 10:30:01,13400.0,2,11236,-2,13400.0,1,13405.0,6,S
2018-04-16 10:30:01,13400.0,2,11238,0,13400.0,2,13405.0,6,S
2018-04-16 10:30:30,13410.0,4,11242,2,13405.0,4,13410.0,4,B
2018-04-16 10:30:31,13410.0,10,11252,4,13410.0,1,13415.0,5,B
2018-04-16 10:30:34,13415.0,4,11256,-2,13410.0,4,13420.0,3,B
2018-04-16 10:30:47,13415.0,8,11264,4,13415.0,4,13425.0,5,B
2018-04-16 10:30:51,13425.0,20,11284,20,13415.0,4,13425.0,1,B
2018-04-16 10:30:51,13420.0,2,11286,0,13420.0,2,13425.0,1,S
2018-04-16 10:30:57,13410.0,2,11288,-2,13410.0,2,13420.0,10,S
2018-04-16 10:31:07,13410.0,2,11290,-2,13410.0,3,13420.0,9,S
2018-04-16 10:31:11,13410.0,4,11294,-2,13405.0,8,13410.0,5,S
2018-04-16 10:31:19,13410.0,2,11296,-2,13405.0,5,13415.0,7,S
2018-04-16 10:32:14,13420.0,2,11298,0,13415.0,7,13420.0,10,B
2018-04-16 10:32:18,13420.0,2,11300,2,13415.0,7,13425.0,12,B
2018-04-16 10:32:23,13415.0,2,11302,0,13410.0,4,13415.0,4,S
2018-04-16 10:32:28,13415.0,2,11304,0,13410.0,2,13415.0,1,S
2018-04-16 10:32:34,13415.0,2,11306,0,13410.0,3,13415.0,10,S
2018-04-16 10:33:03,13410.0,4,11310,2,13410.0,2,13415.0,11,S
2018-04-16 10:33:04,13410.0,4,11314,4,13405.0,3,13410.0,13,S
2018-04-16 10:33:05,13405.0,6,11320,2,13400.0,21,13410.0,13,S
2018-04-16 10:33:13,13405.0,2,11322,2,13405.0,1,13410.0,11,S
2018-04-16 10:33:16,13405.0,2,11324,2,13400.0,27,13405.0,1,S
2018-04-16 10:33:19,13405.0,10,11334,4,13400.0,12,13410.0,25,S
2018-04-16 10:33:23,13405.0,2,11336,0,13400.0,12,13405.0,1,S
2018-04-16 10:33:28,13405.0,2,11338,2,13400.0,14,13405.0,2,S
2018-04-16 10:34:02,13405.0,2,11340,-2,13400.0,9,13405.0,10,S
2018-04-16 10:34:05,13400.0,4,11344,-2,13395.0,3,13400.0,6,S
2018-04-16 10:34:23,13395.0,4,11348,0,13395.0,1,13400.0,28,S
2018-04-16 10:34:36,13395.0,2,11350,2,13390.0,12,13400.0,10,S
2018-04-16 10:34:48,13395.0,2,11352,0,13390.0,12,13400.0,11,S
2018-04-16 10:35:09,13400.0,20,11372,-6,13395.0,26,13405.0,13,B
2018-04-16 10:35:31,13405.0,4,11376,0,13405.0,1,13410.0,22,B
2018-04-16 10:35:32,13405.0,2,11378,0,13400.0,2,13405.0,9,B
2018-04-16 10:35:46,13405.0,2,11380,-2,13400.0,2,13405.0,8,B
2018-04-16 10:37:17,13405.0,4,11384,-4,13400.0,12,13410.0,6,B
2018-04-16 10:37:18,13400.0,4,11388,-2,13395.0,8,13405.0,10,S
2018-04-16 10:37:29,13400.0,6,11394,-6,13395.0,11,13400.0,7,S
2018-04-16 10:37:29,13400.0,6,11400,-2,13395.0,11,13400.0,4,S
2018-04-16 10:38:01,13400.0,2,11402,-2,13395.0,22,13405.0,4,S
2018-04-16 10:38:50,13395.0,2,11404,0,13395.0,2,13400.0,7,S
2018-04-16 10:38:53,13395.0,2,11406,2,13395.0,1,13400.0,7,S
2018-04-16 10:38:53,13395.0,2,11408,0,13395.0,1,13400.0,7,S
2018-04-16 10:39:13,13395.0,2,11410,-2,13390.0,10,13400.0,9,S
2018-04-16 10:40:47,13395.0,6,11416,-4,13390.0,21,13395.0,4,S
2018-04-16 10:40:55,13395.0,8,11424,-4,13395.0,2,13400.0,1,S
2018-04-16 10:40:55,13400.0,2,11426,0,13395.0,17,13405.0,5,B
2018-04-16 10:41:02,13405.0,10,11436,-4,13405.0,5,13410.0,10,B
2018-04-16 10:41:03,13405.0,10,11446,-6,13400.0,1,13405.0,1,B
2018-04-16 10:41:26,13405.0,2,11448,0,13400.0,8,13410.0,6,B
2018-04-16 10:41:51,13405.0,4,11452,0,13400.0,2,13405.0,3,B
2018-04-16 10:41:56,13400.0,2,11454,-2,13395.0,4,13400.0,9,S
2018-04-16 10:42:06,13390.0,10,11464,2,13390.0,1,13400.0,18,S
2018-04-16 10:42:17,13395.0,2,11466,-2,13390.0,2,13395.0,1,B
2018-04-16 10:42:19,13390.0,4,11470,0,13385.0,4,13395.0,1,S
2018-04-16 10:42:32,13390.0,4,11474,0,13385.0,6,13390.0,8,S
2018-04-16 10:42:39,13385.0,6,11480,0,13385.0,2,13390.0,8,S
2018-04-16 10:42:45,13385.0,4,11484,2,13380.0,5,13390.0,8,S
2018-04-16 10:42:52,13380.0,6,11490,2,13375.0,5,13385.0,7,S
2018-04-16 10:42:54,13375.0,4,11494,0,13375.0,3,13380.0,1,S
2018-04-16 10:42:57,13375.0,4,11498,2,13375.0,1,13380.0,1,S
2018-04-16 10:42:58,13375.0,2,11500,0,13370.0,57,13385.0,9,S
2018-04-16 10:42:58,13380.0,2,11502,2,13375.0,2,13380.0,1,B
2018-04-16 10:43:00,13375.0,4,11506,0,13370.0,10,13380.0,9,S
2018-04-16 10:43:06,13370.0,2,11508,2,13370.0,9,13380.0,5,S
2018-04-16 10:43:07,13370.0,4,11512,-4,13370.0,7,13380.0,6,S
2018-04-16 10:43:09,13370.0,4,11516,0,13370.0,28,13380.0,2,S
2018-04-16 10:43:11,13370.0,4,11520,2,13375.0,1,13380.0,1,S
2018-04-16 10:43:18,13380.0,2,11522,2,13375.0,39,13380.0,1,B
2018-04-16 10:43:18,13380.0,2,11524,0,13375.0,37,13385.0,1,B
2018-04-16 10:43:23,13390.0,2,11526,0,13380.0,5,13390.0,11,B
2018-04-16 10:43:33,13385.0,4,11530,2,13380.0,1,13385.0,2,S
2018-04-16 10:43:36,13380.0,4,11534,-2,13375.0,4,13380.0,2,S
2018-04-16 10:43:38,13370.0,10,11544,2,13370.0,3,13375.0,6,S
2018-04-16 10:43:39,13370.0,6,11550,0,13365.0,1,13370.0,4,S
2018-04-16 10:43:43,13365.0,4,11554,0,13365.0,6,13375.0,6,S
2018-04-16 10:43:45,13365.0,4,11558,4,13360.0,26,13375.0,5,S
2018-04-16 10:43:47,13360.0,4,11562,0,13360.0,1,13370.0,5,S
2018-04-16 10:43:48,13365.0,2,11564,-2,13360.0,31,13370.0,5,B
2018-04-16 10:43:50,13360.0,2,11566,2,13360.0,5,13365.0,1,S
2018-04-16 10:43:51,13365.0,2,11568,0,13365.0,3,13370.0,2,B
2018-04-16 10:43:52,13360.0,14,11582,-8,13360.0,24,13370.0,3,S
2018-04-16 10:43:56,13370.0,2,11584,0,13370.0,5,13375.0,5,B
2018-04-16 10:44:05,13370.0,2,11586,2,13365.0,33,13370.0,1,B
2018-04-16 10:44:05,13370.0,2,11588,2,13370.0,3,13375.0,2,B
2018-04-16 10:44:13,13375.0,4,11592,-2,13370.0,35,13380.0,4,B
2018-04-16 10:44:22,13375.0,2,11594,-2,13370.0,2,13375.0,2,B
2018-04-16 10:44:26,13370.0,6,11600,4,13370.0,1,13380.0,9,S
2018-04-16 10:44:33,13370.0,4,11604,4,13365.0,2,13375.0,9,S
2018-04-16 10:44:43,13365.0,2,11606,0,13365.0,3,13375.0,10,S
2018-04-16 10:44:57,13370.0,2,11608,0,13365.0,1,13370.0,4,B
2018-04-16 10:45:01,13365.0,2,11610,2,13360.0,5,13365.0,1,S
2018-04-16 10:45:02,13360.0,2,11612,0,13355.0,2,13365.0,13,S
2018-04-16 10:45:02,13355.0,4,11616,2,13350.0,24,13360.0,9,S
2018-04-16 10:45:04,13360.0,8,11624,8,13355.0,1,13365.0,15,B
2018-04-16 10:45:06,13355.0,2,11626,0,13355.0,5,13365.0,7,S
2018-04-16 10:45:08,13360.0,2,11628,0,13355.0,2,13365.0,7,B
2018-04-16 10:45:13,13360.0,4,11632,4,13355.0,8,13365.0,5,B
2018-04-16 10:45:22,13360.0,2,11634,0,13360.0,4,13365.0,8,B
2018-04-16 10:45:23,13360.0,8,11642,-6,13355.0,1,13360.0,1,B
2018-04-16 10:45:31,13355.0,8,11650,0,13350.0,25,13360.0,10,S
2018-04-16 10:45:33,13350.0,8,11658,-2,13350.0,21,13360.0,10,S
2018-04-16 10:45:33,13350.0,2,11660,0,13350.0,21,13360.0,10,S
2018-04-16 10:45:34,13350.0,2,11662,-2,13355.0,3,13360.0,3,S
2018-04-16 10:45:41,13360.0,2,11664,0,13355.0,9,13365.0,3,B
2018-04-16 10:45:46,13365.0,2,11666,-2,13355.0,9,13365.0,2,B
2018-04-16 10:45:48,13365.0,6,11672,0,13360.0,7,13370.0,2,B
2018-04-16 10:45:49,13360.0,6,11678,2,13360.0,7,13370.0,2,S
2018-04-16 10:45:50,13370.0,4,11682,2,13365.0,7,13375.0,3,B
2018-04-16 10:45:51,13365.0,6,11688,4,13365.0,4,13375.0,3,S
2018-04-16 10:45:52,13375.0,2,11690,-2,13370.0,6,13380.0,3,B
2018-04-16 10:45:53,13370.0,6,11696,6,13370.0,3,13380.0,1,S
2018-04-16 10:45:54,13370.0,6,11702,4,13365.0,44,13380.0,6,S
2018-04-16 10:46:01,13370.0,6,11708,6,13365.0,43,13370.0,7,S
2018-04-16 10:46:01,13370.0,14,11722,10,13370.0,4,13380.0,11,S
2018-04-16 10:46:03,13370.0,4,11726,4,13365.0,2,13370.0,4,S
2018-04-16 10:46:07,13370.0,10,11736,8,13360.0,32,13375.0,6,S
2018-04-16 10:46:10,13370.0,2,11738,0,13370.0,2,13380.0,7,S
2018-04-16 10:46:19,13370.0,2,11740,-2,13360.0,32,13370.0,3,S
2018-04-16 10:46:50,13375.0,2,11742,2,13365.0,6,13380.0,5,B
2018-04-16 10:47:25,13375.0,4,11746,-4,13365.0,7,13380.0,4,B
2018-04-16 10:47:26,13375.0,8,11754,0,13370.0,4,13380.0,4,B
2018-04-16 10:47:29,13380.0,2,11756,2,13375.0,10,13385.0,4,B
2018-04-16 10:47:29,13380.0,2,11758,2,13380.0,1,13385.0,2,B
2018-04-16 10:47:34,13385.0,2,11760,0,13380.0,10,13390.0,2,B
2018-04-16 10:47:35,13385.0,2,11762,0,13380.0,5,13390.0,3,B
2018-04-16 10:47:57,13385.0,2,11764,0,13380.0,3,13385.0,1,B
2018-04-16 10:48:02,13385.0,2,11766,2,13380.0,5,13390.0,7,B
2018-04-16 10:48:09,13390.0,8,11774,2,13380.0,6,13390.0,1,B
2018-04-16 10:48:23,13395.0,6,11780,-2,13385.0,4,13395.0,2,B
2018-04-16 10:48:28,13385.0,4,11784,0,13380.0,6,13390.0,3,S
2018-04-16 10:48:29,13385.0,2,11786,-2,13380.0,2,13385.0,4,S
2018-04-16 10:48:34,13380.0,6,11792,4,13380.0,1,13390.0,16,S
2018-04-16 10:48:45,13390.0,2,11794,2,13380.0,2,13390.0,11,B
2018-04-16 10:48:46,13380.0,4,11798,0,13380.0,3,13390.0,11,S
2018-04-16 10:48:55,13385.0,2,11800,2,13380.0,5,13395.0,14,B
2018-04-16 10:49:42,13385.0,2,11802,2,13380.0,11,13390.0,3,B
2018-04-16 10:49:45,13390.0,2,11804,0,13385.0,1,13390.0,2,B
2018-04-16 10:49:48,13390.0,2,11806,0,13390.0,2,13395.0,6,B
2018-04-16 10:50:06,13390.0,4,11810,-2,13385.0,3,13395.0,8,B
2018-04-16 10:50:32,13385.0,2,11812,0,13380.0,13,13390.0,2,S
2018-04-16 10:50:39,13380.0,2,11814,-2,13380.0,11,13385.0,1,S
2018-04-16 10:50:47,13380.0,16,11830,-16,13380.0,4,13385.0,5,S
2018-04-16 10:50:48,13380.0,8,11838,-6,13375.0,3,13385.0,5,S
2018-04-16 10:51:20,13370.0,4,11842,-2,13370.0,8,13375.0,9,S
2018-04-16 10:51:21,13370.0,2,11844,0,13370.0,7,13375.0,9,S
2018-04-16 10:51:21,13370.0,2,11846,-2,13370.0,6,13375.0,9,S
2018-04-16 10:51:23,13375.0,2,11848,-2,13370.0,7,13380.0,5,B
2018-04-16 10:51:53,13370.0,2,11850,0,13370.0,8,13375.0,2,S
2018-04-16 10:52:03,13370.0,2,11852,0,13370.0,7,13375.0,3,S
2018-04-16 10:52:06,13370.0,14,11866,-10,13365.0,2,13370.0,1,S
2018-04-16 10:52:07,13365.0,4,11870,0,13360.0,3,13370.0,6,S
2018-04-16 10:52:09,13365.0,4,11874,-2,13360.0,47,13370.0,1,S
2018-04-16 10:52:14,13360.0,2,11876,0,13360.0,4,13370.0,7,S
2018-04-16 10:52:23,13360.0,2,11878,0,13360.0,2,13370.0,3,S
2018-04-16 10:52:33,13360.0,2,11880,0,13360.0,2,13365.0,1,S
2018-04-16 10:52:40,13370.0,2,11882,0,13360.0,4,13370.0,2,B
2018-04-16 10:52:46,13370.0,2,11884,0,13360.0,4,13370.0,1,B
2018-04-16 10:53:02,13360.0,2,11886,2,13355.0,6,13365.0,3,S
2018-04-16 10:53:23,13365.0,2,11888,0,13360.0,2,13370.0,4,B
2018-04-16 10:53:30,13365.0,2,11890,2,13360.0,6,13370.0,4,B
2018-04-16 10:53:45,13360.0,2,11892,-2,13360.0,1,13370.0,3,S
2018-04-16 10:53:46,13360.0,2,11894,0,13355.0,42,13360.0,1,S
2018-04-16 10:53:46,13360.0,2,11896,-2,13365.0,2,13370.0,1,S
2018-04-16 10:53:47,13365.0,2,11898,-2,13355.0,36,13370.0,2,B
2018-04-16 10:53:58,13360.0,4,11902,2,13365.0,10,13370.0,2,S
2018-04-16 10:54:04,13365.0,2,11904,0,13365.0,9,13370.0,3,B
2018-04-16 10:54:08,13365.0,4,11908,0,13365.0,7,13375.0,4,B
2018-04-16 10:54:22,13370.0,2,11910,0,13365.0,8,13375.0,4,B
2018-04-16 10:54:40,13370.0,2,11912,2,13365.0,8,13375.0,4,B
2018-04-16 10:54:54,13365.0,4,11916,-2,13365.0,5,13370.0,4,S
2018-04-16 10:54:55,13365.0,2,11918,-2,13365.0,4,13370.0,7,S
2018-04-16 10:55:04,13365.0,2,11920,-2,13365.0,3,13370.0,7,S
2018-04-16 10:55:20,13370.0,4,11924,2,13365.0,3,13370.0,2,B
2018-04-16 10:55:25,13365.0,2,11926,-2,13365.0,2,13370.0,2,S
2018-04-16 10:55:38,13370.0,2,11928,0,13370.0,1,13375.0,5,B
2018-04-16 10:55:46,13375.0,4,11932,0,13375.0,3,13380.0,6,B
2018-04-16 10:55:52,13375.0,2,11934,-2,13370.0,5,13380.0,4,B
2018-04-16 10:56:01,13375.0,4,11938,0,13375.0,4,13380.0,6,B
2018-04-16 10:56:05,13375.0,2,11940,2,13375.0,3,13380.0,6,B
2018-04-16 10:56:18,13385.0,16,11956,0,13375.0,3,13385.0,15,B
2018-04-16 10:56:22,13380.0,2,11958,0,13375.0,3,13385.0,17,S
2018-04-16 10:56:42,13380.0,4,11962,2,13380.0,2,13385.0,14,S
2018-04-16 10:56:45,13385.0,6,11968,6,13375.0,8,13385.0,11,B
2018-04-16 10:56:58,13385.0,2,11970,0,13380.0,4,13385.0,10,B
2018-04-16 10:57:04,13380.0,2,11972,2,13380.0,1,13385.0,1,S
2018-04-16 10:57:11,13380.0,2,11974,-2,13375.0,6,13380.0,2,S
2018-04-16 10:57:12,13375.0,2,11976,0,13375.0,5,13380.0,8,S
2018-04-16 10:57:38,13380.0,2,11978,0,13380.0,5,13385.0,2,B
2018-04-16 10:57:50,13380.0,2,11980,0,13380.0,1,13385.0,2,B
2018-04-16 10:57:53,13380.0,2,11982,2,13375.0,22,13380.0,8,B
2018-04-16 10:58:11,13380.0,6,11988,4,13375.0,22,13385.0,5,B
2018-04-16 10:58:36,13375.0,2,11990,2,13375.0,21,13380.0,3,S
2018-04-16 10:58:37,13375.0,42,12032,22,13370.0,2,13375.0,23,S
2018-04-16 10:58:38,13375.0,2,12034,2,13370.0,7,13375.0,22,S
2018-04-16 10:58:45,13370.0,2,12036,-2,13370.0,1,13375.0,22,S
2018-04-16 10:58:48,13370.0,6,12042,-2,13365.0,15,13370.0,1,S
2018-04-16 10:58:49,13370.0,2,12044,-2,13365.0,15,13375.0,22,S
2018-04-16 10:59:06,13370.0,2,12046,0,13370.0,1,13375.0,23,S
2018-04-16 10:59:07,13370.0,6,12052,-4,13365.0,5,13375.0,23,S
2018-04-16 10:59:08,13370.0,2,12054,-2,13365.0,4,13370.0,1,S
2018-04-16 10:59:17,13370.0,4,12058,-2,13370.0,1,13375.0,25,S
2018-04-16 10:59:43,13375.0,2,12060,0,13365.0,3,13375.0,24,B
2018-04-16 10:59:48,13370.0,2,12062,0,13365.0,20,13370.0,9,S
2018-04-16 10:59:48,13370.0,2,12064,2,13365.0,5,13370.0,8,S
2018-04-16 10:59:57,13370.0,2,12066,2,13365.0,10,13370.0,7,S
2018-04-16 11:00:01,13365.0,6,12072,2,13365.0,5,13370.0,7,S
2018-04-16 11:00:02,13365.0,10,12082,10,13355.0,7,13365.0,1,S
2018-04-16 11:00:04,13355.0,2,12084,2,13355.0,6,13365.0,4,S
2018-04-16 11:00:04,13355.0,2,12086,0,13355.0,6,13365.0,4,S
2018-04-16 11:00:17,13365.0,2,12088,-2,13355.0,6,13365.0,9,B
2018-04-16 11:00:25,13365.0,2,12090,-2,13360.0,7,13370.0,8,B
2018-04-16 11:00:34,13360.0,10,12100,10,13360.0,2,13370.0,12,S
2018-04-16 11:00:44,13360.0,2,12102,0,13360.0,6,13365.0,3,S
2018-04-16 11:00:45,13360.0,2,12104,-2,13360.0,5,13365.0,3,S
2018-04-16 11:00:47,13360.0,2,12106,0,13360.0,4,13365.0,3,S
2018-04-16 11:00:48,13360.0,4,12110,-2,13360.0,3,13365.0,9,S
2018-04-16 11:00:50,13360.0,2,12112,0,13360.0,2,13365.0,11,S
2018-04-16 11:00:53,13360.0,2,12114,0,13360.0,1,13365.0,10,S
2018-04-16 11:00:54,13360.0,2,12116,2,13355.0,6,13365.0,10,S
2018-04-16 11:00:57,13360.0,2,12118,2,13360.0,1,13365.0,5,S
2018-04-16 11:01:02,13365.0,8,12126,0,13360.0,11,13370.0,7,B
2018-04-16 11:01:06,13360.0,2,12128,-2,13355.0,8,13360.0,1,S
2018-04-16 11:01:07,13360.0,2,12130,0,13355.0,8,13365.0,1,S
2018-04-16 11:01:41,13370.0,2,12132,0,13365.0,2,13370.0,6,B
2018-04-16 11:02:17,13370.0,2,12134,0,13365.0,1,13370.0,4,B
2018-04-16 11:02:35,13370.0,2,12136,0,13365.0,5,13370.0,1,B
2018-04-16 11:02:35,13370.0,2,12138,2,13365.0,5,13375.0,22,B
2018-04-16 11:02:42,13375.0,2,12140,0,13370.0,7,13375.0,21,B
2018-04-16 11:02:51,13370.0,6,12146,-2,13370.0,4,13375.0,21,S
2018-04-16 11:02:51,13370.0,8,12154,-8,13365.0,7,13375.0,24,S
2018-04-16 11:03:19,13365.0,2,12156,0,13365.0,5,13370.0,1,S
2018-04-16 11:03:23,13370.0,4,12160,4,13365.0,5,13375.0,23,B
2018-04-16 11:03:44,13370.0,2,12162,-2,13365.0,6,13370.0,1,B
2018-04-16 11:03:57,13365.0,10,12172,10,13360.0,8,13370.0,10,S
2018-04-16 11:04:04,13360.0,4,12176,-4,13360.0,4,13365.0,8,S
2018-04-16 11:04:05,13360.0,2,12178,-2,13360.0,3,13365.0,8,S
2018-04-16 11:04:05,13360.0,6,12184,-2,13355.0,5,13360.0,8,S
2018-04-16 11:04:07,13355.0,8,12192,0,13355.0,1,13360.0,15,S
2018-04-16 11:04:08,13355.0,2,12194,-2,13350.0,23,13360.0,15,S
2018-04-16 11:04:08,13350.0,6,12200,2,13350.0,19,13360.0,12,S
2018-04-16 11:04:09,13350.0,2,12202,-2,13350.0,18,13360.0,8,S
2018-04-16 11:04:15,13355.0,2,12204,0,13350.0,18,13355.0,3,B
2018-04-16 11:04:17,13355.0,2,12206,0,13350.0,18,13355.0,1,B
2018-04-16 11:04:18,13355.0,2,12208,2,13355.0,2,13360.0,2,B
2018-04-16 11:04:19,13360.0,2,12210,2,13360.0,1,13365.0,1,B
2018-04-16 11:04:27,13355.0,2,12212,0,13355.0,10,13365.0,4,S
2018-04-16 11:04:31,13365.0,2,12214,2,13355.0,7,13365.0,4,B
2018-04-16 11:04:39,13365.0,2,12216,0,13355.0,8,13365.0,4,B
2018-04-16 11:05:10,13355.0,4,12220,-2,13355.0,4,13360.0,5,S
2018-04-16 11:05:10,13355.0,4,12224,-4,13355.0,3,13360.0,3,S
2018-04-16 11:05:11,13355.0,2,12226,0,13355.0,2,13360.0,3,S
2018-04-16 11:05:12,13355.0,2,12228,0,13355.0,1,13360.0,8,S
2018-04-16 11:05:13,13355.0,2,12230,2,13350.0,22,13360.0,7,S
2018-04-16 11:05:14,13355.0,2,12232,0,13350.0,22,13360.0,8,S
2018-04-16 11:05:29,13355.0,2,12234,2,13350.0,24,13355.0,4,S
2018-04-16 11:05:30,13355.0,2,12236,0,13350.0,24,13355.0,3,S
2018-04-16 11:05:32,13355.0,6,12242,6,13350.0,25,13360.0,3,S
2018-04-16 11:05:43,13350.0,2,12244,-2,13350.0,24,13360.0,5,S
2018-04-16 11:06:17,13350.0,46,12290,28,13350.0,1,13355.0,2,S
2018-04-16 11:06:17,13345.0,18,12308,12,13345.0,5,13350.0,9,S
2018-04-16 11:06:18,13345.0,8,12316,4,13340.0,12,13345.0,1,S
2018-04-16 11:06:19,13345.0,8,12324,0,13340.0,11,13350.0,3,S
2018-04-16 11:06:23,13340.0,2,12326,0,13340.0,11,13345.0,1,S
2018-04-16 11:06:23,13340.0,10,12336,0,13340.0,6,13345.0,1,S
2018-04-16 11:06:24,13340.0,6,12342,2,13340.0,3,13345.0,7,S
2018-04-16 11:06:25,13340.0,2,12344,2,13340.0,2,13345.0,7,S
2018-04-16 11:06:25,13340.0,2,12346,0,13340.0,2,13345.0,4,S
2018-04-16 11:06:26,13340.0,4,12350,2,13335.0,4,13345.0,5,S
2018-04-16 11:06:31,13335.0,4,12354,0,13335.0,2,13340.0,8,S
2018-04-16 11:06:31,13335.0,4,12358,-4,13330.0,11,13335.0,3,S
2018-04-16 11:06:32,13335.0,6,12364,0,13340.0,4,13345.0,4,S
2018-04-16 11:06:33,13345.0,4,12368,0,13340.0,7,13350.0,3,B
2018-04-16 11:06:34,13340.0,2,12370,0,13340.0,3,13345.0,1,S
2018-04-16 11:06:39,13340.0,2,12372,-2,13335.0,3,13345.0,4,S
2018-04-16 11:06:43,13335.0,2,12374,-2,13335.0,3,13345.0,3,S
2018-04-16 11:06:43,13335.0,2,12376,2,13335.0,2,13345.0,3,S
2018-04-16 11:06:49,13340.0,2,12378,2,13335.0,2,13340.0,1,B
2018-04-16 11:06:50,13340.0,2,12380,-2,13335.0,2,13345.0,7,B
2018-04-16 11:06:50,13335.0,2,12382,2,13335.0,1,13340.0,10,S
2018-04-16 11:06:53,13335.0,4,12386,-2,13330.0,13,13335.0,1,S
2018-04-16 11:06:53,13335.0,2,12388,0,13335.0,2,13345.0,10,S
2018-04-16 11:06:55,13335.0,4,12392,-4,13330.0,12,13335.0,4,S
2018-04-16 11:06:55,13335.0,8,12400,0,13340.0,1,13345.0,10,S
2018-04-16 11:06:56,13335.0,4,12404,-2,13330.0,14,13340.0,4,S
2018-04-16 11:07:01,13335.0,2,12406,0,13330.0,13,13340.0,1,S
2018-04-16 11:07:03,13340.0,4,12410,-2,13330.0,10,13340.0,12,B
2018-04-16 11:07:04,13330.0,8,12418,6,13330.0,6,13335.0,1,S
2018-04-16 11:07:05,13325.0,16,12434,0,13325.0,74,13330.0,6,S
2018-04-16 11:07:05,13325.0,14,12448,-14,13325.0,65,13330.0,6,S
2018-04-16 11:07:06,13330.0,12,12460,0,13325.0,65,13335.0,2,B
2018-04-16 11:07:07,13325.0,10,12470,-4,13325.0,60,13330.0,4,S
2018-04-16 11:07:07,13325.0,6,12476,0,13325.0,57,13330.0,4,S
2018-04-16 11:07:08,13325.0,46,12522,-2,13325.0,34,13330.0,5,S
2018-04-16 11:07:09,13325.0,22,12544,0,13325.0,23,13330.0,5,S
2018-04-16 11:07:09,13330.0,20,12564,-4,13325.0,18,13335.0,3,B
2018-04-16 11:07:13,13325.0,18,12582,0,13325.0,9,13330.0,3,S
2018-04-16 11:07:14,13325.0,2,12584,0,13325.0,8,13335.0,1,S
2018-04-16 11:07:16,13335.0,2,12586,0,13325.0,8,13335.0,6,B
2018-04-16 11:07:18,13325.0,8,12594,0,13325.0,4,13330.0,6,S
2018-04-16 11:07:18,13325.0,8,12602,8,13320.0,2,13330.0,8,S
2018-04-16 11:07:19,13325.0,2,12604,0,13320.0,5,13330.0,5,S
2018-04-16 11:07:22,13325.0,8,12612,-2,13320.0,7,13335.0,3,S
2018-04-16 11:07:25,13330.0,4,12616,0,13325.0,7,13335.0,6,B
2018-04-16 11:07:29,13330.0,2,12618,2,13325.0,4,13335.0,1,B
2018-04-16 11:07:37,13335.0,2,12620,0,13330.0,10,13340.0,5,B
2018-04-16 11:07:41,13335.0,2,12622,0,13335.0,1,13340.0,3,B
2018-04-16 11:07:44,13325.0,2,12624,-2,13320.0,2,13335.0,12,S
2018-04-16 11:07:46,13330.0,2,12626,-2,13330.0,3,13335.0,7,B
2018-04-16 11:07:46,13330.0,6,12632,0,13325.0,1,13330.0,6,B
2018-04-16 11:07:47,13320.0,8,12640,6,13320.0,5,13325.0,2,S
2018-04-16 11:07:48,13320.0,2,12642,0,13320.0,4,13325.0,2,S
2018-04-16 11:07:50,13325.0,4,12646,0,13325.0,5,13330.0,5,B
2018-04-16 11:07:55,13325.0,4,12650,0,13325.0,3,13330.0,2,B
2018-04-16 11:07:57,13325.0,2,12652,-2,13325.0,2,13330.0,8,B
2018-04-16 11:07:57,13325.0,2,12654,-2,13325.0,1,13330.0,5,B
2018-04-16 11:08:00,13325.0,2,12656,0,13320.0,4,13330.0,5,B
2018-04-16 11:08:02,13320.0,2,12658,0,13315.0,4,13325.0,11,S
2018-04-16 11:08:03,13315.0,2,12660,0,13315.0,3,13320.0,5,S
2018-04-16 11:08:05,13315.0,2,12662,2,13315.0,2,13320.0,7,S
2018-04-16 11:08:06,13310.0,8,12670,6,13310.0,13,13320.0,7,S
2018-04-16 11:08:06,13305.0,36,12706,-18,13310.0,2,13320.0,6,S
2018-04-16 11:08:07,13310.0,4,12710,2,13305.0,21,13320.0,6,B
2018-04-16 11:08:08,13310.0,4,12714,-4,13305.0,23,13320.0,6,B
2018-04-16 11:08:08,13310.0,6,12720,4,13310.0,4,13320.0,6,B
2018-04-16 11:08:09,13310.0,2,12722,-2,13305.0,23,13320.0,5,B
2018-04-16 11:08:12,13310.0,4,12726,0,13315.0,6,13330.0,2,B
2018-04-16 11:08:14,13310.0,20,12746,8,13305.0,33,13325.0,12,B
2018-04-16 11:08:15,13310.0,2,12748,-2,13310.0,7,13320.0,1,B
2018-04-16 11:08:16,13320.0,2,12750,2,13315.0,1,13325.0,8,B
2018-04-16 11:08:19,13315.0,8,12758,6,13310.0,14,13315.0,1,S
2018-04-16 11:08:19,13315.0,2,12760,0,13315.0,7,13320.0,1,S
2018-04-16 11:08:21,13315.0,2,12762,-2,13310.0,4,13320.0,2,S
2018-04-16 11:08:24,13315.0,10,12772,4,13310.0,5,13315.0,14,S
2018-04-16 11:08:24,13315.0,22,12794,4,13310.0,5,13315.0,3,S
2018-04-16 11:08:25,13315.0,6,12800,6,13315.0,1,13325.0,4,S
2018-04-16 11:08:28,13325.0,4,12804,4,13320.0,4,13330.0,1,B
2018-04-16 11:08:35,13330.0,2,12806,0,13325.0,6,13330.0,1,B
2018-04-16 11:08:36,13330.0,2,12808,0,13325.0,6,13335.0,1,B
2018-04-16 11:08:36,13330.0,2,12810,0,13325.0,6,13340.0,3,B
2018-04-16 11:08:38,13330.0,2,12812,2,13330.0,17,13340.0,4,B
2018-04-16 11:08:39,13340.0,2,12814,0,13340.0,1,13345.0,2,B
2018-04-16 11:08:40,13345.0,4,12818,-2,13340.0,7,13350.0,1,B
2018-04-16 11:08:40,13355.0,2,12820,0,13350.0,1,13355.0,5,B
2018-04-16 11:08:41,13350.0,2,12822,0,13345.0,1,13350.0,1,S
2018-04-16 11:08:41,13350.0,8,12830,4,13350.0,5,13355.0,3,S
2018-04-16 11:08:42,13350.0,2,12832,0,13350.0,4,13355.0,2,S
2018-04-16 11:08:42,13345.0,10,12842,8,13345.0,1,13350.0,1,S
2018-04-16 11:08:46,13350.0,8,12850,0,13345.0,1,13350.0,2,B
2018-04-16 11:08:49,13350.0,2,12852,-2,13340.0,10,13350.0,1,B
2018-04-16 11:09:01,13340.0,2,12854,0,13335.0,2,13340.0,4,S
2018-04-16 11:09:10,13335.0,2,12856,0,13335.0,9,13345.0,8,S
2018-04-16 11:09:16,13335.0,2,12858,0,13335.0,21,13345.0,6,S
2018-04-16 11:09:17,13345.0,8,12866,-8,13340.0,6,13350.0,6,B
2018-04-16 11:09:59,13345.0,2,12868,0,13340.0,2,13345.0,1,B
2018-04-16 11:10:10,13350.0,6,12874,0,13345.0,20,13350.0,3,B
2018-04-16 11:10:10,13350.0,6,12880,6,13345.0,21,13355.0,3,B
2018-04-16 11:10:14,13345.0,4,12884,-4,13340.0,6,13345.0,6,S
2018-04-16 11:10:16,13340.0,2,12886,0,13335.0,8,13340.0,7,S
2018-04-16 11:10:17,13340.0,2,12888,0,13340.0,1,13345.0,1,S
2018-04-16 11:10:23,13340.0,2,12890,0,13340.0,1,13345.0,7,S
2018-04-16 11:10:24,13340.0,2,12892,0,13335.0,1,13340.0,4,S
2018-04-16 11:10:27,13330.0,2,12894,0,13310.0,2,13335.0,8,S
2018-04-16 11:10:28,13330.0,2,12896,0,13320.0,4,13330.0,11,S
2018-04-16 11:10:37,13330.0,2,12898,0,13330.0,1,13335.0,1,S
2018-04-16 11:10:41,13330.0,10,12908,0,13325.0,5,13335.0,2,S
2018-04-16 11:10:50,13330.0,2,12910,0,13325.0,11,13335.0,9,S
2018-04-16 11:11:02,13330.0,2,12912,0,13325.0,7,13335.0,10,S
2018-04-16 11:11:05,13330.0,2,12914,0,13325.0,7,13335.0,10,S
2018-04-16 11:11:09,13330.0,6,12920,0,13330.0,7,13335.0,10,S
2018-04-16 11:11:20,13335.0,12,12932,6,13335.0,3,13340.0,2,B
2018-04-16 11:11:24,13340.0,2,12934,-2,13340.0,1,13345.0,2,B
2018-04-16 11:11:28,13340.0,2,12936,0,13340.0,10,13345.0,3,B
2018-04-16 11:11:30,13340.0,4,12940,4,13335.0,5,13345.0,4,B
2018-04-16 11:11:31,13330.0,10,12950,6,13330.0,11,13340.0,4,S
2018-04-16 11:11:31,13330.0,10,12960,0,13330.0,8,13340.0,4,S
2018-04-16 11:11:37,13340.0,2,12962,0,13330.0,7,13340.0,3,B
2018-04-16 11:11:43,13340.0,4,12966,-4,13335.0,5,13340.0,1,B
2018-04-16 11:11:45,13340.0,2,12968,-2,13330.0,7,13340.0,3,B
2018-04-16 11:11:48,13340.0,2,12970,0,13330.0,7,13340.0,3,B
2018-04-16 11:12:03,13325.0,14,12984,0,13315.0,3,13335.0,5,S
2018-04-16 11:12:03,13325.0,2,12986,0,13315.0,2,13325.0,1,S
2018-04-16 11:12:04,13325.0,2,12988,0,13315.0,4,13320.0,10,S
2018-04-16 11:12:05,13325.0,2,12990,0,13320.0,9,13330.0,3,S
2018-04-16 11:12:20,13320.0,4,12994,-2,13320.0,5,13325.0,2,S
2018-04-16 11:12:22,13320.0,2,12996,2,13320.0,4,13330.0,5,S
2018-04-16 11:12:23,13320.0,2,12998,2,13320.0,3,13330.0,5,S
2018-04-16 11:12:31,13325.0,6,13004,0,13325.0,14,13330.0,2,B
2018-04-16 11:12:39,13335.0,2,13006,2,13330.0,2,13335.0,1,B
2018-04-16 11:12:40,13335.0,2,13008,-2,13325.0,6,13335.0,1,B
2018-04-16 11:12:41,13330.0,2,13010,2,13330.0,1,13335.0,2,S
2018-04-16 11:12:55,13325.0,2,13012,-2,13325.0,7,13335.0,2,S
2018-04-16 11:12:56,13335.0,2,13014,-2,13325.0,7,13335.0,1,B
2018-04-16 11:13:10,13335.0,6,13020,4,13335.0,5,13340.0,2,B
2018-04-16 11:13:11,13335.0,2,13022,2,13335.0,4,13340.0,4,B
2018-04-16 11:13:11,13335.0,8,13030,0,13330.0,1,13340.0,5,B
2018-04-16 11:13:16,13340.0,2,13032,-2,13335.0,1,13340.0,3,B
2018-04-16 11:13:25,13345.0,4,13036,0,13340.0,8,13350.0,8,B
2018-04-16 11:13:41,13345.0,2,13038,-2,13335.0,8,13345.0,6,B
2018-04-16 11:13:44,13345.0,2,13040,-2,13335.0,14,13345.0,5,B
2018-04-16 11:14:00,13345.0,2,13042,0,13340.0,2,13345.0,4,B
2018-04-16 11:14:09,13345.0,6,13048,0,13340.0,2,13345.0,1,B
2018-04-16 11:14:17,13345.0,2,13050,-2,13340.0,1,13345.0,4,B
2018-04-16 11:14:24,13340.0,2,13052,-2,13335.0,3,13345.0,4,S
2018-04-16 11:14:26,13335.0,2,13054,-2,13335.0,1,13340.0,7,S
2018-04-16 11:14:55,13335.0,2,13056,2,13330.0,3,13340.0,4,S
2018-04-16 11:15:05,13340.0,2,13058,0,13330.0,6,13340.0,5,B
2018-04-16 11:15:07,13335.0,2,13060,0,13330.0,1,13335.0,3,S
2018-04-16 11:15:48,13340.0,2,13062,0,13335.0,2,13345.0,5,B
2018-04-16 11:16:05,13335.0,4,13066,-4,13330.0,7,13340.0,14,S
2018-04-16 11:16:21,13330.0,4,13070,0,13325.0,11,13335.0,8,S
2018-04-16 11:16:22,13330.0,2,13072,0,13325.0,10,13330.0,1,S
2018-04-16 11:16:26,13325.0,2,13074,2,13325.0,9,13330.0,1,S
2018-04-16 11:16:40,13325.0,2,13076,2,13325.0,8,13330.0,3,S
2018-04-16 11:16:40,13325.0,4,13080,4,13325.0,7,13330.0,8,S
2018-04-16 11:16:41,13325.0,2,13082,2,13325.0,6,13330.0,8,S
2018-04-16 11:16:42,13330.0,2,13084,0,13325.0,6,13330.0,2,B
2018-04-16 11:16:43,13330.0,2,13086,-2,13330.0,1,13335.0,14,B
2018-04-16 11:16:44,13330.0,4,13090,0,13325.0,5,13335.0,13,B
2018-04-16 11:16:49,13330.0,2,13092,0,13325.0,5,13335.0,11,B
2018-04-16 11:16:54,13325.0,8,13100,4,13325.0,1,13330.0,1,S
2018-04-16 11:16:55,13325.0,2,13102,2,13320.0,5,13325.0,1,S
2018-04-16 11:16:59,13320.0,8,13110,-4,13315.0,3,13320.0,3,S
2018-04-16 11:17:01,13315.0,6,13116,6,13310.0,3,13315.0,1,S
2018-04-16 11:17:02,13315.0,6,13122,0,13315.0,4,13320.0,3,S
2018-04-16 11:17:03,13320.0,6,13128,-6,13315.0,5,13325.0,1,B
2018-04-16 11:17:05,13320.0,2,13130,0,13315.0,5,13330.0,4,B
2018-04-16 11:17:16,13315.0,4,13134,0,13310.0,3,13315.0,5,S
2018-04-16 11:17:16,13315.0,10,13144,2,13315.0,5,13320.0,3,S
2018-04-16 11:17:29,13315.0,2,13146,-2,13310.0,4,13315.0,1,S
2018-04-16 11:17:29,13315.0,2,13148,-2,13315.0,12,13330.0,8,S
2018-04-16 11:17:31,13315.0,2,13150,2,13310.0,3,13315.0,3,S
2018-04-16 11:17:31,13315.0,2,13152,0,13310.0,3,13315.0,2,S
2018-04-16 11:17:32,13315.0,4,13156,4,13315.0,5,13325.0,3,S
2018-04-16 11:17:34,13315.0,2,13158,2,13315.0,6,13325.0,3,S
2018-04-16 11:17:39,13320.0,6,13164,6,13320.0,4,13330.0,6,B
2018-04-16 11:17:42,13320.0,4,13168,4,13315.0,1,13325.0,12,B
2018-04-16 11:17:44,13325.0,4,13172,2,13315.0,1,13325.0,10,B
2018-04-16 11:17:52,13315.0,2,13174,0,13315.0,1,13325.0,10,S
2018-04-16 11:17:56,13325.0,2,13176,-2,13315.0,3,13325.0,9,B
2018-04-16 11:18:00,13320.0,2,13178,-2,13315.0,3,13325.0,9,S
2018-04-16 11:18:04,13315.0,2,13180,-2,13315.0,1,13320.0,1,S
2018-04-16 11:18:04,13315.0,2,13182,0,13310.0,5,13315.0,2,S
2018-04-16 11:18:07,13315.0,6,13188,2,13310.0,4,13320.0,1,S
2018-04-16 11:18:08,13315.0,2,13190,-2,13315.0,2,13325.0,1,S
2018-04-16 11:18:09,13320.0,2,13192,0,13315.0,6,13325.0,2,B
2018-04-16 11:18:16,13320.0,6,13198,0,13320.0,1,13325.0,1,B
2018-04-16 11:18:21,13320.0,2,13200,0,13315.0,6,13325.0,2,B
2018-04-16 11:18:29,13315.0,2,13202,-2,13310.0,4,13320.0,3,S
2018-04-16 11:18:34,13310.0,2,13204,0,13310.0,8,13320.0,6,S
2018-04-16 11:18:36,13320.0,2,13206,0,13315.0,1,13320.0,5,B
2018-04-16 11:18:39,13315.0,2,13208,0,13310.0,9,13320.0,7,S
2018-04-16 11:18:44,13310.0,2,13210,0,13310.0,3,13315.0,4,S
2018-04-16 11:18:46,13315.0,2,13212,0,13310.0,3,13315.0,3,B
2018-04-16 11:18:51,13315.0,2,13214,2,13315.0,8,13325.0,2,B
2018-04-16 11:18:53,13315.0,2,13216,2,13310.0,4,13320.0,1,B
2018-04-16 11:18:55,13310.0,12,13228,-2,13310.0,1,13320.0,3,S
2018-04-16 11:18:56,13310.0,2,13230,2,13310.0,2,13325.0,2,S
2018-04-16 11:19:01,13310.0,2,13232,0,13305.0,24,13310.0,2,S
2018-04-16 11:19:07,13310.0,4,13236,0,13305.0,23,13310.0,3,S
2018-04-16 11:19:07,13310.0,4,13240,2,13305.0,23,13310.0,1,S
2018-04-16 11:19:08,13305.0,8,13248,-2,13305.0,19,13310.0,1,S
2018-04-16 11:19:09,13305.0,26,13274,-10,13305.0,8,13310.0,6,S
2018-04-16 11:19:09,13305.0,16,13290,2,13300.0,71,13305.0,1,S
2018-04-16 11:19:11,13300.0,4,13294,0,13300.0,69,13305.0,6,S
2018-04-16 11:19:12,13300.0,50,13344,-42,13300.0,47,13305.0,4,S
2018-04-16 11:19:12,13300.0,16,13360,-2,13300.0,39,13305.0,4,S
2018-04-16 11:19:13,13300.0,4,13364,0,13300.0,37,13310.0,3,S
2018-04-16 11:19:19,13305.0,2,13366,2,13300.0,37,13305.0,1,B
2018-04-16 11:19:20,13305.0,2,13368,0,13305.0,2,13310.0,7,B
2018-04-16 11:19:21,13310.0,10,13378,2,13305.0,7,13315.0,2,B
2018-04-16 11:19:25,13305.0,2,13380,2,13300.0,38,13310.0,12,S
2018-04-16 11:19:26,13300.0,2,13382,0,13300.0,37,13310.0,12,S
2018-04-16 11:19:26,13300.0,4,13386,0,13300.0,34,13305.0,10,S
2018-04-16 11:19:28,13300.0,22,13408,0,13300.0,23,13305.0,20,S
2018-04-16 11:19:30,13305.0,2,13410,2,13300.0,23,13305.0,14,B
2018-04-16 11:19:33,13305.0,4,13414,4,13300.0,23,13305.0,12,B
2018-04-16 11:19:35,13300.0,24,13438,-24,13300.0,11,13305.0,12,S
2018-04-16 11:19:35,13300.0,12,13450,0,13300.0,5,13305.0,17,S
2018-04-16 11:19:37,13300.0,10,13460,10,13295.0,4,13300.0,1,S
2018-04-16 11:19:38,13295.0,6,13466,4,13290.0,7,13295.0,1,S
2018-04-16 11:19:38,13280.0,30,13496,8,13280.0,10,13290.0,34,S
2018-04-16 11:19:39,13280.0,26,13522,-4,13270.0,2,13280.0,22,S
2018-04-16 11:19:39,13270.0,4,13526,2,13265.0,2,13270.0,20,S
2018-04-16 11:19:40,13265.0,4,13530,4,13260.0,3,13265.0,11,S
2018-04-16 11:19:40,13270.0,26,13556,2,13260.0,2,13270.0,2,B
2018-04-16 11:19:42,13260.0,6,13562,0,13260.0,2,13270.0,1,S
2018-04-16 11:19:42,13260.0,4,13566,2,13255.0,1,13270.0,1,S
2018-04-16 11:19:43,13275.0,2,13568,2,13260.0,13,13275.0,13,B
2018-04-16 11:19:44,13275.0,2,13570,2,13260.0,9,13275.0,12,B
2018-04-16 11:19:46,13260.0,2,13572,0,13260.0,9,13270.0,12,S
2018-04-16 11:19:47,13270.0,6,13578,-6,13265.0,4,13270.0,10,B
2018-04-16 11:19:47,13270.0,10,13588,-8,13260.0,4,13270.0,9,B
2018-04-16 11:19:49,13260.0,2,13590,0,13260.0,2,13265.0,5,S
2018-04-16 11:19:49,13270.0,16,13606,16,13260.0,4,13275.0,4,B
2018-04-16 11:19:50,13260.0,8,13614,-4,13260.0,1,13275.0,4,S
2018-04-16 11:19:51,13255.0,4,13618,4,13250.0,19,13260.0,13,S
2018-04-16 11:19:52,13260.0,8,13626,4,13255.0,9,13260.0,2,B
2018-04-16 11:19:55,13250.0,24,13650,0,13250.0,13,13255.0,1,S
2018-04-16 11:19:55,13255.0,2,13652,0,13255.0,10,13260.0,2,B
2018-04-16 11:19:56,13250.0,16,13668,8,13250.0,10,13255.0,3,S
2018-04-16 11:19:57,13255.0,6,13674,4,13255.0,2,13260.0,2,B
2018-04-16 11:19:57,13250.0,24,13698,-14,13250.0,7,13260.0,2,S
2018-04-16 11:20:00,13250.0,2,13700,0,13250.0,4,13260.0,5,S
2018-04-16 11:20:01,13250.0,8,13708,-2,13245.0,3,13250.0,8,S
2018-04-16 11:20:01,13250.0,14,13722,0,13240.0,10,13250.0,2,S
2018-04-16 11:20:02,13250.0,2,13724,-2,13240.0,10,13245.0,3,S
2018-04-16 11:20:02,13245.0,4,13728,2,13240.0,10,13245.0,1,S
2018-04-16 11:20:03,13245.0,14,13742,10,13245.0,3,13250.0,5,S
2018-04-16 11:20:03,13250.0,10,13752,10,13245.0,10,13260.0,4,B
2018-04-16 11:20:04,13250.0,2,13754,-2,13245.0,6,13255.0,2,B
2018-04-16 11:20:05,13250.0,2,13756,0,13245.0,4,13255.0,4,B
2018-04-16 11:20:05,13255.0,2,13758,0,13250.0,1,13255.0,2,B
2018-04-16 11:20:07,13250.0,8,13766,-2,13245.0,7,13250.0,1,S
2018-04-16 11:20:07,13250.0,2,13768,-2,13250.0,7,13255.0,2,S
2018-04-16 11:20:09,13255.0,10,13778,2,13255.0,7,13260.0,4,B
2018-04-16 11:20:09,13255.0,14,13792,10,13250.0,1,13255.0,1,B
2018-04-16 11:20:10,13245.0,4,13796,0,13245.0,2,13250.0,3,S
2018-04-16 11:20:11,13250.0,4,13800,2,13245.0,1,13250.0,3,B
2018-04-16 11:20:12,13245.0,2,13802,0,13240.0,10,13245.0,2,S
2018-04-16 11:20:12,13245.0,6,13808,0,13240.0,8,13245.0,3,S
2018-04-16 11:20:13,13245.0,2,13810,0,13240.0,8,13245.0,6,S
2018-04-16 11:20:15,13240.0,20,13830,20,13235.0,1,13240.0,3,S
2018-04-16 11:20:16,13235.0,4,13834,-2,13230.0,13,13235.0,2,S
2018-04-16 11:20:16,13235.0,12,13846,-4,13230.0,12,13240.0,3,S
2018-04-16 11:20:17,13240.0,6,13852,-2,13240.0,16,13245.0,1,B
2018-04-16 11:20:17,13245.0,6,13858,0,13240.0,3,13250.0,5,B
2018-04-16 11:20:22,13245.0,2,13860,0,13240.0,2,13245.0,2,B
2018-04-16 11:20:22,13245.0,4,13864,-4,13240.0,2,13250.0,14,B
2018-04-16 11:20:24,13240.0,2,13866,-2,13240.0,1,13250.0,14,S
2018-04-16 11:20:27,13245.0,4,13870,-4,13245.0,7,13250.0,7,B
2018-04-16 11:20:27,13245.0,10,13880,2,13240.0,6,13245.0,1,B
2018-04-16 11:20:28,13245.0,2,13882,0,13240.0,3,13245.0,3,B
2018-04-16 11:20:29,13245.0,2,13884,0,13240.0,3,13245.0,1,B
2018-04-16 11:20:30,13245.0,2,13886,0,13245.0,1,13250.0,9,B
2018-04-16 11:20:31,13245.0,8,13894,-2,13245.0,3,13250.0,2,B
2018-04-16 11:20:31,13250.0,4,13898,4,13245.0,3,13255.0,1,B
2018-04-16 11:20:37,13255.0,2,13900,-2,13250.0,6,13260.0,8,B
2018-04-16 11:20:38,13245.0,2,13902,2,13245.0,2,13260.0,9,S
2018-04-16 11:20:39,13250.0,2,13904,0,13255.0,1,13260.0,9,B
2018-04-16 11:20:40,13255.0,2,13906,2,13255.0,2,13260.0,4,B
2018-04-16 11:20:41,13260.0,8,13914,0,13260.0,7,13265.0,2,B
2018-04-16 11:20:42,13265.0,2,13916,2,13265.0,1,13270.0,5,B
2018-04-16 11:20:43,13270.0,2,13918,0,13265.0,4,13270.0,3,B
2018-04-16 11:20:43,13265.0,4,13922,-2,13265.0,3,13270.0,3,S
2018-04-16 11:20:44,13270.0,2,13924,2,13265.0,2,13275.0,3,B
2018-04-16 11:20:45,13270.0,6,13930,4,13255.0,4,13270.0,3,B
2018-04-16 11:20:45,13270.0,12,13942,6,13270.0,1,13275.0,8,B
2018-04-16 11:20:46,13270.0,8,13950,0,13260.0,1,13270.0,3,B
2018-04-16 11:20:47,13260.0,2,13952,0,13255.0,4,13270.0,2,S
2018-04-16 11:20:48,13270.0,2,13954,0,13255.0,2,13275.0,7,B
2018-04-16 11:20:49,13270.0,16,13970,14,13270.0,5,13275.0,14,B
2018-04-16 11:20:49,13270.0,12,13982,4,13240.0,7,13255.0,2,B
2018-04-16 11:20:50,13255.0,4,13986,2,13255.0,3,13265.0,1,S
2018-04-16 11:20:50,13255.0,8,13994,4,13250.0,3,13255.0,2,S
2018-04-16 11:20:51,13260.0,6,14000,4,13250.0,5,13260.0,1,B
2018-04-16 11:20:53,13255.0,2,14002,2,13245.0,4,13255.0,3,S
2018-04-16 11:20:55,13255.0,2,14004,0,13250.0,5,13255.0,5,S
2018-04-16 11:20:56,13250.0,2,14006,0,13250.0,4,13255.0,5,S
2018-04-16 11:20:58,13250.0,8,14014,-4,13245.0,8,13255.0,1,S
2018-04-16 11:21:01,13250.0,4,14018,-2,13250.0,1,13255.0,1,S
2018-04-16 11:21:02,13250.0,2,14020,0,13240.0,6,13250.0,2,S
2018-04-16 11:21:03,13245.0,2,14022,0,13245.0,4,13250.0,4,S
2018-04-16 11:21:04,13240.0,2,14024,0,13240.0,3,13250.0,4,S
2018-04-16 11:21:06,13240.0,6,14030,-2,13235.0,3,13240.0,8,S
2018-04-16 11:21:08,13230.0,20,14050,-2,13230.0,3,13235.0,1,S
2018-04-16 11:21:08,13235.0,10,14060,-2,13235.0,3,13240.0,8,B
2018-04-16 11:21:09,13240.0,26,14086,-20,13235.0,6,13240.0,1,B
2018-04-16 11:21:10,13240.0,4,14090,2,13240.0,1,13245.0,1,B
2018-04-16 11:21:10,13245.0,2,14092,0,13235.0,5,13255.0,2,B
2018-04-16 11:21:12,13245.0,4,14096,-2,13245.0,1,13255.0,2,B
2018-04-16 11:21:13,13255.0,4,14100,2,13245.0,7,13255.0,4,B
2018-04-16 11:21:14,13245.0,6,14106,-4,13245.0,3,13250.0,2,S
2018-04-16 11:21:15,13255.0,12,14118,-4,13255.0,4,13260.0,2,B
2018-04-16 11:21:15,13255.0,8,14126,-4,13240.0,5,13255.0,11,B
2018-04-16 11:21:17,13245.0,10,14136,0,13245.0,1,13250.0,5,S
2018-04-16 11:21:18,13250.0,4,14140,-4,13240.0,5,13250.0,3,B
2018-04-16 11:21:21,13250.0,10,14150,-6,13250.0,5,13255.0,7,B
2018-04-16 11:21:25,13250.0,10,14160,-4,13250.0,1,13255.0,6,B
2018-04-16 11:21:26,13250.0,2,14162,0,13250.0,1,13255.0,6,B
2018-04-16 11:21:26,13250.0,2,14164,-2,13240.0,7,13250.0,2,B
2018-04-16 11:21:27,13250.0,2,14166,2,13245.0,1,13250.0,4,B
2018-04-16 11:21:29,13250.0,4,14170,4,13245.0,1,13250.0,2,B
2018-04-16 11:21:30,13245.0,4,14174,4,13245.0,1,13250.0,10,S
2018-04-16 11:21:30,13250.0,2,14176,2,13245.0,1,13250.0,9,B
2018-04-16 11:21:32,13250.0,4,14180,4,13240.0,7,13250.0,7,B
2018-04-16 11:21:39,13250.0,10,14190,0,13245.0,5,13250.0,2,B
2018-04-16 11:21:40,13250.0,4,14194,4,13250.0,12,13255.0,1,B
2018-04-16 11:21:40,13255.0,2,14196,2,13255.0,1,13260.0,2,B
2018-04-16 11:21:42,13260.0,2,14198,-2,13255.0,5,13260.0,3,B
2018-04-16 11:21:44,13255.0,2,14200,0,13255.0,4,13265.0,7,S
2018-04-16 11:21:45,13260.0,4,14204,-4,13255.0,4,13260.0,2,B
2018-04-16 11:21:46,13260.0,4,14208,0,13255.0,4,13265.0,7,B
2018-04-16 11:21:50,13265.0,2,14210,0,13255.0,4,13265.0,6,B
2018-04-16 11:21:53,13270.0,14,14224,12,13265.0,5,13270.0,3,B
2018-04-16 11:21:54,13265.0,4,14228,4,13265.0,3,13270.0,2,S
2018-04-16 11:21:54,13265.0,6,14234,6,13260.0,2,13265.0,6,S
2018-04-16 11:21:56,13265.0,2,14236,2,13260.0,2,13265.0,4,S
2018-04-16 11:21:56,13260.0,4,14240,4,13255.0,1,13260.0,4,S
2018-04-16 11:22:02,13255.0,2,14242,2,13250.0,2,13255.0,6,S
2018-04-16 11:22:02,13250.0,4,14246,0,13240.0,3,13250.0,13,S
2018-04-16 11:22:03,13250.0,2,14248,0,13240.0,2,13245.0,2,S
2018-04-16 11:22:05,13240.0,8,14256,-6,13235.0,1,13240.0,7,S
2018-04-16 11:22:05,13240.0,12,14268,-8,13230.0,6,13240.0,4,S
2018-04-16 11:22:07,13235.0,2,14270,0,13230.0,7,13240.0,6,S
2018-04-16 11:22:08,13235.0,6,14276,-6,13230.0,7,13240.0,9,S
2018-04-16 11:22:09,13235.0,8,14284,6,13235.0,1,13240.0,5,S
2018-04-16 11:22:10,13230.0,6,14290,4,13230.0,3,13235.0,1,S
2018-04-16 11:22:11,13235.0,8,14298,0,13230.0,6,13235.0,3,B
2018-04-16 11:22:13,13230.0,6,14304,4,13230.0,2,13235.0,3,S
2018-04-16 11:22:14,13230.0,4,14308,2,13225.0,2,13230.0,5,S
2018-04-16 11:22:14,13230.0,4,14312,4,13225.0,2,13230.0,1,S
2018-04-16 11:22:15,13230.0,6,14318,0,13230.0,2,13240.0,3,S
2018-04-16 11:22:16,13245.0,4,14322,4,13245.0,1,13250.0,1,B
2018-04-16 11:22:16,13245.0,2,14324,0,13225.0,7,13235.0,4,B
2018-04-16 11:22:17,13245.0,6,14330,4,13230.0,1,13245.0,13,B
2018-04-16 11:22:18,13245.0,4,14334,4,13230.0,2,13245.0,10,B
2018-04-16 11:22:18,13230.0,4,14338,0,13225.0,7,13230.0,2,S
2018-04-16 11:22:19,13245.0,8,14346,0,13230.0,1,13245.0,7,B
2018-04-16 11:22:19,13245.0,2,14348,2,13225.0,9,13240.0,4,B
2018-04-16 11:22:20,13245.0,2,14350,2,13230.0,9,13245.0,7,B
2018-04-16 11:22:21,13230.0,4,14354,-4,13230.0,7,13245.0,3,S
2018-04-16 11:22:22,13230.0,2,14356,0,13235.0,3,13245.0,3,S
2018-04-16 11:22:24,13245.0,2,14358,-2,13230.0,3,13245.0,1,B
2018-04-16 11:22:29,13240.0,2,14360,-2,13230.0,3,13245.0,1,S
2018-04-16 11:22:30,13235.0,14,14374,8,13235.0,2,13245.0,1,S
2018-04-16 11:22:34,13225.0,8,14382,6,13225.0,4,13240.0,8,S
2018-04-16 11:22:35,13240.0,58,14440,-6,13240.0,7,13245.0,5,B
2018-04-16 11:22:35,13240.0,14,14454,-4,13220.0,8,13240.0,3,B
2018-04-16 11:22:38,13225.0,12,14466,0,13220.0,8,13235.0,6,S
2018-04-16 11:22:39,13235.0,4,14470,4,13225.0,5,13235.0,4,B
2018-04-16 11:22:41,13225.0,2,14472,2,13225.0,4,13235.0,2,S
2018-04-16 11:22:43,13225.0,18,14490,4,13220.0,9,13225.0,12,S
2018-04-16 11:22:43,13240.0,28,14518,12,13220.0,10,13240.0,12,B
2018-04-16 11:22:44,13240.0,6,14524,6,13220.0,10,13230.0,1,B
2018-04-16 11:22:45,13240.0,6,14530,6,13220.0,8,13235.0,1,B
2018-04-16 11:22:46,13230.0,4,14534,0,13225.0,3,13230.0,1,S
2018-04-16 11:22:46,13240.0,8,14542,4,13220.0,10,13240.0,9,B
2018-04-16 11:22:47,13240.0,4,14546,4,13220.0,11,13240.0,7,B
2018-04-16 11:22:48,13240.0,14,14560,4,13225.0,1,13240.0,8,B
2018-04-16 11:22:49,13225.0,4,14564,0,13220.0,11,13225.0,2,S
2018-04-16 11:22:50,13235.0,6,14570,4,13220.0,9,13240.0,8,B
2018-04-16 11:22:53,13225.0,10,14580,0,13220.0,10,13225.0,5,S
2018-04-16 11:22:53,13225.0,6,14586,2,13220.0,11,13225.0,4,S
2018-04-16 11:22:54,13225.0,4,14590,0,13220.0,11,13240.0,2,S
2018-04-16 11:22:56,13225.0,12,14602,12,13225.0,1,13235.0,5,S
2018-04-16 11:22:59,13220.0,20,14622,2,13215.0,1,13220.0,12,S
2018-04-16 11:23:00,13210.0,4,14626,0,13210.0,15,13215.0,5,S
2018-04-16 11:23:00,13215.0,36,14662,28,13210.0,1,13215.0,3,B
2018-04-16 11:23:01,13205.0,6,14668,4,13205.0,1,13210.0,16,S
2018-04-16 11:23:01,13200.0,10,14678,6,13200.0,68,13205.0,12,S
2018-04-16 11:23:02,13200.0,32,14710,24,13200.0,65,13205.0,1,S
2018-04-16 11:23:02,13200.0,46,14756,-14,13200.0,43,13205.0,2,S
2018-04-16 11:23:03,13200.0,10,14766,-10,13200.0,39,13205.0,4,S
2018-04-16 11:23:03,13200.0,68,14834,-28,13200.0,5,13205.0,7,S
2018-04-16 11:23:04,13205.0,2,14836,2,13200.0,6,13205.0,2,B
2018-04-16 11:23:05,13205.0,4,14840,4,13200.0,5,13205.0,2,B
2018-04-16 11:23:05,13200.0,14,14854,-4,13195.0,10,13205.0,1,S
2018-04-16 11:23:06,13200.0,2,14856,-2,13195.0,10,13205.0,1,S
2018-04-16 11:23:06,13195.0,4,14860,4,13200.0,1,13205.0,1,S
2018-04-16 11:23:07,13195.0,10,14870,10,13195.0,4,13200.0,1,S
2018-04-16 11:23:07,13200.0,12,14882,-8,13200.0,18,13210.0,1,B
2018-04-16 11:23:08,13195.0,10,14892,-2,13200.0,1,13205.0,3,S
2018-04-16 11:23:09,13200.0,2,14894,2,13190.0,15,13200.0,1,B
2018-04-16 11:23:09,13200.0,2,14896,0,13190.0,15,13205.0,1,B
2018-04-16 11:23:10,13200.0,4,14900,0,13200.0,9,13210.0,2,B
2018-04-16 11:23:12,13200.0,6,14906,4,13195.0,2,13210.0,4,B
2018-04-16 11:23:12,13195.0,4,14910,0,13190.0,18,13210.0,5,S
2018-04-16 11:23:13,13210.0,4,14914,0,13195.0,1,13200.0,16,B
2018-04-16 11:23:13,13195.0,2,14916,0,13190.0,15,13195.0,3,S
2018-04-16 11:23:14,13190.0,6,14922,0,13190.0,13,13195.0,2,S
2018-04-16 11:23:14,13190.0,8,14930,4,13190.0,11,13200.0,29,S
2018-04-16 11:23:15,13190.0,2,14932,2,13190.0,10,13200.0,28,S
2018-04-16 11:23:16,13190.0,8,14940,8,13190.0,6,13200.0,32,S
2018-04-16 11:23:16,13190.0,8,14948,8,13190.0,3,13200.0,29,S
2018-04-16 11:23:18,13200.0,8,14956,4,13190.0,7,13200.0,26,B
2018-04-16 11:23:19,13190.0,8,14964,-6,13190.0,4,13200.0,25,S
2018-04-16 11:23:20,13200.0,10,14974,-10,13190.0,4,13200.0,20,B
2018-04-16 11:23:22,13200.0,2,14976,0,13190.0,3,13195.0,19,B
2018-04-16 11:23:23,13190.0,6,14982,6,13185.0,15,13195.0,24,S
2018-04-16 11:23:26,13190.0,10,14992,-10,13190.0,7,13195.0,21,S
2018-04-16 11:23:27,13190.0,10,15002,0,13185.0,13,13190.0,1,S
2018-04-16 11:23:27,13190.0,4,15006,0,13185.0,12,13190.0,1,S
2018-04-16 11:23:28,13190.0,10,15016,6,13185.0,8,13195.0,19,S
2018-04-16 11:23:32,13195.0,2,15018,2,13185.0,8,13195.0,18,B
2018-04-16 11:23:33,13195.0,36,15054,6,13190.0,5,13200.0,22,B
2018-04-16 11:23:33,13200.0,32,15086,12,13195.0,8,13200.0,5,B
2018-04-16 11:23:34,13200.0,10,15096,10,13200.0,2,13205.0,1,B
2018-04-16 11:23:34,13205.0,4,15100,2,13200.0,1,13210.0,6,B
2018-04-16 11:23:35,13205.0,6,15106,2,13195.0,4,13205.0,6,B
2018-04-16 11:23:39,13205.0,6,15112,-2,13205.0,1,13210.0,4,B
2018-04-16 11:23:39,13210.0,4,15116,2,13210.0,1,13215.0,9,B
2018-04-16 11:23:41,13215.0,6,15122,-6,13210.0,2,13220.0,2,B
2018-04-16 11:23:42,13220.0,4,15126,2,13215.0,4,13225.0,2,B
2018-04-16 11:23:44,13220.0,2,15128,0,13215.0,4,13225.0,2,B
2018-04-16 11:23:46,13215.0,6,15134,6,13210.0,2,13220.0,4,S
2018-04-16 11:23:49,13220.0,2,15136,0,13215.0,1,13225.0,10,B
2018-04-16 11:23:51,13225.0,6,15142,2,13220.0,1,13225.0,2,B
2018-04-16 11:23:52,13225.0,2,15144,0,13215.0,3,13225.0,7,B
2018-04-16 11:23:54,13220.0,6,15150,0,13215.0,4,13220.0,2,S
2018-04-16 11:23:54,13220.0,4,15154,2,13215.0,5,13225.0,1,S
2018-04-16 11:23:56,13215.0,2,15156,2,13215.0,4,13230.0,5,S
2018-04-16 11:23:57,13230.0,10,15166,4,13230.0,2,13235.0,4,B
2018-04-16 11:23:57,13230.0,6,15172,0,13225.0,3,13235.0,1,B
2018-04-16 11:23:58,13225.0,4,15176,-4,13225.0,1,13235.0,1,S
2018-04-16 11:23:59,13225.0,8,15184,-8,13220.0,1,13235.0,1,S
2018-04-16 11:24:00,13235.0,2,15186,-2,13235.0,1,13240.0,3,B
2018-04-16 11:24:00,13235.0,4,15190,-4,13230.0,2,13240.0,1,B
2018-04-16 11:24:01,13230.0,2,15192,0,13230.0,1,13240.0,1,S
2018-04-16 11:24:02,13230.0,2,15194,2,13220.0,1,13230.0,39,S
2018-04-16 11:24:05,13230.0,4,15198,0,13215.0,7,13230.0,41,S
2018-04-16 11:24:09,13215.0,10,15208,4,13215.0,5,13225.0,1,S
2018-04-16 11:24:09,13230.0,4,15212,2,13215.0,6,13230.0,39,B
2018-04-16 11:24:13,13230.0,32,15244,20,13225.0,2,13230.0,22,B
2018-04-16 11:24:14,13230.0,4,15248,0,13225.0,2,13230.0,20,B
2018-04-16 11:24:15,13225.0,20,15268,6,13225.0,3,13230.0,15,S
2018-04-16 11:24:16,13230.0,4,15272,2,13225.0,4,13230.0,13,B
2018-04-16 11:24:17,13230.0,10,15282,10,13225.0,3,13230.0,8,B
2018-04-16 11:24:20,13230.0,2,15284,0,13225.0,2,13230.0,7,B
2018-04-16 11:24:23,13230.0,8,15292,8,13225.0,14,13230.0,3,B
2018-04-16 11:24:23,13230.0,6,15298,2,13225.0,15,13235.0,3,B
2018-04-16 11:24:25,13230.0,6,15304,2,13230.0,3,13240.0,4,B
2018-04-16 11:24:30,13240.0,2,15306,-2,13230.0,4,13240.0,1,B
2018-04-16 11:24:30,13240.0,2,15308,-2,13240.0,1,13245.0,3,B
2018-04-16 11:24:31,13240.0,2,15310,-2,13230.0,5,13240.0,10,B
2018-04-16 11:24:37,13240.0,2,15312,-2,13240.0,1,13245.0,5,B
2018-04-16 11:24:37,13240.0,2,15314,-2,13240.0,6,13245.0,5,B
2018-04-16 11:24:38,13240.0,12,15326,0,13225.0,3,13240.0,1,B
2018-04-16 11:24:39,13240.0,2,15328,0,13230.0,2,13240.0,5,B
2018-04-16 11:24:46,13240.0,2,15330,2,13230.0,5,13240.0,16,B
2018-04-16 11:24:50,13240.0,4,15334,0,13230.0,6,13240.0,15,B
2018-04-16 11:24:53,13230.0,10,15344,0,13230.0,1,13240.0,15,S
2018-04-16 11:24:54,13240.0,2,15346,2,13230.0,1,13240.0,14,B
2018-04-16 11:24:55,13230.0,2,15348,0,13225.0,3,13240.0,14,S
2018-04-16 11:25:03,13230.0,2,15350,0,13225.0,7,13235.0,1,S
2018-04-16 11:25:07,13235.0,2,15352,0,13225.0,12,13240.0,16,B
2018-04-16 11:25:11,13235.0,2,15354,0,13235.0,6,13240.0,15,B
2018-04-16 11:25:13,13240.0,14,15368,0,13235.0,7,13240.0,8,B
2018-04-16 11:25:14,13240.0,10,15378,0,13235.0,6,13240.0,3,B
2018-04-16 11:25:14,13240.0,6,15384,2,13240.0,2,13245.0,4,B
2018-04-16 11:25:16,13245.0,2,15386,-2,13245.0,8,13250.0,11,B
2018-04-16 11:25:16,13245.0,2,15388,-2,13245.0,2,13250.0,8,B
2018-04-16 11:25:18,13250.0,10,15398,4,13245.0,4,13250.0,3,B
2018-04-16 11:25:18,13250.0,6,15404,2,13250.0,3,13255.0,4,B
2018-04-16 11:25:19,13255.0,6,15410,-2,13250.0,3,13255.0,1,B
2018-04-16 11:25:20,13255.0,2,15412,-2,13250.0,4,13260.0,4,B
2018-04-16 11:25:22,13255.0,8,15420,-6,13250.0,1,13260.0,6,B
2018-04-16 11:25:22,13250.0,2,15422,-2,13240.0,5,13255.0,4,S
2018-04-16 11:25:25,13245.0,2,15424,0,13240.0,4,13250.0,3,S
2018-04-16 11:25:28,13250.0,2,15426,0,13240.0,4,13250.0,4,B
2018-04-16 11:25:30,13250.0,4,15430,0,13240.0,2,13250.0,4,B
2018-04-16 11:25:34,13250.0,2,15432,0,13240.0,2,13250.0,1,B
2018-04-16 11:25:35,13245.0,2,15434,2,13240.0,2,13250.0,2,S
2018-04-16 11:25:38,13245.0,2,15436,0,13230.0,5,13245.0,7,S
2018-04-16 11:26:10,13240.0,2,15438,-2,13235.0,1,13245.0,1,S
2018-04-16 11:26:11,13230.0,10,15448,-8,13225.0,1,13230.0,2,S
2018-04-16 11:26:12,13230.0,4,15452,-2,13230.0,7,13240.0,1,S
2018-04-16 11:26:16,13235.0,2,15454,2,13230.0,4,13240.0,1,B
2018-04-16 11:26:27,13240.0,2,15456,2,13230.0,11,13240.0,2,B
2018-04-16 11:26:33,13230.0,2,15458,0,13225.0,1,13235.0,4,S
2018-04-16 11:26:40,13225.0,4,15462,4,13220.0,10,13230.0,11,S
2018-04-16 11:26:42,13230.0,2,15464,2,13220.0,10,13230.0,7,B
2018-04-16 11:26:43,13225.0,2,15466,0,13220.0,10,13230.0,7,S
2018-04-16 11:26:46,13220.0,20,15486,-20,13215.0,3,13230.0,8,S
2018-04-16 11:26:49,13220.0,2,15488,-2,13220.0,3,13230.0,8,S
2018-04-16 11:26:52,13220.0,2,15490,2,13220.0,10,13230.0,8,S
2018-04-16 11:26:53,13220.0,20,15510,20,13215.0,3,13230.0,8,S
2018-04-16 11:27:02,13225.0,4,15514,-4,13215.0,12,13230.0,8,B
2018-04-16 11:27:06,13230.0,2,15516,2,13220.0,10,13230.0,7,B
2018-04-16 11:27:09,13225.0,10,15526,10,13220.0,5,13225.0,5,S
2018-04-16 11:27:09,13225.0,10,15536,10,13225.0,4,13230.0,6,S
2018-04-16 11:27:10,13230.0,4,15540,0,13225.0,2,13230.0,4,B
2018-04-16 11:27:12,13230.0,8,15548,4,13225.0,2,13235.0,3,B
2018-04-16 11:27:15,13230.0,6,15554,-6,13235.0,2,13245.0,3,B
2018-04-16 11:27:17,13230.0,10,15564,8,13225.0,1,13230.0,45,B
2018-04-16 11:27:18,13230.0,4,15568,0,13225.0,3,13230.0,43,B
2018-04-16 11:27:23,13225.0,10,15578,6,13220.0,4,13225.0,38,S
2018-04-16 11:27:24,13225.0,22,15600,4,13220.0,8,13225.0,27,S
2018-04-16 11:27:24,13225.0,10,15610,10,13220.0,9,13225.0,22,S
2018-04-16 11:27:25,13225.0,4,15614,0,13220.0,7,13225.0,21,S
2018-04-16 11:27:28,13225.0,2,15616,2,13220.0,7,13225.0,20,S
2018-04-16 11:27:28,13225.0,4,15620,4,13220.0,7,13225.0,18,S
2018-04-16 11:27:29,13225.0,2,15622,0,13220.0,10,13225.0,17,S
2018-04-16 11:27:34,13220.0,32,15654,-16,13215.0,3,13220.0,4,S
2018-04-16 11:27:34,13225.0,42,15696,-8,13220.0,5,13230.0,2,B
2018-04-16 11:27:35,13230.0,4,15700,-4,13220.0,3,13235.0,3,B
2018-04-16 11:27:35,13230.0,4,15704,-2,13220.0,2,13235.0,3,B
2018-04-16 11:27:37,13230.0,2,15706,0,13220.0,9,13235.0,6,B
2018-04-16 11:27:41,13225.0,2,15708,2,13225.0,5,13235.0,4,S
2018-04-16 11:27:43,13225.0,8,15716,-4,13220.0,1,13225.0,16,S
2018-04-16 11:27:43,13225.0,8,15724,-6,13220.0,3,13225.0,12,S
2018-04-16 11:27:46,13225.0,4,15728,-4,13220.0,3,13225.0,10,S
2018-04-16 11:27:48,13225.0,4,15732,-4,13220.0,5,13225.0,8,S
2018-04-16 11:27:50,13225.0,12,15744,-12,13220.0,11,13225.0,2,S
2018-04-16 11:27:50,13225.0,4,15748,-2,13220.0,11,13240.0,5,S
2018-04-16 11:27:52,13235.0,4,15752,2,13235.0,3,13240.0,2,B
2018-04-16 11:27:55,13235.0,4,15756,-4,13230.0,1,13235.0,23,B
2018-04-16 11:28:00,13235.0,6,15762,-6,13230.0,7,13235.0,20,B
2018-04-16 11:28:02,13230.0,4,15766,0,13225.0,15,13230.0,1,S
2018-04-16 11:28:07,13230.0,2,15768,0,13225.0,15,13235.0,1,S
2018-04-16 11:28:09,13225.0,30,15798,-18,13220.0,5,13225.0,5,S
2018-04-16 11:28:10,13225.0,10,15808,-6,13220.0,10,13235.0,4,S
2018-04-16 11:28:11,13230.0,2,15810,2,13220.0,4,13235.0,4,B
2018-04-16 11:28:14,13230.0,2,15812,2,13220.0,4,13235.0,4,B
2018-04-16 11:28:18,13230.0,2,15814,2,13220.0,4,13230.0,1,B
2018-04-16 11:28:19,13230.0,6,15820,-4,13230.0,4,13235.0,5,B
2018-04-16 11:28:19,13230.0,8,15828,-8,13220.0,2,13230.0,25,B
2018-04-16 11:28:23,13220.0,4,15832,-4,13220.0,1,13225.0,1,S
2018-04-16 11:28:29,13220.0,2,15834,0,13220.0,1,13225.0,2,S
2018-04-16 11:28:30,13225.0,4,15838,-4,13215.0,11,13235.0,6,B
2018-04-16 11:28:31,13215.0,26,15864,-12,13210.0,16,13215.0,12,S
2018-04-16 11:28:31,13215.0,24,15888,-4,13225.0,1,13235.0,7,S
2018-04-16 11:28:32,13225.0,2,15890,0,13220.0,1,13235.0,8,B
2018-04-16 11:28:37,13225.0,2,15892,0,13215.0,5,13230.0,5,B
2018-04-16 11:28:44,13225.0,2,15894,2,13220.0,1,13230.0,5,B
2018-04-16 11:28:47,13225.0,10,15904,0,13225.0,5,13230.0,2,B
2018-04-16 11:28:51,13230.0,4,15908,-4,13225.0,5,13235.0,6,B
2018-04-16 11:28:54,13235.0,2,15910,0,13230.0,1,13235.0,3,B
2018-04-16 11:28:55,13235.0,4,15914,2,13230.0,5,13240.0,3,B
2018-04-16 11:28:56,13235.0,8,15922,-6,13235.0,3,13240.0,3,B
2018-04-16 11:28:58,13230.0,10,15932,6,13235.0,1,13240.0,2,S
2018-04-16 11:28:58,13240.0,4,15936,4,13225.0,5,13245.0,2,B
2018-04-16 11:28:59,13240.0,2,15938,2,13225.0,7,13245.0,6,B
2018-04-16 11:29:00,13245.0,8,15946,-2,13235.0,2,13245.0,4,B
2018-04-16 11:29:01,13245.0,2,15948,-2,13245.0,1,13250.0,4,B
2018-04-16 11:29:01,13245.0,2,15950,-2,13235.0,3,13245.0,1,B
2018-04-16 11:29:04,13245.0,2,15952,2,13235.0,2,13240.0,3,B
2018-04-16 11:29:11,13235.0,2,15954,0,13230.0,2,13235.0,1,S
2018-04-16 11:29:14,13235.0,2,15956,2,13230.0,4,13235.0,2,S
2018-04-16 11:29:19,13235.0,2,15958,2,13225.0,5,13235.0,6,S
2018-04-16 11:29:22,13225.0,2,15960,-2,13225.0,4,13235.0,7,S
2018-04-16 11:29:25,13225.0,4,15964,0,13225.0,2,13230.0,5,S
2018-04-16 11:29:25,13225.0,4,15968,0,13220.0,1,13225.0,2,S
2018-04-16 11:29:26,13220.0,2,15970,2,13215.0,12,13220.0,2,S
2018-04-16 11:29:26,13215.0,2,15972,0,13215.0,11,13220.0,2,S
2018-04-16 11:29:29,13215.0,6,15978,-6,13215.0,8,13225.0,3,S
2018-04-16 11:29:30,13220.0,2,15980,0,13215.0,8,13220.0,1,B
2018-04-16 11:29:31,13215.0,16,15996,-12,13210.0,18,13220.0,3,S
2018-04-16 11:29:31,13215.0,14,16010,-8,13210.0,13,13215.0,2,S
2018-04-16 11:29:32,13210.0,24,16034,18,13210.0,1,13215.0,4,S
2018-04-16 11:29:32,13210.0,2,16036,-2,13205.0,3,13210.0,1,S
2018-04-16 11:29:33,13210.0,10,16046,0,13205.0,4,13210.0,1,S
2018-04-16 11:29:34,13210.0,2,16048,0,13205.0,4,13215.0,4,S
2018-04-16 11:29:35,13205.0,2,16050,2,13205.0,3,13215.0,2,S
2018-04-16 11:29:36,13215.0,6,16056,-6,13215.0,6,13220.0,3,B
2018-04-16 11:29:36,13215.0,12,16068,0,13205.0,3,13215.0,1,B
2018-04-16 11:29:38,13205.0,4,16072,-2,13205.0,1,13220.0,13,S
2018-04-16 11:29:40,13185.0,12,16084,8,13185.0,10,13210.0,7,S
2018-04-16 11:29:41,13185.0,4,16088,2,13190.0,5,13210.0,3,S
2018-04-16 11:29:42,13195.0,2,16090,0,13195.0,1,13200.0,1,B
2018-04-16 11:29:43,13195.0,2,16092,0,13190.0,3,13195.0,4,B
2018-04-16 11:29:45,13185.0,24,16116,12,13185.0,3,13190.0,2,S
2018-04-16 11:29:45,13185.0,6,16122,4,13180.0,17,13185.0,2,S
2018-04-16 11:29:46,13185.0,6,16128,2,13185.0,1,13190.0,4,S
2018-04-16 11:29:46,13185.0,2,16130,0,13180.0,19,13185.0,5,S
2018-04-16 11:29:48,13180.0,12,16142,-2,13180.0,12,13185.0,11,S
2018-04-16 11:29:49,13160.0,38,16180,4,13155.0,6,13175.0,1,S
2018-04-16 11:29:49,13175.0,6,16186,0,13155.0,9,13185.0,10,B
2018-04-16 11:29:50,13180.0,6,16192,-4,13155.0,5,13180.0,2,B
2018-04-16 11:29:52,13165.0,2,16194,0,13165.0,1,13175.0,3,S
2018-04-16 11:29:52,13155.0,12,16206,10,13150.0,15,13175.0,3,S
2018-04-16 11:29:53,13150.0,4,16210,0,13150.0,15,13160.0,1,S
2018-04-16 11:29:53,13160.0,6,16216,4,13165.0,1,13180.0,1,B
2018-04-16 11:29:54,13175.0,4,16220,0,13175.0,1,13185.0,2,B
2018-04-16 11:29:55,13180.0,4,16224,2,13165.0,1,13185.0,4,B
2018-04-16 11:29:56,13160.0,10,16234,4,13160.0,1,13175.0,1,S
2018-04-16 11:29:57,13170.0,2,16236,-2,13150.0,19,13185.0,4,B
2018-04-16 13:30:01,13165.0,6,16242,6,13150.0,19,13170.0,2,S
2018-04-16 13:30:01,13170.0,4,16246,-2,13150.0,19,13165.0,17,B
2018-04-16 13:30:01,13150.0,24,16270,20,13150.0,9,13160.0,1,S
2018-04-16 13:30:02,13150.0,16,16286,14,13150.0,1,13155.0,3,S
2018-04-16 13:30:02,13150.0,4,16290,0,13140.0,1,13150.0,11,S
2018-04-16 13:30:04,13155.0,2,16292,0,13155.0,3,13165.0,15,B
2018-04-16 13:30:05,13150.0,18,16310,6,13150.0,1,13160.0,10,S
2018-04-16 13:30:05,13160.0,4,16314,-2,13150.0,1,13160.0,8,B
2018-04-16 13:30:06,13155.0,4,16318,0,13150.0,1,13160.0,8,S
2018-04-16 13:30:06,13160.0,2,16320,0,13155.0,1,13160.0,7,B
2018-04-16 13:30:07,13150.0,8,16328,-6,13145.0,3,13160.0,7,S
2018-04-16 13:30:08,13155.0,10,16338,2,13145.0,3,13155.0,21,B
2018-04-16 13:30:09,13145.0,2,16340,0,13145.0,2,13150.0,8,S
2018-04-16 13:30:10,13145.0,4,16344,0,13140.0,1,13145.0,5,S
2018-04-16 13:30:10,13140.0,2,16346,2,13135.0,1,13140.0,7,S
2018-04-16 13:30:11,13140.0,8,16354,0,13135.0,1,13140.0,1,S
2018-04-16 13:30:11,13145.0,4,16358,-2,13135.0,2,13150.0,1,B
2018-04-16 13:30:13,13130.0,6,16364,0,13130.0,3,13135.0,9,S
2018-04-16 13:30:14,13135.0,26,16390,16,13120.0,1,13135.0,10,B
2018-04-16 13:30:16,13130.0,2,16392,-2,13130.0,5,13135.0,10,S
2018-04-16 13:30:17,13130.0,4,16396,0,13130.0,1,13135.0,10,S
2018-04-16 13:30:17,13130.0,6,16402,-4,13125.0,2,13130.0,17,S
2018-04-16 13:30:18,13135.0,36,16438,-8,13130.0,2,13135.0,9,B
2018-04-16 13:30:18,13135.0,18,16456,-18,13135.0,2,13140.0,3,B
2018-04-16 13:30:19,13130.0,6,16462,4,13125.0,2,13130.0,19,S
2018-04-16 13:30:19,13130.0,12,16474,0,13125.0,2,13130.0,13,S
2018-04-16 13:30:20,13140.0,28,16502,6,13125.0,8,13145.0,2,B
2018-04-16 13:30:20,13140.0,2,16504,0,13130.0,1,13140.0,3,B
2018-04-16 13:30:22,13135.0,4,16508,0,13130.0,2,13135.0,2,S
2018-04-16 13:30:22,13130.0,4,16512,4,13125.0,2,13135.0,1,S
2018-04-16 13:30:23,13135.0,2,16514,2,13135.0,1,13140.0,5,B
2018-04-16 13:30:23,13135.0,2,16516,2,13125.0,2,13140.0,5,B
2018-04-16 13:30:24,13135.0,4,16520,0,13135.0,12,13145.0,3,B
2018-04-16 13:30:25,13135.0,2,16522,0,13135.0,13,13150.0,2,B
2018-04-16 13:30:25,13135.0,2,16524,-2,13135.0,12,13150.0,4,B
2018-04-16 13:30:26,13135.0,4,16528,4,13135.0,5,13145.0,4,B
2018-04-16 13:30:38,13140.0,22,16550,2,13140.0,1,13145.0,4,B
2018-04-16 13:30:39,13145.0,2,16552,0,13140.0,10,13150.0,10,B
2018-04-16 13:30:40,13140.0,8,16560,6,13140.0,8,13150.0,7,S
2018-04-16 13:30:41,13145.0,14,16574,-8,13140.0,2,13145.0,4,B
2018-04-16 13:30:43,13140.0,2,16576,0,13135.0,2,13145.0,9,S
2018-04-16 13:30:45,13145.0,2,16578,2,13140.0,16,13145.0,6,B
2018-04-16 13:30:47,13140.0,4,16582,0,13140.0,11,13145.0,6,S
2018-04-16 13:30:49,13140.0,2,16584,2,13135.0,2,13140.0,19,S
2018-04-16 13:30:51,13140.0,2,16586,2,13135.0,1,13140.0,28,S
2018-04-16 13:30:56,13135.0,6,16592,4,13130.0,4,13140.0,27,S
2018-04-16 13:30:57,13130.0,4,16596,0,13125.0,2,13130.0,14,S
2018-04-16 13:30:59,13125.0,2,16598,2,13120.0,4,13125.0,1,S
2018-04-16 13:30:59,13120.0,4,16602,0,13120.0,2,13130.0,15,S
2018-04-16 13:31:00,13120.0,4,16606,4,13110.0,4,13125.0,9,S
2018-04-16 13:31:01,13125.0,2,16608,2,13115.0,3,13125.0,8,B
2018-04-16 13:31:03,13110.0,20,16628,4,13120.0,5,13130.0,16,S
2018-04-16 13:31:03,13130.0,2,16630,-2,13120.0,5,13130.0,2,B
2018-04-16 13:31:04,13120.0,2,16632,2,13120.0,5,13130.0,2,S
2018-04-16 13:31:05,13130.0,2,16634,0,13125.0,8,13130.0,1,B
2018-04-16 13:31:06,13120.0,2,16636,0,13120.0,4,13125.0,2,S
2018-04-16 13:31:06,13125.0,4,16640,0,13125.0,3,13130.0,1,B
2018-04-16 13:31:08,13120.0,8,16648,8,13110.0,2,13125.0,15,S
2018-04-16 13:31:11,13115.0,8,16656,-2,13115.0,3,13120.0,4,S
2018-04-16 13:31:11,13120.0,2,16658,2,13120.0,1,13125.0,19,B
2018-04-16 13:31:12,13120.0,2,16660,2,13115.0,1,13120.0,4,B
2018-04-16 13:31:15,13120.0,2,16662,2,13120.0,1,13125.0,17,B
2018-04-16 13:31:16,13120.0,4,16666,2,13115.0,7,13120.0,18,B
2018-04-16 13:31:16,13120.0,8,16674,0,13115.0,9,13120.0,14,B
2018-04-16 13:31:17,13120.0,28,16702,6,13115.0,9,13130.0,6,B
2018-04-16 13:31:17,13135.0,4,16706,0,13120.0,10,13135.0,3,B
2018-04-16 13:31:18,13120.0,4,16710,-2,13125.0,3,13135.0,3,S
2018-04-16 13:31:21,13135.0,2,16712,2,13135.0,9,13140.0,23,B
2018-04-16 13:31:22,13135.0,4,16716,4,13135.0,7,13140.0,25,B
2018-04-16 13:31:24,13135.0,12,16728,12,13135.0,1,13140.0,21,B
2018-04-16 13:31:25,13135.0,4,16732,0,13120.0,2,13135.0,1,B
2018-04-16 13:31:26,13140.0,20,16752,20,13125.0,10,13140.0,10,B
2018-04-16 13:31:28,13140.0,2,16754,2,13125.0,10,13140.0,10,B
2018-04-16 13:31:31,13135.0,2,16756,2,13130.0,9,13140.0,10,S
2018-04-16 13:31:32,13135.0,2,16758,2,13135.0,2,13140.0,13,S
2018-04-16 13:31:33,13140.0,2,16760,0,13135.0,2,13140.0,9,B
2018-04-16 13:31:37,13140.0,2,16762,2,13130.0,1,13140.0,15,B
2018-04-16 13:31:38,13135.0,2,16764,2,13130.0,1,13140.0,15,S
2018-04-16 13:31:39,13135.0,2,16766,0,13130.0,1,13135.0,3,S
2018-04-16 13:31:44,13135.0,2,16768,-2,13130.0,2,13135.0,4,S
2018-04-16 13:31:47,13135.0,2,16770,-2,13130.0,1,13135.0,18,S
2018-04-16 13:31:48,13135.0,2,16772,-2,13130.0,6,13135.0,20,S
2018-04-16 13:31:50,13130.0,12,16784,2,13125.0,5,13130.0,6,S
2018-04-16 13:31:50,13135.0,46,16830,-22,13125.0,1,13135.0,21,B
2018-04-16 13:31:51,13130.0,8,16838,6,13120.0,4,13130.0,3,S
2018-04-16 13:31:54,13130.0,2,16840,2,13125.0,2,13130.0,4,S
2018-04-16 13:31:59,13120.0,2,16842,0,13120.0,5,13130.0,4,S
2018-04-16 13:32:00,13125.0,4,16846,-4,13120.0,5,13130.0,4,B
2018-04-16 13:32:01,13120.0,2,16848,2,13120.0,5,13130.0,4,S
2018-04-16 13:32:01,13120.0,2,16850,0,13115.0,10,13120.0,12,S
2018-04-16 13:32:02,13120.0,22,16872,-2,13115.0,7,13120.0,1,S
2018-04-16 13:32:02,13120.0,2,16874,-2,13120.0,2,13125.0,1,S
2018-04-16 13:32:03,13125.0,2,16876,0,13115.0,7,13125.0,1,B
2018-04-16 13:32:04,13115.0,4,16880,2,13115.0,4,13120.0,1,S
2018-04-16 13:32:04,13120.0,2,16882,0,13120.0,7,13125.0,3,B
2018-04-16 13:32:05,13125.0,4,16886,0,13120.0,6,13130.0,7,B
2018-04-16 13:32:09,13125.0,2,16888,2,13120.0,6,13130.0,8,B
2018-04-16 13:32:11,13125.0,2,16890,-2,13120.0,6,13130.0,7,B
2018-04-16 13:32:16,13130.0,22,16912,4,13120.0,7,13135.0,17,B
2018-04-16 13:32:20,13125.0,4,16916,0,13120.0,8,13130.0,1,S
2018-04-16 13:32:21,13120.0,12,16928,0,13120.0,1,13125.0,6,S
2018-04-16 13:32:22,13120.0,2,16930,-2,13115.0,6,13125.0,5,S
2018-04-16 13:32:23,13115.0,6,16936,4,13115.0,1,13120.0,14,S
2018-04-16 13:32:23,13115.0,2,16938,-2,13110.0,6,13120.0,12,S
2018-04-16 13:32:27,13120.0,4,16942,0,13115.0,5,13120.0,7,B
2018-04-16 13:32:28,13115.0,2,16944,0,13115.0,5,13120.0,7,S
2018-04-16 13:32:29,13120.0,4,16948,4,13115.0,5,13120.0,13,B
2018-04-16 13:32:30,13120.0,12,16960,4,13115.0,8,13120.0,7,B
2018-04-16 13:32:33,13120.0,4,16964,2,13115.0,1,13120.0,6,B
2018-04-16 13:32:36,13120.0,2,16966,0,13115.0,3,13120.0,10,B
2018-04-16 13:32:37,13115.0,4,16970,2,13115.0,2,13120.0,5,S
2018-04-16 13:32:38,13115.0,2,16972,2,13110.0,8,13120.0,10,S
2018-04-16 13:32:40,13115.0,2,16974,2,13110.0,4,13115.0,4,S
2018-04-16 13:32:41,13115.0,2,16976,2,13110.0,4,13115.0,5,S
2018-04-16 13:32:44,13110.0,4,16980,4,13110.0,2,13115.0,7,S
2018-04-16 13:32:45,13115.0,6,16986,2,13105.0,12,13115.0,8,B
2018-04-16 13:32:45,13105.0,4,16990,0,13105.0,8,13110.0,7,S
2018-04-16 13:32:48,13105.0,2,16992,0,13105.0,11,13115.0,13,S
2018-04-16 13:32:52,13105.0,4,16996,-4,13105.0,8,13110.0,1,S
2018-04-16 13:32:52,13105.0,10,17006,-8,13105.0,6,13115.0,16,S
2018-04-16 13:32:53,13105.0,14,17020,-4,13100.0,15,13105.0,4,S
2018-04-16 13:32:54,13105.0,8,17028,0,13105.0,11,13115.0,15,S
2018-04-16 13:32:54,13110.0,2,17030,0,13105.0,11,13115.0,15,B
2018-04-16 13:32:59,13110.0,4,17034,-4,13110.0,2,13115.0,14,B
2018-04-16 13:33:00,13105.0,4,17038,2,13105.0,4,13115.0,12,S
2018-04-16 13:33:01,13110.0,8,17046,0,13110.0,4,13115.0,10,B
2018-04-16 13:33:02,13110.0,4,17050,0,13110.0,7,13115.0,9,B
2018-04-16 13:33:03,13115.0,14,17064,14,13110.0,12,13115.0,2,B
2018-04-16 13:33:03,13120.0,6,17070,0,13115.0,3,13120.0,1,B
2018-04-16 13:33:04,13120.0,2,17072,0,13120.0,2,13125.0,3,B
2018-04-16 13:33:05,13120.0,2,17074,0,13120.0,1,13125.0,2,B
2018-04-16 13:33:06,13125.0,4,17078,0,13120.0,2,13130.0,15,B
2018-04-16 13:33:08,13130.0,18,17096,4,13125.0,3,13130.0,3,B
2018-04-16 13:33:09,13125.0,8,17104,2,13120.0,6,13130.0,3,S
2018-04-16 13:33:10,13125.0,2,17106,0,13125.0,2,13130.0,6,S
2018-04-16 13:33:11,13125.0,12,17118,-6,13125.0,1,13135.0,7,S
2018-04-16 13:33:14,13135.0,6,17124,-2,13135.0,2,13140.0,22,B
2018-04-16 13:33:16,13135.0,4,17128,2,13135.0,2,13140.0,17,B
2018-04-16 13:33:17,13140.0,18,17146,2,13135.0,7,13140.0,8,B
2018-04-16 13:33:18,13140.0,16,17162,10,13135.0,7,13145.0,3,B
2018-04-16 13:33:19,13140.0,2,17164,0,13135.0,1,13145.0,3,B
2018-04-16 13:33:22,13140.0,2,17166,2,13135.0,5,13145.0,4,B
2018-04-16 13:33:23,13145.0,2,17168,0,13135.0,5,13145.0,2,B
2018-04-16 13:33:24,13145.0,2,17170,0,13140.0,3,13150.0,15,B
2018-04-16 13:33:25,13145.0,2,17172,-2,13135.0,13,13145.0,4,B
2018-04-16 13:33:26,13150.0,22,17194,14,13140.0,1,13150.0,7,B
2018-04-16 13:33:30,13145.0,2,17196,0,13140.0,1,13150.0,7,S
2018-04-16 13:33:32,13150.0,4,17200,-2,13150.0,3,13155.0,23,B
2018-04-16 13:33:32,13155.0,2,17202,0,13150.0,3,13155.0,19,B
2018-04-16 13:33:33,13155.0,4,17206,0,13150.0,3,13155.0,17,B
2018-04-16 13:33:33,13155.0,16,17222,4,13150.0,6,13155.0,9,B
2018-04-16 13:33:34,13150.0,6,17228,0,13145.0,1,13150.0,12,S
2018-04-16 13:33:37,13145.0,2,17230,2,13145.0,1,13150.0,12,S
2018-04-16 13:33:37,13145.0,4,17234,2,13145.0,1,13150.0,12,S
2018-04-16 13:33:38,13150.0,4,17238,-4,13145.0,8,13150.0,10,B
2018-04-16 13:33:38,13145.0,16,17254,6,13140.0,3,13150.0,12,S
2018-04-16 13:33:42,13145.0,2,17256,0,13140.0,2,13150.0,13,S
2018-04-16 13:33:43,13150.0,20,17276,-20,13140.0,2,13150.0,1,B
2018-04-16 13:33:44,13150.0,2,17278,2,13140.0,2,13155.0,14,B
2018-04-16 13:33:45,13150.0,2,17280,-2,13150.0,3,13155.0,11,B
2018-04-16 13:33:47,13150.0,2,17282,2,13150.0,7,13155.0,11,B
2018-04-16 13:33:48,13150.0,8,17290,-4,13150.0,3,13155.0,18,B
2018-04-16 13:33:53,13155.0,14,17304,-2,13150.0,1,13155.0,7,B
2018-04-16 13:34:02,13150.0,2,17306,-2,13145.0,1,13150.0,3,S
2018-04-16 13:34:02,13150.0,2,17308,-2,13145.0,5,13155.0,12,S
2018-04-16 13:34:03,13150.0,2,17310,0,13145.0,5,13155.0,9,S
2018-04-16 13:34:09,13145.0,2,17312,-2,13140.0,5,13145.0,7,S
2018-04-16 13:34:11,13140.0,2,17314,-2,13135.0,4,13145.0,5,S
2018-04-16 13:34:12,13135.0,4,17318,0,13135.0,1,13140.0,2,S
2018-04-16 13:34:13,13135.0,4,17322,-2,13130.0,1,13140.0,2,S
2018-04-16 13:34:14,13140.0,4,17326,2,13135.0,1,13145.0,7,B
2018-04-16 13:34:15,13135.0,2,17328,0,13135.0,2,13140.0,2,S
2018-04-16 13:34:20,13130.0,8,17336,0,13125.0,1,13135.0,6,S
2018-04-16 13:34:21,13135.0,6,17342,0,13130.0,3,13140.0,6,B
2018-04-16 13:34:22,13130.0,4,17346,2,13125.0,7,13140.0,7,S
2018-04-16 13:34:23,13135.0,16,17362,16,13135.0,2,13140.0,7,B
2018-04-16 13:34:24,13135.0,4,17366,4,13125.0,2,13140.0,6,B
2018-04-16 13:34:28,13125.0,2,17368,0,13130.0,2,13140.0,3,S
2018-04-16 13:34:29,13140.0,4,17372,2,13130.0,4,13140.0,1,B
2018-04-16 13:34:30,13140.0,2,17374,0,13140.0,5,13145.0,6,B
2018-04-16 13:34:31,13140.0,10,17384,-4,13135.0,4,13145.0,4,B
2018-04-16 13:34:34,13140.0,2,17386,0,13135.0,12,13145.0,5,B
2018-04-16 13:34:36,13145.0,6,17392,-2,13140.0,6,13150.0,12,B
2018-04-16 13:34:41,13145.0,2,17394,0,13140.0,8,13145.0,1,B
2018-04-16 13:34:42,13145.0,2,17396,0,13140.0,10,13150.0,12,B
2018-04-16 13:34:47,13150.0,2,17398,0,13145.0,2,13150.0,11,B
2018-04-16 13:34:47,13145.0,4,17402,2,13140.0,5,13150.0,11,S
2018-04-16 13:34:49,13145.0,2,17404,2,13140.0,6,13145.0,1,S
2018-04-16 13:34:55,13145.0,2,17406,2,13140.0,2,13150.0,25,S
2018-04-16 13:35:11,13145.0,2,17408,0,13140.0,3,13150.0,21,S
2018-04-16 13:35:13,13145.0,2,17410,0,13140.0,4,13150.0,21,S
2018-04-16 13:35:19,13145.0,2,17412,-2,13145.0,7,13150.0,21,S
2018-04-16 13:35:20,13150.0,2,17414,2,13145.0,6,13150.0,20,B
2018-04-16 13:35:24,13150.0,8,17422,2,13145.0,11,13150.0,15,B
2018-04-16 13:35:25,13150.0,30,17452,0,13150.0,27,13155.0,11,B
2018-04-16 13:35:25,13155.0,16,17468,6,13150.0,25,13160.0,4,B
2018-04-16 13:35:27,13160.0,2,17470,0,13160.0,3,13170.0,1,B
2018-04-16 13:35:28,13160.0,8,17478,0,13150.0,22,13165.0,2,B
2018-04-16 13:35:35,13160.0,2,17480,-2,13160.0,3,13165.0,3,B
2018-04-16 13:35:38,13165.0,2,17482,0,13160.0,13,13165.0,1,B
2018-04-16 13:35:41,13160.0,18,17500,-4,13160.0,2,13165.0,8,S
2018-04-16 13:35:42,13160.0,4,17504,2,13155.0,1,13165.0,10,S
2018-04-16 13:35:56,13165.0,2,17506,0,13165.0,1,13170.0,6,B
2018-04-16 13:35:57,13165.0,2,17508,-2,13160.0,7,13170.0,1,B
2018-04-16 13:35:58,13170.0,2,17510,2,13165.0,2,13175.0,10,B
2018-04-16 13:35:59,13175.0,4,17514,0,13165.0,2,13175.0,10,B
2018-04-16 13:35:59,13175.0,4,17518,-4,13170.0,3,13180.0,2,B
2018-04-16 13:36:04,13165.0,2,17520,2,13160.0,3,13170.0,2,S
2018-04-16 13:36:05,13165.0,2,17522,0,13160.0,2,13170.0,9,S
2018-04-16 13:36:08,13165.0,2,17524,0,13160.0,3,13165.0,3,S
2018-04-16 13:36:11,13160.0,6,17530,6,13155.0,4,13160.0,2,S
2018-04-16 13:36:12,13160.0,4,17534,4,13155.0,6,13170.0,9,S
2018-04-16 13:36:16,13160.0,2,17536,2,13155.0,2,13160.0,3,S
2018-04-16 13:36:17,13165.0,4,17540,0,13155.0,2,13165.0,4,B
2018-04-16 13:36:19,13160.0,2,17542,2,13155.0,2,13165.0,6,S
2018-04-16 13:36:22,13155.0,14,17556,2,13150.0,2,13155.0,4,S
2018-04-16 13:36:25,13155.0,6,17562,-4,13145.0,4,13155.0,6,S
2018-04-16 13:36:30,13145.0,2,17564,2,13145.0,5,13155.0,1,S
2018-04-16 13:36:31,13145.0,2,17566,2,13145.0,4,13155.0,2,S
2018-04-16 13:36:34,13150.0,2,17568,-2,13145.0,4,13150.0,4,B
2018-04-16 13:36:34,13150.0,6,17574,2,13145.0,6,13155.0,9,B
2018-04-16 13:36:36,13145.0,6,17580,0,13145.0,1,13155.0,10,S
2018-04-16 13:36:39,13140.0,4,17584,0,13140.0,2,13150.0,5,S
2018-04-16 13:36:47,13145.0,4,17588,2,13140.0,6,13155.0,4,B
2018-04-16 13:36:50,13140.0,2,17590,0,13140.0,4,13150.0,4,S
2018-04-16 13:36:52,13140.0,2,17592,-2,13140.0,3,13150.0,4,S
2018-04-16 13:36:54,13150.0,2,17594,0,13140.0,3,13150.0,4,B
2018-04-16 13:37:01,13140.0,6,17600,0,13135.0,2,13140.0,2,S
2018-04-16 13:37:01,13140.0,4,17604,-4,13140.0,1,13150.0,3,S
2018-04-16 13:37:08,13140.0,2,17606,0,13135.0,3,13140.0,1,S
2018-04-16 13:37:13,13140.0,2,17608,0,13135.0,4,13145.0,1,S
2018-04-16 13:37:14,13140.0,2,17610,0,13140.0,2,13145.0,1,S
2018-04-16 13:37:15,13145.0,2,17612,0,13145.0,1,13150.0,16,B
2018-04-16 13:37:16,13145.0,2,17614,-2,13140.0,6,13150.0,16,B
2018-04-16 13:37:21,13145.0,2,17616,2,13135.0,2,13145.0,1,B
2018-04-16 13:37:24,13145.0,2,17618,2,13140.0,10,13150.0,19,B
2018-04-16 13:37:33,13140.0,16,17634,0,13140.0,2,13145.0,2,S
2018-04-16 13:37:33,13140.0,4,17638,-2,13135.0,3,13140.0,7,S
2018-04-16 13:37:34,13140.0,2,17640,0,13135.0,1,13140.0,2,S
2018-04-16 13:37:38,13140.0,2,17642,0,13135.0,4,13145.0,1,S
2018-04-16 13:37:41,13145.0,2,17644,0,13135.0,2,13145.0,1,B
2018-04-16 13:38:00,13135.0,2,17646,2,13135.0,1,13140.0,12,S
2018-04-16 13:38:07,13145.0,24,17670,8,13140.0,3,13145.0,4,B
2018-04-16 13:38:13,13140.0,4,17674,2,13140.0,2,13150.0,1,S
2018-04-16 13:38:23,13150.0,2,17676,2,13145.0,6,13155.0,4,B
2018-04-16 13:38:31,13150.0,2,17678,2,13145.0,1,13150.0,2,B
2018-04-16 13:38:33,13150.0,2,17680,2,13145.0,1,13150.0,3,B
2018-04-16 13:38:40,13150.0,2,17682,0,13145.0,1,13150.0,2,B
2018-04-16 13:38:47,13145.0,2,17684,2,13140.0,3,13150.0,11,S
2018-04-16 13:39:00,13150.0,4,17688,2,13145.0,1,13150.0,8,B
2018-04-16 13:39:05,13150.0,2,17690,0,13140.0,3,13150.0,7,B
2018-04-16 13:39:10,13155.0,8,17698,2,13155.0,18,13160.0,26,B
2018-04-16 13:39:10,13160.0,88,17786,66,13140.0,4,13160.0,2,B
2018-04-16 13:39:12,13155.0,6,17792,6,13150.0,3,13155.0,4,S
2018-04-16 13:39:14,13155.0,2,17794,0,13145.0,3,13155.0,2,S
2018-04-16 13:39:16,13155.0,2,17796,2,13150.0,5,13155.0,2,S
2018-04-16 13:39:18,13155.0,4,17800,-2,13150.0,6,13160.0,2,S
2018-04-16 13:39:25,13155.0,2,17802,2,13150.0,6,13160.0,3,S
2018-04-16 13:39:26,13150.0,2,17804,0,13150.0,4,13155.0,7,S
2018-04-16 13:39:27,13155.0,4,17808,0,13150.0,3,13155.0,6,B
2018-04-16 13:39:28,13150.0,6,17814,4,13145.0,1,13150.0,3,S
2018-04-16 13:39:29,13150.0,2,17816,0,13145.0,1,13150.0,2,S
2018-04-16 13:39:31,13150.0,2,17818,2,13150.0,1,13155.0,5,S
2018-04-16 13:39:32,13150.0,2,17820,0,13145.0,1,13150.0,5,S
2018-04-16 13:39:37,13150.0,2,17822,2,13145.0,1,13150.0,5,S
2018-04-16 13:40:11,13150.0,10,17832,8,13150.0,3,13160.0,1,S
2018-04-16 13:40:18,13150.0,2,17834,0,13155.0,1,13160.0,1,S
2018-04-16 13:40:32,13160.0,4,17838,2,13155.0,4,13165.0,5,B
2018-04-16 13:40:33,13165.0,2,17840,-2,13155.0,4,13165.0,4,B
2018-04-16 13:40:38,13165.0,4,17844,0,13165.0,4,13170.0,2,B
2018-04-16 13:40:39,13165.0,8,17852,8,13160.0,1,13170.0,2,B
2018-04-16 13:40:46,13160.0,2,17854,2,13155.0,4,13165.0,11,S
2018-04-16 13:40:49,13165.0,4,17858,-4,13155.0,6,13165.0,9,B
2018-04-16 13:40:54,13160.0,10,17868,6,13150.0,6,13160.0,2,S
2018-04-16 13:40:56,13160.0,2,17870,2,13150.0,6,13160.0,1,S
2018-04-16 13:40:59,13155.0,2,17872,2,13150.0,7,13155.0,3,S
2018-04-16 13:41:14,13160.0,2,17874,2,13150.0,8,13160.0,7,B
2018-04-16 13:41:17,13150.0,2,17876,0,13150.0,7,13160.0,9,S
2018-04-16 13:41:19,13150.0,12,17888,12,13145.0,4,13155.0,2,S
2018-04-16 13:41:20,13155.0,2,17890,0,13150.0,6,13155.0,1,B
2018-04-16 13:41:31,13150.0,4,17894,-4,13145.0,1,13150.0,1,S
2018-04-16 13:41:34,13150.0,2,17896,-2,13145.0,1,13155.0,1,S
2018-04-16 13:41:38,13155.0,2,17898,2,13150.0,1,13155.0,2,B
2018-04-16 13:41:43,13150.0,2,17900,2,13145.0,4,13155.0,4,S
2018-04-16 13:41:44,13155.0,2,17902,2,13145.0,4,13155.0,3,B
2018-04-16 13:41:45,13155.0,4,17906,0,13145.0,4,13155.0,1,B
2018-04-16 13:41:48,13150.0,2,17908,2,13145.0,4,13155.0,1,S
2018-04-16 13:41:56,13155.0,4,17912,0,13150.0,5,13160.0,10,B
2018-04-16 13:42:04,13150.0,2,17914,0,13145.0,3,13150.0,6,S
2018-04-16 13:42:04,13140.0,8,17922,8,13140.0,4,13150.0,3,S
2018-04-16 13:42:09,13150.0,2,17924,-2,13140.0,2,13150.0,1,B
2018-04-16 13:42:11,13140.0,2,17926,0,13140.0,1,13150.0,1,S
2018-04-16 13:42:24,13145.0,4,17930,0,13145.0,5,13155.0,3,B
2018-04-16 13:42:25,13145.0,2,17932,-2,13145.0,4,13155.0,3,B
2018-04-16 13:42:26,13145.0,4,17936,0,13145.0,2,13155.0,3,B
2018-04-16 13:42:37,13155.0,4,17940,2,13140.0,2,13160.0,4,B
2018-04-16 13:42:44,13150.0,2,17942,2,13150.0,1,13160.0,8,S
2018-04-16 13:42:53,13160.0,8,17950,2,13160.0,2,13165.0,6,B
2018-04-16 13:43:00,13160.0,2,17952,-2,13160.0,10,13165.0,15,B
2018-04-16 13:43:01,13160.0,2,17954,-2,13160.0,9,13165.0,19,B
2018-04-16 13:43:05,13160.0,10,17964,-10,13160.0,4,13165.0,15,B
2018-04-16 13:43:05,13160.0,8,17972,0,13155.0,3,13160.0,1,B
2018-04-16 13:43:06,13160.0,6,17978,-6,13155.0,5,13165.0,15,B
2018-04-16 13:43:09,13155.0,2,17980,-2,13155.0,4,13165.0,8,S
2018-04-16 13:43:14,13160.0,4,17984,-2,13155.0,2,13165.0,14,B
2018-04-16 13:43:16,13165.0,2,17986,0,13155.0,2,13165.0,16,B
2018-04-16 13:43:50,13155.0,2,17988,-2,13155.0,2,13160.0,3,S
2018-04-16 13:43:51,13160.0,2,17990,2,13155.0,5,13160.0,2,B
2018-04-16 13:43:51,13160.0,2,17992,0,13155.0,5,13160.0,1,B
2018-04-16 13:43:52,13160.0,2,17994,0,13155.0,5,13165.0,13,B
2018-04-16 13:43:54,13165.0,2,17996,0,13155.0,5,13165.0,4,B
2018-04-16 13:43:58,13160.0,2,17998,0,13155.0,5,13160.0,2,S
2018-04-16 13:44:01,13160.0,4,18002,4,13160.0,8,13165.0,5,S
2018-04-16 13:44:05,13165.0,4,18006,-2,13160.0,8,13165.0,2,B
2018-04-16 13:44:06,13165.0,2,18008,0,13160.0,8,13165.0,1,B
2018-04-16 13:44:06,13165.0,2,18010,-2,13165.0,2,13170.0,6,B
2018-04-16 13:44:16,13170.0,4,18014,2,13170.0,1,13175.0,3,B
2018-04-16 13:44:20,13170.0,2,18016,2,13165.0,2,13175.0,16,B
2018-04-16 13:44:24,13175.0,10,18026,10,13165.0,1,13175.0,11,B
2018-04-16 13:44:31,13175.0,4,18030,0,13165.0,2,13175.0,12,B
2018-04-16 13:44:35,13165.0,2,18032,-2,13160.0,9,13165.0,1,S
2018-04-16 13:44:55,13160.0,4,18036,4,13160.0,7,13165.0,11,S
2018-04-16 13:44:55,13160.0,12,18048,2,13160.0,1,13165.0,6,S
2018-04-16 13:44:57,13160.0,2,18050,0,13160.0,1,13165.0,6,S
2018-04-16 13:44:59,13160.0,2,18052,2,13155.0,1,13165.0,6,S
2018-04-16 13:45:02,13155.0,2,18054,0,13150.0,12,13160.0,7,S
2018-04-16 13:45:10,13155.0,2,18056,0,13150.0,12,13160.0,11,S
2018-04-16 13:45:13,13160.0,2,18058,2,13150.0,12,13160.0,9,B
2018-04-16 13:45:15,13155.0,2,18060,0,13150.0,12,13160.0,9,S
2018-04-16 13:45:17,13150.0,20,18080,2,13150.0,3,13160.0,9,S
2018-04-16 13:45:18,13160.0,8,18088,0,13155.0,9,13165.0,8,B
2018-04-16 13:45:45,13160.0,2,18090,2,13155.0,7,13160.0,9,B
2018-04-16 13:45:49,13155.0,8,18098,0,13150.0,6,13155.0,1,S
2018-04-16 13:45:50,13150.0,6,18104,-6,13150.0,3,13155.0,1,S
2018-04-16 13:45:57,13155.0,2,18106,0,13155.0,10,13160.0,14,B
2018-04-16 13:46:01,13155.0,2,18108,0,13155.0,6,13160.0,11,B
2018-04-16 13:46:04,13160.0,2,18110,2,13155.0,6,13160.0,10,B
2018-04-16 13:46:09,13160.0,2,18112,2,13155.0,6,13160.0,9,B
2018-04-16 13:46:12,13160.0,8,18120,0,13155.0,6,13160.0,5,B
2018-04-16 13:46:13,13160.0,6,18126,2,13155.0,8,13160.0,2,B
2018-04-16 13:46:13,13160.0,4,18130,0,13155.0,8,13165.0,9,B
2018-04-16 13:46:19,13165.0,2,18132,2,13155.0,13,13165.0,6,B
2018-04-16 13:46:20,13165.0,2,18134,2,13155.0,13,13165.0,5,B
2018-04-16 13:46:22,13165.0,2,18136,2,13155.0,8,13165.0,4,B
2018-04-16 13:46:26,13165.0,2,18138,2,13155.0,3,13165.0,3,B
2018-04-16 13:46:31,13160.0,2,18140,2,13155.0,4,13165.0,3,S
2018-04-16 13:46:46,13165.0,2,18142,2,13160.0,4,13165.0,1,B
2018-04-16 13:46:53,13165.0,2,18144,2,13160.0,4,13170.0,3,B
2018-04-16 13:47:02,13160.0,2,18146,-2,13150.0,4,13165.0,9,S
2018-04-16 13:47:20,13155.0,40,18186,4,13150.0,4,13155.0,3,S
2018-04-16 13:47:21,13150.0,16,18202,-10,13150.0,4,13160.0,10,S
2018-04-16 13:47:21,13150.0,2,18204,-2,13155.0,5,13160.0,10,S
2018-04-16 13:47:22,13150.0,16,18220,-6,13155.0,1,13160.0,10,S
2018-04-16 13:47:23,13155.0,2,18222,0,13145.0,26,13155.0,13,B
2018-04-16 13:47:23,13155.0,4,18226,-2,13150.0,11,13155.0,11,B
2018-04-16 13:47:24,13150.0,18,18244,-6,13150.0,7,13155.0,9,S
2018-04-16 13:47:32,13155.0,10,18254,-10,13145.0,31,13155.0,16,B
2018-04-16 13:47:46,13155.0,16,18270,8,13150.0,14,13155.0,9,B
2018-04-16 13:47:48,13155.0,4,18274,0,13150.0,19,13155.0,7,B
2018-04-16 13:47:49,13155.0,4,18278,4,13150.0,19,13155.0,5,B
2018-04-16 13:47:50,13155.0,10,18288,8,13155.0,10,13160.0,14,B
2018-04-16 13:47:50,13160.0,8,18296,0,13155.0,3,13160.0,6,B
2018-04-16 13:47:51,13160.0,12,18308,0,13160.0,1,13170.0,4,B
2018-04-16 13:47:53,13170.0,10,18318,-8,13165.0,2,13175.0,3,B
2018-04-16 13:47:57,13165.0,14,18332,8,13160.0,3,13165.0,2,S
2018-04-16 13:47:58,13165.0,4,18336,0,13160.0,1,13170.0,10,S
2018-04-16 13:48:02,13165.0,4,18340,0,13160.0,5,13170.0,8,S
2018-04-16 13:48:11,13170.0,2,18342,0,13165.0,5,13175.0,4,B
2018-04-16 13:48:19,13175.0,4,18346,0,13165.0,5,13175.0,2,B
2018-04-16 13:48:27,13175.0,40,18386,18,13175.0,1,13180.0,32,B
2018-04-16 13:48:29,13175.0,2,18388,2,13165.0,5,13180.0,32,B
2018-04-16 13:48:36,13170.0,2,18390,2,13170.0,1,13175.0,11,S
2018-04-16 13:48:36,13170.0,2,18392,2,13165.0,4,13170.0,5,S
2018-04-16 13:48:37,13165.0,4,18396,0,13160.0,15,13170.0,4,S
2018-04-16 13:48:41,13160.0,2,18398,2,13160.0,12,13170.0,2,S
2018-04-16 13:48:44,13170.0,2,18400,0,13160.0,12,13170.0,1,B
2018-04-16 13:48:48,13165.0,2,18402,0,13160.0,12,13170.0,1,S
2018-04-16 13:48:52,13160.0,4,18406,4,13160.0,10,13170.0,2,S
2018-04-16 13:48:57,13160.0,4,18410,4,13160.0,7,13165.0,7,S
2018-04-16 13:49:03,13165.0,4,18414,4,13160.0,7,13165.0,15,B
2018-04-16 13:49:04,13165.0,10,18424,4,13160.0,9,13165.0,9,B
2018-04-16 13:49:05,13165.0,14,18438,8,13160.0,10,13165.0,2,B
2018-04-16 13:49:05,13170.0,6,18444,2,13165.0,2,13170.0,5,B
2018-04-16 13:49:07,13170.0,2,18446,0,13170.0,2,13175.0,4,B
2018-04-16 13:49:12,13175.0,2,18448,0,13165.0,10,13180.0,29,B
2018-04-16 13:49:16,13175.0,2,18450,0,13170.0,5,13180.0,33,B
2018-04-16 13:49:23,13175.0,10,18460,0,13170.0,5,13175.0,1,B
2018-04-16 13:49:27,13175.0,2,18462,0,13175.0,1,13180.0,29,B
2018-04-16 13:49:29,13175.0,2,18464,-2,13175.0,1,13180.0,29,B
2018-04-16 13:49:30,13175.0,2,18466,0,13165.0,1,13180.0,29,B
2018-04-16 13:49:38,13175.0,2,18468,0,13165.0,5,13180.0,30,B
2018-04-16 13:49:50,13175.0,4,18472,4,13170.0,6,13175.0,4,B
2018-04-16 13:49:51,13175.0,8,18480,6,13175.0,6,13180.0,35,B
2018-04-16 13:50:10,13180.0,20,18500,18,13175.0,8,13180.0,21,B
2018-04-16 13:50:11,13180.0,4,18504,0,13175.0,8,13180.0,19,B
2018-04-16 13:50:13,13180.0,2,18506,2,13175.0,8,13180.0,17,B
2018-04-16 13:50:13,13180.0,16,18522,2,13175.0,12,13180.0,9,B
2018-04-16 13:50:14,13180.0,2,18524,0,13175.0,12,13180.0,8,B
2018-04-16 13:50:14,13180.0,16,18540,4,13180.0,14,13185.0,4,B
2018-04-16 13:50:15,13190.0,6,18546,-6,13190.0,1,13195.0,2,B
2018-04-16 13:50:16,13195.0,6,18552,-4,13195.0,5,13200.0,2,B
2018-04-16 13:50:16,13190.0,12,18564,-4,13185.0,4,13195.0,6,S
2018-04-16 13:50:18,13195.0,8,18572,-6,13195.0,2,13200.0,7,B
2018-04-16 13:50:18,13195.0,4,18576,0,13195.0,2,13200.0,2,B
2018-04-16 13:50:19,13200.0,4,18580,-2,13200.0,1,13205.0,1,B
2018-04-16 13:50:19,13215.0,14,18594,-6,13200.0,1,13220.0,2,B
2018-04-16 13:50:20,13215.0,8,18602,-4,13200.0,1,13215.0,9,B
2018-04-16 13:50:20,13200.0,12,18614,-2,13195.0,2,13215.0,6,S
2018-04-16 13:50:22,13200.0,2,18616,-2,13200.0,6,13215.0,14,S
2018-04-16 13:50:27,13210.0,6,18622,-2,13200.0,6,13210.0,6,B
2018-04-16 13:50:29,13200.0,8,18630,0,13195.0,2,13205.0,4,S
2018-04-16 13:50:31,13200.0,8,18638,-6,13200.0,1,13205.0,8,S
2018-04-16 13:50:31,13200.0,2,18640,-2,13195.0,3,13205.0,7,S
2018-04-16 13:50:33,13195.0,2,18642,2,13195.0,2,13205.0,7,S
2018-04-16 13:50:34,13200.0,2,18644,-2,13195.0,2,13200.0,1,B
2018-04-16 13:50:38,13200.0,2,18646,2,13195.0,3,13200.0,1,B
2018-04-16 13:50:39,13200.0,2,18648,2,13195.0,3,13200.0,10,B
2018-04-16 13:50:41,13200.0,2,18650,0,13195.0,3,13200.0,9,B
2018-04-16 13:50:42,13195.0,2,18652,0,13195.0,3,13200.0,9,S
2018-04-16 13:50:49,13200.0,2,18654,0,13195.0,4,13200.0,8,B
2018-04-16 13:50:50,13200.0,10,18664,10,13195.0,4,13200.0,3,B
2018-04-16 13:50:51,13190.0,12,18676,8,13190.0,2,13200.0,3,S
2018-04-16 13:50:53,13200.0,6,18682,6,13200.0,3,13205.0,6,B
2018-04-16 13:50:54,13200.0,6,18688,2,13190.0,5,13200.0,1,B
2018-04-16 13:51:05,13195.0,2,18690,0,13190.0,2,13195.0,1,S
2018-04-16 13:51:05,13190.0,4,18694,4,13185.0,2,13195.0,4,S
2018-04-16 13:51:07,13185.0,6,18700,4,13180.0,5,13185.0,2,S
2018-04-16 13:51:08,13185.0,4,18704,0,13185.0,1,13195.0,12,S
2018-04-16 13:51:13,13185.0,2,18706,0,13180.0,5,13190.0,7,S
2018-04-16 13:51:14,13180.0,10,18716,4,13175.0,1,13190.0,7,S
2018-04-16 13:51:15,13175.0,2,18718,0,13175.0,2,13190.0,7,S
2018-04-16 13:51:16,13185.0,2,18720,0,13175.0,3,13185.0,1,B
2018-04-16 13:51:24,13190.0,4,18724,0,13185.0,12,13190.0,5,B
2018-04-16 13:51:26,13185.0,2,18726,0,13190.0,2,13195.0,9,S
2018-04-16 13:51:27,13190.0,2,18728,-2,13190.0,1,13195.0,7,B
2018-04-16 13:51:41,13190.0,6,18734,0,13190.0,3,13195.0,9,B
2018-04-16 13:51:43,13195.0,2,18736,0,13190.0,3,13195.0,8,B
2018-04-16 13:51:45,13195.0,10,18746,10,13190.0,4,13195.0,3,B
2018-04-16 13:51:45,13195.0,6,18752,-2,13190.0,5,13200.0,5,B
2018-04-16 13:51:51,13200.0,2,18754,0,13195.0,5,13200.0,2,B
2018-04-16 13:51:53,13200.0,2,18756,2,13195.0,5,13200.0,1,B
2018-04-16 13:51:59,13200.0,4,18760,0,13195.0,2,13200.0,12,B
2018-04-16 13:52:01,13195.0,4,18764,2,13190.0,3,13200.0,19,S
2018-04-16 13:52:02,13195.0,4,18768,0,13190.0,3,13195.0,7,S
2018-04-16 13:52:04,13190.0,4,18772,-2,13190.0,1,13195.0,12,S
2018-04-16 13:52:04,13190.0,2,18774,0,13185.0,11,13195.0,12,S
2018-04-16 13:52:08,13190.0,6,18780,0,13185.0,11,13190.0,17,S
2018-04-16 13:52:11,13190.0,4,18784,0,13185.0,12,13190.0,15,S
2018-04-16 13:52:14,13190.0,6,18790,2,13185.0,12,13190.0,12,S
2018-04-16 13:52:16,13190.0,4,18794,0,13185.0,12,13190.0,10,S
2018-04-16 13:52:19,13190.0,4,18798,0,13185.0,12,13190.0,8,S
2018-04-16 13:52:22,13190.0,4,18802,0,13185.0,12,13190.0,6,S
2018-04-16 13:52:24,13190.0,4,18806,0,13185.0,12,13190.0,4,S
2018-04-16 13:52:25,13185.0,2,18808,0,13185.0,11,13190.0,4,S
2018-04-16 13:52:26,13190.0,4,18812,4,13185.0,11,13190.0,2,B
2018-04-16 13:52:28,13190.0,4,18816,0,13190.0,1,13195.0,1,B
2018-04-16 13:52:29,13190.0,4,18820,0,13190.0,1,13195.0,9,B
2018-04-16 13:52:30,13190.0,2,18822,0,13185.0,11,13190.0,14,B
2018-04-16 13:52:30,13185.0,20,18842,-2,13185.0,1,13190.0,13,S
2018-04-16 13:52:31,13185.0,2,18844,0,13175.0,2,13190.0,13,S
2018-04-16 13:52:33,13190.0,4,18848,0,13180.0,2,13190.0,11,B
2018-04-16 13:52:39,13190.0,4,18852,-2,13180.0,11,13185.0,4,B
2018-04-16 13:52:41,13190.0,4,18856,-4,13180.0,11,13185.0,2,B
2018-04-16 13:52:42,13185.0,4,18860,0,13180.0,11,13190.0,3,S
2018-04-16 13:52:43,13185.0,4,18864,0,13180.0,11,13185.0,5,S
2018-04-16 13:52:46,13185.0,4,18868,0,13180.0,11,13185.0,3,S
2018-04-16 13:52:46,13185.0,2,18870,2,13180.0,11,13185.0,7,S
2018-04-16 13:52:48,13180.0,2,18872,2,13180.0,10,13185.0,2,S
2018-04-16 13:52:49,13185.0,4,18876,0,13180.0,10,13190.0,2,B
2018-04-16 13:52:52,13185.0,2,18878,0,13185.0,1,13190.0,7,B
2018-04-16 13:52:54,13185.0,2,18880,-2,13185.0,2,13190.0,9,B
2018-04-16 13:52:54,13185.0,2,18882,0,13185.0,1,13190.0,9,B
2018-04-16 13:52:55,13185.0,2,18884,0,13180.0,11,13185.0,3,B
2018-04-16 13:52:57,13185.0,4,18888,-2,13180.0,1,13185.0,5,B
2018-04-16 13:53:00,13185.0,4,18892,-4,13180.0,1,13185.0,3,B
2018-04-16 13:53:02,13185.0,4,18896,-4,13180.0,1,13185.0,1,B
2018-04-16 13:53:04,13185.0,4,18900,-2,13180.0,2,13185.0,9,B
2018-04-16 13:53:06,13185.0,4,18904,0,13180.0,2,13185.0,7,B
2018-04-16 13:53:07,13180.0,2,18906,2,13180.0,1,13185.0,7,S
2018-04-16 13:53:08,13180.0,2,18908,0,13180.0,4,13185.0,7,S
2018-04-16 13:53:09,13180.0,6,18914,-4,13175.0,3,13180.0,5,S
2018-04-16 13:53:10,13180.0,10,18924,-10,13180.0,4,13185.0,7,S
2018-04-16 13:53:15,13180.0,24,18948,-8,13180.0,2,13185.0,7,S
2018-04-16 13:53:17,13180.0,2,18950,0,13180.0,2,13185.0,7,S
2018-04-16 13:53:25,13180.0,4,18954,0,13180.0,1,13185.0,7,S
2018-04-16 13:53:39,13180.0,4,18958,0,13175.0,12,13185.0,8,S
2018-04-16 13:54:01,13180.0,4,18962,0,13170.0,4,13180.0,7,S
2018-04-16 13:54:03,13180.0,4,18966,0,13170.0,4,13180.0,5,S
2018-04-16 13:54:05,13180.0,4,18970,-2,13170.0,4,13180.0,13,S
2018-04-16 13:54:07,13180.0,4,18974,0,13170.0,6,13180.0,13,S
2018-04-16 13:54:08,13180.0,4,18978,0,13170.0,6,13180.0,14,S
2018-04-16 13:54:10,13180.0,6,18984,2,13170.0,6,13180.0,12,S
2018-04-16 13:54:13,13180.0,24,19008,-8,13180.0,1,13185.0,11,S
2018-04-16 13:54:14,13180.0,2,19010,0,13170.0,6,13180.0,1,S
2018-04-16 13:54:23,13175.0,2,19012,0,13175.0,1,13180.0,3,S
2018-04-16 13:54:23,13175.0,2,19014,-2,13170.0,4,13180.0,3,S
2018-04-16 13:54:25,13175.0,2,19016,2,13170.0,4,13180.0,2,S
2018-04-16 13:54:30,13175.0,4,19020,-4,13170.0,4,13180.0,12,S
2018-04-16 13:54:37,13175.0,4,19024,-4,13170.0,4,13180.0,11,S
2018-04-16 13:54:42,13175.0,4,19028,-2,13170.0,4,13175.0,1,S
2018-04-16 13:54:44,13175.0,4,19032,-4,13170.0,4,13175.0,3,S
2018-04-16 13:54:46,13175.0,4,19036,-4,13170.0,4,13175.0,1,S
2018-04-16 13:54:47,13175.0,2,19038,-2,13175.0,1,13180.0,12,S
2018-04-16 13:54:48,13175.0,2,19040,-2,13170.0,4,13175.0,5,S
2018-04-16 13:54:49,13175.0,4,19044,-4,13170.0,4,13175.0,3,S
2018-04-16 13:54:51,13175.0,4,19048,-4,13170.0,4,13175.0,3,S
2018-04-16 13:54:53,13175.0,4,19052,-2,13170.0,4,13175.0,1,S
2018-04-16 13:54:55,13175.0,2,19054,0,13175.0,1,13180.0,12,S
2018-04-16 13:54:56,13175.0,2,19056,0,13170.0,4,13175.0,1,S
2018-04-16 13:54:57,13175.0,4,19060,-2,13175.0,1,13180.0,10,S
2018-04-16 13:55:02,13180.0,4,19064,0,13175.0,5,13180.0,8,B
2018-04-16 13:55:05,13180.0,4,19068,0,13175.0,5,13180.0,6,B
2018-04-16 13:55:07,13180.0,4,19072,0,13175.0,5,13180.0,4,B
2018-04-16 13:55:08,13180.0,8,19080,0,13180.0,1,13185.0,16,B
2018-04-16 13:55:14,13180.0,2,19082,0,13180.0,4,13185.0,12,B
2018-04-16 13:55:15,13180.0,8,19090,0,13175.0,6,13180.0,1,B
2018-04-16 13:55:15,13180.0,2,19092,0,13180.0,4,13185.0,12,B
2018-04-16 13:55:31,13185.0,2,19094,0,13175.0,6,13185.0,14,B
2018-04-16 13:55:36,13175.0,4,19098,-4,13175.0,4,13180.0,3,S
2018-04-16 13:55:36,13175.0,8,19106,-8,13170.0,3,13180.0,3,S
2018-04-16 13:55:37,13170.0,4,19110,0,13170.0,1,13175.0,2,S
2018-04-16 13:55:41,13170.0,4,19114,0,13170.0,3,13180.0,4,S
2018-04-16 13:55:41,13170.0,2,19116,0,13170.0,2,13180.0,4,S
2018-04-16 13:55:46,13170.0,2,19118,-2,13170.0,1,13180.0,6,S
2018-04-16 13:56:03,13175.0,2,19120,2,13170.0,2,13180.0,6,B
2018-04-16 13:56:12,13170.0,6,19126,4,13170.0,2,13175.0,2,S
2018-04-16 13:56:37,13175.0,2,19128,2,13170.0,8,13175.0,1,B
2018-04-16 13:57:03,13175.0,2,19130,0,13170.0,8,13180.0,1,B
2018-04-16 13:57:04,13175.0,2,19132,0,13175.0,5,13180.0,3,B
2018-04-16 13:57:06,13175.0,2,19134,0,13175.0,4,13180.0,4,B
2018-04-16 13:57:09,13175.0,2,19136,2,13175.0,8,13180.0,2,B
2018-04-16 13:57:12,13180.0,4,19140,-4,13175.0,5,13185.0,12,B
2018-04-16 13:57:15,13180.0,4,19144,0,13170.0,6,13180.0,3,B
2018-04-16 13:57:16,13180.0,4,19148,0,13175.0,5,13180.0,3,B
2018-04-16 13:57:18,13180.0,4,19152,0,13175.0,5,13185.0,11,B
2018-04-16 13:57:19,13175.0,2,19154,0,13175.0,4,13185.0,13,S
2018-04-16 13:57:43,13185.0,8,19162,0,13175.0,16,13185.0,8,B
2018-04-16 13:57:46,13180.0,2,19164,0,13180.0,1,13185.0,10,S
2018-04-16 13:57:47,13180.0,2,19166,0,13175.0,8,13185.0,10,S
2018-04-16 13:57:49,13185.0,14,19180,-2,13180.0,12,13185.0,1,B
2018-04-16 13:57:50,13185.0,2,19182,-2,13185.0,1,13190.0,7,B
2018-04-16 13:57:53,13190.0,8,19190,4,13185.0,2,13195.0,3,B
2018-04-16 13:58:00,13190.0,4,19194,0,13185.0,6,13190.0,3,B
2018-04-16 13:58:02,13190.0,4,19198,0,13185.0,8,13190.0,1,B
2018-04-16 13:58:02,13190.0,2,19200,0,13185.0,8,13195.0,2,B
2018-04-16 13:58:04,13195.0,4,19204,0,13185.0,8,13200.0,14,B
2018-04-16 13:58:08,13195.0,4,19208,-2,13190.0,1,13200.0,13,B
2018-04-16 13:58:15,13195.0,4,19212,-4,13190.0,1,13200.0,16,B
2018-04-16 13:58:17,13200.0,4,19216,4,13190.0,1,13200.0,15,B
2018-04-16 13:58:17,13200.0,4,19220,0,13190.0,1,13200.0,14,B
2018-04-16 13:58:19,13200.0,4,19224,0,13190.0,1,13200.0,12,B
2018-04-16 13:58:19,13200.0,10,19234,0,13190.0,1,13200.0,7,B
2018-04-16 13:58:20,13200.0,4,19238,0,13190.0,1,13200.0,6,B
2018-04-16 13:58:22,13200.0,4,19242,0,13190.0,1,13200.0,4,B
2018-04-16 13:58:24,13200.0,4,19246,0,13190.0,1,13200.0,2,B
2018-04-16 13:58:30,13200.0,2,19248,0,13195.0,6,13200.0,2,B
2018-04-16 13:58:31,13195.0,2,19250,-2,13195.0,7,13200.0,2,S
2018-04-16 13:58:33,13195.0,2,19252,-2,13195.0,8,13200.0,2,S
2018-04-16 13:58:33,13195.0,2,19254,-2,13195.0,7,13200.0,2,S
2018-04-16 13:58:37,13195.0,2,19256,-2,13195.0,6,13200.0,9,S
2018-04-16 13:58:39,13200.0,2,19258,0,13195.0,6,13200.0,8,B
2018-04-16 13:58:41,13200.0,4,19262,0,13195.0,6,13200.0,8,B
2018-04-16 13:58:44,13200.0,4,19266,0,13195.0,6,13200.0,6,B
2018-04-16 13:58:46,13200.0,4,19270,0,13195.0,6,13200.0,4,B
2018-04-16 13:58:49,13200.0,4,19274,-4,13195.0,6,13200.0,2,B
2018-04-16 13:58:51,13200.0,2,19276,0,13195.0,8,13200.0,1,B
2018-04-16 13:58:51,13200.0,2,19278,2,13200.0,2,13205.0,6,B
2018-04-16 13:58:53,13200.0,2,19280,-2,13200.0,1,13205.0,2,B
2018-04-16 13:58:54,13200.0,2,19282,-2,13195.0,9,13205.0,2,B
2018-04-16 13:58:57,13205.0,4,19286,0,13200.0,9,13210.0,2,B
2018-04-16 13:58:59,13205.0,2,19288,2,13205.0,4,13210.0,1,B
2018-04-16 13:59:01,13205.0,6,19294,2,13205.0,2,13210.0,13,B
2018-04-16 13:59:02,13200.0,8,19302,-2,13200.0,4,13205.0,2,S
2018-04-16 13:59:03,13205.0,2,19304,0,13205.0,4,13210.0,11,B
2018-04-16 13:59:04,13205.0,4,19308,-2,13205.0,2,13210.0,14,B
2018-04-16 13:59:05,13210.0,2,19310,-2,13205.0,6,13210.0,3,B
2018-04-16 13:59:11,13205.0,4,19314,0,13205.0,1,13210.0,11,S
2018-04-16 13:59:13,13210.0,4,19318,0,13205.0,1,13210.0,11,B
2018-04-16 13:59:14,13205.0,2,19320,0,13200.0,3,13210.0,11,S
2018-04-16 13:59:16,13210.0,4,19324,-2,13200.0,1,13210.0,9,B
2018-04-16 13:59:17,13210.0,4,19328,-4,13200.0,1,13210.0,10,B
2018-04-16 13:59:19,13205.0,2,19330,-2,13200.0,1,13205.0,1,S
2018-04-16 13:59:19,13210.0,4,19334,-2,13200.0,1,13210.0,6,B
2018-04-16 13:59:22,13210.0,4,19338,0,13205.0,1,13210.0,5,B
2018-04-16 13:59:23,13210.0,4,19342,-2,13205.0,1,13210.0,3,B
2018-04-16 13:59:25,13205.0,2,19344,0,13200.0,1,13205.0,5,S
2018-04-16 13:59:25,13205.0,4,19348,-2,13200.0,1,13205.0,8,S
2018-04-16 13:59:26,13200.0,2,19350,0,13195.0,10,13205.0,8,S
2018-04-16 13:59:26,13200.0,2,19352,-2,13195.0,12,13205.0,3,S
2018-04-16 13:59:27,13205.0,4,19356,-2,13195.0,12,13205.0,1,B
2018-04-16 13:59:29,13205.0,2,19358,0,13195.0,9,13205.0,5,B
2018-04-16 13:59:30,13195.0,4,19362,0,13195.0,7,13205.0,5,S
2018-04-16 13:59:31,13195.0,4,19366,0,13195.0,3,13200.0,4,S
2018-04-16 13:59:31,13195.0,6,19372,-4,13190.0,6,13195.0,1,S
2018-04-16 13:59:32,13195.0,2,19374,-2,13190.0,4,13200.0,3,S
2018-04-16 13:59:34,13200.0,4,19378,-4,13190.0,5,13200.0,4,B
2018-04-16 13:59:36,13195.0,2,19380,0,13190.0,5,13200.0,1,S
2018-04-16 13:59:37,13200.0,12,19392,2,13190.0,1,13200.0,2,B
2018-04-16 13:59:38,13195.0,2,19394,0,13190.0,2,13200.0,2,S
2018-04-16 13:59:40,13200.0,4,19398,-2,13190.0,2,13200.0,3,B
2018-04-16 13:59:45,13195.0,4,19402,0,13195.0,2,13200.0,3,S
2018-04-16 13:59:46,13200.0,4,19406,0,13195.0,3,13200.0,2,B
2018-04-16 13:59:47,13195.0,2,19408,0,13195.0,2,13200.0,3,S
2018-04-16 13:59:48,13200.0,4,19412,0,13195.0,2,13200.0,1,B
2018-04-16 13:59:49,13200.0,2,19414,0,13200.0,1,13205.0,7,B
2018-04-16 13:59:50,13200.0,2,19416,0,13195.0,2,13200.0,3,B
2018-04-16 13:59:51,13200.0,4,19420,2,13195.0,4,13200.0,3,B
2018-04-16 13:59:51,13200.0,4,19424,-2,13195.0,5,13200.0,1,B
2018-04-16 13:59:54,13200.0,2,19426,0,13200.0,1,13205.0,5,B
2018-04-16 13:59:56,13205.0,8,19434,8,13205.0,1,13210.0,5,B
2018-04-16 13:59:56,13205.0,2,19436,0,13200.0,3,13205.0,3,B
2018-04-16 13:59:57,13200.0,2,19438,-2,13200.0,3,13205.0,2,S
2018-04-16 14:00:01,13205.0,4,19442,-2,13200.0,5,13205.0,6,B
2018-04-16 14:00:01,13200.0,4,19446,0,13200.0,3,13205.0,8,S
2018-04-16 14:00:02,13200.0,6,19452,-6,13190.0,4,13200.0,7,S
2018-04-16 14:00:02,13190.0,4,19456,0,13190.0,5,13200.0,5,S
2018-04-16 14:00:03,13200.0,4,19460,-4,13195.0,13,13200.0,2,B
2018-04-16 14:00:04,13200.0,4,19464,-4,13195.0,13,13205.0,6,B
2018-04-16 14:00:07,13205.0,4,19468,-2,13200.0,1,13210.0,6,B
2018-04-16 14:00:10,13205.0,4,19472,0,13200.0,1,13205.0,8,B
2018-04-16 14:00:12,13205.0,6,19478,0,13195.0,3,13205.0,6,B
2018-04-16 14:00:14,13205.0,2,19480,0,13205.0,1,13210.0,6,B
2018-04-16 14:00:15,13205.0,2,19482,0,13190.0,5,13205.0,16,B
2018-04-16 14:00:17,13205.0,4,19486,0,13190.0,5,13205.0,2,B
2018-04-16 14:00:19,13205.0,4,19490,0,13190.0,5,13200.0,1,B
2018-04-16 14:00:21,13200.0,2,19492,0,13200.0,1,13205.0,5,S
2018-04-16 14:00:21,13200.0,2,19494,-2,13190.0,6,13200.0,1,S
2018-04-16 14:00:23,13200.0,2,19496,0,13200.0,1,13205.0,4,S
2018-04-16 14:00:23,13200.0,2,19498,-2,13190.0,6,13200.0,1,S
2018-04-16 14:00:26,13200.0,2,19500,-2,13200.0,1,13205.0,1,S
2018-04-16 14:00:27,13200.0,2,19502,0,13195.0,3,13205.0,1,S
2018-04-16 14:00:28,13200.0,2,19504,0,13200.0,2,13205.0,1,S
2018-04-16 14:00:29,13200.0,4,19508,-2,13195.0,4,13205.0,1,S
2018-04-16 14:00:30,13205.0,2,19510,2,13200.0,18,13210.0,7,B
2018-04-16 14:00:37,13205.0,2,19512,0,13205.0,3,13210.0,9,B
2018-04-16 14:00:37,13205.0,2,19514,0,13205.0,2,13210.0,12,B
2018-04-16 14:00:38,13205.0,4,19518,0,13205.0,2,13210.0,12,B
2018-04-16 14:00:39,13205.0,2,19520,0,13205.0,1,13210.0,12,B
2018-04-16 14:00:39,13205.0,2,19522,0,13200.0,3,13210.0,12,B
2018-04-16 14:00:45,13200.0,2,19524,0,13200.0,2,13205.0,1,S
2018-04-16 14:00:47,13205.0,2,19526,2,13205.0,4,13210.0,8,B
2018-04-16 14:00:47,13205.0,2,19528,2,13205.0,3,13210.0,12,B
2018-04-16 14:00:48,13205.0,2,19530,2,13205.0,2,13210.0,12,B
2018-04-16 14:00:48,13205.0,2,19532,2,13205.0,1,13210.0,12,B
2018-04-16 14:00:49,13205.0,2,19534,2,13200.0,1,13210.0,12,B
2018-04-16 14:01:10,13200.0,2,19536,0,13195.0,5,13200.0,1,S
2018-04-16 14:01:10,13200.0,2,19538,2,13195.0,3,13205.0,10,S
2018-04-16 14:01:15,13200.0,2,19540,0,13200.0,3,13205.0,10,S
2018-04-16 14:01:26,13205.0,2,19542,-2,13205.0,1,13210.0,2,B
2018-04-16 14:01:29,13205.0,10,19552,-10,13200.0,9,13205.0,5,B
2018-04-16 14:01:32,13205.0,4,19556,-4,13200.0,9,13205.0,3,B
2018-04-16 14:01:37,13205.0,2,19558,-2,13200.0,9,13205.0,4,B
2018-04-16 14:01:38,13205.0,8,19566,-2,13205.0,4,13210.0,3,B
2018-04-16 14:01:42,13210.0,4,19570,0,13205.0,8,13210.0,1,B
2018-04-16 14:01:43,13210.0,2,19572,0,13210.0,3,13215.0,4,B
2018-04-16 14:01:56,13210.0,2,19574,0,13210.0,2,13220.0,3,B
2018-04-16 14:01:57,13210.0,4,19578,-2,13205.0,5,13220.0,8,B
2018-04-16 14:02:03,13210.0,4,19582,0,13205.0,5,13210.0,8,B
2018-04-16 14:02:07,13210.0,2,19584,-2,13205.0,3,13210.0,8,B
2018-04-16 14:02:08,13210.0,8,19592,0,13205.0,3,13210.0,4,B
2018-04-16 14:02:08,13210.0,8,19600,-6,13210.0,7,13220.0,3,B
2018-04-16 14:02:13,13220.0,6,19606,0,13220.0,2,13225.0,4,B
2018-04-16 14:02:14,13225.0,8,19614,2,13210.0,3,13225.0,4,B
2018-04-16 14:02:14,13225.0,10,19624,-6,13225.0,5,13230.0,3,B
2018-04-16 14:02:15,13225.0,10,19634,-10,13215.0,5,13230.0,1,B
2018-04-16 14:02:16,13220.0,2,19636,0,13220.0,5,13230.0,8,S
2018-04-16 14:02:17,13230.0,2,19638,2,13220.0,12,13230.0,6,B
2018-04-16 14:02:18,13230.0,2,19640,2,13230.0,1,13235.0,3,B
2018-04-16 14:02:18,13220.0,8,19648,8,13220.0,1,13230.0,23,S
2018-04-16 14:02:23,13230.0,2,19650,0,13220.0,5,13230.0,19,B
2018-04-16 14:02:26,13225.0,2,19652,-2,13225.0,4,13230.0,14,S
2018-04-16 14:02:29,13225.0,6,19658,0,13225.0,1,13230.0,13,S
2018-04-16 14:02:29,13225.0,2,19660,-2,13220.0,11,13225.0,2,S
2018-04-16 14:02:30,13225.0,4,19664,-4,13220.0,11,13230.0,13,S
2018-04-16 14:02:34,13220.0,2,19666,2,13220.0,11,13230.0,21,S
2018-04-16 14:02:42,13225.0,2,19668,2,13220.0,15,13230.0,19,B
2018-04-16 14:02:44,13220.0,14,19682,4,13220.0,9,13225.0,2,S
2018-04-16 14:02:46,13225.0,2,19684,2,13220.0,9,13225.0,9,B
2018-04-16 14:02:47,13220.0,2,19686,2,13220.0,8,13225.0,9,S
2018-04-16 14:02:48,13220.0,2,19688,0,13220.0,7,13225.0,9,S
2018-04-16 14:02:54,13220.0,4,19692,4,13220.0,5,13225.0,6,S
2018-04-16 14:02:55,13220.0,4,19696,0,13220.0,3,13225.0,6,S
2018-04-16 14:02:55,13220.0,2,19698,0,13220.0,2,13225.0,6,S
2018-04-16 14:02:57,13220.0,2,19700,-2,13220.0,1,13225.0,17,S
2018-04-16 14:03:01,13220.0,2,19702,2,13215.0,6,13220.0,3,S
2018-04-16 14:03:01,13220.0,4,19706,0,13215.0,8,13220.0,1,S
2018-04-16 14:03:03,13215.0,4,19710,2,13215.0,4,13220.0,1,S
2018-04-16 14:03:04,13215.0,4,19714,4,13215.0,2,13220.0,1,S
2018-04-16 14:03:04,13215.0,2,19716,2,13215.0,1,13220.0,1,S
2018-04-16 14:03:07,13220.0,10,19726,0,13215.0,1,13225.0,17,B
2018-04-16 14:03:13,13220.0,4,19730,-4,13220.0,4,13225.0,12,B
2018-04-16 14:03:13,13220.0,6,19736,0,13220.0,1,13225.0,13,B
2018-04-16 14:03:14,13220.0,2,19738,-2,13210.0,1,13215.0,2,B
2018-04-16 14:03:14,13215.0,6,19744,0,13215.0,1,13220.0,10,S
2018-04-16 14:03:18,13210.0,2,19746,0,13210.0,4,13220.0,13,S
2018-04-16 14:03:23,13215.0,2,19748,2,13210.0,3,13215.0,1,B
2018-04-16 14:03:37,13205.0,2,19750,0,13205.0,2,13215.0,3,S
2018-04-16 14:03:40,13205.0,2,19752,0,13200.0,10,13205.0,1,S
2018-04-16 14:03:41,13205.0,4,19756,0,13205.0,1,13215.0,3,S
2018-04-16 14:03:43,13205.0,2,19758,0,13200.0,13,13210.0,11,S
2018-04-16 14:03:47,13210.0,2,19760,2,13205.0,9,13215.0,5,B
2018-04-16 14:03:55,13210.0,2,19762,0,13210.0,2,13215.0,2,B
2018-04-16 14:04:53,13210.0,2,19764,-2,13205.0,1,13210.0,3,B
2018-04-16 14:05:01,13210.0,2,19766,0,13205.0,1,13210.0,1,B
2018-04-16 14:05:02,13210.0,2,19768,-2,13205.0,5,13215.0,3,B
2018-04-16 14:05:24,13205.0,2,19770,0,13200.0,5,13215.0,10,S
2018-04-16 14:05:31,13200.0,10,19780,2,13200.0,1,13205.0,2,S
2018-04-16 14:05:54,13200.0,2,19782,0,13195.0,9,13200.0,2,S
2018-04-16 14:06:01,13195.0,2,19784,2,13195.0,9,13200.0,3,S
2018-04-16 14:06:06,13195.0,2,19786,2,13195.0,8,13200.0,5,S
2018-04-16 14:06:12,13200.0,8,19794,0,13195.0,8,13200.0,3,B
2018-04-16 14:06:15,13195.0,10,19804,8,13190.0,3,13195.0,1,S
2018-04-16 14:06:29,13190.0,6,19810,0,13190.0,1,13195.0,3,S
2018-04-16 14:06:30,13190.0,2,19812,2,13185.0,10,13190.0,2,S
2018-04-16 14:06:30,13190.0,4,19816,0,13185.0,7,13195.0,2,S
2018-04-16 14:06:37,13185.0,2,19818,0,13185.0,17,13195.0,2,S
2018-04-16 14:06:39,13190.0,2,19820,-2,13190.0,1,13195.0,2,B
2018-04-16 14:06:44,13190.0,4,19824,2,13185.0,18,13195.0,3,B
2018-04-16 14:06:50,13195.0,6,19830,-2,13190.0,10,13200.0,10,B
2018-04-16 14:06:51,13195.0,2,19832,0,13190.0,17,13200.0,10,B
2018-04-16 14:06:55,13190.0,2,19834,2,13190.0,18,13200.0,6,S
2018-04-16 14:06:58,13190.0,2,19836,2,13190.0,3,13195.0,5,S
2018-04-16 14:07:09,13190.0,4,19840,2,13190.0,1,13195.0,3,S
2018-04-16 14:07:48,13190.0,6,19846,2,13185.0,13,13195.0,4,S
2018-04-16 14:07:49,13185.0,4,19850,0,13185.0,5,13190.0,2,S
2018-04-16 14:07:53,13185.0,2,19852,0,13185.0,4,13190.0,3,S
2018-04-16 14:07:54,13185.0,8,19860,2,13180.0,6,13190.0,2,S
2018-04-16 14:07:56,13190.0,4,19864,0,13180.0,4,13195.0,5,B
2018-04-16 14:07:56,13180.0,8,19872,-8,13175.0,7,13180.0,1,S
2018-04-16 14:07:57,13180.0,4,19876,-2,13180.0,4,13195.0,6,S
2018-04-16 14:08:04,13185.0,2,19878,0,13180.0,2,13195.0,6,B
2018-04-16 14:08:05,13190.0,2,19880,0,13185.0,2,13190.0,5,B
2018-04-16 14:08:06,13190.0,2,19882,2,13185.0,4,13190.0,4,B
2018-04-16 14:08:09,13190.0,8,19890,0,13185.0,11,13195.0,3,B
2018-04-16 14:08:11,13185.0,6,19896,0,13185.0,8,13190.0,1,S
2018-04-16 14:08:12,13190.0,2,19898,2,13185.0,8,13200.0,9,B
2018-04-16 14:08:47,13185.0,4,19902,4,13185.0,7,13195.0,10,S
2018-04-16 14:09:05,13195.0,2,19904,2,13185.0,1,13195.0,9,B
2018-04-16 14:09:31,13190.0,2,19906,0,13185.0,4,13190.0,1,S
2018-04-16 14:09:35,13190.0,2,19908,-2,13185.0,4,13200.0,10,S
2018-04-16 14:10:11,13185.0,2,19910,2,13185.0,9,13190.0,1,S
2018-04-16 14:10:16,13190.0,2,19912,0,13185.0,9,13200.0,6,B
2018-04-16 14:10:25,13190.0,2,19914,0,13185.0,9,13195.0,9,B
2018-04-16 14:10:28,13195.0,2,19916,2,13185.0,9,13195.0,8,B
2018-04-16 14:10:30,13195.0,14,19930,6,13190.0,7,13200.0,5,B
2018-04-16 14:10:30,13200.0,2,19932,2,13195.0,15,13205.0,2,B
2018-04-16 14:10:57,13200.0,2,19934,2,13195.0,5,13205.0,5,B
2018-04-16 14:11:00,13205.0,2,19936,0,13200.0,2,13205.0,4,B
2018-04-16 14:11:11,13205.0,6,19942,0,13200.0,2,13205.0,2,B
2018-04-16 14:11:15,13200.0,2,19944,0,13200.0,1,13205.0,1,S
2018-04-16 14:11:19,13200.0,2,19946,0,13200.0,3,13205.0,2,S
2018-04-16 14:11:20,13200.0,2,19948,-2,13195.0,2,13205.0,4,S
2018-04-16 14:11:39,13200.0,2,19950,0,13195.0,6,13205.0,4,S
2018-04-16 14:11:47,13195.0,2,19952,-2,13190.0,5,13200.0,2,S
2018-04-16 14:11:48,13200.0,2,19954,-2,13185.0,3,13195.0,3,B
2018-04-16 14:11:56,13195.0,4,19958,0,13195.0,1,13200.0,3,S
2018-04-16 14:11:58,13195.0,2,19960,-2,13190.0,9,13200.0,6,S
2018-04-16 14:12:04,13195.0,2,19962,2,13195.0,2,13200.0,1,S
2018-04-16 14:13:11,13200.0,4,19966,0,13200.0,18,13205.0,6,B
2018-04-16 14:13:15,13205.0,6,19972,-4,13200.0,18,13210.0,4,B
2018-04-16 14:13:27,13210.0,2,19974,0,13205.0,7,13215.0,8,B
2018-04-16 14:13:42,13215.0,4,19978,0,13205.0,5,13215.0,3,B
2018-04-16 14:13:51,13205.0,4,19982,2,13205.0,4,13215.0,4,S
2018-04-16 14:13:52,13205.0,4,19986,0,13205.0,2,13210.0,1,S
2018-04-16 14:14:42,13210.0,2,19988,-2,13205.0,2,13210.0,2,B
2018-04-16 14:15:13,13205.0,6,19994,-4,13205.0,7,13210.0,5,S
2018-04-16 14:15:14,13205.0,2,19996,-2,13200.0,19,13210.0,7,S
2018-04-16 14:15:45,13200.0,4,20000,0,13200.0,17,13205.0,13,S
2018-04-16 14:15:46,13200.0,8,20008,0,13200.0,13,13205.0,13,S
2018-04-16 14:15:47,13200.0,6,20014,-2,13200.0,10,13205.0,13,S
2018-04-16 14:15:48,13200.0,4,20018,0,13200.0,8,13205.0,13,S
2018-04-16 14:15:49,13200.0,4,20022,0,13200.0,6,13205.0,13,S
2018-04-16 14:15:49,13200.0,2,20024,0,13200.0,5,13205.0,13,S
2018-04-16 14:15:51,13200.0,2,20026,-2,13200.0,4,13205.0,13,S
2018-04-16 14:15:52,13200.0,8,20034,2,13195.0,2,13205.0,13,S
2018-04-16 14:16:43,13200.0,4,20038,4,13195.0,12,13200.0,2,S
2018-04-16 14:16:44,13200.0,2,20040,0,13195.0,12,13200.0,1,S
2018-04-16 14:16:44,13200.0,2,20042,0,13200.0,2,13205.0,2,S
2018-04-16 14:16:46,13200.0,2,20044,0,13200.0,1,13205.0,2,S
2018-04-16 14:16:52,13200.0,2,20046,0,13195.0,2,13205.0,3,S
2018-04-16 14:16:52,13195.0,2,20048,2,13195.0,1,13205.0,3,S
2018-04-16 14:17:05,13205.0,2,20050,-2,13195.0,1,13205.0,2,B
2018-04-16 14:18:15,13200.0,2,20052,-2,13195.0,8,13205.0,5,S
2018-04-16 14:18:17,13200.0,4,20056,4,13200.0,11,13205.0,4,S
2018-04-16 14:18:18,13205.0,6,20062,0,13200.0,16,13205.0,1,B
2018-04-16 14:18:18,13205.0,2,20064,-2,13200.0,16,13210.0,4,B
2018-04-16 14:19:05,13205.0,2,20066,0,13195.0,2,13200.0,1,B
2018-04-16 14:19:06,13200.0,4,20070,2,13195.0,1,13205.0,1,S
2018-04-16 14:19:23,13195.0,2,20072,-2,13195.0,8,13205.0,8,S
2018-04-16 14:19:31,13200.0,2,20074,0,13195.0,8,13205.0,2,B
2018-04-16 14:20:07,13195.0,4,20078,0,13195.0,6,13200.0,1,S
2018-04-16 14:20:09,13195.0,2,20080,-2,13195.0,5,13200.0,1,S
2018-04-16 14:20:13,13200.0,2,20082,-2,13195.0,7,13205.0,2,B
2018-04-16 14:20:31,13195.0,6,20088,-4,13195.0,5,13200.0,2,S
2018-04-16 14:20:41,13200.0,2,20090,2,13195.0,5,13200.0,2,B
2018-04-16 14:20:43,13195.0,2,20092,0,13195.0,4,13200.0,2,S
2018-04-16 14:20:49,13200.0,4,20096,4,13200.0,4,13205.0,2,B
2018-04-16 14:20:51,13205.0,2,20098,-2,13205.0,5,13210.0,6,B
2018-04-16 14:21:15,13205.0,2,20100,0,13200.0,5,13205.0,2,B
2018-04-16 14:21:19,13200.0,2,20102,-2,13195.0,10,13205.0,10,S
2018-04-16 14:21:25,13200.0,2,20104,0,13200.0,2,13205.0,2,S
2018-04-16 14:21:29,13205.0,2,20106,-2,13200.0,2,13205.0,7,B
2018-04-16 14:22:13,13205.0,2,20108,2,13200.0,8,13205.0,5,B
2018-04-16 14:22:14,13205.0,4,20112,4,13200.0,8,13205.0,3,B
2018-04-16 14:22:17,13205.0,6,20118,6,13205.0,1,13210.0,8,B
2018-04-16 14:22:18,13210.0,6,20124,-2,13205.0,5,13210.0,1,B
2018-04-16 14:22:18,13210.0,2,20126,0,13210.0,1,13215.0,6,B
2018-04-16 14:22:35,13215.0,2,20128,-2,13210.0,8,13215.0,1,B
2018-04-16 14:22:37,13215.0,2,20130,2,13210.0,8,13220.0,15,B
2018-04-16 14:22:38,13215.0,4,20134,0,13210.0,8,13220.0,12,B
2018-04-16 14:22:43,13215.0,6,20140,-6,13210.0,6,13220.0,13,B
2018-04-16 14:22:46,13215.0,2,20142,-2,13210.0,2,13220.0,13,B
2018-04-16 14:22:50,13210.0,4,20146,0,13205.0,4,13215.0,14,S
2018-04-16 14:23:16,13215.0,2,20148,0,13205.0,6,13215.0,13,B
2018-04-16 14:23:28,13220.0,20,20168,-12,13205.0,11,13220.0,12,B
2018-04-16 14:23:46,13215.0,2,20170,-2,13205.0,7,13215.0,8,S
2018-04-16 14:24:03,13215.0,2,20172,2,13210.0,4,13215.0,9,S
2018-04-16 14:24:08,13205.0,10,20182,-2,13205.0,6,13215.0,10,S
2018-04-16 14:24:12,13210.0,2,20184,2,13205.0,6,13210.0,2,B
2018-04-16 14:24:16,13210.0,2,20186,0,13205.0,6,13210.0,2,B
2018-04-16 14:24:22,13205.0,2,20188,-2,13205.0,5,13210.0,4,S
2018-04-16 14:24:26,13205.0,4,20192,-4,13205.0,3,13210.0,4,S
2018-04-16 14:24:32,13210.0,12,20204,-10,13210.0,2,13215.0,13,B
2018-04-16 14:24:33,13210.0,4,20208,0,13205.0,3,13215.0,10,B
2018-04-16 14:25:03,13215.0,6,20214,0,13210.0,6,13215.0,8,B
2018-04-16 14:25:07,13215.0,10,20224,-6,13210.0,8,13215.0,3,B
2018-04-16 14:25:07,13215.0,6,20230,4,13210.0,8,13220.0,11,B
2018-04-16 14:25:09,13220.0,8,20238,-2,13215.0,2,13220.0,3,B
2018-04-16 14:25:13,13220.0,2,20240,0,13215.0,2,13220.0,2,B
2018-04-16 14:25:17,13220.0,4,20244,-2,13215.0,4,13225.0,8,B
2018-04-16 14:25:21,13225.0,8,20252,-6,13225.0,2,13230.0,10,B
2018-04-16 14:25:21,13230.0,2,20254,-2,13225.0,3,13230.0,5,B
2018-04-16 14:25:27,13225.0,2,20256,0,13225.0,2,13230.0,5,S
2018-04-16 14:25:28,13225.0,4,20260,2,13215.0,2,13230.0,5,S
2018-04-16 14:25:29,13225.0,2,20262,-2,13220.0,10,13230.0,5,S
2018-04-16 14:25:31,13230.0,10,20272,2,13220.0,10,13235.0,6,B
2018-04-16 14:26:13,13225.0,2,20274,0,13215.0,4,13225.0,3,S
2018-04-16 14:26:36,13225.0,4,20278,2,13220.0,2,13225.0,3,S
2018-04-16 14:26:37,13220.0,4,20282,-2,13210.0,1,13215.0,2,S
2018-04-16 14:26:37,13215.0,4,20286,2,13210.0,1,13215.0,1,S
2018-04-16 14:26:38,13215.0,2,20288,2,13210.0,2,13225.0,5,S
2018-04-16 14:26:49,13225.0,4,20292,0,13215.0,5,13225.0,3,B
2018-04-16 14:26:50,13225.0,4,20296,4,13215.0,5,13225.0,1,B
2018-04-16 14:27:03,13220.0,2,20298,-2,13215.0,3,13225.0,1,S
2018-04-16 14:27:14,13230.0,8,20306,-2,13225.0,13,13230.0,1,B
2018-04-16 14:27:19,13230.0,2,20308,0,13230.0,2,13235.0,6,B
2018-04-16 14:27:21,13230.0,2,20310,0,13225.0,1,13235.0,2,B
2018-04-16 14:27:24,13235.0,2,20312,0,13225.0,1,13235.0,2,B
2018-04-16 14:27:47,13230.0,2,20314,2,13225.0,1,13235.0,5,S
2018-04-16 14:28:04,13230.0,4,20318,-2,13225.0,3,13235.0,6,S
2018-04-16 14:28:33,13225.0,2,20320,0,13220.0,2,13230.0,2,S
2018-04-16 14:28:50,13225.0,2,20322,0,13225.0,2,13230.0,3,S
2018-04-16 14:28:53,13225.0,2,20324,2,13225.0,1,13230.0,3,S
2018-04-16 14:29:01,13230.0,2,20326,0,13225.0,1,13230.0,3,B
2018-04-16 14:29:01,13225.0,2,20328,0,13220.0,5,13230.0,3,S
2018-04-16 14:29:27,13220.0,2,20330,0,13215.0,1,13225.0,8,S
2018-04-16 14:29:36,13210.0,2,20332,0,13210.0,4,13220.0,2,S
2018-04-16 14:29:43,13210.0,2,20334,2,13210.0,10,13220.0,3,S
2018-04-16 14:29:47,13220.0,2,20336,0,13215.0,4,13220.0,1,B
2018-04-16 14:29:59,13225.0,2,20338,2,13215.0,4,13225.0,8,B
2018-04-16 14:30:03,13225.0,4,20342,0,13215.0,4,13225.0,7,B
2018-04-16 14:30:19,13220.0,2,20344,0,13215.0,3,13230.0,6,S
2018-04-16 14:30:46,13215.0,8,20352,0,13210.0,6,13215.0,17,S
2018-04-16 14:31:30,13210.0,4,20356,0,13210.0,3,13215.0,3,S
2018-04-16 14:31:42,13210.0,2,20358,-2,13210.0,2,13215.0,5,S
2018-04-16 14:31:48,13210.0,2,20360,0,13210.0,5,13215.0,5,S
2018-04-16 14:31:55,13210.0,2,20362,-2,13210.0,3,13220.0,24,S
2018-04-16 14:32:04,13210.0,8,20370,6,13210.0,1,13220.0,24,S
2018-04-16 14:32:11,13215.0,4,20374,0,13215.0,5,13220.0,24,B
2018-04-16 14:32:14,13210.0,2,20376,0,13205.0,6,13210.0,145,S
2018-04-16 14:32:14,13210.0,22,20398,-14,13205.0,12,13210.0,134,S
2018-04-16 14:32:15,13210.0,4,20402,0,13205.0,14,13210.0,132,S
2018-04-16 14:32:17,13210.0,10,20412,-10,13205.0,18,13210.0,127,S
2018-04-16 14:32:43,13210.0,4,20416,-4,13205.0,21,13210.0,125,S
2018-04-16 14:32:44,13210.0,52,20468,-42,13205.0,24,13210.0,99,S
2018-04-16 14:32:44,13210.0,4,20472,0,13205.0,24,13210.0,97,S
2018-04-16 14:32:45,13210.0,18,20490,-2,13205.0,19,13210.0,88,S
2018-04-16 14:32:46,13210.0,2,20492,-2,13205.0,19,13210.0,87,S
2018-04-16 14:32:46,13210.0,8,20500,-8,13205.0,19,13210.0,83,S
2018-04-16 14:32:47,13210.0,12,20512,-12,13205.0,24,13210.0,77,S
2018-04-16 14:32:47,13210.0,14,20526,-14,13205.0,24,13210.0,70,S
2018-04-16 14:32:48,13210.0,140,20666,-132,13210.0,18,13215.0,4,S
2018-04-16 14:32:48,13215.0,8,20674,4,13210.0,11,13220.0,8,B
2018-04-16 14:32:49,13215.0,2,20676,-2,13210.0,18,13220.0,8,B
2018-04-16 14:32:52,13220.0,2,20678,0,13215.0,8,13220.0,3,B
2018-04-16 14:32:53,13215.0,8,20686,0,13215.0,4,13220.0,3,S
2018-04-16 14:32:53,13215.0,2,20688,0,13215.0,3,13220.0,3,S
2018-04-16 14:32:54,13220.0,6,20694,-4,13210.0,8,13220.0,2,B
2018-04-16 14:33:13,13215.0,4,20698,4,13215.0,1,13220.0,1,S
2018-04-16 14:33:17,13220.0,2,20700,0,13210.0,11,13225.0,5,B
2018-04-16 14:33:50,13215.0,2,20702,0,13215.0,4,13220.0,7,S
2018-04-16 14:33:50,13215.0,2,20704,-2,13215.0,3,13220.0,7,S
2018-04-16 14:34:08,13220.0,6,20710,-4,13220.0,3,13225.0,3,B
2018-04-16 14:34:09,13220.0,4,20714,-4,13220.0,1,13225.0,2,B
2018-04-16 14:34:16,13220.0,2,20716,0,13215.0,3,13225.0,6,B
2018-04-16 14:34:20,13220.0,4,20720,-2,13215.0,3,13220.0,4,B
2018-04-16 14:34:20,13220.0,2,20722,-2,13215.0,3,13220.0,3,B
2018-04-16 14:34:21,13220.0,2,20724,0,13215.0,3,13220.0,2,B
2018-04-16 14:34:33,13215.0,6,20730,-6,13210.0,3,13215.0,5,S
2018-04-16 14:34:33,13210.0,4,20734,0,13205.0,10,13215.0,4,S
2018-04-16 14:34:34,13210.0,2,20736,0,13210.0,1,13215.0,2,S
2018-04-16 14:34:35,13210.0,2,20738,0,13205.0,8,13215.0,2,S
2018-04-16 14:35:09,13205.0,10,20748,0,13205.0,3,13215.0,4,S
2018-04-16 14:35:54,13210.0,2,20750,0,13205.0,7,13215.0,4,B
2018-04-16 14:36:20,13215.0,4,20754,4,13210.0,5,13220.0,23,B
2018-04-16 14:36:39,13215.0,4,20758,0,13210.0,5,13215.0,1,B
2018-04-16 14:36:51,13215.0,2,20760,-2,13210.0,1,13215.0,1,B
2018-04-16 14:37:56,13205.0,10,20770,6,13200.0,7,13205.0,2,S
2018-04-16 14:37:58,13200.0,8,20778,-2,13195.0,7,13205.0,3,S
2018-04-16 14:37:59,13195.0,10,20788,-2,13195.0,2,13200.0,2,S
2018-04-16 14:37:59,13200.0,4,20792,0,13200.0,3,13210.0,2,B
2018-04-16 14:38:08,13195.0,2,20794,0,13195.0,1,13205.0,4,S
2018-04-16 14:38:19,13195.0,2,20796,0,13190.0,13,13205.0,5,S
2018-04-16 14:38:26,13195.0,2,20798,2,13190.0,13,13200.0,1,S
2018-04-16 14:38:32,13200.0,2,20800,-2,13190.0,14,13200.0,1,B
2018-04-16 14:38:36,13195.0,2,20802,0,13195.0,2,13200.0,21,S
2018-04-16 14:38:40,13190.0,6,20808,2,13190.0,10,13200.0,21,S
2018-04-16 14:38:51,13195.0,2,20810,0,13190.0,10,13195.0,1,B
2018-04-16 14:38:55,13190.0,6,20816,-2,13190.0,9,13200.0,22,S
2018-04-16 14:39:05,13200.0,2,20818,0,13200.0,4,13205.0,1,B
2018-04-16 14:39:07,13205.0,2,20820,2,13200.0,1,13210.0,9,B
2018-04-16 14:39:15,13200.0,2,20822,0,13190.0,10,13205.0,1,S
2018-04-16 14:39:15,13205.0,2,20824,0,13195.0,12,13210.0,6,B
2018-04-16 14:39:24,13200.0,2,20826,0,13190.0,12,13205.0,3,S
2018-04-16 14:39:35,13195.0,2,20828,2,13195.0,11,13205.0,5,S
2018-04-16 14:39:35,13195.0,2,20830,0,13195.0,10,13205.0,5,S
2018-04-16 14:39:42,13200.0,2,20832,-2,13195.0,1,13200.0,6,B
2018-04-16 14:39:56,13195.0,20,20852,-8,13190.0,10,13195.0,4,S
2018-04-16 14:39:56,13195.0,8,20860,8,13195.0,11,13205.0,2,S
2018-04-16 14:39:58,13195.0,2,20862,2,13195.0,8,13205.0,2,S
2018-04-16 14:39:59,13195.0,4,20866,4,13195.0,6,13205.0,2,S
2018-04-16 14:40:20,13200.0,4,20870,-4,13195.0,2,13200.0,3,B
2018-04-16 14:40:34,13195.0,2,20872,0,13195.0,1,13200.0,1,S
2018-04-16 14:40:47,13195.0,2,20874,-2,13190.0,11,13200.0,3,S
2018-04-16 14:40:48,13195.0,2,20876,0,13190.0,11,13200.0,3,S
2018-04-16 14:40:55,13190.0,2,20878,-2,13190.0,10,13200.0,3,S
2018-04-16 14:41:05,13190.0,4,20882,-2,13190.0,8,13200.0,5,S
2018-04-16 14:41:22,13195.0,2,20884,-2,13190.0,13,13195.0,1,B
2018-04-16 14:41:24,13190.0,6,20890,0,13190.0,10,13195.0,1,S
2018-04-16 14:41:26,13195.0,2,20892,0,13190.0,15,13200.0,22,B
2018-04-16 14:41:35,13200.0,4,20896,-4,13190.0,19,13205.0,4,B
2018-04-16 14:41:42,13205.0,2,20898,-2,13205.0,1,13210.0,10,B
2018-04-16 14:41:43,13205.0,2,20900,0,13200.0,15,13205.0,3,B
2018-04-16 14:41:46,13200.0,2,20902,2,13200.0,9,13205.0,3,S
2018-04-16 14:41:46,13205.0,2,20904,0,13200.0,9,13205.0,2,B
2018-04-16 14:41:50,13205.0,4,20908,0,13200.0,9,13210.0,9,B
2018-04-16 14:42:44,13200.0,2,20910,2,13200.0,9,13210.0,3,S
2018-04-16 14:42:46,13210.0,4,20914,0,13200.0,9,13210.0,1,B
2018-04-16 14:43:01,13210.0,2,20916,0,13200.0,9,13215.0,3,B
2018-04-16 14:43:24,13210.0,4,20920,-4,13205.0,2,13220.0,26,B
2018-04-16 14:43:31,13205.0,4,20924,0,13195.0,5,13210.0,1,S
2018-04-16 14:43:39,13210.0,2,20926,-2,13205.0,5,13215.0,2,B
2018-04-16 14:43:40,13215.0,2,20928,0,13205.0,5,13220.0,27,B
2018-04-16 14:43:47,13215.0,6,20934,-2,13210.0,10,13220.0,24,B
2018-04-16 14:43:55,13215.0,2,20936,-2,13210.0,10,13220.0,5,B
2018-04-16 14:44:01,13220.0,2,20938,-2,13215.0,16,13220.0,8,B
2018-04-16 14:44:01,13220.0,8,20946,6,13215.0,16,13220.0,4,B
2018-04-16 14:44:02,13220.0,8,20954,8,13220.0,8,13225.0,6,B
2018-04-16 14:44:04,13225.0,2,20956,0,13220.0,7,13225.0,2,B
2018-04-16 14:44:04,13225.0,2,20958,2,13220.0,12,13225.0,1,B
2018-04-16 14:44:05,13225.0,2,20960,2,13225.0,2,13230.0,5,B
2018-04-16 14:44:06,13230.0,4,20964,-2,13225.0,7,13230.0,1,B
2018-04-16 14:44:07,13230.0,2,20966,2,13230.0,4,13235.0,2,B
2018-04-16 14:44:07,13230.0,8,20974,4,13220.0,10,13235.0,2,B
2018-04-16 14:44:10,13225.0,2,20976,0,13225.0,11,13235.0,4,S
2018-04-16 14:44:18,13225.0,4,20980,4,13220.0,6,13230.0,6,S
2018-04-16 14:44:21,13230.0,2,20982,0,13220.0,6,13230.0,9,B
2018-04-16 14:44:24,13230.0,4,20986,0,13220.0,23,13230.0,8,B
2018-04-16 14:44:35,13225.0,4,20990,0,13220.0,16,13230.0,8,S
2018-04-16 14:44:53,13220.0,2,20992,-2,13205.0,6,13220.0,1,S
2018-04-16 14:45:05,13225.0,4,20996,-2,13220.0,10,13225.0,5,B
2018-04-16 14:45:09,13225.0,18,21014,10,13225.0,2,13230.0,23,B
2018-04-16 14:45:09,13225.0,4,21018,0,13220.0,10,13225.0,3,B
2018-04-16 14:45:18,13215.0,2,21020,0,13215.0,4,13225.0,3,S
2018-04-16 14:45:53,13220.0,6,21026,0,13215.0,1,13225.0,5,B
2018-04-16 14:45:57,13220.0,2,21028,-2,13215.0,1,13225.0,5,B
2018-04-16 14:47:13,13225.0,2,21030,2,13225.0,1,13230.0,6,B
2018-04-16 14:47:41,13225.0,2,21032,2,13220.0,1,13230.0,4,B
2018-04-16 14:47:44,13220.0,2,21034,0,13215.0,6,13220.0,16,S
2018-04-16 14:47:44,13220.0,8,21042,4,13215.0,6,13220.0,12,S
2018-04-16 14:47:49,13215.0,12,21054,12,13210.0,6,13215.0,6,S
2018-04-16 14:47:50,13220.0,14,21068,0,13210.0,9,13230.0,6,B
2018-04-16 14:48:08,13225.0,8,21076,0,13215.0,24,13225.0,3,B
2018-04-16 14:48:10,13220.0,2,21078,0,13220.0,11,13225.0,1,S
2018-04-16 14:48:25,13220.0,2,21080,0,13220.0,11,13225.0,1,S
2018-04-16 14:48:26,13220.0,2,21082,2,13220.0,10,13225.0,1,S
2018-04-16 14:48:41,13220.0,2,21084,2,13220.0,9,13225.0,2,S
2018-04-16 14:48:46,13225.0,2,21086,2,13220.0,1,13225.0,1,B
2018-04-16 14:49:16,13225.0,2,21088,-2,13220.0,3,13230.0,8,B
2018-04-16 14:49:16,13230.0,14,21102,0,13215.0,1,13230.0,5,B
2018-04-16 14:49:18,13225.0,2,21104,0,13220.0,4,13230.0,4,S
2018-04-16 14:49:23,13220.0,2,21106,-2,13220.0,3,13225.0,4,S
2018-04-16 14:49:24,13220.0,2,21108,-2,13215.0,1,13225.0,5,S
2018-04-16 14:50:36,13225.0,4,21112,0,13220.0,5,13230.0,7,B
2018-04-16 14:50:53,13225.0,2,21114,2,13220.0,5,13225.0,1,B
2018-04-16 14:50:55,13220.0,2,21116,-2,13220.0,3,13225.0,21,S
2018-04-16 14:51:07,13220.0,4,21120,2,13215.0,3,13220.0,1,S
2018-04-16 14:51:17,13215.0,4,21124,0,13210.0,8,13220.0,2,S
2018-04-16 14:51:18,13215.0,2,21126,-2,13210.0,7,13215.0,2,S
2018-04-16 14:51:27,13210.0,4,21130,0,13210.0,5,13215.0,2,S
2018-04-16 14:51:27,13210.0,2,21132,0,13210.0,4,13215.0,3,S
2018-04-16 14:51:28,13210.0,8,21140,2,13205.0,3,13215.0,5,S
2018-04-16 14:51:30,13205.0,2,21142,0,13205.0,1,13210.0,3,S
2018-04-16 14:51:30,13205.0,2,21144,0,13200.0,12,13205.0,6,S
2018-04-16 14:51:35,13200.0,20,21164,-20,13200.0,1,13205.0,6,S
2018-04-16 14:51:36,13200.0,2,21166,0,13190.0,12,13200.0,2,S
2018-04-16 14:51:39,13195.0,4,21170,4,13195.0,1,13200.0,2,S
2018-04-16 14:51:42,13200.0,2,21172,-2,13195.0,1,13205.0,2,B
2018-04-16 14:51:44,13195.0,2,21174,-2,13190.0,6,13200.0,5,S
2018-04-16 14:52:01,13195.0,2,21176,-2,13190.0,9,13200.0,6,S
2018-04-16 14:52:03,13200.0,2,21178,0,13190.0,9,13200.0,5,B
2018-04-16 14:52:07,13195.0,6,21184,0,13190.0,9,13205.0,5,S
2018-04-16 14:52:17,13195.0,6,21190,0,13195.0,2,13200.0,1,S
2018-04-16 14:52:43,13195.0,2,21192,-2,13195.0,5,13200.0,2,S
2018-04-16 14:52:51,13200.0,4,21196,2,13195.0,5,13205.0,4,B
2018-04-16 14:53:01,13205.0,4,21200,0,13205.0,5,13210.0,3,B
2018-04-16 14:53:02,13205.0,2,21202,-2,13205.0,1,13215.0,2,B
2018-04-16 14:53:47,13210.0,2,21204,-2,13205.0,2,13215.0,3,B
2018-04-16 14:54:10,13210.0,2,21206,0,13205.0,6,13215.0,4,B
2018-04-16 14:54:44,13205.0,2,21208,-2,13200.0,4,13210.0,1,S
2018-04-16 14:55:03,13210.0,2,21210,0,13210.0,1,13215.0,4,B
2018-04-16 14:55:10,13210.0,2,21212,0,13210.0,1,13215.0,6,B
2018-04-16 14:55:18,13210.0,2,21214,2,13210.0,1,13215.0,6,B
2018-04-16 14:55:20,13215.0,4,21218,-2,13210.0,1,13215.0,4,B
2018-04-16 14:55:30,13210.0,4,21222,0,13210.0,4,13215.0,4,S
2018-04-16 14:55:31,13215.0,10,21232,-10,13215.0,5,13220.0,1,B
2018-04-16 14:55:34,13215.0,10,21242,0,13205.0,1,13220.0,2,B
2018-04-16 14:55:34,13210.0,2,21244,0,13210.0,1,13215.0,7,S
2018-04-16 14:56:06,13215.0,2,21246,0,13210.0,4,13220.0,2,B
2018-04-16 14:56:32,13215.0,4,21250,4,13210.0,4,13220.0,2,B
2018-04-16 14:57:00,13210.0,2,21252,2,13210.0,1,13215.0,4,S
2018-04-16 14:57:01,13215.0,2,21254,-2,13210.0,1,13220.0,3,B
2018-04-16 14:57:01,13220.0,2,21256,-2,13210.0,1,13220.0,2,B
2018-04-16 14:57:02,13210.0,2,21258,2,13205.0,7,13210.0,9,S
2018-04-16 14:57:03,13210.0,18,21276,16,13205.0,7,13220.0,2,S
2018-04-16 14:57:13,13210.0,2,21278,2,13210.0,1,13215.0,2,S
2018-04-16 14:57:17,13210.0,2,21280,2,13205.0,13,13220.0,2,S
2018-04-16 14:57:30,13215.0,2,21282,-2,13215.0,4,13220.0,2,B
2018-04-16 14:57:31,13215.0,8,21290,0,13205.0,8,13215.0,13,B
2018-04-16 14:57:34,13215.0,4,21294,0,13205.0,13,13215.0,12,B
2018-04-16 14:57:40,13205.0,22,21316,8,13205.0,2,13215.0,1,S
2018-04-16 14:57:46,13215.0,4,21320,2,13205.0,3,13220.0,3,B
2018-04-16 14:57:56,13220.0,6,21326,0,13210.0,10,13225.0,7,B
2018-04-16 14:58:01,13215.0,2,21328,-2,13210.0,10,13225.0,5,S
2018-04-16 14:58:02,13220.0,4,21332,-4,13220.0,3,13225.0,5,B
2018-04-16 14:58:08,13220.0,2,21334,-2,13215.0,5,13220.0,1,B
2018-04-16 14:58:11,13220.0,2,21336,0,13220.0,2,13225.0,8,B
2018-04-16 14:58:14,13220.0,2,21338,0,13220.0,1,13225.0,5,B
2018-04-16 14:58:17,13225.0,2,21340,0,13220.0,1,13225.0,4,B
2018-04-16 14:58:27,13225.0,2,21342,0,13220.0,2,13225.0,3,B
2018-04-16 14:58:30,13225.0,6,21348,0,13220.0,3,13230.0,3,B
2018-04-16 14:58:31,13220.0,2,21350,0,13220.0,2,13225.0,2,S
2018-04-16 14:58:41,13220.0,4,21354,2,13220.0,2,13225.0,5,S
2018-04-16 14:58:42,13220.0,4,21358,0,13210.0,1,13225.0,5,S
2018-04-16 14:58:49,13210.0,2,21360,-2,13200.0,8,13215.0,1,S
2018-04-16 14:59:00,13220.0,6,21366,-4,13205.0,6,13220.0,1,B
2018-04-16 14:59:00,13210.0,2,21368,0,13205.0,6,13220.0,1,S
2018-04-16 14:59:17,13220.0,4,21372,-4,13205.0,1,13220.0,2,B
2018-04-16 14:59:21,13220.0,2,21374,0,13205.0,1,13225.0,2,B
2018-04-16 14:59:30,13220.0,2,21376,0,13205.0,1,13220.0,6,B
2018-04-16 14:59:34,13220.0,16,21392,-10,13210.0,1,13220.0,7,B
2018-04-16 14:59:36,13210.0,2,21394,-2,13205.0,1,13210.0,1,S
2018-04-16 14:59:37,13210.0,2,21396,-2,13205.0,1,13215.0,1,S
2018-04-16 14:59:43,13205.0,2,21398,2,13205.0,5,13215.0,1,S
2018-04-16 14:59:44,13215.0,2,21400,0,13215.0,5,13220.0,12,B
2018-04-16 14:59:46,13215.0,2,21402,0,13215.0,4,13220.0,12,B
2018-04-16 14:59:48,13220.0,8,21410,0,13210.0,5,13220.0,4,B
2018-04-16 14:59:53,13220.0,8,21418,-2,13220.0,3,13225.0,2,B
2018-04-16 14:59:55,13220.0,4,21422,-4,13220.0,1,13225.0,2,B
2018-04-16 14:59:56,13220.0,2,21424,-2,13215.0,3,13225.0,2,B
2018-04-16 14:59:57,13215.0,6,21430,-6,13210.0,5,13220.0,1,S
2018-04-16 20:59:00,13200.0,418,418,65126,0.0,0,0.0,0,B
2018-04-16 21:00:00,13200.0,26,444,26,13200.0,32,13250.0,1,B
2018-04-16 21:00:01,13250.0,24,468,-2,13250.0,2,13300.0,5,B
2018-04-16 21:00:01,13285.0,8,476,-6,13225.0,2,13290.0,2,B
2018-04-16 21:00:02,13225.0,18,494,-2,13225.0,12,13270.0,1,S
2018-04-16 21:00:03,13230.0,6,500,0,13230.0,33,13235.0,3,B
2018-04-16 21:00:03,13225.0,12,512,4,13220.0,2,13235.0,3,S
2018-04-16 21:00:05,13230.0,2,514,-2,13225.0,4,13235.0,3,B
2018-04-16 21:00:05,13225.0,10,524,4,13225.0,1,13235.0,3,S
2018-04-16 21:00:06,13225.0,2,526,0,13205.0,21,13225.0,2,S
2018-04-16 21:00:07,13225.0,4,530,0,13225.0,3,13230.0,3,S
2018-04-16 21:00:07,13230.0,4,534,-2,13210.0,12,13230.0,1,B
2018-04-16 21:00:08,13230.0,2,536,0,13230.0,2,13235.0,1,B
2018-04-16 21:00:15,13235.0,8,544,6,13240.0,16,13245.0,8,B
2018-04-16 21:00:15,13235.0,34,578,16,13230.0,2,13240.0,2,B
2018-04-16 21:00:16,13230.0,4,582,4,13225.0,2,13245.0,21,S
2018-04-16 21:00:19,13225.0,4,586,0,13220.0,3,13225.0,1,S
2018-04-16 21:00:19,13225.0,2,588,0,13225.0,4,13240.0,8,S
2018-04-16 21:00:21,13230.0,2,590,-2,13225.0,4,13230.0,4,B
2018-04-16 21:00:22,13230.0,2,592,-2,13225.0,4,13230.0,6,B
2018-04-16 21:00:23,13225.0,2,594,0,13225.0,3,13230.0,8,S
2018-04-16 21:00:24,13225.0,6,600,-6,13220.0,3,13230.0,8,S
2018-04-16 21:00:25,13225.0,2,602,0,13220.0,1,13225.0,4,S
2018-04-16 21:00:25,13225.0,6,608,0,13220.0,1,13225.0,1,S
2018-04-16 21:00:26,13225.0,2,610,-2,13220.0,3,13230.0,3,S
2018-04-16 21:00:30,13230.0,4,614,-2,13225.0,2,13235.0,1,B
2018-04-16 21:00:32,13220.0,20,634,-10,13215.0,2,13220.0,3,S
2018-04-16 21:00:32,13220.0,6,640,-6,13220.0,2,13235.0,4,S
2018-04-16 21:00:35,13235.0,2,642,-2,13225.0,11,13235.0,1,B
2018-04-16 21:00:36,13230.0,2,644,-2,13230.0,4,13235.0,1,S
2018-04-16 21:00:38,13235.0,2,646,0,13235.0,2,13240.0,7,B
2018-04-16 21:00:38,13235.0,2,648,0,13235.0,1,13240.0,7,B
2018-04-16 21:00:39,13235.0,4,652,-2,13230.0,3,13240.0,5,B
2018-04-16 21:00:41,13235.0,2,654,0,13230.0,3,13240.0,10,B
2018-04-16 21:00:43,13235.0,2,656,-2,13230.0,2,13235.0,1,B
2018-04-16 21:00:50,13230.0,2,658,2,13230.0,1,13235.0,1,S
2018-04-16 21:01:06,13225.0,8,666,8,13225.0,2,13230.0,7,S
2018-04-16 21:01:06,13225.0,6,672,-4,13220.0,2,13230.0,7,S
2018-04-16 21:01:08,13225.0,4,676,-2,13215.0,6,13225.0,2,S
2018-04-16 21:01:12,13220.0,2,678,0,13220.0,1,13225.0,4,S
2018-04-16 21:01:12,13210.0,4,682,-4,13210.0,7,13225.0,4,S
2018-04-16 21:01:17,13210.0,2,684,-2,13210.0,8,13215.0,1,S
2018-04-16 21:01:20,13215.0,6,690,2,13215.0,2,13220.0,10,B
2018-04-16 21:01:21,13215.0,2,692,-2,13210.0,15,13220.0,10,B
2018-04-16 21:01:21,13210.0,24,716,4,13205.0,1,13210.0,4,S
2018-04-16 21:01:22,13210.0,2,718,0,13210.0,4,13220.0,14,S
2018-04-16 21:01:23,13220.0,4,722,0,13205.0,8,13220.0,12,B
2018-04-16 21:01:25,13210.0,4,726,-4,13210.0,3,13215.0,1,S
2018-04-16 21:01:25,13215.0,2,728,2,13215.0,1,13220.0,8,B
2018-04-16 21:01:27,13220.0,6,734,0,13215.0,2,13220.0,5,B
2018-04-16 21:01:27,13220.0,10,744,0,13220.0,2,13225.0,3,B
2018-04-16 21:01:28,13220.0,6,750,0,13220.0,1,13225.0,2,B
2018-04-16 21:01:31,13220.0,2,752,-2,13220.0,1,13225.0,4,B
2018-04-16 21:01:31,13220.0,2,754,2,13215.0,3,13220.0,2,B
2018-04-16 21:01:51,13215.0,4,758,2,13210.0,1,13215.0,2,S
2018-04-16 21:01:52,13220.0,2,760,0,13210.0,1,13220.0,7,B
2018-04-16 21:01:58,13215.0,2,762,-2,13215.0,2,13220.0,17,S
2018-04-16 21:01:58,13215.0,2,764,-2,13215.0,1,13220.0,17,S
2018-04-16 21:02:00,13220.0,6,770,-2,13210.0,2,13220.0,15,B
2018-04-16 21:02:04,13220.0,12,782,0,13210.0,8,13220.0,4,B
2018-04-16 21:02:05,13220.0,8,790,0,13220.0,5,13225.0,5,B
2018-04-16 21:02:05,13225.0,10,800,4,13220.0,12,13230.0,1,B
2018-04-16 21:02:06,13230.0,6,806,-4,13220.0,9,13230.0,2,B
2018-04-16 21:02:08,13225.0,2,808,0,13225.0,1,13235.0,9,S
2018-04-16 21:02:15,13225.0,2,810,0,13220.0,8,13235.0,9,S
2018-04-16 21:02:20,13230.0,4,814,-4,13225.0,3,13235.0,7,B
2018-04-16 21:02:22,13230.0,2,816,2,13225.0,3,13235.0,7,B
2018-04-16 21:02:41,13230.0,4,820,0,13220.0,4,13230.0,3,B
2018-04-16 21:03:01,13230.0,4,824,0,13225.0,3,13230.0,5,B
2018-04-16 21:03:01,13230.0,10,834,2,13225.0,3,13235.0,10,B
2018-04-16 21:03:04,13230.0,2,836,-2,13225.0,3,13235.0,8,B
2018-04-16 21:03:05,13235.0,2,838,-2,13225.0,4,13235.0,7,B
2018-04-16 21:03:06,13235.0,4,842,-2,13225.0,4,13235.0,5,B
2018-04-16 21:03:09,13235.0,10,852,2,13230.0,9,13240.0,28,B
2018-04-16 21:03:15,13230.0,2,854,0,13230.0,5,13235.0,3,S
2018-04-16 21:03:25,13230.0,2,856,0,13230.0,4,13235.0,17,S
2018-04-16 21:03:25,13230.0,4,860,0,13230.0,2,13235.0,17,S
2018-04-16 21:03:26,13230.0,4,864,-2,13220.0,13,13235.0,5,S
2018-04-16 21:03:27,13235.0,2,866,-2,13225.0,9,13235.0,2,B
2018-04-16 21:03:32,13230.0,2,868,0,13225.0,7,13230.0,5,S
2018-04-16 21:03:32,13230.0,10,878,8,13230.0,8,13235.0,2,S
2018-04-16 21:03:33,13235.0,2,880,0,13230.0,8,13235.0,1,B
2018-04-16 21:03:36,13235.0,2,882,0,13235.0,2,13240.0,18,B
2018-04-16 21:03:37,13235.0,4,886,-4,13230.0,2,13235.0,3,B
2018-04-16 21:03:45,13230.0,4,890,0,13225.0,6,13235.0,5,S
2018-04-16 21:03:52,13225.0,2,892,0,13220.0,2,13225.0,3,S
2018-04-16 21:03:53,13225.0,6,898,-6,13220.0,7,13230.0,2,S
2018-04-16 21:04:03,13225.0,4,902,2,13225.0,3,13230.0,3,S
2018-04-16 21:04:09,13230.0,8,910,0,13220.0,9,13235.0,20,B
2018-04-16 21:04:13,13225.0,2,912,0,13225.0,4,13235.0,20,S
2018-04-16 21:04:22,13230.0,2,914,2,13225.0,4,13230.0,1,B
2018-04-16 21:04:26,13230.0,2,916,0,13230.0,4,13240.0,16,B
2018-04-16 21:04:28,13240.0,4,920,0,13230.0,5,13240.0,16,B
2018-04-16 21:04:29,13240.0,2,922,0,13230.0,5,13235.0,1,B
2018-04-16 21:04:29,13230.0,10,932,10,13225.0,3,13230.0,4,S
2018-04-16 21:04:47,13235.0,2,934,-2,13225.0,5,13235.0,2,B
2018-04-16 21:04:48,13235.0,4,938,-2,13225.0,5,13240.0,25,B
2018-04-16 21:04:55,13230.0,2,940,0,13225.0,5,13230.0,2,S
2018-04-16 21:04:59,13230.0,8,948,0,13225.0,1,13235.0,1,S
2018-04-16 21:05:04,13235.0,4,952,4,13225.0,5,13240.0,16,B
2018-04-16 21:05:07,13240.0,6,958,-2,13225.0,5,13240.0,13,B
2018-04-16 21:05:34,13225.0,2,960,0,13220.0,7,13230.0,4,S
2018-04-16 21:05:38,13225.0,2,962,2,13220.0,3,13225.0,8,S
2018-04-16 21:05:44,13220.0,2,964,0,13220.0,2,13225.0,5,S
2018-04-16 21:05:44,13220.0,6,970,4,13215.0,1,13225.0,5,S
2018-04-16 21:05:47,13215.0,4,974,0,13210.0,3,13215.0,4,S
2018-04-16 21:05:50,13210.0,2,976,0,13210.0,2,13215.0,4,S
2018-04-16 21:05:51,13215.0,2,978,0,13210.0,7,13225.0,16,B
2018-04-16 21:05:54,13210.0,2,980,2,13210.0,6,13220.0,3,S
2018-04-16 21:06:04,13210.0,8,988,4,13210.0,4,13220.0,11,S
2018-04-16 21:06:05,13215.0,2,990,0,13210.0,5,13220.0,11,B
2018-04-16 21:06:06,13210.0,2,992,2,13210.0,5,13220.0,11,S
2018-04-16 21:06:06,13210.0,2,994,0,13210.0,3,13215.0,1,S
2018-04-16 21:06:07,13215.0,2,996,0,13210.0,3,13220.0,12,B
2018-04-16 21:06:10,13215.0,4,1000,4,13215.0,3,13220.0,13,B
2018-04-16 21:06:12,13215.0,2,1002,2,13215.0,2,13220.0,13,B
2018-04-16 21:06:14,13220.0,6,1008,0,13215.0,4,13220.0,10,B
2018-04-16 21:06:15,13220.0,20,1028,14,13220.0,11,13225.0,4,B
2018-04-16 21:06:15,13225.0,2,1030,2,13220.0,10,13230.0,4,B
2018-04-16 21:06:17,13220.0,2,1032,2,13215.0,5,13230.0,8,S
2018-04-16 21:06:20,13220.0,2,1034,2,13215.0,4,13230.0,8,S
2018-04-16 21:06:26,13220.0,2,1036,2,13215.0,4,13220.0,1,S
2018-04-16 21:06:27,13215.0,4,1040,4,13215.0,2,13220.0,1,S
2018-04-16 21:06:28,13215.0,2,1042,2,13215.0,1,13220.0,1,S
2018-04-16 21:06:32,13220.0,2,1044,2,13215.0,1,13220.0,1,B
2018-04-16 21:06:34,13215.0,2,1046,2,13210.0,6,13220.0,3,S
2018-04-16 21:06:36,13210.0,2,1048,0,13210.0,5,13215.0,2,S
2018-04-16 21:06:46,13210.0,2,1050,2,13210.0,5,13215.0,6,S
2018-04-16 21:06:47,13215.0,6,1056,-2,13210.0,5,13215.0,3,B
2018-04-16 21:06:47,13215.0,6,1062,2,13215.0,8,13220.0,4,B
2018-04-16 21:06:48,13225.0,12,1074,4,13215.0,11,13225.0,6,B
2018-04-16 21:06:48,13215.0,2,1076,2,13215.0,6,13225.0,2,S
2018-04-16 21:06:49,13225.0,2,1078,0,13220.0,3,13225.0,1,B
2018-04-16 21:06:51,13225.0,2,1080,0,13220.0,7,13230.0,5,B
2018-04-16 21:06:53,13220.0,2,1082,0,13220.0,6,13230.0,6,S
2018-04-16 21:06:54,13230.0,4,1086,-4,13225.0,5,13235.0,4,B
2018-04-16 21:06:58,13235.0,4,1090,2,13230.0,3,13235.0,3,B
2018-04-16 21:06:59,13230.0,6,1096,-6,13225.0,2,13235.0,3,S
2018-04-16 21:07:03,13220.0,2,1098,0,13220.0,7,13230.0,6,S
2018-04-16 21:07:11,13225.0,2,1100,2,13225.0,7,13230.0,4,B
2018-04-16 21:07:13,13225.0,2,1102,0,13220.0,2,13230.0,8,B
2018-04-16 21:07:15,13230.0,6,1108,0,13220.0,3,13230.0,5,B
2018-04-16 21:07:19,13220.0,2,1110,0,13220.0,5,13230.0,5,S
2018-04-16 21:07:19,13220.0,2,1112,0,13220.0,4,13230.0,5,S
2018-04-16 21:07:31,13225.0,2,1114,2,13220.0,5,13225.0,1,B
2018-04-16 21:07:31,13225.0,2,1116,0,13220.0,5,13230.0,8,B
2018-04-16 21:07:32,13230.0,2,1118,0,13220.0,5,13230.0,7,B
2018-04-16 21:07:35,13225.0,2,1120,-2,13225.0,4,13230.0,4,S
2018-04-16 21:07:43,13225.0,2,1122,2,13225.0,3,13230.0,5,S
2018-04-16 21:07:50,13225.0,2,1124,2,13225.0,2,13230.0,5,S
2018-04-16 21:08:08,13225.0,4,1128,4,13225.0,2,13230.0,14,S
2018-04-16 21:08:08,13225.0,2,1130,0,13225.0,1,13230.0,14,S
2018-04-16 21:08:13,13225.0,2,1132,0,13225.0,2,13230.0,14,S
2018-04-16 21:08:14,13225.0,2,1134,2,13225.0,1,13230.0,15,S
2018-04-16 21:08:18,13225.0,2,1136,2,13220.0,5,13225.0,1,S
2018-04-16 21:08:19,13230.0,38,1174,28,13230.0,1,13235.0,20,B
2018-04-16 21:08:20,13230.0,2,1176,0,13220.0,7,13230.0,29,B
2018-04-16 21:08:21,13225.0,2,1178,2,13220.0,5,13225.0,2,S
2018-04-16 21:08:23,13220.0,10,1188,-6,13215.0,1,13225.0,6,S
2018-04-16 21:08:30,13215.0,2,1190,2,13210.0,9,13220.0,1,S
2018-04-16 21:08:36,13225.0,4,1194,4,13210.0,13,13225.0,7,B
2018-04-16 21:08:42,13215.0,2,1196,0,13215.0,5,13225.0,6,S
2018-04-16 21:08:50,13215.0,2,1198,2,13220.0,4,13225.0,7,S
2018-04-16 21:09:07,13220.0,8,1206,8,13215.0,6,13225.0,9,B
2018-04-16 21:09:11,13215.0,2,1208,0,13215.0,5,13225.0,9,S
2018-04-16 21:09:20,13220.0,4,1212,4,13210.0,14,13225.0,22,B
2018-04-16 21:09:21,13225.0,4,1216,0,13210.0,14,13225.0,20,B
2018-04-16 21:09:31,13215.0,4,1220,2,13215.0,3,13220.0,1,S
2018-04-16 21:09:35,13220.0,2,1222,2,13220.0,1,13225.0,8,B
2018-04-16 21:09:36,13220.0,2,1224,0,13215.0,3,13225.0,8,B
2018-04-16 21:09:48,13220.0,4,1228,4,13215.0,4,13220.0,3,B
2018-04-16 21:09:49,13215.0,8,1236,0,13210.0,11,13220.0,5,S
2018-04-16 21:09:59,13215.0,2,1238,2,13210.0,10,13220.0,7,S
2018-04-16 21:10:06,13220.0,4,1242,2,13210.0,10,13220.0,3,B
2018-04-16 21:10:06,13220.0,6,1248,-4,13220.0,2,13225.0,24,B
2018-04-16 21:10:09,13225.0,4,1252,0,13215.0,5,13225.0,7,B
2018-04-16 21:10:25,13215.0,2,1254,0,13210.0,13,13215.0,1,S
2018-04-16 21:10:25,13215.0,2,1256,-2,13215.0,1,13220.0,4,S
2018-04-16 21:10:42,13210.0,12,1268,6,13210.0,7,13220.0,5,S
2018-04-16 21:10:44,13210.0,2,1270,2,13210.0,1,13215.0,2,S
2018-04-16 21:10:47,13210.0,2,1272,-2,13205.0,7,13215.0,2,S
2018-04-16 21:10:52,13205.0,2,1274,2,13205.0,8,13215.0,4,S
2018-04-16 21:10:55,13205.0,2,1276,-2,13205.0,7,13215.0,4,S
2018-04-16 21:11:02,13215.0,4,1280,4,13205.0,7,13215.0,2,B
2018-04-16 21:11:03,13215.0,4,1284,0,13215.0,2,13220.0,19,B
2018-04-16 21:11:06,13220.0,4,1288,4,13215.0,1,13220.0,2,B
2018-04-16 21:11:07,13215.0,2,1290,0,13210.0,7,13220.0,3,S
2018-04-16 21:11:23,13220.0,8,1298,6,13215.0,3,13220.0,5,B
2018-04-16 21:11:29,13220.0,4,1302,4,13215.0,3,13220.0,3,B
2018-04-16 21:11:31,13220.0,6,1308,4,13220.0,3,13225.0,22,B
2018-04-16 21:11:35,13225.0,4,1312,4,13220.0,1,13225.0,6,B
2018-04-16 21:11:38,13220.0,2,1314,0,13215.0,7,13225.0,6,S
2018-04-16 21:11:54,13220.0,6,1320,0,13215.0,7,13225.0,7,S
2018-04-16 21:11:58,13225.0,2,1322,0,13215.0,7,13225.0,5,B
2018-04-16 21:12:25,13225.0,2,1324,2,13220.0,1,13225.0,5,B
2018-04-16 21:12:27,13220.0,2,1326,0,13215.0,4,13220.0,1,S
2018-04-16 21:12:40,13215.0,2,1328,2,13215.0,3,13225.0,7,S
2018-04-16 21:13:06,13225.0,4,1332,4,13215.0,3,13225.0,16,B
2018-04-16 21:13:09,13220.0,10,1342,6,13220.0,1,13225.0,10,S
2018-04-16 21:13:11,13225.0,2,1344,2,13220.0,1,13225.0,9,B
2018-04-16 21:13:12,13225.0,2,1346,2,13220.0,1,13225.0,8,B
2018-04-16 21:13:21,13225.0,2,1348,2,13215.0,9,13225.0,7,B
2018-04-16 21:13:22,13225.0,2,1350,2,13220.0,1,13225.0,6,B
2018-04-16 21:13:55,13220.0,4,1354,2,13215.0,3,13220.0,4,S
2018-04-16 21:13:59,13220.0,2,1356,0,13215.0,4,13220.0,4,S
2018-04-16 21:14:02,13220.0,2,1358,0,13215.0,3,13220.0,15,S
2018-04-16 21:14:03,13215.0,2,1360,2,13215.0,2,13220.0,14,S
2018-04-16 21:14:04,13215.0,2,1362,2,13215.0,1,13220.0,14,S
2018-04-16 21:14:05,13215.0,2,1364,0,13210.0,11,13220.0,15,S
2018-04-16 21:14:14,13210.0,2,1366,0,13210.0,8,13220.0,15,S
2018-04-16 21:14:17,13210.0,2,1368,2,13210.0,7,13215.0,1,S
2018-04-16 21:14:25,13210.0,2,1370,2,13210.0,6,13215.0,1,S
2018-04-16 21:14:36,13215.0,4,1374,0,13210.0,5,13215.0,1,B
2018-04-16 21:14:38,13220.0,4,1378,2,13210.0,6,13220.0,5,B
2018-04-16 21:14:48,13215.0,2,1380,0,13215.0,1,13220.0,2,S
2018-04-16 21:14:59,13220.0,4,1384,4,13215.0,1,13225.0,22,B
2018-04-16 21:15:04,13220.0,2,1386,2,13220.0,21,13225.0,22,B
2018-04-16 21:15:13,13220.0,10,1396,2,13220.0,16,13225.0,14,B
2018-04-16 21:15:23,13220.0,4,1400,0,13220.0,14,13225.0,13,B
2018-04-16 21:15:26,13225.0,4,1404,2,13220.0,14,13225.0,10,B
2018-04-16 21:15:31,13220.0,6,1410,0,13220.0,11,13225.0,10,S
2018-04-16 21:15:33,13225.0,2,1412,2,13220.0,11,13225.0,10,B
2018-04-16 21:15:34,13220.0,2,1414,0,13220.0,10,13225.0,10,S
2018-04-16 21:15:47,13220.0,20,1434,0,13215.0,2,13220.0,7,S
2018-04-16 21:16:07,13220.0,2,1436,-2,13210.0,17,13220.0,9,S
2018-04-16 21:16:39,13210.0,26,1462,14,13205.0,5,13210.0,7,S
2018-04-16 21:16:40,13210.0,6,1468,4,13205.0,7,13210.0,4,S
2018-04-16 21:16:47,13205.0,4,1472,4,13205.0,4,13210.0,10,S
2018-04-16 21:16:49,13205.0,8,1480,2,13200.0,3,13210.0,15,S
2018-04-16 21:16:51,13200.0,2,1482,2,13200.0,3,13205.0,6,S
2018-04-16 21:16:52,13200.0,2,1484,0,13200.0,1,13205.0,11,S
2018-04-16 21:16:52,13200.0,2,1486,-2,13190.0,2,13195.0,2,S
2018-04-16 21:16:53,13200.0,6,1492,-6,13200.0,1,13205.0,6,S
2018-04-16 21:16:56,13200.0,2,1494,0,13200.0,2,13205.0,6,S
2018-04-16 21:16:58,13200.0,2,1496,0,13200.0,1,13205.0,6,S
2018-04-16 21:16:58,13200.0,2,1498,-2,13200.0,1,13205.0,6,S
2018-04-16 21:17:03,13200.0,4,1502,0,13195.0,10,13200.0,28,S
2018-04-16 21:17:04,13200.0,12,1514,-6,13195.0,11,13200.0,22,S
2018-04-16 21:17:04,13200.0,44,1558,-18,13200.0,10,13205.0,6,S
2018-04-16 21:17:05,13205.0,12,1570,-4,13205.0,5,13210.0,12,B
2018-04-16 21:17:10,13210.0,4,1574,4,13205.0,4,13210.0,9,B
2018-04-16 21:17:11,13205.0,8,1582,-2,13200.0,8,13205.0,1,S
2018-04-16 21:17:11,13200.0,12,1594,6,13200.0,1,13205.0,7,S
2018-04-16 21:17:12,13200.0,4,1598,0,13195.0,8,13205.0,7,S
2018-04-16 21:17:13,13200.0,2,1600,0,13200.0,1,13205.0,7,S
2018-04-16 21:17:16,13200.0,2,1602,2,13195.0,7,13205.0,7,S
2018-04-16 21:17:19,13205.0,10,1612,-2,13205.0,5,13210.0,18,B
2018-04-16 21:17:19,13205.0,10,1622,-6,13200.0,1,13210.0,18,B
2018-04-16 21:17:20,13200.0,2,1624,0,13200.0,1,13205.0,1,S
2018-04-16 21:17:24,13200.0,2,1626,0,13195.0,2,13200.0,2,S
2018-04-16 21:17:25,13185.0,8,1634,2,13185.0,7,13190.0,2,S
2018-04-16 21:17:27,13190.0,4,1638,0,13185.0,6,13195.0,4,B
2018-04-16 21:17:28,13195.0,4,1642,2,13195.0,2,13200.0,12,B
2018-04-16 21:17:30,13195.0,4,1646,0,13190.0,3,13200.0,10,B
2018-04-16 21:17:35,13190.0,4,1650,0,13185.0,12,13200.0,21,S
2018-04-16 21:17:40,13195.0,4,1654,4,13190.0,4,13200.0,21,B
2018-04-16 21:17:43,13195.0,2,1656,2,13195.0,1,13200.0,8,B
2018-04-16 21:17:47,13195.0,2,1658,2,13190.0,4,13195.0,3,B
2018-04-16 21:17:47,13195.0,4,1662,2,13190.0,4,13195.0,1,B
2018-04-16 21:18:00,13195.0,2,1664,2,13190.0,4,13195.0,1,B
2018-04-16 21:18:00,13195.0,2,1666,-2,13195.0,1,13200.0,21,B
2018-04-16 21:18:01,13200.0,4,1670,4,13195.0,1,13200.0,23,B
2018-04-16 21:18:01,13200.0,2,1672,2,13195.0,1,13200.0,17,B
2018-04-16 21:18:02,13200.0,32,1704,4,13195.0,7,13200.0,1,B
2018-04-16 21:18:02,13200.0,2,1706,2,13200.0,6,13205.0,6,B
2018-04-16 21:18:04,13200.0,4,1710,0,13200.0,4,13205.0,8,B
2018-04-16 21:18:05,13205.0,6,1716,6,13200.0,2,13205.0,7,B
2018-04-16 21:18:07,13205.0,2,1718,-2,13200.0,3,13205.0,3,B
2018-04-16 21:18:08,13200.0,2,1720,2,13200.0,2,13205.0,3,S
2018-04-16 21:18:15,13210.0,2,1722,2,13200.0,5,13210.0,7,B
2018-04-16 21:18:22,13210.0,2,1724,-2,13200.0,2,13205.0,3,B
2018-04-16 21:18:24,13205.0,2,1726,-2,13200.0,2,13205.0,2,S
2018-04-16 21:18:33,13200.0,4,1730,4,13200.0,1,13205.0,3,S
2018-04-16 21:18:40,13205.0,4,1734,0,13200.0,5,13205.0,1,B
2018-04-16 21:18:41,13205.0,2,1736,0,13205.0,1,13210.0,7,B
2018-04-16 21:18:41,13210.0,8,1744,6,13205.0,1,13215.0,9,B
2018-04-16 21:18:52,13205.0,2,1746,2,13200.0,8,13210.0,3,S
2018-04-16 21:19:03,13205.0,2,1748,-2,13205.0,5,13210.0,7,S
2018-04-16 21:19:04,13205.0,10,1758,-10,13200.0,2,13205.0,5,S
2018-04-16 21:19:18,13200.0,2,1760,0,13195.0,7,13200.0,1,S
2018-04-16 21:19:18,13200.0,2,1762,0,13195.0,7,13200.0,1,S
2018-04-16 21:19:22,13195.0,4,1766,0,13195.0,5,13205.0,17,S
2018-04-16 21:19:23,13195.0,2,1768,0,13195.0,4,13205.0,18,S
2018-04-16 21:19:30,13200.0,2,1770,0,13200.0,1,13205.0,2,B
2018-04-16 21:19:43,13205.0,2,1772,2,13200.0,5,13205.0,1,B
2018-04-16 21:19:43,13205.0,2,1774,2,13205.0,3,13210.0,24,B
2018-04-16 21:19:44,13205.0,2,1776,2,13205.0,2,13210.0,20,B
2018-04-16 21:19:45,13205.0,4,1780,-2,13200.0,5,13205.0,1,B
2018-04-16 21:19:53,13200.0,4,1784,0,13200.0,3,13205.0,1,S
2018-04-16 21:19:56,13200.0,2,1786,0,13195.0,9,13205.0,7,S
2018-04-16 21:20:08,13195.0,6,1792,0,13190.0,4,13200.0,2,S
2018-04-16 21:20:10,13200.0,4,1796,0,13195.0,2,13205.0,12,B
2018-04-16 21:20:14,13200.0,2,1798,0,13200.0,1,13205.0,12,B
2018-04-16 21:20:40,13200.0,2,1800,2,13200.0,2,13205.0,13,B
2018-04-16 21:20:42,13205.0,8,1808,-2,13200.0,5,13205.0,4,B
2018-04-16 21:20:43,13205.0,8,1816,2,13200.0,6,13210.0,12,B
2018-04-16 21:20:47,13205.0,14,1830,8,13200.0,10,13205.0,13,B
2018-04-16 21:20:48,13205.0,4,1834,0,13200.0,10,13205.0,11,B
2018-04-16 21:20:57,13205.0,22,1856,20,13205.0,14,13210.0,7,B
2018-04-16 21:20:58,13210.0,2,1858,-2,13205.0,10,13210.0,6,B
2018-04-16 21:21:00,13210.0,6,1864,2,13205.0,7,13210.0,3,B
2018-04-16 21:21:02,13210.0,6,1870,6,13205.0,6,13215.0,9,B
2018-04-16 21:21:03,13210.0,2,1872,0,13205.0,7,13215.0,7,B
2018-04-16 21:21:21,13215.0,8,1880,4,13210.0,1,13215.0,1,B
2018-04-16 21:21:21,13215.0,2,1882,2,13210.0,1,13220.0,6,B
2018-04-16 21:21:23,13215.0,2,1884,2,13215.0,29,13220.0,9,B
2018-04-16 21:21:26,13215.0,4,1888,4,13215.0,27,13220.0,11,B
2018-04-16 21:21:28,13215.0,8,1896,0,13215.0,23,13220.0,13,B
2018-04-16 21:21:33,13220.0,6,1902,-6,13215.0,23,13220.0,12,B
2018-04-16 21:21:34,13215.0,2,1904,0,13215.0,22,13220.0,11,S
2018-04-16 21:21:34,13220.0,2,1906,-2,13215.0,22,13220.0,10,B
2018-04-16 21:21:56,13215.0,2,1908,2,13215.0,21,13220.0,10,S
2018-04-16 21:21:58,13215.0,6,1914,0,13215.0,18,13220.0,8,S
2018-04-16 21:21:58,13215.0,36,1950,30,13210.0,4,13215.0,8,S
2018-04-16 21:22:03,13210.0,2,1952,2,13205.0,4,13210.0,3,S
2018-04-16 21:22:08,13215.0,2,1954,0,13205.0,8,13215.0,16,B
2018-04-16 21:22:10,13205.0,2,1956,2,13205.0,7,13215.0,15,S
2018-04-16 21:22:10,13215.0,2,1958,2,13205.0,7,13215.0,14,B
2018-04-16 21:22:12,13205.0,2,1960,2,13205.0,6,13215.0,14,S
2018-04-16 21:22:14,13205.0,2,1962,0,13205.0,5,13215.0,15,S
2018-04-16 21:22:21,13205.0,2,1964,0,13205.0,4,13210.0,3,S
2018-04-16 21:22:29,13210.0,6,1970,-6,13210.0,3,13215.0,9,B
2018-04-16 21:22:30,13215.0,12,1982,-10,13210.0,6,13215.0,3,B
2018-04-16 21:22:35,13210.0,6,1988,0,13205.0,2,13215.0,6,S
2018-04-16 21:22:38,13215.0,10,1998,-4,13210.0,5,13220.0,9,B
2018-04-16 21:22:46,13215.0,4,2002,2,13210.0,4,13220.0,14,B
2018-04-16 21:22:49,13215.0,2,2004,0,13210.0,5,13215.0,1,B
2018-04-16 21:22:58,13220.0,4,2008,2,13215.0,3,13220.0,22,B
2018-04-16 21:23:08,13215.0,6,2014,4,13210.0,5,13215.0,2,S
2018-04-16 21:23:28,13210.0,2,2016,2,13210.0,1,13215.0,3,S
2018-04-16 21:23:40,13210.0,8,2024,-2,13205.0,10,13215.0,4,S
2018-04-16 21:23:43,13210.0,2,2026,2,13210.0,1,13215.0,4,S
2018-04-16 21:23:57,13210.0,4,2030,4,13205.0,10,13215.0,1,S
2018-04-16 21:23:59,13205.0,2,2032,2,13205.0,9,13215.0,2,S
2018-04-16 21:24:15,13205.0,8,2040,-2,13200.0,9,13205.0,1,S
2018-04-16 21:24:21,13205.0,2,2042,0,13200.0,18,13205.0,1,S
2018-04-16 21:24:23,13205.0,2,2044,-2,13200.0,17,13210.0,6,S
2018-04-16 21:24:24,13205.0,2,2046,0,13200.0,18,13210.0,6,S
2018-04-16 21:24:28,13205.0,2,2048,0,13200.0,18,13210.0,6,S
2018-04-16 21:24:30,13205.0,2,2050,2,13200.0,18,13210.0,5,S
2018-04-16 21:24:59,13200.0,12,2062,-2,13200.0,11,13210.0,5,S
2018-04-16 21:25:02,13210.0,4,2066,2,13200.0,11,13210.0,5,B
2018-04-16 21:25:17,13210.0,4,2070,-2,13205.0,11,13215.0,7,B
2018-04-16 21:25:41,13205.0,2,2072,0,13205.0,4,13210.0,5,S
2018-04-16 21:26:07,13210.0,4,2076,2,13205.0,6,13215.0,4,B
2018-04-16 21:26:31,13205.0,2,2078,0,13205.0,5,13215.0,8,S
2018-04-16 21:26:40,13210.0,2,2080,2,13205.0,5,13215.0,8,B
2018-04-16 21:26:42,13215.0,4,2084,0,13205.0,5,13215.0,6,B
2018-04-16 21:27:16,13210.0,2,2086,0,13210.0,6,13215.0,5,S
2018-04-16 21:27:26,13215.0,8,2094,6,13210.0,6,13215.0,1,B
2018-04-16 21:27:33,13215.0,2,2096,0,13210.0,7,13220.0,26,B
2018-04-16 21:27:45,13215.0,2,2098,2,13215.0,4,13220.0,43,B
2018-04-16 21:27:46,13220.0,8,2106,4,13215.0,4,13220.0,41,B
2018-04-16 21:27:49,13215.0,2,2108,0,13215.0,4,13220.0,29,S
2018-04-16 21:27:53,13215.0,2,2110,0,13215.0,4,13220.0,29,S
2018-04-16 21:28:01,13215.0,2,2112,0,13215.0,3,13220.0,30,S
2018-04-16 21:28:01,13215.0,6,2118,0,13210.0,8,13220.0,30,S
2018-04-16 21:28:03,13210.0,4,2122,2,13210.0,3,13215.0,21,S
2018-04-16 21:28:04,13210.0,6,2128,-6,13205.0,2,13210.0,1,S
2018-04-16 21:28:05,13205.0,4,2132,2,13200.0,5,13210.0,7,S
2018-04-16 21:28:15,13210.0,4,2136,2,13205.0,2,13210.0,5,B
2018-04-16 21:28:17,13210.0,2,2138,0,13205.0,2,13210.0,4,B
2018-04-16 21:28:42,13205.0,4,2142,0,13200.0,6,13210.0,6,S
2018-04-16 21:28:48,13200.0,4,2146,0,13195.0,10,13205.0,6,S
2018-04-16 21:28:58,13195.0,2,2148,0,13195.0,12,13205.0,7,S
2018-04-16 21:29:09,13200.0,2,2150,-2,13195.0,12,13200.0,4,B
2018-04-16 21:29:21,13195.0,18,2168,-12,13190.0,4,13200.0,6,S
2018-04-16 21:29:22,13195.0,2,2170,0,13190.0,2,13195.0,6,S
2018-04-16 21:29:23,13190.0,4,2174,0,13185.0,5,13190.0,1,S
2018-04-16 21:29:31,13185.0,2,2176,0,13185.0,4,13190.0,4,S
2018-04-16 21:29:32,13185.0,8,2184,4,13180.0,3,13185.0,3,S
2018-04-16 21:29:36,13190.0,2,2186,2,13185.0,15,13195.0,10,B
2018-04-16 21:29:44,13185.0,4,2190,-2,13185.0,13,13190.0,3,S
2018-04-16 21:29:45,13190.0,4,2194,0,13190.0,15,13195.0,7,B
2018-04-16 21:29:48,13195.0,4,2198,4,13190.0,16,13195.0,2,B
2018-04-16 21:29:50,13190.0,2,2200,2,13190.0,12,13195.0,2,S
2018-04-16 21:29:52,13190.0,24,2224,-2,13185.0,9,13190.0,18,S
2018-04-16 21:29:53,13190.0,12,2236,-8,13185.0,8,13190.0,12,S
2018-04-16 21:29:53,13190.0,2,2238,-2,13185.0,12,13190.0,11,S
2018-04-16 21:29:58,13185.0,2,2240,0,13185.0,4,13190.0,11,S
2018-04-16 21:30:02,13190.0,2,2242,0,13185.0,4,13190.0,10,B
2018-04-16 21:30:07,13190.0,14,2256,0,13185.0,11,13190.0,4,B
2018-04-16 21:30:07,13190.0,8,2264,-6,13190.0,10,13195.0,6,B
2018-04-16 21:30:10,13190.0,2,2266,2,13190.0,6,13195.0,3,B
2018-04-16 21:30:15,13195.0,2,2268,2,13190.0,6,13195.0,1,B
2018-04-16 21:30:19,13195.0,2,2270,2,13195.0,2,13200.0,2,B
2018-04-16 21:30:20,13200.0,4,2274,2,13195.0,2,13200.0,6,B
2018-04-16 21:30:20,13200.0,8,2282,2,13195.0,4,13205.0,4,B
2018-04-16 21:30:21,13195.0,6,2288,2,13195.0,8,13210.0,18,S
2018-04-16 21:30:26,13200.0,4,2292,2,13200.0,4,13205.0,1,B
2018-04-16 21:30:31,13195.0,2,2294,0,13195.0,4,13205.0,4,S
2018-04-16 21:30:31,13205.0,2,2296,0,13195.0,4,13205.0,1,B
2018-04-16 21:30:32,13200.0,4,2300,4,13200.0,2,13210.0,26,S
2018-04-16 21:30:33,13205.0,2,2302,0,13200.0,8,13210.0,25,B
2018-04-16 21:30:34,13200.0,8,2310,8,13200.0,4,13210.0,24,S
2018-04-16 21:30:37,13205.0,2,2312,2,13200.0,4,13205.0,1,B
2018-04-16 21:30:39,13200.0,2,2314,0,13200.0,3,13205.0,1,S
2018-04-16 21:30:40,13200.0,2,2316,2,13200.0,2,13205.0,1,S
2018-04-16 21:30:42,13200.0,4,2320,4,13195.0,25,13205.0,1,S
2018-04-16 21:30:46,13205.0,2,2322,0,13200.0,7,13205.0,2,B
2018-04-16 21:30:47,13200.0,6,2328,2,13200.0,26,13210.0,31,S
2018-04-16 21:30:49,13205.0,2,2330,0,13200.0,14,13210.0,28,B
2018-04-16 21:30:55,13210.0,2,2332,0,13205.0,1,13210.0,27,B
2018-04-16 21:30:59,13210.0,54,2386,28,13210.0,3,13215.0,9,B
2018-04-16 21:30:59,13210.0,4,2390,4,13210.0,1,13215.0,11,B
2018-04-16 21:31:00,13210.0,2,2392,0,13205.0,3,13215.0,11,B
2018-04-16 21:31:04,13210.0,2,2394,2,13205.0,3,13210.0,1,B
2018-04-16 21:31:05,13205.0,4,2398,2,13205.0,1,13210.0,3,S
2018-04-16 21:31:07,13210.0,2,2400,2,13200.0,18,13210.0,2,B
2018-04-16 21:31:13,13200.0,2,2402,0,13200.0,21,13210.0,7,S
2018-04-16 21:31:15,13200.0,2,2404,2,13200.0,20,13210.0,8,S
2018-04-16 21:31:21,13200.0,2,2406,2,13200.0,4,13210.0,12,S
2018-04-16 21:31:26,13200.0,2,2408,2,13200.0,2,13205.0,2,S
2018-04-16 21:31:32,13200.0,2,2410,2,13200.0,7,13205.0,1,S
2018-04-16 21:31:35,13200.0,4,2414,2,13200.0,6,13210.0,15,S
2018-04-16 21:31:36,13210.0,4,2418,0,13200.0,18,13210.0,10,B
2018-04-16 21:31:41,13205.0,6,2424,6,13205.0,6,13210.0,9,S
2018-04-16 21:31:50,13205.0,6,2430,6,13205.0,3,13210.0,9,S
2018-04-16 21:31:56,13205.0,2,2432,0,13205.0,2,13210.0,14,S
2018-04-16 21:32:04,13205.0,2,2434,2,13200.0,29,13210.0,15,S
2018-04-16 21:32:07,13205.0,2,2436,2,13200.0,14,13205.0,10,S
2018-04-16 21:32:07,13200.0,2,2438,0,13200.0,13,13205.0,5,S
2018-04-16 21:32:19,13200.0,26,2464,6,13195.0,6,13200.0,35,S
2018-04-16 21:32:38,13195.0,2,2466,2,13195.0,16,13200.0,35,S
2018-04-16 21:32:39,13195.0,6,2472,0,13195.0,13,13200.0,35,S
2018-04-16 21:32:41,13195.0,2,2474,0,13195.0,12,13200.0,35,S
2018-04-16 21:32:50,13195.0,2,2476,2,13195.0,11,13200.0,37,S
2018-04-16 21:32:55,13200.0,10,2486,4,13195.0,8,13200.0,37,B
2018-04-16 21:32:55,13195.0,14,2500,10,13195.0,1,13200.0,41,S
2018-04-16 21:32:56,13195.0,2,2502,0,13190.0,5,13200.0,42,S
2018-04-16 21:32:59,13195.0,2,2504,2,13190.0,5,13200.0,42,S
2018-04-16 21:33:16,13200.0,10,2514,10,13190.0,10,13200.0,42,B
2018-04-16 21:33:19,13200.0,84,2598,78,13200.0,8,13205.0,20,B
2018-04-16 21:33:19,13200.0,16,2614,16,13195.0,2,13200.0,7,B
2018-04-16 21:33:26,13190.0,4,2618,0,13190.0,13,13200.0,10,S
2018-04-16 21:33:31,13190.0,20,2638,-6,13190.0,3,13200.0,10,S
2018-04-16 21:33:51,13190.0,2,2640,0,13190.0,5,13200.0,15,S
2018-04-16 21:34:11,13190.0,2,2642,0,13190.0,7,13195.0,3,S
2018-04-16 21:34:16,13195.0,6,2648,0,13195.0,3,13200.0,12,B
2018-04-16 21:34:18,13195.0,2,2650,0,13195.0,4,13200.0,5,B
2018-04-16 21:34:20,13200.0,2,2652,0,13195.0,3,13200.0,4,B
2018-04-16 21:34:31,13200.0,2,2654,2,13195.0,6,13200.0,2,B
2018-04-16 21:34:32,13200.0,4,2658,2,13195.0,6,13205.0,28,B
2018-04-16 21:34:49,13200.0,2,2660,-2,13195.0,9,13205.0,19,B
2018-04-16 21:34:57,13200.0,2,2662,-2,13195.0,9,13205.0,19,B
2018-04-16 21:35:00,13200.0,2,2664,2,13195.0,9,13205.0,19,B
2018-04-16 21:35:05,13200.0,6,2670,6,13200.0,2,13205.0,19,B
2018-04-16 21:35:08,13200.0,2,2672,2,13200.0,1,13205.0,19,B
2018-04-16 21:35:09,13200.0,2,2674,2,13195.0,6,13205.0,17,B
2018-04-16 21:35:19,13195.0,4,2678,0,13195.0,5,13200.0,50,S
2018-04-16 21:35:25,13195.0,2,2680,0,13195.0,5,13200.0,53,S
2018-04-16 21:35:32,13200.0,2,2682,0,13195.0,3,13200.0,52,B
2018-04-16 21:35:39,13195.0,2,2684,2,13195.0,1,13200.0,60,S
2018-04-16 21:35:39,13195.0,2,2686,2,13190.0,22,13200.0,60,S
2018-04-16 21:35:40,13195.0,2,2688,-2,13195.0,1,13200.0,60,S
2018-04-16 21:35:53,13190.0,2,2690,0,13190.0,5,13195.0,4,S
2018-04-16 21:35:57,13190.0,8,2698,6,13190.0,2,13195.0,54,S
2018-04-16 21:35:57,13190.0,4,2702,-2,13190.0,1,13195.0,54,S
2018-04-16 21:35:58,13190.0,2,2704,-2,13185.0,20,13195.0,54,S
2018-04-16 21:35:59,13190.0,2,2706,0,13190.0,1,13195.0,55,S
2018-04-16 21:36:04,13195.0,2,2708,2,13190.0,4,13195.0,52,B
2018-04-16 21:36:06,13195.0,16,2724,-8,13190.0,4,13195.0,44,B
2018-04-16 21:36:07,13195.0,16,2740,-14,13190.0,22,13195.0,36,B
2018-04-16 21:36:07,13195.0,34,2774,-24,13190.0,26,13195.0,19,B
2018-04-16 21:36:08,13190.0,22,2796,-18,13190.0,25,13195.0,9,S
2018-04-16 21:36:08,13195.0,8,2804,-8,13190.0,25,13195.0,5,B
2018-04-16 21:36:09,13195.0,10,2814,0,13195.0,1,13200.0,17,B
2018-04-16 21:36:11,13190.0,22,2836,18,13190.0,17,13200.0,15,S
2018-04-16 21:36:15,13190.0,2,2838,0,13190.0,12,13200.0,15,S
2018-04-16 21:36:19,13195.0,2,2840,0,13190.0,26,13200.0,16,B
2018-04-16 21:36:33,13190.0,20,2860,14,13190.0,19,13200.0,16,S
2018-04-16 21:36:50,13195.0,4,2864,0,13190.0,12,13195.0,7,B
2018-04-16 21:36:59,13195.0,2,2866,2,13190.0,12,13195.0,4,B
2018-04-16 21:37:02,13195.0,2,2868,0,13190.0,12,13195.0,4,B
2018-04-16 21:37:11,13190.0,16,2884,0,13190.0,4,13195.0,8,S
2018-04-16 21:37:23,13190.0,2,2886,0,13190.0,5,13195.0,10,S
2018-04-16 21:37:30,13190.0,2,2888,-2,13190.0,4,13195.0,59,S
2018-04-16 21:37:37,13190.0,4,2892,0,13190.0,2,13195.0,59,S
2018-04-16 21:37:46,13190.0,2,2894,2,13190.0,1,13195.0,59,S
2018-04-16 21:37:46,13190.0,2,2896,-2,13185.0,16,13195.0,59,S
2018-04-16 21:38:01,13185.0,4,2900,0,13180.0,6,13190.0,6,S
2018-04-16 21:38:19,13180.0,2,2902,0,13180.0,4,13185.0,6,S
2018-04-16 21:38:24,13185.0,6,2908,0,13180.0,23,13185.0,4,B
2018-04-16 21:38:25,13180.0,2,2910,2,13180.0,22,13185.0,4,S
2018-04-16 21:38:27,13180.0,6,2916,4,13180.0,17,13185.0,6,S
2018-04-16 21:38:28,13180.0,2,2918,2,13180.0,16,13185.0,5,S
2018-04-16 21:38:32,13185.0,2,2920,0,13180.0,16,13185.0,4,B
2018-04-16 21:38:33,13180.0,2,2922,2,13180.0,15,13185.0,4,S
2018-04-16 21:38:34,13185.0,2,2924,2,13180.0,15,13185.0,3,B
2018-04-16 21:38:38,13185.0,2,2926,2,13180.0,15,13185.0,2,B
2018-04-16 21:38:40,13185.0,6,2932,2,13180.0,16,13190.0,13,B
2018-04-16 21:38:41,13190.0,4,2936,2,13180.0,19,13190.0,14,B
2018-04-16 21:38:42,13185.0,2,2938,2,13180.0,21,13190.0,14,S
2018-04-16 21:38:51,13180.0,2,2940,2,13180.0,22,13190.0,15,S
2018-04-16 21:38:57,13180.0,4,2944,2,13180.0,19,13190.0,15,S
2018-04-16 21:39:03,13190.0,6,2950,2,13180.0,20,13190.0,14,B
2018-04-16 21:39:12,13190.0,2,2952,0,13185.0,6,13190.0,7,B
2018-04-16 21:39:19,13185.0,4,2956,4,13180.0,20,13185.0,3,S
2018-04-16 21:39:21,13185.0,2,2958,0,13180.0,15,13185.0,4,S
2018-04-16 21:39:22,13180.0,6,2964,2,13175.0,5,13180.0,3,S
2018-04-16 21:39:22,13180.0,2,2966,2,13175.0,18,13180.0,2,S
2018-04-16 21:39:23,13180.0,4,2970,0,13175.0,18,13185.0,10,S
2018-04-16 21:39:26,13180.0,4,2974,0,13175.0,16,13185.0,10,S
2018-04-16 21:39:28,13175.0,2,2976,0,13175.0,18,13185.0,10,S
2018-04-16 21:39:29,13175.0,8,2984,-8,13170.0,5,13175.0,6,S
2018-04-16 21:39:31,13175.0,2,2986,-2,13170.0,17,13175.0,6,S
2018-04-16 21:39:32,13175.0,12,2998,-8,13175.0,8,13180.0,3,S
2018-04-16 21:39:32,13180.0,4,3002,-4,13175.0,8,13185.0,12,B
2018-04-16 21:39:33,13180.0,2,3004,0,13175.0,21,13185.0,16,B
2018-04-16 21:39:43,13175.0,4,3008,2,13170.0,11,13175.0,1,S
2018-04-16 21:39:49,13175.0,8,3016,-4,13175.0,1,13180.0,10,S
2018-04-16 21:39:50,13180.0,6,3022,-4,13170.0,27,13180.0,3,B
2018-04-16 21:39:50,13180.0,4,3026,4,13175.0,12,13185.0,10,B
2018-04-16 21:39:51,13175.0,6,3032,-4,13175.0,9,13185.0,9,S
2018-04-16 21:39:55,13175.0,12,3044,12,13175.0,2,13180.0,10,S
2018-04-16 21:39:55,13175.0,4,3048,0,13170.0,20,13180.0,11,S
2018-04-16 21:39:58,13180.0,4,3052,2,13170.0,20,13180.0,9,B
2018-04-16 21:40:17,13175.0,2,3054,-2,13175.0,5,13180.0,1,S
2018-04-16 21:40:18,13180.0,2,3056,0,13175.0,5,13185.0,16,B
2018-04-16 21:40:25,13175.0,16,3072,12,13175.0,1,13185.0,13,S
2018-04-16 21:40:25,13185.0,6,3078,0,13175.0,4,13185.0,10,B
2018-04-16 21:40:26,13185.0,2,3080,-2,13180.0,4,13190.0,17,B
2018-04-16 21:40:27,13190.0,6,3086,2,13180.0,7,13190.0,16,B
2018-04-16 21:40:28,13185.0,2,3088,-2,13180.0,6,13190.0,17,S
2018-04-16 21:40:39,13185.0,2,3090,-2,13180.0,13,13190.0,18,S
2018-04-16 21:40:52,13190.0,2,3092,2,13185.0,1,13190.0,17,B
2018-04-16 21:40:54,13185.0,2,3094,-2,13180.0,13,13190.0,17,S
2018-04-16 21:41:16,13185.0,2,3096,0,13180.0,13,13190.0,18,S
2018-04-16 21:41:25,13175.0,2,3098,2,13175.0,13,13185.0,10,S
2018-04-16 21:41:34,13185.0,10,3108,4,13175.0,13,13185.0,3,B
2018-04-16 21:41:58,13185.0,2,3110,0,13180.0,6,13190.0,17,B
2018-04-16 21:42:02,13185.0,2,3112,0,13180.0,7,13190.0,17,B
2018-04-16 21:42:12,13180.0,14,3126,6,13175.0,16,13185.0,1,S
2018-04-16 21:42:34,13170.0,32,3158,-24,13165.0,3,13170.0,34,S
2018-04-16 21:42:34,13165.0,16,3174,-8,13165.0,10,13170.0,27,S
2018-04-16 21:42:35,13170.0,2,3176,-2,13165.0,18,13170.0,26,B
2018-04-16 21:42:35,13170.0,2,3178,-2,13165.0,17,13170.0,25,B
2018-04-16 21:42:36,13170.0,4,3182,-2,13165.0,15,13170.0,23,B
2018-04-16 21:42:36,13170.0,2,3184,-2,13165.0,17,13170.0,22,B
2018-04-16 21:42:37,13170.0,2,3186,-2,13165.0,18,13170.0,21,B
2018-04-16 21:42:37,13170.0,2,3188,-2,13165.0,18,13170.0,20,B
2018-04-16 21:42:38,13170.0,2,3190,-2,13165.0,18,13170.0,19,B
2018-04-16 21:42:38,13170.0,2,3192,-2,13165.0,18,13170.0,18,B
2018-04-16 21:42:39,13170.0,4,3196,-2,13165.0,18,13170.0,16,B
2018-04-16 21:42:39,13170.0,2,3198,-2,13165.0,18,13170.0,15,B
2018-04-16 21:42:40,13170.0,2,3200,-2,13165.0,17,13170.0,14,B
2018-04-16 21:42:40,13170.0,2,3202,-2,13165.0,17,13170.0,13,B
2018-04-16 21:42:41,13170.0,2,3204,-2,13165.0,17,13170.0,12,B
2018-04-16 21:42:41,13170.0,2,3206,-2,13165.0,17,13170.0,11,B
2018-04-16 21:42:42,13170.0,8,3214,-2,13165.0,17,13170.0,7,B
2018-04-16 21:42:42,13170.0,6,3220,-2,13165.0,17,13170.0,4,B
2018-04-16 21:42:44,13170.0,2,3222,0,13165.0,17,13170.0,4,B
2018-04-16 21:42:46,13170.0,16,3238,4,13165.0,12,13170.0,1,B
2018-04-16 21:42:46,13170.0,2,3240,0,13170.0,2,13175.0,4,B
2018-04-16 21:42:49,13170.0,4,3244,4,13170.0,6,13175.0,4,B
2018-04-16 21:42:53,13175.0,8,3252,-2,13175.0,4,13180.0,10,B
2018-04-16 21:42:57,13180.0,6,3258,2,13175.0,2,13180.0,3,B
2018-04-16 21:43:02,13175.0,4,3262,0,13170.0,6,13175.0,3,S
2018-04-16 21:43:02,13175.0,2,3264,2,13170.0,5,13175.0,2,S
2018-04-16 21:43:04,13170.0,2,3266,0,13170.0,6,13175.0,2,S
2018-04-16 21:43:09,13175.0,2,3268,2,13170.0,2,13175.0,5,B
2018-04-16 21:43:10,13170.0,2,3270,0,13170.0,2,13175.0,5,S
2018-04-16 21:43:15,13175.0,10,3280,2,13175.0,3,13180.0,5,B
2018-04-16 21:43:18,13180.0,6,3286,4,13175.0,1,13180.0,2,B
2018-04-16 21:43:43,13180.0,2,3288,2,13180.0,1,13185.0,20,B
2018-04-16 21:43:44,13185.0,4,3292,2,13180.0,1,13185.0,18,B
2018-04-16 21:43:51,13185.0,2,3294,-2,13180.0,3,13185.0,2,B
2018-04-16 21:44:03,13185.0,2,3296,-2,13180.0,4,13185.0,2,B
2018-04-16 21:44:10,13185.0,4,3300,-4,13180.0,5,13190.0,29,B
2018-04-16 21:44:13,13180.0,2,3302,2,13180.0,2,13185.0,3,S
2018-04-16 21:44:13,13180.0,4,3306,-2,13175.0,3,13180.0,1,S
2018-04-16 21:44:19,13175.0,8,3314,4,13170.0,8,13175.0,6,S
2018-04-16 21:44:21,13175.0,2,3316,2,13170.0,8,13175.0,5,S
2018-04-16 21:44:21,13175.0,10,3326,0,13170.0,8,13180.0,5,S
2018-04-16 21:44:25,13180.0,4,3330,0,13175.0,4,13180.0,1,B
2018-04-16 21:44:30,13180.0,2,3332,2,13175.0,4,13185.0,11,B
2018-04-16 21:44:30,13175.0,2,3334,0,13175.0,3,13185.0,11,S
2018-04-16 21:44:32,13185.0,8,3342,6,13175.0,6,13185.0,6,B
2018-04-16 21:44:48,13185.0,6,3348,6,13185.0,2,13190.0,17,B
2018-04-16 21:44:52,13185.0,2,3350,2,13185.0,2,13190.0,17,B
2018-04-16 21:44:53,13185.0,4,3354,4,13180.0,4,13190.0,17,B
2018-04-16 21:45:04,13180.0,4,3358,0,13180.0,2,13185.0,5,S
2018-04-16 21:45:21,13185.0,8,3366,8,13185.0,41,13190.0,17,B
2018-04-16 21:45:22,13185.0,2,3368,2,13185.0,40,13190.0,17,B
2018-04-16 21:45:23,13185.0,2,3370,2,13185.0,39,13190.0,17,B
2018-04-16 21:45:25,13185.0,4,3374,4,13185.0,37,13190.0,17,B
2018-04-16 21:45:25,13185.0,4,3378,0,13185.0,35,13190.0,18,B
2018-04-16 21:45:26,13185.0,2,3380,2,13185.0,34,13190.0,33,B
2018-04-16 21:45:26,13185.0,4,3384,2,13185.0,32,13190.0,33,B
2018-04-16 21:45:27,13185.0,28,3412,28,13185.0,18,13190.0,33,B
2018-04-16 21:45:27,13185.0,36,3448,28,13180.0,6,13190.0,21,B
2018-04-16 21:45:50,13185.0,2,3450,0,13180.0,3,13185.0,1,B
2018-04-16 21:45:54,13180.0,6,3456,0,13175.0,9,13185.0,1,S
2018-04-16 21:46:27,13175.0,2,3458,2,13175.0,13,13185.0,9,S
2018-04-16 21:46:55,13175.0,4,3462,4,13175.0,13,13180.0,9,S
2018-04-16 21:46:58,13175.0,26,3488,0,13170.0,6,13175.0,2,S
2018-04-16 21:46:59,13180.0,24,3512,8,13170.0,9,13180.0,5,B
2018-04-16 21:47:09,13170.0,2,3514,2,13170.0,8,13180.0,7,S
2018-04-16 21:47:19,13170.0,20,3534,-10,13165.0,21,13170.0,5,S
2018-04-16 21:47:19,13170.0,10,3544,-10,13170.0,11,13175.0,4,S
2018-04-16 21:47:22,13180.0,12,3556,-10,13175.0,8,13180.0,2,B
2018-04-16 21:47:24,13180.0,8,3564,8,13175.0,3,13180.0,4,B
2018-04-16 21:47:30,13175.0,8,3572,-8,13175.0,1,13180.0,7,S
2018-04-16 21:47:31,13175.0,4,3576,2,13170.0,10,13175.0,2,S
2018-04-16 21:47:31,13175.0,4,3580,0,13175.0,1,13180.0,7,S
2018-04-16 21:47:36,13180.0,16,3596,10,13180.0,1,13185.0,13,B
2018-04-16 21:47:36,13185.0,8,3604,8,13180.0,2,13185.0,9,B
2018-04-16 21:47:37,13180.0,6,3610,2,13180.0,5,13185.0,2,S
2018-04-16 21:47:49,13180.0,6,3616,2,13175.0,8,13180.0,3,S
2018-04-16 21:48:44,13175.0,2,3618,0,13175.0,4,13180.0,28,S
2018-04-16 21:48:47,13180.0,4,3622,4,13175.0,6,13180.0,26,B
2018-04-16 21:48:47,13180.0,52,3674,-10,13180.0,2,13185.0,6,B
2018-04-16 21:48:48,13185.0,12,3686,4,13180.0,10,13190.0,15,B
2018-04-16 21:48:49,13185.0,2,3688,0,13180.0,9,13190.0,23,B
2018-04-16 21:48:50,13185.0,2,3690,2,13185.0,1,13190.0,21,B
2018-04-16 21:48:56,13185.0,2,3692,2,13180.0,7,13190.0,33,B
2018-04-16 21:49:10,13180.0,6,3698,2,13180.0,3,13185.0,4,S
2018-04-16 21:49:14,13180.0,4,3702,0,13175.0,11,13185.0,6,S
2018-04-16 21:49:15,13175.0,4,3706,4,13170.0,5,13180.0,7,S
2018-04-16 21:49:22,13180.0,2,3708,2,13175.0,1,13180.0,3,B
2018-04-16 21:49:23,13170.0,20,3728,-14,13175.0,1,13180.0,5,S
2018-04-16 21:49:36,13170.0,12,3740,-8,13175.0,1,13180.0,3,S
2018-04-16 21:49:38,13175.0,2,3742,0,13170.0,1,13180.0,3,B
2018-04-16 21:49:41,13175.0,2,3744,0,13170.0,4,13180.0,5,B
2018-04-16 21:49:54,13175.0,4,3748,4,13165.0,9,13175.0,5,B
2018-04-16 21:49:54,13175.0,8,3756,2,13175.0,2,13180.0,46,B
2018-04-16 21:49:55,13175.0,2,3758,0,13175.0,1,13180.0,6,B
2018-04-16 21:50:02,13170.0,4,3762,2,13170.0,4,13180.0,2,S
2018-04-16 21:50:04,13175.0,2,3764,0,13170.0,8,13180.0,5,B
2018-04-16 21:50:12,13175.0,2,3766,0,13170.0,8,13175.0,1,B
2018-04-16 21:50:13,13175.0,2,3768,0,13170.0,8,13180.0,6,B
2018-04-16 21:50:18,13170.0,4,3772,4,13170.0,6,13180.0,6,S
2018-04-16 21:50:34,13170.0,4,3776,2,13165.0,12,13175.0,1,S
2018-04-16 21:50:39,13175.0,2,3778,0,13165.0,15,13175.0,32,B
2018-04-16 21:50:44,13175.0,4,3782,0,13165.0,15,13175.0,33,B
2018-04-16 21:50:44,13175.0,8,3790,0,13165.0,15,13175.0,29,B
2018-04-16 21:50:45,13175.0,8,3798,0,13165.0,15,13175.0,25,B
2018-04-16 21:50:45,13175.0,8,3806,-4,13165.0,40,13175.0,17,B
2018-04-16 21:50:51,13170.0,2,3808,0,13170.0,9,13175.0,14,S
2018-04-16 21:51:14,13175.0,2,3810,0,13170.0,10,13175.0,13,B
2018-04-16 21:51:18,13170.0,2,3812,0,13170.0,9,13175.0,13,S
2018-04-16 21:51:19,13170.0,2,3814,2,13170.0,8,13175.0,13,S
2018-04-16 21:51:21,13175.0,2,3816,0,13170.0,9,13175.0,12,B
2018-04-16 21:51:22,13170.0,2,3818,0,13170.0,8,13175.0,12,S
2018-04-16 21:51:24,13175.0,2,3820,-2,13170.0,8,13175.0,11,B
2018-04-16 21:51:25,13175.0,2,3822,-2,13170.0,8,13175.0,10,B
2018-04-16 21:51:51,13170.0,2,3824,2,13170.0,8,13175.0,10,S
2018-04-16 21:52:03,13175.0,2,3826,0,13170.0,8,13175.0,9,B
2018-04-16 21:52:22,13170.0,18,3844,2,13165.0,14,13175.0,17,S
2018-04-16 21:52:24,13170.0,4,3848,-4,13165.0,9,13175.0,17,S
2018-04-16 21:52:26,13165.0,6,3854,-4,13160.0,9,13170.0,10,S
2018-04-16 21:52:29,13165.0,2,3856,0,13160.0,4,13165.0,5,S
2018-04-16 21:52:29,13160.0,8,3864,-2,13160.0,1,13165.0,5,S
2018-04-16 21:52:30,13160.0,2,3866,2,13155.0,6,13160.0,5,S
2018-04-16 21:52:30,13155.0,4,3870,-2,13155.0,4,13160.0,5,S
2018-04-16 21:52:31,13155.0,4,3874,-2,13155.0,2,13160.0,5,S
2018-04-16 21:52:33,13160.0,10,3884,10,13160.0,2,13165.0,8,B
2018-04-16 21:52:34,13170.0,4,3888,-4,13160.0,12,13170.0,2,B
2018-04-16 21:52:35,13160.0,10,3898,8,13160.0,15,13170.0,1,S
2018-04-16 21:52:58,13170.0,4,3902,0,13165.0,3,13170.0,9,B
2018-04-16 21:53:02,13170.0,2,3904,0,13165.0,3,13170.0,8,B
2018-04-16 21:53:07,13170.0,16,3920,-14,13170.0,3,13175.0,5,B
2018-04-16 21:53:12,13170.0,4,3924,0,13170.0,1,13175.0,4,B
2018-04-16 21:53:13,13170.0,2,3926,-2,13165.0,19,13170.0,2,B
2018-04-16 21:53:21,13170.0,6,3932,0,13165.0,1,13170.0,2,B
2018-04-16 21:53:33,13170.0,6,3938,0,13165.0,2,13170.0,1,B
2018-04-16 21:54:07,13170.0,4,3942,-4,13170.0,2,13175.0,4,B
2018-04-16 21:54:23,13175.0,4,3946,2,13175.0,3,13180.0,19,B
2018-04-16 21:54:26,13175.0,2,3948,0,13175.0,2,13180.0,14,B
2018-04-16 21:54:41,13175.0,8,3956,6,13175.0,6,13180.0,14,B
2018-04-16 21:54:42,13180.0,4,3960,2,13175.0,6,13180.0,12,B
2018-04-16 21:54:44,13180.0,10,3970,4,13175.0,9,13185.0,3,B
2018-04-16 21:54:46,13180.0,2,3972,0,13175.0,9,13185.0,7,B
2018-04-16 21:54:50,13185.0,2,3974,2,13180.0,5,13185.0,1,B
2018-04-16 21:54:55,13185.0,2,3976,2,13180.0,7,13190.0,16,B
2018-04-16 21:55:01,13190.0,12,3988,-2,13180.0,6,13190.0,10,B
2018-04-16 21:55:10,13185.0,10,3998,10,13180.0,5,13185.0,8,S
2018-04-16 21:56:12,13185.0,10,4008,8,13180.0,4,13190.0,10,S
2018-04-16 21:56:52,13190.0,2,4010,2,13185.0,7,13190.0,4,B
2018-04-16 21:56:57,13190.0,6,4016,6,13185.0,7,13190.0,1,B
2018-04-16 21:56:57,13190.0,2,4018,0,13185.0,7,13195.0,15,B
2018-04-16 21:57:10,13185.0,2,4020,0,13185.0,3,13195.0,9,S
2018-04-16 21:57:18,13195.0,4,4024,2,13185.0,3,13195.0,12,B
2018-04-16 21:57:28,13190.0,2,4026,-2,13185.0,3,13195.0,14,S
2018-04-16 21:57:54,13190.0,4,4030,2,13190.0,1,13195.0,25,S
2018-04-16 21:58:05,13190.0,2,4032,0,13190.0,1,13195.0,14,S
2018-04-16 21:58:13,13190.0,2,4034,-2,13185.0,4,13195.0,19,S
2018-04-16 21:58:15,13185.0,2,4036,2,13185.0,1,13190.0,16,S
2018-04-16 21:58:16,13185.0,2,4038,0,13180.0,5,13185.0,1,S
2018-04-16 21:58:20,13180.0,4,4042,0,13180.0,1,13185.0,1,S
2018-04-16 21:58:24,13180.0,4,4046,2,13180.0,4,13190.0,4,S
2018-04-16 21:58:35,13185.0,2,4048,0,13180.0,3,13190.0,9,B
2018-04-16 21:58:39,13180.0,2,4050,-2,13175.0,7,13180.0,1,S
2018-04-16 21:59:09,13180.0,2,4052,0,13180.0,6,13185.0,1,S
2018-04-16 21:59:14,13180.0,12,4064,0,13175.0,7,13180.0,34,S
2018-04-16 21:59:14,13180.0,4,4068,2,13175.0,8,13180.0,32,S
2018-04-16 21:59:16,13180.0,8,4076,0,13175.0,5,13180.0,28,S
2018-04-16 21:59:23,13180.0,10,4086,4,13175.0,29,13180.0,23,S
2018-04-16 21:59:23,13180.0,12,4098,4,13175.0,17,13180.0,17,S
2018-04-16 21:59:39,13180.0,2,4100,0,13180.0,1,13185.0,5,S
2018-04-16 21:59:40,13180.0,2,4102,0,13175.0,9,13185.0,5,S
2018-04-16 21:59:51,13180.0,10,4112,6,13175.0,4,13185.0,6,S
2018-04-16 22:00:10,13185.0,2,4114,-2,13180.0,11,13185.0,1,B
2018-04-16 22:00:15,13185.0,2,4116,-2,13185.0,1,13190.0,7,B
2018-04-16 22:00:20,13180.0,2,4118,2,13180.0,10,13185.0,8,S
2018-04-16 22:00:26,13185.0,2,4120,-2,13180.0,7,13185.0,5,B
2018-04-16 22:00:40,13185.0,4,4124,2,13180.0,7,13185.0,1,B
2018-04-16 22:00:49,13185.0,2,4126,2,13185.0,9,13190.0,8,B
2018-04-16 22:00:49,13185.0,2,4128,2,13185.0,8,13190.0,8,B
2018-04-16 22:01:06,13190.0,2,4130,2,13185.0,8,13190.0,5,B
2018-04-16 22:01:14,13185.0,2,4132,2,13185.0,7,13190.0,5,S
2018-04-16 22:01:18,13190.0,2,4134,0,13185.0,7,13190.0,4,B
2018-04-16 22:01:23,13190.0,2,4136,-2,13185.0,7,13195.0,19,B
2018-04-16 22:01:29,13190.0,2,4138,2,13185.0,11,13190.0,1,B
2018-04-16 22:01:30,13190.0,2,4140,2,13185.0,11,13195.0,21,B
2018-04-16 22:01:46,13190.0,4,4144,-4,13190.0,3,13195.0,11,B
2018-04-16 22:01:52,13195.0,6,4150,-2,13190.0,3,13195.0,8,B
2018-04-16 22:01:58,13195.0,18,4168,-12,13195.0,14,13200.0,36,B
2018-04-16 22:01:58,13195.0,12,4180,0,13195.0,8,13200.0,39,B
2018-04-16 22:01:59,13195.0,2,4182,0,13195.0,7,13200.0,28,B
2018-04-16 22:02:02,13195.0,2,4184,0,13195.0,6,13200.0,26,B
2018-04-16 22:02:07,13200.0,20,4204,18,13195.0,6,13200.0,16,B
2018-04-16 22:02:11,13195.0,2,4206,-2,13195.0,5,13200.0,6,S
2018-04-16 22:02:15,13200.0,4,4210,0,13195.0,5,13200.0,4,B
2018-04-16 22:02:16,13200.0,8,4218,4,13195.0,5,13205.0,12,B
2018-04-16 22:02:23,13205.0,6,4224,0,13200.0,12,13205.0,4,B
2018-04-16 22:02:23,13205.0,8,4232,6,13200.0,12,13210.0,14,B
2018-04-16 22:02:25,13210.0,20,4252,4,13205.0,13,13210.0,1,B
2018-04-16 22:02:25,13215.0,14,4266,2,13205.0,13,13215.0,6,B
2018-04-16 22:02:26,13210.0,2,4268,0,13210.0,1,13215.0,6,S
2018-04-16 22:02:27,13210.0,2,4270,0,13205.0,13,13215.0,6,S
2018-04-16 22:02:32,13215.0,12,4282,10,13215.0,1,13220.0,17,B
2018-04-16 22:02:33,13210.0,8,4290,0,13205.0,11,13210.0,3,S
2018-04-16 22:02:34,13205.0,4,4294,0,13200.0,6,13205.0,1,S
2018-04-16 22:02:34,13205.0,2,4296,2,13200.0,8,13210.0,3,S
2018-04-16 22:02:35,13210.0,2,4298,-2,13200.0,7,13210.0,5,B
2018-04-16 22:02:38,13210.0,4,4302,4,13200.0,7,13210.0,8,B
2018-04-16 22:02:41,13210.0,6,4308,2,13200.0,7,13210.0,8,B
2018-04-16 22:02:45,13210.0,6,4314,-6,13205.0,16,13215.0,10,B
2018-04-16 22:02:54,13215.0,2,4316,2,13210.0,1,13215.0,14,B
2018-04-16 22:02:58,13210.0,2,4318,0,13210.0,1,13215.0,14,S
2018-04-16 22:03:05,13215.0,2,4320,2,13210.0,4,13215.0,13,B
2018-04-16 22:03:05,13210.0,8,4328,-6,13205.0,15,13210.0,1,S
2018-04-16 22:03:06,13210.0,2,4330,-2,13205.0,15,13215.0,11,S
2018-04-16 22:03:07,13215.0,4,4334,2,13205.0,16,13215.0,10,B
2018-04-16 22:03:16,13205.0,2,4336,0,13205.0,15,13215.0,14,S
2018-04-16 22:03:30,13205.0,2,4338,-2,13205.0,11,13215.0,20,S
2018-04-16 22:03:36,13205.0,2,4340,2,13205.0,10,13215.0,21,S
2018-04-16 22:03:38,13205.0,2,4342,0,13205.0,9,13215.0,22,S
2018-04-16 22:03:54,13215.0,6,4348,0,13205.0,11,13215.0,21,B
2018-04-16 22:04:01,13210.0,2,4350,-2,13205.0,11,13215.0,21,S
2018-04-16 22:04:11,13205.0,2,4352,0,13205.0,8,13215.0,21,S
2018-04-16 22:04:39,13205.0,2,4354,0,13205.0,9,13215.0,25,S
2018-04-16 22:05:10,13205.0,2,4356,0,13205.0,8,13215.0,27,S
2018-04-16 22:05:15,13205.0,12,4368,-4,13200.0,20,13210.0,1,S
2018-04-16 22:05:32,13200.0,2,4370,0,13200.0,7,13205.0,2,S
2018-04-16 22:05:38,13200.0,4,4374,4,13200.0,5,13205.0,2,S
2018-04-16 22:05:43,13205.0,4,4378,0,13200.0,21,13210.0,8,B
2018-04-16 22:05:44,13205.0,2,4380,-2,13205.0,2,13210.0,6,B
2018-04-16 22:05:44,13205.0,2,4382,0,13205.0,1,13210.0,6,B
2018-04-16 22:05:45,13205.0,2,4384,2,13200.0,18,13210.0,6,B
2018-04-16 22:06:30,13210.0,10,4394,-10,13200.0,8,13210.0,20,B
2018-04-16 22:06:46,13210.0,14,4408,6,13205.0,9,13215.0,13,B
2018-04-16 22:06:57,13210.0,2,4410,0,13205.0,8,13210.0,1,B
2018-04-16 22:07:40,13205.0,2,4412,-2,13200.0,9,13205.0,1,S
2018-04-16 22:08:18,13200.0,2,4414,2,13200.0,5,13205.0,1,S
2018-04-16 22:08:22,13200.0,6,4420,-2,13195.0,6,13200.0,3,S
2018-04-16 22:08:25,13205.0,2,4422,0,13195.0,9,13205.0,36,B
2018-04-16 22:08:33,13195.0,2,4424,0,13195.0,8,13205.0,24,S
2018-04-16 22:08:34,13205.0,2,4426,2,13195.0,8,13205.0,23,B
2018-04-16 22:09:19,13200.0,2,4428,0,13195.0,27,13200.0,10,S
2018-04-16 22:09:32,13200.0,2,4430,2,13195.0,14,13200.0,9,S
2018-04-16 22:09:43,13200.0,4,4434,0,13195.0,14,13200.0,7,S
2018-04-16 22:09:44,13200.0,6,4440,0,13195.0,15,13200.0,4,S
2018-04-16 22:09:49,13195.0,4,4444,0,13195.0,7,13200.0,4,S
2018-04-16 22:09:57,13195.0,2,4446,0,13195.0,6,13200.0,4,S
2018-04-16 22:10:26,13200.0,6,4452,6,13195.0,8,13205.0,7,B
2018-04-16 22:10:27,13205.0,6,4458,6,13195.0,10,13205.0,4,B
2018-04-16 22:10:32,13195.0,2,4460,2,13195.0,7,13205.0,11,S
2018-04-16 22:10:38,13205.0,8,4468,6,13195.0,7,13205.0,12,B
2018-04-16 22:11:11,13205.0,26,4494,12,13195.0,9,13210.0,21,B
2018-04-16 22:11:12,13210.0,26,4520,16,13200.0,1,13210.0,13,B
2018-04-16 22:11:37,13205.0,2,4522,2,13200.0,7,13210.0,14,S
2018-04-16 22:11:37,13210.0,4,4526,2,13200.0,7,13210.0,12,B
2018-04-16 22:11:45,13210.0,6,4532,6,13200.0,7,13210.0,11,B
2018-04-16 22:11:50,13205.0,20,4552,20,13200.0,11,13210.0,8,S
2018-04-16 22:11:51,13210.0,16,4568,4,13210.0,2,13215.0,12,B
2018-04-16 22:11:52,13210.0,4,4572,2,13205.0,1,13210.0,6,B
2018-04-16 22:12:19,13210.0,2,4574,0,13200.0,12,13210.0,4,B
2018-04-16 22:12:38,13200.0,2,4576,-2,13200.0,15,13210.0,10,S
2018-04-16 22:12:50,13205.0,4,4580,4,13200.0,11,13205.0,8,B
2018-04-16 22:13:59,13205.0,6,4586,6,13200.0,26,13205.0,10,B
2018-04-16 22:14:00,13205.0,20,4606,6,13205.0,23,13210.0,5,B
2018-04-16 22:14:08,13210.0,6,4612,4,13205.0,26,13210.0,2,B
2018-04-16 22:14:29,13205.0,18,4630,18,13205.0,14,13210.0,11,S
2018-04-16 22:14:29,13205.0,28,4658,22,13200.0,7,13205.0,15,S
2018-04-16 22:14:30,13205.0,4,4662,0,13200.0,3,13205.0,7,S
2018-04-16 22:14:41,13205.0,12,4674,-6,13200.0,3,13205.0,5,S
2018-04-16 22:14:45,13205.0,2,4676,0,13200.0,3,13205.0,7,S
2018-04-16 22:14:57,13200.0,8,4684,6,13195.0,5,13200.0,2,S
2018-04-16 22:15:00,13200.0,2,4686,0,13195.0,6,13205.0,18,S
2018-04-16 22:15:14,13195.0,4,4690,4,13195.0,3,13200.0,4,S
2018-04-16 22:15:38,13195.0,6,4696,-6,13190.0,17,13200.0,14,S
2018-04-16 22:15:50,13190.0,2,4698,2,13190.0,2,13195.0,2,S
2018-04-16 22:15:50,13190.0,4,4702,2,13185.0,5,13190.0,1,S
2018-04-16 22:16:14,13190.0,2,4704,-2,13190.0,15,13200.0,9,S
2018-04-16 22:16:20,13190.0,4,4708,2,13190.0,15,13200.0,9,S
2018-04-16 22:16:51,13200.0,16,4724,6,13195.0,19,13200.0,2,B
2018-04-16 22:16:52,13200.0,4,4728,0,13200.0,2,13205.0,4,B
2018-04-16 22:16:55,13200.0,4,4732,-4,13200.0,2,13205.0,2,B
2018-04-16 22:17:13,13195.0,4,4736,2,13190.0,7,13195.0,6,S
2018-04-16 22:17:15,13195.0,2,4738,2,13190.0,6,13195.0,3,S
2018-04-16 22:17:38,13190.0,12,4750,2,13190.0,1,13195.0,7,S
2018-04-16 22:17:39,13190.0,2,4752,2,13185.0,6,13195.0,19,S
2018-04-16 22:17:48,13190.0,2,4754,2,13185.0,6,13195.0,4,S
2018-04-16 22:17:50,13190.0,2,4756,0,13185.0,14,13195.0,4,S
2018-04-16 22:17:56,13195.0,4,4760,0,13190.0,21,13195.0,1,B
2018-04-16 22:17:57,13195.0,2,4762,0,13190.0,23,13200.0,11,B
2018-04-16 22:18:09,13195.0,2,4764,0,13190.0,4,13195.0,1,B
2018-04-16 22:18:20,13195.0,2,4766,0,13190.0,3,13200.0,19,B
2018-04-16 22:18:21,13190.0,2,4768,2,13185.0,6,13195.0,18,S
2018-04-16 22:18:35,13190.0,2,4770,0,13185.0,7,13195.0,7,S
2018-04-16 22:18:54,13195.0,4,4774,0,13195.0,2,13200.0,6,B
2018-04-16 22:18:54,13195.0,4,4778,0,13190.0,14,13200.0,3,B
2018-04-16 22:19:24,13195.0,2,4780,2,13195.0,2,13200.0,4,B
2018-04-16 22:19:40,13200.0,2,4782,0,13195.0,3,13200.0,3,B
2018-04-16 22:19:43,13195.0,2,4784,0,13195.0,1,13200.0,3,S
2018-04-16 22:19:58,13200.0,4,4788,0,13195.0,1,13205.0,18,B
2018-04-16 22:20:15,13195.0,2,4790,2,13195.0,28,13205.0,6,S
2018-04-16 22:20:35,13205.0,6,4796,0,13205.0,2,13210.0,10,B
2018-04-16 22:20:35,13205.0,4,4800,-2,13200.0,5,13210.0,12,B
2018-04-16 22:20:43,13200.0,6,4806,0,13195.0,3,13205.0,9,S
2018-04-16 22:20:46,13200.0,4,4810,-4,13195.0,4,13200.0,2,S
2018-04-16 22:21:37,13195.0,2,4812,0,13190.0,9,13200.0,8,S
2018-04-16 22:21:48,13195.0,8,4820,-4,13190.0,10,13200.0,8,S
2018-04-16 22:22:11,13200.0,10,4830,4,13190.0,4,13200.0,37,B
2018-04-16 22:22:12,13190.0,2,4832,0,13190.0,3,13195.0,3,S
2018-04-16 22:22:18,13190.0,2,4834,0,13190.0,2,13195.0,4,S
2018-04-16 22:22:35,13195.0,4,4838,2,13190.0,13,13200.0,10,B
2018-04-16 22:22:39,13200.0,10,4848,4,13190.0,14,13200.0,2,B
2018-04-16 22:22:45,13195.0,2,4850,0,13190.0,13,13200.0,10,S
2018-04-16 22:22:56,13190.0,4,4854,0,13185.0,9,13190.0,1,S
2018-04-16 22:22:56,13185.0,4,4858,2,13185.0,2,13195.0,9,S
2018-04-16 22:23:04,13185.0,2,4860,0,13185.0,1,13190.0,4,S
2018-04-16 22:23:05,13190.0,4,4864,-4,13185.0,1,13190.0,2,B
2018-04-16 22:23:05,13185.0,2,4866,0,13185.0,4,13190.0,2,S
2018-04-16 22:23:06,13190.0,2,4868,-2,13185.0,4,13190.0,1,B
2018-04-16 22:23:25,13185.0,18,4886,-16,13185.0,8,13195.0,6,S
2018-04-16 22:23:40,13190.0,2,4888,0,13190.0,10,13195.0,2,B
2018-04-16 22:23:45,13195.0,2,4890,0,13190.0,14,13200.0,7,B
2018-04-16 22:23:48,13200.0,2,4892,0,13195.0,6,13205.0,7,B
2018-04-16 22:24:30,13190.0,2,4894,-2,13185.0,7,13195.0,4,S
2018-04-16 22:25:12,13195.0,12,4906,-4,13190.0,3,13200.0,31,B
2018-04-16 22:25:27,13190.0,2,4908,0,13190.0,1,13195.0,1,S
2018-04-16 22:26:02,13195.0,2,4910,2,13190.0,1,13200.0,33,B
2018-04-16 22:26:20,13190.0,10,4920,-8,13185.0,20,13195.0,4,S
2018-04-16 22:26:41,13190.0,2,4922,0,13190.0,13,13195.0,4,S
2018-04-16 22:26:49,13190.0,2,4924,0,13185.0,8,13190.0,44,S
2018-04-16 22:27:04,13200.0,8,4932,4,13195.0,3,13205.0,19,B
2018-04-16 22:27:33,13195.0,4,4936,-4,13190.0,12,13195.0,1,S
2018-04-16 22:27:34,13195.0,2,4938,-2,13190.0,19,13200.0,13,S
2018-04-16 22:27:49,13200.0,4,4942,0,13195.0,14,13200.0,8,B
2018-04-16 22:27:50,13200.0,12,4954,-6,13195.0,15,13200.0,2,B
2018-04-16 22:27:50,13200.0,4,4958,0,13195.0,15,13205.0,7,B
2018-04-16 22:27:52,13205.0,6,4964,2,13200.0,10,13210.0,6,B
2018-04-16 22:27:59,13205.0,2,4966,0,13200.0,14,13210.0,7,B
2018-04-16 22:28:13,13205.0,2,4968,0,13200.0,17,13210.0,4,B
2018-04-16 22:28:22,13205.0,4,4972,0,13205.0,4,13210.0,8,B
2018-04-16 22:28:24,13205.0,6,4978,-6,13200.0,4,13210.0,6,B
2018-04-16 22:28:25,13205.0,2,4980,0,13205.0,1,13210.0,7,B
2018-04-16 22:28:48,13205.0,2,4982,0,13200.0,13,13210.0,7,B
2018-04-16 22:28:56,13205.0,2,4984,0,13205.0,1,13210.0,6,B
2018-04-16 22:29:54,13205.0,2,4986,0,13200.0,13,13210.0,8,B
2018-04-16 22:30:16,13205.0,2,4988,2,13200.0,1,13205.0,3,B
2018-04-16 22:30:17,13205.0,2,4990,2,13200.0,1,13205.0,2,B
2018-04-16 22:30:25,13205.0,2,4992,0,13200.0,3,13205.0,2,B
2018-04-16 22:31:09,13200.0,2,4994,0,13200.0,2,13205.0,2,S
2018-04-16 22:31:23,13205.0,2,4996,0,13200.0,24,13210.0,10,B
2018-04-16 22:31:42,13200.0,2,4998,-2,13200.0,11,13210.0,9,S
2018-04-16 22:31:42,13200.0,2,5000,2,13200.0,10,13210.0,9,S
2018-04-16 22:31:49,13200.0,4,5004,2,13195.0,17,13205.0,7,S
2018-04-16 22:32:00,13200.0,2,5006,2,13200.0,2,13205.0,7,S
2018-04-16 22:33:26,13200.0,2,5008,0,13200.0,1,13205.0,5,S
2018-04-16 22:33:27,13200.0,2,5010,0,13195.0,2,13200.0,7,S
2018-04-16 22:33:39,13200.0,2,5012,-2,13200.0,1,13205.0,4,S
2018-04-16 22:33:44,13200.0,2,5014,-2,13195.0,27,13205.0,5,S
2018-04-16 22:33:46,13200.0,2,5016,0,13195.0,26,13205.0,5,S
2018-04-16 22:34:09,13195.0,2,5018,-2,13190.0,15,13200.0,7,S
2018-04-16 22:34:29,13195.0,2,5020,0,13195.0,1,13200.0,4,S
2018-04-16 22:35:05,13200.0,2,5022,2,13190.0,18,13200.0,2,B
2018-04-16 22:35:11,13200.0,2,5024,-2,13195.0,1,13200.0,1,B
2018-04-16 22:35:13,13205.0,8,5032,4,13205.0,3,13210.0,19,B
2018-04-16 22:35:14,13205.0,6,5038,6,13200.0,11,13210.0,5,B
2018-04-16 22:35:19,13205.0,2,5040,0,13200.0,2,13210.0,20,B
2018-04-16 22:35:37,13205.0,6,5046,0,13200.0,6,13210.0,20,B
2018-04-16 22:36:16,13210.0,2,5048,0,13205.0,1,13210.0,4,B
2018-04-16 22:36:24,13205.0,2,5050,-2,13200.0,28,13210.0,4,S
2018-04-16 22:36:43,13205.0,2,5052,0,13200.0,3,13205.0,3,S
2018-04-16 22:37:15,13200.0,2,5054,0,13200.0,2,13205.0,8,S
2018-04-16 22:37:27,13205.0,16,5070,0,13205.0,2,13210.0,20,B
2018-04-16 22:37:27,13205.0,4,5074,-4,13200.0,2,13205.0,4,B
2018-04-16 22:37:41,13200.0,2,5076,2,13195.0,4,13200.0,2,S
2018-04-16 22:37:52,13195.0,6,5082,2,13190.0,5,13200.0,20,S
2018-04-16 22:37:55,13195.0,2,5084,0,13190.0,6,13200.0,21,S
2018-04-16 22:38:34,13200.0,2,5086,2,13195.0,15,13200.0,9,B
2018-04-16 22:38:48,13195.0,2,5088,-2,13190.0,6,13200.0,9,S
2018-04-16 22:39:02,13195.0,2,5090,0,13190.0,17,13195.0,2,S
2018-04-16 22:40:09,13200.0,2,5092,0,13195.0,15,13200.0,9,B
2018-04-16 22:40:28,13195.0,26,5118,8,13195.0,2,13200.0,9,S
2018-04-16 22:40:29,13195.0,6,5124,4,13190.0,20,13200.0,9,S
2018-04-16 22:40:38,13200.0,6,5130,0,13195.0,5,13200.0,6,B
2018-04-16 22:41:03,13195.0,4,5134,0,13190.0,19,13195.0,3,S
2018-04-16 22:41:04,13195.0,6,5140,4,13190.0,19,13200.0,3,S
2018-04-16 22:41:10,13200.0,2,5142,0,13190.0,33,13200.0,2,B
2018-04-16 22:41:36,13205.0,34,5176,-12,13205.0,3,13210.0,34,B
2018-04-16 22:41:37,13200.0,8,5184,-6,13195.0,9,13205.0,11,S
2018-04-16 22:41:52,13195.0,2,5186,-2,13195.0,2,13200.0,5,S
2018-04-16 22:42:11,13195.0,6,5192,-6,13195.0,3,13200.0,4,S
2018-04-16 22:42:11,13195.0,2,5194,-2,13195.0,2,13200.0,4,S
2018-04-16 22:42:12,13195.0,2,5196,0,13195.0,1,13200.0,6,S
2018-04-16 22:42:19,13200.0,2,5198,2,13195.0,1,13200.0,4,B
2018-04-16 22:42:20,13195.0,2,5200,-2,13190.0,5,13200.0,4,S
2018-04-16 22:43:03,13200.0,2,5202,-2,13190.0,17,13200.0,2,B
2018-04-16 22:44:38,13190.0,2,5204,0,13190.0,4,13195.0,3,S
2018-04-16 22:44:38,13190.0,2,5206,0,13190.0,4,13195.0,3,S
2018-04-16 22:44:48,13190.0,8,5214,2,13185.0,9,13190.0,2,S
2018-04-16 22:44:49,13185.0,4,5218,0,13185.0,4,13190.0,4,S
2018-04-16 22:44:49,13185.0,2,5220,-2,13185.0,3,13190.0,5,S
2018-04-16 22:44:53,13185.0,2,5222,0,13185.0,2,13190.0,11,S
2018-04-16 22:44:55,13190.0,18,5240,-10,13190.0,4,13195.0,9,B
2018-04-16 22:44:58,13190.0,14,5254,-14,13190.0,12,13200.0,8,B
2018-04-16 22:46:26,13185.0,2,5256,0,13185.0,31,13190.0,6,S
2018-04-16 22:46:36,13185.0,2,5258,0,13185.0,29,13190.0,28,S
2018-04-16 22:46:39,13190.0,2,5260,0,13185.0,29,13190.0,11,B
2018-04-16 22:46:47,13190.0,14,5274,0,13185.0,31,13190.0,3,B
2018-04-16 22:46:47,13190.0,6,5280,0,13185.0,31,13195.0,19,B
2018-04-16 22:46:49,13190.0,2,5282,0,13190.0,3,13195.0,19,B
2018-04-16 22:47:16,13195.0,2,5284,-2,13190.0,8,13195.0,2,B
2018-04-16 22:47:49,13190.0,2,5286,0,13190.0,1,13195.0,20,S
2018-04-16 22:47:49,13190.0,2,5288,-2,13185.0,47,13195.0,20,S
2018-04-16 22:48:26,13185.0,2,5290,0,13185.0,35,13190.0,3,S
2018-04-16 22:48:33,13185.0,20,5310,-4,13185.0,45,13190.0,8,S
2018-04-16 22:48:47,13185.0,4,5314,0,13185.0,20,13190.0,10,S
2018-04-16 22:48:53,13190.0,20,5334,0,13185.0,20,13195.0,17,B
2018-04-16 22:49:18,13190.0,10,5344,0,13185.0,20,13195.0,7,B
2018-04-16 22:49:48,13190.0,2,5346,0,13185.0,27,13195.0,7,B
2018-04-16 22:50:08,13195.0,2,5348,0,13190.0,11,13200.0,14,B
2018-04-16 22:50:11,13200.0,4,5352,-4,13190.0,11,13200.0,10,B
2018-04-16 22:50:22,13200.0,2,5354,0,13190.0,14,13200.0,11,B
2018-04-16 22:50:28,13200.0,26,5380,-16,13200.0,35,13205.0,28,B
2018-04-16 22:50:28,13200.0,18,5398,-10,13200.0,26,13205.0,29,B
2018-04-16 22:50:29,13200.0,2,5400,-2,13200.0,25,13205.0,19,B
2018-04-16 22:50:42,13200.0,2,5402,0,13200.0,24,13205.0,18,B
2018-04-16 22:50:46,13200.0,34,5436,-8,13200.0,7,13205.0,26,B
2018-04-16 22:50:46,13195.0,20,5456,-16,13190.0,8,13200.0,3,S
2018-04-16 22:50:53,13195.0,2,5458,0,13190.0,5,13200.0,10,S
2018-04-16 22:51:13,13200.0,2,5460,0,13195.0,2,13200.0,1,B
2018-04-16 22:51:42,13195.0,4,5464,-4,13190.0,5,13200.0,5,S
2018-04-16 22:51:43,13190.0,4,5468,-4,13190.0,7,13195.0,3,S
2018-04-16 22:51:45,13195.0,2,5470,0,13190.0,14,13195.0,1,B
2018-04-16 22:51:46,13195.0,2,5472,2,13190.0,14,13200.0,8,B
2018-04-16 22:52:36,13190.0,2,5474,-2,13190.0,10,13195.0,3,S
2018-04-16 22:53:21,13195.0,2,5476,2,13195.0,2,13200.0,14,B
2018-04-16 22:53:29,13195.0,2,5478,0,13195.0,1,13200.0,14,B
2018-04-16 22:53:31,13190.0,4,5482,-4,13190.0,9,13200.0,16,S
2018-04-16 22:53:32,13190.0,2,5484,0,13185.0,33,13195.0,7,S
2018-04-16 22:53:35,13190.0,8,5492,-4,13185.0,33,13190.0,3,S
2018-04-16 22:53:41,13185.0,4,5496,-4,13185.0,32,13190.0,8,S
2018-04-16 22:53:42,13185.0,48,5544,-36,13185.0,8,13190.0,11,S
2018-04-16 22:53:42,13185.0,16,5560,-4,13180.0,6,13185.0,12,S
2018-04-16 22:53:44,13180.0,2,5562,0,13175.0,5,13180.0,4,S
2018-04-16 22:53:45,13175.0,2,5564,-2,13170.0,10,13180.0,11,S
2018-04-16 22:53:46,13175.0,8,5572,0,13175.0,7,13180.0,5,S
2018-04-16 22:53:48,13180.0,8,5580,0,13175.0,8,13180.0,1,B
2018-04-16 22:53:48,13180.0,6,5586,4,13180.0,11,13185.0,1,B
2018-04-16 22:53:49,13185.0,2,5588,0,13180.0,11,13190.0,7,B
2018-04-16 22:53:50,13185.0,4,5592,0,13185.0,2,13190.0,2,B
2018-04-16 22:53:51,13185.0,4,5596,0,13180.0,9,13190.0,4,B
2018-04-16 22:53:55,13185.0,2,5598,0,13185.0,8,13190.0,2,B
2018-04-16 22:54:03,13190.0,2,5600,-2,13185.0,11,13195.0,2,B
2018-04-16 22:54:25,13190.0,4,5604,0,13185.0,8,13195.0,6,B
2018-04-16 22:54:31,13190.0,4,5608,-2,13185.0,11,13195.0,2,B
2018-04-16 22:54:33,13195.0,4,5612,4,13190.0,8,13200.0,23,B
2018-04-16 22:54:44,13185.0,4,5616,-4,13180.0,6,13190.0,8,S
2018-04-16 22:54:56,13185.0,8,5624,0,13180.0,2,13190.0,9,S
2018-04-16 22:54:59,13180.0,2,5626,-2,13175.0,1,13185.0,12,S
2018-04-16 22:55:00,13180.0,2,5628,0,13175.0,1,13185.0,11,S
2018-04-16 22:55:01,13175.0,2,5630,0,13170.0,7,13180.0,5,S
2018-04-16 22:55:06,13170.0,10,5640,0,13170.0,6,13180.0,7,S
2018-04-16 22:55:31,13180.0,2,5642,0,13175.0,4,13185.0,10,B
2018-04-16 22:56:20,13185.0,20,5662,10,13175.0,5,13185.0,2,B
2018-04-16 22:56:23,13180.0,2,5664,2,13175.0,3,13180.0,2,S
2018-04-16 22:56:26,13175.0,2,5666,0,13175.0,2,13180.0,4,S
2018-04-16 22:56:26,13175.0,2,5668,0,13175.0,1,13180.0,4,S
2018-04-16 22:56:27,13180.0,4,5672,0,13175.0,1,13180.0,2,B
2018-04-16 22:56:45,13175.0,2,5674,0,13175.0,1,13180.0,2,S
2018-04-16 22:56:46,13185.0,20,5694,14,13175.0,2,13185.0,6,B
2018-04-16 22:56:58,13180.0,2,5696,2,13175.0,2,13185.0,6,S
2018-04-16 22:57:01,13185.0,8,5704,0,13175.0,4,13185.0,2,B
2018-04-16 22:57:20,13175.0,2,5706,-2,13175.0,5,13180.0,7,S
2018-04-16 22:57:21,13175.0,6,5712,0,13175.0,2,13180.0,7,S
2018-04-16 22:57:21,13175.0,4,5716,-4,13170.0,3,13175.0,10,S
2018-04-16 22:57:22,13170.0,4,5720,2,13170.0,1,13175.0,13,S
2018-04-16 22:57:22,13170.0,2,5722,-2,13165.0,1,13175.0,13,S
2018-04-16 22:57:24,13165.0,2,5724,0,13165.0,5,13175.0,12,S
2018-04-16 22:57:26,13170.0,2,5726,0,13165.0,6,13170.0,1,B
2018-04-16 22:57:31,13170.0,4,5730,0,13160.0,13,13170.0,1,B
2018-04-16 22:57:42,13170.0,4,5734,-4,13165.0,5,13170.0,4,B
2018-04-16 22:57:45,13170.0,8,5742,-4,13170.0,2,13175.0,2,B
2018-04-16 22:57:47,13170.0,4,5746,0,13165.0,4,13175.0,12,B
2018-04-16 22:58:01,13175.0,10,5756,10,13170.0,6,13175.0,6,B
2018-04-16 22:58:02,13175.0,2,5758,0,13170.0,6,13175.0,5,B
2018-04-16 22:58:05,13170.0,14,5772,0,13165.0,1,13170.0,1,S
2018-04-16 22:58:06,13170.0,2,5774,-2,13165.0,1,13175.0,3,S
2018-04-16 22:58:07,13155.0,8,5782,-2,13155.0,13,13175.0,3,S
2018-04-16 22:58:07,13155.0,8,5790,-6,13160.0,2,13175.0,3,S
2018-04-16 22:58:09,13165.0,2,5792,0,13160.0,2,13170.0,8,B
2018-04-16 22:58:11,13160.0,2,5794,0,13165.0,1,13170.0,8,S
2018-04-16 22:58:11,13160.0,4,5798,0,13155.0,4,13160.0,3,S
2018-04-16 22:58:12,13160.0,6,5804,0,13160.0,3,13170.0,8,S
2018-04-16 22:58:12,13160.0,2,5806,0,13160.0,2,13170.0,9,S
2018-04-16 22:58:14,13160.0,2,5808,0,13160.0,1,13170.0,9,S
2018-04-16 22:58:15,13160.0,2,5810,-2,13155.0,4,13170.0,9,S
2018-04-16 22:58:22,13160.0,2,5812,0,13160.0,1,13170.0,5,S
2018-04-16 22:58:34,13180.0,20,5832,-4,13180.0,1,13185.0,1,B
2018-04-16 22:58:34,13180.0,2,5834,0,13170.0,1,13175.0,1,B
2018-04-16 22:58:35,13175.0,2,5836,0,13170.0,1,13180.0,1,S
2018-04-16 22:58:44,13175.0,8,5844,0,13170.0,9,13175.0,2,S
2018-04-16 22:58:45,13175.0,4,5848,4,13175.0,2,13180.0,2,S
2018-04-16 22:58:45,13180.0,4,5852,0,13175.0,6,13185.0,3,B
2018-04-16 22:58:53,13185.0,6,5858,-4,13175.0,5,13185.0,1,B
2018-04-16 22:59:21,13170.0,2,5860,-2,13160.0,2,13175.0,4,S
2018-04-16 22:59:21,13160.0,2,5862,-2,13160.0,3,13175.0,4,S
2018-04-16 22:59:33,13160.0,2,5864,0,13165.0,2,13170.0,2,S
2018-04-16 22:59:37,13170.0,2,5866,0,13170.0,1,13175.0,1,B
2018-04-16 22:59:38,13170.0,2,5868,-2,13160.0,1,13175.0,4,B
2018-04-16 22:59:40,13175.0,2,5870,-2,13160.0,1,13175.0,3,B
2018-04-16 22:59:42,13175.0,2,5872,0,13170.0,1,13175.0,2,B
2018-04-16 22:59:47,13170.0,2,5874,0,13160.0,1,13175.0,5,S
2018-04-16 22:59:48,13175.0,2,5876,0,13160.0,3,13175.0,4,B
2018-04-16 22:59:55,13175.0,4,5880,0,13170.0,5,13175.0,2,B
2018-04-16 22:59:56,13175.0,4,5884,0,13170.0,5,13185.0,2,B
2018-04-16 22:59:58,13170.0,2,5886,2,13170.0,4,13180.0,1,S
2018-04-17 09:00:00,13170.0,8,5894,8,13155.0,2,13170.0,14,S
2018-04-17 09:00:01,13155.0,4,5898,0,13150.0,18,13155.0,1,S
2018-04-17 09:00:01,13150.0,4,5902,-4,13150.0,17,13155.0,1,S
2018-04-17 09:00:02,13150.0,38,5940,-22,13150.0,1,13165.0,3,S
2018-04-17 09:00:02,13150.0,2,5942,0,13145.0,1,13150.0,9,S
2018-04-17 09:00:03,13150.0,14,5956,-12,13145.0,1,13150.0,6,S
2018-04-17 09:00:03,13110.0,12,5968,8,13110.0,1,13150.0,7,S
2018-04-17 09:00:04,13145.0,12,5980,4,13120.0,1,13145.0,12,B
2018-04-17 09:00:04,13125.0,4,5984,4,13125.0,6,13145.0,10,S
2018-04-17 09:00:06,13140.0,2,5986,0,13135.0,4,13150.0,10,B
2018-04-17 09:00:07,13150.0,4,5990,0,13140.0,4,13150.0,11,B
2018-04-17 09:00:11,13145.0,4,5994,-4,13140.0,4,13150.0,11,S
2018-04-17 09:00:14,13150.0,18,6012,6,13145.0,4,13155.0,1,B
2018-04-17 09:00:15,13145.0,8,6020,6,13145.0,1,13150.0,1,S
2018-04-17 09:00:15,13150.0,2,6022,-2,13145.0,5,13155.0,1,B
2018-04-17 09:00:19,13150.0,10,6032,2,13150.0,2,13155.0,1,B
2018-04-17 09:00:19,13155.0,2,6034,0,13150.0,2,13160.0,2,B
2018-04-17 09:00:20,13150.0,2,6036,0,13150.0,1,13160.0,2,S
2018-04-17 09:00:21,13160.0,2,6038,0,13155.0,16,13165.0,2,B
2018-04-17 09:00:27,13160.0,4,6042,2,13155.0,6,13165.0,5,B
2018-04-17 09:00:29,13165.0,2,6044,0,13155.0,6,13165.0,5,B
2018-04-17 09:00:37,13160.0,2,6046,2,13150.0,1,13155.0,11,S
2018-04-17 09:00:38,13150.0,2,6048,0,13145.0,3,13155.0,15,S
2018-04-17 09:00:38,13155.0,2,6050,2,13145.0,2,13155.0,14,B
2018-04-17 09:00:40,13150.0,2,6052,2,13145.0,2,13150.0,3,S
2018-04-17 09:00:42,13150.0,2,6054,0,13135.0,6,13145.0,12,S
2018-04-17 09:00:44,13145.0,4,6058,0,13135.0,2,13140.0,6,S
2018-04-17 09:00:45,13135.0,2,6060,0,13135.0,2,13140.0,6,S
2018-04-17 09:00:47,13125.0,6,6066,-2,13125.0,1,13140.0,6,S
2018-04-17 09:00:48,13125.0,10,6076,8,13125.0,4,13135.0,11,S
2018-04-17 09:00:49,13125.0,8,6084,6,13120.0,4,13125.0,12,S
2018-04-17 09:00:49,13125.0,6,6090,6,13120.0,4,13125.0,2,S
2018-04-17 09:00:51,13125.0,4,6094,0,13120.0,4,13130.0,3,S
2018-04-17 09:00:51,13125.0,4,6098,-4,13120.0,7,13130.0,2,S
2018-04-17 09:00:53,13120.0,12,6110,6,13120.0,2,13130.0,2,S
2018-04-17 09:00:54,13130.0,2,6112,-2,13120.0,2,13130.0,1,B
2018-04-17 09:00:56,13130.0,2,6114,0,13125.0,2,13130.0,4,B
2018-04-17 09:00:57,13130.0,8,6122,8,13125.0,3,13135.0,5,B
2018-04-17 09:01:00,13130.0,2,6124,0,13130.0,4,13140.0,2,B
2018-04-17 09:01:01,13130.0,8,6132,2,13125.0,3,13130.0,1,B
2018-04-17 09:01:02,13130.0,2,6134,2,13125.0,2,13135.0,1,B
2018-04-17 09:01:04,13135.0,2,6136,0,13135.0,1,13140.0,10,B
2018-04-17 09:01:04,13135.0,2,6138,2,13130.0,1,13135.0,3,B
2018-04-17 09:01:06,13135.0,8,6146,-2,13135.0,1,13140.0,11,B
2018-04-17 09:01:06,13135.0,2,6148,-2,13130.0,1,13135.0,3,B
2018-04-17 09:01:07,13130.0,8,6156,8,13125.0,1,13130.0,1,S
2018-04-17 09:01:13,13130.0,2,6158,2,13120.0,6,13130.0,1,S
2018-04-17 09:01:16,13125.0,16,6174,8,13120.0,6,13125.0,17,S
2018-04-17 09:01:17,13125.0,34,6208,10,13125.0,2,13130.0,1,S
2018-04-17 09:01:23,13130.0,2,6210,-2,13125.0,3,13130.0,9,B
2018-04-17 09:01:23,13130.0,4,6214,-4,13125.0,19,13130.0,7,B
2018-04-17 09:01:28,13130.0,14,6228,14,13130.0,2,13135.0,2,B
2018-04-17 09:01:29,13135.0,4,6232,0,13130.0,22,13140.0,2,B
2018-04-17 09:01:31,13140.0,2,6234,0,13135.0,24,13140.0,1,B
2018-04-17 09:01:32,13140.0,2,6236,2,13135.0,24,13145.0,2,B
2018-04-17 09:01:33,13140.0,4,6240,2,13135.0,7,13140.0,2,B
2018-04-17 09:01:33,13135.0,14,6254,14,13130.0,8,13140.0,22,S
2018-04-17 09:01:34,13140.0,2,6256,0,13130.0,6,13140.0,14,B
2018-04-17 09:01:35,13135.0,6,6262,2,13130.0,4,13140.0,14,S
2018-04-17 09:01:36,13135.0,2,6264,0,13130.0,3,13135.0,5,S
2018-04-17 09:01:37,13130.0,2,6266,-2,13130.0,2,13135.0,5,S
2018-04-17 09:01:42,13130.0,4,6270,4,13130.0,3,13140.0,13,S
2018-04-17 09:01:49,13135.0,2,6272,-2,13135.0,5,13140.0,1,B
2018-04-17 09:01:50,13140.0,4,6276,0,13140.0,3,13145.0,17,B
2018-04-17 09:01:51,13140.0,6,6282,0,13135.0,2,13140.0,1,B
2018-04-17 09:01:53,13140.0,2,6284,0,13135.0,2,13145.0,17,B
2018-04-17 09:01:54,13140.0,2,6286,0,13135.0,2,13145.0,17,B
2018-04-17 09:02:02,13140.0,2,6288,0,13140.0,2,13145.0,4,B
2018-04-17 09:02:06,13145.0,8,6296,-4,13145.0,6,13150.0,2,B
2018-04-17 09:02:09,13150.0,24,6320,-10,13150.0,1,13155.0,2,B
2018-04-17 09:02:10,13155.0,2,6322,0,13150.0,3,13155.0,1,B
2018-04-17 09:02:11,13155.0,2,6324,2,13155.0,6,13160.0,2,B
2018-04-17 09:02:12,13155.0,2,6326,2,13155.0,5,13160.0,3,B
2018-04-17 09:02:15,13160.0,2,6328,0,13155.0,5,13160.0,2,B
2018-04-17 09:02:16,13160.0,2,6330,0,13160.0,7,13165.0,2,B
2018-04-17 09:02:16,13165.0,4,6334,-2,13160.0,1,13170.0,2,B
2018-04-17 09:02:17,13160.0,2,6336,2,13160.0,1,13165.0,1,S
2018-04-17 09:02:17,13165.0,4,6340,-4,13160.0,1,13170.0,6,B
2018-04-17 09:02:18,13170.0,6,6346,0,13165.0,17,13175.0,3,B
2018-04-17 09:02:19,13165.0,4,6350,4,13165.0,23,13170.0,1,S
2018-04-17 09:02:20,13165.0,32,6382,18,13160.0,3,13170.0,20,S
2018-04-17 09:02:22,13165.0,8,6390,0,13160.0,3,13170.0,8,S
2018-04-17 09:02:40,13160.0,2,6392,0,13150.0,8,13155.0,4,S
2018-04-17 09:02:41,13150.0,2,6394,2,13150.0,7,13155.0,4,S
2018-04-17 09:02:42,13150.0,8,6402,-8,13150.0,5,13160.0,11,S
2018-04-17 09:02:45,13150.0,2,6404,0,13150.0,22,13155.0,3,S
2018-04-17 09:02:46,13155.0,6,6410,-6,13155.0,3,13160.0,9,B
2018-04-17 09:02:55,13155.0,4,6414,0,13155.0,4,13160.0,3,B
2018-04-17 09:02:57,13155.0,2,6416,0,13155.0,3,13160.0,6,B
2018-04-17 09:02:58,13155.0,6,6422,6,13150.0,26,13160.0,6,B
2018-04-17 09:02:58,13160.0,4,6426,2,13150.0,26,13160.0,6,B
2018-04-17 09:02:59,13160.0,2,6428,0,13150.0,26,13160.0,5,B
2018-04-17 09:03:07,13155.0,4,6432,-4,13150.0,26,13155.0,1,S
2018-04-17 09:03:08,13155.0,2,6434,-2,13155.0,1,13160.0,7,S
2018-04-17 09:03:08,13155.0,2,6436,-2,13150.0,26,13160.0,8,S
2018-04-17 09:03:15,13155.0,4,6440,0,13155.0,8,13160.0,8,S
2018-04-17 09:03:19,13155.0,2,6442,0,13155.0,7,13160.0,8,S
2018-04-17 09:03:20,13155.0,6,6448,-6,13155.0,4,13160.0,8,S
2018-04-17 09:03:24,13155.0,6,6454,0,13155.0,1,13160.0,12,S
2018-04-17 09:03:24,13155.0,2,6456,0,13150.0,26,13160.0,12,S
2018-04-17 09:03:32,13150.0,2,6458,-2,13150.0,25,13155.0,16,S
2018-04-17 09:03:33,13150.0,2,6460,0,13150.0,24,13155.0,16,S
2018-04-17 09:03:36,13150.0,2,6462,0,13150.0,23,13155.0,16,S
2018-04-17 09:03:36,13155.0,2,6464,0,13150.0,23,13155.0,15,B
2018-04-17 09:03:40,13150.0,2,6466,0,13150.0,23,13155.0,15,S
2018-04-17 09:03:41,13150.0,28,6494,-20,13150.0,11,13155.0,13,S
2018-04-17 09:03:41,13150.0,22,6516,-22,13145.0,6,13155.0,12,S
2018-04-17 09:03:45,13150.0,4,6520,-4,13145.0,14,13155.0,3,S
2018-04-17 09:03:48,13150.0,2,6522,-2,13145.0,15,13155.0,14,S
2018-04-17 09:03:51,13150.0,4,6526,0,13150.0,8,13155.0,2,S
2018-04-17 09:03:52,13155.0,2,6528,0,13155.0,1,13160.0,11,B
2018-04-17 09:03:54,13150.0,2,6530,0,13150.0,27,13160.0,15,S
2018-04-17 09:04:09,13150.0,8,6538,0,13150.0,11,13155.0,12,S
2018-04-17 09:04:10,13150.0,20,6558,0,13145.0,6,13150.0,7,S
2018-04-17 09:04:12,13150.0,10,6568,-6,13145.0,16,13155.0,5,S
2018-04-17 09:04:20,13150.0,4,6572,-4,13145.0,19,13150.0,3,S
2018-04-17 09:04:24,13150.0,2,6574,-2,13145.0,19,13150.0,2,S
2018-04-17 09:04:24,13150.0,4,6578,-4,13145.0,19,13150.0,1,S
2018-04-17 09:04:32,13150.0,2,6580,-2,13145.0,20,13155.0,7,S
2018-04-17 09:04:32,13145.0,2,6582,0,13145.0,19,13155.0,8,S
2018-04-17 09:04:40,13150.0,2,6584,2,13145.0,9,13150.0,8,B
2018-04-17 09:05:00,13145.0,2,6586,0,13145.0,18,13150.0,14,S
2018-04-17 09:05:03,13145.0,4,6590,-4,13145.0,16,13150.0,16,S
2018-04-17 09:05:04,13145.0,8,6598,2,13145.0,12,13150.0,16,S
2018-04-17 09:05:04,13145.0,4,6602,2,13145.0,10,13150.0,16,S
2018-04-17 09:05:07,13145.0,2,6604,2,13145.0,9,13150.0,16,S
2018-04-17 09:05:07,13145.0,18,6622,18,13140.0,2,13145.0,1,S
2018-04-17 09:05:08,13140.0,4,6626,-2,13135.0,2,13140.0,2,S
2018-04-17 09:05:14,13140.0,14,6640,-4,13140.0,3,13145.0,23,S
2018-04-17 09:05:16,13140.0,2,6642,0,13140.0,2,13145.0,23,S
2018-04-17 09:05:17,13140.0,4,6646,0,13135.0,12,13145.0,23,S
2018-04-17 09:05:18,13145.0,2,6648,2,13135.0,14,13145.0,22,B
2018-04-17 09:05:20,13140.0,4,6652,0,13140.0,7,13145.0,10,S
2018-04-17 09:05:22,13145.0,2,6654,2,13140.0,7,13145.0,9,B
2018-04-17 09:05:24,13145.0,4,6658,4,13135.0,7,13145.0,8,B
2018-04-17 09:05:25,13140.0,4,6662,0,13140.0,8,13145.0,11,S
2018-04-17 09:05:31,13145.0,26,6688,-4,13140.0,4,13150.0,5,B
2018-04-17 09:05:42,13145.0,2,6690,0,13145.0,3,13150.0,1,B
2018-04-17 09:05:42,13150.0,2,6692,0,13145.0,3,13155.0,8,B
2018-04-17 09:05:50,13155.0,2,6694,-2,13150.0,5,13160.0,6,B
2018-04-17 09:05:59,13155.0,2,6696,2,13150.0,22,13160.0,17,B
2018-04-17 09:06:00,13155.0,2,6698,0,13155.0,2,13160.0,17,B
2018-04-17 09:06:07,13155.0,2,6700,0,13155.0,2,13160.0,7,B
2018-04-17 09:06:21,13160.0,8,6708,8,13155.0,6,13160.0,12,B
2018-04-17 09:06:22,13160.0,24,6732,24,13160.0,1,13165.0,7,B
2018-04-17 09:06:24,13165.0,2,6734,0,13160.0,5,13165.0,1,B
2018-04-17 09:06:24,13165.0,2,6736,2,13160.0,5,13170.0,3,B
2018-04-17 09:06:25,13165.0,4,6740,-4,13160.0,5,13170.0,19,B
2018-04-17 09:06:28,13160.0,10,6750,10,13160.0,13,13165.0,20,S
2018-04-17 09:06:28,13160.0,2,6752,0,13160.0,12,13165.0,21,S
2018-04-17 09:06:41,13165.0,2,6754,0,13160.0,12,13170.0,10,B
2018-04-17 09:06:45,13170.0,4,6758,2,13160.0,13,13170.0,18,B
2018-04-17 09:06:51,13170.0,22,6780,2,13165.0,9,13170.0,5,B
2018-04-17 09:06:51,13175.0,4,6784,0,13165.0,17,13175.0,5,B
2018-04-17 09:06:55,13175.0,4,6788,0,13170.0,2,13175.0,5,B
2018-04-17 09:06:57,13170.0,4,6792,-2,13165.0,5,13170.0,2,S
2018-04-17 09:06:58,13170.0,4,6796,0,13165.0,5,13175.0,7,S
2018-04-17 09:07:08,13175.0,4,6800,-2,13170.0,6,13175.0,7,B
2018-04-17 09:07:08,13170.0,2,6802,-2,13170.0,5,13175.0,7,S
2018-04-17 09:07:09,13170.0,2,6804,2,13170.0,2,13175.0,7,S
2018-04-17 09:07:10,13170.0,4,6808,-4,13165.0,2,13175.0,7,S
2018-04-17 09:07:11,13165.0,2,6810,2,13165.0,5,13170.0,2,S
2018-04-17 09:07:12,13165.0,2,6812,0,13165.0,4,13170.0,2,S
2018-04-17 09:07:23,13170.0,10,6822,-10,13165.0,16,13170.0,1,B
2018-04-17 09:07:23,13170.0,2,6824,-2,13170.0,2,13175.0,3,B
2018-04-17 09:07:25,13175.0,2,6826,2,13170.0,19,13180.0,6,B
2018-04-17 09:07:31,13180.0,10,6836,-6,13180.0,1,13185.0,3,B
2018-04-17 09:07:32,13185.0,2,6838,0,13175.0,13,13185.0,1,B
2018-04-17 09:07:33,13185.0,2,6840,0,13180.0,16,13185.0,3,B
2018-04-17 09:07:33,13185.0,2,6842,-2,13180.0,16,13185.0,2,B
2018-04-17 09:07:38,13180.0,4,6846,0,13180.0,1,13185.0,4,S
2018-04-17 09:07:39,13180.0,2,6848,0,13175.0,8,13185.0,5,S
2018-04-17 09:07:44,13180.0,2,6850,-2,13170.0,19,13180.0,20,S
2018-04-17 09:07:47,13180.0,2,6852,0,13170.0,7,13180.0,20,S
2018-04-17 09:07:50,13170.0,2,6854,-2,13170.0,6,13180.0,22,S
2018-04-17 09:07:51,13180.0,2,6856,0,13170.0,18,13180.0,20,B
2018-04-17 09:08:16,13175.0,4,6860,0,13175.0,1,13180.0,7,S
2018-04-17 09:08:23,13180.0,2,6862,0,13180.0,2,13185.0,4,B
2018-04-17 09:08:24,13180.0,4,6866,2,13175.0,4,13180.0,4,B
2018-04-17 09:08:25,13180.0,2,6868,2,13175.0,6,13185.0,6,B
2018-04-17 09:08:27,13180.0,8,6876,8,13175.0,15,13185.0,4,B
2018-04-17 09:08:30,13180.0,2,6878,2,13175.0,15,13185.0,7,B
2018-04-17 09:08:30,13180.0,4,6882,2,13175.0,15,13185.0,7,B
2018-04-17 09:08:33,13180.0,2,6884,0,13185.0,1,13190.0,16,B
2018-04-17 09:08:40,13190.0,2,6886,-2,13180.0,11,13190.0,7,B
2018-04-17 09:08:41,13190.0,4,6890,0,13180.0,10,13190.0,6,B
2018-04-17 09:08:52,13190.0,8,6898,4,13185.0,14,13195.0,16,B
2018-04-17 09:09:01,13195.0,2,6900,2,13185.0,15,13195.0,13,B
2018-04-17 09:09:03,13195.0,6,6906,0,13185.0,15,13195.0,11,B
2018-04-17 09:09:08,13190.0,2,6908,0,13190.0,11,13195.0,13,S
2018-04-17 09:09:09,13190.0,4,6912,0,13190.0,10,13195.0,13,S
2018-04-17 09:09:16,13195.0,2,6914,0,13190.0,10,13195.0,14,B
2018-04-17 09:09:20,13195.0,14,6928,12,13190.0,10,13195.0,7,B
2018-04-17 09:09:20,13195.0,14,6942,4,13190.0,12,13200.0,29,B
2018-04-17 09:09:21,13190.0,4,6946,0,13190.0,18,13200.0,28,S
2018-04-17 09:09:27,13190.0,16,6962,2,13185.0,4,13195.0,9,S
2018-04-17 09:09:40,13185.0,2,6964,-2,13185.0,2,13190.0,5,S
2018-04-17 09:09:40,13185.0,4,6968,-4,13180.0,5,13185.0,11,S
2018-04-17 09:09:45,13185.0,10,6978,-10,13180.0,13,13190.0,14,S
2018-04-17 09:09:47,13190.0,18,6996,-8,13190.0,11,13195.0,5,B
2018-04-17 09:09:49,13190.0,2,6998,0,13190.0,10,13195.0,2,B
2018-04-17 09:09:51,13190.0,2,7000,0,13190.0,9,13195.0,6,B
2018-04-17 09:09:51,13190.0,10,7010,0,13190.0,4,13195.0,6,B
2018-04-17 09:09:52,13190.0,2,7012,-2,13190.0,3,13195.0,6,B
2018-04-17 09:09:53,13190.0,6,7018,0,13185.0,2,13190.0,4,B
2018-04-17 09:09:58,13180.0,2,7020,0,13180.0,13,13190.0,4,S
2018-04-17 09:10:00,13180.0,2,7022,2,13180.0,1,13185.0,1,S
2018-04-17 09:10:02,13180.0,2,7024,2,13175.0,6,13185.0,2,S
2018-04-17 09:10:24,13180.0,2,7026,2,13180.0,4,13185.0,3,S
2018-04-17 09:10:31,13185.0,2,7028,0,13180.0,4,13185.0,1,B
2018-04-17 09:10:37,13185.0,2,7030,0,13185.0,9,13190.0,8,B
2018-04-17 09:10:52,13185.0,2,7032,0,13185.0,8,13190.0,8,B
2018-04-17 09:11:02,13190.0,4,7036,2,13185.0,18,13195.0,10,B
2018-04-17 09:11:04,13195.0,12,7048,10,13195.0,4,13200.0,41,B
2018-04-17 09:11:04,13195.0,8,7056,0,13190.0,1,13195.0,7,B
2018-04-17 09:11:17,13190.0,2,7058,-2,13190.0,3,13195.0,3,S
2018-04-17 09:11:18,13195.0,4,7062,-4,13190.0,11,13195.0,1,B
2018-04-17 09:11:18,13195.0,2,7064,0,13190.0,13,13200.0,34,B
2018-04-17 09:11:21,13190.0,2,7066,-2,13190.0,1,13195.0,13,S
2018-04-17 09:11:21,13190.0,2,7068,-2,13185.0,11,13190.0,3,S
2018-04-17 09:11:25,13190.0,2,7070,2,13185.0,10,13190.0,2,S
2018-04-17 09:11:29,13190.0,2,7072,2,13185.0,27,13195.0,5,S
2018-04-17 09:11:31,13190.0,2,7074,2,13185.0,27,13195.0,7,S
2018-04-17 09:11:35,13190.0,6,7080,0,13185.0,16,13190.0,1,S
2018-04-17 09:11:35,13190.0,2,7082,0,13185.0,16,13195.0,30,S
2018-04-17 09:11:38,13195.0,2,7084,-2,13185.0,26,13195.0,3,B
2018-04-17 09:11:44,13195.0,2,7086,0,13185.0,26,13195.0,3,B
2018-04-17 09:11:49,13190.0,4,7090,4,13190.0,2,13195.0,2,S
2018-04-17 09:11:52,13190.0,2,7092,0,13190.0,4,13195.0,3,S
2018-04-17 09:11:57,13190.0,2,7094,0,13190.0,2,13195.0,3,S
2018-04-17 09:11:57,13190.0,4,7098,-4,13185.0,16,13190.0,3,S
2018-04-17 09:12:02,13190.0,6,7104,-6,13185.0,16,13195.0,3,S
2018-04-17 09:12:08,13190.0,2,7106,2,13185.0,16,13190.0,2,S
2018-04-17 09:12:09,13185.0,2,7108,-2,13185.0,15,13190.0,4,S
2018-04-17 09:12:09,13185.0,6,7114,0,13185.0,12,13190.0,4,S
2018-04-17 09:12:10,13185.0,2,7116,-2,13185.0,11,13190.0,4,S
2018-04-17 09:12:28,13185.0,2,7118,0,13185.0,10,13190.0,16,S
2018-04-17 09:12:34,13185.0,2,7120,0,13185.0,6,13190.0,6,S
2018-04-17 09:12:43,13185.0,6,7126,-4,13180.0,10,13185.0,7,S
2018-04-17 09:12:59,13180.0,2,7128,-2,13180.0,16,13190.0,11,S
2018-04-17 09:13:11,13180.0,10,7138,-2,13175.0,14,13180.0,1,S
2018-04-17 09:13:26,13180.0,20,7158,-12,13175.0,10,13185.0,14,S
2018-04-17 09:13:31,13185.0,2,7160,-2,13185.0,3,13190.0,8,B
2018-04-17 09:13:41,13185.0,2,7162,-2,13180.0,9,13185.0,1,B
2018-04-17 09:13:52,13185.0,4,7166,-2,13185.0,8,13190.0,11,B
2018-04-17 09:13:53,13185.0,16,7182,-4,13175.0,7,13185.0,3,B
2018-04-17 09:14:03,13180.0,2,7184,2,13175.0,7,13180.0,12,S
2018-04-17 09:14:07,13180.0,2,7186,-2,13175.0,7,13180.0,9,S
2018-04-17 09:14:08,13180.0,18,7204,-18,13180.0,1,13185.0,4,S
2018-04-17 09:14:09,13180.0,2,7206,-2,13175.0,7,13185.0,4,S
2018-04-17 09:14:30,13180.0,4,7210,-4,13175.0,15,13185.0,4,S
2018-04-17 09:15:23,13180.0,6,7216,-6,13175.0,6,13180.0,1,S
2018-04-17 09:15:33,13175.0,2,7218,0,13175.0,5,13180.0,2,S
2018-04-17 09:15:33,13180.0,2,7220,0,13175.0,5,13180.0,1,B
2018-04-17 09:15:45,13180.0,2,7222,0,13175.0,5,13185.0,8,B
2018-04-17 09:15:54,13180.0,2,7224,-2,13175.0,5,13180.0,3,B
2018-04-17 09:16:02,13175.0,4,7228,-4,13175.0,2,13180.0,22,S
2018-04-17 09:16:03,13175.0,4,7232,4,13170.0,12,13175.0,5,S
2018-04-17 09:16:08,13175.0,2,7234,0,13170.0,12,13175.0,3,S
2018-04-17 09:16:27,13175.0,2,7236,2,13170.0,9,13175.0,5,S
2018-04-17 09:16:38,13170.0,4,7240,-4,13170.0,7,13175.0,4,S
2018-04-17 09:16:47,13170.0,2,7242,-2,13170.0,6,13175.0,6,S
2018-04-17 09:16:47,13170.0,12,7254,-12,13165.0,7,13170.0,1,S
2018-04-17 09:16:50,13170.0,2,7256,-2,13165.0,6,13175.0,5,S
2018-04-17 09:17:06,13175.0,16,7272,6,13175.0,1,13180.0,27,B
2018-04-17 09:17:21,13175.0,8,7280,6,13170.0,18,13175.0,6,B
2018-04-17 09:17:26,13175.0,4,7284,4,13170.0,18,13175.0,5,B
2018-04-17 09:17:40,13170.0,8,7292,6,13170.0,14,13175.0,2,S
2018-04-17 09:17:44,13170.0,2,7294,-2,13170.0,13,13175.0,2,S
2018-04-17 09:17:53,13170.0,4,7298,0,13170.0,11,13175.0,2,S
2018-04-17 09:17:54,13170.0,4,7302,2,13170.0,10,13175.0,3,S
2018-04-17 09:18:04,13170.0,12,7314,6,13170.0,6,13175.0,3,S
2018-04-17 09:18:13,13175.0,2,7316,0,13170.0,6,13175.0,2,B
2018-04-17 09:18:13,13175.0,4,7320,2,13175.0,5,13180.0,25,B
2018-04-17 09:18:21,13175.0,6,7326,6,13175.0,1,13180.0,25,B
2018-04-17 09:18:21,13175.0,4,7330,2,13170.0,11,13180.0,26,B
2018-04-17 09:18:22,13175.0,4,7334,-4,13175.0,1,13180.0,26,B
2018-04-17 09:18:23,13175.0,2,7336,0,13175.0,1,13180.0,26,B
2018-04-17 09:18:26,13180.0,2,7338,0,13175.0,1,13180.0,25,B
2018-04-17 09:18:34,13175.0,4,7342,0,13170.0,17,13180.0,24,S
2018-04-17 09:18:37,13170.0,4,7346,0,13170.0,15,13180.0,25,S
2018-04-17 09:18:41,13180.0,2,7348,0,13170.0,6,13180.0,46,B
2018-04-17 09:18:50,13170.0,12,7360,2,13165.0,5,13180.0,34,S
2018-04-17 09:19:03,13165.0,18,7378,12,13165.0,1,13175.0,3,S
2018-04-17 09:19:03,13165.0,4,7382,0,13165.0,1,13175.0,4,S
2018-04-17 09:19:09,13165.0,10,7392,2,13160.0,19,13175.0,5,S
2018-04-17 09:19:13,13165.0,18,7410,16,13165.0,2,13175.0,5,S
2018-04-17 09:19:16,13165.0,2,7412,2,13165.0,6,13175.0,8,S
2018-04-17 09:19:20,13175.0,2,7414,0,13165.0,7,13175.0,7,B
2018-04-17 09:19:26,13165.0,10,7424,10,13160.0,12,13165.0,18,S
2018-04-17 09:19:27,13165.0,2,7426,2,13160.0,15,13165.0,17,S
2018-04-17 09:19:32,13165.0,6,7432,6,13160.0,15,13165.0,14,S
2018-04-17 09:19:34,13165.0,10,7442,8,13160.0,25,13165.0,9,S
2018-04-17 09:19:34,13165.0,6,7448,4,13160.0,26,13165.0,6,S
2018-04-17 09:19:35,13165.0,2,7450,2,13160.0,26,13165.0,5,S
2018-04-17 09:19:35,13165.0,10,7460,0,13165.0,2,13170.0,4,S
2018-04-17 09:19:38,13165.0,2,7462,2,13165.0,1,13170.0,4,S
2018-04-17 09:19:38,13165.0,2,7464,2,13160.0,14,13170.0,12,S
2018-04-17 09:19:49,13160.0,4,7468,0,13160.0,12,13170.0,12,S
2018-04-17 09:19:52,13165.0,2,7470,0,13160.0,12,13170.0,12,B
2018-04-17 09:20:01,13160.0,4,7474,0,13160.0,10,13170.0,14,S
2018-04-17 09:20:07,13165.0,2,7476,0,13160.0,10,13165.0,5,B
2018-04-17 09:20:09,13165.0,2,7478,2,13160.0,10,13165.0,4,B
2018-04-17 09:20:10,13165.0,2,7480,0,13160.0,10,13170.0,14,B
2018-04-17 09:20:16,13165.0,2,7482,-2,13160.0,10,13165.0,4,B
2018-04-17 09:20:17,13165.0,8,7490,-8,13165.0,10,13170.0,3,B
2018-04-17 09:20:18,13170.0,2,7492,0,13165.0,15,13175.0,7,B
2018-04-17 09:20:19,13165.0,2,7494,2,13165.0,14,13175.0,14,S
2018-04-17 09:20:20,13165.0,2,7496,0,13165.0,13,13175.0,13,S
2018-04-17 09:20:27,13170.0,2,7498,2,13165.0,9,13170.0,8,B
2018-04-17 09:20:32,13165.0,2,7500,2,13165.0,6,13170.0,18,S
2018-04-17 09:20:34,13165.0,22,7522,10,13160.0,23,13165.0,2,S
2018-04-17 09:20:35,13165.0,4,7526,4,13165.0,4,13170.0,18,S
2018-04-17 09:20:44,13165.0,2,7528,2,13165.0,5,13170.0,18,S
2018-04-17 09:20:56,13165.0,14,7542,12,13160.0,25,13165.0,3,S
2018-04-17 09:20:56,13165.0,6,7548,0,13165.0,13,13170.0,8,S
2018-04-17 09:21:17,13165.0,16,7564,0,13165.0,4,13175.0,12,S
2018-04-17 09:21:21,13165.0,10,7574,6,13160.0,12,13170.0,3,S
2018-04-17 09:21:25,13170.0,14,7588,-10,13170.0,4,13175.0,27,B
2018-04-17 09:21:25,13170.0,8,7596,0,13165.0,1,13170.0,6,B
2018-04-17 09:21:32,13170.0,2,7598,-2,13165.0,12,13170.0,2,B
2018-04-17 09:21:32,13170.0,4,7602,-4,13170.0,2,13175.0,25,B
2018-04-17 09:21:33,13170.0,4,7606,0,13165.0,14,13170.0,3,B
2018-04-17 09:21:34,13170.0,4,7610,-4,13170.0,1,13175.0,25,B
2018-04-17 09:21:36,13175.0,2,7612,-2,13170.0,2,13175.0,12,B
2018-04-17 09:21:37,13170.0,2,7614,0,13170.0,1,13175.0,12,S
2018-04-17 09:21:43,13175.0,4,7618,-4,13170.0,3,13175.0,10,B
2018-04-17 09:21:47,13175.0,2,7620,-2,13170.0,6,13175.0,9,B
2018-04-17 09:21:48,13175.0,8,7628,-4,13170.0,6,13175.0,5,B
2018-04-17 09:21:50,13170.0,4,7632,0,13170.0,4,13175.0,5,S
2018-04-17 09:21:52,13175.0,2,7634,-2,13170.0,4,13175.0,3,B
2018-04-17 09:21:53,13175.0,8,7642,-4,13175.0,12,13180.0,27,B
2018-04-17 09:21:54,13175.0,4,7646,-2,13175.0,10,13180.0,28,B
2018-04-17 09:21:54,13175.0,6,7652,-6,13175.0,12,13180.0,27,B
2018-04-17 09:21:56,13180.0,16,7668,10,13175.0,12,13180.0,16,B
2018-04-17 09:21:57,13180.0,12,7680,4,13175.0,13,13180.0,9,B
2018-04-17 09:21:58,13180.0,6,7686,2,13175.0,21,13180.0,5,B
2018-04-17 09:21:58,13180.0,2,7688,0,13175.0,21,13180.0,4,B
2018-04-17 09:22:07,13180.0,2,7690,2,13175.0,12,13180.0,4,B
2018-04-17 09:22:09,13180.0,2,7692,0,13175.0,7,13180.0,3,B
2018-04-17 09:22:10,13180.0,2,7694,-2,13175.0,7,13180.0,2,B
2018-04-17 09:22:18,13175.0,16,7710,-6,13170.0,7,13180.0,15,S
2018-04-17 09:22:19,13170.0,2,7712,0,13170.0,2,13180.0,15,S
2018-04-17 09:22:23,13170.0,34,7746,18,13165.0,11,13170.0,23,S
2018-04-17 09:22:24,13170.0,22,7768,14,13165.0,11,13170.0,12,S
2018-04-17 09:22:24,13170.0,8,7776,8,13165.0,13,13170.0,8,S
2018-04-17 09:22:25,13170.0,16,7792,8,13165.0,13,13175.0,1,S
2018-04-17 09:22:29,13175.0,8,7800,-4,13175.0,5,13180.0,24,B
2018-04-17 09:22:29,13175.0,10,7810,0,13170.0,6,13180.0,28,B
2018-04-17 09:22:48,13175.0,2,7812,-2,13170.0,8,13180.0,25,B
2018-04-17 09:22:49,13170.0,2,7814,-2,13170.0,3,13175.0,28,S
2018-04-17 09:22:49,13170.0,6,7820,-2,13165.0,13,13170.0,1,S
2018-04-17 09:23:01,13170.0,2,7822,2,13165.0,13,13175.0,26,S
2018-04-17 09:23:01,13175.0,2,7824,0,13165.0,13,13175.0,25,B
2018-04-17 09:23:05,13165.0,2,7826,0,13165.0,32,13170.0,2,S
2018-04-17 09:23:07,13170.0,4,7830,0,13170.0,4,13175.0,24,B
2018-04-17 09:23:09,13170.0,4,7834,0,13170.0,3,13175.0,24,B
2018-04-17 09:23:09,13170.0,6,7840,-2,13165.0,32,13175.0,24,B
2018-04-17 09:23:17,13175.0,6,7846,0,13165.0,32,13175.0,21,B
2018-04-17 09:23:18,13170.0,2,7848,0,13165.0,32,13170.0,1,S
2018-04-17 09:23:18,13170.0,2,7850,0,13165.0,32,13175.0,21,S
2018-04-17 09:23:50,13170.0,2,7852,2,13165.0,34,13170.0,1,S
2018-04-17 09:23:51,13170.0,2,7854,0,13165.0,34,13170.0,8,S
2018-04-17 09:23:51,13170.0,4,7858,-4,13165.0,34,13175.0,12,S
2018-04-17 09:23:59,13175.0,2,7860,0,13170.0,1,13175.0,22,B
2018-04-17 09:24:00,13170.0,8,7868,6,13165.0,36,13175.0,22,S
2018-04-17 09:24:01,13170.0,2,7870,2,13170.0,1,13175.0,22,S
2018-04-17 09:24:02,13170.0,2,7872,2,13165.0,36,13170.0,1,S
2018-04-17 09:24:10,13170.0,22,7894,4,13165.0,37,13170.0,2,S
2018-04-17 09:24:11,13170.0,4,7898,0,13170.0,2,13175.0,13,S
2018-04-17 09:24:11,13175.0,2,7900,-2,13170.0,4,13175.0,2,B
2018-04-17 09:24:12,13175.0,4,7904,0,13175.0,1,13180.0,6,B
2018-04-17 09:24:12,13175.0,2,7906,-2,13170.0,6,13180.0,8,B
2018-04-17 09:24:14,13180.0,2,7908,-2,13170.0,6,13180.0,8,B
2018-04-17 09:24:20,13170.0,2,7910,-2,13170.0,5,13175.0,2,S
2018-04-17 09:24:35,13170.0,8,7918,4,13165.0,42,13175.0,13,S
2018-04-17 09:24:37,13170.0,2,7920,2,13165.0,38,13175.0,15,S
2018-04-17 09:24:41,13170.0,2,7922,2,13165.0,38,13170.0,1,S
2018-04-17 09:24:44,13170.0,2,7924,2,13170.0,3,13175.0,13,S
2018-04-17 09:25:14,13170.0,12,7936,10,13170.0,5,13175.0,6,S
2018-04-17 09:25:16,13170.0,2,7938,-2,13170.0,4,13175.0,8,S
2018-04-17 09:25:16,13170.0,8,7946,0,13165.0,41,13170.0,5,S
2018-04-17 09:25:23,13170.0,2,7948,-2,13165.0,39,13170.0,7,S
2018-04-17 09:25:26,13170.0,2,7950,-2,13165.0,39,13170.0,5,S
2018-04-17 09:25:32,13170.0,14,7964,-6,13165.0,45,13175.0,8,S
2018-04-17 09:25:35,13170.0,4,7968,0,13170.0,9,13175.0,9,S
2018-04-17 09:25:40,13170.0,4,7972,0,13170.0,7,13175.0,7,S
2018-04-17 09:25:42,13170.0,2,7974,0,13170.0,6,13175.0,7,S
2018-04-17 09:25:47,13170.0,2,7976,0,13170.0,5,13175.0,8,S
2018-04-17 09:26:14,13175.0,18,7994,10,13175.0,1,13180.0,19,B
2018-04-17 09:26:15,13175.0,10,8004,-4,13175.0,4,13185.0,21,B
2018-04-17 09:26:16,13180.0,2,8006,-2,13175.0,1,13185.0,32,B
2018-04-17 09:26:16,13175.0,2,8008,0,13175.0,2,13185.0,32,S
2018-04-17 09:26:30,13180.0,2,8010,-2,13175.0,6,13180.0,1,B
2018-04-17 09:26:48,13180.0,4,8014,0,13175.0,9,13180.0,8,B
2018-04-17 09:26:52,13175.0,4,8018,4,13175.0,7,13180.0,8,S
2018-04-17 09:26:53,13180.0,20,8038,0,13180.0,12,13185.0,3,B
2018-04-17 09:27:04,13185.0,4,8042,-4,13180.0,14,13190.0,11,B
2018-04-17 09:27:04,13190.0,4,8046,-2,13180.0,12,13190.0,9,B
2018-04-17 09:27:05,13190.0,2,8048,-2,13180.0,12,13190.0,13,B
2018-04-17 09:27:10,13190.0,10,8058,-6,13180.0,11,13190.0,8,B
2018-04-17 09:27:10,13180.0,22,8080,0,13175.0,5,13185.0,17,S
2018-04-17 09:27:15,13185.0,8,8088,4,13175.0,4,13185.0,7,B
2018-04-17 09:27:24,13180.0,2,8090,2,13185.0,1,13190.0,8,S
2018-04-17 09:27:24,13185.0,2,8092,-2,13180.0,2,13185.0,1,B
2018-04-17 09:27:27,13185.0,2,8094,0,13180.0,2,13185.0,2,B
2018-04-17 09:27:38,13180.0,2,8096,2,13175.0,9,13180.0,1,S
2018-04-17 09:27:38,13180.0,2,8098,0,13175.0,12,13185.0,2,S
2018-04-17 09:27:49,13185.0,4,8102,0,13180.0,11,13185.0,1,B
2018-04-17 09:27:58,13185.0,6,8108,4,13180.0,3,13185.0,9,B
2018-04-17 09:28:01,13180.0,2,8110,0,13180.0,1,13185.0,9,S
2018-04-17 09:28:03,13180.0,2,8112,2,13175.0,11,13180.0,1,S
2018-04-17 09:28:07,13180.0,2,8114,2,13180.0,9,13185.0,1,S
2018-04-17 09:28:14,13180.0,2,8116,-2,13180.0,8,13190.0,10,S
2018-04-17 09:28:25,13185.0,6,8122,-2,13180.0,9,13190.0,9,B
2018-04-17 09:28:26,13185.0,4,8126,0,13180.0,9,13190.0,9,B
2018-04-17 09:28:58,13185.0,2,8128,2,13180.0,8,13190.0,12,B
2018-04-17 09:28:58,13190.0,2,8130,2,13180.0,8,13190.0,11,B
2018-04-17 09:29:15,13180.0,16,8146,6,13175.0,5,13180.0,1,S
2018-04-17 09:29:15,13175.0,6,8152,6,13170.0,10,13180.0,13,S
2018-04-17 09:29:23,13180.0,4,8156,2,13180.0,2,13185.0,2,B
2018-04-17 09:29:31,13180.0,2,8158,0,13175.0,3,13185.0,13,B
2018-04-17 09:29:55,13185.0,2,8160,0,13180.0,1,13185.0,1,B
2018-04-17 09:30:03,13185.0,10,8170,-8,13180.0,1,13185.0,2,B
2018-04-17 09:30:03,13185.0,4,8174,-4,13180.0,3,13190.0,8,B
2018-04-17 09:30:07,13180.0,2,8176,0,13175.0,3,13185.0,8,S
2018-04-17 09:30:45,13175.0,2,8178,2,13175.0,2,13180.0,4,S
2018-04-17 09:30:47,13175.0,2,8180,2,13170.0,11,13180.0,9,S
2018-04-17 09:31:05,13175.0,10,8190,0,13170.0,14,13180.0,12,S
2018-04-17 09:31:17,13175.0,4,8194,4,13175.0,1,13180.0,3,S
2018-04-17 09:32:17,13175.0,4,8198,2,13175.0,2,13180.0,1,S
2018-04-17 09:32:22,13180.0,2,8200,0,13175.0,2,13185.0,7,B
2018-04-17 09:32:45,13175.0,4,8204,2,13175.0,2,13185.0,11,S
2018-04-17 09:32:58,13175.0,2,8206,0,13170.0,13,13175.0,4,S
2018-04-17 09:33:09,13175.0,4,8210,0,13175.0,3,13180.0,3,S
2018-04-17 09:33:30,13175.0,2,8212,0,13175.0,2,13180.0,4,S
2018-04-17 09:33:43,13180.0,2,8214,0,13175.0,3,13180.0,2,B
2018-04-17 09:34:03,13175.0,4,8218,0,13170.0,15,13180.0,8,S
2018-04-17 09:34:52,13175.0,2,8220,-2,13170.0,16,13180.0,11,S
2018-04-17 09:34:55,13175.0,2,8222,-2,13170.0,17,13175.0,1,S
2018-04-17 09:34:56,13170.0,30,8252,4,13170.0,2,13175.0,3,S
2018-04-17 09:35:10,13175.0,2,8254,0,13170.0,3,13175.0,2,B
2018-04-17 09:35:27,13175.0,2,8256,-2,13170.0,3,13175.0,1,B
2018-04-17 09:35:48,13175.0,2,8258,0,13175.0,1,13180.0,13,B
2018-04-17 09:35:48,13175.0,2,8260,0,13170.0,9,13175.0,1,B
2018-04-17 09:36:27,13180.0,6,8266,2,13175.0,7,13180.0,1,B
2018-04-17 09:36:27,13180.0,2,8268,2,13180.0,1,13185.0,12,B
2018-04-17 09:37:27,13185.0,2,8270,2,13180.0,4,13185.0,2,B
2018-04-17 09:37:49,13185.0,4,8274,-4,13180.0,7,13190.0,8,B
2018-04-17 09:38:22,13185.0,2,8276,2,13180.0,5,13190.0,4,B
2018-04-17 09:38:28,13190.0,2,8278,0,13185.0,8,13190.0,3,B
2018-04-17 09:38:29,13190.0,4,8282,-2,13185.0,8,13190.0,1,B
2018-04-17 09:38:39,13190.0,2,8284,2,13185.0,8,13195.0,7,B
2018-04-17 09:38:41,13185.0,2,8286,0,13185.0,7,13195.0,4,S
2018-04-17 09:38:48,13190.0,2,8288,2,13190.0,5,13195.0,4,B
2018-04-17 09:38:49,13195.0,6,8294,0,13190.0,5,13195.0,1,B
2018-04-17 09:38:50,13200.0,50,8344,-20,13195.0,13,13200.0,11,B
2018-04-17 09:38:50,13200.0,20,8364,6,13195.0,19,13200.0,1,B
2018-04-17 09:38:51,13200.0,2,8366,0,13195.0,17,13205.0,5,B
2018-04-17 09:38:55,13205.0,16,8382,-10,13200.0,3,13205.0,5,B
2018-04-17 09:38:56,13205.0,4,8386,-2,13200.0,3,13205.0,3,B
2018-04-17 09:39:04,13205.0,8,8394,-4,13205.0,1,13210.0,22,B
2018-04-17 09:39:05,13205.0,2,8396,0,13200.0,2,13205.0,4,B
2018-04-17 09:39:05,13205.0,8,8404,0,13205.0,1,13210.0,11,B
2018-04-17 09:39:06,13205.0,2,8406,0,13200.0,2,13205.0,6,B
2018-04-17 09:39:07,13200.0,4,8410,0,13195.0,4,13200.0,1,S
2018-04-17 09:39:09,13200.0,2,8412,2,13195.0,4,13200.0,1,S
2018-04-17 09:39:12,13200.0,2,8414,0,13200.0,9,13205.0,9,S
2018-04-17 09:39:12,13200.0,2,8416,0,13200.0,8,13205.0,9,S
2018-04-17 09:39:18,13205.0,8,8424,0,13200.0,8,13205.0,1,B
2018-04-17 09:39:18,13205.0,2,8426,-2,13200.0,8,13205.0,1,B
2018-04-17 09:39:21,13200.0,2,8428,2,13200.0,8,13205.0,2,S
2018-04-17 09:39:24,13205.0,12,8440,0,13200.0,3,13205.0,2,B
2018-04-17 09:39:28,13205.0,2,8442,0,13200.0,6,13210.0,12,B
2018-04-17 09:39:34,13205.0,6,8448,6,13200.0,11,13205.0,2,B
2018-04-17 09:39:34,13205.0,4,8452,4,13200.0,10,13210.0,7,B
2018-04-17 09:39:41,13210.0,6,8458,0,13205.0,2,13210.0,4,B
2018-04-17 09:39:42,13210.0,6,8464,2,13205.0,5,13210.0,1,B
2018-04-17 09:39:43,13205.0,4,8468,-2,13205.0,1,13210.0,3,S
2018-04-17 09:39:44,13210.0,8,8476,-4,13205.0,1,13210.0,1,B
2018-04-17 09:39:46,13215.0,8,8484,-2,13205.0,2,13215.0,4,B
2018-04-17 09:39:47,13215.0,4,8488,0,13205.0,3,13215.0,2,B
2018-04-17 09:39:51,13210.0,12,8500,-4,13205.0,1,13210.0,3,S
2018-04-17 09:39:51,13210.0,6,8506,-6,13205.0,3,13215.0,4,S
2018-04-17 09:39:53,13215.0,4,8510,-4,13205.0,4,13215.0,1,B
2018-04-17 09:39:56,13210.0,2,8512,2,13205.0,3,13210.0,1,S
2018-04-17 09:39:56,13210.0,2,8514,2,13210.0,4,13215.0,2,S
2018-04-17 09:40:05,13210.0,2,8516,2,13210.0,3,13215.0,4,S
2018-04-17 09:40:06,13210.0,6,8522,0,13205.0,2,13210.0,1,S
2018-04-17 09:40:08,13210.0,2,8524,0,13205.0,1,13210.0,7,S
2018-04-17 09:40:14,13205.0,2,8526,2,13205.0,2,13210.0,7,S
2018-04-17 09:40:17,13210.0,2,8528,-2,13205.0,2,13210.0,6,B
2018-04-17 09:40:21,13210.0,2,8530,-2,13205.0,17,13210.0,2,B
2018-04-17 09:40:21,13210.0,4,8534,-4,13205.0,21,13215.0,8,B
2018-04-17 09:40:23,13210.0,2,8536,2,13210.0,9,13215.0,5,B
2018-04-17 09:40:31,13215.0,14,8550,4,13210.0,7,13220.0,25,B
2018-04-17 09:40:32,13210.0,4,8554,2,13210.0,3,13215.0,3,S
2018-04-17 09:40:37,13220.0,6,8560,4,13215.0,7,13220.0,19,B
2018-04-17 09:40:38,13220.0,20,8580,-6,13215.0,6,13220.0,9,B
2018-04-17 09:40:38,13220.0,12,8592,12,13215.0,6,13220.0,3,B
2018-04-17 09:40:39,13215.0,2,8594,0,13210.0,6,13220.0,3,S
2018-04-17 09:40:40,13220.0,2,8596,0,13210.0,6,13220.0,2,B
2018-04-17 09:40:52,13215.0,6,8602,4,13210.0,6,13220.0,10,S
2018-04-17 09:40:57,13210.0,2,8604,0,13210.0,4,13220.0,13,S
2018-04-17 09:40:57,13210.0,2,8606,0,13210.0,3,13220.0,13,S
2018-04-17 09:41:03,13210.0,2,8608,0,13210.0,3,13215.0,2,S
2018-04-17 09:41:08,13210.0,4,8612,2,13205.0,6,13215.0,5,S
2018-04-17 09:41:15,13210.0,2,8614,0,13210.0,1,13215.0,6,S
2018-04-17 09:41:22,13210.0,2,8616,0,13210.0,1,13215.0,6,S
2018-04-17 09:41:29,13210.0,4,8620,2,13205.0,5,13215.0,6,S
2018-04-17 09:41:37,13205.0,4,8624,2,13205.0,4,13215.0,9,S
2018-04-17 09:41:39,13205.0,6,8630,-2,13200.0,8,13210.0,6,S
2018-04-17 09:41:40,13205.0,2,8632,0,13200.0,10,13210.0,6,S
2018-04-17 09:41:43,13200.0,12,8644,4,13200.0,2,13205.0,6,S
2018-04-17 09:41:44,13200.0,2,8646,0,13200.0,1,13205.0,7,S
2018-04-17 09:41:44,13200.0,2,8648,2,13195.0,2,13205.0,5,S
2018-04-17 09:41:48,13200.0,4,8652,4,13195.0,32,13205.0,4,S
2018-04-17 09:41:49,13200.0,4,8656,0,13200.0,1,13205.0,4,S
2018-04-17 09:41:53,13200.0,2,8658,2,13200.0,1,13205.0,4,S
2018-04-17 09:41:57,13200.0,4,8662,0,13195.0,35,13205.0,5,S
2018-04-17 09:42:06,13200.0,4,8666,0,13200.0,2,13205.0,5,S
2018-04-17 09:42:07,13200.0,4,8670,0,13200.0,2,13205.0,4,S
2018-04-17 09:42:18,13200.0,4,8674,4,13200.0,1,13205.0,4,S
2018-04-17 09:42:25,13200.0,2,8676,0,13200.0,1,13205.0,4,S
2018-04-17 09:42:46,13200.0,2,8678,2,13195.0,10,13205.0,23,S
2018-04-17 09:42:52,13200.0,2,8680,0,13195.0,6,13200.0,3,S
2018-04-17 09:42:54,13200.0,2,8682,-2,13195.0,6,13200.0,3,S
2018-04-17 09:43:12,13200.0,2,8684,0,13195.0,5,13200.0,2,S
2018-04-17 09:43:24,13200.0,2,8686,-2,13195.0,2,13200.0,1,S
2018-04-17 09:44:11,13200.0,4,8690,-2,13200.0,3,13205.0,8,S
2018-04-17 09:44:12,13200.0,6,8696,0,13195.0,5,13205.0,8,S
2018-04-17 09:44:17,13195.0,2,8698,2,13195.0,6,13205.0,8,S
2018-04-17 09:44:18,13200.0,2,8700,2,13195.0,6,13200.0,1,B
2018-04-17 09:44:32,13200.0,2,8702,-2,13195.0,6,13205.0,20,B
2018-04-17 09:44:55,13195.0,12,8714,4,13190.0,5,13195.0,14,S
2018-04-17 09:44:56,13195.0,10,8724,8,13190.0,9,13195.0,9,S
2018-04-17 09:45:00,13195.0,4,8728,4,13190.0,12,13195.0,7,S
2018-04-17 09:45:00,13195.0,14,8742,14,13195.0,3,13200.0,2,S
2018-04-17 09:45:03,13200.0,6,8748,-4,13200.0,8,13205.0,4,B
2018-04-17 09:45:05,13200.0,2,8750,0,13195.0,13,13205.0,1,B
2018-04-17 09:45:14,13200.0,2,8752,2,13195.0,28,13200.0,1,B
2018-04-17 09:45:14,13200.0,2,8754,2,13200.0,1,13205.0,3,B
2018-04-17 09:45:27,13200.0,2,8756,-2,13195.0,15,13205.0,9,B
2018-04-17 09:45:44,13200.0,4,8760,0,13195.0,15,13205.0,9,B
2018-04-17 09:46:01,13200.0,4,8764,4,13195.0,12,13205.0,9,B
2018-04-17 09:46:02,13195.0,4,8768,0,13195.0,10,13205.0,9,S
2018-04-17 09:46:04,13200.0,2,8770,2,13195.0,10,13205.0,9,B
2018-04-17 09:46:15,13200.0,2,8772,2,13200.0,2,13205.0,11,B
2018-04-17 09:46:40,13200.0,2,8774,2,13200.0,1,13205.0,1,B
2018-04-17 09:46:43,13205.0,2,8776,-2,13200.0,1,13210.0,13,B
2018-04-17 09:46:44,13200.0,4,8780,2,13200.0,1,13210.0,17,S
2018-04-17 09:47:37,13210.0,2,8782,2,13205.0,14,13210.0,4,B
2018-04-17 09:47:43,13205.0,2,8784,0,13205.0,13,13210.0,5,S
2018-04-17 09:47:44,13205.0,26,8810,22,13200.0,1,13205.0,1,S
2018-04-17 09:47:49,13205.0,4,8814,-2,13200.0,3,13205.0,4,S
2018-04-17 09:48:01,13205.0,6,8820,2,13205.0,1,13210.0,14,S
2018-04-17 09:48:26,13205.0,6,8826,0,13200.0,5,13210.0,12,S
2018-04-17 09:49:07,13205.0,2,8828,0,13205.0,9,13210.0,14,S
2018-04-17 09:49:17,13205.0,4,8832,0,13200.0,6,13210.0,15,S
2018-04-17 09:49:20,13205.0,2,8834,-2,13200.0,5,13205.0,3,S
2018-04-17 09:49:33,13205.0,6,8840,-6,13205.0,7,13210.0,15,S
2018-04-17 09:49:34,13205.0,14,8854,-12,13200.0,5,13210.0,15,S
2018-04-17 09:49:40,13200.0,2,8856,0,13200.0,4,13210.0,15,S
2018-04-17 09:49:56,13200.0,2,8858,0,13200.0,1,13205.0,19,S
2018-04-17 09:49:58,13200.0,2,8860,0,13195.0,11,13205.0,19,S
2018-04-17 09:50:10,13200.0,2,8862,0,13195.0,10,13205.0,20,S
2018-04-17 09:50:35,13200.0,2,8864,0,13200.0,9,13205.0,30,S
2018-04-17 09:50:39,13200.0,2,8866,2,13200.0,8,13205.0,30,S
2018-04-17 09:51:00,13205.0,2,8868,-2,13200.0,10,13205.0,13,B
2018-04-17 09:51:00,13205.0,26,8894,-2,13200.0,11,13210.0,24,B
2018-04-17 09:51:01,13200.0,20,8914,-4,13200.0,1,13210.0,24,S
2018-04-17 09:51:02,13200.0,8,8922,-2,13195.0,23,13200.0,6,S
2018-04-17 09:51:03,13200.0,12,8934,-12,13200.0,5,13205.0,1,S
2018-04-17 09:51:28,13205.0,2,8936,2,13195.0,21,13205.0,1,B
2018-04-17 09:51:44,13210.0,2,8938,0,13205.0,4,13210.0,15,B
2018-04-17 09:51:44,13210.0,6,8944,-4,13205.0,4,13210.0,12,B
2018-04-17 09:51:45,13205.0,8,8952,8,13200.0,12,13205.0,6,S
2018-04-17 09:51:47,13205.0,2,8954,2,13200.0,12,13205.0,5,S
2018-04-17 09:51:48,13205.0,2,8956,2,13200.0,12,13205.0,6,S
2018-04-17 09:51:51,13205.0,4,8960,4,13200.0,12,13205.0,4,S
2018-04-17 09:52:04,13205.0,2,8962,2,13200.0,13,13205.0,3,S
2018-04-17 09:52:06,13205.0,2,8964,2,13200.0,13,13205.0,2,S
2018-04-17 09:52:08,13200.0,24,8988,4,13195.0,14,13205.0,2,S
2018-04-17 09:52:20,13200.0,2,8990,0,13195.0,12,13205.0,7,S
2018-04-17 09:53:03,13200.0,2,8992,-2,13195.0,9,13200.0,3,S
2018-04-17 09:53:04,13200.0,6,8998,-2,13200.0,2,13205.0,7,S
2018-04-17 09:53:06,13200.0,4,9002,0,13195.0,15,13205.0,4,S
2018-04-17 09:53:29,13200.0,4,9006,4,13195.0,13,13205.0,9,S
2018-04-17 09:53:33,13200.0,2,9008,0,13195.0,13,13205.0,4,S
2018-04-17 09:53:44,13205.0,12,9020,-8,13195.0,13,13210.0,27,B
2018-04-17 09:53:51,13205.0,2,9022,0,13200.0,3,13210.0,25,B
2018-04-17 09:53:57,13205.0,2,9024,0,13205.0,1,13210.0,18,B
2018-04-17 09:53:57,13205.0,2,9026,2,13200.0,2,13205.0,1,B
2018-04-17 09:54:09,13200.0,4,9030,4,13195.0,20,13205.0,1,S
2018-04-17 09:54:51,13205.0,4,9034,0,13205.0,1,13210.0,18,B
2018-04-17 09:55:07,13205.0,4,9038,2,13200.0,11,13210.0,30,B
2018-04-17 09:55:20,13205.0,2,9040,0,13200.0,9,13210.0,43,B
2018-04-17 09:55:29,13205.0,2,9042,2,13200.0,17,13205.0,1,B
2018-04-17 09:56:12,13205.0,2,9044,2,13200.0,17,13210.0,22,B
2018-04-17 09:56:15,13205.0,2,9046,2,13200.0,17,13205.0,1,B
2018-04-17 09:56:17,13205.0,2,9048,-2,13205.0,9,13210.0,22,B
2018-04-17 09:56:21,13205.0,2,9050,-2,13205.0,8,13210.0,22,B
2018-04-17 09:56:22,13205.0,16,9066,-4,13200.0,17,13210.0,38,B
2018-04-17 09:56:25,13205.0,2,9068,0,13200.0,17,13205.0,7,B
2018-04-17 09:56:27,13205.0,2,9070,0,13200.0,17,13205.0,6,B
2018-04-17 09:56:28,13205.0,2,9072,2,13200.0,27,13205.0,5,B
2018-04-17 09:56:33,13205.0,2,9074,-2,13200.0,27,13205.0,6,B
2018-04-17 09:56:35,13205.0,2,9076,0,13200.0,27,13205.0,4,B
2018-04-17 09:56:42,13205.0,4,9080,0,13200.0,31,13205.0,2,B
2018-04-17 09:56:43,13205.0,2,9082,-2,13200.0,33,13205.0,1,B
2018-04-17 09:56:46,13200.0,2,9084,0,13200.0,32,13205.0,1,S
2018-04-17 09:56:48,13205.0,2,9086,-2,13205.0,9,13210.0,18,B
2018-04-17 09:56:58,13210.0,2,9088,0,13205.0,9,13210.0,19,B
2018-04-17 09:57:00,13205.0,4,9092,-4,13205.0,7,13210.0,19,S
2018-04-17 09:57:00,13210.0,2,9094,2,13205.0,7,13210.0,18,B
2018-04-17 09:57:33,13205.0,4,9098,0,13205.0,6,13210.0,26,S
2018-04-17 09:57:46,13205.0,20,9118,4,13205.0,2,13210.0,24,S
2018-04-17 09:57:47,13205.0,2,9120,0,13200.0,28,13205.0,1,S
2018-04-17 09:57:49,13205.0,2,9122,0,13205.0,3,13210.0,26,S
2018-04-17 09:57:50,13205.0,4,9126,4,13205.0,1,13210.0,24,S
2018-04-17 09:57:57,13205.0,4,9130,0,13205.0,9,13210.0,24,S
2018-04-17 09:58:12,13205.0,20,9150,0,13200.0,27,13210.0,13,S
2018-04-17 09:58:18,13210.0,2,9152,2,13205.0,4,13210.0,12,B
2018-04-17 09:58:19,13210.0,14,9166,-4,13205.0,4,13210.0,5,B
2018-04-17 09:58:32,13210.0,2,9168,-2,13205.0,5,13210.0,3,B
2018-04-17 09:58:45,13205.0,6,9174,4,13200.0,27,13210.0,13,S
2018-04-17 09:58:46,13205.0,4,9178,4,13200.0,27,13210.0,13,S
2018-04-17 09:59:02,13205.0,18,9196,0,13200.0,28,13205.0,1,S
2018-04-17 09:59:03,13205.0,2,9198,2,13200.0,28,13210.0,5,S
2018-04-17 09:59:25,13205.0,4,9202,4,13200.0,33,13205.0,8,S
2018-04-17 09:59:26,13205.0,16,9218,4,13205.0,1,13210.0,13,S
2018-04-17 09:59:26,13205.0,2,9220,-2,13205.0,1,13210.0,13,S
2018-04-17 09:59:27,13205.0,2,9222,0,13200.0,40,13210.0,13,S
2018-04-17 09:59:32,13205.0,4,9226,4,13200.0,40,13205.0,8,S
2018-04-17 09:59:32,13205.0,4,9230,4,13200.0,44,13205.0,6,S
2018-04-17 09:59:39,13205.0,10,9240,10,13200.0,37,13205.0,1,S
2018-04-17 09:59:39,13205.0,2,9242,0,13205.0,1,13210.0,16,S
2018-04-17 09:59:43,13210.0,12,9254,-6,13205.0,3,13210.0,10,B
2018-04-17 09:59:54,13205.0,6,9260,6,13200.0,40,13205.0,7,S
2018-04-17 09:59:56,13205.0,4,9264,4,13200.0,44,13205.0,7,S
2018-04-17 10:00:02,13205.0,26,9290,26,13200.0,44,13205.0,4,S
2018-04-17 10:00:03,13205.0,8,9298,4,13205.0,4,13210.0,9,S
2018-04-17 10:00:03,13205.0,8,9306,0,13200.0,49,13205.0,2,S
2018-04-17 10:00:04,13205.0,4,9310,-4,13200.0,41,13210.0,9,S
2018-04-17 10:00:05,13205.0,2,9312,0,13200.0,38,13210.0,10,S
2018-04-17 10:00:13,13200.0,4,9316,-4,13200.0,32,13205.0,13,S
2018-04-17 10:00:27,13200.0,20,9336,0,13200.0,25,13205.0,11,S
2018-04-17 10:00:38,13200.0,4,9340,0,13200.0,20,13205.0,13,S
2018-04-17 10:00:42,13200.0,12,9352,-10,13200.0,10,13205.0,15,S
2018-04-17 10:00:43,13200.0,20,9372,8,13195.0,12,13200.0,3,S
2018-04-17 10:00:44,13200.0,2,9374,-2,13195.0,9,13200.0,1,S
2018-04-17 10:00:58,13200.0,8,9382,0,13195.0,9,13200.0,9,S
2018-04-17 10:00:59,13195.0,18,9400,0,13190.0,7,13195.0,1,S
2018-04-17 10:01:00,13195.0,2,9402,2,13195.0,2,13200.0,9,S
2018-04-17 10:01:01,13195.0,4,9406,2,13195.0,1,13200.0,9,S
2018-04-17 10:01:03,13200.0,2,9408,0,13195.0,3,13200.0,8,B
2018-04-17 10:01:03,13200.0,6,9414,6,13195.0,9,13200.0,5,B
2018-04-17 10:01:04,13200.0,10,9424,8,13195.0,12,13205.0,15,B
2018-04-17 10:01:06,13205.0,2,9426,2,13200.0,6,13205.0,13,B
2018-04-17 10:01:09,13200.0,4,9430,4,13200.0,3,13205.0,4,S
2018-04-17 10:01:11,13200.0,6,9436,0,13195.0,9,13205.0,5,S
2018-04-17 10:01:22,13200.0,12,9448,0,13195.0,23,13205.0,8,S
2018-04-17 10:01:25,13200.0,2,9450,0,13195.0,19,13205.0,8,S
2018-04-17 10:01:32,13205.0,4,9454,0,13200.0,12,13205.0,2,B
2018-04-17 10:01:33,13205.0,2,9456,0,13200.0,12,13205.0,1,B
2018-04-17 10:01:38,13200.0,2,9458,2,13200.0,1,13205.0,6,S
2018-04-17 10:01:51,13205.0,4,9462,0,13205.0,8,13210.0,4,B
2018-04-17 10:02:10,13210.0,20,9482,8,13205.0,8,13215.0,15,B
2018-04-17 10:02:10,13205.0,4,9486,4,13205.0,6,13215.0,20,S
2018-04-17 10:02:19,13210.0,2,9488,-2,13200.0,12,13210.0,8,B
2018-04-17 10:02:25,13205.0,2,9490,0,13200.0,6,13210.0,14,S
2018-04-17 10:02:39,13210.0,20,9510,8,13205.0,3,13210.0,3,B
2018-04-17 10:02:45,13210.0,6,9516,0,13205.0,10,13215.0,17,B
2018-04-17 10:02:59,13215.0,46,9562,14,13215.0,1,13220.0,10,B
2018-04-17 10:03:00,13220.0,14,9576,6,13220.0,8,13225.0,9,B
2018-04-17 10:03:00,13225.0,2,9578,0,13220.0,10,13225.0,8,B
2018-04-17 10:03:01,13225.0,2,9580,0,13220.0,8,13225.0,7,B
2018-04-17 10:03:01,13220.0,28,9608,8,13215.0,31,13225.0,7,S
2018-04-17 10:03:03,13220.0,2,9610,-2,13215.0,1,13225.0,15,S
2018-04-17 10:03:09,13215.0,4,9614,4,13215.0,6,13225.0,10,S
2018-04-17 10:03:09,13215.0,2,9616,0,13215.0,2,13225.0,16,S
2018-04-17 10:03:10,13215.0,2,9618,0,13215.0,1,13220.0,4,S
2018-04-17 10:03:13,13220.0,6,9624,6,13215.0,1,13220.0,2,B
2018-04-17 10:03:14,13215.0,2,9626,0,13210.0,8,13220.0,2,S
2018-04-17 10:03:17,13210.0,2,9628,2,13205.0,11,13220.0,12,S
2018-04-17 10:03:26,13210.0,2,9630,0,13210.0,1,13215.0,8,S
2018-04-17 10:03:27,13210.0,2,9632,0,13205.0,13,13210.0,1,S
2018-04-17 10:03:30,13215.0,4,9636,-4,13205.0,20,13215.0,4,B
2018-04-17 10:03:35,13215.0,2,9638,0,13210.0,3,13215.0,4,B
2018-04-17 10:03:36,13215.0,8,9646,0,13215.0,6,13220.0,14,B
2018-04-17 10:03:36,13215.0,2,9648,0,13215.0,5,13220.0,14,B
2018-04-17 10:03:37,13215.0,10,9658,6,13210.0,3,13220.0,11,B
2018-04-17 10:03:39,13215.0,2,9660,-2,13210.0,3,13220.0,11,B
2018-04-17 10:03:53,13210.0,2,9662,-2,13210.0,3,13215.0,2,S
2018-04-17 10:04:18,13210.0,4,9666,0,13210.0,2,13215.0,2,S
2018-04-17 10:04:19,13215.0,4,9670,4,13210.0,1,13220.0,10,B
2018-04-17 10:04:31,13215.0,2,9672,2,13210.0,2,13220.0,22,B
2018-04-17 10:04:38,13215.0,4,9676,-4,13215.0,1,13220.0,21,B
2018-04-17 10:04:39,13220.0,2,9678,0,13215.0,4,13225.0,26,B
2018-04-17 10:04:41,13225.0,2,9680,2,13215.0,3,13225.0,27,B
2018-04-17 10:04:50,13225.0,2,9682,2,13215.0,1,13220.0,2,B
2018-04-17 10:04:54,13215.0,2,9684,-2,13210.0,7,13220.0,5,S
2018-04-17 10:04:56,13220.0,2,9686,2,13210.0,4,13220.0,22,B
2018-04-17 10:05:09,13220.0,2,9688,0,13215.0,15,13225.0,12,B
2018-04-17 10:05:14,13220.0,2,9690,0,13215.0,13,13220.0,1,B
2018-04-17 10:05:15,13220.0,2,9692,0,13215.0,14,13225.0,10,B
2018-04-17 10:05:18,13225.0,6,9698,4,13215.0,9,13225.0,9,B
2018-04-17 10:05:43,13220.0,4,9702,0,13220.0,8,13225.0,24,S
2018-04-17 10:05:43,13220.0,10,9712,-6,13220.0,3,13225.0,28,S
2018-04-17 10:05:44,13220.0,6,9718,-6,13215.0,2,13220.0,1,S
2018-04-17 10:05:53,13220.0,2,9720,0,13215.0,2,13225.0,27,S
2018-04-17 10:05:55,13225.0,6,9726,-4,13220.0,7,13225.0,26,B
2018-04-17 10:05:56,13220.0,6,9732,0,13220.0,5,13225.0,14,S
2018-04-17 10:05:58,13220.0,4,9736,0,13220.0,3,13225.0,14,S
2018-04-17 10:05:59,13220.0,2,9738,0,13220.0,2,13225.0,14,S
2018-04-17 10:06:00,13220.0,4,9742,2,13215.0,5,13225.0,14,S
2018-04-17 10:06:12,13215.0,8,9750,4,13210.0,7,13215.0,2,S
2018-04-17 10:06:43,13210.0,2,9752,2,13210.0,1,13215.0,5,S
2018-04-17 10:06:48,13215.0,2,9754,2,13210.0,1,13215.0,3,B
2018-04-17 10:06:51,13210.0,2,9756,-2,13205.0,10,13215.0,3,S
2018-04-17 10:07:09,13210.0,2,9758,-2,13205.0,10,13215.0,9,S
2018-04-17 10:07:34,13210.0,2,9760,0,13210.0,9,13215.0,21,S
2018-04-17 10:07:46,13215.0,4,9764,0,13210.0,9,13215.0,7,B
2018-04-17 10:07:50,13210.0,2,9766,-2,13210.0,8,13215.0,7,S
2018-04-17 10:07:51,13215.0,6,9772,-6,13210.0,8,13215.0,4,B
2018-04-17 10:07:54,13215.0,4,9776,-2,13210.0,8,13215.0,4,B
2018-04-17 10:08:00,13210.0,2,9778,-2,13210.0,7,13215.0,7,S
2018-04-17 10:08:09,13210.0,2,9780,-2,13210.0,6,13215.0,5,S
2018-04-17 10:08:58,13210.0,2,9782,-2,13210.0,5,13215.0,3,S
2018-04-17 10:09:04,13210.0,2,9784,0,13210.0,4,13215.0,7,S
2018-04-17 10:09:23,13210.0,2,9786,0,13210.0,3,13215.0,7,S
2018-04-17 10:10:02,13205.0,12,9798,-4,13205.0,3,13215.0,14,S
2018-04-17 10:10:16,13205.0,6,9804,-4,13200.0,11,13205.0,2,S
2018-04-17 10:10:16,13200.0,2,9806,0,13200.0,1,13210.0,20,S
2018-04-17 10:10:30,13205.0,2,9808,0,13200.0,10,13210.0,8,B
2018-04-17 10:10:40,13200.0,2,9810,0,13200.0,9,13210.0,8,S
2018-04-17 10:10:49,13200.0,2,9812,0,13200.0,8,13210.0,8,S
2018-04-17 10:11:02,13200.0,2,9814,0,13200.0,7,13210.0,7,S
2018-04-17 10:11:03,13210.0,4,9818,0,13205.0,17,13215.0,9,B
2018-04-17 10:11:12,13215.0,2,9820,-2,13205.0,12,13215.0,7,B
2018-04-17 10:11:22,13205.0,2,9822,0,13205.0,21,13215.0,7,S
2018-04-17 10:11:31,13205.0,2,9824,0,13205.0,20,13215.0,8,S
2018-04-17 10:11:43,13210.0,2,9826,-2,13210.0,3,13215.0,9,B
2018-04-17 10:12:18,13210.0,2,9828,0,13205.0,17,13215.0,11,B
2018-04-17 10:12:26,13210.0,4,9832,4,13205.0,19,13210.0,2,B
2018-04-17 10:12:36,13210.0,6,9838,-2,13210.0,3,13215.0,7,B
2018-04-17 10:12:39,13215.0,2,9840,-2,13210.0,10,13215.0,6,B
2018-04-17 10:12:39,13215.0,8,9848,2,13210.0,10,13215.0,2,B
2018-04-17 10:12:55,13215.0,4,9852,-4,13215.0,2,13220.0,8,B
2018-04-17 10:13:00,13215.0,10,9862,6,13210.0,15,13215.0,5,B
2018-04-17 10:13:07,13215.0,4,9866,-4,13210.0,14,13215.0,1,B
2018-04-17 10:13:08,13215.0,2,9868,-2,13210.0,14,13220.0,14,B
2018-04-17 10:13:11,13210.0,10,9878,-4,13210.0,9,13220.0,27,S
2018-04-17 10:13:12,13215.0,4,9882,0,13215.0,8,13220.0,26,B
2018-04-17 10:13:12,13215.0,2,9884,-2,13215.0,7,13220.0,26,B
2018-04-17 10:13:13,13215.0,6,9890,-6,13215.0,4,13220.0,28,B
2018-04-17 10:13:15,13215.0,2,9892,-2,13215.0,3,13220.0,28,B
2018-04-17 10:13:19,13220.0,4,9896,0,13215.0,10,13220.0,3,B
2018-04-17 10:13:22,13220.0,6,9902,-2,13215.0,10,13225.0,12,B
2018-04-17 10:13:26,13225.0,2,9904,0,13215.0,10,13225.0,13,B
2018-04-17 10:13:29,13225.0,20,9924,-4,13215.0,10,13225.0,2,B
2018-04-17 10:13:30,13225.0,6,9930,-6,13225.0,2,13230.0,14,B
2018-04-17 10:13:30,13225.0,4,9934,0,13215.0,10,13225.0,1,B
2018-04-17 10:13:46,13225.0,8,9942,-6,13215.0,11,13225.0,4,B
2018-04-17 10:13:52,13225.0,6,9948,-4,13220.0,1,13225.0,4,B
2018-04-17 10:13:55,13225.0,8,9956,4,13225.0,6,13230.0,27,B
2018-04-17 10:13:55,13225.0,12,9968,12,13220.0,2,13230.0,28,B
2018-04-17 10:14:01,13225.0,4,9972,0,13220.0,3,13225.0,1,B
2018-04-17 10:14:04,13225.0,2,9974,-2,13220.0,4,13225.0,2,B
2018-04-17 10:14:08,13225.0,2,9976,-2,13220.0,2,13225.0,6,B
2018-04-17 10:14:08,13225.0,2,9978,0,13220.0,2,13225.0,5,B
2018-04-17 10:14:17,13220.0,2,9980,-2,13215.0,11,13220.0,1,S
2018-04-17 10:14:18,13220.0,2,9982,-2,13215.0,11,13225.0,7,S
2018-04-17 10:14:24,13220.0,2,9984,-2,13220.0,2,13225.0,7,S
2018-04-17 10:14:31,13225.0,8,9992,-4,13225.0,9,13230.0,13,B
2018-04-17 10:14:32,13230.0,2,9994,2,13225.0,14,13230.0,10,B
2018-04-17 10:14:32,13230.0,8,10002,-2,13225.0,13,13230.0,7,B
2018-04-17 10:14:33,13230.0,14,10016,4,13230.0,8,13235.0,4,B
2018-04-17 10:14:34,13235.0,4,10020,4,13230.0,8,13235.0,1,B
2018-04-17 10:14:35,13235.0,2,10022,0,13230.0,8,13240.0,6,B
2018-04-17 10:14:36,13235.0,2,10024,0,13230.0,8,13240.0,7,B
2018-04-17 10:14:40,13230.0,16,10040,10,13225.0,5,13230.0,1,S
2018-04-17 10:14:40,13225.0,10,10050,6,13220.0,12,13225.0,1,S
2018-04-17 10:14:41,13230.0,10,10060,0,13220.0,12,13230.0,9,B
2018-04-17 10:14:43,13230.0,2,10062,2,13225.0,2,13235.0,5,B
2018-04-17 10:14:45,13225.0,2,10064,0,13225.0,1,13235.0,8,S
2018-04-17 10:14:51,13235.0,6,10070,-4,13225.0,4,13235.0,11,B
2018-04-17 10:14:54,13230.0,2,10072,0,13230.0,2,13235.0,15,S
2018-04-17 10:14:58,13235.0,2,10074,-2,13225.0,5,13235.0,11,B
2018-04-17 10:30:02,13235.0,12,10086,-8,13230.0,3,13235.0,2,B
2018-04-17 10:30:04,13230.0,2,10088,2,13230.0,2,13235.0,3,S
2018-04-17 10:30:12,13235.0,6,10094,-2,13230.0,13,13240.0,9,B
2018-04-17 10:30:13,13240.0,2,10096,0,13235.0,7,13240.0,5,B
2018-04-17 10:30:14,13235.0,2,10098,-2,13235.0,6,13240.0,4,S
2018-04-17 10:30:16,13240.0,2,10100,0,13235.0,6,13240.0,3,B
2018-04-17 10:30:20,13240.0,8,10108,2,13235.0,5,13245.0,8,B
2018-04-17 10:30:24,13240.0,2,10110,2,13235.0,1,13240.0,2,B
2018-04-17 10:30:25,13235.0,2,10112,-2,13230.0,7,13240.0,2,S
2018-04-17 10:30:33,13235.0,2,10114,-2,13235.0,1,13240.0,4,S
2018-04-17 10:30:38,13240.0,2,10116,0,13230.0,13,13240.0,2,B
2018-04-17 10:30:38,13240.0,4,10120,-2,13230.0,13,13245.0,23,B
2018-04-17 10:30:40,13235.0,2,10122,2,13235.0,16,13245.0,6,S
2018-04-17 10:30:54,13240.0,2,10124,2,13235.0,16,13245.0,9,B
2018-04-17 10:31:06,13235.0,8,10132,8,13230.0,10,13235.0,3,S
2018-04-17 10:31:19,13230.0,10,10142,2,13225.0,12,13235.0,9,S
2018-04-17 10:31:21,13225.0,20,10162,-8,13220.0,26,13235.0,10,S
2018-04-17 10:31:28,13230.0,8,10170,-8,13225.0,5,13230.0,1,B
2018-04-17 10:31:28,13230.0,2,10172,2,13230.0,10,13235.0,6,B
2018-04-17 10:31:29,13235.0,4,10176,-4,13230.0,6,13235.0,3,B
2018-04-17 10:31:30,13235.0,2,10178,2,13230.0,5,13235.0,2,B
2018-04-17 10:31:31,13235.0,2,10180,2,13230.0,33,13235.0,1,B
2018-04-17 10:31:31,13235.0,2,10182,2,13230.0,21,13240.0,4,B
2018-04-17 10:31:32,13235.0,2,10184,-2,13230.0,21,13240.0,3,B
2018-04-17 10:31:35,13240.0,10,10194,-10,13230.0,12,13240.0,2,B
2018-04-17 10:31:40,13240.0,2,10196,2,13235.0,2,13245.0,12,B
2018-04-17 10:31:47,13240.0,2,10198,0,13235.0,8,13245.0,13,B
2018-04-17 10:31:52,13240.0,2,10200,0,13240.0,1,13245.0,14,B
2018-04-17 10:31:56,13240.0,2,10202,2,13235.0,8,13245.0,14,B
2018-04-17 10:31:57,13235.0,14,10216,14,13230.0,2,13235.0,2,S
2018-04-17 10:32:05,13235.0,2,10218,0,13230.0,3,13240.0,14,S
2018-04-17 10:32:06,13240.0,2,10220,0,13230.0,3,13240.0,13,B
2018-04-17 10:32:07,13240.0,2,10222,0,13230.0,3,13240.0,12,B
2018-04-17 10:32:18,13230.0,2,10224,2,13230.0,2,13235.0,11,S
2018-04-17 10:32:18,13230.0,4,10228,0,13225.0,9,13235.0,17,S
2018-04-17 10:32:32,13230.0,2,10230,0,13225.0,13,13230.0,1,S
2018-04-17 10:32:32,13230.0,4,10234,0,13230.0,1,13235.0,11,S
2018-04-17 10:32:36,13235.0,14,10248,0,13230.0,17,13235.0,5,B
2018-04-17 10:32:37,13235.0,4,10252,0,13230.0,21,13235.0,3,B
2018-04-17 10:32:38,13235.0,6,10258,6,13235.0,2,13240.0,4,B
2018-04-17 10:32:39,13240.0,4,10262,-2,13235.0,12,13245.0,10,B
2018-04-17 10:32:44,13240.0,8,10270,4,13235.0,4,13245.0,14,B
2018-04-17 10:32:47,13240.0,2,10272,-2,13240.0,1,13245.0,10,B
2018-04-17 10:32:48,13240.0,2,10274,0,13235.0,13,13240.0,2,B
2018-04-17 10:32:49,13240.0,2,10276,-2,13235.0,19,13240.0,1,B
2018-04-17 10:32:51,13240.0,2,10278,0,13235.0,19,13245.0,8,B
2018-04-17 10:32:54,13235.0,2,10280,0,13235.0,4,13240.0,5,S
2018-04-17 10:33:01,13240.0,10,10290,-6,13235.0,4,13245.0,17,B
2018-04-17 10:33:07,13240.0,2,10292,-2,13240.0,19,13245.0,17,B
2018-04-17 10:33:08,13240.0,2,10294,-2,13240.0,18,13245.0,17,B
2018-04-17 10:33:10,13240.0,2,10296,-2,13240.0,17,13245.0,17,B
2018-04-17 10:33:10,13240.0,34,10330,0,13235.0,4,13245.0,17,B
2018-04-17 10:33:14,13235.0,6,10336,-2,13230.0,6,13240.0,12,S
2018-04-17 10:33:15,13230.0,4,10340,2,13230.0,1,13235.0,8,S
2018-04-17 10:33:16,13235.0,6,10346,-2,13235.0,1,13240.0,11,B
2018-04-17 10:33:31,13240.0,2,10348,-2,13235.0,5,13245.0,14,B
2018-04-17 10:33:38,13240.0,6,10354,6,13235.0,5,13245.0,13,B
2018-04-17 10:33:47,13240.0,6,10360,-6,13240.0,2,13245.0,13,B
2018-04-17 10:33:48,13240.0,2,10362,-2,13240.0,1,13245.0,13,B
2018-04-17 10:33:49,13240.0,2,10364,0,13235.0,4,13245.0,13,B
2018-04-17 10:33:59,13245.0,8,10372,4,13235.0,4,13245.0,9,B
2018-04-17 10:34:02,13235.0,2,10374,2,13235.0,6,13240.0,11,S
2018-04-17 10:34:07,13240.0,2,10376,2,13235.0,6,13240.0,10,B
2018-04-17 10:34:24,13240.0,2,10378,-2,13235.0,7,13245.0,10,B
2018-04-17 10:34:28,13240.0,2,10380,0,13240.0,3,13245.0,11,B
2018-04-17 10:34:31,13245.0,2,10382,0,13240.0,6,13245.0,3,B
2018-04-17 10:34:31,13245.0,2,10384,-2,13240.0,6,13245.0,2,B
2018-04-17 10:34:32,13240.0,24,10408,-10,13240.0,6,13250.0,20,S
2018-04-17 10:34:33,13245.0,4,10412,0,13240.0,2,13245.0,9,B
2018-04-17 10:34:37,13240.0,2,10414,2,13235.0,3,13240.0,10,S
2018-04-17 10:34:49,13240.0,10,10424,0,13235.0,5,13240.0,5,S
2018-04-17 10:34:57,13235.0,2,10426,0,13235.0,8,13240.0,11,S
2018-04-17 10:35:14,13235.0,2,10428,0,13235.0,7,13240.0,12,S
2018-04-17 10:35:16,13235.0,2,10430,0,13235.0,6,13240.0,12,S
2018-04-17 10:35:29,13235.0,4,10434,-4,13235.0,5,13240.0,14,S
2018-04-17 10:35:30,13235.0,10,10444,0,13230.0,3,13235.0,5,S
2018-04-17 10:35:42,13230.0,6,10450,4,13225.0,3,13235.0,8,S
2018-04-17 10:35:53,13225.0,2,10452,0,13225.0,1,13235.0,12,S
2018-04-17 10:35:54,13225.0,2,10454,2,13225.0,2,13235.0,12,S
2018-04-17 10:36:18,13220.0,2,10456,0,13220.0,27,13230.0,2,S
2018-04-17 10:36:19,13225.0,2,10458,0,13220.0,3,13230.0,12,B
2018-04-17 10:36:21,13225.0,2,10460,2,13220.0,3,13225.0,3,B
2018-04-17 10:36:26,13220.0,6,10466,2,13215.0,16,13220.0,23,S
2018-04-17 10:36:27,13215.0,12,10478,-8,13215.0,10,13220.0,21,S
2018-04-17 10:36:27,13215.0,4,10482,-4,13215.0,8,13220.0,16,S
2018-04-17 10:36:32,13220.0,2,10484,0,13215.0,8,13220.0,9,B
2018-04-17 10:36:45,13215.0,16,10500,-16,13210.0,12,13220.0,22,S
2018-04-17 10:36:59,13220.0,2,10502,0,13215.0,2,13220.0,15,B
2018-04-17 10:37:04,13220.0,4,10506,0,13215.0,2,13220.0,9,B
2018-04-17 10:37:05,13220.0,18,10524,16,13215.0,2,13225.0,9,B
2018-04-17 10:37:23,13220.0,2,10526,-2,13215.0,2,13220.0,8,B
2018-04-17 10:37:32,13220.0,10,10536,10,13215.0,2,13220.0,3,B
2018-04-17 10:37:33,13215.0,4,10540,-4,13215.0,1,13220.0,3,S
2018-04-17 10:38:09,13220.0,2,10542,0,13210.0,12,13220.0,10,B
2018-04-17 10:38:15,13215.0,2,10544,2,13210.0,12,13220.0,10,S
2018-04-17 10:38:20,13220.0,4,10548,0,13215.0,4,13225.0,4,B
2018-04-17 10:38:34,13225.0,4,10552,0,13220.0,7,13230.0,11,B
2018-04-17 10:38:41,13220.0,14,10566,0,13215.0,4,13225.0,14,S
2018-04-17 10:38:46,13220.0,4,10570,4,13215.0,8,13225.0,10,S
2018-04-17 10:38:49,13220.0,8,10578,-8,13215.0,8,13220.0,11,S
2018-04-17 10:38:52,13215.0,12,10590,4,13210.0,43,13220.0,12,S
2018-04-17 10:39:20,13215.0,4,10594,-2,13215.0,1,13220.0,11,S
2018-04-17 10:39:27,13215.0,2,10596,2,13210.0,28,13215.0,1,S
2018-04-17 10:39:28,13220.0,10,10606,2,13210.0,19,13220.0,13,B
2018-04-17 10:39:33,13215.0,2,10608,0,13210.0,19,13215.0,1,S
2018-04-17 10:39:36,13210.0,2,10610,0,13210.0,18,13215.0,1,S
2018-04-17 10:39:38,13210.0,2,10612,0,13210.0,17,13215.0,4,S
2018-04-17 10:39:40,13215.0,14,10626,6,13210.0,17,13220.0,35,B
2018-04-17 10:39:58,13215.0,4,10630,-2,13210.0,19,13220.0,13,B
2018-04-17 10:40:14,13215.0,2,10632,-2,13215.0,3,13220.0,11,B
2018-04-17 10:40:22,13215.0,2,10634,0,13215.0,2,13220.0,20,B
2018-04-17 10:40:39,13215.0,4,10638,0,13210.0,29,13220.0,11,B
2018-04-17 10:40:50,13220.0,18,10656,-8,13215.0,4,13225.0,5,B
2018-04-17 10:41:08,13225.0,2,10658,0,13220.0,3,13230.0,24,B
2018-04-17 10:41:10,13230.0,2,10660,0,13220.0,4,13230.0,10,B
2018-04-17 10:41:35,13225.0,2,10662,0,13220.0,1,13230.0,22,S
2018-04-17 10:41:50,13220.0,4,10666,-2,13215.0,8,13225.0,4,S
2018-04-17 10:42:17,13220.0,2,10668,0,13215.0,18,13225.0,3,S
2018-04-17 10:42:30,13215.0,2,10670,2,13210.0,22,13215.0,1,S
2018-04-17 10:42:32,13215.0,2,10672,-2,13215.0,1,13220.0,18,S
2018-04-17 10:42:45,13215.0,2,10674,0,13215.0,1,13220.0,5,S
2018-04-17 10:42:54,13215.0,2,10676,2,13210.0,32,13220.0,4,S
2018-04-17 10:43:13,13215.0,2,10678,0,13215.0,2,13220.0,3,S
2018-04-17 10:43:37,13215.0,2,10680,2,13210.0,19,13220.0,13,S
2018-04-17 10:43:53,13220.0,2,10682,0,13215.0,5,13220.0,5,B
2018-04-17 10:43:54,13220.0,4,10686,-2,13215.0,2,13220.0,1,B
2018-04-17 10:43:55,13220.0,4,10690,0,13215.0,5,13225.0,6,B
2018-04-17 10:44:34,13215.0,6,10696,4,13210.0,31,13215.0,2,S
2018-04-17 10:44:34,13215.0,4,10700,4,13210.0,31,13220.0,5,S
2018-04-17 10:44:47,13220.0,14,10714,-8,13215.0,1,13225.0,24,B
2018-04-17 10:45:04,13220.0,6,10720,2,13215.0,4,13225.0,19,B
2018-04-17 10:45:05,13210.0,42,10762,2,13210.0,15,13220.0,1,S
2018-04-17 10:45:11,13215.0,4,10766,2,13210.0,17,13215.0,18,B
2018-04-17 10:45:15,13210.0,2,10768,0,13210.0,4,13215.0,18,S
2018-04-17 10:45:27,13210.0,2,10770,-2,13210.0,8,13215.0,18,S
2018-04-17 10:45:38,13210.0,2,10772,0,13210.0,8,13215.0,18,S
2018-04-17 10:45:50,13210.0,16,10788,0,13205.0,18,13215.0,18,S
2018-04-17 10:45:51,13210.0,2,10790,0,13205.0,16,13215.0,19,S
2018-04-17 10:46:04,13205.0,10,10800,-10,13205.0,11,13215.0,19,S
2018-04-17 10:46:11,13205.0,2,10802,-2,13205.0,12,13210.0,1,S
2018-04-17 10:46:20,13210.0,2,10804,0,13205.0,12,13215.0,20,B
2018-04-17 10:46:33,13205.0,18,10822,6,13205.0,1,13210.0,5,S
2018-04-17 10:46:33,13205.0,2,10824,0,13200.0,3,13210.0,6,S
2018-04-17 10:47:04,13205.0,2,10826,0,13200.0,6,13210.0,4,S
2018-04-17 10:47:05,13210.0,2,10828,0,13205.0,14,13210.0,1,B
2018-04-17 10:47:05,13210.0,2,10830,-2,13205.0,4,13215.0,22,B
2018-04-17 10:47:11,13205.0,2,10832,0,13200.0,19,13210.0,1,S
2018-04-17 10:47:53,13210.0,2,10834,0,13205.0,7,13215.0,22,B
2018-04-17 10:48:13,13210.0,4,10838,0,13205.0,6,13210.0,1,B
2018-04-17 10:48:17,13205.0,6,10844,-2,13200.0,15,13210.0,5,S
2018-04-17 10:48:46,13205.0,2,10846,-2,13200.0,5,13210.0,7,S
2018-04-17 10:49:01,13200.0,4,10850,4,13195.0,14,13200.0,4,S
2018-04-17 10:49:05,13200.0,2,10852,0,13195.0,15,13200.0,3,S
2018-04-17 10:49:13,13195.0,10,10862,0,13195.0,8,13200.0,5,S
2018-04-17 10:49:14,13195.0,14,10876,0,13195.0,1,13200.0,7,S
2018-04-17 10:49:14,13195.0,2,10878,-2,13190.0,5,13195.0,4,S
2018-04-17 10:49:19,13190.0,2,10880,2,13190.0,5,13195.0,5,S
2018-04-17 10:49:20,13190.0,2,10882,-2,13190.0,6,13195.0,5,S
2018-04-17 10:49:25,13190.0,2,10884,-2,13190.0,5,13195.0,4,S
2018-04-17 10:49:26,13195.0,4,10888,0,13190.0,5,13195.0,3,B
2018-04-17 10:49:28,13195.0,2,10890,-2,13190.0,5,13200.0,7,B
2018-04-17 10:49:46,13200.0,8,10898,8,13200.0,1,13205.0,5,B
2018-04-17 10:49:46,13200.0,2,10900,0,13195.0,1,13205.0,5,B
2018-04-17 10:49:48,13195.0,2,10902,0,13195.0,1,13205.0,3,S
2018-04-17 10:49:58,13200.0,4,10906,0,13195.0,5,13205.0,6,B
2018-04-17 10:50:08,13200.0,2,10908,0,13200.0,9,13210.0,9,B
2018-04-17 10:50:41,13205.0,2,10910,0,13205.0,4,13210.0,6,B
2018-04-17 10:50:42,13205.0,2,10912,2,13205.0,3,13210.0,6,B
2018-04-17 10:50:47,13205.0,2,10914,2,13205.0,2,13210.0,7,B
2018-04-17 10:50:48,13205.0,4,10918,0,13200.0,2,13210.0,7,B
2018-04-17 10:50:49,13200.0,2,10920,2,13195.0,3,13200.0,1,S
2018-04-17 10:51:00,13205.0,2,10922,0,13195.0,4,13205.0,6,B
2018-04-17 10:51:10,13200.0,2,10924,0,13200.0,1,13205.0,5,S
2018-04-17 10:51:25,13200.0,2,10926,0,13200.0,1,13205.0,1,S
2018-04-17 10:52:03,13200.0,2,10928,0,13195.0,17,13205.0,2,S
2018-04-17 10:52:08,13205.0,2,10930,0,13195.0,18,13205.0,1,B
2018-04-17 10:52:09,13205.0,2,10932,-2,13205.0,5,13210.0,18,B
2018-04-17 10:52:09,13205.0,10,10942,10,13200.0,5,13210.0,15,B
2018-04-17 10:52:36,13205.0,2,10944,0,13200.0,1,13205.0,2,B
2018-04-17 10:53:23,13205.0,2,10946,0,13205.0,21,13210.0,39,B
2018-04-17 10:53:24,13205.0,42,10988,36,13200.0,2,13205.0,1,B
2018-04-17 10:53:24,13200.0,2,10990,0,13195.0,8,13200.0,2,S
2018-04-17 10:53:40,13200.0,2,10992,0,13195.0,9,13200.0,1,S
2018-04-17 10:53:49,13205.0,2,10994,0,13195.0,9,13205.0,33,B
2018-04-17 10:54:01,13205.0,14,11008,10,13205.0,3,13210.0,19,B
2018-04-17 10:54:03,13205.0,2,11010,0,13200.0,5,13210.0,34,B
2018-04-17 10:54:21,13205.0,2,11012,0,13200.0,6,13210.0,16,B
2018-04-17 10:55:20,13205.0,2,11014,0,13200.0,5,13205.0,2,B
2018-04-17 10:55:49,13200.0,2,11016,0,13200.0,26,13210.0,19,S
2018-04-17 10:55:51,13200.0,2,11018,0,13200.0,23,13205.0,1,S
2018-04-17 10:56:01,13205.0,2,11020,-2,13205.0,1,13210.0,29,B
2018-04-17 10:56:01,13205.0,2,11022,-2,13200.0,34,13210.0,29,B
2018-04-17 10:56:46,13200.0,2,11024,2,13200.0,34,13205.0,21,S
2018-04-17 10:56:47,13200.0,8,11032,0,13200.0,30,13205.0,21,S
2018-04-17 10:56:47,13200.0,12,11044,2,13200.0,24,13205.0,16,S
2018-04-17 10:56:48,13200.0,4,11048,0,13200.0,22,13205.0,17,S
2018-04-17 10:57:04,13200.0,2,11050,2,13200.0,21,13205.0,22,S
2018-04-17 10:57:05,13205.0,2,11052,0,13200.0,34,13205.0,13,B
2018-04-17 10:57:16,13200.0,40,11092,36,13200.0,1,13205.0,18,S
2018-04-17 10:57:17,13200.0,2,11094,-2,13195.0,12,13205.0,18,S
2018-04-17 10:57:25,13210.0,14,11108,10,13205.0,6,13210.0,18,B
2018-04-17 10:57:54,13205.0,2,11110,0,13200.0,5,13205.0,1,S
2018-04-17 10:58:35,13210.0,10,11120,0,13205.0,10,13210.0,12,B
2018-04-17 10:59:08,13210.0,22,11142,-18,13210.0,1,13215.0,25,B
2018-04-17 10:59:09,13210.0,2,11144,-2,13205.0,11,13215.0,28,B
2018-04-17 10:59:22,13205.0,2,11146,-2,13205.0,12,13215.0,31,S
2018-04-17 10:59:34,13210.0,2,11148,0,13205.0,12,13215.0,31,B
2018-04-17 10:59:42,13210.0,20,11168,-20,13205.0,12,13215.0,30,B
2018-04-17 10:59:55,13205.0,2,11170,0,13205.0,11,13215.0,25,S
2018-04-17 11:00:00,13210.0,2,11172,-2,13205.0,12,13215.0,25,B
2018-04-17 11:00:13,13215.0,2,11174,0,13210.0,10,13215.0,23,B
2018-04-17 11:00:44,13210.0,2,11176,0,13210.0,9,13215.0,22,S
2018-04-17 11:00:54,13215.0,2,11178,0,13210.0,11,13215.0,21,B
2018-04-17 11:00:55,13215.0,2,11180,0,13210.0,11,13215.0,20,B
2018-04-17 11:01:01,13210.0,2,11182,-2,13210.0,10,13215.0,20,S
2018-04-17 11:01:05,13215.0,2,11184,2,13210.0,10,13215.0,19,B
2018-04-17 11:01:07,13210.0,18,11202,0,13205.0,13,13215.0,19,S
2018-04-17 11:01:17,13205.0,2,11204,-2,13205.0,12,13215.0,21,S
2018-04-17 11:01:23,13210.0,2,11206,-2,13210.0,1,13215.0,22,B
2018-04-17 11:01:23,13215.0,12,11218,10,13210.0,27,13215.0,17,B
2018-04-17 11:01:24,13215.0,16,11234,12,13210.0,25,13215.0,9,B
2018-04-17 11:01:24,13215.0,16,11250,-8,13210.0,24,13215.0,1,B
2018-04-17 11:01:25,13215.0,2,11252,0,13210.0,23,13220.0,18,B
2018-04-17 11:01:38,13215.0,2,11254,0,13215.0,1,13220.0,16,B
2018-04-17 11:01:51,13220.0,10,11264,8,13215.0,3,13220.0,12,B
2018-04-17 11:02:08,13215.0,2,11266,2,13215.0,1,13220.0,12,S
2018-04-17 11:02:19,13215.0,2,11268,0,13215.0,2,13220.0,13,S
2018-04-17 11:02:31,13215.0,2,11270,0,13215.0,1,13220.0,14,S
2018-04-17 11:02:38,13220.0,2,11272,0,13215.0,5,13220.0,11,B
2018-04-17 11:02:43,13215.0,2,11274,0,13215.0,2,13220.0,11,S
2018-04-17 11:02:52,13215.0,4,11278,2,13215.0,1,13220.0,11,S
2018-04-17 11:03:25,13220.0,10,11288,10,13215.0,8,13220.0,7,B
2018-04-17 11:03:30,13220.0,2,11290,0,13210.0,11,13220.0,7,B
2018-04-17 11:04:49,13210.0,32,11322,-14,13210.0,1,13215.0,1,S
2018-04-17 11:04:50,13205.0,28,11350,-14,13205.0,13,13215.0,2,S
2018-04-17 11:05:04,13210.0,4,11354,-2,13210.0,2,13215.0,8,B
2018-04-17 11:05:06,13210.0,4,11358,0,13205.0,30,13215.0,8,B
2018-04-17 11:05:11,13215.0,12,11370,6,13215.0,8,13220.0,14,B
2018-04-17 11:05:20,13215.0,16,11386,-16,13210.0,4,13220.0,12,B
2018-04-17 11:05:20,13205.0,22,11408,-8,13205.0,5,13220.0,13,S
2018-04-17 11:05:27,13205.0,2,11410,0,13205.0,15,13215.0,5,S
2018-04-17 11:05:50,13215.0,10,11420,10,13210.0,5,13215.0,7,B
2018-04-17 11:05:54,13210.0,2,11422,0,13210.0,4,13215.0,7,S
2018-04-17 11:06:30,13215.0,36,11458,6,13210.0,10,13215.0,11,B
2018-04-17 11:06:31,13215.0,22,11480,18,13215.0,7,13220.0,30,B
2018-04-17 11:06:32,13215.0,14,11494,-2,13210.0,14,13220.0,27,B
2018-04-17 11:06:51,13220.0,20,11514,-4,13215.0,14,13220.0,27,B
2018-04-17 11:06:55,13220.0,14,11528,12,13215.0,17,13220.0,20,B
2018-04-17 11:06:55,13220.0,8,11536,8,13215.0,17,13220.0,16,B
2018-04-17 11:06:59,13220.0,2,11538,0,13215.0,17,13220.0,15,B
2018-04-17 11:07:00,13220.0,2,11540,0,13215.0,17,13220.0,14,B
2018-04-17 11:07:01,13220.0,6,11546,0,13215.0,17,13220.0,11,B
2018-04-17 11:07:06,13215.0,2,11548,2,13215.0,16,13220.0,11,S
2018-04-17 11:07:15,13215.0,2,11550,2,13215.0,5,13220.0,11,S
2018-04-17 11:07:46,13215.0,2,11552,-2,13215.0,1,13220.0,12,S
2018-04-17 11:07:46,13210.0,4,11556,4,13210.0,7,13220.0,11,S
2018-04-17 11:07:47,13210.0,2,11558,2,13210.0,14,13220.0,10,S
2018-04-17 11:07:48,13210.0,28,11586,26,13205.0,33,13210.0,6,S
2018-04-17 11:07:48,13210.0,12,11598,10,13210.0,21,13215.0,1,S
2018-04-17 11:08:08,13215.0,10,11608,-8,13210.0,4,13215.0,2,B
2018-04-17 11:08:12,13215.0,2,11610,0,13210.0,12,13215.0,1,B
2018-04-17 11:08:13,13215.0,2,11612,0,13210.0,15,13220.0,8,B
2018-04-17 11:08:27,13220.0,2,11614,0,13210.0,19,13220.0,5,B
2018-04-17 11:08:40,13215.0,2,11616,0,13215.0,1,13220.0,6,S
2018-04-17 11:08:51,13215.0,2,11618,-2,13210.0,15,13220.0,6,S
2018-04-17 11:09:00,13220.0,10,11628,0,13215.0,1,13220.0,1,B
2018-04-17 11:09:38,13225.0,2,11630,0,13215.0,12,13225.0,12,B
2018-04-17 11:09:48,13220.0,10,11640,0,13220.0,5,13225.0,12,S
2018-04-17 11:09:57,13225.0,2,11642,2,13220.0,11,13225.0,13,B
2018-04-17 11:10:24,13220.0,2,11644,2,13220.0,8,13225.0,13,S
2018-04-17 11:10:43,13225.0,10,11654,10,13220.0,8,13225.0,8,B
2018-04-17 11:10:56,13220.0,2,11656,0,13220.0,9,13225.0,8,S
2018-04-17 11:10:56,13220.0,4,11660,4,13220.0,7,13225.0,8,S
2018-04-17 11:10:57,13210.0,32,11692,-10,13210.0,18,13220.0,3,S
2018-04-17 11:10:57,13210.0,10,11702,0,13215.0,1,13220.0,3,S
2018-04-17 11:11:21,13220.0,2,11704,0,13210.0,20,13220.0,4,B
2018-04-17 11:11:27,13210.0,2,11706,0,13210.0,7,13215.0,10,S
2018-04-17 11:11:40,13215.0,12,11718,0,13210.0,9,13215.0,4,B
2018-04-17 11:11:47,13215.0,8,11726,8,13215.0,23,13220.0,13,B
2018-04-17 11:12:07,13220.0,10,11736,10,13215.0,18,13220.0,7,B
2018-04-17 11:12:09,13215.0,2,11738,0,13210.0,7,13220.0,8,S
2018-04-17 11:12:10,13220.0,2,11740,0,13210.0,7,13220.0,7,B
2018-04-17 11:12:28,13215.0,2,11742,0,13210.0,7,13220.0,7,S
2018-04-17 11:13:36,13210.0,2,11744,0,13210.0,1,13215.0,7,S
2018-04-17 11:13:37,13210.0,2,11746,-2,13205.0,7,13215.0,6,S
2018-04-17 11:13:49,13205.0,4,11750,2,13205.0,3,13210.0,5,S
2018-04-17 11:13:50,13205.0,6,11756,-2,13200.0,15,13205.0,2,S
2018-04-17 11:14:05,13205.0,2,11758,0,13200.0,13,13210.0,3,S
2018-04-17 11:14:10,13210.0,2,11760,0,13210.0,4,13215.0,6,B
2018-04-17 11:14:10,13210.0,8,11768,0,13205.0,1,13215.0,6,B
2018-04-17 11:14:15,13205.0,6,11774,6,13205.0,2,13215.0,7,S
2018-04-17 11:16:17,13215.0,4,11778,-2,13215.0,5,13220.0,10,B
2018-04-17 11:16:18,13220.0,4,11782,4,13215.0,17,13220.0,5,B
2018-04-17 11:16:42,13220.0,2,11784,0,13215.0,1,13220.0,8,B
2018-04-17 11:16:49,13220.0,8,11792,4,13215.0,1,13220.0,4,B
2018-04-17 11:16:53,13215.0,2,11794,2,13210.0,7,13220.0,4,S
2018-04-17 11:16:58,13220.0,2,11796,0,13215.0,16,13225.0,13,B
2018-04-17 11:17:14,13215.0,2,11798,0,13210.0,2,13215.0,1,S
2018-04-17 11:17:20,13215.0,2,11800,-2,13210.0,5,13220.0,9,S
2018-04-17 11:17:28,13210.0,4,11804,-2,13205.0,7,13210.0,1,S
2018-04-17 11:18:08,13210.0,2,11806,-2,13210.0,5,13220.0,3,S
2018-04-17 11:18:19,13215.0,2,11808,2,13215.0,4,13220.0,4,B
2018-04-17 11:18:20,13215.0,8,11816,8,13210.0,5,13220.0,4,B
2018-04-17 11:19:15,13220.0,10,11826,2,13210.0,4,13220.0,1,B
2018-04-17 11:19:32,13215.0,2,11828,0,13210.0,4,13220.0,10,S
2018-04-17 11:20:02,13215.0,4,11832,-2,13210.0,4,13220.0,33,S
2018-04-17 11:20:09,13210.0,8,11840,-6,13205.0,7,13215.0,5,S
2018-04-17 11:20:33,13215.0,2,11842,-2,13210.0,15,13220.0,19,B
2018-04-17 11:20:59,13215.0,4,11846,-2,13215.0,2,13220.0,10,B
2018-04-17 11:21:04,13215.0,2,11848,0,13210.0,4,13220.0,11,B
2018-04-17 11:21:43,13210.0,4,11852,0,13205.0,8,13215.0,16,S
2018-04-17 11:21:56,13215.0,2,11854,-2,13210.0,13,13220.0,21,B
2018-04-17 11:22:36,13215.0,2,11856,0,13210.0,6,13220.0,15,B
2018-04-17 11:22:51,13215.0,2,11858,0,13210.0,5,13215.0,1,B
2018-04-17 11:23:17,13210.0,8,11866,6,13205.0,53,13215.0,1,S
2018-04-17 11:23:31,13210.0,8,11874,8,13205.0,7,13215.0,5,S
2018-04-17 11:23:39,13210.0,2,11876,0,13205.0,6,13215.0,9,S
2018-04-17 11:23:52,13205.0,2,11878,-2,13205.0,1,13210.0,7,S
2018-04-17 11:23:52,13205.0,2,11880,2,13200.0,12,13210.0,7,S
2018-04-17 11:24:07,13210.0,2,11882,2,13200.0,11,13210.0,17,B
2018-04-17 11:24:09,13205.0,4,11886,0,13200.0,11,13210.0,17,S
2018-04-17 11:24:27,13200.0,2,11888,-2,13200.0,8,13205.0,1,S
2018-04-17 11:25:12,13200.0,2,11890,2,13200.0,7,13205.0,7,S
2018-04-17 11:25:13,13200.0,14,11904,2,13195.0,18,13205.0,7,S
2018-04-17 11:25:14,13195.0,2,11906,0,13195.0,14,13200.0,10,S
2018-04-17 11:25:18,13200.0,10,11916,-6,13195.0,14,13200.0,4,B
2018-04-17 11:25:19,13200.0,8,11924,-2,13200.0,3,13205.0,3,B
2018-04-17 11:25:20,13200.0,2,11926,-2,13195.0,17,13205.0,13,B
2018-04-17 11:25:37,13195.0,4,11930,0,13195.0,15,13200.0,15,S
2018-04-17 11:25:37,13195.0,30,11960,-18,13190.0,11,13200.0,17,S
2018-04-17 11:25:41,13190.0,18,11978,10,13185.0,14,13200.0,16,S
2018-04-17 11:25:53,13195.0,2,11980,2,13195.0,8,13200.0,16,B
2018-04-17 11:25:55,13195.0,16,11996,0,13190.0,35,13195.0,2,B
2018-04-17 11:25:55,13195.0,4,12000,-2,13195.0,5,13200.0,16,B
2018-04-17 11:26:01,13195.0,4,12004,2,13195.0,5,13200.0,14,B
2018-04-17 11:26:06,13200.0,20,12024,20,13195.0,11,13200.0,3,B
2018-04-17 11:26:07,13200.0,6,12030,6,13195.0,23,13205.0,15,B
2018-04-17 11:26:07,13200.0,2,12032,0,13195.0,26,13205.0,13,B
2018-04-17 11:26:12,13200.0,2,12034,0,13200.0,1,13205.0,13,B
2018-04-17 11:26:22,13200.0,2,12036,2,13200.0,7,13205.0,11,B
2018-04-17 11:26:23,13200.0,2,12038,2,13200.0,16,13205.0,11,B
2018-04-17 11:26:25,13200.0,4,12042,0,13200.0,13,13205.0,12,B
2018-04-17 11:26:44,13205.0,4,12046,0,13200.0,11,13205.0,15,B
2018-04-17 11:26:53,13200.0,16,12062,0,13200.0,4,13205.0,15,S
2018-04-17 11:27:03,13205.0,12,12074,8,13200.0,8,13205.0,8,B
2018-04-17 11:27:04,13205.0,16,12090,12,13200.0,10,13210.0,15,B
2018-04-17 11:27:09,13205.0,4,12094,0,13200.0,7,13205.0,3,B
2018-04-17 11:27:21,13200.0,2,12096,2,13200.0,5,13210.0,17,S
2018-04-17 11:27:42,13205.0,2,12098,2,13200.0,5,13210.0,15,B
2018-04-17 11:28:08,13200.0,2,12100,0,13200.0,2,13210.0,18,S
2018-04-17 11:28:20,13205.0,2,12102,2,13205.0,1,13210.0,17,B
2018-04-17 11:28:21,13205.0,2,12104,0,13200.0,2,13205.0,2,B
2018-04-17 11:28:22,13200.0,4,12108,4,13195.0,3,13205.0,6,S
2018-04-17 11:28:26,13200.0,2,12110,0,13190.0,7,13200.0,4,S
2018-04-17 11:28:27,13200.0,4,12114,-4,13190.0,6,13200.0,2,S
2018-04-17 11:29:02,13195.0,4,12118,0,13195.0,6,13205.0,5,S
2018-04-17 11:29:21,13200.0,2,12120,0,13200.0,1,13205.0,3,B
2018-04-17 11:29:23,13200.0,2,12122,-2,13195.0,5,13200.0,2,B
2018-04-17 11:29:27,13200.0,2,12124,0,13195.0,7,13200.0,1,B
2018-04-17 11:29:27,13200.0,2,12126,-2,13200.0,1,13205.0,3,B
2018-04-17 11:29:30,13200.0,2,12128,0,13195.0,7,13205.0,2,B
2018-04-17 11:29:52,13205.0,2,12130,-2,13195.0,6,13205.0,1,B
2018-04-17 13:30:01,13200.0,2,12132,0,13195.0,4,13200.0,4,S
2018-04-17 13:30:01,13195.0,2,12134,-2,13195.0,3,13200.0,4,S
2018-04-17 13:30:31,13195.0,2,12136,-2,13195.0,3,13200.0,4,S
2018-04-17 13:30:36,13195.0,6,12142,4,13190.0,5,13200.0,4,S
2018-04-17 13:30:40,13190.0,2,12144,0,13190.0,4,13195.0,7,S
2018-04-17 13:30:40,13190.0,2,12146,-2,13190.0,3,13195.0,7,S
2018-04-17 13:30:43,13190.0,2,12148,-2,13190.0,2,13195.0,7,S
2018-04-17 13:30:50,13190.0,2,12150,0,13190.0,3,13195.0,6,S
2018-04-17 13:31:05,13190.0,6,12156,2,13190.0,1,13195.0,4,S
2018-04-17 13:31:23,13185.0,4,12160,0,13185.0,3,13195.0,3,S
2018-04-17 13:31:23,13185.0,2,12162,0,13185.0,6,13195.0,3,S
2018-04-17 13:31:29,13190.0,2,12164,0,13185.0,4,13195.0,3,B
2018-04-17 13:31:33,13185.0,4,12168,0,13185.0,1,13195.0,8,S
2018-04-17 13:31:37,13185.0,2,12170,2,13180.0,6,13185.0,1,S
2018-04-17 13:31:38,13185.0,2,12172,0,13185.0,2,13190.0,2,S
2018-04-17 13:31:39,13190.0,2,12174,-2,13185.0,2,13190.0,1,B
2018-04-17 13:31:50,13190.0,4,12178,2,13185.0,2,13190.0,4,B
2018-04-17 13:32:07,13190.0,8,12186,0,13190.0,2,13195.0,10,B
2018-04-17 13:32:08,13190.0,4,12190,-4,13185.0,2,13195.0,12,B
2018-04-17 13:32:08,13190.0,2,12192,-2,13185.0,2,13195.0,12,B
2018-04-17 13:32:34,13190.0,2,12194,2,13185.0,2,13195.0,10,B
2018-04-17 13:33:01,13180.0,6,12200,0,13180.0,13,13195.0,11,S
2018-04-17 13:33:01,13180.0,20,12220,20,13185.0,5,13190.0,1,S
2018-04-17 13:33:04,13180.0,2,12222,0,13185.0,4,13190.0,1,S
2018-04-17 13:33:14,13180.0,18,12240,-4,13180.0,5,13190.0,3,S
2018-04-17 13:33:19,13185.0,2,12242,-2,13180.0,9,13190.0,4,B
2018-04-17 13:33:23,13180.0,14,12256,-8,13175.0,4,13185.0,11,S
2018-04-17 13:33:27,13175.0,2,12258,0,13175.0,3,13180.0,6,S
2018-04-17 13:33:27,13175.0,2,12260,-2,13175.0,2,13180.0,6,S
2018-04-17 13:33:28,13175.0,2,12262,-2,13175.0,1,13180.0,6,S
2018-04-17 13:33:31,13180.0,2,12264,0,13175.0,1,13180.0,5,B
2018-04-17 13:33:33,13180.0,2,12266,2,13175.0,1,13180.0,4,B
2018-04-17 13:33:44,13175.0,2,12268,0,13170.0,12,13180.0,1,S
2018-04-17 13:33:46,13180.0,2,12270,2,13170.0,12,13180.0,9,B
2018-04-17 13:33:53,13170.0,2,12272,-2,13170.0,11,13175.0,15,S
2018-04-17 13:33:54,13175.0,2,12274,-2,13170.0,11,13175.0,17,B
2018-04-17 13:33:59,13170.0,2,12276,0,13170.0,10,13175.0,16,S
2018-04-17 13:34:09,13175.0,6,12282,0,13170.0,11,13175.0,13,B
2018-04-17 13:34:12,13170.0,2,12284,0,13170.0,10,13175.0,11,S
2018-04-17 13:34:16,13170.0,2,12286,0,13170.0,9,13175.0,12,S
2018-04-17 13:34:20,13170.0,12,12298,0,13170.0,3,13175.0,12,S
2018-04-17 13:34:27,13170.0,6,12304,4,13170.0,2,13175.0,12,S
2018-04-17 13:34:31,13170.0,14,12318,12,13165.0,4,13170.0,1,S
2018-04-17 13:34:32,13170.0,4,12322,4,13165.0,4,13170.0,3,S
2018-04-17 13:34:38,13170.0,4,12326,4,13165.0,4,13170.0,1,S
2018-04-17 13:34:41,13170.0,2,12328,0,13165.0,7,13175.0,9,S
2018-04-17 13:34:45,13170.0,2,12330,0,13170.0,3,13175.0,7,S
2018-04-17 13:34:53,13170.0,2,12332,0,13165.0,9,13175.0,7,S
2018-04-17 13:35:17,13170.0,2,12334,0,13165.0,8,13170.0,8,S
2018-04-17 13:35:23,13165.0,6,12340,-6,13165.0,5,13170.0,12,S
2018-04-17 13:35:25,13165.0,2,12342,0,13165.0,4,13170.0,12,S
2018-04-17 13:35:26,13165.0,8,12350,-6,13160.0,7,13170.0,12,S
2018-04-17 13:35:42,13165.0,2,12352,0,13160.0,7,13165.0,2,S
2018-04-17 13:35:43,13160.0,2,12354,0,13160.0,6,13165.0,1,S
2018-04-17 13:35:43,13160.0,4,12358,4,13160.0,4,13165.0,1,S
2018-04-17 13:35:49,13165.0,2,12360,0,13160.0,5,13165.0,1,B
2018-04-17 13:36:06,13160.0,2,12362,0,13160.0,4,13165.0,24,S
2018-04-17 13:36:10,13160.0,10,12372,0,13155.0,12,13160.0,4,S
2018-04-17 13:36:11,13160.0,4,12376,-4,13155.0,12,13160.0,2,S
2018-04-17 13:36:11,13160.0,2,12378,0,13155.0,12,13160.0,1,S
2018-04-17 13:36:15,13160.0,2,12380,-2,13155.0,12,13165.0,5,S
2018-04-17 13:36:16,13155.0,2,12382,0,13155.0,11,13165.0,5,S
2018-04-17 13:36:17,13165.0,2,12384,-2,13160.0,11,13165.0,1,B
2018-04-17 13:36:18,13165.0,2,12386,-2,13160.0,14,13170.0,8,B
2018-04-17 13:36:39,13165.0,6,12392,2,13160.0,3,13165.0,9,B
2018-04-17 13:36:43,13165.0,2,12394,-2,13160.0,3,13165.0,8,B
2018-04-17 13:36:52,13160.0,2,12396,0,13160.0,1,13165.0,10,S
2018-04-17 13:36:57,13160.0,2,12398,-2,13155.0,13,13165.0,10,S
2018-04-17 13:37:00,13155.0,2,12400,0,13155.0,12,13165.0,10,S
2018-04-17 13:37:18,13155.0,4,12404,0,13155.0,13,13165.0,9,S
2018-04-17 13:37:28,13160.0,4,12408,0,13155.0,13,13165.0,4,B
2018-04-17 13:37:33,13160.0,4,12412,4,13160.0,3,13165.0,3,B
2018-04-17 13:37:49,13165.0,6,12418,-6,13160.0,5,13170.0,13,B
2018-04-17 13:38:04,13165.0,2,12420,-2,13160.0,5,13170.0,12,B
2018-04-17 13:38:08,13165.0,2,12422,-2,13160.0,3,13170.0,9,B
2018-04-17 13:38:21,13170.0,2,12424,2,13160.0,5,13170.0,8,B
2018-04-17 13:38:28,13165.0,2,12426,0,13160.0,5,13170.0,8,S
2018-04-17 13:38:44,13160.0,2,12428,2,13160.0,6,13165.0,1,S
2018-04-17 13:39:17,13165.0,2,12430,0,13160.0,5,13170.0,10,B
2018-04-17 13:39:47,13170.0,2,12432,-2,13165.0,1,13170.0,6,B
2018-04-17 13:39:47,13170.0,12,12444,6,13165.0,1,13175.0,7,B
2018-04-17 13:39:59,13170.0,2,12446,-2,13170.0,1,13175.0,7,B
2018-04-17 13:40:02,13175.0,4,12450,-4,13170.0,1,13175.0,5,B
2018-04-17 13:40:15,13170.0,4,12454,-2,13165.0,2,13175.0,5,S
2018-04-17 13:40:57,13175.0,2,12456,0,13165.0,12,13175.0,4,B
2018-04-17 13:41:01,13170.0,2,12458,0,13165.0,12,13175.0,5,S
2018-04-17 13:41:24,13170.0,4,12462,4,13165.0,2,13170.0,3,S
2018-04-17 13:41:25,13165.0,2,12464,0,13165.0,1,13170.0,3,S
2018-04-17 13:41:35,13170.0,6,12470,0,13170.0,3,13175.0,9,B
2018-04-17 13:41:49,13170.0,4,12474,4,13170.0,2,13175.0,3,B
2018-04-17 13:42:01,13170.0,2,12476,-2,13165.0,6,13175.0,5,B
2018-04-17 13:42:01,13165.0,2,12478,0,13165.0,9,13175.0,5,S
2018-04-17 13:42:42,13165.0,4,12482,-2,13160.0,8,13170.0,16,S
2018-04-17 13:43:15,13160.0,2,12484,-2,13160.0,7,13170.0,21,S
2018-04-17 13:43:47,13165.0,2,12486,0,13160.0,7,13170.0,3,B
2018-04-17 13:43:50,13160.0,6,12492,2,13155.0,14,13165.0,17,S
2018-04-17 13:44:10,13155.0,2,12494,0,13155.0,15,13165.0,16,S
2018-04-17 13:44:10,13155.0,4,12498,-2,13155.0,13,13165.0,16,S
2018-04-17 13:44:12,13155.0,2,12500,0,13155.0,8,13165.0,4,S
2018-04-17 13:44:25,13155.0,2,12502,0,13155.0,7,13160.0,2,S
2018-04-17 13:44:30,13155.0,14,12516,-12,13150.0,35,13155.0,1,S
2018-04-17 13:44:30,13150.0,24,12540,-2,13150.0,21,13155.0,3,S
2018-04-17 13:44:31,13150.0,16,12556,-6,13150.0,13,13155.0,9,S
2018-04-17 13:44:31,13150.0,16,12572,-2,13150.0,5,13155.0,16,S
2018-04-17 13:44:32,13150.0,10,12582,8,13145.0,3,13155.0,16,S
2018-04-17 13:44:51,13145.0,6,12588,-2,13140.0,2,13145.0,7,S
2018-04-17 13:44:57,13140.0,2,12590,0,13140.0,5,13145.0,7,S
2018-04-17 13:44:58,13140.0,2,12592,0,13140.0,9,13145.0,7,S
2018-04-17 13:45:03,13145.0,8,12600,-8,13140.0,9,13145.0,3,B
2018-04-17 13:45:04,13145.0,6,12606,-6,13145.0,18,13150.0,11,B
2018-04-17 13:45:05,13150.0,20,12626,20,13150.0,1,13155.0,21,B
2018-04-17 13:45:06,13155.0,2,12628,0,13150.0,9,13155.0,19,B
2018-04-17 13:45:11,13145.0,4,12632,-2,13145.0,4,13155.0,20,S
2018-04-17 13:45:21,13145.0,2,12634,0,13145.0,4,13150.0,2,S
2018-04-17 13:45:38,13150.0,4,12638,0,13150.0,4,13155.0,19,B
2018-04-17 13:45:45,13150.0,2,12640,0,13145.0,7,13155.0,19,B
2018-04-17 13:45:47,13155.0,2,12642,0,13145.0,6,13155.0,21,B
2018-04-17 13:45:59,13145.0,2,12644,-2,13145.0,5,13150.0,19,S
2018-04-17 13:46:05,13155.0,2,12646,0,13145.0,9,13155.0,29,B
2018-04-17 13:46:14,13145.0,4,12650,-4,13145.0,7,13155.0,24,S
2018-04-17 13:46:27,13155.0,2,12652,0,13145.0,6,13155.0,21,B
2018-04-17 13:46:43,13155.0,2,12654,2,13150.0,1,13155.0,20,B
2018-04-17 13:46:49,13150.0,2,12656,-2,13150.0,2,13155.0,20,S
2018-04-17 13:47:05,13155.0,4,12660,0,13150.0,5,13155.0,14,B
2018-04-17 13:47:10,13155.0,8,12668,8,13150.0,4,13155.0,10,B
2018-04-17 13:47:15,13155.0,18,12686,18,13150.0,7,13160.0,3,B
2018-04-17 13:48:06,13155.0,10,12696,2,13150.0,4,13155.0,2,B
2018-04-17 13:48:06,13150.0,2,12698,-2,13150.0,3,13155.0,1,S
2018-04-17 13:48:09,13155.0,2,12700,2,13150.0,3,13155.0,2,B
2018-04-17 13:49:15,13155.0,4,12704,2,13150.0,4,13160.0,14,B
2018-04-17 13:49:29,13155.0,2,12706,-2,13150.0,11,13160.0,14,B
2018-04-17 13:49:37,13160.0,2,12708,-2,13155.0,13,13160.0,2,B
2018-04-17 13:49:39,13155.0,6,12714,6,13155.0,10,13160.0,2,S
2018-04-17 13:49:47,13155.0,20,12734,0,13150.0,11,13160.0,3,S
2018-04-17 13:49:52,13155.0,2,12736,2,13150.0,10,13155.0,1,S
2018-04-17 13:49:52,13150.0,2,12738,-2,13150.0,4,13155.0,4,S
2018-04-17 13:49:53,13150.0,4,12742,-2,13150.0,3,13155.0,8,S
2018-04-17 13:49:53,13150.0,6,12748,-4,13145.0,2,13155.0,21,S
2018-04-17 13:50:03,13145.0,8,12756,4,13140.0,9,13145.0,1,S
2018-04-17 13:50:03,13145.0,2,12758,2,13140.0,10,13155.0,20,S
2018-04-17 13:50:11,13145.0,2,12760,-2,13145.0,2,13150.0,15,S
2018-04-17 13:50:21,13145.0,2,12762,0,13145.0,8,13155.0,3,S
2018-04-17 13:50:34,13145.0,2,12764,0,13150.0,9,13155.0,3,S
2018-04-17 13:50:38,13150.0,2,12766,0,13150.0,8,13155.0,2,B
2018-04-17 13:50:49,13150.0,2,12768,0,13150.0,7,13155.0,3,B
2018-04-17 13:51:16,13155.0,4,12772,2,13150.0,12,13155.0,2,B
2018-04-17 13:51:21,13150.0,16,12788,-10,13145.0,5,13150.0,8,S
2018-04-17 13:51:41,13150.0,14,12802,0,13145.0,7,13155.0,5,S
2018-04-17 13:51:41,13150.0,6,12808,0,13145.0,7,13155.0,7,S
2018-04-17 13:51:50,13145.0,6,12814,0,13140.0,8,13145.0,1,S
2018-04-17 13:51:51,13145.0,2,12816,0,13150.0,1,13155.0,12,S
2018-04-17 13:51:51,13150.0,2,12818,0,13145.0,3,13150.0,15,B
2018-04-17 13:51:52,13145.0,4,12822,0,13145.0,2,13150.0,10,S
2018-04-17 13:51:52,13145.0,2,12824,0,13140.0,7,13145.0,1,S
2018-04-17 13:51:56,13140.0,10,12834,-2,13140.0,2,13145.0,3,S
2018-04-17 13:52:01,13140.0,4,12838,-2,13135.0,7,13145.0,11,S
2018-04-17 13:52:26,13140.0,12,12850,6,13140.0,2,13145.0,5,S
2018-04-17 13:52:46,13135.0,2,12852,-2,13135.0,6,13140.0,2,S
2018-04-17 13:52:47,13140.0,4,12856,4,13135.0,10,13145.0,10,B
2018-04-17 13:52:48,13135.0,2,12858,-2,13135.0,5,13145.0,14,S
2018-04-17 13:52:58,13135.0,4,12862,0,13135.0,7,13140.0,1,S
2018-04-17 13:52:58,13135.0,4,12866,-4,13135.0,5,13140.0,1,S
2018-04-17 13:53:04,13140.0,2,12868,-2,13135.0,5,13145.0,3,B
2018-04-17 13:53:10,13140.0,2,12870,0,13140.0,1,13145.0,2,B
2018-04-17 13:53:51,13145.0,2,12872,2,13140.0,17,13145.0,1,B
2018-04-17 13:54:08,13145.0,2,12874,0,13140.0,18,13145.0,1,B
2018-04-17 13:54:23,13145.0,4,12878,-4,13140.0,22,13145.0,1,B
2018-04-17 13:54:24,13140.0,2,12880,0,13140.0,17,13150.0,15,S
2018-04-17 13:54:25,13145.0,2,12882,-2,13145.0,1,13150.0,11,B
2018-04-17 13:54:45,13145.0,2,12884,0,13145.0,1,13150.0,2,B
2018-04-17 13:54:46,13150.0,2,12886,0,13145.0,1,13150.0,2,B
2018-04-17 13:55:00,13150.0,4,12890,0,13150.0,1,13155.0,21,B
2018-04-17 13:55:01,13150.0,2,12892,0,13145.0,2,13155.0,23,B
2018-04-17 13:55:04,13150.0,4,12896,2,13145.0,3,13155.0,21,B
2018-04-17 13:55:12,13150.0,2,12898,-2,13145.0,3,13155.0,21,B
2018-04-17 13:55:27,13150.0,2,12900,0,13145.0,3,13150.0,8,B
2018-04-17 13:55:51,13145.0,2,12902,0,13145.0,1,13150.0,9,S
2018-04-17 13:55:52,13150.0,4,12906,4,13140.0,18,13150.0,7,B
2018-04-17 13:55:53,13150.0,4,12910,4,13140.0,19,13150.0,5,B
2018-04-17 13:56:20,13150.0,2,12912,2,13145.0,2,13150.0,7,B
2018-04-17 13:56:23,13150.0,14,12926,14,13145.0,8,13155.0,20,B
2018-04-17 13:56:29,13155.0,2,12928,0,13145.0,8,13155.0,11,B
2018-04-17 13:56:30,13145.0,4,12932,4,13145.0,6,13155.0,11,S
2018-04-17 13:56:40,13155.0,2,12934,0,13150.0,1,13155.0,8,B
2018-04-17 13:56:41,13155.0,18,12952,-4,13155.0,6,13160.0,7,B
2018-04-17 13:56:41,13155.0,4,12956,-2,13155.0,4,13160.0,11,B
2018-04-17 13:56:42,13155.0,2,12958,-2,13155.0,3,13160.0,16,B
2018-04-17 13:56:44,13160.0,6,12964,-2,13155.0,3,13160.0,17,B
2018-04-17 13:56:45,13155.0,2,12966,-2,13155.0,2,13160.0,19,S
2018-04-17 13:57:15,13155.0,8,12974,-6,13150.0,1,13155.0,1,S
2018-04-17 13:57:20,13145.0,2,12976,0,13145.0,3,13155.0,6,S
2018-04-17 13:57:20,13145.0,2,12978,0,13145.0,2,13155.0,6,S
2018-04-17 13:57:31,13155.0,2,12980,0,13145.0,7,13155.0,6,B
2018-04-17 13:58:15,13150.0,4,12984,0,13145.0,7,13150.0,1,S
2018-04-17 13:58:23,13140.0,2,12986,-2,13140.0,12,13145.0,12,S
2018-04-17 13:58:23,13145.0,8,12994,-6,13140.0,16,13150.0,10,B
2018-04-17 13:58:33,13150.0,2,12996,0,13145.0,1,13150.0,3,B
2018-04-17 13:58:50,13145.0,2,12998,2,13145.0,1,13150.0,4,S
2018-04-17 13:58:54,13145.0,2,13000,0,13140.0,17,13150.0,4,S
2018-04-17 13:58:58,13140.0,10,13010,-10,13140.0,12,13145.0,1,S
2018-04-17 13:59:08,13140.0,2,13012,0,13140.0,11,13145.0,3,S
2018-04-17 13:59:09,13140.0,2,13014,0,13140.0,9,13145.0,3,S
2018-04-17 13:59:10,13140.0,6,13020,2,13140.0,6,13145.0,3,S
2018-04-17 13:59:11,13140.0,2,13022,-2,13140.0,6,13145.0,3,S
2018-04-17 13:59:20,13140.0,2,13024,2,13140.0,5,13145.0,3,S
2018-04-17 13:59:23,13140.0,4,13028,0,13140.0,3,13145.0,3,S
2018-04-17 13:59:26,13140.0,2,13030,2,13140.0,3,13145.0,3,S
2018-04-17 13:59:36,13140.0,6,13036,4,13135.0,10,13140.0,7,S
2018-04-17 13:59:37,13140.0,14,13050,14,13135.0,11,13145.0,3,S
2018-04-17 13:59:38,13145.0,4,13054,2,13145.0,13,13150.0,35,B
2018-04-17 13:59:38,13150.0,2,13056,0,13145.0,9,13150.0,34,B
2018-04-17 13:59:44,13140.0,4,13060,0,13140.0,6,13150.0,33,S
2018-04-17 13:59:48,13150.0,4,13064,0,13140.0,6,13150.0,30,B
2018-04-17 13:59:59,13150.0,6,13070,-2,13145.0,6,13150.0,27,B
2018-04-17 14:00:00,13150.0,12,13082,-2,13145.0,6,13150.0,21,B
2018-04-17 14:00:01,13150.0,42,13124,-6,13150.0,4,13155.0,7,B
2018-04-17 14:00:03,13155.0,6,13130,-2,13155.0,2,13160.0,7,B
2018-04-17 14:00:43,13160.0,4,13134,2,13150.0,3,13160.0,9,B
2018-04-17 14:00:55,13160.0,4,13138,0,13155.0,3,13160.0,1,B
2018-04-17 14:01:00,13160.0,2,13140,0,13155.0,2,13165.0,6,B
2018-04-17 14:01:09,13160.0,2,13142,0,13155.0,2,13160.0,3,B
2018-04-17 14:01:23,13160.0,2,13144,-2,13150.0,4,13160.0,5,B
2018-04-17 14:01:29,13160.0,2,13146,0,13150.0,15,13160.0,4,B
2018-04-17 14:01:37,13160.0,2,13148,0,13150.0,16,13160.0,3,B
2018-04-17 14:01:43,13160.0,6,13154,-4,13160.0,7,13165.0,9,B
2018-04-17 14:01:43,13160.0,10,13164,-6,13160.0,2,13165.0,8,B
2018-04-17 14:01:44,13160.0,4,13168,-2,13155.0,1,13165.0,6,B
2018-04-17 14:02:23,13160.0,2,13170,2,13155.0,3,13165.0,7,B
2018-04-17 14:02:31,13155.0,2,13172,-2,13155.0,1,13160.0,18,S
2018-04-17 14:03:11,13150.0,4,13176,-4,13150.0,3,13160.0,11,S
2018-04-17 14:03:15,13160.0,4,13180,0,13150.0,3,13160.0,9,B
2018-04-17 14:04:11,13160.0,6,13186,0,13155.0,1,13160.0,5,B
2018-04-17 14:04:53,13160.0,2,13188,0,13155.0,1,13160.0,4,B
2018-04-17 14:05:41,13160.0,4,13192,0,13155.0,1,13160.0,2,B
2018-04-17 14:05:58,13160.0,2,13194,-2,13155.0,1,13165.0,7,B
2018-04-17 14:06:11,13155.0,2,13196,2,13155.0,1,13160.0,1,S
2018-04-17 14:06:11,13160.0,4,13200,2,13150.0,9,13165.0,5,B
2018-04-17 14:06:42,13165.0,2,13202,2,13160.0,8,13165.0,2,B
2018-04-17 14:06:43,13165.0,6,13208,-2,13160.0,13,13170.0,9,B
2018-04-17 14:06:45,13170.0,2,13210,2,13165.0,8,13170.0,5,B
2018-04-17 14:07:04,13165.0,4,13214,0,13165.0,6,13170.0,5,S
2018-04-17 14:07:04,13165.0,12,13226,-12,13160.0,3,13170.0,10,S
2018-04-17 14:07:11,13170.0,2,13228,0,13160.0,3,13170.0,8,B
2018-04-17 14:07:27,13160.0,2,13230,-2,13160.0,2,13170.0,12,S
2018-04-17 14:08:18,13165.0,2,13232,2,13160.0,4,13170.0,7,B
2018-04-17 14:08:27,13170.0,2,13234,2,13165.0,11,13170.0,5,B
2018-04-17 14:08:55,13165.0,4,13238,4,13165.0,8,13170.0,7,S
2018-04-17 14:08:55,13165.0,16,13254,16,13160.0,2,13170.0,11,S
2018-04-17 14:09:09,13170.0,4,13258,4,13160.0,3,13170.0,11,B
2018-04-17 14:09:35,13170.0,18,13276,-2,13165.0,2,13170.0,2,B
2018-04-17 14:09:39,13165.0,4,13280,4,13160.0,4,13170.0,4,S
2018-04-17 14:09:53,13160.0,2,13282,0,13160.0,3,13165.0,1,S
2018-04-17 14:09:57,13165.0,2,13284,0,13165.0,9,13170.0,4,B
2018-04-17 14:10:31,13165.0,2,13286,0,13165.0,9,13170.0,12,B
2018-04-17 14:11:38,13170.0,4,13290,0,13165.0,10,13170.0,9,B
2018-04-17 14:11:49,13170.0,4,13294,0,13165.0,10,13170.0,7,B
2018-04-17 14:11:55,13165.0,4,13298,-4,13165.0,8,13170.0,7,S
2018-04-17 14:12:15,13170.0,8,13306,8,13165.0,13,13175.0,8,B
2018-04-17 14:12:39,13170.0,8,13314,-8,13165.0,8,13175.0,13,B
2018-04-17 14:12:46,13175.0,2,13316,0,13165.0,13,13175.0,12,B
2018-04-17 14:13:13,13175.0,2,13318,0,13165.0,13,13175.0,11,B
2018-04-17 14:13:15,13165.0,2,13320,0,13165.0,12,13175.0,11,S
2018-04-17 14:13:16,13165.0,4,13324,0,13165.0,6,13170.0,8,S
2018-04-17 14:13:18,13170.0,2,13326,2,13165.0,6,13170.0,3,B
2018-04-17 14:13:25,13170.0,4,13330,0,13170.0,1,13175.0,16,B
2018-04-17 14:13:40,13165.0,4,13334,-4,13165.0,4,13170.0,10,S
2018-04-17 14:13:40,13165.0,8,13342,-4,13160.0,5,13165.0,4,S
2018-04-17 14:13:53,13165.0,2,13344,0,13160.0,3,13165.0,3,S
2018-04-17 14:13:58,13160.0,2,13346,0,13160.0,2,13165.0,5,S
2018-04-17 14:14:00,13160.0,2,13348,2,13160.0,1,13165.0,5,S
2018-04-17 14:14:01,13160.0,2,13350,2,13155.0,4,13165.0,5,S
2018-04-17 14:15:06,13155.0,2,13352,0,13155.0,1,13160.0,12,S
2018-04-17 14:15:07,13155.0,2,13354,0,13150.0,4,13160.0,12,S
2018-04-17 14:15:40,13155.0,4,13358,4,13150.0,2,13155.0,4,S
2018-04-17 14:15:57,13150.0,8,13366,-4,13145.0,3,13155.0,14,S
2018-04-17 14:15:58,13150.0,2,13368,-2,13145.0,9,13155.0,14,S
2018-04-17 14:16:04,13150.0,2,13370,0,13150.0,4,13155.0,14,S
2018-04-17 14:16:15,13150.0,2,13372,0,13150.0,3,13155.0,14,S
2018-04-17 14:16:17,13150.0,4,13376,4,13150.0,1,13155.0,20,S
2018-04-17 14:16:31,13150.0,2,13378,0,13145.0,11,13150.0,1,S
2018-04-17 14:16:31,13150.0,2,13380,2,13145.0,14,13155.0,20,S
2018-04-17 14:16:33,13150.0,2,13382,-2,13145.0,16,13155.0,26,S
2018-04-17 14:16:51,13145.0,10,13392,0,13140.0,24,13150.0,4,S
2018-04-17 14:17:01,13140.0,2,13394,-2,13140.0,22,13145.0,5,S
2018-04-17 14:17:02,13140.0,2,13396,0,13140.0,21,13145.0,5,S
2018-04-17 14:17:06,13140.0,14,13410,-4,13140.0,13,13145.0,14,S
2018-04-17 14:17:06,13140.0,26,13436,14,13135.0,9,13145.0,14,S
2018-04-17 14:17:25,13145.0,10,13446,2,13145.0,2,13150.0,16,B
2018-04-17 14:17:26,13145.0,2,13448,-2,13145.0,2,13150.0,14,B
2018-04-17 14:17:33,13145.0,2,13450,0,13140.0,11,13150.0,13,B
2018-04-17 14:17:40,13145.0,2,13452,-2,13140.0,8,13150.0,18,B
2018-04-17 14:17:51,13150.0,2,13454,0,13140.0,4,13150.0,16,B
2018-04-17 14:18:24,13140.0,10,13464,2,13135.0,7,13140.0,5,S
2018-04-17 14:18:24,13140.0,6,13470,2,13135.0,9,13140.0,2,S
2018-04-17 14:18:25,13140.0,2,13472,0,13135.0,9,13140.0,1,S
2018-04-17 14:18:26,13140.0,2,13474,2,13135.0,10,13145.0,1,S
2018-04-17 14:18:26,13145.0,2,13476,2,13135.0,10,13150.0,19,B
2018-04-17 14:18:33,13140.0,2,13478,-2,13135.0,12,13145.0,7,S
2018-04-17 14:18:56,13140.0,2,13480,-2,13140.0,13,13150.0,16,S
2018-04-17 14:19:09,13140.0,2,13482,-2,13140.0,9,13145.0,2,S
2018-04-17 14:19:28,13140.0,4,13486,0,13140.0,9,13150.0,17,S
2018-04-17 14:19:34,13145.0,2,13488,0,13145.0,2,13150.0,17,B
2018-04-17 14:19:35,13145.0,2,13490,2,13145.0,2,13150.0,17,B
2018-04-17 14:19:45,13150.0,2,13492,0,13145.0,6,13150.0,17,B
2018-04-17 14:19:46,13145.0,8,13500,6,13145.0,2,13150.0,17,S
2018-04-17 14:19:47,13145.0,6,13506,4,13140.0,9,13145.0,1,S
2018-04-17 14:19:47,13145.0,2,13508,-2,13140.0,9,13145.0,1,S
2018-04-17 14:19:50,13145.0,6,13514,0,13140.0,4,13145.0,8,S
2018-04-17 14:19:52,13140.0,8,13522,0,13140.0,5,13145.0,8,S
2018-04-17 14:19:58,13140.0,2,13524,0,13140.0,9,13145.0,6,S
2018-04-17 14:20:00,13140.0,20,13544,-6,13135.0,7,13140.0,1,S
2018-04-17 14:20:01,13140.0,4,13548,0,13135.0,6,13140.0,1,S
2018-04-17 14:20:01,13140.0,2,13550,-2,13140.0,2,13145.0,3,S
2018-04-17 14:20:04,13145.0,2,13552,-2,13145.0,1,13150.0,18,B
2018-04-17 14:20:06,13145.0,2,13554,2,13140.0,5,13145.0,6,B
2018-04-17 14:20:25,13150.0,8,13562,4,13140.0,9,13150.0,13,B
2018-04-17 14:20:49,13140.0,6,13568,-6,13140.0,2,13145.0,1,S
2018-04-17 14:21:12,13145.0,2,13570,2,13145.0,3,13150.0,26,B
2018-04-17 14:21:19,13145.0,2,13572,0,13140.0,13,13150.0,10,B
2018-04-17 14:21:33,13145.0,2,13574,0,13140.0,13,13150.0,15,B
2018-04-17 14:21:35,13140.0,20,13594,0,13140.0,3,13150.0,16,S
2018-04-17 14:22:11,13145.0,2,13596,2,13145.0,1,13150.0,13,B
2018-04-17 14:22:28,13145.0,2,13598,-2,13140.0,11,13150.0,12,B
2018-04-17 14:22:54,13140.0,2,13600,-2,13140.0,5,13145.0,26,S
2018-04-17 14:22:54,13140.0,8,13608,2,13140.0,1,13145.0,30,S
2018-04-17 14:22:55,13140.0,2,13610,2,13135.0,12,13145.0,34,S
2018-04-17 14:22:57,13140.0,8,13618,8,13135.0,6,13145.0,12,S
2018-04-17 14:23:01,13140.0,2,13620,0,13135.0,8,13140.0,1,S
2018-04-17 14:23:15,13140.0,2,13622,-2,13140.0,1,13150.0,16,S
2018-04-17 14:23:45,13145.0,20,13642,8,13135.0,7,13145.0,2,B
2018-04-17 14:24:01,13145.0,20,13662,18,13135.0,11,13145.0,3,B
2018-04-17 14:24:07,13145.0,4,13666,-4,13140.0,19,13150.0,13,B
2018-04-17 14:24:16,13150.0,20,13686,6,13140.0,19,13155.0,33,B
2018-04-17 14:24:53,13145.0,2,13688,0,13145.0,9,13150.0,1,S
2018-04-17 14:25:01,13150.0,4,13692,0,13145.0,11,13155.0,36,B
2018-04-17 14:25:17,13150.0,2,13694,0,13145.0,10,13150.0,1,B
2018-04-17 14:25:22,13145.0,4,13698,2,13145.0,8,13150.0,1,S
2018-04-17 14:25:34,13145.0,14,13712,12,13140.0,7,13145.0,1,S
2018-04-17 14:25:50,13140.0,4,13716,-2,13140.0,1,13150.0,9,S
2018-04-17 14:26:06,13150.0,2,13718,-2,13140.0,8,13150.0,16,B
2018-04-17 14:26:10,13140.0,2,13720,0,13140.0,11,13145.0,17,S
2018-04-17 14:26:11,13135.0,28,13748,8,13135.0,7,13140.0,3,S
2018-04-17 14:26:12,13135.0,2,13750,-2,13135.0,2,13140.0,11,S
2018-04-17 14:26:16,13135.0,8,13758,-4,13135.0,3,13140.0,23,S
2018-04-17 14:26:17,13135.0,2,13760,2,13135.0,2,13140.0,23,S
2018-04-17 14:26:21,13135.0,2,13762,0,13135.0,1,13140.0,22,S
2018-04-17 14:26:22,13135.0,2,13764,2,13130.0,10,13140.0,21,S
2018-04-17 14:26:22,13130.0,2,13766,2,13130.0,11,13140.0,22,S
2018-04-17 14:26:23,13130.0,2,13768,-2,13130.0,10,13135.0,2,S
2018-04-17 14:26:25,13130.0,2,13770,2,13130.0,9,13135.0,2,S
2018-04-17 14:26:27,13130.0,2,13772,0,13130.0,8,13135.0,2,S
2018-04-17 14:26:27,13135.0,4,13776,0,13130.0,8,13140.0,16,B
2018-04-17 14:26:31,13135.0,2,13778,2,13130.0,12,13140.0,15,B
2018-04-17 14:26:35,13135.0,2,13780,0,13135.0,15,13145.0,17,B
2018-04-17 14:26:41,13140.0,2,13782,0,13135.0,13,13145.0,9,B
2018-04-17 14:26:50,13140.0,2,13784,2,13140.0,9,13145.0,19,B
2018-04-17 14:26:56,13140.0,6,13790,2,13140.0,7,13145.0,16,B
2018-04-17 14:26:56,13140.0,2,13792,0,13140.0,6,13145.0,17,B
2018-04-17 14:26:57,13140.0,4,13796,2,13140.0,5,13145.0,15,B
2018-04-17 14:27:03,13140.0,2,13798,2,13140.0,4,13145.0,20,B
2018-04-17 14:27:03,13145.0,2,13800,0,13140.0,4,13145.0,19,B
2018-04-17 14:27:09,13140.0,2,13802,2,13140.0,5,13145.0,16,S
2018-04-17 14:27:12,13140.0,2,13804,2,13140.0,3,13145.0,17,S
2018-04-17 14:27:13,13135.0,16,13820,2,13135.0,6,13140.0,7,S
2018-04-17 14:27:16,13140.0,2,13822,0,13135.0,13,13140.0,6,B
2018-04-17 14:27:19,13135.0,2,13824,0,13135.0,12,13140.0,6,S
2018-04-17 14:27:24,13135.0,6,13830,0,13135.0,7,13140.0,7,S
2018-04-17 14:27:28,13140.0,14,13844,2,13140.0,3,13145.0,8,B
2018-04-17 14:27:35,13140.0,2,13846,2,13140.0,2,13145.0,16,B
2018-04-17 14:27:46,13140.0,8,13854,4,13140.0,1,13145.0,15,B
2018-04-17 14:27:47,13145.0,4,13858,0,13140.0,1,13145.0,13,B
2018-04-17 14:27:53,13140.0,2,13860,0,13135.0,11,13145.0,18,S
2018-04-17 14:27:54,13140.0,2,13862,0,13140.0,2,13145.0,11,S
2018-04-17 14:28:14,13140.0,4,13866,-2,13140.0,3,13145.0,1,S
2018-04-17 14:28:27,13140.0,2,13868,0,13140.0,2,13145.0,1,S
2018-04-17 14:28:59,13145.0,4,13872,4,13145.0,4,13150.0,7,B
2018-04-17 14:28:59,13145.0,2,13874,0,13145.0,5,13150.0,3,B
2018-04-17 14:29:00,13145.0,4,13878,0,13140.0,2,13150.0,14,B
2018-04-17 14:29:05,13150.0,4,13882,2,13140.0,2,13150.0,14,B
2018-04-17 14:29:20,13150.0,2,13884,0,13145.0,4,13150.0,3,B
2018-04-17 14:29:41,13150.0,4,13888,4,13145.0,1,13150.0,2,B
2018-04-17 14:29:53,13145.0,8,13896,2,13145.0,5,13150.0,4,S
2018-04-17 14:29:54,13145.0,6,13902,0,13145.0,2,13150.0,4,S
2018-04-17 14:29:56,13140.0,4,13906,2,13140.0,8,13150.0,5,S
2018-04-17 14:29:59,13140.0,2,13908,2,13140.0,8,13150.0,5,S
2018-04-17 14:30:00,13140.0,2,13910,2,13140.0,7,13150.0,5,S
2018-04-17 14:30:07,13140.0,2,13912,0,13140.0,6,13150.0,5,S
2018-04-17 14:30:11,13140.0,2,13914,2,13140.0,5,13145.0,2,S
2018-04-17 14:30:11,13145.0,4,13918,2,13140.0,5,13150.0,7,B
2018-04-17 14:31:04,13140.0,12,13930,12,13135.0,8,13145.0,1,S
2018-04-17 14:31:09,13145.0,8,13938,-6,13135.0,7,13145.0,3,B
2018-04-17 14:31:33,13135.0,2,13940,0,13135.0,4,13140.0,8,S
2018-04-17 14:31:34,13135.0,2,13942,2,13135.0,3,13140.0,8,S
2018-04-17 14:31:36,13135.0,6,13948,2,13130.0,11,13140.0,8,S
2018-04-17 14:31:40,13130.0,2,13950,0,13130.0,10,13140.0,7,S
2018-04-17 14:31:48,13130.0,2,13952,-2,13130.0,9,13140.0,7,S
2018-04-17 14:31:49,13130.0,2,13954,2,13130.0,8,13140.0,8,S
2018-04-17 14:32:01,13130.0,2,13956,0,13130.0,7,13140.0,13,S
2018-04-17 14:32:06,13135.0,8,13964,0,13135.0,1,13140.0,14,B
2018-04-17 14:32:20,13135.0,6,13970,0,13130.0,7,13135.0,10,B
2018-04-17 14:32:21,13135.0,20,13990,12,13135.0,3,13140.0,10,B
2018-04-17 14:32:32,13135.0,6,13996,2,13135.0,1,13140.0,11,B
2018-04-17 14:32:32,13135.0,2,13998,0,13130.0,11,13140.0,15,B
2018-04-17 14:33:42,13135.0,2,14000,2,13135.0,10,13140.0,13,B
2018-04-17 14:33:43,13135.0,6,14006,0,13135.0,7,13140.0,13,B
2018-04-17 14:34:24,13135.0,14,14020,0,13130.0,8,13135.0,3,B
2018-04-17 14:34:44,13135.0,2,14022,0,13130.0,7,13135.0,2,B
2018-04-17 14:34:45,13135.0,2,14024,0,13130.0,7,13135.0,1,B
2018-04-17 14:34:58,13135.0,2,14026,0,13130.0,7,13140.0,13,B
2018-04-17 14:35:12,13135.0,2,14028,2,13130.0,9,13140.0,11,B
2018-04-17 14:35:38,13135.0,2,14030,-2,13130.0,8,13140.0,11,B
2018-04-17 14:35:56,13130.0,4,14034,0,13130.0,5,13135.0,1,S
2018-04-17 14:35:56,13135.0,2,14036,2,13130.0,5,13140.0,17,B
2018-04-17 14:36:04,13130.0,2,14038,2,13130.0,4,13135.0,1,S
2018-04-17 14:36:05,13135.0,2,14040,2,13130.0,5,13140.0,13,B
2018-04-17 14:36:21,13135.0,2,14042,0,13130.0,9,13140.0,9,B
2018-04-17 14:36:22,13135.0,2,14044,0,13130.0,12,13140.0,9,B
2018-04-17 14:36:43,13135.0,2,14046,0,13130.0,14,13140.0,10,B
2018-04-17 14:36:49,13140.0,2,14048,-2,13130.0,14,13140.0,9,B
2018-04-17 14:37:22,13135.0,2,14050,2,13135.0,1,13140.0,10,S
2018-04-17 14:37:54,13135.0,2,14052,0,13135.0,2,13140.0,12,S
2018-04-17 14:37:56,13135.0,2,14054,2,13135.0,1,13140.0,17,S
2018-04-17 14:37:56,13135.0,4,14058,-2,13135.0,9,13140.0,17,S
2018-04-17 14:37:59,13135.0,2,14060,2,13135.0,8,13140.0,17,S
2018-04-17 14:38:06,13135.0,2,14062,2,13135.0,7,13140.0,16,S
2018-04-17 14:38:09,13135.0,2,14064,2,13135.0,6,13140.0,16,S
2018-04-17 14:38:09,13135.0,2,14066,2,13135.0,5,13140.0,16,S
2018-04-17 14:38:13,13140.0,2,14068,2,13135.0,5,13140.0,15,B
2018-04-17 14:38:20,13140.0,4,14072,4,13135.0,5,13140.0,13,B
2018-04-17 14:38:20,13135.0,10,14082,6,13130.0,4,13140.0,17,S
2018-04-17 14:38:30,13130.0,4,14086,2,13125.0,9,13135.0,2,S
2018-04-17 14:39:05,13130.0,4,14090,0,13125.0,7,13130.0,1,S
2018-04-17 14:39:05,13130.0,2,14092,2,13125.0,11,13135.0,5,S
2018-04-17 14:39:38,13130.0,2,14094,0,13125.0,14,13130.0,5,S
2018-04-17 14:39:39,13130.0,8,14102,4,13125.0,10,13130.0,1,S
2018-04-17 14:39:40,13130.0,2,14104,0,13130.0,2,13135.0,8,S
2018-04-17 14:39:41,13130.0,4,14108,0,13125.0,10,13135.0,8,S
2018-04-17 14:39:42,13130.0,2,14110,0,13125.0,10,13135.0,12,S
2018-04-17 14:39:49,13125.0,10,14120,-2,13125.0,8,13135.0,8,S
2018-04-17 14:39:49,13125.0,2,14122,-2,13125.0,8,13135.0,8,S
2018-04-17 14:39:51,13130.0,2,14124,0,13125.0,5,13135.0,12,B
2018-04-17 14:40:01,13125.0,4,14128,0,13125.0,10,13130.0,1,S
2018-04-17 14:40:14,13130.0,16,14144,4,13125.0,8,13135.0,11,B
2018-04-17 14:41:00,13130.0,2,14146,2,13130.0,3,13135.0,10,B
2018-04-17 14:41:03,13135.0,4,14150,2,13130.0,8,13135.0,8,B
2018-04-17 14:41:08,13135.0,2,14152,0,13130.0,3,13135.0,6,B
2018-04-17 14:41:08,13135.0,2,14154,2,13130.0,3,13135.0,5,B
2018-04-17 14:41:09,13135.0,10,14164,-4,13130.0,8,13140.0,11,B
2018-04-17 14:41:12,13135.0,2,14166,0,13130.0,10,13140.0,10,B
2018-04-17 14:41:13,13140.0,4,14170,0,13130.0,10,13140.0,7,B
2018-04-17 14:41:21,13140.0,2,14172,-2,13135.0,1,13140.0,5,B
2018-04-17 14:41:22,13140.0,4,14176,-2,13135.0,1,13140.0,3,B
2018-04-17 14:41:29,13140.0,4,14180,0,13135.0,1,13145.0,8,B
2018-04-17 14:41:30,13145.0,2,14182,-2,13135.0,2,13145.0,10,B
2018-04-17 14:41:31,13135.0,4,14186,-2,13135.0,3,13140.0,1,S
2018-04-17 14:41:31,13140.0,2,14188,0,13135.0,3,13145.0,6,B
2018-04-17 14:41:33,13135.0,2,14190,0,13135.0,2,13145.0,7,S
2018-04-17 14:41:45,13145.0,8,14198,-2,13140.0,1,13150.0,11,B
2018-04-17 14:42:06,13145.0,10,14208,2,13140.0,13,13145.0,6,B
2018-04-17 14:42:06,13145.0,12,14220,10,13140.0,13,13150.0,11,B
2018-04-17 14:42:36,13140.0,2,14222,2,13140.0,14,13145.0,2,S
2018-04-17 14:42:42,13145.0,4,14226,2,13140.0,14,13150.0,11,B
2018-04-17 14:42:43,13145.0,4,14230,4,13145.0,8,13150.0,11,B
2018-04-17 14:42:45,13145.0,4,14234,0,13145.0,8,13150.0,11,B
2018-04-17 14:42:46,13150.0,6,14240,6,13145.0,9,13150.0,8,B
2018-04-17 14:42:47,13150.0,16,14256,6,13145.0,9,13155.0,28,B
2018-04-17 14:42:51,13150.0,2,14258,0,13145.0,13,13150.0,1,B
2018-04-17 14:42:52,13150.0,2,14260,2,13150.0,20,13155.0,26,B
2018-04-17 14:42:53,13150.0,4,14264,4,13150.0,17,13155.0,26,B
2018-04-17 14:42:56,13150.0,2,14266,2,13150.0,2,13155.0,25,B
2018-04-17 14:43:02,13150.0,2,14268,2,13145.0,4,13150.0,1,B
2018-04-17 14:43:03,13150.0,2,14270,0,13145.0,4,13155.0,28,B
2018-04-17 14:43:13,13150.0,8,14278,-8,13145.0,10,13150.0,6,B
2018-04-17 14:43:42,13150.0,2,14280,2,13150.0,1,13155.0,28,B
2018-04-17 14:43:44,13150.0,6,14286,2,13145.0,11,13150.0,2,B
2018-04-17 14:43:49,13150.0,4,14290,4,13150.0,8,13155.0,28,B
2018-04-17 14:44:12,13150.0,2,14292,2,13150.0,7,13155.0,26,B
2018-04-17 14:44:12,13145.0,16,14308,14,13150.0,2,13155.0,26,S
2018-04-17 14:44:14,13145.0,2,14310,0,13150.0,1,13155.0,26,S
2018-04-17 14:44:18,13150.0,2,14312,0,13150.0,1,13155.0,26,B
2018-04-17 14:44:20,13150.0,2,14314,0,13145.0,7,13155.0,26,B
2018-04-17 14:45:01,13145.0,14,14328,0,13140.0,10,13150.0,7,S
2018-04-17 14:45:01,13135.0,38,14366,10,13130.0,27,13145.0,1,S
2018-04-17 14:45:14,13140.0,2,14368,2,13140.0,4,13145.0,4,B
2018-04-17 14:45:15,13140.0,8,14376,0,13135.0,4,13140.0,3,B
2018-04-17 14:45:15,13135.0,4,14380,0,13135.0,1,13140.0,8,S
2018-04-17 14:45:16,13135.0,2,14382,0,13130.0,36,13140.0,9,S
2018-04-17 14:45:26,13135.0,2,14384,-2,13135.0,1,13140.0,9,S
2018-04-17 14:45:40,13135.0,4,14388,0,13130.0,31,13140.0,13,S
2018-04-17 14:45:41,13130.0,4,14392,0,13130.0,32,13140.0,12,S
2018-04-17 14:45:47,13140.0,2,14394,-2,13140.0,3,13145.0,6,B
2018-04-17 14:45:54,13140.0,4,14398,0,13140.0,2,13145.0,9,B
2018-04-17 14:46:22,13145.0,2,14400,2,13135.0,15,13145.0,11,B
2018-04-17 14:46:37,13135.0,2,14402,-2,13135.0,4,13140.0,1,S
2018-04-17 14:46:38,13140.0,2,14404,0,13135.0,4,13145.0,11,B
2018-04-17 14:46:40,13145.0,2,14406,0,13135.0,9,13145.0,11,B
2018-04-17 14:46:44,13135.0,2,14408,0,13135.0,8,13145.0,11,S
2018-04-17 14:47:18,13145.0,2,14410,0,13140.0,2,13145.0,6,B
2018-04-17 14:47:32,13145.0,12,14422,0,13140.0,3,13150.0,12,B
2018-04-17 14:47:33,13140.0,4,14426,-2,13140.0,2,13150.0,17,S
2018-04-17 14:47:33,13150.0,2,14428,0,13140.0,2,13150.0,16,B
2018-04-17 14:47:34,13140.0,6,14434,4,13135.0,21,13150.0,15,S
2018-04-17 14:47:51,13140.0,10,14444,6,13140.0,2,13145.0,15,S
2018-04-17 14:47:51,13145.0,2,14446,0,13140.0,4,13145.0,14,B
2018-04-17 14:48:07,13140.0,2,14448,0,13140.0,6,13145.0,25,S
2018-04-17 14:48:10,13145.0,2,14450,0,13140.0,1,13145.0,24,B
2018-04-17 14:48:14,13140.0,2,14452,2,13135.0,22,13140.0,4,S
2018-04-17 14:48:15,13140.0,8,14460,2,13140.0,4,13145.0,24,S
2018-04-17 14:48:50,13145.0,10,14470,10,13135.0,30,13145.0,20,B
2018-04-17 14:48:53,13145.0,2,14472,0,13135.0,30,13145.0,19,B
2018-04-17 14:48:57,13140.0,2,14474,-2,13140.0,2,13145.0,19,S
2018-04-17 14:49:10,13140.0,2,14476,0,13135.0,20,13145.0,19,S
2018-04-17 14:49:46,13140.0,2,14478,-2,13140.0,2,13145.0,19,S
2018-04-17 14:49:57,13140.0,2,14480,2,13135.0,20,13140.0,1,S
2018-04-17 14:49:58,13140.0,2,14482,0,13140.0,2,13145.0,18,S
2018-04-17 14:50:21,13145.0,36,14518,28,13145.0,1,13150.0,14,B
2018-04-17 14:50:35,13145.0,4,14522,2,13145.0,1,13150.0,9,B
2018-04-17 14:50:36,13150.0,12,14534,-4,13145.0,1,13150.0,3,B
2018-04-17 14:50:46,13150.0,2,14536,0,13145.0,18,13150.0,2,B
2018-04-17 14:50:46,13150.0,4,14540,-2,13145.0,22,13155.0,31,B
2018-04-17 14:50:57,13150.0,2,14542,0,13150.0,3,13155.0,29,B
2018-04-17 14:51:02,13155.0,2,14544,0,13150.0,3,13155.0,27,B
2018-04-17 14:51:03,13155.0,2,14546,2,13150.0,17,13155.0,27,B
2018-04-17 14:51:05,13155.0,4,14550,0,13150.0,24,13155.0,25,B
2018-04-17 14:51:06,13155.0,2,14552,2,13150.0,24,13155.0,24,B
2018-04-17 14:51:08,13155.0,2,14554,0,13150.0,24,13155.0,23,B
2018-04-17 14:51:10,13155.0,20,14574,20,13150.0,23,13155.0,13,B
2018-04-17 14:51:37,13155.0,10,14584,0,13150.0,9,13155.0,10,B
2018-04-17 14:51:39,13155.0,4,14588,0,13150.0,4,13155.0,8,B
2018-04-17 14:51:44,13150.0,2,14590,0,13150.0,3,13155.0,9,S
2018-04-17 14:51:55,13150.0,2,14592,2,13150.0,3,13155.0,9,S
2018-04-17 14:51:56,13150.0,2,14594,2,13150.0,2,13155.0,9,S
2018-04-17 14:51:56,13150.0,2,14596,0,13150.0,1,13155.0,9,S
2018-04-17 14:52:01,13150.0,4,14600,-2,13145.0,7,13155.0,9,S
2018-04-17 14:52:24,13150.0,2,14602,0,13140.0,20,13150.0,8,S
2018-04-17 14:52:53,13150.0,2,14604,-2,13145.0,18,13155.0,15,S
2018-04-17 14:53:08,13145.0,2,14606,0,13145.0,27,13155.0,17,S
2018-04-17 14:53:31,13155.0,6,14612,6,13150.0,1,13155.0,8,B
2018-04-17 14:53:35,13150.0,6,14618,-4,13150.0,12,13155.0,2,S
2018-04-17 14:53:36,13155.0,4,14622,2,13150.0,15,13160.0,16,B
2018-04-17 14:53:39,13150.0,4,14626,2,13150.0,5,13155.0,5,S
2018-04-17 14:53:40,13155.0,4,14630,-2,13145.0,12,13155.0,4,B
2018-04-17 14:53:43,13155.0,6,14636,-2,13145.0,19,13155.0,1,B
2018-04-17 14:53:50,13150.0,2,14638,2,13150.0,1,13155.0,2,S
2018-04-17 14:54:01,13145.0,10,14648,0,13145.0,17,13155.0,3,S
2018-04-17 14:54:11,13150.0,2,14650,-2,13150.0,1,13155.0,2,B
2018-04-17 14:54:19,13155.0,4,14654,-2,13150.0,13,13160.0,19,B
2018-04-17 14:54:20,13155.0,2,14656,-2,13150.0,13,13160.0,19,B
2018-04-17 14:54:24,13155.0,2,14658,0,13150.0,1,13155.0,3,B
2018-04-17 14:54:25,13155.0,4,14662,-4,13150.0,1,13160.0,17,B
2018-04-17 14:54:26,13155.0,2,14664,2,13150.0,2,13155.0,4,B
2018-04-17 14:54:35,13150.0,2,14666,2,13150.0,16,13160.0,17,S
2018-04-17 14:54:35,13150.0,4,14670,0,13150.0,14,13160.0,17,S
2018-04-17 14:54:45,13150.0,2,14672,0,13150.0,14,13160.0,16,S
2018-04-17 14:54:59,13155.0,2,14674,0,13150.0,15,13160.0,16,B
2018-04-17 14:55:02,13150.0,16,14690,12,13145.0,5,13160.0,17,S
2018-04-17 14:55:34,13155.0,2,14692,2,13145.0,20,13155.0,12,B
2018-04-17 14:55:51,13150.0,2,14694,0,13145.0,13,13150.0,1,S
2018-04-17 14:55:53,13150.0,2,14696,0,13145.0,9,13155.0,8,S
2018-04-17 14:55:58,13150.0,6,14702,0,13145.0,8,13150.0,1,S
2018-04-17 14:56:26,13150.0,8,14710,0,13145.0,8,13155.0,5,S
2018-04-17 14:56:45,13150.0,2,14712,2,13145.0,8,13150.0,4,S
2018-04-17 14:57:01,13155.0,2,14714,-2,13145.0,8,13155.0,23,B
2018-04-17 14:57:01,13155.0,6,14720,-4,13145.0,8,13155.0,20,B
2018-04-17 14:57:03,13145.0,2,14722,-2,13145.0,7,13155.0,20,S
2018-04-17 14:57:08,13150.0,2,14724,2,13145.0,7,13150.0,1,B
2018-04-17 14:57:09,13150.0,2,14726,2,13145.0,7,13155.0,20,B
2018-04-17 14:57:11,13155.0,2,14728,2,13145.0,18,13155.0,19,B
2018-04-17 14:57:11,13155.0,2,14730,2,13145.0,18,13155.0,18,B
2018-04-17 14:57:12,13155.0,2,14732,2,13145.0,18,13155.0,7,B
2018-04-17 14:57:13,13155.0,2,14734,2,13145.0,18,13155.0,7,B
2018-04-17 14:57:14,13155.0,2,14736,2,13145.0,18,13155.0,6,B
2018-04-17 14:57:15,13155.0,2,14738,2,13150.0,1,13155.0,5,B
2018-04-17 14:57:15,13155.0,2,14740,2,13150.0,1,13155.0,4,B
2018-04-17 14:57:16,13155.0,2,14742,2,13150.0,1,13155.0,3,B
2018-04-17 14:57:17,13155.0,2,14744,2,13150.0,2,13155.0,2,B
2018-04-17 14:57:17,13155.0,2,14746,2,13150.0,2,13155.0,1,B
2018-04-17 14:57:18,13155.0,2,14748,0,13150.0,2,13160.0,12,B
2018-04-17 14:57:19,13155.0,2,14750,0,13150.0,3,13160.0,21,B
2018-04-17 14:57:19,13150.0,2,14752,0,13150.0,2,13160.0,24,S
2018-04-17 14:57:22,13150.0,4,14756,2,13145.0,5,13150.0,4,S
2018-04-17 14:57:23,13150.0,2,14758,2,13145.0,8,13150.0,3,S
2018-04-17 14:57:23,13150.0,2,14760,2,13145.0,8,13150.0,2,S
2018-04-17 14:57:24,13150.0,2,14762,2,13145.0,8,13150.0,1,S
2018-04-17 14:57:25,13150.0,2,14764,2,13145.0,8,13155.0,11,S
2018-04-17 14:57:36,13155.0,2,14766,0,13150.0,2,13155.0,11,B
2018-04-17 14:57:36,13155.0,2,14768,0,13150.0,2,13155.0,2,B
2018-04-17 14:57:39,13155.0,4,14772,4,13155.0,1,13160.0,14,B
2018-04-17 14:57:39,13155.0,2,14774,2,13150.0,2,13155.0,8,B
2018-04-17 14:57:40,13150.0,2,14776,0,13150.0,1,13155.0,8,S
2018-04-17 14:57:42,13145.0,8,14784,4,13145.0,13,13155.0,8,S
2018-04-17 14:57:50,13145.0,18,14802,12,13145.0,8,13155.0,8,S
2018-04-17 14:57:52,13155.0,10,14812,0,13145.0,8,13155.0,3,B
2018-04-17 14:58:00,13150.0,6,14818,0,13150.0,2,13155.0,4,S
2018-04-17 14:58:06,13150.0,2,14820,0,13150.0,1,13155.0,3,S
2018-04-17 14:58:10,13155.0,4,14824,-2,13150.0,3,13155.0,2,B
2018-04-17 14:58:12,13150.0,2,14826,0,13150.0,2,13155.0,2,S
2018-04-17 14:58:18,13150.0,2,14828,0,13150.0,3,13155.0,2,S
2018-04-17 14:58:27,13155.0,6,14834,0,13150.0,4,13160.0,14,B
2018-04-17 14:58:38,13150.0,8,14842,-2,13145.0,16,13150.0,6,S
2018-04-17 14:58:38,13150.0,12,14854,-10,13145.0,20,13155.0,1,S
2018-04-17 14:58:48,13150.0,2,14856,-2,13150.0,2,13160.0,19,S
2018-04-17 14:59:00,13160.0,6,14862,0,13150.0,2,13160.0,16,B
2018-04-17 14:59:01,13160.0,20,14882,0,13150.0,6,13160.0,6,B
2018-04-17 14:59:02,13150.0,8,14890,-4,13150.0,2,13160.0,6,S
2018-04-17 14:59:05,13160.0,2,14892,2,13150.0,2,13160.0,5,B
2018-04-17 14:59:09,13155.0,2,14894,0,13150.0,2,13160.0,8,S
2018-04-17 14:59:10,13150.0,2,14896,0,13150.0,1,13160.0,8,S
2018-04-17 14:59:10,13150.0,2,14898,-2,13150.0,1,13160.0,8,S
2018-04-17 14:59:11,13150.0,2,14900,-2,13145.0,15,13160.0,8,S
2018-04-17 14:59:25,13155.0,2,14902,-2,13145.0,16,13155.0,3,B
2018-04-17 14:59:29,13155.0,4,14906,-4,13145.0,19,13155.0,1,B
2018-04-17 14:59:30,13145.0,2,14908,0,13145.0,18,13155.0,2,S
2018-04-17 14:59:30,13155.0,2,14910,-2,13145.0,18,13160.0,11,B
2018-04-17 14:59:40,13145.0,6,14916,0,13145.0,15,13160.0,9,S
2018-04-17 14:59:42,13145.0,4,14920,0,13145.0,13,13160.0,7,S
2018-04-17 14:59:43,13155.0,2,14922,0,13145.0,14,13160.0,7,B
2018-04-17 14:59:48,13145.0,2,14924,0,13145.0,12,13160.0,7,S
2018-04-17 20:59:00,13160.0,12,12,66556,0.0,0,0.0,0,B
2018-04-17 21:00:00,13185.0,32,44,26,13185.0,7,13200.0,3,B
2018-04-17 21:00:01,13210.0,22,66,22,13190.0,7,13210.0,2,B
2018-04-17 21:00:01,13215.0,12,78,-8,13210.0,1,13215.0,4,B
2018-04-17 21:00:02,13210.0,6,84,2,13190.0,9,13205.0,5,S
2018-04-17 21:00:02,13190.0,8,92,8,13190.0,2,13205.0,2,S
2018-04-17 21:00:03,13190.0,6,98,2,13190.0,1,13205.0,1,S
2018-04-17 21:00:03,13190.0,2,100,-2,13185.0,11,13190.0,2,S
2018-04-17 21:00:04,13190.0,4,104,-2,13185.0,10,13190.0,1,S
2018-04-17 21:00:05,13185.0,26,130,-14,13165.0,4,13190.0,2,S
2018-04-17 21:00:07,13170.0,2,132,-2,13170.0,2,13180.0,2,S
2018-04-17 21:00:10,13180.0,2,134,-2,13170.0,1,13180.0,4,B
2018-04-17 21:00:13,13170.0,2,136,0,13165.0,3,13180.0,6,S
2018-04-17 21:00:18,13170.0,2,138,0,13170.0,1,13180.0,6,S
2018-04-17 21:00:19,13170.0,2,140,-2,13170.0,1,13180.0,6,S
2018-04-17 21:00:20,13180.0,2,142,-2,13170.0,1,13180.0,6,B
2018-04-17 21:00:20,13180.0,4,146,0,13170.0,1,13175.0,1,B
2018-04-17 21:00:26,13170.0,2,148,0,13165.0,4,13175.0,2,S
2018-04-17 21:00:29,13175.0,8,156,-4,13175.0,76,13180.0,6,B
2018-04-17 21:00:29,13175.0,2,158,0,13175.0,75,13180.0,7,B
2018-04-17 21:00:30,13175.0,4,162,0,13175.0,73,13180.0,10,B
2018-04-17 21:00:32,13180.0,12,174,-6,13175.0,73,13190.0,4,B
2018-04-17 21:00:36,13185.0,2,176,0,13175.0,75,13185.0,3,B
2018-04-17 21:00:37,13185.0,6,182,6,13185.0,2,13190.0,4,B
2018-04-17 21:00:39,13190.0,24,206,-6,13190.0,68,13195.0,3,B
2018-04-17 21:00:40,13190.0,2,208,0,13190.0,67,13195.0,4,B
2018-04-17 21:00:41,13190.0,2,210,0,13190.0,66,13195.0,5,B
2018-04-17 21:00:41,13190.0,2,212,-2,13190.0,65,13195.0,5,B
2018-04-17 21:00:42,13190.0,12,224,0,13190.0,59,13195.0,6,B
2018-04-17 21:00:43,13190.0,102,326,-24,13190.0,8,13195.0,10,B
2018-04-17 21:00:43,13190.0,16,342,-8,13185.0,1,13195.0,11,B
2018-04-17 21:00:45,13185.0,4,346,2,13180.0,1,13185.0,1,S
2018-04-17 21:00:52,13185.0,2,348,-2,13180.0,4,13190.0,10,S
2018-04-17 21:00:58,13180.0,2,350,0,13180.0,3,13185.0,3,S
2018-04-17 21:01:01,13180.0,6,356,0,13180.0,6,13185.0,1,S
2018-04-17 21:01:02,13180.0,2,358,-2,13180.0,7,13185.0,1,S
2018-04-17 21:01:02,13185.0,2,360,2,13180.0,7,13190.0,14,B
2018-04-17 21:01:05,13185.0,2,362,0,13180.0,9,13190.0,17,B
2018-04-17 21:01:09,13185.0,2,364,0,13180.0,10,13190.0,15,B
2018-04-17 21:01:11,13185.0,10,374,2,13180.0,6,13185.0,1,B
2018-04-17 21:01:12,13190.0,4,378,2,13180.0,6,13185.0,3,B
2018-04-17 21:01:12,13185.0,2,380,-2,13180.0,6,13190.0,4,S
2018-04-17 21:01:14,13190.0,2,382,2,13185.0,1,13190.0,3,B
2018-04-17 21:01:15,13185.0,2,384,0,13180.0,6,13190.0,4,S
2018-04-17 21:01:25,13185.0,2,386,0,13185.0,1,13190.0,20,S
2018-04-17 21:01:27,13185.0,2,388,2,13185.0,1,13190.0,20,S
2018-04-17 21:01:28,13190.0,4,392,4,13185.0,1,13190.0,14,B
2018-04-17 21:01:29,13190.0,6,398,6,13185.0,2,13190.0,9,B
2018-04-17 21:01:33,13190.0,18,416,4,13190.0,3,13195.0,6,B
2018-04-17 21:01:33,13190.0,2,418,2,13190.0,2,13195.0,4,B
2018-04-17 21:01:38,13195.0,2,420,-2,13190.0,2,13195.0,3,B
2018-04-17 21:01:38,13190.0,2,422,2,13190.0,1,13195.0,3,S
2018-04-17 21:01:39,13195.0,2,424,-2,13190.0,1,13195.0,2,B
2018-04-17 21:01:40,13190.0,2,426,2,13185.0,3,13190.0,1,S
2018-04-17 21:01:40,13190.0,4,430,0,13185.0,3,13195.0,2,S
2018-04-17 21:01:41,13195.0,2,432,0,13185.0,6,13195.0,2,B
2018-04-17 21:01:43,13195.0,4,436,-2,13185.0,7,13195.0,2,B
2018-04-17 21:01:48,13195.0,10,446,-6,13195.0,1,13200.0,11,B
2018-04-17 21:01:48,13195.0,2,448,2,13185.0,7,13195.0,3,B
2018-04-17 21:01:54,13190.0,10,458,2,13185.0,7,13190.0,1,S
2018-04-17 21:01:54,13190.0,2,460,0,13185.0,7,13200.0,15,S
2018-04-17 21:01:55,13195.0,2,462,0,13185.0,12,13200.0,15,B
2018-04-17 21:02:05,13185.0,2,464,0,13185.0,12,13195.0,3,S
2018-04-17 21:02:06,13185.0,2,466,2,13185.0,11,13195.0,4,S
2018-04-17 21:02:07,13195.0,2,468,2,13185.0,10,13195.0,4,B
2018-04-17 21:02:08,13195.0,2,470,-2,13185.0,4,13195.0,15,B
2018-04-17 21:02:14,13195.0,18,488,-10,13185.0,4,13195.0,6,B
2018-04-17 21:02:16,13185.0,8,496,0,13185.0,1,13195.0,8,S
2018-04-17 21:02:17,13185.0,2,498,0,13180.0,4,13190.0,6,S
2018-04-17 21:02:28,13185.0,2,500,0,13185.0,2,13190.0,5,S
2018-04-17 21:02:29,13185.0,4,504,-4,13180.0,25,13190.0,7,S
2018-04-17 21:02:43,13185.0,2,506,0,13185.0,2,13190.0,18,S
2018-04-17 21:03:01,13190.0,22,528,22,13185.0,8,13190.0,4,B
2018-04-17 21:03:01,13190.0,8,536,6,13190.0,2,13195.0,4,B
2018-04-17 21:03:05,13190.0,10,546,6,13190.0,5,13195.0,4,B
2018-04-17 21:03:10,13190.0,8,554,-4,13185.0,5,13190.0,6,B
2018-04-17 21:03:11,13190.0,2,556,-2,13185.0,5,13190.0,5,B
2018-04-17 21:03:13,13190.0,2,558,0,13185.0,5,13190.0,4,B
2018-04-17 21:03:15,13190.0,2,560,0,13185.0,5,13190.0,3,B
2018-04-17 21:03:17,13190.0,2,562,-2,13185.0,5,13190.0,2,B
2018-04-17 21:03:19,13190.0,4,566,0,13190.0,3,13195.0,23,B
2018-04-17 21:03:31,13195.0,2,568,2,13190.0,23,13195.0,22,B
2018-04-17 21:03:32,13190.0,10,578,10,13190.0,18,13195.0,22,S
2018-04-17 21:03:32,13195.0,44,622,16,13195.0,8,13200.0,7,B
2018-04-17 21:03:33,13195.0,4,626,0,13195.0,6,13200.0,15,B
2018-04-17 21:03:34,13195.0,6,632,6,13195.0,3,13200.0,15,B
2018-04-17 21:03:41,13200.0,2,634,2,13195.0,5,13200.0,18,B
2018-04-17 21:03:43,13200.0,36,670,-20,13200.0,55,13205.0,15,B
2018-04-17 21:03:44,13200.0,4,674,0,13200.0,53,13205.0,20,B
2018-04-17 21:03:44,13200.0,4,678,0,13200.0,51,13205.0,22,B
2018-04-17 21:03:45,13205.0,2,680,-2,13200.0,51,13205.0,21,B
2018-04-17 21:03:49,13205.0,6,686,-2,13200.0,51,13210.0,13,B
2018-04-17 21:03:50,13205.0,2,688,0,13200.0,51,13210.0,25,B
2018-04-17 21:03:51,13205.0,2,690,2,13200.0,51,13210.0,25,B
2018-04-17 21:03:55,13205.0,2,692,0,13200.0,53,13210.0,29,B
2018-04-17 21:03:56,13210.0,10,702,0,13200.0,53,13210.0,24,B
2018-04-17 21:03:57,13205.0,4,706,-4,13200.0,53,13210.0,17,S
2018-04-17 21:04:04,13205.0,6,712,0,13200.0,54,13205.0,14,S
2018-04-17 21:04:05,13205.0,6,718,6,13200.0,54,13205.0,14,S
2018-04-17 21:04:07,13200.0,2,720,-2,13200.0,53,13205.0,19,S
2018-04-17 21:04:07,13200.0,2,722,0,13200.0,52,13205.0,20,S
2018-04-17 21:04:10,13200.0,2,724,0,13200.0,51,13205.0,20,S
2018-04-17 21:04:14,13205.0,2,726,0,13200.0,55,13205.0,17,B
2018-04-17 21:04:16,13205.0,4,730,0,13200.0,53,13205.0,15,B
2018-04-17 21:04:18,13200.0,4,734,-4,13200.0,51,13205.0,15,S
2018-04-17 21:04:23,13200.0,2,736,0,13200.0,50,13205.0,13,S
2018-04-17 21:04:29,13205.0,2,738,0,13200.0,48,13205.0,17,B
2018-04-17 21:04:38,13200.0,2,740,0,13200.0,51,13205.0,16,S
2018-04-17 21:04:39,13205.0,12,752,12,13200.0,52,13205.0,10,B
2018-04-17 21:04:40,13205.0,10,762,8,13200.0,52,13205.0,3,B
2018-04-17 21:04:40,13205.0,8,770,0,13205.0,1,13210.0,30,B
2018-04-17 21:04:44,13205.0,2,772,2,13205.0,10,13210.0,30,B
2018-04-17 21:04:46,13210.0,2,774,0,13205.0,10,13210.0,29,B
2018-04-17 21:04:49,13210.0,2,776,2,13205.0,10,13210.0,28,B
2018-04-17 21:04:51,13205.0,2,778,0,13205.0,9,13210.0,28,S
2018-04-17 21:04:52,13205.0,8,786,-4,13205.0,5,13210.0,28,S
2018-04-17 21:04:52,13205.0,10,796,-6,13200.0,48,13205.0,1,S
2018-04-17 21:05:03,13200.0,2,798,0,13200.0,49,13210.0,41,S
2018-04-17 21:05:06,13205.0,2,800,0,13200.0,50,13205.0,1,B
2018-04-17 21:05:13,13205.0,2,802,0,13200.0,49,13205.0,1,B
2018-04-17 21:05:20,13205.0,2,804,0,13205.0,19,13210.0,39,B
2018-04-17 21:05:26,13205.0,8,812,-8,13205.0,16,13210.0,41,B
2018-04-17 21:05:27,13205.0,10,822,0,13205.0,11,13210.0,41,B
2018-04-17 21:05:30,13205.0,2,824,0,13205.0,10,13210.0,41,B
2018-04-17 21:05:31,13205.0,4,828,0,13205.0,8,13210.0,45,B
2018-04-17 21:05:38,13210.0,66,894,-24,13210.0,26,13215.0,7,B
2018-04-17 21:05:38,13210.0,8,902,0,13210.0,22,13215.0,22,B
2018-04-17 21:05:39,13210.0,4,906,0,13210.0,20,13215.0,20,B
2018-04-17 21:05:41,13210.0,8,914,0,13210.0,17,13215.0,19,B
2018-04-17 21:05:42,13215.0,2,916,0,13210.0,17,13215.0,18,B
2018-04-17 21:05:44,13210.0,2,918,0,13210.0,16,13215.0,18,S
2018-04-17 21:05:57,13210.0,2,920,0,13210.0,15,13215.0,19,S
2018-04-17 21:06:04,13215.0,2,922,2,13210.0,18,13215.0,3,B
2018-04-17 21:06:06,13210.0,2,924,-2,13210.0,18,13215.0,3,S
2018-04-17 21:06:07,13215.0,8,932,6,13210.0,16,13215.0,16,B
2018-04-17 21:06:13,13215.0,28,960,-20,13210.0,2,13215.0,3,B
2018-04-17 21:06:14,13210.0,2,962,2,13210.0,1,13215.0,3,S
2018-04-17 21:06:21,13215.0,4,966,-2,13205.0,3,13215.0,2,B
2018-04-17 21:06:23,13210.0,2,968,0,13205.0,1,13215.0,21,S
2018-04-17 21:06:30,13210.0,2,970,2,13205.0,1,13210.0,4,S
2018-04-17 21:06:33,13205.0,2,972,0,13200.0,47,13205.0,1,S
2018-04-17 21:06:35,13205.0,2,974,0,13200.0,55,13210.0,4,S
2018-04-17 21:06:59,13200.0,4,978,-4,13200.0,45,13205.0,3,S
2018-04-17 21:07:02,13200.0,2,980,0,13200.0,44,13205.0,3,S
2018-04-17 21:07:09,13205.0,2,982,0,13200.0,44,13205.0,3,B
2018-04-17 21:07:10,13205.0,6,988,2,13200.0,44,13205.0,1,B
2018-04-17 21:07:19,13205.0,4,992,0,13205.0,11,13210.0,9,B
2018-04-17 21:07:21,13205.0,2,994,0,13205.0,4,13210.0,8,B
2018-04-17 21:07:22,13200.0,2,996,0,13200.0,52,13210.0,8,S
2018-04-17 21:07:28,13205.0,2,998,0,13205.0,9,13210.0,7,B
2018-04-17 21:07:34,13210.0,6,1004,0,13205.0,1,13210.0,6,B
2018-04-17 21:07:35,13210.0,2,1006,0,13205.0,1,13210.0,5,B
2018-04-17 21:07:35,13205.0,2,1008,2,13200.0,52,13205.0,7,S
2018-04-17 21:07:40,13205.0,8,1016,8,13200.0,53,13205.0,5,S
2018-04-17 21:07:48,13210.0,14,1030,4,13205.0,8,13210.0,1,B
2018-04-17 21:07:59,13205.0,2,1032,0,13205.0,8,13210.0,3,S
2018-04-17 21:08:03,13210.0,2,1034,0,13205.0,8,13210.0,5,B
2018-04-17 21:08:06,13210.0,2,1036,0,13205.0,8,13210.0,2,B
2018-04-17 21:08:06,13210.0,4,1040,2,13210.0,5,13215.0,9,B
2018-04-17 21:08:07,13210.0,2,1042,0,13210.0,4,13215.0,4,B
2018-04-17 21:08:13,13210.0,4,1046,-2,13210.0,14,13215.0,5,B
2018-04-17 21:08:16,13210.0,2,1048,0,13210.0,11,13215.0,16,B
2018-04-17 21:08:20,13210.0,8,1056,-8,13210.0,7,13215.0,16,B
2018-04-17 21:08:30,13215.0,8,1064,8,13210.0,10,13215.0,4,B
2018-04-17 21:08:31,13215.0,8,1072,-2,13210.0,10,13220.0,8,B
2018-04-17 21:08:32,13220.0,8,1080,-2,13215.0,1,13220.0,2,B
2018-04-17 21:08:37,13220.0,2,1082,2,13215.0,3,13220.0,2,B
2018-04-17 21:08:40,13215.0,2,1084,0,13215.0,3,13220.0,2,S
2018-04-17 21:08:40,13220.0,6,1090,2,13220.0,7,13225.0,7,B
2018-04-17 21:08:41,13220.0,14,1104,12,13220.0,1,13225.0,15,B
2018-04-17 21:08:41,13225.0,4,1108,0,13220.0,1,13225.0,11,B
2018-04-17 21:08:43,13225.0,2,1110,2,13220.0,1,13225.0,10,B
2018-04-17 21:08:44,13225.0,2,1112,2,13220.0,2,13230.0,9,B
2018-04-17 21:08:47,13225.0,4,1116,-4,13220.0,3,13225.0,1,B
2018-04-17 21:08:47,13225.0,2,1118,-2,13220.0,3,13225.0,1,B
2018-04-17 21:08:48,13220.0,6,1124,0,13215.0,1,13220.0,3,S
2018-04-17 21:08:51,13225.0,24,1148,-10,13225.0,27,13230.0,25,B
2018-04-17 21:08:52,13225.0,54,1202,-34,13215.0,1,13225.0,2,B
2018-04-17 21:08:55,13220.0,6,1208,-4,13215.0,12,13225.0,5,S
2018-04-17 21:08:56,13215.0,2,1210,2,13210.0,10,13225.0,18,S
2018-04-17 21:09:01,13220.0,2,1212,0,13210.0,21,13220.0,1,B
2018-04-17 21:09:03,13220.0,2,1214,-2,13210.0,21,13220.0,1,B
2018-04-17 21:09:07,13220.0,2,1216,-2,13220.0,3,13225.0,34,B
2018-04-17 21:09:09,13220.0,2,1218,0,13220.0,2,13225.0,17,B
2018-04-17 21:09:16,13220.0,2,1220,2,13220.0,4,13225.0,16,B
2018-04-17 21:09:21,13225.0,6,1226,0,13220.0,15,13225.0,13,B
2018-04-17 21:09:21,13225.0,10,1236,2,13220.0,15,13225.0,8,B
2018-04-17 21:09:25,13225.0,2,1238,2,13220.0,17,13225.0,7,B
2018-04-17 21:09:26,13225.0,14,1252,2,13225.0,11,13230.0,15,B
2018-04-17 21:09:28,13225.0,2,1254,0,13225.0,10,13230.0,8,B
2018-04-17 21:09:29,13230.0,2,1256,0,13225.0,10,13230.0,8,B
2018-04-17 21:09:30,13230.0,4,1260,0,13225.0,10,13230.0,6,B
2018-04-17 21:09:31,13230.0,12,1272,4,13230.0,7,13235.0,3,B
2018-04-17 21:09:32,13235.0,2,1274,2,13230.0,5,13240.0,4,B
2018-04-17 21:09:34,13235.0,2,1276,-2,13230.0,5,13240.0,10,B
2018-04-17 21:09:38,13230.0,2,1278,2,13225.0,8,13230.0,1,S
2018-04-17 21:09:40,13230.0,2,1280,0,13225.0,8,13235.0,6,S
2018-04-17 21:09:41,13235.0,2,1282,-2,13230.0,3,13235.0,6,B
2018-04-17 21:09:42,13230.0,2,1284,0,13225.0,8,13235.0,7,S
2018-04-17 21:09:45,13230.0,6,1290,-4,13220.0,8,13230.0,4,S
2018-04-17 21:09:50,13230.0,2,1292,2,13230.0,14,13235.0,8,S
2018-04-17 21:09:53,13230.0,4,1296,0,13230.0,12,13235.0,7,S
2018-04-17 21:09:55,13235.0,2,1298,2,13230.0,12,13235.0,6,B
2018-04-17 21:09:56,13230.0,4,1302,0,13230.0,11,13235.0,6,S
2018-04-17 21:10:00,13235.0,2,1304,0,13230.0,12,13235.0,6,B
2018-04-17 21:10:05,13235.0,12,1316,8,13235.0,3,13240.0,13,B
2018-04-17 21:10:06,13235.0,2,1318,2,13230.0,22,13240.0,11,B
2018-04-17 21:10:09,13240.0,2,1320,0,13235.0,1,13240.0,5,B
2018-04-17 21:10:09,13235.0,4,1324,2,13235.0,11,13240.0,4,S
2018-04-17 21:10:10,13235.0,2,1326,0,13235.0,12,13240.0,4,S
2018-04-17 21:10:11,13240.0,4,1330,0,13235.0,15,13240.0,2,B
2018-04-17 21:10:11,13240.0,4,1334,-2,13240.0,9,13245.0,4,B
2018-04-17 21:10:12,13240.0,2,1336,-2,13240.0,9,13245.0,2,B
2018-04-17 21:10:12,13245.0,2,1338,0,13240.0,8,13245.0,1,B
2018-04-17 21:10:13,13245.0,2,1340,2,13240.0,8,13250.0,8,B
2018-04-17 21:10:16,13240.0,16,1356,-6,13235.0,9,13245.0,2,S
2018-04-17 21:10:17,13240.0,2,1358,2,13235.0,3,13240.0,1,S
2018-04-17 21:10:17,13245.0,10,1368,2,13240.0,1,13245.0,14,B
2018-04-17 21:10:18,13240.0,2,1370,0,13235.0,4,13245.0,14,S
2018-04-17 21:10:21,13245.0,4,1374,4,13240.0,4,13245.0,9,B
2018-04-17 21:10:22,13240.0,2,1376,0,13240.0,3,13245.0,9,S
2018-04-17 21:10:23,13245.0,2,1378,2,13240.0,4,13245.0,9,B
2018-04-17 21:10:26,13240.0,2,1380,-2,13240.0,10,13245.0,11,S
2018-04-17 21:10:30,13240.0,6,1386,-4,13240.0,10,13245.0,12,S
2018-04-17 21:10:31,13240.0,14,1400,-6,13240.0,3,13245.0,16,S
2018-04-17 21:10:32,13245.0,4,1404,0,13240.0,3,13245.0,14,B
2018-04-17 21:10:32,13240.0,6,1410,-4,13235.0,4,13245.0,17,S
2018-04-17 21:10:33,13245.0,2,1412,2,13235.0,3,13245.0,16,B
2018-04-17 21:10:36,13240.0,2,1414,2,13235.0,3,13240.0,5,S
2018-04-17 21:10:39,13235.0,4,1418,2,13235.0,1,13240.0,2,S
2018-04-17 21:10:39,13235.0,2,1420,-2,13230.0,13,13240.0,2,S
2018-04-17 21:10:44,13240.0,2,1422,0,13235.0,1,13240.0,4,B
2018-04-17 21:10:45,13235.0,2,1424,0,13230.0,22,13240.0,5,S
2018-04-17 21:10:48,13235.0,2,1426,0,13230.0,14,13240.0,12,S
2018-04-17 21:10:49,13230.0,2,1428,2,13230.0,14,13240.0,15,S
2018-04-17 21:10:50,13230.0,2,1430,2,13230.0,13,13240.0,17,S
2018-04-17 21:10:52,13235.0,2,1432,2,13230.0,13,13240.0,15,B
2018-04-17 21:10:55,13235.0,2,1434,-2,13230.0,13,13235.0,7,B
2018-04-17 21:10:59,13230.0,2,1436,0,13230.0,12,13235.0,9,S
2018-04-17 21:11:00,13235.0,20,1456,-4,13230.0,13,13240.0,30,B
2018-04-17 21:11:04,13235.0,2,1458,0,13230.0,13,13235.0,4,B
2018-04-17 21:11:07,13230.0,2,1460,2,13230.0,12,13235.0,9,S
2018-04-17 21:11:12,13230.0,2,1462,2,13230.0,11,13235.0,10,S
2018-04-17 21:11:14,13230.0,2,1464,0,13230.0,10,13235.0,10,S
2018-04-17 21:11:24,13230.0,8,1472,6,13225.0,4,13230.0,1,S
2018-04-17 21:11:30,13230.0,2,1474,2,13225.0,14,13235.0,19,S
2018-04-17 21:11:30,13225.0,2,1476,-2,13225.0,13,13230.0,1,S
2018-04-17 21:11:33,13230.0,2,1478,0,13225.0,13,13235.0,20,B
2018-04-17 21:11:38,13235.0,2,1480,2,13230.0,13,13235.0,13,B
2018-04-17 21:11:49,13230.0,2,1482,0,13230.0,12,13235.0,15,S
2018-04-17 21:11:51,13230.0,10,1492,4,13230.0,7,13235.0,15,S
2018-04-17 21:11:54,13235.0,2,1494,0,13230.0,6,13235.0,14,B
2018-04-17 21:11:54,13230.0,2,1496,0,13230.0,5,13235.0,14,S
2018-04-17 21:11:58,13230.0,2,1498,0,13230.0,2,13235.0,15,S
2018-04-17 21:11:59,13230.0,2,1500,-2,13230.0,1,13235.0,15,S
2018-04-17 21:12:07,13235.0,2,1502,0,13230.0,1,13235.0,10,B
2018-04-17 21:12:09,13230.0,2,1504,2,13225.0,4,13230.0,5,S
2018-04-17 21:12:10,13230.0,2,1506,2,13225.0,9,13230.0,4,S
2018-04-17 21:12:13,13230.0,2,1508,0,13225.0,12,13230.0,3,S
2018-04-17 21:12:14,13230.0,2,1510,0,13225.0,12,13230.0,2,S
2018-04-17 21:12:14,13230.0,2,1512,0,13225.0,12,13230.0,1,S
2018-04-17 21:12:17,13225.0,2,1514,0,13225.0,11,13230.0,1,S
2018-04-17 21:12:19,13230.0,2,1516,0,13225.0,11,13235.0,9,B
2018-04-17 21:12:31,13225.0,4,1520,-2,13220.0,31,13230.0,4,S
2018-04-17 21:12:52,13220.0,2,1522,0,13220.0,29,13225.0,7,S
2018-04-17 21:12:56,13220.0,2,1524,2,13220.0,28,13225.0,6,S
2018-04-17 21:12:58,13225.0,2,1526,0,13220.0,28,13225.0,6,B
2018-04-17 21:13:02,13220.0,2,1528,2,13220.0,27,13225.0,6,S
2018-04-17 21:13:04,13220.0,2,1530,0,13220.0,26,13225.0,5,S
2018-04-17 21:13:13,13220.0,2,1532,2,13220.0,25,13225.0,5,S
2018-04-17 21:13:14,13220.0,2,1534,2,13220.0,24,13225.0,5,S
2018-04-17 21:13:27,13220.0,2,1536,0,13220.0,23,13225.0,29,S
2018-04-17 21:13:29,13220.0,2,1538,0,13220.0,22,13225.0,29,S
2018-04-17 21:13:35,13220.0,4,1542,0,13220.0,21,13225.0,29,S
2018-04-17 21:14:17,13225.0,2,1544,0,13220.0,27,13225.0,5,B
2018-04-17 21:14:17,13225.0,14,1558,14,13225.0,7,13230.0,6,B
2018-04-17 21:14:25,13230.0,2,1560,-2,13225.0,4,13230.0,4,B
2018-04-17 21:14:45,13225.0,2,1562,-2,13225.0,12,13230.0,5,S
2018-04-17 21:14:46,13225.0,2,1564,2,13225.0,11,13230.0,5,S
2018-04-17 21:14:59,13230.0,2,1566,-2,13225.0,10,13230.0,4,B
2018-04-17 21:15:00,13225.0,2,1568,2,13225.0,9,13230.0,5,S
2018-04-17 21:15:00,13230.0,2,1570,2,13225.0,9,13230.0,4,B
2018-04-17 21:15:06,13225.0,8,1578,-2,13225.0,6,13230.0,4,S
2018-04-17 21:15:07,13225.0,8,1586,-6,13225.0,5,13230.0,4,S
2018-04-17 21:15:12,13230.0,4,1590,4,13225.0,5,13230.0,3,B
2018-04-17 21:15:13,13230.0,2,1592,0,13225.0,5,13230.0,2,B
2018-04-17 21:15:19,13230.0,4,1596,4,13225.0,5,13235.0,12,B
2018-04-17 21:15:20,13225.0,6,1602,-2,13220.0,23,13230.0,13,S
2018-04-17 21:15:21,13230.0,2,1604,0,13220.0,24,13230.0,13,B
2018-04-17 21:15:23,13225.0,2,1606,2,13220.0,24,13225.0,3,S
2018-04-17 21:15:31,13225.0,2,1608,0,13220.0,26,13225.0,1,S
2018-04-17 21:15:32,13225.0,4,1612,2,13220.0,26,13230.0,13,S
2018-04-17 21:15:56,13225.0,2,1614,0,13225.0,2,13230.0,2,S
2018-04-17 21:16:07,13225.0,2,1616,-2,13225.0,1,13230.0,7,S
2018-04-17 21:16:10,13225.0,2,1618,-2,13225.0,3,13230.0,7,S
2018-04-17 21:16:10,13225.0,6,1624,-6,13220.0,24,13230.0,7,S
2018-04-17 21:16:16,13225.0,2,1626,-2,13220.0,27,13230.0,12,S
2018-04-17 21:16:17,13230.0,2,1628,-2,13220.0,27,13230.0,35,B
2018-04-17 21:16:22,13230.0,2,1630,2,13220.0,24,13230.0,23,B
2018-04-17 21:16:22,13230.0,2,1632,0,13220.0,24,13230.0,34,B
2018-04-17 21:16:41,13220.0,2,1634,0,13220.0,21,13225.0,16,S
2018-04-17 21:16:44,13225.0,2,1636,0,13220.0,21,13225.0,16,B
2018-04-17 21:17:00,13220.0,2,1638,2,13220.0,20,13225.0,16,S
2018-04-17 21:17:08,13220.0,2,1640,2,13220.0,19,13225.0,18,S
2018-04-17 21:17:09,13220.0,2,1642,0,13220.0,18,13225.0,18,S
2018-04-17 21:17:18,13220.0,2,1644,2,13220.0,17,13225.0,13,S
2018-04-17 21:17:19,13220.0,16,1660,16,13220.0,9,13225.0,13,S
2018-04-17 21:17:28,13220.0,8,1668,8,13220.0,5,13225.0,19,S
2018-04-17 21:17:30,13220.0,2,1670,0,13220.0,4,13225.0,19,S
2018-04-17 21:17:30,13220.0,8,1678,2,13215.0,10,13220.0,1,S
2018-04-17 21:17:51,13215.0,2,1680,0,13215.0,9,13220.0,1,S
2018-04-17 21:18:06,13220.0,8,1688,6,13215.0,11,13220.0,1,B
2018-04-17 21:18:07,13220.0,2,1690,0,13220.0,7,13225.0,13,B
2018-04-17 21:18:21,13220.0,2,1692,2,13220.0,4,13225.0,13,B
2018-04-17 21:18:40,13220.0,12,1704,-10,13215.0,13,13220.0,14,B
2018-04-17 21:18:40,13220.0,6,1710,-6,13215.0,15,13220.0,11,B
2018-04-17 21:18:41,13220.0,2,1712,-2,13215.0,15,13220.0,10,B
2018-04-17 21:19:03,13215.0,8,1720,0,13215.0,12,13220.0,12,S
2018-04-17 21:19:09,13215.0,12,1732,2,13215.0,6,13220.0,12,S
2018-04-17 21:19:23,13220.0,2,1734,-2,13215.0,8,13220.0,12,B
2018-04-17 21:19:36,13215.0,2,1736,0,13215.0,7,13220.0,12,S
2018-04-17 21:19:38,13215.0,10,1746,6,13210.0,2,13215.0,6,S
2018-04-17 21:19:48,13210.0,2,1748,-2,13210.0,3,13215.0,15,S
2018-04-17 21:20:01,13210.0,2,1750,0,13210.0,2,13215.0,15,S
2018-04-17 21:20:04,13210.0,2,1752,2,13210.0,1,13215.0,15,S
2018-04-17 21:20:05,13210.0,2,1754,0,13205.0,7,13210.0,2,S
2018-04-17 21:20:05,13210.0,2,1756,2,13205.0,7,13210.0,1,S
2018-04-17 21:20:30,13210.0,2,1758,-2,13210.0,6,13220.0,15,S
2018-04-17 21:20:40,13220.0,2,1760,-2,13210.0,7,13220.0,14,B
2018-04-17 21:20:53,13220.0,2,1762,2,13215.0,2,13220.0,2,B
2018-04-17 21:20:57,13220.0,2,1764,0,13215.0,1,13225.0,13,B
2018-04-17 21:21:00,13215.0,2,1766,-2,13210.0,11,13220.0,24,S
2018-04-17 21:21:56,13215.0,2,1768,0,13210.0,8,13215.0,1,S
2018-04-17 21:22:05,13215.0,2,1770,-2,13210.0,10,13215.0,1,S
2018-04-17 21:22:05,13215.0,2,1772,0,13215.0,4,13220.0,3,S
2018-04-17 21:22:55,13220.0,10,1782,6,13220.0,6,13225.0,34,B
2018-04-17 21:23:00,13220.0,2,1784,0,13220.0,5,13225.0,30,B
2018-04-17 21:23:01,13225.0,2,1786,0,13220.0,6,13225.0,29,B
2018-04-17 21:23:11,13220.0,2,1788,0,13220.0,6,13225.0,29,S
2018-04-17 21:23:27,13220.0,2,1790,2,13220.0,6,13225.0,29,S
2018-04-17 21:23:32,13220.0,6,1796,0,13220.0,3,13225.0,29,S
2018-04-17 21:23:32,13220.0,6,1802,4,13215.0,5,13220.0,22,S
2018-04-17 21:23:36,13220.0,4,1806,-2,13215.0,3,13220.0,11,S
2018-04-17 21:23:49,13220.0,10,1816,6,13220.0,5,13225.0,32,S
2018-04-17 21:23:49,13220.0,10,1826,6,13215.0,3,13220.0,1,S
2018-04-17 21:24:05,13215.0,2,1828,2,13215.0,2,13220.0,2,S
2018-04-17 21:24:34,13215.0,4,1832,4,13215.0,1,13220.0,1,S
2018-04-17 21:24:41,13220.0,2,1834,2,13215.0,1,13220.0,8,B
2018-04-17 21:24:52,13220.0,2,1836,0,13215.0,10,13225.0,19,B
2018-04-17 21:25:40,13225.0,2,1838,2,13220.0,8,13225.0,16,B
2018-04-17 21:25:40,13225.0,2,1840,0,13220.0,8,13225.0,15,B
2018-04-17 21:25:41,13225.0,2,1842,2,13220.0,8,13225.0,14,B
2018-04-17 21:25:42,13220.0,2,1844,0,13220.0,6,13225.0,14,S
2018-04-17 21:26:42,13225.0,2,1846,-2,13220.0,7,13225.0,13,B
2018-04-17 21:26:50,13220.0,2,1848,0,13220.0,6,13225.0,13,S
2018-04-17 21:26:51,13225.0,2,1850,-2,13220.0,6,13225.0,12,B
2018-04-17 21:26:56,13225.0,24,1874,4,13225.0,4,13230.0,11,B
2018-04-17 21:26:57,13230.0,2,1876,2,13225.0,7,13230.0,6,B
2018-04-17 21:26:57,13230.0,12,1888,8,13225.0,10,13235.0,14,B
2018-04-17 21:27:03,13235.0,16,1904,-10,13225.0,5,13235.0,29,B
2018-04-17 21:27:07,13235.0,2,1906,-2,13225.0,6,13235.0,28,B
2018-04-17 21:27:09,13235.0,2,1908,0,13225.0,6,13235.0,27,B
2018-04-17 21:27:21,13235.0,30,1938,14,13235.0,15,13240.0,17,B
2018-04-17 21:27:22,13235.0,30,1968,14,13230.0,1,13235.0,12,B
2018-04-17 21:27:28,13235.0,2,1970,0,13225.0,13,13235.0,2,B
2018-04-17 21:27:30,13235.0,4,1974,-2,13235.0,1,13240.0,21,B
2018-04-17 21:27:31,13235.0,2,1976,0,13230.0,1,13235.0,5,B
2018-04-17 21:27:32,13230.0,4,1980,2,13225.0,15,13230.0,8,S
2018-04-17 21:27:37,13230.0,2,1982,0,13225.0,14,13230.0,7,S
2018-04-17 21:27:42,13230.0,10,1992,10,13225.0,13,13230.0,2,S
2018-04-17 21:27:55,13230.0,2,1994,2,13225.0,7,13230.0,1,S
2018-04-17 21:27:57,13230.0,2,1996,0,13225.0,7,13235.0,7,S
2018-04-17 21:28:07,13225.0,2,1998,-2,13225.0,1,13230.0,6,S
2018-04-17 21:28:08,13225.0,2,2000,0,13220.0,5,13225.0,1,S
2018-04-17 21:28:10,13225.0,2,2002,-2,13220.0,9,13230.0,8,S
2018-04-17 21:28:24,13225.0,4,2006,4,13220.0,15,13225.0,4,S
2018-04-17 21:29:43,13225.0,2,2008,2,13220.0,16,13230.0,10,S
2018-04-17 21:29:58,13230.0,6,2014,0,13225.0,15,13230.0,7,B
2018-04-17 21:29:59,13230.0,6,2020,0,13225.0,17,13230.0,4,B
2018-04-17 21:29:59,13230.0,8,2028,-2,13230.0,4,13235.0,5,B
2018-04-17 21:30:58,13225.0,2,2030,-2,13225.0,1,13230.0,3,S
2018-04-17 21:31:07,13225.0,2,2032,-2,13220.0,20,13225.0,1,S
2018-04-17 21:31:15,13220.0,2,2034,0,13220.0,19,13225.0,1,S
2018-04-17 21:32:26,13225.0,4,2038,0,13225.0,19,13230.0,3,B
2018-04-17 21:32:38,13230.0,2,2040,0,13225.0,19,13230.0,4,B
2018-04-17 21:32:42,13225.0,2,2042,0,13225.0,18,13230.0,4,S
2018-04-17 21:33:02,13230.0,2,2044,0,13225.0,18,13230.0,1,B
2018-04-17 21:33:18,13230.0,2,2046,0,13225.0,18,13235.0,30,B
2018-04-17 21:33:43,13230.0,2,2048,2,13225.0,18,13235.0,20,B
2018-04-17 21:34:14,13235.0,2,2050,-2,13225.0,20,13235.0,18,B
2018-04-17 21:35:12,13235.0,6,2056,4,13235.0,1,13240.0,19,B
2018-04-17 21:35:13,13240.0,6,2062,-2,13235.0,3,13240.0,11,B
2018-04-17 21:35:17,13235.0,6,2068,-4,13230.0,12,13235.0,1,S
2018-04-17 21:35:25,13240.0,4,2072,0,13235.0,4,13240.0,8,B
2018-04-17 21:35:26,13240.0,16,2088,-4,13235.0,15,13245.0,9,B
2018-04-17 21:35:27,13245.0,18,2106,6,13245.0,5,13250.0,12,B
2018-04-17 21:35:27,13255.0,28,2134,18,13250.0,1,13255.0,4,B
2018-04-17 21:35:28,13270.0,26,2160,0,13255.0,14,13270.0,4,B
2018-04-17 21:35:28,13260.0,2,2162,-2,13255.0,30,13265.0,3,S
2018-04-17 21:35:29,13265.0,4,2166,2,13265.0,2,13270.0,4,B
2018-04-17 21:35:29,13265.0,4,2170,0,13255.0,2,13265.0,6,B
2018-04-17 21:35:30,13255.0,2,2172,0,13250.0,2,13255.0,11,S
2018-04-17 21:35:31,13250.0,2,2174,0,13245.0,6,13250.0,2,S
2018-04-17 21:35:31,13245.0,2,2176,-2,13245.0,3,13255.0,1,S
2018-04-17 21:35:38,13255.0,2,2178,0,13245.0,14,13255.0,3,B
2018-04-17 21:35:41,13250.0,2,2180,0,13245.0,14,13255.0,3,S
2018-04-17 21:35:46,13250.0,4,2184,0,13250.0,10,13255.0,3,S
2018-04-17 21:35:47,13250.0,2,2186,0,13250.0,9,13255.0,3,S
2018-04-17 21:35:49,13255.0,2,2188,0,13250.0,10,13255.0,2,B
2018-04-17 21:35:49,13250.0,2,2190,-2,13250.0,9,13255.0,6,S
2018-04-17 21:35:50,13250.0,6,2196,0,13250.0,6,13255.0,6,S
2018-04-17 21:35:50,13250.0,2,2198,0,13250.0,5,13255.0,5,S
2018-04-17 21:35:54,13250.0,4,2202,-4,13250.0,3,13255.0,5,S
2018-04-17 21:35:55,13250.0,2,2204,0,13250.0,2,13255.0,5,S
2018-04-17 21:35:55,13250.0,2,2206,-2,13250.0,1,13255.0,5,S
2018-04-17 21:35:56,13250.0,2,2208,0,13245.0,3,13250.0,2,S
2018-04-17 21:35:56,13245.0,4,2212,0,13240.0,7,13245.0,2,S
2018-04-17 21:36:02,13245.0,2,2214,2,13240.0,2,13245.0,6,S
2018-04-17 21:36:05,13240.0,4,2218,2,13235.0,2,13240.0,4,S
2018-04-17 21:36:07,13235.0,2,2220,2,13230.0,2,13235.0,6,S
2018-04-17 21:36:21,13235.0,2,2222,0,13235.0,14,13245.0,6,S
2018-04-17 21:36:26,13240.0,2,2224,0,13235.0,14,13245.0,6,B
2018-04-17 21:36:41,13245.0,2,2226,2,13235.0,15,13245.0,8,B
2018-04-17 21:36:52,13245.0,2,2228,0,13240.0,14,13245.0,1,B
2018-04-17 21:36:52,13245.0,2,2230,-2,13245.0,6,13250.0,4,B
2018-04-17 21:36:54,13250.0,4,2234,-2,13245.0,15,13250.0,1,B
2018-04-17 21:36:54,13250.0,2,2236,0,13245.0,15,13255.0,11,B
2018-04-17 21:37:03,13250.0,2,2238,0,13245.0,15,13250.0,9,B
2018-04-17 21:37:04,13250.0,20,2258,0,13250.0,9,13255.0,8,B
2018-04-17 21:37:05,13250.0,18,2276,-2,13245.0,7,13250.0,1,B
2018-04-17 21:37:12,13250.0,10,2286,-2,13245.0,5,13250.0,1,B
2018-04-17 21:37:14,13250.0,2,2288,-2,13245.0,4,13255.0,19,B
2018-04-17 21:37:18,13255.0,6,2294,4,13250.0,8,13255.0,4,B
2018-04-17 21:37:18,13255.0,8,2302,6,13255.0,4,13260.0,9,B
2018-04-17 21:37:20,13260.0,4,2306,-4,13255.0,8,13260.0,4,B
2018-04-17 21:37:21,13255.0,2,2308,-2,13255.0,7,13260.0,4,S
2018-04-17 21:37:22,13260.0,2,2310,0,13255.0,7,13260.0,3,B
2018-04-17 21:37:23,13260.0,2,2312,0,13255.0,7,13260.0,2,B
2018-04-17 21:37:25,13255.0,2,2314,0,13255.0,1,13260.0,5,S
2018-04-17 21:37:25,13255.0,2,2316,0,13250.0,6,13260.0,4,S
2018-04-17 21:37:26,13260.0,2,2318,2,13255.0,1,13260.0,3,B
2018-04-17 21:37:26,13260.0,2,2320,0,13255.0,1,13260.0,2,B
2018-04-17 21:37:37,13255.0,2,2322,0,13250.0,7,13260.0,4,S
2018-04-17 21:37:40,13260.0,2,2324,-2,13255.0,5,13260.0,3,B
2018-04-17 21:37:40,13260.0,2,2326,2,13255.0,5,13260.0,2,B
2018-04-17 21:37:41,13260.0,2,2328,0,13255.0,6,13260.0,1,B
2018-04-17 21:37:41,13260.0,2,2330,0,13255.0,7,13265.0,7,B
2018-04-17 21:37:42,13260.0,2,2332,2,13255.0,12,13265.0,4,B
2018-04-17 21:37:45,13255.0,4,2336,0,13255.0,5,13265.0,17,S
2018-04-17 21:37:50,13265.0,2,2338,-2,13255.0,9,13265.0,4,B
2018-04-17 21:37:53,13260.0,2,2340,0,13255.0,8,13265.0,4,S
2018-04-17 21:37:56,13265.0,2,2342,0,13260.0,7,13265.0,3,B
2018-04-17 21:37:56,13265.0,8,2350,6,13265.0,5,13270.0,11,B
2018-04-17 21:37:57,13265.0,2,2352,2,13265.0,2,13270.0,11,B
2018-04-17 21:37:59,13270.0,18,2370,16,13270.0,2,13275.0,4,B
2018-04-17 21:38:00,13275.0,6,2376,-2,13270.0,7,13275.0,1,B
2018-04-17 21:38:00,13270.0,4,2380,0,13270.0,12,13275.0,1,S
2018-04-17 21:38:01,13270.0,10,2390,-2,13270.0,7,13275.0,3,S
2018-04-17 21:38:01,13270.0,12,2402,4,13270.0,1,13275.0,4,S
2018-04-17 21:38:02,13275.0,12,2414,-4,13265.0,10,13275.0,5,B
2018-04-17 21:38:04,13265.0,2,2416,-2,13260.0,7,13270.0,1,S
2018-04-17 21:38:12,13270.0,10,2426,2,13265.0,1,13270.0,5,B
2018-04-17 21:38:17,13265.0,2,2428,2,13260.0,5,13270.0,11,S
2018-04-17 21:38:19,13265.0,6,2434,2,13265.0,2,13270.0,12,S
2018-04-17 21:38:20,13265.0,2,2436,0,13265.0,1,13270.0,3,S
2018-04-17 21:38:21,13265.0,4,2440,2,13260.0,5,13265.0,5,S
2018-04-17 21:38:28,13265.0,4,2444,0,13260.0,4,13265.0,1,S
2018-04-17 21:38:34,13265.0,2,2446,-2,13260.0,6,13270.0,4,S
2018-04-17 21:38:39,13265.0,2,2448,2,13260.0,6,13265.0,9,S
2018-04-17 21:38:49,13265.0,2,2450,0,13260.0,11,13265.0,9,S
2018-04-17 21:38:53,13260.0,2,2452,0,13260.0,11,13265.0,9,S
2018-04-17 21:38:54,13265.0,12,2464,8,13260.0,14,13265.0,3,B
2018-04-17 21:38:54,13265.0,6,2470,-2,13260.0,26,13270.0,7,B
2018-04-17 21:38:55,13270.0,4,2474,-2,13265.0,2,13270.0,4,B
2018-04-17 21:39:01,13265.0,8,2482,0,13260.0,19,13265.0,6,S
2018-04-17 21:39:01,13265.0,2,2484,-2,13260.0,21,13265.0,5,S
2018-04-17 21:39:04,13265.0,8,2492,-2,13260.0,21,13265.0,1,S
2018-04-17 21:39:05,13265.0,2,2494,-2,13260.0,21,13270.0,4,S
2018-04-17 21:39:11,13260.0,6,2500,2,13260.0,2,13265.0,2,S
2018-04-17 21:39:15,13260.0,2,2502,-2,13260.0,2,13265.0,2,S
2018-04-17 21:39:28,13265.0,4,2506,-2,13255.0,3,13265.0,12,B
2018-04-17 21:39:51,13255.0,2,2508,0,13250.0,24,13265.0,18,S
2018-04-17 21:40:07,13255.0,2,2510,-2,13250.0,24,13265.0,18,S
2018-04-17 21:40:14,13260.0,8,2518,-4,13250.0,24,13265.0,18,B
2018-04-17 21:40:18,13260.0,2,2520,2,13250.0,24,13265.0,18,B
2018-04-17 21:40:21,13265.0,4,2524,-2,13250.0,24,13265.0,18,B
2018-04-17 21:40:21,13265.0,8,2532,4,13250.0,24,13265.0,18,B
2018-04-17 21:40:22,13265.0,4,2536,4,13250.0,24,13265.0,18,B
2018-04-17 21:40:24,13260.0,6,2542,0,13250.0,24,13265.0,18,S
2018-04-17 21:40:35,13265.0,4,2546,4,13250.0,24,13265.0,18,B
2018-04-17 21:40:46,13265.0,14,2560,2,13250.0,24,13265.0,18,B
2018-04-17 21:40:46,13265.0,6,2566,6,13250.0,24,13265.0,18,B
2018-04-17 21:41:06,13265.0,2,2568,-2,13250.0,24,13265.0,18,B
2018-04-17 21:41:10,13270.0,2,2570,0,13265.0,12,13270.0,1,B
2018-04-17 21:41:10,13270.0,2,2572,0,13265.0,17,13275.0,10,B
2018-04-17 21:41:12,13275.0,2,2574,0,13270.0,9,13275.0,6,B
2018-04-17 21:41:16,13270.0,4,2578,4,13270.0,9,13275.0,7,S
2018-04-17 21:41:18,13275.0,14,2592,8,13275.0,7,13280.0,22,B
2018-04-17 21:41:19,13275.0,2,2594,0,13275.0,1,13280.0,21,B
2018-04-17 21:41:20,13275.0,2,2596,0,13270.0,8,13275.0,3,B
2018-04-17 21:41:20,13275.0,4,2600,0,13270.0,11,13275.0,1,B
2018-04-17 21:41:23,13275.0,4,2604,-4,13270.0,7,13275.0,7,B
2018-04-17 21:41:23,13275.0,2,2606,0,13270.0,5,13275.0,6,B
2018-04-17 21:41:25,13275.0,2,2608,-2,13270.0,5,13275.0,5,B
2018-04-17 21:41:26,13270.0,2,2610,0,13270.0,4,13275.0,5,S
2018-04-17 21:41:27,13270.0,8,2618,8,13265.0,13,13270.0,21,S
2018-04-17 21:41:29,13270.0,2,2620,2,13265.0,21,13270.0,20,S
2018-04-17 21:41:30,13270.0,10,2630,10,13265.0,21,13270.0,15,S
2018-04-17 21:41:37,13270.0,4,2634,0,13265.0,21,13270.0,13,S
2018-04-17 21:41:42,13270.0,2,2636,2,13265.0,24,13270.0,14,S
2018-04-17 21:41:44,13270.0,2,2638,2,13265.0,24,13270.0,14,S
2018-04-17 21:41:52,13270.0,28,2666,24,13265.0,24,13275.0,10,S
2018-04-17 21:41:53,13270.0,2,2668,2,13265.0,24,13275.0,15,S
2018-04-17 21:41:55,13270.0,4,2672,0,13270.0,2,13275.0,15,S
2018-04-17 21:41:56,13270.0,4,2676,4,13265.0,22,13275.0,15,S
2018-04-17 21:41:59,13275.0,8,2684,6,13275.0,14,13280.0,22,B
2018-04-17 21:42:02,13280.0,32,2716,8,13275.0,9,13280.0,4,B
2018-04-17 21:42:03,13285.0,14,2730,4,13280.0,2,13285.0,6,B
2018-04-17 21:42:03,13280.0,18,2748,6,13280.0,17,13290.0,9,S
2018-04-17 21:42:04,13290.0,2,2750,0,13285.0,3,13290.0,8,B
2018-04-17 21:42:04,13285.0,6,2756,2,13280.0,33,13285.0,4,S
2018-04-17 21:42:07,13285.0,2,2758,0,13280.0,2,13285.0,5,S
2018-04-17 21:42:09,13285.0,2,2760,-2,13280.0,30,13285.0,5,S
2018-04-17 21:42:10,13280.0,2,2762,0,13280.0,29,13285.0,3,S
2018-04-17 21:42:10,13280.0,2,2764,2,13280.0,32,13285.0,3,S
2018-04-17 21:42:14,13285.0,6,2770,0,13280.0,31,13285.0,3,B
2018-04-17 21:42:15,13280.0,2,2772,2,13280.0,30,13285.0,3,S
2018-04-17 21:42:16,13285.0,2,2774,0,13280.0,5,13285.0,3,B
2018-04-17 21:42:17,13285.0,4,2778,-2,13275.0,15,13285.0,2,B
2018-04-17 21:42:18,13285.0,16,2794,8,13285.0,2,13290.0,9,B
2018-04-17 21:42:19,13285.0,4,2798,4,13280.0,34,13285.0,3,B
2018-04-17 21:42:20,13285.0,6,2804,0,13280.0,39,13290.0,7,B
2018-04-17 21:42:20,13285.0,6,2810,4,13280.0,39,13285.0,18,B
2018-04-17 21:42:22,13285.0,14,2824,14,13280.0,36,13285.0,11,B
2018-04-17 21:42:23,13285.0,4,2828,4,13280.0,36,13285.0,9,B
2018-04-17 21:42:24,13285.0,2,2830,0,13280.0,36,13285.0,8,B
2018-04-17 21:42:24,13285.0,8,2838,6,13280.0,36,13285.0,4,B
2018-04-17 21:42:25,13285.0,8,2846,2,13285.0,17,13290.0,7,B
2018-04-17 21:42:25,13285.0,2,2848,0,13285.0,34,13290.0,7,B
2018-04-17 21:42:26,13285.0,2,2850,2,13285.0,38,13290.0,7,B
2018-04-17 21:42:26,13290.0,2,2852,0,13285.0,38,13290.0,6,B
2018-04-17 21:42:27,13290.0,4,2856,2,13285.0,37,13290.0,5,B
2018-04-17 21:42:27,13290.0,10,2866,0,13290.0,5,13295.0,67,B
2018-04-17 21:42:29,13290.0,6,2872,6,13290.0,22,13295.0,67,B
2018-04-17 21:42:30,13295.0,22,2894,22,13290.0,12,13295.0,66,B
2018-04-17 21:42:31,13290.0,10,2904,4,13285.0,16,13295.0,66,S
2018-04-17 21:42:31,13290.0,6,2910,0,13285.0,11,13290.0,2,S
2018-04-17 21:42:34,13285.0,12,2922,0,13285.0,8,13290.0,6,S
2018-04-17 21:42:36,13285.0,2,2924,0,13285.0,6,13290.0,4,S
2018-04-17 21:42:38,13285.0,2,2926,2,13285.0,5,13290.0,5,S
2018-04-17 21:42:42,13290.0,12,2938,0,13285.0,12,13290.0,1,B
2018-04-17 21:42:42,13290.0,2,2940,2,13290.0,2,13295.0,68,B
2018-04-17 21:42:43,13290.0,6,2946,4,13290.0,2,13295.0,66,B
2018-04-17 21:42:46,13295.0,2,2948,2,13290.0,3,13295.0,65,B
2018-04-17 21:42:47,13295.0,2,2950,2,13290.0,3,13295.0,64,B
2018-04-17 21:42:47,13290.0,6,2956,6,13285.0,15,13290.0,3,S
2018-04-17 21:42:50,13290.0,10,2966,6,13290.0,5,13295.0,66,S
2018-04-17 21:42:51,13290.0,6,2972,4,13290.0,2,13295.0,74,S
2018-04-17 21:42:52,13290.0,4,2976,0,13285.0,6,13290.0,8,S
2018-04-17 21:43:01,13290.0,4,2980,0,13285.0,16,13290.0,8,S
2018-04-17 21:43:04,13290.0,2,2982,0,13285.0,37,13290.0,7,S
2018-04-17 21:43:04,13290.0,2,2984,-2,13285.0,37,13290.0,6,S
2018-04-17 21:43:07,13290.0,2,2986,0,13285.0,37,13290.0,5,S
2018-04-17 21:43:09,13290.0,4,2990,0,13285.0,37,13290.0,3,S
2018-04-17 21:43:10,13290.0,2,2992,0,13285.0,39,13290.0,2,S
2018-04-17 21:43:19,13290.0,2,2994,0,13285.0,12,13290.0,7,S
2018-04-17 21:43:20,13290.0,2,2996,0,13285.0,12,13290.0,6,S
2018-04-17 21:43:21,13285.0,4,3000,4,13285.0,10,13290.0,6,S
2018-04-17 21:43:21,13285.0,20,3020,6,13280.0,23,13285.0,4,S
2018-04-17 21:43:24,13285.0,2,3022,2,13280.0,4,13285.0,3,S
2018-04-17 21:43:25,13285.0,4,3026,0,13280.0,39,13285.0,1,S
2018-04-17 21:43:25,13285.0,2,3028,0,13285.0,1,13290.0,3,S
2018-04-17 21:43:27,13280.0,2,3030,2,13280.0,21,13290.0,9,S
2018-04-17 21:43:29,13280.0,4,3034,0,13280.0,4,13290.0,9,S
2018-04-17 21:43:30,13290.0,4,3038,-2,13280.0,2,13290.0,9,B
2018-04-17 21:43:32,13280.0,6,3044,4,13275.0,23,13280.0,3,S
2018-04-17 21:43:32,13280.0,6,3050,2,13275.0,40,13290.0,9,S
2018-04-17 21:43:44,13280.0,8,3058,-2,13275.0,39,13285.0,4,S
2018-04-17 21:43:45,13280.0,2,3060,0,13275.0,39,13285.0,4,S
2018-04-17 21:43:49,13280.0,2,3062,0,13275.0,42,13280.0,3,S
2018-04-17 21:43:50,13275.0,2,3064,2,13275.0,41,13280.0,3,S
2018-04-17 21:43:51,13280.0,2,3066,0,13275.0,3,13280.0,2,B
2018-04-17 21:43:52,13275.0,2,3068,-2,13275.0,2,13280.0,2,S
2018-04-17 21:43:52,13275.0,2,3070,0,13275.0,1,13280.0,4,S
2018-04-17 21:43:54,13275.0,2,3072,0,13270.0,19,13280.0,5,S
2018-04-17 21:43:54,13280.0,2,3074,0,13275.0,2,13280.0,4,B
2018-04-17 21:43:58,13280.0,2,3076,0,13275.0,20,13280.0,4,B
2018-04-17 21:44:00,13295.0,74,3150,-56,13275.0,20,13295.0,49,B
2018-04-17 21:44:07,13285.0,2,3152,0,13280.0,7,13290.0,11,S
2018-04-17 21:44:10,13280.0,2,3154,2,13280.0,5,13285.0,7,S
2018-04-17 21:44:12,13285.0,2,3156,0,13280.0,6,13285.0,7,B
2018-04-17 21:44:13,13280.0,4,3160,-4,13280.0,4,13285.0,8,S
2018-04-17 21:44:17,13280.0,2,3162,2,13280.0,4,13285.0,8,S
2018-04-17 21:44:27,13280.0,4,3166,0,13280.0,5,13285.0,8,S
2018-04-17 21:44:27,13280.0,2,3168,0,13280.0,4,13285.0,8,S
2018-04-17 21:44:29,13285.0,4,3172,0,13280.0,4,13285.0,3,B
2018-04-17 21:44:38,13280.0,2,3174,0,13280.0,13,13285.0,3,S
2018-04-17 21:44:39,13280.0,14,3188,0,13280.0,6,13285.0,3,S
2018-04-17 21:44:39,13285.0,2,3190,0,13280.0,6,13285.0,2,B
2018-04-17 21:44:46,13280.0,2,3192,2,13280.0,5,13285.0,2,S
2018-04-17 21:44:52,13280.0,4,3196,4,13275.0,41,13285.0,10,S
2018-04-17 21:44:56,13280.0,2,3198,0,13275.0,31,13285.0,9,S
2018-04-17 21:45:02,13275.0,2,3200,0,13275.0,30,13285.0,9,S
2018-04-17 21:45:07,13275.0,2,3202,-2,13275.0,26,13280.0,11,S
2018-04-17 21:45:09,13280.0,8,3210,6,13275.0,31,13280.0,3,B
2018-04-17 21:45:13,13275.0,10,3220,0,13275.0,21,13280.0,5,S
2018-04-17 21:45:17,13275.0,2,3222,0,13275.0,20,13280.0,5,S
2018-04-17 21:45:17,13275.0,2,3224,-2,13275.0,19,13280.0,5,S
2018-04-17 21:45:18,13280.0,2,3226,2,13275.0,19,13280.0,4,B
2018-04-17 21:45:20,13275.0,4,3230,-2,13275.0,18,13280.0,2,S
2018-04-17 21:45:21,13280.0,4,3234,2,13280.0,1,13285.0,3,B
2018-04-17 21:45:23,13280.0,2,3236,2,13280.0,4,13285.0,2,B
2018-04-17 21:45:30,13280.0,2,3238,2,13280.0,3,13285.0,4,B
2018-04-17 21:45:30,13280.0,2,3240,2,13280.0,2,13285.0,5,B
2018-04-17 21:45:32,13280.0,4,3244,4,13275.0,19,13285.0,4,B
2018-04-17 21:45:41,13275.0,2,3246,0,13275.0,29,13285.0,5,S
2018-04-17 21:45:42,13275.0,2,3248,0,13280.0,1,13285.0,4,S
2018-04-17 21:45:47,13280.0,2,3250,0,13275.0,29,13285.0,6,B
2018-04-17 21:45:58,13275.0,2,3252,0,13275.0,27,13280.0,3,S
2018-04-17 21:46:03,13280.0,2,3254,-2,13275.0,27,13280.0,3,B
2018-04-17 21:46:04,13275.0,2,3256,-2,13275.0,26,13280.0,3,S
2018-04-17 21:46:05,13275.0,12,3268,-12,13275.0,20,13280.0,3,S
2018-04-17 21:46:10,13275.0,2,3270,-2,13275.0,8,13280.0,4,S
2018-04-17 21:46:15,13275.0,2,3272,-2,13275.0,18,13280.0,3,S
2018-04-17 21:46:16,13280.0,4,3276,0,13275.0,18,13280.0,1,B
2018-04-17 21:46:17,13280.0,2,3278,0,13280.0,1,13285.0,8,B
2018-04-17 21:46:18,13280.0,2,3280,0,13275.0,18,13285.0,8,B
2018-04-17 21:46:22,13280.0,2,3282,0,13280.0,5,13285.0,10,B
2018-04-17 21:46:26,13280.0,2,3284,2,13280.0,4,13285.0,10,B
2018-04-17 21:46:26,13280.0,4,3288,0,13280.0,2,13285.0,10,B
2018-04-17 21:46:27,13280.0,4,3292,4,13275.0,17,13280.0,1,B
2018-04-17 21:46:45,13275.0,2,3294,0,13275.0,7,13280.0,2,S
2018-04-17 21:47:05,13280.0,4,3298,-2,13275.0,9,13285.0,13,B
2018-04-17 21:47:07,13280.0,2,3300,-2,13275.0,20,13285.0,8,B
2018-04-17 21:47:17,13285.0,2,3302,0,13275.0,20,13285.0,8,B
2018-04-17 21:47:30,13275.0,2,3304,0,13275.0,19,13285.0,8,S
2018-04-17 21:47:30,13275.0,2,3306,2,13275.0,18,13285.0,8,S
2018-04-17 21:47:35,13285.0,12,3318,8,13275.0,18,13285.0,2,B
2018-04-17 21:47:41,13280.0,2,3320,0,13280.0,1,13285.0,2,S
2018-04-17 21:47:42,13280.0,2,3322,0,13275.0,18,13280.0,4,S
2018-04-17 21:47:43,13280.0,6,3328,4,13275.0,18,13280.0,1,S
2018-04-17 21:47:43,13280.0,2,3330,0,13275.0,18,13285.0,1,S
2018-04-17 21:47:48,13280.0,2,3332,0,13280.0,1,13285.0,1,S
2018-04-17 21:47:51,13280.0,2,3334,2,13280.0,1,13285.0,1,S
2018-04-17 21:48:05,13275.0,2,3336,0,13275.0,17,13285.0,2,S
2018-04-17 21:48:20,13280.0,2,3338,0,13275.0,16,13285.0,4,B
2018-04-17 21:48:22,13285.0,2,3340,0,13275.0,17,13285.0,6,B
2018-04-17 21:48:38,13280.0,2,3342,2,13280.0,1,13285.0,7,S
2018-04-17 21:48:39,13280.0,4,3346,4,13275.0,17,13285.0,5,S
2018-04-17 21:48:54,13285.0,4,3350,0,13275.0,17,13285.0,4,B
2018-04-17 21:48:58,13285.0,2,3352,-2,13280.0,1,13285.0,3,B
2018-04-17 21:49:08,13280.0,2,3354,0,13275.0,19,13285.0,5,S
2018-04-17 21:49:22,13280.0,6,3360,2,13275.0,11,13280.0,1,S
2018-04-17 21:49:25,13275.0,2,3362,-2,13275.0,10,13280.0,6,S
2018-04-17 21:49:30,13275.0,20,3382,4,13270.0,21,13275.0,5,S
2018-04-17 21:49:32,13270.0,4,3386,2,13270.0,1,13275.0,15,S
2018-04-17 21:49:32,13270.0,2,3388,0,13265.0,2,13270.0,4,S
2018-04-17 21:49:33,13270.0,2,3390,-2,13265.0,13,13270.0,3,S
2018-04-17 21:49:35,13265.0,16,3406,0,13260.0,16,13270.0,3,S
2018-04-17 21:49:37,13260.0,12,3418,-6,13255.0,19,13260.0,4,S
2018-04-17 21:49:37,13260.0,8,3426,-6,13260.0,3,13270.0,9,S
2018-04-17 21:49:39,13255.0,4,3430,0,13250.0,26,13255.0,3,S
2018-04-17 21:49:40,13255.0,2,3432,0,13250.0,24,13255.0,5,S
2018-04-17 21:49:44,13255.0,2,3434,-2,13250.0,10,13255.0,5,S
2018-04-17 21:49:47,13255.0,8,3442,0,13250.0,10,13255.0,2,S
2018-04-17 21:49:48,13255.0,4,3446,-4,13255.0,1,13260.0,4,S
2018-04-17 21:49:51,13255.0,4,3450,0,13255.0,3,13260.0,12,S
2018-04-17 21:49:52,13255.0,6,3456,-6,13250.0,13,13260.0,12,S
2018-04-17 21:49:55,13250.0,2,3458,0,13250.0,10,13255.0,17,S
2018-04-17 21:49:56,13250.0,2,3460,0,13250.0,9,13255.0,17,S
2018-04-17 21:49:56,13250.0,2,3462,0,13250.0,8,13255.0,17,S
2018-04-17 21:49:57,13250.0,2,3464,0,13250.0,7,13255.0,17,S
2018-04-17 21:49:58,13250.0,8,3472,-2,13250.0,3,13255.0,17,S
2018-04-17 21:49:58,13250.0,6,3478,-2,13245.0,13,13250.0,8,S
2018-04-17 21:50:00,13245.0,12,3490,-12,13245.0,5,13250.0,9,S
2018-04-17 21:50:02,13245.0,4,3494,-4,13245.0,3,13250.0,10,S
2018-04-17 21:50:05,13250.0,2,3496,0,13245.0,4,13250.0,4,B
2018-04-17 21:50:09,13250.0,2,3498,-2,13245.0,4,13255.0,18,B
2018-04-17 21:50:14,13245.0,2,3500,0,13245.0,2,13250.0,4,S
2018-04-17 21:50:14,13245.0,4,3504,-2,13240.0,4,13250.0,19,S
2018-04-17 21:50:16,13245.0,4,3508,2,13240.0,2,13245.0,1,S
2018-04-17 21:50:17,13240.0,2,3510,2,13240.0,1,13245.0,2,S
2018-04-17 21:50:18,13240.0,2,3512,0,13235.0,1,13245.0,3,S
2018-04-17 21:50:18,13240.0,2,3514,0,13235.0,1,13240.0,1,S
2018-04-17 21:50:19,13240.0,2,3516,-2,13230.0,5,13235.0,1,S
2018-04-17 21:50:20,13235.0,4,3520,-4,13230.0,4,13240.0,12,S
2018-04-17 21:50:22,13235.0,10,3530,-6,13235.0,2,13240.0,13,S
2018-04-17 21:50:22,13235.0,6,3536,-4,13235.0,2,13240.0,5,S
2018-04-17 21:50:27,13235.0,6,3542,0,13230.0,17,13235.0,2,S
2018-04-17 21:50:27,13235.0,4,3546,2,13230.0,21,13240.0,1,S
2018-04-17 21:50:34,13235.0,2,3548,0,13235.0,2,13240.0,2,S
2018-04-17 21:50:35,13235.0,2,3550,2,13230.0,21,13240.0,8,S
2018-04-17 21:50:38,13235.0,2,3552,-2,13230.0,18,13235.0,1,S
2018-04-17 21:50:41,13235.0,2,3554,-2,13230.0,16,13235.0,1,S
2018-04-17 21:50:46,13230.0,2,3556,0,13230.0,15,13235.0,2,S
2018-04-17 21:50:48,13230.0,2,3558,0,13230.0,14,13235.0,2,S
2018-04-17 21:50:50,13235.0,2,3560,0,13230.0,14,13235.0,7,B
2018-04-17 21:50:52,13230.0,2,3562,-2,13230.0,13,13235.0,16,S
2018-04-17 21:50:55,13235.0,2,3564,2,13230.0,13,13235.0,10,B
2018-04-17 21:50:56,13235.0,6,3570,6,13230.0,13,13235.0,8,B
2018-04-17 21:51:00,13230.0,2,3572,0,13230.0,12,13235.0,27,S
2018-04-17 21:51:01,13230.0,10,3582,-2,13230.0,7,13235.0,24,S
2018-04-17 21:51:04,13230.0,2,3584,0,13230.0,6,13235.0,29,S
2018-04-17 21:51:04,13230.0,12,3596,4,13225.0,6,13230.0,4,S
2018-04-17 21:51:05,13225.0,2,3598,0,13225.0,3,13230.0,6,S
2018-04-17 21:51:05,13225.0,4,3602,-4,13225.0,2,13230.0,1,S
2018-04-17 21:51:09,13230.0,2,3604,0,13230.0,2,13240.0,24,B
2018-04-17 21:51:13,13235.0,2,3606,-2,13230.0,3,13240.0,22,B
2018-04-17 21:51:14,13235.0,2,3608,-2,13230.0,7,13240.0,11,B
2018-04-17 21:51:15,13235.0,2,3610,0,13230.0,3,13235.0,3,B
2018-04-17 21:51:15,13240.0,4,3614,-4,13230.0,3,13235.0,1,B
2018-04-17 21:51:25,13235.0,6,3620,-2,13230.0,11,13235.0,6,S
2018-04-17 21:51:25,13235.0,12,3632,-6,13235.0,1,13240.0,5,S
2018-04-17 21:51:28,13240.0,6,3638,-6,13235.0,7,13245.0,10,B
2018-04-17 21:51:33,13240.0,2,3640,0,13235.0,8,13245.0,17,B
2018-04-17 21:51:38,13240.0,8,3648,2,13240.0,2,13245.0,26,B
2018-04-17 21:51:39,13240.0,4,3652,4,13235.0,7,13240.0,1,B
2018-04-17 21:51:39,13240.0,2,3654,0,13235.0,7,13245.0,26,B
2018-04-17 21:51:45,13240.0,2,3656,0,13240.0,1,13245.0,31,B
2018-04-17 21:51:54,13245.0,12,3668,-6,13240.0,3,13245.0,15,B
2018-04-17 21:52:13,13240.0,16,3684,2,13235.0,19,13240.0,26,S
2018-04-17 21:52:16,13240.0,2,3686,-2,13235.0,17,13240.0,20,S
2018-04-17 21:52:24,13235.0,2,3688,-2,13235.0,26,13240.0,18,S
2018-04-17 21:52:36,13235.0,2,3690,0,13235.0,25,13240.0,18,S
2018-04-17 21:52:36,13235.0,20,3710,-8,13235.0,15,13240.0,21,S
2018-04-17 21:52:37,13235.0,4,3714,0,13235.0,13,13240.0,21,S
2018-04-17 21:52:50,13235.0,2,3716,2,13235.0,13,13240.0,6,S
2018-04-17 21:52:54,13240.0,2,3718,-2,13235.0,13,13240.0,5,B
2018-04-17 21:53:05,13240.0,2,3720,-2,13235.0,12,13240.0,7,B
2018-04-17 21:53:13,13240.0,8,3728,-4,13235.0,17,13245.0,11,B
2018-04-17 21:53:23,13245.0,8,3736,0,13240.0,9,13245.0,2,B
2018-04-17 21:53:24,13245.0,4,3740,-2,13245.0,6,13250.0,9,B
2018-04-17 21:53:32,13250.0,4,3744,-2,13245.0,7,13250.0,2,B
2018-04-17 21:53:33,13250.0,4,3748,0,13245.0,8,13255.0,5,B
2018-04-17 21:53:43,13250.0,14,3762,6,13250.0,16,13255.0,17,B
2018-04-17 21:53:44,13250.0,24,3786,8,13250.0,4,13255.0,16,B
2018-04-17 21:53:44,13250.0,8,3794,8,13245.0,3,13250.0,2,B
2018-04-17 21:53:45,13250.0,2,3796,0,13245.0,1,13250.0,10,B
2018-04-17 21:53:48,13250.0,6,3802,6,13245.0,1,13250.0,8,B
2018-04-17 21:54:18,13250.0,6,3808,-2,13245.0,3,13250.0,7,B
2018-04-17 21:54:28,13250.0,2,3810,-2,13245.0,3,13250.0,10,B
2018-04-17 21:54:41,13245.0,6,3816,6,13240.0,8,13250.0,24,S
2018-04-17 21:55:25,13245.0,6,3822,-6,13240.0,18,13245.0,5,S
2018-04-17 21:55:25,13245.0,10,3832,-4,13245.0,6,13250.0,6,S
2018-04-17 21:55:50,13250.0,2,3834,0,13245.0,1,13250.0,4,B
2018-04-17 21:56:11,13250.0,2,3836,0,13245.0,4,13250.0,5,B
2018-04-17 21:56:14,13245.0,4,3840,-2,13245.0,2,13250.0,5,S
2018-04-17 21:56:20,13245.0,4,3844,0,13240.0,18,13250.0,6,S
2018-04-17 21:57:10,13250.0,10,3854,-6,13240.0,5,13250.0,12,B
2018-04-17 21:57:31,13250.0,4,3858,0,13240.0,6,13245.0,1,B
2018-04-17 21:57:40,13245.0,2,3860,-2,13245.0,3,13250.0,12,S
2018-04-17 21:58:21,13245.0,2,3862,-2,13245.0,4,13250.0,3,S
2018-04-17 21:58:27,13245.0,4,3866,0,13240.0,12,13250.0,9,S
2018-04-17 21:58:31,13245.0,2,3868,-2,13240.0,10,13250.0,9,S
2018-04-17 21:58:53,13240.0,2,3870,-2,13240.0,9,13245.0,21,S
2018-04-17 21:58:55,13240.0,2,3872,-2,13240.0,5,13245.0,10,S
2018-04-17 21:59:38,13245.0,2,3874,-2,13240.0,5,13245.0,4,B
2018-04-17 21:59:50,13245.0,8,3882,-8,13245.0,4,13250.0,7,B
2018-04-17 21:59:53,13245.0,2,3884,-2,13245.0,1,13250.0,6,B
2018-04-17 22:00:19,13245.0,2,3886,2,13240.0,9,13245.0,8,B
2018-04-17 22:00:52,13245.0,2,3888,0,13240.0,8,13245.0,7,B
2018-04-17 22:00:54,13245.0,6,3894,0,13240.0,10,13245.0,4,B
2018-04-17 22:01:01,13245.0,4,3898,0,13240.0,20,13250.0,7,B
2018-04-17 22:01:07,13250.0,4,3902,2,13245.0,3,13250.0,6,B
2018-04-17 22:01:25,13250.0,2,3904,-2,13245.0,4,13250.0,5,B
2018-04-17 22:01:41,13250.0,10,3914,6,13245.0,4,13255.0,21,B
2018-04-17 22:01:47,13250.0,2,3916,0,13245.0,4,13255.0,10,B
2018-04-17 22:01:57,13255.0,20,3936,-12,13245.0,5,13260.0,31,B
2018-04-17 22:02:20,13255.0,2,3938,0,13250.0,1,13255.0,10,B
2018-04-17 22:02:27,13250.0,2,3940,2,13245.0,5,13255.0,10,S
2018-04-17 22:03:11,13245.0,2,3942,2,13245.0,11,13255.0,10,S
2018-04-17 22:03:45,13245.0,2,3944,2,13245.0,1,13250.0,7,S
2018-04-17 22:03:49,13245.0,2,3946,2,13240.0,12,13250.0,7,S
2018-04-17 22:04:28,13240.0,2,3948,-2,13240.0,21,13245.0,9,S
2018-04-17 22:04:28,13240.0,8,3956,2,13240.0,17,13245.0,9,S
2018-04-17 22:04:43,13240.0,2,3958,-2,13240.0,15,13245.0,9,S
2018-04-17 22:05:20,13240.0,2,3960,-2,13240.0,7,13245.0,5,S
2018-04-17 22:05:22,13245.0,2,3962,0,13240.0,7,13245.0,4,B
2018-04-17 22:05:52,13245.0,4,3966,4,13240.0,2,13245.0,14,B
2018-04-17 22:06:01,13240.0,2,3968,-2,13240.0,1,13245.0,19,S
2018-04-17 22:06:01,13240.0,2,3970,-2,13240.0,1,13245.0,19,S
2018-04-17 22:06:18,13240.0,2,3972,0,13240.0,2,13245.0,19,S
2018-04-17 22:06:31,13240.0,2,3974,0,13240.0,2,13245.0,19,S
2018-04-17 22:06:32,13240.0,2,3976,-2,13240.0,1,13245.0,19,S
2018-04-17 22:06:44,13240.0,2,3978,-2,13235.0,9,13240.0,4,S
2018-04-17 22:06:48,13235.0,2,3980,2,13235.0,8,13240.0,3,S
2018-04-17 22:06:54,13235.0,2,3982,2,13235.0,7,13240.0,4,S
2018-04-17 22:07:00,13235.0,2,3984,-2,13235.0,3,13240.0,4,S
2018-04-17 22:07:01,13235.0,2,3986,2,13235.0,3,13240.0,4,S
2018-04-17 22:07:05,13235.0,2,3988,0,13235.0,2,13240.0,4,S
2018-04-17 22:07:08,13235.0,2,3990,2,13230.0,34,13240.0,4,S
2018-04-17 22:07:27,13240.0,2,3992,-2,13235.0,5,13240.0,3,B
2018-04-17 22:08:18,13235.0,2,3994,-2,13235.0,8,13245.0,38,S
2018-04-17 22:09:15,13235.0,2,3996,0,13235.0,7,13240.0,2,S
2018-04-17 22:09:40,13240.0,2,3998,0,13240.0,1,13245.0,20,B
2018-04-17 22:09:56,13240.0,2,4000,0,13240.0,1,13245.0,20,B
2018-04-17 22:10:19,13245.0,4,4004,0,13240.0,27,13245.0,18,B
2018-04-17 22:10:19,13245.0,18,4022,14,13240.0,39,13245.0,9,B
2018-04-17 22:10:20,13245.0,18,4040,6,13240.0,39,13250.0,9,B
2018-04-17 22:10:21,13245.0,2,4042,0,13245.0,1,13250.0,7,B
2018-04-17 22:10:36,13250.0,6,4048,-2,13245.0,2,13255.0,29,B
2018-04-17 22:10:55,13245.0,2,4050,0,13245.0,3,13250.0,4,S
2018-04-17 22:10:59,13250.0,2,4052,0,13250.0,1,13255.0,27,B
2018-04-17 22:11:06,13250.0,2,4054,2,13245.0,40,13255.0,8,B
2018-04-17 22:13:26,13250.0,10,4064,4,13245.0,40,13255.0,8,B
2018-04-17 22:14:12,13250.0,16,4080,-4,13250.0,2,13255.0,18,B
2018-04-17 22:14:12,13250.0,4,4084,-4,13245.0,4,13250.0,1,B
2018-04-17 22:16:23,13250.0,2,4086,0,13245.0,39,13250.0,1,B
2018-04-17 22:16:37,13250.0,2,4088,0,13245.0,3,13250.0,2,B
2018-04-17 22:18:08,13245.0,2,4090,0,13245.0,1,13250.0,3,S
2018-04-17 22:18:57,13245.0,2,4092,0,13240.0,7,13250.0,5,S
2018-04-17 22:18:59,13240.0,4,4096,0,13240.0,3,13245.0,4,S
2018-04-17 22:18:59,13240.0,2,4098,0,13240.0,2,13245.0,7,S
2018-04-17 22:19:06,13240.0,4,4102,0,13235.0,9,13245.0,9,S
2018-04-17 22:19:24,13235.0,2,4104,-2,13235.0,7,13240.0,3,S
2018-04-17 22:19:27,13235.0,2,4106,0,13235.0,6,13240.0,11,S
2018-04-17 22:19:27,13235.0,12,4118,0,13230.0,20,13235.0,10,S
2018-04-17 22:19:28,13230.0,4,4122,4,13230.0,16,13235.0,34,S
2018-04-17 22:19:28,13230.0,8,4130,0,13230.0,12,13235.0,28,S
2018-04-17 22:19:29,13230.0,8,4138,8,13230.0,8,13235.0,28,S
2018-04-17 22:19:29,13230.0,16,4154,8,13225.0,5,13235.0,28,S
2018-04-17 22:19:30,13225.0,8,4162,0,13220.0,26,13225.0,16,S
2018-04-17 22:19:30,13220.0,14,4176,-2,13220.0,17,13225.0,3,S
2018-04-17 22:19:31,13225.0,18,4194,14,13220.0,9,13225.0,10,B
2018-04-17 22:19:31,13215.0,28,4222,6,13210.0,4,13220.0,51,S
2018-04-17 22:19:32,13210.0,8,4230,0,13205.0,14,13210.0,10,S
2018-04-17 22:19:32,13210.0,14,4244,-6,13210.0,9,13215.0,4,S
2018-04-17 22:19:33,13215.0,8,4252,0,13215.0,4,13220.0,3,B
2018-04-17 22:19:34,13220.0,2,4254,0,13220.0,1,13225.0,10,B
2018-04-17 22:19:35,13225.0,2,4256,-2,13220.0,3,13225.0,1,B
2018-04-17 22:19:36,13220.0,2,4258,-2,13215.0,4,13220.0,2,S
2018-04-17 22:19:39,13220.0,2,4260,-2,13220.0,1,13225.0,20,S
2018-04-17 22:19:43,13220.0,8,4268,-8,13215.0,5,13220.0,26,S
2018-04-17 22:19:43,13220.0,2,4270,-2,13215.0,11,13220.0,25,S
2018-04-17 22:19:44,13220.0,4,4274,-4,13215.0,11,13220.0,23,S
2018-04-17 22:19:45,13220.0,4,4278,0,13215.0,23,13220.0,21,S
2018-04-17 22:19:45,13220.0,22,4300,-14,13215.0,18,13220.0,10,S
2018-04-17 22:19:46,13220.0,16,4316,0,13215.0,18,13220.0,2,S
2018-04-17 22:19:46,13220.0,2,4318,0,13215.0,18,13220.0,1,S
2018-04-17 22:19:47,13215.0,6,4324,-6,13210.0,19,13215.0,6,S
2018-04-17 22:19:48,13215.0,2,4326,0,13210.0,19,13215.0,5,S
2018-04-17 22:19:49,13215.0,2,4328,-2,13210.0,17,13215.0,5,S
2018-04-17 22:19:50,13210.0,4,4332,4,13205.0,32,13210.0,1,S
2018-04-17 22:19:54,13210.0,2,4334,0,13210.0,1,13215.0,8,S
2018-04-17 22:19:59,13210.0,2,4336,-2,13210.0,2,13215.0,5,S
2018-04-17 22:20:06,13215.0,2,4338,-2,13210.0,1,13215.0,8,B
2018-04-17 22:20:06,13215.0,2,4340,-2,13210.0,2,13215.0,4,B
2018-04-17 22:20:15,13215.0,2,4342,-2,13210.0,19,13215.0,2,B
2018-04-17 22:20:17,13215.0,2,4344,-2,13210.0,19,13215.0,1,B
2018-04-17 22:20:18,13215.0,2,4346,0,13215.0,4,13220.0,7,B
2018-04-17 22:20:23,13220.0,2,4348,-2,13215.0,5,13220.0,9,B
2018-04-17 22:20:28,13220.0,12,4360,2,13215.0,8,13225.0,10,B
2018-04-17 22:20:28,13220.0,2,4362,-2,13215.0,25,13220.0,1,B
2018-04-17 22:20:29,13220.0,2,4364,0,13215.0,25,13225.0,11,B
2018-04-17 22:21:38,13215.0,4,4368,-2,13215.0,7,13220.0,30,S
2018-04-17 22:21:38,13215.0,14,4382,-8,13210.0,13,13220.0,18,S
2018-04-17 22:21:44,13215.0,2,4384,-2,13210.0,39,13220.0,3,S
2018-04-17 22:21:48,13215.0,2,4386,2,13210.0,11,13215.0,2,S
2018-04-17 22:21:52,13210.0,2,4388,0,13210.0,7,13215.0,3,S
2018-04-17 22:22:02,13210.0,2,4390,0,13210.0,6,13215.0,3,S
2018-04-17 22:22:05,13210.0,6,4396,0,13210.0,25,13220.0,7,S
2018-04-17 22:22:19,13215.0,2,4398,-2,13210.0,6,13215.0,1,B
2018-04-17 22:22:49,13210.0,2,4400,0,13210.0,6,13215.0,4,S
2018-04-17 22:22:55,13210.0,4,4404,2,13210.0,4,13215.0,32,S
2018-04-17 22:22:56,13210.0,8,4412,2,13205.0,27,13210.0,1,S
2018-04-17 22:22:57,13205.0,6,4418,-4,13205.0,19,13210.0,23,S
2018-04-17 22:22:57,13205.0,26,4444,-20,13205.0,6,13210.0,26,S
2018-04-17 22:22:58,13205.0,2,4446,0,13205.0,5,13210.0,27,S
2018-04-17 22:23:01,13205.0,4,4450,0,13205.0,3,13210.0,22,S
2018-04-17 22:23:03,13210.0,2,4452,0,13205.0,3,13210.0,18,B
2018-04-17 22:23:15,13205.0,4,4456,-4,13205.0,1,13210.0,19,S
2018-04-17 22:23:17,13205.0,2,4458,0,13200.0,28,13210.0,19,S
2018-04-17 22:23:18,13200.0,2,4460,0,13200.0,27,13205.0,29,S
2018-04-17 22:23:19,13200.0,48,4508,-26,13195.0,9,13200.0,18,S
2018-04-17 22:23:19,13195.0,8,4516,6,13195.0,9,13200.0,18,S
2018-04-17 22:23:20,13200.0,2,4518,0,13195.0,10,13200.0,18,B
2018-04-17 22:23:24,13200.0,2,4520,-2,13195.0,20,13200.0,17,B
2018-04-17 22:23:25,13195.0,8,4528,-2,13195.0,9,13200.0,36,S
2018-04-17 22:23:26,13200.0,14,4542,-6,13195.0,5,13200.0,35,B
2018-04-17 22:23:27,13195.0,2,4544,0,13195.0,4,13200.0,35,S
2018-04-17 22:23:37,13200.0,4,4548,0,13195.0,15,13200.0,13,B
2018-04-17 22:23:42,13200.0,26,4574,-18,13195.0,12,13205.0,5,B
2018-04-17 22:23:49,13200.0,2,4576,2,13195.0,13,13205.0,21,B
2018-04-17 22:23:53,13195.0,4,4580,-2,13195.0,12,13200.0,1,S
2018-04-17 22:24:08,13195.0,18,4598,4,13190.0,21,13195.0,21,S
2018-04-17 22:24:08,13195.0,4,4602,4,13190.0,21,13195.0,20,S
2018-04-17 22:24:10,13190.0,2,4604,-2,13190.0,19,13195.0,20,S
2018-04-17 22:24:10,13195.0,10,4614,10,13190.0,19,13195.0,15,B
2018-04-17 22:24:16,13195.0,2,4616,2,13190.0,21,13195.0,14,B
2018-04-17 22:24:21,13190.0,4,4620,-2,13190.0,21,13195.0,13,S
2018-04-17 22:24:25,13190.0,10,4630,-8,13190.0,17,13195.0,13,S
2018-04-17 22:24:29,13195.0,8,4638,8,13190.0,15,13195.0,8,B
2018-04-17 22:24:30,13195.0,16,4654,6,13195.0,6,13200.0,12,B
2018-04-17 22:24:32,13195.0,2,4656,0,13195.0,2,13200.0,9,B
2018-04-17 22:24:34,13200.0,4,4660,0,13195.0,2,13200.0,7,B
2018-04-17 22:24:39,13200.0,2,4662,0,13195.0,2,13200.0,6,B
2018-04-17 22:24:45,13195.0,4,4666,0,13195.0,2,13200.0,6,S
2018-04-17 22:24:46,13200.0,10,4676,0,13195.0,11,13200.0,1,B
2018-04-17 22:24:47,13200.0,2,4678,-2,13200.0,1,13205.0,5,B
2018-04-17 22:24:52,13205.0,6,4684,4,13205.0,2,13210.0,8,B
2018-04-17 22:24:52,13205.0,4,4688,0,13205.0,1,13210.0,7,B
2018-04-17 22:24:53,13205.0,2,4690,0,13200.0,9,13205.0,3,B
2018-04-17 22:25:04,13205.0,4,4694,0,13200.0,9,13210.0,17,B
2018-04-17 22:25:07,13205.0,2,4696,0,13205.0,1,13210.0,3,B
2018-04-17 22:25:13,13210.0,6,4702,2,13200.0,6,13210.0,17,B
2018-04-17 22:25:13,13200.0,12,4714,-6,13195.0,28,13200.0,4,S
2018-04-17 22:25:14,13200.0,8,4722,-2,13195.0,30,13205.0,4,S
2018-04-17 22:25:37,13200.0,6,4728,-4,13195.0,5,13205.0,5,S
2018-04-17 22:25:43,13200.0,2,4730,-2,13195.0,3,13205.0,16,S
2018-04-17 22:26:00,13195.0,6,4736,0,13195.0,2,13200.0,5,S
2018-04-17 22:26:01,13195.0,4,4740,2,13190.0,15,13195.0,1,S
2018-04-17 22:26:07,13195.0,2,4742,-2,13190.0,13,13195.0,1,S
2018-04-17 22:26:28,13195.0,2,4744,-2,13190.0,15,13195.0,3,S
2018-04-17 22:26:31,13195.0,6,4750,4,13195.0,2,13200.0,17,S
2018-04-17 22:26:35,13195.0,2,4752,0,13195.0,1,13200.0,17,S
2018-04-17 22:26:36,13195.0,2,4754,2,13190.0,16,13200.0,17,S
2018-04-17 22:26:52,13200.0,6,4760,-4,13195.0,4,13205.0,7,B
2018-04-17 22:26:55,13195.0,6,4766,-2,13195.0,1,13205.0,17,S
2018-04-17 22:27:08,13195.0,2,4768,2,13195.0,7,13200.0,4,S
2018-04-17 22:27:16,13200.0,2,4770,0,13195.0,24,13200.0,3,B
2018-04-17 22:27:16,13200.0,6,4776,6,13200.0,2,13205.0,6,B
2018-04-17 22:27:32,13205.0,2,4778,2,13200.0,11,13205.0,1,B
2018-04-17 22:27:33,13205.0,2,4780,-2,13200.0,11,13210.0,8,B
2018-04-17 22:27:43,13205.0,2,4782,0,13200.0,8,13205.0,1,B
2018-04-17 22:27:46,13200.0,6,4788,0,13200.0,5,13205.0,1,S
2018-04-17 22:27:47,13205.0,2,4790,-2,13200.0,5,13205.0,1,B
2018-04-17 22:28:07,13205.0,6,4796,-4,13200.0,4,13205.0,1,B
2018-04-17 22:28:08,13205.0,2,4798,0,13200.0,4,13205.0,1,B
2018-04-17 22:28:12,13200.0,2,4800,-2,13200.0,3,13205.0,4,S
2018-04-17 22:28:12,13200.0,6,4806,0,13195.0,3,13205.0,28,S
2018-04-17 22:28:17,13205.0,4,4810,0,13195.0,4,13205.0,14,B
2018-04-17 22:28:22,13200.0,6,4816,2,13195.0,17,13200.0,17,S
2018-04-17 22:28:22,13200.0,18,4834,12,13195.0,32,13200.0,8,S
2018-04-17 22:28:23,13200.0,16,4850,16,13200.0,1,13205.0,2,S
2018-04-17 22:28:41,13200.0,2,4852,0,13200.0,1,13205.0,2,S
2018-04-17 22:28:47,13200.0,2,4854,-2,13200.0,1,13205.0,14,S
2018-04-17 22:28:48,13200.0,2,4856,2,13195.0,5,13205.0,15,S
2018-04-17 22:29:31,13200.0,20,4876,20,13195.0,5,13200.0,11,S
2018-04-17 22:29:48,13200.0,2,4878,0,13195.0,7,13200.0,10,S
2018-04-17 22:30:05,13200.0,2,4880,0,13195.0,5,13200.0,13,S
2018-04-17 22:30:17,13200.0,2,4882,2,13195.0,5,13200.0,12,S
2018-04-17 22:30:28,13200.0,4,4886,4,13195.0,10,13200.0,10,S
2018-04-17 22:30:30,13200.0,2,4888,2,13195.0,21,13200.0,9,S
2018-04-17 22:30:39,13200.0,2,4890,0,13195.0,9,13200.0,8,S
2018-04-17 22:30:53,13200.0,4,4894,0,13195.0,9,13200.0,6,S
2018-04-17 22:31:02,13200.0,12,4906,10,13200.0,4,13205.0,6,S
2018-04-17 22:31:17,13200.0,4,4910,2,13200.0,2,13205.0,12,S
2018-04-17 22:31:27,13200.0,8,4918,4,13195.0,11,13200.0,2,S
2018-04-17 22:31:32,13200.0,4,4922,4,13195.0,12,13205.0,13,S
2018-04-17 22:31:52,13195.0,2,4924,-2,13195.0,6,13200.0,14,S
2018-04-17 22:31:56,13195.0,2,4926,2,13195.0,5,13200.0,14,S
2018-04-17 22:32:09,13195.0,10,4936,4,13190.0,16,13195.0,5,S
2018-04-17 22:32:17,13195.0,2,4938,2,13190.0,21,13200.0,7,S
2018-04-17 22:32:43,13195.0,2,4940,2,13195.0,1,13200.0,8,S
2018-04-17 22:32:44,13195.0,2,4942,0,13190.0,34,13200.0,8,S
2018-04-17 22:33:19,13195.0,2,4944,2,13190.0,22,13200.0,14,S
2018-04-17 22:33:24,13195.0,2,4946,2,13195.0,1,13200.0,14,S
2018-04-17 22:33:40,13195.0,2,4948,0,13190.0,27,13200.0,9,S
2018-04-17 22:33:42,13190.0,2,4950,-2,13190.0,28,13200.0,9,S
2018-04-17 22:33:42,13190.0,2,4952,-2,13190.0,27,13200.0,9,S
2018-04-17 22:33:55,13195.0,2,4954,0,13195.0,5,13200.0,7,B
2018-04-17 22:33:56,13195.0,2,4956,2,13195.0,5,13200.0,7,B
2018-04-17 22:34:23,13200.0,2,4958,0,13195.0,5,13200.0,7,B
2018-04-17 22:34:29,13195.0,2,4960,0,13195.0,5,13200.0,5,S
2018-04-17 22:34:49,13200.0,6,4966,0,13195.0,25,13200.0,1,B
2018-04-17 22:34:49,13200.0,2,4968,-2,13195.0,25,13205.0,8,B
2018-04-17 22:34:58,13205.0,2,4970,-2,13195.0,14,13205.0,7,B
2018-04-17 22:35:06,13205.0,4,4974,-4,13200.0,1,13205.0,5,B
2018-04-17 22:35:13,13205.0,6,4980,0,13205.0,4,13210.0,7,B
2018-04-17 22:35:27,13210.0,4,4984,4,13205.0,2,13210.0,6,B
2018-04-17 22:35:56,13210.0,8,4992,6,13210.0,6,13215.0,7,B
2018-04-17 22:35:56,13210.0,4,4996,2,13210.0,5,13215.0,11,B
2018-04-17 22:35:58,13210.0,2,4998,0,13210.0,4,13215.0,15,B
2018-04-17 22:36:04,13210.0,10,5008,10,13205.0,4,13210.0,5,B
2018-04-17 22:36:21,13210.0,2,5010,2,13205.0,4,13210.0,6,B
2018-04-17 22:38:24,13210.0,2,5012,0,13205.0,22,13210.0,5,B
2018-04-17 22:38:46,13205.0,2,5014,-2,13205.0,5,13210.0,5,S
2018-04-17 22:39:13,13210.0,2,5016,2,13205.0,43,13210.0,4,B
2018-04-17 22:39:14,13210.0,8,5024,8,13205.0,43,13215.0,6,B
2018-04-17 22:40:42,13215.0,6,5030,0,13210.0,36,13220.0,7,B
2018-04-17 22:40:56,13220.0,2,5032,0,13210.0,35,13220.0,5,B
2018-04-17 22:40:56,13220.0,2,5034,0,13210.0,37,13220.0,4,B
2018-04-17 22:41:04,13220.0,8,5042,-4,13215.0,5,13220.0,4,B
2018-04-17 22:41:11,13215.0,2,5044,2,13215.0,4,13225.0,7,S
2018-04-17 22:41:19,13215.0,2,5046,0,13215.0,3,13225.0,9,S
2018-04-17 22:41:56,13220.0,6,5052,6,13215.0,27,13220.0,7,B
2018-04-17 22:41:56,13220.0,2,5054,2,13215.0,29,13220.0,6,B
2018-04-17 22:42:07,13220.0,2,5056,2,13215.0,28,13220.0,5,B
2018-04-17 22:42:12,13215.0,6,5062,6,13210.0,18,13215.0,8,S
2018-04-17 22:43:32,13215.0,2,5064,-2,13210.0,8,13220.0,10,S
2018-04-17 22:46:05,13220.0,4,5068,2,13215.0,2,13220.0,6,B
2018-04-17 22:46:45,13220.0,2,5070,2,13215.0,3,13220.0,6,B
2018-04-17 22:46:51,13220.0,2,5072,0,13215.0,4,13220.0,5,B
2018-04-17 22:47:21,13215.0,2,5074,0,13215.0,2,13220.0,6,S
2018-04-17 22:47:37,13215.0,2,5076,-2,13210.0,11,13215.0,1,S
2018-04-17 22:48:33,13210.0,16,5092,-2,13205.0,30,13215.0,5,S
2018-04-17 22:48:37,13210.0,2,5094,0,13205.0,5,13210.0,2,S
2018-04-17 22:48:49,13205.0,6,5100,2,13205.0,2,13210.0,6,S
2018-04-17 22:48:54,13205.0,6,5106,-6,13200.0,30,13205.0,3,S
2018-04-17 22:48:54,13205.0,6,5112,0,13200.0,40,13210.0,3,S
2018-04-17 22:49:01,13205.0,2,5114,2,13200.0,38,13210.0,4,S
2018-04-17 22:49:06,13205.0,2,5116,2,13200.0,38,13210.0,4,S
2018-04-17 22:49:12,13200.0,2,5118,-2,13200.0,3,13205.0,1,S
2018-04-17 22:49:14,13205.0,2,5120,0,13200.0,4,13205.0,1,B
2018-04-17 22:49:44,13205.0,2,5122,0,13205.0,2,13210.0,2,B
2018-04-17 22:50:21,13210.0,2,5124,0,13205.0,22,13210.0,1,B
2018-04-17 22:50:21,13210.0,2,5126,-2,13210.0,1,13215.0,9,B
2018-04-17 22:50:22,13210.0,2,5128,-2,13205.0,22,13215.0,9,B
2018-04-17 22:50:37,13210.0,2,5130,0,13210.0,7,13215.0,22,B
2018-04-17 22:50:50,13210.0,2,5132,2,13210.0,6,13215.0,4,B
2018-04-17 22:50:56,13215.0,8,5140,6,13215.0,2,13220.0,23,B
2018-04-17 22:51:05,13215.0,2,5142,2,13215.0,1,13220.0,15,B
2018-04-17 22:51:16,13215.0,2,5144,0,13210.0,7,13220.0,15,B
2018-04-17 22:51:23,13215.0,4,5148,-4,13210.0,12,13220.0,11,B
2018-04-17 22:51:39,13220.0,2,5150,0,13215.0,11,13220.0,6,B
2018-04-17 22:51:49,13215.0,2,5152,0,13215.0,9,13220.0,6,S
2018-04-17 22:52:10,13220.0,12,5164,-6,13220.0,1,13225.0,6,B
2018-04-17 22:52:48,13225.0,6,5170,0,13220.0,13,13230.0,9,B
2018-04-17 22:52:48,13230.0,4,5174,0,13220.0,13,13230.0,7,B
2018-04-17 22:52:56,13230.0,2,5176,-2,13220.0,13,13230.0,8,B
2018-04-17 22:53:04,13230.0,20,5196,14,13220.0,16,13230.0,1,B
2018-04-17 22:53:39,13220.0,10,5206,4,13215.0,5,13220.0,9,S
2018-04-17 22:53:53,13220.0,2,5208,-2,13215.0,3,13220.0,1,S
2018-04-17 22:53:54,13220.0,2,5210,0,13215.0,15,13225.0,3,S
2018-04-17 22:54:05,13225.0,8,5218,4,13225.0,2,13230.0,19,B
2018-04-17 22:54:05,13225.0,4,5222,0,13220.0,4,13225.0,2,B
2018-04-17 22:54:18,13220.0,4,5226,2,13215.0,5,13225.0,14,S
2018-04-17 22:54:30,13215.0,8,5234,-6,13215.0,13,13225.0,2,S
2018-04-17 22:54:44,13215.0,2,5236,-2,13210.0,15,13220.0,1,S
2018-04-17 22:54:46,13210.0,4,5240,-4,13210.0,12,13215.0,1,S
2018-04-17 22:54:58,13215.0,2,5242,-2,13210.0,12,13220.0,5,B
2018-04-17 22:55:22,13220.0,2,5244,0,13210.0,13,13220.0,4,B
2018-04-17 22:56:18,13215.0,2,5246,0,13215.0,1,13220.0,5,S
2018-04-17 22:56:44,13215.0,2,5248,2,13215.0,3,13220.0,5,S
2018-04-17 22:57:01,13215.0,2,5250,-2,13215.0,2,13220.0,6,S
2018-04-17 22:57:02,13225.0,18,5268,-12,13215.0,2,13225.0,13,B
2018-04-17 22:57:07,13215.0,2,5270,2,13215.0,3,13225.0,14,S
2018-04-17 22:57:22,13220.0,2,5272,0,13215.0,3,13220.0,2,B
2018-04-17 22:58:02,13220.0,2,5274,0,13215.0,5,13220.0,1,B
2018-04-17 22:58:04,13215.0,2,5276,0,13215.0,4,13220.0,3,S
2018-04-17 22:58:19,13220.0,2,5278,0,13215.0,2,13220.0,5,B
2018-04-17 22:58:38,13220.0,8,5286,8,13220.0,6,13225.0,17,B
2018-04-17 22:58:39,13220.0,8,5294,6,13220.0,4,13225.0,17,B
2018-04-17 22:58:39,13220.0,6,5300,4,13220.0,1,13225.0,17,B
2018-04-17 22:58:41,13220.0,2,5302,-2,13215.0,3,13225.0,5,B
2018-04-17 22:58:47,13215.0,6,5308,-4,13210.0,13,13215.0,2,S
2018-04-17 22:58:57,13215.0,2,5310,-2,13210.0,11,13215.0,1,S
2018-04-17 22:59:00,13210.0,2,5312,0,13210.0,10,13215.0,1,S
2018-04-17 22:59:05,13215.0,2,5314,-2,13210.0,5,13220.0,1,B
2018-04-17 22:59:11,13210.0,2,5316,-2,13210.0,5,13225.0,4,S
2018-04-17 22:59:21,13210.0,2,5318,-2,13210.0,4,13220.0,1,S
2018-04-17 22:59:40,13210.0,2,5320,-2,13210.0,3,13220.0,2,S
2018-04-17 22:59:42,13220.0,4,5324,-4,13205.0,22,13225.0,2,B
2018-04-17 22:59:54,13220.0,2,5326,0,13205.0,24,13225.0,2,B
2018-04-18 09:00:00,13250.0,36,5362,16,13245.0,5,13250.0,7,B
2018-04-18 09:00:01,13260.0,24,5386,2,13250.0,1,13260.0,12,B
2018-04-18 09:00:01,13260.0,12,5398,0,13250.0,1,13260.0,6,B
2018-04-18 09:00:02,13260.0,12,5410,6,13250.0,3,13265.0,3,B
2018-04-18 09:00:02,13265.0,2,5412,2,13260.0,1,13265.0,2,B
2018-04-18 09:00:03,13260.0,2,5414,0,13255.0,7,13260.0,2,S
2018-04-18 09:00:04,13255.0,2,5416,2,13255.0,6,13260.0,2,S
2018-04-18 09:00:04,13255.0,4,5420,0,13255.0,2,13260.0,1,S
2018-04-18 09:00:05,13255.0,4,5424,2,13250.0,4,13260.0,2,S
2018-04-18 09:00:05,13260.0,2,5426,2,13250.0,2,13260.0,1,B
2018-04-18 09:00:08,13250.0,2,5428,0,13250.0,1,13260.0,16,S
2018-04-18 09:00:10,13260.0,2,5430,-2,13250.0,4,13260.0,1,B
2018-04-18 09:00:15,13250.0,2,5432,0,13250.0,2,13255.0,5,S
2018-04-18 09:00:16,13260.0,2,5434,0,13250.0,4,13260.0,7,B
2018-04-18 09:00:19,13255.0,4,5438,0,13250.0,5,13255.0,3,S
2018-04-18 09:00:19,13255.0,6,5444,-6,13250.0,4,13260.0,2,S
2018-04-18 09:00:20,13255.0,4,5448,0,13255.0,11,13260.0,2,S
2018-04-18 09:00:22,13260.0,6,5454,0,13255.0,7,13260.0,2,B
2018-04-18 09:00:23,13255.0,2,5456,0,13255.0,7,13260.0,2,S
2018-04-18 09:00:29,13260.0,6,5462,2,13255.0,1,13260.0,13,B
2018-04-18 09:00:29,13255.0,2,5464,0,13250.0,3,13260.0,17,S
2018-04-18 09:00:32,13255.0,2,5466,0,13250.0,3,13255.0,14,S
2018-04-18 09:00:33,13250.0,6,5472,2,13245.0,2,13255.0,14,S
2018-04-18 09:00:36,13250.0,2,5474,0,13245.0,5,13255.0,3,S
2018-04-18 09:00:39,13245.0,2,5476,0,13245.0,4,13255.0,2,S
2018-04-18 09:00:40,13250.0,2,5478,0,13245.0,3,13255.0,1,B
2018-04-18 09:00:43,13250.0,4,5482,-2,13245.0,4,13250.0,8,B
2018-04-18 09:00:45,13250.0,2,5484,-2,13245.0,7,13250.0,7,B
2018-04-18 09:00:51,13250.0,2,5486,-2,13245.0,6,13250.0,6,B
2018-04-18 09:00:52,13250.0,2,5488,-2,13245.0,8,13250.0,5,B
2018-04-18 09:00:52,13250.0,2,5490,-2,13245.0,8,13250.0,4,B
2018-04-18 09:00:56,13250.0,2,5492,0,13245.0,11,13250.0,4,B
2018-04-18 09:00:57,13250.0,8,5500,2,13245.0,11,13250.0,1,B
2018-04-18 09:00:57,13250.0,2,5502,2,13245.0,11,13255.0,2,B
2018-04-18 09:01:00,13245.0,4,5506,0,13245.0,10,13250.0,2,S
2018-04-18 09:01:02,13245.0,10,5516,-2,13245.0,5,13250.0,3,S
2018-04-18 09:01:07,13250.0,2,5518,-2,13245.0,7,13250.0,2,B
2018-04-18 09:01:13,13245.0,2,5520,-2,13245.0,1,13250.0,3,S
2018-04-18 09:01:21,13245.0,2,5522,2,13240.0,13,13245.0,1,S
2018-04-18 09:01:21,13245.0,2,5524,0,13245.0,3,13250.0,3,S
2018-04-18 09:01:23,13250.0,6,5530,-2,13245.0,3,13250.0,1,B
2018-04-18 09:01:23,13250.0,2,5532,0,13245.0,3,13255.0,3,B
2018-04-18 09:01:24,13250.0,2,5534,0,13250.0,3,13255.0,7,B
2018-04-18 09:01:25,13250.0,4,5538,0,13250.0,1,13255.0,7,B
2018-04-18 09:01:27,13255.0,4,5542,2,13250.0,1,13255.0,4,B
2018-04-18 09:01:28,13255.0,8,5550,4,13255.0,6,13260.0,19,B
2018-04-18 09:01:29,13255.0,6,5556,2,13255.0,3,13260.0,8,B
2018-04-18 09:01:29,13255.0,6,5562,0,13250.0,2,13260.0,8,B
2018-04-18 09:01:32,13260.0,8,5570,2,13255.0,6,13260.0,3,B
2018-04-18 09:01:34,13260.0,6,5576,2,13260.0,27,13265.0,3,B
2018-04-18 09:01:34,13265.0,6,5582,0,13265.0,5,13270.0,23,B
2018-04-18 09:01:35,13270.0,46,5628,8,13265.0,4,13275.0,3,B
2018-04-18 09:01:36,13280.0,8,5636,-2,13270.0,18,13280.0,16,B
2018-04-18 09:01:36,13275.0,4,5640,0,13270.0,15,13280.0,16,S
2018-04-18 09:01:39,13275.0,4,5644,0,13270.0,14,13275.0,1,S
2018-04-18 09:01:39,13275.0,2,5646,2,13270.0,14,13275.0,1,S
2018-04-18 09:01:41,13270.0,2,5648,0,13270.0,13,13275.0,1,S
2018-04-18 09:01:41,13280.0,6,5654,2,13275.0,19,13280.0,15,B
2018-04-18 09:01:42,13275.0,4,5658,4,13275.0,17,13280.0,18,S
2018-04-18 09:01:43,13275.0,28,5686,28,13275.0,3,13280.0,18,S
2018-04-18 09:01:43,13270.0,8,5694,0,13265.0,4,13270.0,1,S
2018-04-18 09:01:44,13265.0,2,5696,2,13260.0,3,13265.0,3,S
2018-04-18 09:01:52,13275.0,2,5698,0,13265.0,15,13275.0,4,B
2018-04-18 09:01:53,13265.0,8,5706,2,13265.0,5,13270.0,1,S
2018-04-18 09:01:53,13270.0,2,5708,0,13265.0,3,13270.0,3,B
2018-04-18 09:01:54,13265.0,2,5710,0,13260.0,3,13265.0,4,S
2018-04-18 09:01:56,13265.0,6,5716,2,13260.0,1,13265.0,2,S
2018-04-18 09:01:57,13265.0,2,5718,0,13265.0,1,13270.0,4,S
2018-04-18 09:02:00,13260.0,2,5720,0,13260.0,10,13270.0,4,S
2018-04-18 09:02:02,13260.0,2,5722,0,13260.0,11,13270.0,2,S
2018-04-18 09:02:02,13270.0,4,5726,2,13270.0,13,13275.0,4,B
2018-04-18 09:02:03,13270.0,26,5752,20,13260.0,10,13270.0,9,B
2018-04-18 09:02:07,13260.0,4,5756,0,13260.0,3,13270.0,11,S
2018-04-18 09:02:08,13265.0,10,5766,6,13255.0,6,13265.0,14,B
2018-04-18 09:02:25,13250.0,2,5768,2,13250.0,8,13260.0,10,S
2018-04-18 09:02:26,13260.0,10,5778,6,13250.0,8,13260.0,5,B
2018-04-18 09:02:27,13260.0,8,5786,4,13260.0,9,13265.0,7,B
2018-04-18 09:02:35,13260.0,2,5788,2,13255.0,12,13265.0,6,B
2018-04-18 09:02:48,13255.0,8,5796,-6,13255.0,7,13260.0,6,S
2018-04-18 09:02:53,13255.0,2,5798,0,13255.0,7,13260.0,7,S
2018-04-18 09:02:55,13255.0,2,5800,0,13255.0,8,13260.0,7,S
2018-04-18 09:02:56,13255.0,16,5816,-4,13250.0,15,13255.0,2,S
2018-04-18 09:02:57,13255.0,4,5820,-4,13255.0,2,13260.0,1,S
2018-04-18 09:03:05,13260.0,6,5826,0,13260.0,3,13265.0,19,B
2018-04-18 09:03:10,13260.0,2,5828,0,13260.0,1,13265.0,19,B
2018-04-18 09:03:10,13260.0,2,5830,2,13255.0,22,13260.0,2,B
2018-04-18 09:03:23,13260.0,4,5834,0,13255.0,27,13260.0,1,B
2018-04-18 09:03:24,13260.0,2,5836,0,13260.0,2,13265.0,19,B
2018-04-18 09:03:32,13260.0,2,5838,0,13260.0,1,13265.0,19,B
2018-04-18 09:03:35,13265.0,16,5854,4,13260.0,28,13265.0,11,B
2018-04-18 09:03:35,13265.0,16,5870,-14,13260.0,28,13265.0,3,B
2018-04-18 09:03:36,13265.0,2,5872,0,13260.0,28,13265.0,2,B
2018-04-18 09:03:36,13265.0,2,5874,0,13260.0,28,13265.0,1,B
2018-04-18 09:03:43,13265.0,2,5876,0,13260.0,16,13270.0,13,B
2018-04-18 09:03:52,13270.0,2,5878,0,13265.0,2,13270.0,13,B
2018-04-18 09:03:54,13265.0,4,5882,0,13260.0,14,13265.0,2,S
2018-04-18 09:04:12,13260.0,2,5884,2,13260.0,15,13270.0,19,S
2018-04-18 09:04:20,13265.0,2,5886,-2,13260.0,13,13265.0,8,B
2018-04-18 09:04:22,13265.0,2,5888,0,13260.0,4,13265.0,7,B
2018-04-18 09:04:34,13260.0,2,5890,0,13255.0,11,13265.0,9,S
2018-04-18 09:04:39,13255.0,10,5900,-6,13250.0,3,13260.0,9,S
2018-04-18 09:04:46,13255.0,4,5904,-4,13250.0,21,13260.0,2,S
2018-04-18 09:04:50,13255.0,2,5906,2,13255.0,3,13260.0,5,S
2018-04-18 09:05:01,13260.0,18,5924,8,13260.0,16,13265.0,9,B
2018-04-18 09:05:02,13265.0,4,5928,2,13260.0,23,13265.0,1,B
2018-04-18 09:05:08,13260.0,6,5934,2,13260.0,22,13270.0,20,S
2018-04-18 09:05:10,13270.0,4,5938,2,13260.0,25,13270.0,22,B
2018-04-18 09:05:26,13260.0,10,5948,6,13260.0,13,13265.0,3,S
2018-04-18 09:05:27,13260.0,2,5950,0,13260.0,12,13265.0,6,S
2018-04-18 09:05:28,13260.0,4,5954,0,13260.0,10,13265.0,10,S
2018-04-18 09:05:30,13260.0,2,5956,0,13260.0,8,13265.0,4,S
2018-04-18 09:05:37,13260.0,4,5960,4,13260.0,6,13265.0,2,S
2018-04-18 09:05:52,13265.0,4,5964,0,13260.0,13,13270.0,20,B
2018-04-18 09:06:02,13265.0,4,5968,0,13265.0,10,13270.0,19,B
2018-04-18 09:06:04,13270.0,2,5970,2,13265.0,16,13270.0,19,B
2018-04-18 09:06:04,13270.0,6,5976,6,13265.0,16,13270.0,16,B
2018-04-18 09:06:05,13270.0,4,5980,4,13265.0,14,13270.0,14,B
2018-04-18 09:06:05,13270.0,4,5984,4,13265.0,14,13270.0,12,B
2018-04-18 09:06:08,13265.0,10,5994,-6,13260.0,9,13270.0,15,S
2018-04-18 09:06:17,13265.0,2,5996,-2,13260.0,10,13265.0,1,S
2018-04-18 09:06:18,13265.0,4,6000,2,13260.0,13,13270.0,13,S
2018-04-18 09:06:19,13265.0,2,6002,2,13260.0,12,13270.0,14,S
2018-04-18 09:06:22,13260.0,2,6004,2,13260.0,8,13265.0,10,S
2018-04-18 09:06:26,13260.0,10,6014,6,13260.0,4,13265.0,10,S
2018-04-18 09:06:29,13265.0,10,6024,10,13260.0,4,13265.0,5,B
2018-04-18 09:06:35,13265.0,10,6034,-4,13260.0,4,13270.0,19,B
2018-04-18 09:06:42,13260.0,2,6036,2,13260.0,3,13265.0,4,S
2018-04-18 09:06:44,13265.0,2,6038,-2,13260.0,4,13265.0,5,B
2018-04-18 09:06:50,13265.0,10,6048,0,13265.0,6,13270.0,14,B
2018-04-18 09:06:55,13265.0,2,6050,0,13265.0,25,13270.0,15,B
2018-04-18 09:07:01,13265.0,6,6056,0,13265.0,22,13270.0,20,B
2018-04-18 09:07:04,13265.0,2,6058,2,13265.0,21,13270.0,22,B
2018-04-18 09:07:08,13265.0,2,6060,2,13265.0,20,13270.0,22,B
2018-04-18 09:07:13,13265.0,36,6096,36,13265.0,2,13270.0,22,B
2018-04-18 09:07:14,13260.0,6,6102,4,13260.0,2,13265.0,8,S
2018-04-18 09:07:14,13260.0,4,6106,4,13255.0,2,13260.0,3,S
2018-04-18 09:07:24,13255.0,2,6108,0,13250.0,4,13255.0,1,S
2018-04-18 09:07:27,13255.0,4,6112,0,13250.0,4,13260.0,9,S
2018-04-18 09:07:28,13260.0,2,6114,0,13260.0,1,13265.0,8,B
2018-04-18 09:07:35,13255.0,2,6116,2,13250.0,6,13255.0,1,S
2018-04-18 09:07:36,13260.0,16,6132,6,13260.0,17,13265.0,12,B
2018-04-18 09:07:36,13260.0,8,6140,4,13260.0,13,13265.0,17,B
2018-04-18 09:07:37,13260.0,2,6142,2,13260.0,12,13265.0,16,B
2018-04-18 09:07:38,13260.0,24,6166,24,13250.0,9,13260.0,5,B
2018-04-18 09:07:38,13250.0,2,6168,0,13250.0,3,13255.0,4,S
2018-04-18 09:07:40,13255.0,2,6170,2,13250.0,3,13255.0,6,B
2018-04-18 09:07:41,13250.0,6,6176,2,13245.0,3,13250.0,6,S
2018-04-18 09:07:51,13255.0,6,6182,-4,13250.0,14,13255.0,1,B
2018-04-18 09:07:51,13255.0,2,6184,0,13250.0,20,13260.0,7,B
2018-04-18 09:07:59,13260.0,2,6186,0,13250.0,10,13260.0,15,B
2018-04-18 09:08:01,13260.0,2,6188,0,13250.0,10,13260.0,14,B
2018-04-18 09:08:02,13260.0,2,6190,0,13250.0,10,13260.0,13,B
2018-04-18 09:08:11,13250.0,2,6192,0,13250.0,9,13255.0,1,S
2018-04-18 09:08:16,13255.0,2,6194,-2,13250.0,15,13255.0,1,B
2018-04-18 09:08:17,13255.0,2,6196,2,13255.0,1,13260.0,5,B
2018-04-18 09:08:29,13255.0,4,6200,0,13255.0,4,13260.0,4,B
2018-04-18 09:08:34,13250.0,6,6206,0,13245.0,9,13260.0,19,S
2018-04-18 09:08:34,13250.0,2,6208,0,13245.0,12,13255.0,9,S
2018-04-18 09:08:41,13250.0,2,6210,2,13245.0,12,13255.0,9,S
2018-04-18 09:08:46,13250.0,2,6212,0,13255.0,1,13260.0,7,S
2018-04-18 09:08:48,13250.0,2,6214,-2,13250.0,12,13260.0,7,S
2018-04-18 09:08:52,13250.0,2,6216,2,13255.0,24,13260.0,28,S
2018-04-18 09:08:53,13255.0,8,6224,8,13255.0,20,13260.0,16,B
2018-04-18 09:08:53,13255.0,4,6228,4,13255.0,18,13260.0,16,B
2018-04-18 09:08:54,13255.0,4,6232,4,13255.0,16,13260.0,16,B
2018-04-18 09:08:56,13260.0,2,6234,0,13255.0,16,13260.0,16,B
2018-04-18 09:09:02,13260.0,20,6254,-4,13255.0,17,13265.0,10,B
2018-04-18 09:09:12,13255.0,2,6256,2,13255.0,16,13260.0,14,S
2018-04-18 09:09:17,13255.0,2,6258,2,13255.0,15,13260.0,18,S
2018-04-18 09:09:18,13255.0,4,6262,4,13255.0,13,13260.0,17,S
2018-04-18 09:09:24,13260.0,2,6264,0,13255.0,13,13260.0,8,B
2018-04-18 09:09:28,13260.0,4,6268,-2,13255.0,13,13260.0,7,B
2018-04-18 09:09:34,13255.0,2,6270,2,13255.0,12,13260.0,9,S
2018-04-18 09:09:39,13260.0,2,6272,2,13255.0,14,13260.0,9,B
2018-04-18 09:10:02,13255.0,28,6300,22,13250.0,3,13260.0,18,S
2018-04-18 09:10:29,13250.0,10,6310,6,13245.0,6,13250.0,5,S
2018-04-18 09:10:29,13250.0,6,6316,0,13245.0,10,13250.0,2,S
2018-04-18 09:10:34,13250.0,2,6318,0,13245.0,13,13250.0,1,S
2018-04-18 09:10:37,13250.0,2,6320,2,13245.0,12,13250.0,1,S
2018-04-18 09:10:42,13250.0,2,6322,-2,13245.0,12,13255.0,2,S
2018-04-18 09:10:47,13250.0,2,6324,0,13250.0,2,13255.0,3,S
2018-04-18 09:11:03,13245.0,10,6334,6,13245.0,3,13250.0,1,S
2018-04-18 09:11:04,13245.0,4,6338,0,13245.0,6,13250.0,3,S
2018-04-18 09:11:15,13255.0,2,6340,-2,13245.0,8,13255.0,6,B
2018-04-18 09:11:17,13245.0,2,6342,0,13245.0,7,13255.0,6,S
2018-04-18 09:11:22,13245.0,4,6346,-4,13250.0,2,13255.0,6,S
2018-04-18 09:11:23,13255.0,10,6356,-2,13255.0,18,13260.0,12,B
2018-04-18 09:11:33,13255.0,2,6358,2,13255.0,3,13260.0,9,B
2018-04-18 09:11:35,13260.0,18,6376,6,13260.0,1,13265.0,5,B
2018-04-18 09:11:36,13260.0,2,6378,2,13260.0,4,13265.0,4,B
2018-04-18 09:11:41,13265.0,2,6380,2,13255.0,5,13265.0,11,B
2018-04-18 09:11:46,13260.0,2,6382,2,13260.0,2,13265.0,4,S
2018-04-18 09:11:54,13265.0,4,6386,4,13260.0,1,13265.0,9,B
2018-04-18 09:12:06,13255.0,6,6392,4,13250.0,30,13260.0,3,S
2018-04-18 09:12:07,13255.0,2,6394,0,13255.0,8,13260.0,1,S
2018-04-18 09:12:08,13260.0,2,6396,-2,13255.0,9,13265.0,8,B
2018-04-18 09:12:25,13255.0,2,6398,2,13250.0,1,13255.0,5,S
2018-04-18 09:12:33,13260.0,10,6408,-2,13250.0,2,13260.0,6,B
2018-04-18 09:12:49,13260.0,2,6410,2,13255.0,10,13265.0,6,B
2018-04-18 09:13:06,13260.0,2,6412,-2,13250.0,6,13260.0,9,B
2018-04-18 09:13:07,13255.0,2,6414,0,13255.0,8,13260.0,1,S
2018-04-18 09:13:07,13255.0,2,6416,2,13255.0,7,13260.0,1,S
2018-04-18 09:13:08,13255.0,2,6418,2,13255.0,4,13260.0,1,S
2018-04-18 09:13:08,13255.0,2,6420,2,13255.0,3,13260.0,1,S
2018-04-18 09:13:09,13255.0,2,6422,2,13255.0,2,13260.0,1,S
2018-04-18 09:13:09,13255.0,2,6424,2,13255.0,1,13260.0,1,S
2018-04-18 09:13:10,13255.0,2,6426,2,13250.0,15,13260.0,1,S
2018-04-18 09:13:10,13255.0,2,6428,2,13255.0,4,13260.0,1,S
2018-04-18 09:13:11,13255.0,2,6430,2,13250.0,15,13260.0,1,S
2018-04-18 09:13:39,13260.0,2,6432,2,13260.0,1,13265.0,7,B
2018-04-18 09:13:46,13260.0,2,6434,0,13255.0,1,13265.0,9,B
2018-04-18 09:13:55,13260.0,2,6436,0,13255.0,9,13260.0,5,B
2018-04-18 09:13:55,13260.0,10,6446,-4,13255.0,10,13265.0,5,B
2018-04-18 09:13:57,13260.0,2,6448,0,13260.0,18,13265.0,3,B
2018-04-18 09:13:57,13260.0,2,6450,0,13260.0,17,13265.0,3,B
2018-04-18 09:13:58,13260.0,2,6452,0,13260.0,16,13265.0,3,B
2018-04-18 09:13:58,13260.0,2,6454,0,13260.0,15,13265.0,3,B
2018-04-18 09:14:18,13265.0,10,6464,-2,13265.0,10,13270.0,31,B
2018-04-18 09:14:18,13265.0,6,6470,-4,13265.0,7,13270.0,38,B
2018-04-18 09:14:19,13265.0,14,6484,-4,13265.0,1,13270.0,38,B
2018-04-18 09:14:19,13265.0,2,6486,0,13260.0,2,13265.0,1,B
2018-04-18 09:14:25,13270.0,4,6490,0,13260.0,5,13270.0,21,B
2018-04-18 09:14:28,13265.0,2,6492,0,13260.0,5,13270.0,21,S
2018-04-18 09:14:29,13265.0,4,6496,2,13260.0,5,13270.0,21,S
2018-04-18 09:14:49,13265.0,2,6498,0,13260.0,6,13270.0,25,S
2018-04-18 09:14:53,13265.0,2,6500,0,13260.0,6,13270.0,25,S
2018-04-18 09:15:19,13260.0,4,6504,-2,13260.0,4,13265.0,6,S
2018-04-18 09:15:46,13260.0,6,6510,0,13260.0,1,13265.0,12,S
2018-04-18 09:15:46,13260.0,2,6512,2,13255.0,5,13260.0,1,S
2018-04-18 09:16:01,13260.0,2,6514,2,13255.0,5,13260.0,1,S
2018-04-18 09:16:14,13255.0,2,6516,-2,13250.0,8,13260.0,21,S
2018-04-18 09:16:21,13255.0,2,6518,0,13255.0,1,13260.0,20,S
2018-04-18 09:16:56,13255.0,2,6520,-2,13250.0,10,13260.0,22,S
2018-04-18 09:17:22,13250.0,2,6522,0,13250.0,6,13255.0,7,S
2018-04-18 09:17:26,13250.0,2,6524,-2,13250.0,5,13255.0,7,S
2018-04-18 09:17:27,13250.0,2,6526,0,13250.0,4,13255.0,7,S
2018-04-18 09:17:32,13250.0,8,6534,-4,13245.0,7,13250.0,6,S
2018-04-18 09:17:33,13250.0,2,6536,-2,13245.0,13,13250.0,5,S
2018-04-18 09:17:34,13245.0,2,6538,-2,13245.0,12,13250.0,5,S
2018-04-18 09:17:35,13250.0,2,6540,-2,13245.0,12,13250.0,4,B
2018-04-18 09:17:42,13245.0,2,6542,-2,13245.0,2,13250.0,5,S
2018-04-18 09:17:42,13250.0,2,6544,-2,13245.0,3,13250.0,4,B
2018-04-18 09:17:49,13245.0,2,6546,0,13245.0,4,13250.0,3,S
2018-04-18 09:17:51,13245.0,6,6552,0,13240.0,9,13245.0,2,S
2018-04-18 09:17:52,13245.0,2,6554,2,13240.0,10,13245.0,1,S
2018-04-18 09:17:52,13245.0,2,6556,2,13240.0,9,13250.0,3,S
2018-04-18 09:18:04,13245.0,2,6558,0,13240.0,9,13245.0,1,S
2018-04-18 09:18:12,13245.0,2,6560,0,13245.0,4,13250.0,6,S
2018-04-18 09:18:43,13245.0,2,6562,2,13240.0,10,13250.0,13,S
2018-04-18 09:18:48,13240.0,2,6564,0,13240.0,3,13245.0,8,S
2018-04-18 09:18:49,13245.0,8,6572,6,13235.0,24,13245.0,24,B
2018-04-18 09:18:53,13240.0,8,6580,0,13240.0,2,13245.0,24,S
2018-04-18 09:18:54,13240.0,4,6584,-4,13235.0,22,13240.0,1,S
2018-04-18 09:19:02,13245.0,4,6588,2,13245.0,2,13250.0,15,B
2018-04-18 09:19:25,13245.0,4,6592,-2,13240.0,7,13250.0,14,B
2018-04-18 09:19:26,13245.0,2,6594,2,13240.0,3,13250.0,18,B
2018-04-18 09:19:57,13250.0,6,6600,-6,13240.0,10,13250.0,16,B
2018-04-18 09:19:59,13240.0,2,6602,0,13240.0,14,13250.0,16,S
2018-04-18 09:20:03,13245.0,6,6608,0,13240.0,14,13250.0,10,B
2018-04-18 09:20:17,13245.0,2,6610,0,13245.0,2,13250.0,10,B
2018-04-18 09:20:40,13250.0,2,6612,2,13245.0,5,13250.0,9,B
2018-04-18 09:20:43,13250.0,16,6628,-10,13250.0,1,13255.0,23,B
2018-04-18 09:20:50,13255.0,8,6636,-2,13250.0,10,13255.0,4,B
2018-04-18 09:20:50,13255.0,8,6644,0,13250.0,15,13260.0,9,B
2018-04-18 09:21:08,13260.0,4,6648,-2,13255.0,1,13260.0,7,B
2018-04-18 09:21:09,13260.0,2,6650,-2,13255.0,1,13260.0,6,B
2018-04-18 09:21:16,13260.0,12,6662,2,13260.0,4,13265.0,40,B
2018-04-18 09:21:19,13260.0,2,6664,2,13260.0,3,13265.0,43,B
2018-04-18 09:21:26,13260.0,2,6666,2,13260.0,6,13265.0,27,B
2018-04-18 09:21:26,13260.0,2,6668,0,13260.0,6,13265.0,24,B
2018-04-18 09:21:29,13265.0,2,6670,2,13260.0,6,13265.0,23,B
2018-04-18 09:21:29,13265.0,2,6672,2,13260.0,6,13265.0,22,B
2018-04-18 09:21:33,13260.0,2,6674,0,13255.0,2,13260.0,4,S
2018-04-18 09:21:35,13260.0,4,6678,0,13255.0,7,13260.0,2,S
2018-04-18 09:21:35,13260.0,2,6680,-2,13255.0,8,13260.0,1,S
2018-04-18 09:21:36,13260.0,2,6682,0,13260.0,12,13265.0,17,S
2018-04-18 09:21:45,13260.0,2,6684,2,13260.0,8,13265.0,17,S
2018-04-18 09:21:46,13265.0,4,6688,4,13260.0,8,13265.0,15,B
2018-04-18 09:21:48,13260.0,4,6692,2,13255.0,2,13260.0,3,S
2018-04-18 09:22:16,13255.0,2,6694,-2,13250.0,4,13260.0,14,S
2018-04-18 09:22:41,13255.0,2,6696,0,13250.0,26,13260.0,5,S
2018-04-18 09:23:09,13250.0,6,6702,2,13245.0,23,13255.0,7,S
2018-04-18 09:23:49,13250.0,4,6706,0,13250.0,2,13255.0,12,S
2018-04-18 09:25:02,13255.0,4,6710,2,13250.0,5,13255.0,8,B
2018-04-18 09:25:03,13255.0,4,6714,0,13250.0,27,13255.0,6,B
2018-04-18 09:25:03,13255.0,12,6726,-12,13250.0,27,13260.0,10,B
2018-04-18 09:25:09,13255.0,2,6728,2,13250.0,4,13255.0,2,B
2018-04-18 09:25:10,13255.0,4,6732,0,13250.0,4,13260.0,26,B
2018-04-18 09:25:14,13260.0,2,6734,-2,13250.0,5,13260.0,29,B
2018-04-18 09:26:18,13250.0,6,6740,4,13245.0,15,13255.0,13,S
2018-04-18 09:26:29,13250.0,2,6742,-2,13245.0,15,13255.0,9,S
2018-04-18 09:26:35,13250.0,2,6744,0,13245.0,15,13255.0,8,S
2018-04-18 09:26:55,13245.0,2,6746,-2,13245.0,9,13250.0,2,S
2018-04-18 09:27:00,13245.0,2,6748,-2,13245.0,6,13250.0,14,S
2018-04-18 09:27:01,13245.0,2,6750,0,13245.0,5,13250.0,14,S
2018-04-18 09:27:06,13245.0,2,6752,0,13245.0,4,13250.0,11,S
2018-04-18 09:27:31,13250.0,2,6754,0,13245.0,9,13250.0,10,B
2018-04-18 09:27:45,13245.0,20,6774,14,13245.0,3,13250.0,10,S
2018-04-18 09:27:54,13245.0,2,6776,0,13245.0,2,13250.0,8,S
2018-04-18 09:27:57,13245.0,2,6778,0,13245.0,1,13250.0,10,S
2018-04-18 09:27:57,13240.0,10,6788,-2,13240.0,8,13245.0,9,S
2018-04-18 09:27:58,13245.0,2,6790,0,13240.0,8,13250.0,9,B
2018-04-18 09:28:01,13245.0,2,6792,0,13240.0,8,13250.0,10,B
2018-04-18 09:28:02,13245.0,4,6796,4,13240.0,8,13245.0,1,B
2018-04-18 09:28:04,13240.0,2,6798,0,13240.0,7,13245.0,1,S
2018-04-18 09:28:07,13245.0,2,6800,0,13245.0,1,13250.0,7,B
2018-04-18 09:28:49,13250.0,4,6804,4,13250.0,10,13255.0,4,B
2018-04-18 09:28:49,13255.0,8,6812,-2,13255.0,1,13260.0,35,B
2018-04-18 09:28:51,13255.0,2,6814,2,13255.0,10,13260.0,33,B
2018-04-18 09:28:52,13255.0,14,6828,12,13250.0,15,13255.0,2,B
2018-04-18 09:29:01,13260.0,4,6832,-2,13255.0,5,13260.0,31,B
2018-04-18 09:29:02,13260.0,6,6838,-4,13255.0,19,13260.0,28,B
2018-04-18 09:29:02,13260.0,48,6886,-38,13255.0,19,13260.0,4,B
2018-04-18 09:29:03,13260.0,8,6894,-4,13260.0,2,13265.0,24,B
2018-04-18 09:29:07,13260.0,2,6896,0,13260.0,7,13265.0,21,B
2018-04-18 09:29:07,13260.0,14,6910,14,13255.0,18,13265.0,21,B
2018-04-18 09:29:18,13260.0,2,6912,0,13260.0,5,13265.0,21,B
2018-04-18 09:29:20,13265.0,8,6920,0,13260.0,5,13265.0,18,B
2018-04-18 09:29:21,13270.0,94,7014,-54,13265.0,9,13275.0,8,B
2018-04-18 09:29:22,13275.0,2,7016,0,13270.0,2,13275.0,7,B
2018-04-18 09:29:22,13275.0,4,7020,0,13270.0,5,13275.0,5,B
2018-04-18 09:29:28,13275.0,10,7030,-6,13275.0,6,13280.0,34,B
2018-04-18 09:29:31,13280.0,2,7032,0,13275.0,9,13280.0,33,B
2018-04-18 09:29:32,13280.0,8,7040,-6,13275.0,9,13280.0,29,B
2018-04-18 09:29:32,13275.0,2,7042,0,13275.0,8,13280.0,29,S
2018-04-18 09:29:33,13275.0,12,7054,-12,13270.0,3,13275.0,3,S
2018-04-18 09:29:38,13265.0,8,7062,0,13270.0,2,13275.0,4,S
2018-04-18 09:29:39,13270.0,2,7064,-2,13265.0,3,13270.0,1,B
2018-04-18 09:29:40,13270.0,2,7066,-2,13265.0,2,13270.0,15,B
2018-04-18 09:29:43,13270.0,2,7068,2,13265.0,3,13270.0,1,B
2018-04-18 09:29:51,13270.0,2,7070,2,13265.0,3,13270.0,1,B
2018-04-18 09:29:53,13270.0,2,7072,2,13265.0,3,13275.0,16,B
2018-04-18 09:30:06,13270.0,2,7074,0,13265.0,13,13270.0,10,B
2018-04-18 09:30:09,13265.0,6,7080,-2,13265.0,2,13270.0,5,S
2018-04-18 09:30:13,13270.0,2,7082,2,13270.0,1,13275.0,8,B
2018-04-18 09:30:16,13270.0,2,7084,0,13265.0,3,13270.0,2,B
2018-04-18 09:30:19,13270.0,4,7088,4,13265.0,2,13270.0,5,B
2018-04-18 09:30:20,13265.0,2,7090,2,13265.0,1,13270.0,5,S
2018-04-18 09:30:25,13265.0,2,7092,2,13260.0,2,13265.0,12,S
2018-04-18 09:30:36,13260.0,10,7102,10,13255.0,25,13265.0,6,S
2018-04-18 09:30:48,13255.0,2,7104,0,13250.0,10,13260.0,3,S
2018-04-18 09:30:56,13255.0,4,7108,-2,13250.0,9,13255.0,10,S
2018-04-18 09:30:58,13250.0,4,7112,0,13245.0,18,13255.0,7,S
2018-04-18 09:31:00,13245.0,2,7114,0,13245.0,18,13255.0,7,S
2018-04-18 09:31:03,13250.0,2,7116,-2,13245.0,16,13255.0,10,B
2018-04-18 09:31:06,13250.0,4,7120,-4,13250.0,1,13255.0,10,B
2018-04-18 09:31:07,13250.0,2,7122,0,13245.0,12,13250.0,1,B
2018-04-18 09:31:08,13250.0,2,7124,0,13245.0,20,13255.0,10,B
2018-04-18 09:31:15,13255.0,2,7126,0,13250.0,1,13255.0,13,B
2018-04-18 09:31:20,13255.0,10,7136,6,13250.0,10,13255.0,3,B
2018-04-18 09:31:21,13255.0,6,7142,0,13250.0,13,13260.0,4,B
2018-04-18 09:31:22,13255.0,2,7144,2,13255.0,2,13260.0,6,B
2018-04-18 09:31:41,13255.0,4,7148,0,13250.0,2,13255.0,1,B
2018-04-18 09:31:49,13255.0,2,7150,-2,13250.0,4,13260.0,12,B
2018-04-18 09:31:57,13255.0,2,7152,0,13255.0,1,13260.0,10,B
2018-04-18 09:32:10,13255.0,10,7162,2,13250.0,5,13260.0,19,B
2018-04-18 09:32:14,13255.0,2,7164,0,13250.0,10,13260.0,23,B
2018-04-18 09:32:16,13260.0,2,7166,2,13250.0,8,13260.0,22,B
2018-04-18 09:32:25,13255.0,4,7170,0,13255.0,4,13260.0,8,S
2018-04-18 09:32:55,13255.0,6,7176,0,13250.0,7,13260.0,9,S
2018-04-18 09:32:57,13255.0,2,7178,2,13250.0,14,13260.0,10,S
2018-04-18 09:33:00,13260.0,2,7180,2,13255.0,2,13260.0,9,B
2018-04-18 09:33:06,13260.0,4,7184,-4,13255.0,2,13260.0,7,B
2018-04-18 09:33:07,13260.0,2,7186,-2,13255.0,2,13260.0,6,B
2018-04-18 09:33:24,13255.0,2,7188,0,13255.0,2,13260.0,6,S
2018-04-18 09:33:25,13255.0,4,7192,2,13250.0,7,13255.0,12,S
2018-04-18 09:33:25,13250.0,8,7200,4,13250.0,1,13255.0,5,S
2018-04-18 09:33:26,13250.0,2,7202,0,13245.0,18,13250.0,3,S
2018-04-18 09:33:27,13250.0,2,7204,-2,13245.0,25,13255.0,12,S
2018-04-18 09:33:35,13255.0,4,7208,4,13250.0,1,13255.0,2,B
2018-04-18 09:33:58,13250.0,2,7210,0,13245.0,21,13255.0,24,S
2018-04-18 09:34:10,13245.0,34,7244,20,13245.0,3,13250.0,25,S
2018-04-18 09:34:11,13245.0,6,7250,0,13240.0,7,13245.0,3,S
2018-04-18 09:34:27,13240.0,8,7258,-8,13235.0,13,13240.0,6,S
2018-04-18 09:34:27,13240.0,2,7260,0,13235.0,21,13240.0,5,S
2018-04-18 09:34:28,13240.0,8,7268,-6,13235.0,19,13240.0,1,S
2018-04-18 09:34:28,13240.0,2,7270,-2,13240.0,4,13245.0,2,S
2018-04-18 09:34:39,13245.0,2,7272,0,13240.0,5,13245.0,2,B
2018-04-18 09:34:40,13240.0,10,7282,4,13235.0,15,13240.0,45,S
2018-04-18 09:34:44,13235.0,2,7284,0,13235.0,23,13240.0,47,S
2018-04-18 09:34:45,13240.0,84,7368,58,13235.0,31,13240.0,6,B
2018-04-18 09:34:45,13240.0,12,7380,6,13240.0,3,13245.0,6,B
2018-04-18 09:34:50,13245.0,2,7382,0,13240.0,11,13250.0,10,B
2018-04-18 09:34:51,13245.0,2,7384,0,13240.0,11,13250.0,10,B
2018-04-18 09:34:58,13245.0,4,7388,0,13240.0,19,13250.0,12,B
2018-04-18 09:35:12,13240.0,4,7392,2,13235.0,28,13245.0,7,S
2018-04-18 09:35:28,13245.0,12,7404,12,13240.0,4,13250.0,11,B
2018-04-18 09:35:41,13240.0,2,7406,-2,13235.0,25,13240.0,3,S
2018-04-18 09:35:42,13240.0,8,7414,0,13240.0,1,13245.0,8,S
2018-04-18 09:35:42,13240.0,2,7416,2,13235.0,9,13240.0,5,S
2018-04-18 09:35:53,13245.0,2,7418,0,13240.0,8,13250.0,11,B
2018-04-18 09:36:05,13240.0,12,7430,-2,13235.0,21,13240.0,1,S
2018-04-18 09:36:05,13240.0,2,7432,0,13235.0,25,13245.0,8,S
2018-04-18 09:36:21,13245.0,2,7434,0,13240.0,15,13250.0,20,B
2018-04-18 09:36:30,13245.0,2,7436,-2,13240.0,8,13245.0,5,B
2018-04-18 09:36:36,13245.0,2,7438,2,13245.0,4,13250.0,17,B
2018-04-18 09:36:37,13245.0,8,7446,8,13240.0,8,13245.0,1,B
2018-04-18 09:36:37,13245.0,2,7448,-2,13240.0,8,13250.0,21,B
2018-04-18 09:36:47,13240.0,2,7450,-2,13240.0,12,13245.0,4,S
2018-04-18 09:36:53,13240.0,2,7452,2,13240.0,11,13245.0,4,S
2018-04-18 09:36:55,13240.0,22,7474,-6,13235.0,20,13245.0,8,S
2018-04-18 09:37:01,13240.0,2,7476,2,13235.0,15,13245.0,11,S
2018-04-18 09:37:09,13240.0,2,7478,2,13235.0,15,13245.0,14,S
2018-04-18 09:37:35,13245.0,4,7482,2,13240.0,1,13245.0,11,B
2018-04-18 09:38:26,13240.0,2,7484,2,13240.0,6,13245.0,9,S
2018-04-18 09:38:47,13240.0,2,7486,-2,13240.0,5,13245.0,13,S
2018-04-18 09:39:52,13240.0,2,7488,-2,13240.0,7,13245.0,10,S
2018-04-18 09:39:57,13240.0,4,7492,2,13240.0,5,13245.0,13,S
2018-04-18 09:40:11,13240.0,10,7502,10,13235.0,15,13240.0,7,S
2018-04-18 09:40:19,13235.0,2,7504,0,13235.0,14,13240.0,10,S
2018-04-18 09:40:19,13240.0,2,7506,0,13235.0,14,13240.0,9,B
2018-04-18 09:40:20,13235.0,2,7508,0,13235.0,13,13240.0,9,S
2018-04-18 09:40:21,13235.0,2,7510,-2,13235.0,12,13240.0,10,S
2018-04-18 09:40:23,13235.0,2,7512,0,13235.0,11,13240.0,8,S
2018-04-18 09:40:23,13235.0,10,7522,-2,13235.0,6,13240.0,15,S
2018-04-18 09:40:24,13235.0,12,7534,8,13230.0,8,13235.0,14,S
2018-04-18 09:40:24,13230.0,8,7542,0,13230.0,3,13235.0,24,S
2018-04-18 09:40:25,13230.0,6,7548,2,13225.0,2,13230.0,3,S
2018-04-18 09:40:27,13230.0,4,7552,-4,13225.0,6,13230.0,1,S
2018-04-18 09:40:33,13230.0,2,7554,-2,13225.0,4,13230.0,5,S
2018-04-18 09:40:38,13225.0,2,7556,0,13225.0,1,13230.0,16,S
2018-04-18 09:40:41,13225.0,4,7560,0,13220.0,7,13225.0,1,S
2018-04-18 09:40:41,13225.0,2,7562,-2,13220.0,11,13230.0,7,S
2018-04-18 09:40:46,13225.0,2,7564,0,13220.0,9,13230.0,9,S
2018-04-18 09:40:48,13225.0,6,7570,0,13220.0,9,13230.0,9,S
2018-04-18 09:40:54,13225.0,2,7572,2,13220.0,9,13225.0,7,S
2018-04-18 09:40:56,13220.0,10,7582,-4,13215.0,5,13220.0,1,S
2018-04-18 09:40:59,13215.0,6,7588,2,13210.0,4,13215.0,1,S
2018-04-18 09:41:00,13215.0,2,7590,-2,13215.0,5,13220.0,3,S
2018-04-18 09:41:03,13215.0,2,7592,0,13220.0,3,13225.0,10,S
2018-04-18 09:41:06,13215.0,6,7598,0,13215.0,12,13225.0,14,S
2018-04-18 09:41:10,13220.0,2,7600,0,13215.0,13,13220.0,2,B
2018-04-18 09:41:10,13220.0,2,7602,-2,13215.0,13,13225.0,12,B
2018-04-18 09:41:16,13220.0,2,7604,0,13220.0,1,13225.0,12,B
2018-04-18 09:41:20,13220.0,6,7610,4,13215.0,13,13220.0,1,B
2018-04-18 09:41:21,13220.0,4,7614,4,13215.0,11,13220.0,7,B
2018-04-18 09:41:28,13215.0,6,7620,0,13215.0,8,13220.0,5,S
2018-04-18 09:41:35,13220.0,8,7628,-6,13215.0,8,13225.0,30,B
2018-04-18 09:41:39,13220.0,2,7630,0,13215.0,9,13220.0,2,B
2018-04-18 09:41:48,13220.0,2,7632,0,13215.0,11,13220.0,4,B
2018-04-18 09:41:51,13220.0,2,7634,-2,13215.0,11,13220.0,4,B
2018-04-18 09:42:13,13215.0,2,7636,0,13215.0,7,13220.0,22,S
2018-04-18 09:42:18,13220.0,4,7640,-4,13215.0,9,13225.0,20,B
2018-04-18 09:42:28,13220.0,2,7642,2,13215.0,11,13225.0,23,B
2018-04-18 09:43:21,13220.0,4,7646,0,13220.0,2,13225.0,36,B
2018-04-18 09:43:24,13220.0,2,7648,-2,13220.0,1,13225.0,36,B
2018-04-18 09:44:18,13220.0,2,7650,0,13220.0,6,13225.0,9,B
2018-04-18 09:44:28,13220.0,2,7652,0,13220.0,4,13225.0,11,B
2018-04-18 09:44:49,13220.0,10,7662,6,13215.0,7,13220.0,1,B
2018-04-18 09:44:50,13215.0,4,7666,4,13215.0,5,13220.0,13,S
2018-04-18 09:44:59,13215.0,10,7676,-6,13215.0,2,13220.0,14,S
2018-04-18 09:45:01,13220.0,2,7678,-2,13215.0,11,13220.0,13,B
2018-04-18 09:45:03,13220.0,6,7684,0,13215.0,16,13225.0,21,B
2018-04-18 09:45:49,13220.0,4,7688,0,13220.0,7,13225.0,10,B
2018-04-18 09:46:03,13220.0,2,7690,-2,13220.0,6,13225.0,11,B
2018-04-18 09:46:50,13225.0,2,7692,2,13220.0,8,13225.0,10,B
2018-04-18 09:46:57,13225.0,2,7694,0,13220.0,8,13225.0,9,B
2018-04-18 09:47:38,13225.0,2,7696,0,13220.0,6,13225.0,8,B
2018-04-18 09:47:39,13225.0,2,7698,2,13220.0,6,13225.0,7,B
2018-04-18 09:48:14,13225.0,2,7700,0,13220.0,6,13225.0,7,B
2018-04-18 09:48:15,13225.0,2,7702,-2,13220.0,8,13225.0,6,B
2018-04-18 09:48:21,13225.0,8,7710,-2,13220.0,8,13225.0,2,B
2018-04-18 09:48:22,13225.0,4,7714,-2,13225.0,2,13230.0,30,B
2018-04-18 09:48:46,13225.0,2,7716,0,13225.0,2,13230.0,27,B
2018-04-18 09:48:58,13225.0,4,7720,0,13225.0,1,13230.0,27,B
2018-04-18 09:48:59,13230.0,14,7734,10,13225.0,1,13230.0,21,B
2018-04-18 09:49:07,13230.0,14,7748,12,13225.0,4,13230.0,15,B
2018-04-18 09:49:23,13225.0,2,7750,0,13225.0,4,13230.0,18,S
2018-04-18 09:49:29,13225.0,6,7756,-4,13225.0,1,13230.0,25,S
2018-04-18 09:49:29,13225.0,2,7758,-2,13220.0,6,13225.0,2,S
2018-04-18 09:49:31,13225.0,2,7760,-2,13225.0,3,13230.0,26,S
2018-04-18 09:49:38,13225.0,2,7762,0,13225.0,5,13230.0,26,S
2018-04-18 09:50:04,13225.0,10,7772,4,13220.0,4,13230.0,18,S
2018-04-18 09:50:15,13225.0,2,7774,0,13220.0,4,13225.0,7,S
2018-04-18 09:50:35,13220.0,2,7776,0,13220.0,9,13230.0,19,S
2018-04-18 09:50:50,13220.0,4,7780,-4,13220.0,5,13230.0,19,S
2018-04-18 09:51:31,13215.0,2,7782,0,13215.0,2,13220.0,5,S
2018-04-18 09:51:37,13215.0,2,7784,2,13215.0,2,13220.0,2,S
2018-04-18 09:52:16,13220.0,6,7790,-4,13220.0,3,13225.0,5,B
2018-04-18 09:52:17,13225.0,4,7794,2,13220.0,12,13230.0,18,B
2018-04-18 09:53:06,13230.0,10,7804,8,13220.0,3,13230.0,24,B
2018-04-18 09:53:10,13230.0,2,7806,0,13220.0,4,13230.0,28,B
2018-04-18 09:53:36,13220.0,6,7812,2,13215.0,4,13225.0,26,S
2018-04-18 09:54:16,13225.0,6,7818,0,13220.0,10,13225.0,2,B
2018-04-18 09:54:17,13225.0,4,7822,4,13225.0,1,13230.0,23,B
2018-04-18 09:54:18,13225.0,2,7824,0,13220.0,10,13230.0,33,B
2018-04-18 09:54:27,13225.0,2,7826,2,13220.0,7,13230.0,33,B
2018-04-18 09:54:28,13225.0,4,7830,-4,13220.0,11,13230.0,33,B
2018-04-18 09:54:30,13225.0,2,7832,0,13225.0,1,13230.0,21,B
2018-04-18 09:54:44,13230.0,2,7834,-2,13225.0,2,13230.0,18,B
2018-04-18 09:54:46,13230.0,2,7836,-2,13225.0,2,13230.0,17,B
2018-04-18 09:54:54,13230.0,4,7840,-2,13225.0,4,13230.0,13,B
2018-04-18 09:55:05,13225.0,2,7842,0,13225.0,4,13230.0,13,S
2018-04-18 09:55:11,13230.0,2,7844,-2,13225.0,3,13230.0,12,B
2018-04-18 09:55:13,13225.0,8,7852,-4,13220.0,10,13225.0,6,S
2018-04-18 09:55:14,13225.0,12,7864,-8,13225.0,1,13230.0,11,S
2018-04-18 09:55:14,13230.0,4,7868,0,13225.0,3,13230.0,9,B
2018-04-18 09:55:38,13225.0,4,7872,2,13220.0,15,13225.0,3,S
2018-04-18 09:55:39,13225.0,6,7878,0,13225.0,2,13230.0,9,S
2018-04-18 09:55:39,13225.0,4,7882,4,13225.0,1,13230.0,11,S
2018-04-18 09:55:42,13225.0,2,7884,2,13220.0,15,13230.0,11,S
2018-04-18 09:55:49,13230.0,4,7888,-2,13225.0,13,13230.0,7,B
2018-04-18 09:55:50,13230.0,2,7890,0,13225.0,27,13230.0,6,B
2018-04-18 09:56:06,13225.0,4,7894,2,13225.0,2,13230.0,6,S
2018-04-18 09:56:12,13225.0,4,7898,4,13220.0,11,13230.0,13,S
2018-04-18 09:57:00,13230.0,4,7902,4,13225.0,2,13230.0,6,B
2018-04-18 09:57:06,13230.0,2,7904,0,13225.0,2,13230.0,5,B
2018-04-18 09:57:13,13225.0,2,7906,0,13225.0,1,13230.0,5,S
2018-04-18 09:57:17,13225.0,2,7908,-2,13225.0,2,13230.0,5,S
2018-04-18 09:57:18,13225.0,4,7912,4,13220.0,11,13225.0,3,S
2018-04-18 09:57:18,13225.0,6,7918,4,13220.0,15,13230.0,5,S
2018-04-18 09:57:43,13230.0,2,7920,2,13220.0,21,13230.0,4,B
2018-04-18 09:58:44,13230.0,4,7924,2,13220.0,11,13225.0,1,B
2018-04-18 09:58:55,13220.0,4,7928,-4,13220.0,10,13225.0,1,S
2018-04-18 09:59:01,13220.0,2,7930,0,13220.0,8,13225.0,1,S
2018-04-18 09:59:04,13225.0,2,7932,0,13220.0,9,13230.0,11,B
2018-04-18 09:59:09,13225.0,2,7934,0,13220.0,8,13225.0,1,B
2018-04-18 09:59:14,13225.0,4,7938,0,13225.0,4,13230.0,11,B
2018-04-18 09:59:15,13225.0,2,7940,-2,13225.0,3,13230.0,11,B
2018-04-18 09:59:38,13230.0,6,7946,-2,13225.0,3,13230.0,2,B
2018-04-18 10:00:03,13230.0,2,7948,0,13225.0,4,13235.0,6,B
2018-04-18 10:00:10,13235.0,4,7952,0,13230.0,1,13235.0,1,B
2018-04-18 10:00:57,13230.0,6,7958,2,13225.0,19,13230.0,2,S
2018-04-18 10:00:57,13230.0,4,7962,4,13230.0,1,13235.0,2,S
2018-04-18 10:01:15,13235.0,2,7964,0,13235.0,2,13240.0,6,B
2018-04-18 10:01:19,13235.0,2,7966,0,13235.0,1,13240.0,6,B
2018-04-18 10:01:44,13230.0,8,7974,6,13225.0,22,13230.0,1,S
2018-04-18 10:01:45,13230.0,2,7976,0,13225.0,24,13235.0,6,S
2018-04-18 10:01:47,13225.0,2,7978,0,13225.0,9,13235.0,6,S
2018-04-18 10:01:51,13225.0,10,7988,8,13225.0,9,13235.0,6,S
2018-04-18 10:02:14,13230.0,2,7990,2,13225.0,2,13235.0,8,B
2018-04-18 10:02:18,13230.0,2,7992,0,13230.0,8,13235.0,10,B
2018-04-18 10:02:22,13230.0,2,7994,0,13230.0,7,13235.0,10,B
2018-04-18 10:02:27,13230.0,4,7998,0,13230.0,4,13235.0,29,B
2018-04-18 10:02:28,13230.0,8,8006,8,13225.0,2,13235.0,17,B
2018-04-18 10:03:31,13225.0,6,8012,-4,13220.0,6,13230.0,28,S
2018-04-18 10:03:48,13230.0,2,8014,0,13230.0,3,13235.0,13,B
2018-04-18 10:03:49,13230.0,2,8016,0,13225.0,5,13235.0,12,B
2018-04-18 10:04:06,13220.0,2,8018,0,13220.0,6,13230.0,17,S
2018-04-18 10:04:14,13225.0,2,8020,-2,13220.0,6,13230.0,16,B
2018-04-18 10:04:53,13220.0,2,8022,0,13220.0,7,13225.0,7,S
2018-04-18 10:04:54,13220.0,6,8028,-4,13220.0,4,13225.0,14,S
2018-04-18 10:05:00,13220.0,2,8030,0,13220.0,3,13225.0,12,S
2018-04-18 10:05:06,13220.0,4,8034,-4,13220.0,1,13225.0,12,S
2018-04-18 10:05:07,13220.0,2,8036,-2,13215.0,8,13225.0,10,S
2018-04-18 10:05:30,13220.0,2,8038,2,13220.0,6,13230.0,13,S
2018-04-18 10:06:03,13225.0,2,8040,0,13220.0,2,13230.0,13,B
2018-04-18 10:06:13,13225.0,2,8042,-2,13220.0,2,13230.0,13,B
2018-04-18 10:06:48,13220.0,6,8048,2,13215.0,20,13220.0,7,S
2018-04-18 10:06:48,13220.0,8,8056,4,13215.0,24,13220.0,3,S
2018-04-18 10:06:49,13220.0,2,8058,2,13215.0,24,13220.0,2,S
2018-04-18 10:06:49,13220.0,4,8062,0,13215.0,24,13225.0,3,S
2018-04-18 10:07:04,13220.0,2,8064,2,13215.0,21,13225.0,3,S
2018-04-18 10:07:10,13220.0,2,8066,2,13215.0,7,13225.0,14,S
2018-04-18 10:07:11,13220.0,2,8068,2,13215.0,7,13220.0,1,S
2018-04-18 10:07:24,13215.0,2,8070,2,13215.0,5,13220.0,7,S
2018-04-18 10:07:56,13220.0,6,8076,-4,13215.0,7,13225.0,10,B
2018-04-18 10:08:21,13220.0,2,8078,2,13215.0,7,13220.0,1,B
2018-04-18 10:09:25,13220.0,2,8080,-2,13215.0,8,13225.0,13,B
2018-04-18 10:09:31,13220.0,2,8082,0,13215.0,8,13225.0,13,B
2018-04-18 10:10:02,13220.0,2,8084,0,13215.0,9,13220.0,4,B
2018-04-18 10:10:25,13220.0,10,8094,-10,13215.0,9,13225.0,7,B
2018-04-18 10:11:15,13225.0,12,8106,-4,13220.0,10,13225.0,3,B
2018-04-18 10:11:18,13225.0,8,8114,-6,13220.0,3,13225.0,1,B
2018-04-18 10:11:19,13225.0,2,8116,0,13220.0,3,13230.0,30,B
2018-04-18 10:11:19,13230.0,10,8126,-2,13220.0,3,13230.0,37,B
2018-04-18 10:11:43,13225.0,2,8128,0,13225.0,2,13230.0,28,S
2018-04-18 10:11:52,13230.0,6,8134,0,13220.0,3,13230.0,26,B
2018-04-18 10:12:23,13225.0,2,8136,2,13220.0,8,13230.0,17,S
2018-04-18 10:12:53,13225.0,6,8142,6,13220.0,8,13230.0,19,S
2018-04-18 10:14:06,13230.0,4,8146,4,13225.0,2,13235.0,8,B
2018-04-18 10:14:21,13235.0,10,8156,4,13225.0,8,13235.0,14,B
2018-04-18 10:14:30,13235.0,20,8176,-16,13230.0,1,13235.0,3,B
2018-04-18 10:14:34,13235.0,6,8182,-6,13235.0,7,13240.0,19,B
2018-04-18 10:14:35,13230.0,18,8200,-10,13225.0,8,13240.0,32,S
2018-04-18 10:14:36,13230.0,4,8204,2,13230.0,3,13235.0,3,S
2018-04-18 10:14:36,13235.0,4,8208,2,13230.0,3,13235.0,1,B
2018-04-18 10:14:51,13235.0,2,8210,-2,13230.0,2,13240.0,28,B
2018-04-18 10:30:01,13230.0,4,8214,-2,13230.0,30,13235.0,1,S
2018-04-18 10:30:06,13240.0,2,8216,2,13235.0,1,13240.0,4,B
2018-04-18 10:30:09,13235.0,2,8218,0,13235.0,1,13240.0,5,S
2018-04-18 10:30:44,13240.0,6,8224,6,13235.0,11,13240.0,4,B
2018-04-18 10:30:44,13240.0,2,8226,2,13235.0,11,13240.0,3,B
2018-04-18 10:31:00,13240.0,2,8228,-2,13235.0,11,13240.0,4,B
2018-04-18 10:31:12,13240.0,8,8236,-8,13240.0,6,13245.0,19,B
2018-04-18 10:31:13,13240.0,4,8240,0,13240.0,4,13245.0,27,B
2018-04-18 10:31:13,13235.0,12,8252,0,13230.0,27,13245.0,28,S
2018-04-18 10:31:14,13235.0,2,8254,2,13235.0,7,13245.0,28,S
2018-04-18 10:31:20,13240.0,2,8256,-2,13235.0,22,13245.0,9,B
2018-04-18 10:31:35,13245.0,4,8260,0,13240.0,11,13245.0,4,B
2018-04-18 10:31:41,13245.0,8,8268,2,13240.0,11,13245.0,2,B
2018-04-18 10:31:45,13240.0,4,8272,0,13240.0,8,13245.0,16,S
2018-04-18 10:31:46,13240.0,4,8276,0,13240.0,6,13245.0,10,S
2018-04-18 10:31:48,13245.0,2,8278,0,13240.0,6,13245.0,14,B
2018-04-18 10:31:48,13240.0,2,8280,-2,13240.0,5,13245.0,14,S
2018-04-18 10:31:51,13240.0,2,8282,-2,13240.0,5,13245.0,14,S
2018-04-18 10:32:00,13245.0,2,8284,0,13240.0,6,13245.0,5,B
2018-04-18 10:32:18,13240.0,2,8286,0,13240.0,5,13245.0,8,S
2018-04-18 10:32:19,13240.0,8,8294,-2,13240.0,1,13245.0,15,S
2018-04-18 10:32:19,13240.0,2,8296,0,13235.0,3,13245.0,18,S
2018-04-18 10:32:23,13235.0,2,8298,0,13235.0,4,13245.0,20,S
2018-04-18 10:32:28,13235.0,2,8300,0,13235.0,3,13240.0,1,S
2018-04-18 10:32:50,13240.0,2,8302,-2,13230.0,14,13240.0,5,B
2018-04-18 10:33:03,13235.0,2,8304,2,13235.0,1,13240.0,5,S
2018-04-18 10:33:24,13235.0,4,8308,2,13235.0,1,13240.0,5,S
2018-04-18 10:34:11,13240.0,2,8310,2,13235.0,4,13240.0,6,B
2018-04-18 10:34:37,13240.0,2,8312,-2,13235.0,2,13240.0,7,B
2018-04-18 10:35:42,13240.0,2,8314,-2,13235.0,3,13240.0,6,B
2018-04-18 10:35:52,13240.0,2,8316,0,13235.0,3,13240.0,6,B
2018-04-18 10:36:45,13235.0,2,8318,-2,13235.0,2,13240.0,9,S
2018-04-18 10:37:05,13240.0,2,8320,0,13235.0,3,13240.0,6,B
2018-04-18 10:37:27,13240.0,2,8322,0,13235.0,6,13240.0,7,B
2018-04-18 10:37:30,13240.0,10,8332,0,13235.0,25,13240.0,1,B
2018-04-18 10:37:31,13240.0,2,8334,2,13235.0,25,13240.0,1,B
2018-04-18 10:37:31,13240.0,2,8336,0,13235.0,25,13245.0,6,B
2018-04-18 10:37:43,13240.0,2,8338,-2,13240.0,1,13245.0,4,B
2018-04-18 10:38:04,13240.0,2,8340,-2,13235.0,3,13240.0,2,B
2018-04-18 10:38:25,13240.0,8,8348,0,13240.0,1,13245.0,13,B
2018-04-18 10:38:26,13240.0,2,8350,2,13235.0,5,13245.0,18,B
2018-04-18 10:38:41,13235.0,6,8356,6,13230.0,27,13235.0,7,S
2018-04-18 10:38:57,13230.0,14,8370,14,13230.0,14,13240.0,9,S
2018-04-18 10:40:11,13230.0,2,8372,2,13230.0,4,13235.0,8,S
2018-04-18 10:40:22,13230.0,2,8374,0,13230.0,3,13235.0,8,S
2018-04-18 10:40:41,13230.0,2,8376,2,13230.0,12,13235.0,11,S
2018-04-18 10:41:02,13235.0,20,8396,-18,13230.0,3,13235.0,1,B
2018-04-18 10:41:23,13235.0,2,8398,0,13230.0,5,13235.0,1,B
2018-04-18 10:41:45,13230.0,10,8408,8,13225.0,14,13230.0,1,S
2018-04-18 10:41:46,13225.0,2,8410,0,13225.0,1,13230.0,7,S
2018-04-18 10:41:47,13225.0,2,8412,0,13225.0,1,13230.0,7,S
2018-04-18 10:41:47,13225.0,2,8414,0,13220.0,28,13230.0,6,S
2018-04-18 10:42:00,13220.0,2,8416,-2,13220.0,24,13225.0,8,S
2018-04-18 10:42:02,13220.0,4,8420,4,13220.0,13,13225.0,11,S
2018-04-18 10:42:02,13220.0,26,8446,20,13215.0,8,13225.0,11,S
2018-04-18 10:42:09,13215.0,2,8448,2,13215.0,6,13220.0,11,S
2018-04-18 10:42:09,13215.0,12,8460,10,13210.0,17,13215.0,2,S
2018-04-18 10:42:10,13215.0,4,8464,4,13210.0,16,13220.0,18,S
2018-04-18 10:42:12,13210.0,2,8466,2,13210.0,15,13215.0,5,S
2018-04-18 10:42:12,13210.0,2,8468,-2,13210.0,14,13215.0,2,S
2018-04-18 10:42:13,13210.0,4,8472,0,13210.0,13,13215.0,1,S
2018-04-18 10:42:17,13215.0,2,8474,0,13215.0,1,13220.0,1,B
2018-04-18 10:42:20,13215.0,2,8476,-2,13215.0,3,13220.0,26,B
2018-04-18 10:42:26,13215.0,2,8478,-2,13210.0,13,13220.0,25,B
2018-04-18 10:42:29,13215.0,2,8480,0,13215.0,1,13220.0,4,B
2018-04-18 10:42:52,13215.0,2,8482,0,13215.0,5,13220.0,4,B
2018-04-18 10:42:53,13215.0,6,8488,0,13215.0,2,13220.0,30,B
2018-04-18 10:42:54,13215.0,2,8490,0,13215.0,1,13220.0,30,B
2018-04-18 10:42:54,13215.0,2,8492,2,13210.0,14,13220.0,30,B
2018-04-18 10:43:02,13215.0,4,8496,0,13215.0,3,13220.0,24,B
2018-04-18 10:43:03,13215.0,2,8498,0,13215.0,2,13220.0,29,B
2018-04-18 10:43:04,13215.0,4,8502,0,13210.0,15,13220.0,29,B
2018-04-18 10:43:07,13210.0,2,8504,2,13210.0,14,13215.0,1,S
2018-04-18 10:43:10,13215.0,2,8506,2,13210.0,14,13215.0,2,B
2018-04-18 10:43:16,13215.0,4,8510,0,13210.0,19,13220.0,25,B
2018-04-18 10:43:25,13215.0,2,8512,0,13215.0,4,13220.0,26,B
2018-04-18 10:43:26,13215.0,2,8514,-2,13215.0,3,13220.0,26,B
2018-04-18 10:43:34,13215.0,2,8516,0,13215.0,3,13220.0,31,B
2018-04-18 10:43:35,13215.0,2,8518,-2,13215.0,2,13220.0,31,B
2018-04-18 10:43:41,13220.0,2,8520,0,13215.0,9,13220.0,2,B
2018-04-18 10:43:41,13220.0,4,8524,2,13215.0,9,13225.0,17,B
2018-04-18 10:43:54,13220.0,2,8526,2,13215.0,7,13220.0,9,B
2018-04-18 10:44:02,13215.0,6,8532,2,13215.0,2,13220.0,33,S
2018-04-18 10:44:04,13215.0,4,8536,4,13210.0,20,13215.0,18,S
2018-04-18 10:44:20,13210.0,2,8538,2,13210.0,19,13215.0,38,S
2018-04-18 10:44:22,13215.0,12,8550,8,13210.0,25,13215.0,22,B
2018-04-18 10:44:22,13215.0,42,8592,32,13210.0,24,13215.0,1,B
2018-04-18 10:44:23,13215.0,2,8594,2,13215.0,5,13220.0,2,B
2018-04-18 10:44:25,13210.0,6,8600,4,13210.0,22,13220.0,18,S
2018-04-18 10:44:26,13210.0,2,8602,2,13210.0,21,13220.0,31,S
2018-04-18 10:44:34,13215.0,2,8604,-2,13210.0,17,13215.0,1,B
2018-04-18 10:44:42,13215.0,2,8606,0,13210.0,17,13220.0,26,B
2018-04-18 10:44:54,13210.0,4,8610,2,13210.0,16,13215.0,20,S
2018-04-18 10:44:54,13210.0,4,8614,0,13210.0,14,13215.0,32,S
2018-04-18 10:44:55,13210.0,4,8618,0,13210.0,12,13215.0,38,S
2018-04-18 10:44:55,13210.0,20,8638,2,13210.0,2,13215.0,38,S
2018-04-18 10:44:56,13210.0,4,8642,4,13205.0,7,13215.0,38,S
2018-04-18 10:44:56,13205.0,2,8644,2,13205.0,5,13215.0,38,S
2018-04-18 10:44:58,13205.0,8,8652,2,13200.0,30,13210.0,25,S
2018-04-18 10:44:58,13200.0,2,8654,0,13200.0,29,13210.0,38,S
2018-04-18 10:45:00,13200.0,2,8656,0,13205.0,3,13215.0,36,S
2018-04-18 10:45:05,13205.0,2,8658,-2,13205.0,3,13210.0,1,B
2018-04-18 10:45:07,13205.0,2,8660,-2,13205.0,3,13210.0,1,B
2018-04-18 10:45:09,13205.0,2,8662,-2,13205.0,3,13215.0,43,B
2018-04-18 10:45:10,13205.0,2,8664,-2,13205.0,4,13215.0,43,B
2018-04-18 10:45:12,13210.0,2,8666,0,13205.0,4,13215.0,38,B
2018-04-18 10:45:15,13205.0,2,8668,0,13205.0,3,13215.0,42,S
2018-04-18 10:45:19,13205.0,2,8670,0,13205.0,2,13215.0,42,S
2018-04-18 10:45:27,13205.0,4,8674,0,13205.0,3,13215.0,38,S
2018-04-18 10:45:35,13215.0,2,8676,0,13205.0,3,13215.0,32,B
2018-04-18 10:45:36,13205.0,6,8682,-4,13205.0,2,13215.0,36,S
2018-04-18 10:45:39,13205.0,4,8686,0,13210.0,8,13215.0,36,S
2018-04-18 10:45:40,13205.0,2,8688,0,13210.0,8,13215.0,36,S
2018-04-18 10:45:40,13210.0,16,8704,-16,13205.0,3,13210.0,2,B
2018-04-18 10:45:48,13210.0,6,8710,-6,13210.0,7,13215.0,32,B
2018-04-18 10:45:51,13210.0,2,8712,0,13210.0,6,13215.0,37,B
2018-04-18 10:45:51,13210.0,4,8716,0,13210.0,4,13215.0,37,B
2018-04-18 10:45:52,13210.0,4,8720,0,13210.0,2,13215.0,37,B
2018-04-18 10:45:52,13210.0,4,8724,0,13205.0,2,13215.0,37,B
2018-04-18 10:46:12,13210.0,2,8726,0,13210.0,9,13215.0,16,B
2018-04-18 10:46:13,13210.0,4,8730,0,13210.0,7,13215.0,39,B
2018-04-18 10:46:13,13210.0,4,8734,0,13210.0,5,13215.0,39,B
2018-04-18 10:46:14,13210.0,10,8744,-10,13205.0,7,13215.0,34,B
2018-04-18 10:46:19,13215.0,2,8746,2,13205.0,6,13215.0,33,B
2018-04-18 10:46:28,13210.0,2,8748,0,13210.0,2,13215.0,4,S
2018-04-18 10:47:02,13215.0,2,8750,-2,13210.0,16,13215.0,2,B
2018-04-18 10:47:20,13210.0,20,8770,-18,13210.0,6,13215.0,4,S
2018-04-18 10:47:37,13215.0,6,8776,0,13215.0,11,13220.0,3,B
2018-04-18 10:49:04,13220.0,2,8778,0,13215.0,21,13220.0,1,B
2018-04-18 10:49:05,13220.0,2,8780,0,13220.0,1,13225.0,6,B
2018-04-18 10:49:10,13215.0,8,8788,2,13215.0,3,13220.0,1,S
2018-04-18 10:49:11,13215.0,6,8794,4,13215.0,1,13220.0,2,S
2018-04-18 10:50:05,13215.0,2,8796,2,13215.0,1,13220.0,3,S
2018-04-18 10:51:25,13215.0,2,8798,0,13210.0,6,13215.0,3,S
2018-04-18 10:51:51,13215.0,8,8806,6,13210.0,6,13220.0,17,S
2018-04-18 10:52:02,13210.0,12,8818,0,13205.0,6,13215.0,19,S
2018-04-18 10:52:03,13205.0,6,8824,2,13205.0,2,13215.0,35,S
2018-04-18 10:53:17,13210.0,2,8826,0,13205.0,10,13210.0,4,B
2018-04-18 10:53:28,13210.0,8,8834,8,13210.0,1,13215.0,8,B
2018-04-18 10:53:59,13215.0,16,8850,-6,13215.0,2,13220.0,24,B
2018-04-18 10:54:00,13210.0,8,8858,2,13205.0,5,13210.0,1,S
2018-04-18 10:54:00,13210.0,6,8864,4,13205.0,7,13210.0,1,S
2018-04-18 10:54:01,13210.0,2,8866,2,13205.0,6,13215.0,4,S
2018-04-18 10:54:54,13215.0,2,8868,0,13215.0,1,13220.0,7,B
2018-04-18 10:56:18,13220.0,2,8870,2,13215.0,7,13220.0,3,B
2018-04-18 10:56:21,13220.0,2,8872,0,13215.0,9,13220.0,2,B
2018-04-18 10:56:21,13220.0,4,8876,0,13215.0,9,13225.0,13,B
2018-04-18 10:56:41,13215.0,8,8884,-6,13215.0,2,13220.0,1,S
2018-04-18 10:56:47,13220.0,2,8886,0,13215.0,1,13220.0,5,B
2018-04-18 10:56:53,13220.0,8,8894,6,13215.0,1,13220.0,1,B
2018-04-18 10:57:07,13220.0,2,8896,0,13215.0,6,13225.0,17,B
2018-04-18 10:57:41,13220.0,2,8898,0,13220.0,1,13225.0,10,B
2018-04-18 10:58:27,13225.0,4,8902,-2,13220.0,19,13230.0,42,B
2018-04-18 10:58:47,13220.0,2,8904,0,13215.0,16,13220.0,9,S
2018-04-18 10:58:47,13220.0,2,8906,0,13215.0,16,13220.0,8,S
2018-04-18 10:59:22,13220.0,2,8908,2,13215.0,12,13220.0,8,S
2018-04-18 11:00:27,13220.0,12,8920,2,13215.0,15,13220.0,2,S
2018-04-18 11:00:28,13220.0,4,8924,0,13220.0,4,13225.0,3,S
2018-04-18 11:00:35,13225.0,2,8926,2,13220.0,5,13225.0,2,B
2018-04-18 11:00:42,13220.0,2,8928,-2,13220.0,5,13225.0,2,S
2018-04-18 11:00:52,13220.0,6,8934,-2,13215.0,10,13225.0,15,S
2018-04-18 11:01:24,13220.0,2,8936,0,13220.0,3,13225.0,13,S
2018-04-18 11:01:42,13220.0,2,8938,0,13220.0,1,13225.0,13,S
2018-04-18 11:01:42,13220.0,2,8940,2,13215.0,3,13220.0,9,S
2018-04-18 11:02:29,13220.0,2,8942,2,13220.0,2,13225.0,13,S
2018-04-18 11:02:35,13225.0,26,8968,26,13225.0,2,13230.0,56,B
2018-04-18 11:02:35,13225.0,4,8972,0,13220.0,2,13225.0,3,B
2018-04-18 11:02:40,13225.0,2,8974,2,13220.0,3,13230.0,41,B
2018-04-18 11:02:55,13225.0,4,8978,4,13220.0,27,13225.0,8,B
2018-04-18 11:03:04,13225.0,2,8980,0,13220.0,13,13225.0,7,B
2018-04-18 11:03:18,13220.0,2,8982,0,13220.0,2,13225.0,8,S
2018-04-18 11:03:29,13220.0,2,8984,-2,13220.0,1,13225.0,7,S
2018-04-18 11:03:41,13220.0,2,8986,2,13215.0,5,13220.0,1,S
2018-04-18 11:03:55,13215.0,2,8988,0,13215.0,2,13220.0,1,S
2018-04-18 11:03:55,13215.0,4,8992,2,13210.0,4,13215.0,2,S
2018-04-18 11:04:24,13215.0,2,8994,2,13215.0,1,13220.0,3,S
2018-04-18 11:05:02,13210.0,8,9002,2,13210.0,1,13215.0,7,S
2018-04-18 11:05:03,13210.0,2,9004,2,13205.0,6,13210.0,2,S
2018-04-18 11:05:10,13205.0,18,9022,-4,13200.0,22,13205.0,14,S
2018-04-18 11:05:10,13205.0,8,9030,-4,13200.0,26,13205.0,10,S
2018-04-18 11:05:20,13205.0,4,9034,-4,13200.0,22,13205.0,8,S
2018-04-18 11:05:22,13205.0,2,9036,0,13200.0,22,13205.0,7,S
2018-04-18 11:05:22,13205.0,6,9042,2,13200.0,27,13205.0,5,S
2018-04-18 11:05:23,13205.0,10,9052,0,13200.0,27,13210.0,2,S
2018-04-18 11:05:26,13210.0,4,9056,4,13205.0,9,13215.0,2,B
2018-04-18 11:06:33,13205.0,2,9058,-2,13205.0,9,13215.0,5,S
2018-04-18 11:06:43,13205.0,2,9060,2,13205.0,8,13215.0,6,S
2018-04-18 11:06:50,13205.0,14,9074,-4,13205.0,2,13210.0,8,S
2018-04-18 11:06:51,13205.0,4,9078,2,13200.0,21,13210.0,8,S
2018-04-18 11:07:01,13210.0,2,9080,2,13200.0,22,13210.0,4,B
2018-04-18 11:07:26,13210.0,2,9082,0,13205.0,13,13215.0,7,B
2018-04-18 11:07:33,13215.0,2,9084,2,13210.0,2,13215.0,2,B
2018-04-18 11:07:40,13210.0,2,9086,0,13210.0,1,13215.0,5,S
2018-04-18 11:07:41,13210.0,2,9088,2,13205.0,5,13210.0,1,S
2018-04-18 11:07:41,13210.0,2,9090,-2,13210.0,2,13215.0,7,S
2018-04-18 11:07:43,13210.0,4,9094,-4,13205.0,1,13215.0,7,S
2018-04-18 11:08:10,13210.0,2,9096,2,13205.0,13,13210.0,3,S
2018-04-18 11:08:18,13205.0,4,9100,0,13205.0,11,13210.0,7,S
2018-04-18 11:08:33,13210.0,2,9102,-2,13205.0,11,13210.0,2,B
2018-04-18 11:08:34,13210.0,4,9106,0,13210.0,1,13215.0,8,B
2018-04-18 11:09:07,13215.0,12,9118,4,13215.0,3,13220.0,25,B
2018-04-18 11:09:07,13210.0,10,9128,2,13205.0,11,13210.0,1,S
2018-04-18 11:09:08,13210.0,4,9132,0,13210.0,1,13215.0,2,S
2018-04-18 11:09:10,13215.0,2,9134,0,13210.0,5,13220.0,18,B
2018-04-18 11:09:38,13210.0,18,9152,-16,13205.0,23,13220.0,15,S
2018-04-18 11:11:07,13210.0,2,9154,0,13205.0,28,13215.0,6,S
2018-04-18 11:11:50,13205.0,6,9160,-6,13205.0,9,13215.0,8,S
2018-04-18 11:13:12,13210.0,2,9162,2,13205.0,11,13215.0,8,B
2018-04-18 11:13:37,13215.0,2,9164,0,13205.0,11,13215.0,7,B
2018-04-18 11:15:04,13210.0,2,9166,2,13205.0,11,13210.0,2,S
2018-04-18 11:15:15,13205.0,12,9178,-8,13205.0,5,13210.0,19,S
2018-04-18 11:15:15,13200.0,14,9192,4,13200.0,23,13205.0,1,S
2018-04-18 11:15:16,13200.0,6,9198,6,13200.0,17,13205.0,5,S
2018-04-18 11:15:16,13200.0,16,9214,6,13200.0,9,13205.0,30,S
2018-04-18 11:15:17,13200.0,18,9232,0,13195.0,2,13205.0,46,S
2018-04-18 11:15:25,13195.0,4,9236,0,13190.0,21,13200.0,2,S
2018-04-18 11:15:35,13200.0,4,9240,0,13195.0,7,13210.0,32,B
2018-04-18 11:15:58,13205.0,2,9242,2,13195.0,4,13205.0,6,B
2018-04-18 11:16:04,13195.0,2,9244,0,13195.0,6,13200.0,6,S
2018-04-18 11:16:05,13195.0,2,9246,2,13195.0,1,13200.0,1,S
2018-04-18 11:16:06,13195.0,4,9250,4,13190.0,10,13195.0,4,S
2018-04-18 11:16:15,13195.0,2,9252,0,13190.0,16,13195.0,3,S
2018-04-18 11:16:16,13195.0,4,9256,2,13190.0,19,13195.0,1,S
2018-04-18 11:16:17,13195.0,2,9258,0,13195.0,3,13200.0,1,S
2018-04-18 11:16:46,13195.0,2,9260,-2,13190.0,11,13200.0,3,S
2018-04-18 11:17:07,13190.0,4,9264,-4,13190.0,10,13195.0,8,S
2018-04-18 11:17:08,13190.0,16,9280,10,13190.0,2,13195.0,21,S
2018-04-18 11:17:08,13190.0,6,9286,-4,13185.0,7,13195.0,33,S
2018-04-18 11:17:15,13190.0,4,9290,-4,13185.0,6,13190.0,1,S
2018-04-18 11:17:19,13190.0,2,9292,2,13190.0,1,13195.0,19,S
2018-04-18 11:17:35,13190.0,10,9302,8,13185.0,9,13190.0,5,S
2018-04-18 11:17:36,13185.0,2,9304,2,13185.0,6,13190.0,20,S
2018-04-18 11:17:36,13185.0,6,9310,-4,13185.0,3,13190.0,33,S
2018-04-18 11:17:37,13180.0,42,9352,28,13175.0,1,13185.0,53,S
2018-04-18 11:17:38,13180.0,2,9354,-2,13175.0,7,13185.0,13,S
2018-04-18 11:17:39,13180.0,6,9360,-2,13175.0,6,13180.0,3,S
2018-04-18 11:17:40,13180.0,6,9366,-4,13180.0,1,13185.0,3,S
2018-04-18 11:17:40,13180.0,2,9368,0,13175.0,1,13185.0,5,S
2018-04-18 11:17:43,13175.0,2,9370,0,13170.0,3,13180.0,35,S
2018-04-18 11:17:44,13175.0,2,9372,0,13170.0,4,13180.0,27,S
2018-04-18 11:17:54,13175.0,2,9374,0,13175.0,4,13185.0,5,S
2018-04-18 11:17:54,13185.0,2,9376,2,13175.0,6,13185.0,4,B
2018-04-18 11:18:01,13175.0,2,9378,-2,13175.0,9,13185.0,35,S
2018-04-18 11:18:02,13175.0,4,9382,4,13175.0,7,13180.0,47,S
2018-04-18 11:18:03,13175.0,2,9384,0,13175.0,6,13180.0,47,S
2018-04-18 11:18:03,13175.0,2,9386,0,13175.0,5,13180.0,47,S
2018-04-18 11:18:07,13180.0,2,9388,2,13175.0,6,13180.0,2,B
2018-04-18 11:18:10,13180.0,2,9390,0,13175.0,7,13180.0,1,B
2018-04-18 11:18:12,13180.0,2,9392,0,13175.0,7,13185.0,27,B
2018-04-18 11:18:14,13180.0,2,9394,0,13175.0,7,13180.0,44,B
2018-04-18 11:18:15,13175.0,2,9396,0,13175.0,6,13180.0,45,S
2018-04-18 11:18:19,13175.0,2,9398,2,13175.0,1,13180.0,32,S
2018-04-18 11:18:22,13180.0,8,9406,0,13175.0,2,13180.0,28,B
2018-04-18 11:18:33,13175.0,2,9408,2,13175.0,2,13180.0,13,S
2018-04-18 11:18:39,13180.0,2,9410,-2,13175.0,5,13180.0,1,B
2018-04-18 11:18:40,13180.0,2,9412,0,13180.0,1,13185.0,14,B
2018-04-18 11:18:52,13180.0,2,9414,0,13180.0,2,13185.0,4,B
2018-04-18 11:18:58,13180.0,2,9416,-2,13175.0,6,13185.0,4,B
2018-04-18 11:19:10,13175.0,2,9418,0,13175.0,2,13185.0,18,S
2018-04-18 11:19:23,13185.0,2,9420,2,13175.0,2,13185.0,19,B
2018-04-18 11:19:25,13180.0,2,9422,0,13175.0,2,13180.0,1,S
2018-04-18 11:19:27,13180.0,2,9424,0,13175.0,2,13185.0,14,S
2018-04-18 11:19:37,13175.0,4,9428,-2,13175.0,1,13180.0,20,S
2018-04-18 11:19:37,13175.0,2,9430,0,13170.0,6,13180.0,22,S
2018-04-18 11:19:45,13175.0,2,9432,0,13170.0,4,13175.0,23,S
2018-04-18 11:19:47,13170.0,4,9436,4,13165.0,12,13170.0,30,S
2018-04-18 11:19:47,13160.0,24,9460,-6,13160.0,17,13165.0,34,S
2018-04-18 11:19:48,13160.0,20,9480,0,13160.0,8,13165.0,27,S
2018-04-18 11:19:48,13160.0,18,9498,0,13155.0,4,13160.0,4,S
2018-04-18 11:19:49,13160.0,18,9516,2,13155.0,3,13160.0,1,S
2018-04-18 11:19:49,13165.0,4,9520,-2,13160.0,4,13170.0,20,B
2018-04-18 11:19:51,13160.0,4,9524,0,13160.0,4,13170.0,25,S
2018-04-18 11:19:52,13160.0,4,9528,4,13160.0,2,13165.0,11,S
2018-04-18 11:19:53,13160.0,2,9530,2,13160.0,1,13165.0,3,S
2018-04-18 11:19:54,13170.0,2,9532,0,13160.0,3,13170.0,8,B
2018-04-18 11:19:59,13170.0,2,9534,0,13165.0,7,13170.0,1,B
2018-04-18 11:20:02,13160.0,6,9540,4,13160.0,7,13170.0,13,S
2018-04-18 11:20:02,13160.0,2,9542,0,13160.0,3,13170.0,13,S
2018-04-18 11:20:05,13160.0,2,9544,2,13160.0,3,13170.0,20,S
2018-04-18 11:20:09,13165.0,8,9552,-8,13165.0,1,13170.0,2,B
2018-04-18 11:20:09,13165.0,2,9554,2,13160.0,17,13170.0,2,B
2018-04-18 11:20:12,13170.0,4,9558,0,13165.0,17,13175.0,3,B
2018-04-18 11:20:16,13165.0,6,9564,0,13165.0,7,13175.0,14,S
2018-04-18 11:20:22,13170.0,2,9566,2,13165.0,2,13175.0,9,B
2018-04-18 11:20:24,13175.0,2,9568,2,13165.0,3,13175.0,10,B
2018-04-18 11:20:26,13175.0,2,9570,2,13165.0,4,13175.0,9,B
2018-04-18 11:20:28,13170.0,4,9574,4,13165.0,4,13175.0,9,S
2018-04-18 11:20:28,13165.0,4,9578,2,13165.0,5,13175.0,9,S
2018-04-18 11:20:31,13175.0,2,9580,-2,13165.0,13,13175.0,2,B
2018-04-18 11:20:48,13175.0,4,9584,0,13175.0,8,13180.0,10,B
2018-04-18 11:20:48,13175.0,8,9592,0,13175.0,4,13180.0,10,B
2018-04-18 11:20:49,13175.0,8,9600,-8,13170.0,3,13180.0,15,B
2018-04-18 11:21:04,13165.0,8,9608,0,13165.0,14,13175.0,18,S
2018-04-18 11:21:05,13165.0,4,9612,0,13165.0,12,13175.0,18,S
2018-04-18 11:21:19,13165.0,4,9616,0,13170.0,8,13175.0,15,S
2018-04-18 11:21:19,13165.0,4,9620,0,13170.0,6,13175.0,15,S
2018-04-18 11:21:20,13170.0,2,9622,-2,13170.0,5,13175.0,15,B
2018-04-18 11:21:39,13170.0,2,9624,-2,13170.0,9,13175.0,1,B
2018-04-18 11:21:51,13170.0,2,9626,0,13170.0,8,13175.0,1,B
2018-04-18 11:21:55,13175.0,2,9628,-2,13170.0,8,13180.0,15,B
2018-04-18 11:21:57,13170.0,4,9632,-4,13170.0,6,13180.0,17,S
2018-04-18 11:22:02,13165.0,14,9646,-12,13165.0,10,13175.0,7,S
2018-04-18 11:22:02,13165.0,2,9648,2,13165.0,4,13175.0,12,S
2018-04-18 11:22:04,13175.0,2,9650,-2,13165.0,5,13175.0,11,B
2018-04-18 11:22:17,13165.0,4,9654,2,13165.0,4,13175.0,11,S
2018-04-18 11:22:17,13165.0,4,9658,4,13165.0,2,13175.0,12,S
2018-04-18 11:22:30,13175.0,2,9660,-2,13165.0,3,13175.0,11,B
2018-04-18 11:22:47,13170.0,2,9662,0,13170.0,2,13175.0,2,S
2018-04-18 11:22:50,13170.0,2,9664,0,13170.0,2,13175.0,2,S
2018-04-18 11:22:51,13175.0,2,9666,-2,13170.0,2,13175.0,1,B
2018-04-18 11:22:52,13170.0,2,9668,0,13170.0,2,13175.0,1,S
2018-04-18 11:23:13,13180.0,4,9672,4,13170.0,3,13180.0,14,B
2018-04-18 11:23:18,13180.0,4,9676,-4,13175.0,10,13180.0,3,B
2018-04-18 11:23:18,13185.0,8,9684,0,13175.0,5,13185.0,4,B
2018-04-18 11:23:21,13185.0,2,9686,2,13175.0,6,13185.0,7,B
2018-04-18 11:23:33,13185.0,2,9688,0,13175.0,6,13185.0,7,B
2018-04-18 11:23:53,13175.0,4,9692,4,13175.0,6,13185.0,23,S
2018-04-18 11:23:59,13185.0,2,9694,2,13175.0,23,13185.0,3,B
2018-04-18 11:24:08,13180.0,4,9698,-4,13180.0,2,13185.0,3,S
2018-04-18 11:24:17,13180.0,4,9702,-4,13175.0,11,13185.0,3,S
2018-04-18 11:24:29,13175.0,2,9704,0,13175.0,10,13185.0,7,S
2018-04-18 11:24:30,13185.0,4,9708,4,13175.0,10,13185.0,5,B
2018-04-18 11:24:47,13175.0,4,9712,-4,13170.0,12,13180.0,1,S
2018-04-18 11:24:50,13180.0,2,9714,0,13170.0,12,13185.0,20,B
2018-04-18 11:24:51,13180.0,2,9716,2,13170.0,12,13180.0,5,B
2018-04-18 11:25:27,13185.0,6,9722,-4,13180.0,15,13190.0,5,B
2018-04-18 11:26:01,13190.0,4,9726,4,13185.0,3,13195.0,16,B
2018-04-18 11:26:02,13185.0,4,9730,0,13185.0,1,13195.0,22,S
2018-04-18 11:26:03,13185.0,2,9732,0,13185.0,1,13195.0,20,S
2018-04-18 11:26:28,13190.0,4,9736,4,13185.0,4,13190.0,1,B
2018-04-18 11:26:35,13185.0,4,9740,2,13185.0,2,13190.0,24,S
2018-04-18 11:26:36,13185.0,2,9742,2,13185.0,1,13190.0,24,S
2018-04-18 11:26:50,13185.0,2,9744,0,13180.0,5,13190.0,8,S
2018-04-18 11:27:02,13185.0,2,9746,2,13180.0,4,13190.0,8,S
2018-04-18 11:27:31,13185.0,2,9748,0,13180.0,4,13190.0,3,S
2018-04-18 11:28:19,13180.0,4,9752,2,13180.0,2,13185.0,1,S
2018-04-18 11:28:42,13180.0,2,9754,2,13180.0,2,13185.0,1,S
2018-04-18 11:29:00,13190.0,6,9760,-2,13180.0,2,13195.0,30,B
2018-04-18 11:29:03,13180.0,2,9762,-2,13180.0,2,13190.0,25,S
2018-04-18 11:29:09,13185.0,2,9764,-2,13180.0,4,13190.0,14,B
2018-04-18 11:29:20,13195.0,2,9766,0,13190.0,6,13195.0,3,B
2018-04-18 11:29:21,13195.0,4,9770,-4,13190.0,18,13195.0,1,B
2018-04-18 11:29:25,13195.0,2,9772,2,13195.0,1,13200.0,19,B
2018-04-18 11:29:44,13195.0,2,9774,2,13190.0,1,13195.0,22,B
2018-04-18 11:29:45,13190.0,2,9776,0,13190.0,2,13195.0,13,S
2018-04-18 11:29:49,13200.0,22,9798,10,13200.0,9,13205.0,18,B
2018-04-18 11:29:50,13200.0,18,9816,0,13195.0,1,13200.0,9,B
2018-04-18 11:29:51,13195.0,2,9818,0,13190.0,1,13200.0,4,S
2018-04-18 11:29:55,13190.0,4,9822,-4,13185.0,19,13200.0,1,S
2018-04-18 13:30:01,13200.0,4,9826,-2,13195.0,2,13200.0,6,B
2018-04-18 13:30:01,13200.0,12,9838,0,13200.0,1,13205.0,3,B
2018-04-18 13:30:02,13205.0,6,9844,6,13200.0,5,13210.0,2,B
2018-04-18 13:30:03,13210.0,2,9846,0,13200.0,5,13210.0,9,B
2018-04-18 13:30:03,13210.0,2,9848,-2,13200.0,5,13210.0,8,B
2018-04-18 13:30:13,13205.0,2,9850,-2,13200.0,5,13205.0,3,S
2018-04-18 13:30:14,13205.0,6,9856,0,13200.0,8,13210.0,17,S
2018-04-18 13:30:19,13205.0,2,9858,2,13200.0,10,13210.0,14,S
2018-04-18 13:30:26,13205.0,2,9860,-2,13200.0,8,13205.0,1,S
2018-04-18 13:30:28,13205.0,2,9862,-2,13200.0,8,13210.0,14,S
2018-04-18 13:30:40,13205.0,12,9874,10,13200.0,3,13205.0,6,S
2018-04-18 13:30:43,13205.0,2,9876,0,13200.0,8,13210.0,18,S
2018-04-18 13:30:55,13210.0,2,9878,0,13200.0,12,13210.0,16,B
2018-04-18 13:30:55,13210.0,2,9880,2,13200.0,12,13210.0,15,B
2018-04-18 13:31:04,13205.0,6,9886,2,13205.0,1,13210.0,9,S
2018-04-18 13:31:10,13205.0,4,9890,0,13205.0,3,13210.0,9,S
2018-04-18 13:31:19,13205.0,4,9894,4,13200.0,9,13205.0,5,S
2018-04-18 13:31:21,13205.0,2,9896,0,13205.0,1,13210.0,19,S
2018-04-18 13:31:22,13200.0,4,9900,0,13200.0,23,13210.0,12,S
2018-04-18 13:31:23,13210.0,2,9902,2,13200.0,23,13210.0,11,B
2018-04-18 13:31:26,13210.0,2,9904,2,13200.0,6,13210.0,15,B
2018-04-18 13:32:02,13205.0,2,9906,2,13200.0,9,13210.0,14,S
2018-04-18 13:32:09,13200.0,2,9908,0,13200.0,8,13210.0,19,S
2018-04-18 13:32:15,13200.0,2,9910,0,13200.0,5,13205.0,11,S
2018-04-18 13:32:28,13205.0,2,9912,0,13205.0,1,13210.0,7,B
2018-04-18 13:32:43,13210.0,2,9914,0,13200.0,25,13210.0,3,B
2018-04-18 13:32:43,13210.0,2,9916,-2,13200.0,13,13210.0,3,B
2018-04-18 13:33:00,13205.0,2,9918,2,13205.0,1,13210.0,13,S
2018-04-18 13:33:01,13200.0,4,9922,2,13200.0,12,13210.0,9,S
2018-04-18 13:33:19,13200.0,2,9924,0,13200.0,15,13210.0,2,S
2018-04-18 13:33:33,13200.0,4,9928,-4,13200.0,21,13210.0,3,S
2018-04-18 13:33:39,13200.0,2,9930,0,13200.0,20,13210.0,4,S
2018-04-18 13:33:45,13210.0,4,9934,0,13205.0,9,13210.0,2,B
2018-04-18 13:33:46,13210.0,4,9938,2,13210.0,1,13215.0,12,B
2018-04-18 13:33:55,13215.0,2,9940,2,13210.0,1,13215.0,8,B
2018-04-18 13:33:55,13215.0,2,9942,0,13210.0,1,13215.0,7,B
2018-04-18 13:34:06,13215.0,6,9948,2,13210.0,17,13215.0,4,B
2018-04-18 13:34:06,13215.0,8,9956,4,13210.0,12,13220.0,12,B
2018-04-18 13:34:07,13210.0,2,9958,-2,13210.0,11,13220.0,9,S
2018-04-18 13:34:07,13210.0,2,9960,-2,13210.0,16,13220.0,9,S
2018-04-18 13:34:12,13220.0,4,9964,4,13210.0,15,13220.0,7,B
2018-04-18 13:34:30,13215.0,4,9968,-2,13215.0,8,13220.0,5,S
2018-04-18 13:34:36,13220.0,4,9972,0,13215.0,3,13220.0,3,B
2018-04-18 13:34:44,13215.0,2,9974,2,13215.0,4,13220.0,3,S
2018-04-18 13:34:50,13220.0,2,9976,0,13215.0,23,13220.0,2,B
2018-04-18 13:34:50,13220.0,4,9980,-4,13215.0,28,13225.0,12,B
2018-04-18 13:35:02,13225.0,2,9982,2,13220.0,18,13225.0,8,B
2018-04-18 13:35:02,13225.0,4,9986,2,13220.0,20,13225.0,6,B
2018-04-18 13:35:04,13225.0,4,9990,-4,13220.0,19,13225.0,4,B
2018-04-18 13:35:04,13225.0,8,9998,-4,13225.0,3,13230.0,49,B
2018-04-18 13:35:06,13225.0,2,10000,-2,13220.0,11,13230.0,46,B
2018-04-18 13:35:24,13225.0,2,10002,0,13220.0,13,13225.0,1,B
2018-04-18 13:35:25,13225.0,2,10004,0,13225.0,4,13230.0,49,B
2018-04-18 13:35:31,13230.0,20,10024,2,13225.0,13,13230.0,35,B
2018-04-18 13:35:31,13230.0,18,10042,-14,13225.0,16,13230.0,26,B
2018-04-18 13:35:32,13230.0,2,10044,0,13225.0,31,13230.0,25,B
2018-04-18 13:35:35,13230.0,2,10046,-2,13225.0,12,13230.0,24,B
2018-04-18 13:35:37,13225.0,4,10050,-2,13225.0,3,13230.0,24,S
2018-04-18 13:35:37,13225.0,6,10056,4,13220.0,10,13225.0,1,S
2018-04-18 13:35:51,13220.0,14,10070,6,13220.0,3,13225.0,10,S
2018-04-18 13:35:52,13220.0,6,10076,4,13215.0,8,13220.0,3,S
2018-04-18 13:35:55,13220.0,2,10078,2,13215.0,16,13225.0,15,S
2018-04-18 13:36:05,13215.0,2,10080,0,13215.0,15,13225.0,15,S
2018-04-18 13:36:14,13220.0,4,10084,4,13215.0,24,13225.0,16,B
2018-04-18 13:36:21,13220.0,4,10088,0,13215.0,38,13220.0,2,B
2018-04-18 13:36:21,13220.0,2,10090,2,13215.0,38,13220.0,1,B
2018-04-18 13:36:42,13220.0,2,10092,0,13215.0,23,13220.0,3,B
2018-04-18 13:36:43,13220.0,2,10094,0,13215.0,28,13220.0,2,B
2018-04-18 13:36:48,13220.0,2,10096,0,13215.0,28,13220.0,2,B
2018-04-18 13:37:27,13220.0,4,10100,0,13215.0,29,13220.0,5,B
2018-04-18 13:37:30,13215.0,4,10104,0,13215.0,27,13220.0,3,S
2018-04-18 13:37:36,13220.0,2,10106,0,13215.0,27,13220.0,2,B
2018-04-18 13:37:37,13220.0,2,10108,2,13215.0,27,13220.0,1,B
2018-04-18 13:38:10,13215.0,4,10112,0,13215.0,6,13220.0,20,S
2018-04-18 13:38:30,13220.0,2,10114,0,13215.0,5,13220.0,7,B
2018-04-18 13:38:32,13215.0,2,10116,0,13215.0,4,13220.0,6,S
2018-04-18 13:38:38,13220.0,2,10118,0,13215.0,4,13220.0,5,B
2018-04-18 13:38:43,13220.0,2,10120,0,13215.0,4,13220.0,3,B
2018-04-18 13:39:03,13220.0,4,10124,-2,13215.0,19,13225.0,24,B
2018-04-18 13:39:18,13225.0,20,10144,20,13215.0,25,13225.0,14,B
2018-04-18 13:39:47,13225.0,6,10150,0,13220.0,4,13225.0,11,B
2018-04-18 13:40:08,13225.0,8,10158,-8,13220.0,25,13225.0,6,B
2018-04-18 13:40:09,13225.0,12,10170,0,13220.0,25,13230.0,11,B
2018-04-18 13:40:16,13230.0,4,10174,0,13225.0,23,13230.0,7,B
2018-04-18 13:40:18,13230.0,10,10184,10,13225.0,23,13230.0,2,B
2018-04-18 13:40:18,13230.0,2,10186,0,13225.0,24,13230.0,1,B
2018-04-18 13:40:21,13230.0,2,10188,2,13225.0,24,13235.0,5,B
2018-04-18 13:40:23,13230.0,2,10190,0,13230.0,10,13235.0,8,B
2018-04-18 13:40:26,13235.0,10,10200,8,13230.0,29,13240.0,10,B
2018-04-18 13:40:28,13240.0,2,10202,0,13230.0,31,13240.0,11,B
2018-04-18 13:40:28,13240.0,6,10208,-2,13230.0,34,13240.0,7,B
2018-04-18 13:40:29,13240.0,12,10220,-6,13235.0,25,13245.0,12,B
2018-04-18 13:40:30,13235.0,2,10222,2,13235.0,18,13240.0,1,S
2018-04-18 13:40:37,13240.0,4,10226,-4,13235.0,22,13245.0,15,B
2018-04-18 13:40:42,13245.0,2,10228,2,13240.0,7,13245.0,22,B
2018-04-18 13:40:46,13245.0,12,10240,-4,13240.0,21,13245.0,15,B
2018-04-18 13:40:59,13235.0,8,10248,-4,13235.0,25,13245.0,18,S
2018-04-18 13:41:02,13245.0,2,10250,0,13240.0,5,13245.0,21,B
2018-04-18 13:41:05,13240.0,4,10254,4,13240.0,3,13245.0,19,S
2018-04-18 13:41:14,13240.0,2,10256,2,13240.0,2,13245.0,16,S
2018-04-18 13:41:15,13245.0,4,10260,2,13240.0,9,13245.0,17,B
2018-04-18 13:41:17,13245.0,4,10264,-4,13240.0,4,13245.0,15,B
2018-04-18 13:41:19,13245.0,28,10292,18,13245.0,1,13250.0,8,B
2018-04-18 13:41:24,13250.0,2,10294,0,13245.0,24,13250.0,5,B
2018-04-18 13:41:25,13245.0,2,10296,0,13245.0,23,13250.0,5,S
2018-04-18 13:41:25,13250.0,4,10300,2,13245.0,23,13250.0,3,B
2018-04-18 13:41:26,13250.0,8,10308,6,13250.0,31,13255.0,6,B
2018-04-18 13:41:26,13255.0,10,10318,8,13250.0,7,13255.0,1,B
2018-04-18 13:41:27,13255.0,2,10320,2,13250.0,7,13260.0,20,B
2018-04-18 13:41:27,13260.0,8,10328,0,13250.0,11,13260.0,18,B
2018-04-18 13:41:30,13260.0,2,10330,0,13250.0,5,13260.0,33,B
2018-04-18 13:41:40,13250.0,2,10332,0,13250.0,3,13255.0,7,S
2018-04-18 13:41:41,13250.0,6,10338,0,13245.0,16,13255.0,7,S
2018-04-18 13:41:50,13250.0,2,10340,0,13245.0,2,13250.0,1,S
2018-04-18 13:42:19,13245.0,4,10344,-2,13245.0,1,13250.0,6,S
2018-04-18 13:42:21,13250.0,2,10346,0,13245.0,1,13250.0,10,B
2018-04-18 13:42:22,13245.0,2,10348,0,13240.0,21,13245.0,1,S
2018-04-18 13:42:24,13245.0,2,10350,0,13240.0,38,13245.0,3,S
2018-04-18 13:42:24,13245.0,8,10358,6,13245.0,5,13250.0,10,S
2018-04-18 13:42:29,13250.0,2,10360,0,13245.0,15,13250.0,8,B
2018-04-18 13:42:30,13245.0,2,10362,0,13245.0,14,13250.0,8,S
2018-04-18 13:42:34,13250.0,2,10364,0,13245.0,14,13250.0,8,B
2018-04-18 13:42:37,13250.0,2,10366,0,13245.0,15,13250.0,7,B
2018-04-18 13:42:42,13250.0,2,10368,2,13245.0,15,13250.0,8,B
2018-04-18 13:42:47,13245.0,2,10370,2,13245.0,1,13250.0,10,S
2018-04-18 13:42:47,13245.0,2,10372,2,13240.0,23,13250.0,10,S
2018-04-18 13:42:49,13245.0,2,10374,0,13240.0,29,13250.0,10,S
2018-04-18 13:42:52,13250.0,2,10376,0,13240.0,29,13250.0,8,B
2018-04-18 13:42:54,13250.0,2,10378,0,13245.0,22,13250.0,5,B
2018-04-18 13:42:57,13250.0,2,10380,0,13245.0,22,13250.0,4,B
2018-04-18 13:43:15,13250.0,2,10382,0,13245.0,1,13250.0,17,B
2018-04-18 13:43:16,13245.0,2,10384,2,13240.0,19,13250.0,17,S
2018-04-18 13:43:22,13245.0,2,10386,2,13240.0,19,13250.0,20,S
2018-04-18 13:43:47,13245.0,6,10392,-4,13240.0,3,13250.0,20,S
2018-04-18 13:43:56,13240.0,6,10398,0,13235.0,14,13240.0,4,S
2018-04-18 13:44:09,13235.0,2,10400,0,13235.0,20,13240.0,5,S
2018-04-18 13:44:24,13235.0,2,10402,0,13235.0,14,13240.0,7,S
2018-04-18 13:44:25,13240.0,2,10404,0,13235.0,14,13240.0,6,B
2018-04-18 13:44:35,13240.0,2,10406,-2,13235.0,14,13240.0,5,B
2018-04-18 13:44:35,13240.0,10,10416,-2,13240.0,13,13245.0,1,B
2018-04-18 13:44:49,13245.0,2,10418,0,13240.0,12,13250.0,27,B
2018-04-18 13:45:07,13245.0,4,10422,0,13240.0,10,13250.0,25,B
2018-04-18 13:45:16,13245.0,2,10424,2,13240.0,5,13245.0,3,B
2018-04-18 13:45:32,13245.0,4,10428,2,13245.0,26,13250.0,16,B
2018-04-18 13:45:43,13245.0,2,10430,0,13245.0,7,13250.0,10,B
2018-04-18 13:45:58,13245.0,2,10432,2,13245.0,6,13250.0,30,B
2018-04-18 13:46:13,13245.0,2,10434,0,13245.0,5,13250.0,30,B
2018-04-18 13:46:39,13240.0,2,10436,0,13240.0,7,13250.0,43,S
2018-04-18 13:46:45,13245.0,2,10438,-2,13240.0,5,13250.0,47,B
2018-04-18 13:46:52,13240.0,2,10440,0,13240.0,7,13245.0,1,S
2018-04-18 13:46:55,13240.0,4,10444,-2,13235.0,19,13245.0,9,S
2018-04-18 13:47:28,13245.0,6,10450,4,13240.0,15,13250.0,51,B
2018-04-18 13:47:45,13245.0,4,10454,0,13240.0,15,13250.0,49,B
2018-04-18 13:47:52,13240.0,2,10456,2,13240.0,14,13245.0,1,S
2018-04-18 13:48:06,13240.0,2,10458,2,13240.0,15,13245.0,2,S
2018-04-18 13:48:12,13245.0,4,10462,-2,13240.0,15,13250.0,50,B
2018-04-18 13:48:24,13240.0,4,10466,4,13240.0,13,13245.0,1,S
2018-04-18 13:48:42,13235.0,10,10476,6,13235.0,9,13240.0,10,S
2018-04-18 13:48:50,13235.0,10,10486,10,13235.0,4,13240.0,10,S
2018-04-18 13:48:52,13240.0,2,10488,2,13235.0,4,13240.0,11,B
2018-04-18 13:49:03,13235.0,4,10492,0,13235.0,1,13240.0,16,S
2018-04-18 13:49:05,13235.0,2,10494,2,13235.0,1,13240.0,16,S
2018-04-18 13:49:12,13235.0,2,10496,0,13230.0,20,13240.0,15,S
2018-04-18 13:49:29,13235.0,4,10500,4,13230.0,32,13235.0,1,S
2018-04-18 13:49:34,13235.0,2,10502,2,13230.0,32,13240.0,15,S
2018-04-18 13:49:37,13235.0,2,10504,0,13230.0,36,13240.0,15,S
2018-04-18 13:50:03,13235.0,2,10506,2,13230.0,37,13235.0,14,S
2018-04-18 13:50:03,13235.0,28,10534,4,13235.0,6,13240.0,28,S
2018-04-18 13:50:16,13235.0,6,10540,6,13235.0,10,13240.0,28,S
2018-04-18 13:50:26,13240.0,2,10542,2,13235.0,15,13240.0,27,B
2018-04-18 13:50:29,13240.0,10,10552,10,13235.0,16,13240.0,23,B
2018-04-18 13:50:30,13240.0,6,10558,6,13235.0,22,13240.0,20,B
2018-04-18 13:50:30,13240.0,12,10570,12,13235.0,22,13240.0,14,B
2018-04-18 13:50:51,13235.0,18,10588,16,13230.0,26,13235.0,4,S
2018-04-18 13:50:55,13235.0,2,10590,0,13230.0,34,13235.0,3,S
2018-04-18 13:50:57,13230.0,4,10594,0,13230.0,32,13235.0,3,S
2018-04-18 13:51:03,13230.0,4,10598,0,13230.0,30,13235.0,3,S
2018-04-18 13:51:15,13235.0,12,10610,12,13235.0,4,13240.0,22,B
2018-04-18 13:51:15,13235.0,8,10618,4,13230.0,7,13235.0,2,B
2018-04-18 13:51:30,13230.0,4,10622,4,13230.0,10,13235.0,2,S
2018-04-18 13:51:38,13230.0,4,10626,4,13230.0,7,13235.0,5,S
2018-04-18 13:51:51,13230.0,2,10628,0,13230.0,5,13235.0,9,S
2018-04-18 13:51:52,13230.0,10,10638,0,13225.0,26,13230.0,1,S
2018-04-18 13:52:10,13225.0,2,10640,0,13225.0,16,13230.0,4,S
2018-04-18 13:52:33,13225.0,4,10644,0,13225.0,14,13230.0,3,S
2018-04-18 13:52:40,13225.0,4,10648,0,13225.0,12,13230.0,3,S
2018-04-18 13:52:48,13225.0,4,10652,-4,13225.0,10,13230.0,3,S
2018-04-18 13:53:01,13225.0,20,10672,4,13220.0,11,13230.0,6,S
2018-04-18 13:53:03,13225.0,10,10682,8,13220.0,20,13230.0,5,S
2018-04-18 13:53:18,13230.0,4,10686,4,13225.0,6,13230.0,4,B
2018-04-18 13:53:35,13230.0,8,10694,2,13225.0,19,13235.0,7,B
2018-04-18 13:53:38,13235.0,2,10696,0,13230.0,7,13235.0,1,B
2018-04-18 13:53:44,13235.0,2,10698,0,13225.0,13,13235.0,11,B
2018-04-18 13:53:51,13230.0,12,10710,12,13225.0,21,13230.0,4,S
2018-04-18 13:54:07,13230.0,2,10712,2,13225.0,21,13230.0,4,S
2018-04-18 13:54:11,13230.0,2,10714,2,13225.0,21,13230.0,3,S
2018-04-18 13:54:17,13230.0,2,10716,2,13225.0,9,13230.0,2,S
2018-04-18 13:54:44,13225.0,18,10734,0,13220.0,14,13225.0,2,S
2018-04-18 13:54:54,13225.0,4,10738,0,13225.0,4,13230.0,2,S
2018-04-18 13:55:04,13225.0,2,10740,2,13225.0,3,13230.0,3,S
2018-04-18 13:55:20,13230.0,4,10744,4,13230.0,2,13235.0,7,B
2018-04-18 13:55:36,13230.0,2,10746,0,13225.0,12,13230.0,3,B
2018-04-18 13:55:37,13230.0,2,10748,-2,13225.0,17,13235.0,5,B
2018-04-18 13:55:49,13230.0,10,10758,10,13225.0,19,13230.0,5,B
2018-04-18 13:55:51,13230.0,2,10760,0,13225.0,18,13230.0,4,B
2018-04-18 13:55:56,13230.0,4,10764,4,13225.0,18,13230.0,2,B
2018-04-18 13:55:58,13230.0,2,10766,2,13225.0,18,13230.0,1,B
2018-04-18 13:55:59,13230.0,2,10768,0,13225.0,18,13235.0,2,B
2018-04-18 13:56:15,13235.0,2,10770,0,13235.0,1,13240.0,17,B
2018-04-18 13:56:42,13240.0,10,10780,0,13235.0,24,13240.0,8,B
2018-04-18 13:56:48,13240.0,2,10782,-2,13235.0,5,13240.0,11,B
2018-04-18 13:57:14,13240.0,2,10784,-2,13235.0,8,13240.0,11,B
2018-04-18 13:57:33,13240.0,10,10794,4,13235.0,21,13240.0,2,B
2018-04-18 13:57:34,13235.0,24,10818,22,13235.0,11,13245.0,8,S
2018-04-18 13:57:50,13245.0,4,10822,2,13240.0,18,13245.0,5,B
2018-04-18 13:58:10,13240.0,42,10864,32,13240.0,5,13250.0,36,S
2018-04-18 13:58:12,13245.0,10,10874,-4,13240.0,5,13245.0,24,B
2018-04-18 13:58:12,13240.0,10,10884,10,13235.0,7,13245.0,24,S
2018-04-18 13:58:49,13235.0,6,10890,2,13230.0,1,13240.0,16,S
2018-04-18 13:59:15,13240.0,64,10954,-12,13230.0,2,13240.0,1,B
2018-04-18 13:59:20,13235.0,2,10956,0,13230.0,2,13240.0,8,S
2018-04-18 14:00:00,13235.0,2,10958,2,13230.0,7,13235.0,4,S
2018-04-18 14:00:03,13235.0,2,10960,0,13230.0,8,13235.0,3,S
2018-04-18 14:00:03,13240.0,14,10974,12,13235.0,24,13240.0,19,B
2018-04-18 14:00:20,13235.0,6,10980,-6,13235.0,1,13240.0,21,S
2018-04-18 14:00:21,13235.0,2,10982,2,13230.0,7,13235.0,2,S
2018-04-18 14:00:24,13235.0,4,10986,0,13230.0,10,13240.0,24,S
2018-04-18 14:00:45,13235.0,2,10988,2,13230.0,8,13240.0,23,S
2018-04-18 14:01:09,13240.0,2,10990,0,13230.0,11,13240.0,18,B
2018-04-18 14:01:40,13230.0,6,10996,2,13225.0,10,13230.0,1,S
2018-04-18 14:02:01,13225.0,4,11000,0,13225.0,8,13230.0,15,S
2018-04-18 14:02:09,13225.0,2,11002,2,13225.0,7,13230.0,11,S
2018-04-18 14:02:12,13225.0,14,11016,-2,13220.0,2,13225.0,13,S
2018-04-18 14:02:14,13225.0,6,11022,-6,13220.0,8,13225.0,10,S
2018-04-18 14:02:19,13225.0,2,11024,0,13220.0,9,13225.0,9,S
2018-04-18 14:02:23,13225.0,2,11026,-2,13220.0,10,13225.0,8,S
2018-04-18 14:02:53,13220.0,6,11032,-6,13220.0,9,13225.0,4,S
2018-04-18 14:02:55,13220.0,10,11042,-6,13220.0,4,13225.0,4,S
2018-04-18 14:02:56,13220.0,4,11046,-2,13220.0,3,13225.0,4,S
2018-04-18 14:03:03,13230.0,10,11056,0,13225.0,3,13230.0,9,B
2018-04-18 14:03:24,13230.0,4,11060,0,13220.0,20,13230.0,7,B
2018-04-18 14:03:37,13225.0,8,11068,2,13220.0,21,13225.0,1,S
2018-04-18 14:03:38,13225.0,2,11070,0,13220.0,19,13230.0,12,S
2018-04-18 14:04:25,13220.0,8,11078,2,13215.0,11,13220.0,4,S
2018-04-18 14:04:36,13220.0,2,11080,2,13220.0,14,13225.0,7,S
2018-04-18 14:05:07,13225.0,2,11082,2,13220.0,4,13225.0,5,B
2018-04-18 14:05:07,13225.0,10,11092,8,13225.0,9,13230.0,17,B
2018-04-18 14:05:08,13225.0,2,11094,2,13220.0,2,13230.0,19,B
2018-04-18 14:05:18,13220.0,4,11098,0,13215.0,11,13225.0,11,S
2018-04-18 14:05:22,13220.0,2,11100,0,13220.0,2,13225.0,3,S
2018-04-18 14:05:34,13225.0,2,11102,2,13220.0,17,13225.0,4,B
2018-04-18 14:05:37,13225.0,8,11110,-6,13225.0,2,13230.0,17,B
2018-04-18 14:05:46,13225.0,2,11112,0,13225.0,1,13230.0,22,B
2018-04-18 14:05:47,13225.0,2,11114,0,13220.0,18,13230.0,22,B
2018-04-18 14:06:10,13230.0,16,11130,12,13225.0,4,13230.0,5,B
2018-04-18 14:06:11,13230.0,10,11140,6,13230.0,3,13235.0,9,B
2018-04-18 14:07:49,13230.0,8,11148,0,13225.0,3,13230.0,4,B
2018-04-18 14:08:05,13230.0,2,11150,0,13225.0,8,13230.0,3,B
2018-04-18 14:08:07,13230.0,4,11154,-2,13225.0,8,13230.0,1,B
2018-04-18 14:08:41,13235.0,16,11170,16,13235.0,12,13240.0,22,B
2018-04-18 14:08:45,13235.0,2,11172,2,13235.0,11,13240.0,29,B
2018-04-18 14:08:54,13240.0,20,11192,14,13235.0,11,13240.0,20,B
2018-04-18 14:09:27,13240.0,2,11194,-2,13235.0,11,13240.0,14,B
2018-04-18 14:09:37,13235.0,4,11198,4,13235.0,9,13240.0,14,S
2018-04-18 14:09:37,13235.0,2,11200,2,13235.0,8,13240.0,14,S
2018-04-18 14:09:57,13235.0,10,11210,0,13235.0,3,13240.0,19,S
2018-04-18 14:10:05,13240.0,2,11212,0,13235.0,3,13240.0,19,B
2018-04-18 14:10:20,13235.0,6,11218,0,13230.0,9,13240.0,19,S
2018-04-18 14:10:37,13235.0,2,11220,0,13230.0,9,13240.0,19,S
2018-04-18 14:11:05,13235.0,2,11222,0,13230.0,9,13240.0,20,S
2018-04-18 14:11:10,13235.0,2,11224,-2,13230.0,16,13240.0,12,S
2018-04-18 14:11:21,13230.0,2,11226,0,13230.0,9,13235.0,2,S
2018-04-18 14:11:23,13230.0,16,11242,8,13225.0,8,13230.0,1,S
2018-04-18 14:11:31,13225.0,10,11252,-6,13225.0,2,13230.0,12,S
2018-04-18 14:11:32,13230.0,6,11258,-2,13220.0,12,13230.0,11,B
2018-04-18 14:11:33,13220.0,2,11260,0,13220.0,11,13230.0,11,S
2018-04-18 14:11:36,13220.0,10,11270,0,13220.0,4,13225.0,25,S
2018-04-18 14:11:37,13220.0,8,11278,-8,13215.0,11,13225.0,25,S
2018-04-18 14:11:47,13220.0,2,11280,0,13220.0,4,13225.0,1,S
2018-04-18 14:11:53,13225.0,2,11282,2,13220.0,3,13225.0,1,B
2018-04-18 14:12:29,13225.0,2,11284,0,13220.0,13,13230.0,18,B
2018-04-18 14:12:33,13220.0,2,11286,2,13220.0,12,13230.0,13,S
2018-04-18 14:12:42,13220.0,8,11294,-6,13220.0,9,13230.0,12,S
2018-04-18 14:12:56,13220.0,10,11304,0,13220.0,4,13230.0,12,S
2018-04-18 14:12:58,13225.0,2,11306,2,13225.0,4,13230.0,12,B
2018-04-18 14:13:01,13225.0,2,11308,0,13225.0,3,13230.0,12,B
2018-04-18 14:13:05,13225.0,6,11314,2,13220.0,3,13225.0,3,B
2018-04-18 14:13:21,13220.0,2,11316,0,13220.0,3,13225.0,4,S
2018-04-18 14:13:47,13225.0,2,11318,-2,13220.0,3,13225.0,9,B
2018-04-18 14:13:48,13220.0,6,11324,-2,13215.0,14,13220.0,10,S
2018-04-18 14:13:49,13220.0,2,11326,0,13215.0,12,13225.0,14,S
2018-04-18 14:13:55,13215.0,6,11332,-2,13215.0,8,13220.0,16,S
2018-04-18 14:13:56,13215.0,6,11338,-6,13215.0,5,13220.0,16,S
2018-04-18 14:13:56,13215.0,2,11340,-2,13215.0,4,13220.0,16,S
2018-04-18 14:13:57,13220.0,2,11342,2,13215.0,4,13220.0,15,B
2018-04-18 14:14:13,13215.0,2,11344,-2,13215.0,3,13220.0,16,S
2018-04-18 14:14:15,13215.0,6,11350,-4,13210.0,24,13220.0,16,S
2018-04-18 14:14:21,13215.0,6,11356,0,13215.0,2,13220.0,16,S
2018-04-18 14:14:27,13220.0,2,11358,2,13215.0,5,13220.0,2,B
2018-04-18 14:14:48,13220.0,2,11360,2,13215.0,4,13220.0,2,B
2018-04-18 14:14:55,13215.0,8,11368,-4,13210.0,26,13215.0,4,S
2018-04-18 14:14:56,13215.0,8,11376,-8,13215.0,3,13220.0,4,S
2018-04-18 14:15:05,13215.0,2,11378,0,13215.0,7,13220.0,2,S
2018-04-18 14:15:44,13220.0,10,11388,2,13215.0,8,13220.0,4,B
2018-04-18 14:15:45,13220.0,4,11392,0,13215.0,8,13220.0,2,B
2018-04-18 14:15:46,13220.0,4,11396,4,13215.0,8,13225.0,9,B
2018-04-18 14:16:50,13225.0,4,11400,0,13220.0,15,13225.0,5,B
2018-04-18 14:18:17,13225.0,4,11404,0,13220.0,6,13225.0,4,B
2018-04-18 14:18:17,13225.0,8,11412,6,13225.0,5,13230.0,10,B
2018-04-18 14:18:32,13225.0,4,11416,0,13225.0,1,13230.0,9,B
2018-04-18 14:18:57,13225.0,4,11420,-2,13220.0,12,13230.0,9,B
2018-04-18 14:19:10,13215.0,52,11472,24,13210.0,27,13215.0,74,S
2018-04-18 14:19:10,13220.0,150,11622,10,13220.0,6,13225.0,1,B
2018-04-18 14:19:11,13220.0,8,11630,4,13215.0,15,13225.0,2,B
2018-04-18 14:19:11,13220.0,2,11632,-2,13215.0,8,13225.0,7,B
2018-04-18 14:19:13,13220.0,2,11634,2,13220.0,2,13225.0,7,B
2018-04-18 14:19:13,13220.0,4,11638,4,13215.0,7,13225.0,7,B
2018-04-18 14:19:20,13210.0,80,11718,28,13205.0,3,13210.0,60,S
2018-04-18 14:19:21,13215.0,122,11840,66,13215.0,1,13220.0,1,B
2018-04-18 14:19:22,13215.0,4,11844,4,13210.0,5,13220.0,3,B
2018-04-18 14:19:23,13215.0,2,11846,0,13210.0,5,13220.0,5,B
2018-04-18 14:19:41,13215.0,4,11850,0,13215.0,8,13220.0,7,B
2018-04-18 14:20:02,13220.0,2,11852,0,13215.0,18,13220.0,10,B
2018-04-18 14:20:05,13215.0,2,11854,2,13215.0,17,13220.0,10,S
2018-04-18 14:20:17,13220.0,2,11856,2,13215.0,17,13220.0,9,B
2018-04-18 14:20:29,13220.0,4,11860,4,13215.0,19,13220.0,3,B
2018-04-18 14:20:34,13220.0,4,11864,0,13215.0,19,13220.0,1,B
2018-04-18 14:20:34,13220.0,2,11866,2,13215.0,19,13225.0,19,B
2018-04-18 14:20:35,13220.0,2,11868,-2,13215.0,19,13225.0,19,B
2018-04-18 14:20:57,13220.0,2,11870,-2,13215.0,17,13220.0,2,B
2018-04-18 14:21:17,13220.0,2,11872,0,13215.0,17,13225.0,18,B
2018-04-18 14:21:18,13225.0,4,11876,4,13215.0,17,13225.0,18,B
2018-04-18 14:21:28,13215.0,2,11878,2,13215.0,18,13225.0,19,S
2018-04-18 14:21:57,13220.0,2,11880,0,13215.0,13,13225.0,20,B
2018-04-18 14:22:01,13220.0,2,11882,0,13215.0,13,13225.0,18,B
2018-04-18 14:22:10,13220.0,2,11884,0,13215.0,13,13225.0,20,B
2018-04-18 14:22:12,13220.0,2,11886,0,13215.0,13,13225.0,20,B
2018-04-18 14:22:18,13225.0,12,11898,10,13220.0,9,13225.0,4,B
2018-04-18 14:22:20,13225.0,8,11906,8,13220.0,9,13230.0,11,B
2018-04-18 14:22:51,13225.0,2,11908,-2,13220.0,37,13230.0,17,B
2018-04-18 14:23:28,13225.0,4,11912,0,13225.0,2,13230.0,10,B
2018-04-18 14:23:58,13230.0,2,11914,0,13225.0,2,13230.0,8,B
2018-04-18 14:24:04,13230.0,4,11918,0,13225.0,11,13230.0,6,B
2018-04-18 14:24:15,13230.0,4,11922,0,13225.0,11,13230.0,4,B
2018-04-18 14:24:16,13230.0,8,11930,0,13230.0,1,13235.0,9,B
2018-04-18 14:24:17,13235.0,4,11934,0,13230.0,15,13235.0,4,B
2018-04-18 14:24:22,13235.0,8,11942,0,13235.0,2,13240.0,25,B
2018-04-18 14:24:23,13235.0,4,11946,0,13230.0,3,13235.0,2,B
2018-04-18 14:24:28,13235.0,6,11952,0,13225.0,14,13235.0,3,B
2018-04-18 14:25:00,13235.0,2,11954,0,13230.0,5,13235.0,4,B
2018-04-18 14:25:00,13230.0,4,11958,0,13225.0,5,13235.0,3,S
2018-04-18 14:25:05,13240.0,10,11968,-2,13235.0,14,13240.0,17,B
2018-04-18 14:25:06,13240.0,34,12002,16,13240.0,3,13245.0,20,B
2018-04-18 14:25:06,13240.0,4,12006,-4,13235.0,3,13245.0,21,B
2018-04-18 14:25:17,13240.0,2,12008,2,13235.0,4,13245.0,22,B
2018-04-18 14:25:25,13240.0,8,12016,4,13235.0,2,13240.0,6,B
2018-04-18 14:25:32,13240.0,2,12018,2,13235.0,2,13240.0,4,B
2018-04-18 14:25:33,13235.0,2,12020,2,13230.0,3,13240.0,9,S
2018-04-18 14:25:35,13230.0,4,12024,4,13225.0,4,13235.0,26,S
2018-04-18 14:26:19,13230.0,12,12036,8,13230.0,1,13235.0,23,S
2018-04-18 14:26:20,13230.0,2,12038,2,13225.0,5,13235.0,25,S
2018-04-18 14:26:27,13230.0,6,12044,2,13225.0,2,13230.0,8,S
2018-04-18 14:26:28,13230.0,4,12048,4,13225.0,2,13230.0,6,S
2018-04-18 14:26:41,13225.0,6,12054,6,13220.0,34,13230.0,24,S
2018-04-18 14:26:58,13225.0,8,12062,-6,13225.0,1,13235.0,11,S
2018-04-18 14:27:40,13235.0,2,12064,-2,13230.0,5,13240.0,7,B
2018-04-18 14:27:45,13230.0,4,12068,4,13230.0,3,13240.0,10,S
2018-04-18 14:27:48,13230.0,2,12070,0,13230.0,2,13235.0,26,S
2018-04-18 14:27:49,13230.0,4,12074,4,13225.0,1,13235.0,27,S
2018-04-18 14:27:50,13235.0,2,12076,0,13225.0,1,13235.0,26,B
2018-04-18 14:28:08,13235.0,2,12078,0,13225.0,4,13235.0,4,B
2018-04-18 14:28:43,13235.0,2,12080,-2,13225.0,4,13235.0,6,B
2018-04-18 14:29:02,13225.0,2,12082,2,13225.0,3,13235.0,10,S
2018-04-18 14:29:27,13230.0,2,12084,0,13225.0,3,13230.0,21,B
2018-04-18 14:29:34,13225.0,6,12090,-4,13220.0,34,13230.0,22,S
2018-04-18 14:29:35,13225.0,2,12092,0,13220.0,34,13230.0,26,S
2018-04-18 14:29:43,13225.0,2,12094,0,13220.0,34,13230.0,10,S
2018-04-18 14:29:58,13225.0,2,12096,0,13225.0,4,13230.0,9,S
2018-04-18 14:30:03,13230.0,8,12104,-4,13230.0,2,13235.0,9,B
2018-04-18 14:30:18,13230.0,2,12106,-2,13225.0,6,13235.0,9,B
2018-04-18 14:30:40,13225.0,2,12108,-2,13220.0,40,13230.0,4,S
2018-04-18 14:30:55,13230.0,2,12110,0,13225.0,9,13235.0,13,B
2018-04-18 14:32:40,13230.0,2,12112,0,13225.0,7,13235.0,8,B
2018-04-18 14:32:52,13235.0,2,12114,0,13230.0,4,13235.0,1,B
2018-04-18 14:32:56,13235.0,2,12116,0,13230.0,1,13235.0,4,B
2018-04-18 14:33:01,13235.0,2,12118,2,13230.0,6,13240.0,14,B
2018-04-18 14:33:09,13230.0,4,12122,-2,13230.0,4,13240.0,13,S
2018-04-18 14:33:18,13235.0,4,12126,0,13235.0,21,13240.0,7,B
2018-04-18 14:33:19,13240.0,8,12134,2,13235.0,21,13240.0,3,B
2018-04-18 14:33:19,13240.0,6,12140,-2,13235.0,21,13245.0,22,B
2018-04-18 14:33:22,13240.0,4,12144,0,13240.0,1,13245.0,19,B
2018-04-18 14:33:36,13240.0,4,12148,-2,13240.0,18,13245.0,19,B
2018-04-18 14:33:36,13240.0,28,12176,-10,13240.0,4,13245.0,30,B
2018-04-18 14:33:37,13240.0,8,12184,-8,13230.0,4,13240.0,8,B
2018-04-18 14:33:55,13235.0,2,12186,0,13235.0,20,13240.0,7,S
2018-04-18 14:34:10,13240.0,2,12188,-2,13235.0,21,13240.0,20,B
2018-04-18 14:34:16,13235.0,2,12190,-2,13235.0,20,13240.0,19,S
2018-04-18 14:34:16,13235.0,2,12192,0,13235.0,19,13240.0,19,S
2018-04-18 14:34:29,13235.0,30,12222,-14,13235.0,4,13240.0,16,S
2018-04-18 14:34:29,13235.0,8,12230,-2,13230.0,2,13240.0,20,S
2018-04-18 14:34:37,13230.0,4,12234,-2,13225.0,2,13230.0,1,S
2018-04-18 14:34:38,13230.0,2,12236,-2,13225.0,8,13235.0,3,S
2018-04-18 14:34:45,13235.0,6,12242,0,13225.0,9,13240.0,17,B
2018-04-18 14:34:59,13235.0,2,12244,2,13230.0,10,13235.0,19,B
2018-04-18 14:35:09,13230.0,20,12264,0,13225.0,4,13235.0,19,S
2018-04-18 14:35:26,13225.0,6,12270,4,13220.0,36,13230.0,11,S
2018-04-18 14:35:45,13225.0,4,12274,-4,13220.0,38,13225.0,18,S
2018-04-18 14:35:46,13225.0,2,12276,-2,13220.0,38,13225.0,17,S
2018-04-18 14:35:54,13225.0,2,12278,-2,13220.0,38,13225.0,16,S
2018-04-18 14:35:59,13220.0,8,12286,0,13220.0,34,13225.0,16,S
2018-04-18 14:36:18,13220.0,32,12318,0,13220.0,13,13230.0,11,S
2018-04-18 14:36:25,13220.0,2,12320,2,13220.0,13,13225.0,4,S
2018-04-18 14:36:26,13220.0,2,12322,2,13220.0,12,13225.0,4,S
2018-04-18 14:36:35,13220.0,2,12324,0,13220.0,11,13225.0,9,S
2018-04-18 14:36:38,13220.0,6,12330,6,13220.0,8,13225.0,9,S
2018-04-18 14:36:40,13225.0,6,12336,-6,13220.0,8,13225.0,1,B
2018-04-18 14:36:46,13225.0,2,12338,-2,13220.0,8,13230.0,6,B
2018-04-18 14:37:00,13225.0,6,12344,-6,13220.0,8,13230.0,2,B
2018-04-18 14:37:14,13230.0,4,12348,-2,13225.0,6,13235.0,6,B
2018-04-18 14:37:34,13225.0,2,12350,0,13225.0,5,13235.0,12,S
2018-04-18 14:38:31,13220.0,2,12352,2,13220.0,12,13230.0,28,S
2018-04-18 14:38:34,13225.0,2,12354,0,13220.0,11,13225.0,1,B
2018-04-18 14:39:11,13220.0,2,12356,2,13220.0,6,13225.0,10,S
2018-04-18 14:39:29,13225.0,2,12358,0,13220.0,6,13225.0,10,B
2018-04-18 14:39:42,13220.0,8,12366,4,13220.0,2,13225.0,6,S
2018-04-18 14:39:43,13220.0,4,12370,-2,13215.0,17,13220.0,2,S
2018-04-18 14:39:44,13220.0,4,12374,0,13215.0,20,13225.0,7,S
2018-04-18 14:40:13,13220.0,4,12378,0,13215.0,14,13220.0,1,S
2018-04-18 14:41:26,13220.0,2,12380,0,13215.0,19,13220.0,4,S
2018-04-18 14:41:27,13220.0,4,12384,4,13215.0,19,13220.0,2,S
2018-04-18 14:41:27,13220.0,4,12388,4,13215.0,19,13225.0,9,S
2018-04-18 14:41:28,13215.0,20,12408,0,13215.0,9,13225.0,9,S
2018-04-18 14:41:29,13215.0,2,12410,0,13220.0,1,13225.0,9,S
2018-04-18 14:41:57,13225.0,8,12418,6,13220.0,11,13225.0,4,B
2018-04-18 14:42:22,13220.0,2,12420,0,13220.0,9,13225.0,4,S
2018-04-18 14:42:23,13225.0,8,12428,8,13225.0,1,13230.0,14,B
2018-04-18 14:42:23,13225.0,2,12430,0,13220.0,9,13230.0,14,B
2018-04-18 14:42:55,13220.0,2,12432,0,13220.0,11,13225.0,1,S
2018-04-18 14:44:06,13225.0,6,12438,-4,13220.0,6,13225.0,2,B
2018-04-18 14:45:01,13225.0,2,12440,-2,13220.0,8,13225.0,1,B
2018-04-18 14:45:05,13225.0,2,12442,0,13225.0,1,13230.0,17,B
2018-04-18 14:45:06,13225.0,2,12444,-2,13220.0,8,13230.0,15,B
2018-04-18 14:45:35,13225.0,2,12446,0,13220.0,5,13225.0,8,B
2018-04-18 14:45:56,13225.0,2,12448,2,13225.0,4,13230.0,24,B
2018-04-18 14:46:29,13230.0,8,12456,8,13225.0,6,13230.0,23,B
2018-04-18 14:46:38,13230.0,16,12472,-4,13225.0,6,13230.0,17,B
2018-04-18 14:46:42,13230.0,16,12488,4,13225.0,5,13230.0,14,B
2018-04-18 14:46:42,13225.0,10,12498,4,13220.0,6,13225.0,2,S
2018-04-18 14:46:43,13225.0,10,12508,-6,13220.0,6,13230.0,15,S
2018-04-18 14:46:44,13225.0,2,12510,-2,13220.0,7,13230.0,9,S
2018-04-18 14:46:53,13220.0,8,12518,0,13220.0,2,13230.0,13,S
2018-04-18 14:46:57,13225.0,4,12522,2,13220.0,2,13230.0,13,B
2018-04-18 14:47:10,13230.0,2,12524,0,13220.0,2,13230.0,12,B
2018-04-18 14:47:11,13230.0,2,12526,2,13220.0,2,13230.0,11,B
2018-04-18 14:49:14,13225.0,6,12532,-6,13220.0,9,13225.0,5,S
2018-04-18 14:49:14,13225.0,10,12542,0,13220.0,9,13230.0,10,S
2018-04-18 14:49:20,13230.0,2,12544,0,13220.0,8,13230.0,11,B
2018-04-18 14:49:39,13230.0,10,12554,-10,13220.0,5,13230.0,19,B
2018-04-18 14:51:38,13230.0,2,12556,0,13225.0,6,13230.0,12,B
2018-04-18 14:51:42,13225.0,2,12558,0,13225.0,5,13230.0,12,S
2018-04-18 14:51:42,13230.0,2,12560,0,13225.0,5,13230.0,11,B
2018-04-18 14:52:17,13230.0,20,12580,10,13225.0,5,13230.0,2,B
2018-04-18 14:52:26,13230.0,4,12584,4,13230.0,3,13235.0,13,B
2018-04-18 14:52:33,13235.0,8,12592,-2,13230.0,3,13235.0,7,B
2018-04-18 14:52:43,13235.0,12,12604,10,13230.0,3,13235.0,2,B
2018-04-18 14:52:45,13235.0,2,12606,-2,13230.0,3,13235.0,1,B
2018-04-18 14:52:53,13235.0,2,12608,0,13230.0,4,13240.0,14,B
2018-04-18 14:53:04,13235.0,4,12612,2,13230.0,9,13235.0,3,B
2018-04-18 14:53:04,13235.0,6,12618,0,13230.0,9,13240.0,13,B
2018-04-18 14:53:06,13235.0,2,12620,-2,13230.0,9,13235.0,7,B
2018-04-18 14:53:31,13235.0,2,12622,-2,13230.0,10,13235.0,12,B
2018-04-18 14:53:38,13235.0,18,12640,-2,13230.0,8,13235.0,3,B
2018-04-18 14:53:46,13235.0,4,12644,0,13230.0,8,13235.0,1,B
2018-04-18 14:53:48,13235.0,2,12646,0,13230.0,9,13240.0,15,B
2018-04-18 14:54:12,13235.0,2,12648,0,13230.0,65,13235.0,1,B
2018-04-18 14:54:12,13235.0,2,12650,-2,13230.0,65,13240.0,29,B
2018-04-18 14:54:26,13235.0,8,12658,8,13230.0,66,13235.0,6,B
2018-04-18 14:54:27,13235.0,12,12670,8,13235.0,2,13240.0,15,B
2018-04-18 14:54:39,13235.0,20,12690,-20,13230.0,67,13240.0,14,B
2018-04-18 14:55:32,13235.0,4,12694,-4,13235.0,14,13240.0,13,B
2018-04-18 14:55:34,13235.0,6,12700,-6,13235.0,10,13240.0,16,B
2018-04-18 14:56:05,13235.0,2,12702,-2,13235.0,8,13240.0,25,B
2018-04-18 14:56:05,13235.0,2,12704,0,13235.0,7,13240.0,25,B
2018-04-18 14:56:21,13235.0,2,12706,0,13235.0,6,13240.0,25,B
2018-04-18 14:56:28,13235.0,2,12708,-2,13235.0,5,13240.0,26,B
2018-04-18 14:56:30,13240.0,2,12710,0,13235.0,5,13240.0,25,B
2018-04-18 14:56:30,13240.0,6,12716,6,13235.0,5,13240.0,22,B
2018-04-18 14:56:33,13235.0,2,12718,-2,13235.0,4,13240.0,22,S
2018-04-18 14:56:35,13235.0,8,12726,-2,13230.0,63,13235.0,2,S
2018-04-18 14:56:36,13235.0,2,12728,0,13230.0,63,13235.0,1,S
2018-04-18 14:56:48,13235.0,6,12734,6,13230.0,63,13235.0,4,S
2018-04-18 14:57:00,13235.0,10,12744,8,13235.0,5,13240.0,23,S
2018-04-18 14:57:01,13240.0,16,12760,2,13230.0,63,13235.0,2,B
2018-04-18 14:57:01,13235.0,4,12764,-4,13230.0,63,13240.0,30,S
2018-04-18 14:57:02,13240.0,10,12774,0,13230.0,63,13240.0,25,B
2018-04-18 14:57:11,13240.0,4,12778,2,13230.0,63,13240.0,46,B
2018-04-18 14:57:27,13230.0,10,12788,0,13230.0,58,13235.0,10,S
2018-04-18 14:57:27,13235.0,2,12790,2,13230.0,58,13235.0,9,B
2018-04-18 14:57:33,13235.0,6,12796,6,13230.0,58,13235.0,6,B
2018-04-18 14:57:45,13230.0,10,12806,0,13230.0,53,13235.0,13,S
2018-04-18 14:57:46,13230.0,10,12816,0,13230.0,48,13235.0,14,S
2018-04-18 14:57:53,13230.0,10,12826,0,13230.0,43,13235.0,15,S
2018-04-18 14:58:00,13230.0,10,12836,0,13230.0,38,13235.0,22,S
2018-04-18 14:58:03,13235.0,2,12838,2,13230.0,38,13235.0,14,B
2018-04-18 14:58:08,13230.0,8,12846,-8,13230.0,34,13235.0,14,S
2018-04-18 14:58:09,13235.0,4,12850,0,13230.0,34,13235.0,12,B
2018-04-18 14:58:22,13230.0,10,12860,0,13230.0,29,13235.0,23,S
2018-04-18 14:58:24,13230.0,10,12870,0,13230.0,24,13235.0,33,S
2018-04-18 14:58:41,13235.0,2,12872,0,13230.0,24,13235.0,57,B
2018-04-18 14:59:00,13235.0,6,12878,-2,13230.0,24,13235.0,81,B
2018-04-18 14:59:08,13230.0,2,12880,0,13230.0,23,13235.0,81,S
2018-04-18 14:59:09,13230.0,10,12890,0,13230.0,18,13235.0,81,S
2018-04-18 14:59:12,13230.0,2,12892,0,13230.0,17,13235.0,80,S
2018-04-18 14:59:14,13230.0,2,12894,-2,13230.0,16,13235.0,78,S
2018-04-18 14:59:17,13230.0,20,12914,-20,13230.0,6,13235.0,78,S
2018-04-18 14:59:18,13230.0,12,12926,4,13225.0,1,13235.0,78,S
2018-04-18 14:59:19,13230.0,4,12930,-2,13225.0,4,13230.0,4,S
2018-04-18 14:59:29,13230.0,20,12950,0,13225.0,4,13230.0,11,S
2018-04-18 14:59:29,13230.0,10,12960,4,13225.0,4,13230.0,6,S
2018-04-18 14:59:30,13225.0,12,12972,-2,13225.0,3,13230.0,1,S
2018-04-18 14:59:30,13230.0,2,12974,2,13225.0,3,13235.0,77,B
2018-04-18 14:59:41,13235.0,4,12978,0,13225.0,4,13235.0,75,B
2018-04-18 14:59:48,13225.0,2,12980,-2,13225.0,4,13235.0,75,S
2018-04-18 14:59:54,13235.0,2,12982,0,13225.0,2,13235.0,73,B
2018-04-18 20:59:00,13260.0,90,90,67874,0.0,0,0.0,0,B
2018-04-18 21:00:00,13285.0,14,104,6,13280.0,9,13290.0,3,B
2018-04-18 21:00:01,13295.0,30,134,24,13295.0,8,13305.0,1,B
2018-04-18 21:00:01,13305.0,8,142,-2,13305.0,18,13315.0,1,B
2018-04-18 21:00:02,13315.0,26,168,2,13310.0,13,13330.0,3,B
2018-04-18 21:00:02,13320.0,12,180,8,13320.0,5,13335.0,1,B
2018-04-18 21:00:03,13320.0,2,182,0,13325.0,6,13335.0,1,B
2018-04-18 21:00:03,13315.0,22,204,16,13315.0,4,13325.0,1,S
2018-04-18 21:00:04,13335.0,8,212,2,13315.0,4,13345.0,2,B
2018-04-18 21:00:05,13345.0,12,224,-4,13325.0,4,13345.0,20,B
2018-04-18 21:00:05,13325.0,8,232,-6,13315.0,1,13325.0,1,S
2018-04-18 21:00:06,13325.0,2,234,-2,13330.0,1,13340.0,5,S
2018-04-18 21:00:06,13330.0,2,236,-2,13315.0,3,13335.0,1,B
2018-04-18 21:00:07,13315.0,4,240,4,13315.0,1,13320.0,2,S
2018-04-18 21:00:07,13320.0,6,246,-4,13320.0,1,13340.0,14,B
2018-04-18 21:00:08,13320.0,4,250,-4,13320.0,1,13330.0,6,B
2018-04-18 21:00:08,13320.0,40,290,-14,13315.0,4,13340.0,8,B
2018-04-18 21:00:09,13320.0,2,292,0,13315.0,4,13325.0,1,B
2018-04-18 21:00:09,13315.0,2,294,0,13315.0,3,13325.0,2,S
2018-04-18 21:00:10,13315.0,10,304,-4,13310.0,4,13315.0,1,S
2018-04-18 21:00:10,13310.0,4,308,-2,13310.0,5,13315.0,1,S
2018-04-18 21:00:11,13315.0,2,310,0,13310.0,4,13325.0,1,B
2018-04-18 21:00:11,13325.0,4,314,-4,13310.0,4,13330.0,11,B
2018-04-18 21:00:12,13310.0,4,318,0,13310.0,4,13325.0,7,S
2018-04-18 21:00:13,13310.0,2,320,0,13305.0,1,13310.0,1,S
2018-04-18 21:00:13,13325.0,12,332,2,13305.0,1,13325.0,1,B
2018-04-18 21:00:15,13330.0,12,344,4,13320.0,1,13330.0,10,B
2018-04-18 21:00:15,13310.0,12,356,0,13315.0,20,13320.0,1,S
2018-04-18 21:00:16,13320.0,54,410,12,13305.0,1,13320.0,1,B
2018-04-18 21:00:17,13320.0,2,412,-2,13315.0,5,13320.0,4,B
2018-04-18 21:00:18,13320.0,18,430,-8,13315.0,1,13320.0,6,B
2018-04-18 21:00:18,13320.0,6,436,-2,13305.0,3,13320.0,4,B
2018-04-18 21:00:20,13320.0,2,438,0,13305.0,3,13310.0,4,B
2018-04-18 21:00:21,13310.0,2,440,-2,13305.0,3,13310.0,8,S
2018-04-18 21:00:22,13305.0,6,446,-2,13305.0,2,13315.0,6,S
2018-04-18 21:00:23,13310.0,2,448,0,13305.0,2,13310.0,1,B
2018-04-18 21:00:23,13310.0,4,452,-2,13305.0,1,13310.0,5,B
2018-04-18 21:00:25,13305.0,2,454,-2,13305.0,4,13310.0,6,S
2018-04-18 21:00:26,13305.0,2,456,-2,13305.0,3,13310.0,12,S
2018-04-18 21:00:26,13305.0,2,458,-2,13305.0,2,13310.0,13,S
2018-04-18 21:00:27,13310.0,6,464,0,13305.0,2,13310.0,3,B
2018-04-18 21:00:28,13305.0,2,466,-2,13305.0,2,13310.0,1,S
2018-04-18 21:00:29,13305.0,2,468,0,13305.0,1,13310.0,1,S
2018-04-18 21:00:30,13305.0,2,470,0,13300.0,2,13305.0,1,S
2018-04-18 21:00:31,13305.0,2,472,-2,13300.0,4,13310.0,7,S
2018-04-18 21:00:33,13300.0,2,474,0,13300.0,5,13305.0,4,S
2018-04-18 21:00:36,13305.0,10,484,0,13300.0,5,13310.0,14,B
2018-04-18 21:00:37,13305.0,4,488,4,13300.0,3,13305.0,3,B
2018-04-18 21:00:38,13335.0,104,592,-70,13300.0,2,13340.0,10,B
2018-04-18 21:00:39,13300.0,2,594,0,13300.0,14,13310.0,7,S
2018-04-18 21:00:40,13310.0,2,596,2,13300.0,2,13310.0,9,B
2018-04-18 21:00:41,13305.0,4,600,0,13300.0,3,13305.0,6,S
2018-04-18 21:00:42,13310.0,12,612,2,13305.0,1,13310.0,5,B
2018-04-18 21:00:42,13310.0,2,614,2,13300.0,3,13310.0,4,B
2018-04-18 21:00:43,13310.0,6,620,-4,13305.0,1,13310.0,2,B
2018-04-18 21:00:44,13305.0,2,622,0,13300.0,3,13310.0,2,S
2018-04-18 21:00:46,13310.0,2,624,2,13305.0,1,13310.0,2,B
2018-04-18 21:00:46,13310.0,4,628,-2,13310.0,2,13320.0,1,B
2018-04-18 21:00:47,13310.0,4,632,0,13305.0,1,13315.0,7,B
2018-04-18 21:00:48,13310.0,20,652,-6,13305.0,1,13315.0,12,B
2018-04-18 21:00:48,13305.0,2,654,2,13300.0,3,13310.0,1,S
2018-04-18 21:00:49,13305.0,8,662,-2,13300.0,3,13310.0,13,S
2018-04-18 21:00:51,13300.0,4,666,4,13300.0,3,13305.0,12,S
2018-04-18 21:00:52,13300.0,2,668,-2,13300.0,2,13305.0,12,S
2018-04-18 21:00:53,13305.0,32,700,16,13305.0,7,13310.0,7,B
2018-04-18 21:00:54,13305.0,22,722,12,13305.0,18,13310.0,9,B
2018-04-18 21:00:54,13305.0,36,758,-12,13295.0,4,13310.0,9,B
2018-04-18 21:00:55,13305.0,2,760,0,13295.0,4,13310.0,9,B
2018-04-18 21:00:57,13305.0,8,768,8,13295.0,4,13305.0,7,B
2018-04-18 21:00:58,13305.0,2,770,0,13295.0,4,13305.0,6,B
2018-04-18 21:00:59,13300.0,12,782,2,13275.0,16,13300.0,20,S
2018-04-18 21:00:59,13285.0,2,784,0,13285.0,3,13300.0,2,S
2018-04-18 21:01:01,13305.0,18,802,-4,13295.0,4,13305.0,4,B
2018-04-18 21:01:01,13295.0,2,804,2,13295.0,1,13310.0,4,S
2018-04-18 21:01:03,13300.0,2,806,2,13295.0,3,13305.0,2,B
2018-04-18 21:01:05,13305.0,4,810,0,13305.0,8,13310.0,7,B
2018-04-18 21:01:05,13305.0,16,826,-6,13295.0,3,13300.0,1,B
2018-04-18 21:01:07,13300.0,2,828,-2,13300.0,4,13305.0,1,S
2018-04-18 21:01:08,13305.0,2,830,2,13305.0,1,13310.0,9,B
2018-04-18 21:01:09,13305.0,2,832,0,13305.0,2,13310.0,9,B
2018-04-18 21:01:09,13305.0,6,838,0,13305.0,4,13310.0,17,B
2018-04-18 21:01:10,13305.0,4,842,0,13305.0,2,13310.0,17,B
2018-04-18 21:01:11,13305.0,2,844,-2,13305.0,1,13310.0,19,B
2018-04-18 21:01:11,13305.0,2,846,-2,13300.0,5,13305.0,1,B
2018-04-18 21:01:12,13305.0,6,852,-2,13305.0,6,13310.0,18,B
2018-04-18 21:01:13,13305.0,4,856,-2,13305.0,3,13310.0,15,B
2018-04-18 21:01:13,13305.0,2,858,-2,13305.0,2,13310.0,15,B
2018-04-18 21:01:16,13305.0,8,866,4,13295.0,2,13305.0,1,B
2018-04-18 21:01:20,13310.0,2,868,2,13305.0,2,13310.0,15,B
2018-04-18 21:01:21,13305.0,6,874,-4,13295.0,3,13305.0,7,S
2018-04-18 21:01:22,13305.0,8,882,-8,13300.0,1,13305.0,4,S
2018-04-18 21:01:23,13305.0,2,884,-2,13300.0,6,13305.0,3,S
2018-04-18 21:01:24,13305.0,2,886,-2,13295.0,3,13305.0,4,S
2018-04-18 21:01:25,13295.0,10,896,-8,13295.0,3,13300.0,1,S
2018-04-18 21:01:27,13300.0,2,898,-2,13300.0,4,13305.0,4,B
2018-04-18 21:01:28,13295.0,4,902,-4,13295.0,6,13305.0,4,S
2018-04-18 21:01:31,13300.0,2,904,2,13295.0,6,13305.0,5,B
2018-04-18 21:01:36,13295.0,6,910,-6,13295.0,5,13305.0,3,S
2018-04-18 21:01:39,13295.0,10,920,-4,13295.0,2,13305.0,3,S
2018-04-18 21:01:48,13295.0,4,924,0,13295.0,14,13305.0,4,S
2018-04-18 21:01:48,13305.0,8,932,-4,13305.0,3,13310.0,21,B
2018-04-18 21:01:52,13305.0,4,936,0,13305.0,4,13310.0,19,B
2018-04-18 21:01:54,13305.0,6,942,-2,13305.0,3,13310.0,19,B
2018-04-18 21:01:59,13305.0,6,948,0,13300.0,2,13305.0,2,B
2018-04-18 21:01:59,13305.0,4,952,-4,13300.0,4,13310.0,19,B
2018-04-18 21:02:00,13310.0,2,954,2,13305.0,4,13310.0,18,B
2018-04-18 21:02:00,13305.0,16,970,0,13300.0,7,13305.0,4,S
2018-04-18 21:02:01,13305.0,8,978,0,13300.0,7,13310.0,18,S
2018-04-18 21:02:03,13300.0,10,988,-4,13300.0,7,13310.0,18,S
2018-04-18 21:02:06,13310.0,4,992,-2,13305.0,1,13310.0,16,B
2018-04-18 21:02:06,13310.0,32,1024,14,13310.0,34,13315.0,2,B
2018-04-18 21:02:07,13315.0,4,1028,-2,13310.0,35,13320.0,3,B
2018-04-18 21:02:10,13315.0,2,1030,0,13310.0,35,13315.0,3,B
2018-04-18 21:02:12,13315.0,12,1042,4,13310.0,35,13315.0,3,B
2018-04-18 21:02:13,13315.0,4,1046,-4,13310.0,35,13315.0,1,B
2018-04-18 21:02:13,13315.0,6,1052,0,13315.0,3,13320.0,3,B
2018-04-18 21:02:18,13315.0,2,1054,0,13315.0,3,13320.0,3,B
2018-04-18 21:02:20,13310.0,2,1056,0,13315.0,3,13320.0,3,S
2018-04-18 21:02:22,13315.0,8,1064,8,13315.0,3,13320.0,3,B
2018-04-18 21:02:29,13315.0,2,1066,0,13315.0,3,13320.0,3,B
2018-04-18 21:02:31,13320.0,26,1092,18,13315.0,3,13320.0,3,B
2018-04-18 21:02:32,13315.0,2,1094,0,13315.0,3,13320.0,3,S
2018-04-18 21:02:34,13310.0,6,1100,6,13315.0,3,13320.0,3,S
2018-04-18 21:02:35,13310.0,2,1102,2,13315.0,3,13320.0,3,S
2018-04-18 21:02:35,13310.0,2,1104,0,13315.0,3,13320.0,3,S
2018-04-18 21:02:36,13310.0,4,1108,2,13315.0,3,13320.0,3,S
2018-04-18 21:02:39,13310.0,4,1112,4,13315.0,3,13320.0,3,S
2018-04-18 21:02:41,13310.0,2,1114,0,13315.0,3,13320.0,3,S
2018-04-18 21:02:42,13315.0,2,1116,0,13315.0,3,13320.0,3,B
2018-04-18 21:02:43,13310.0,4,1120,2,13315.0,3,13320.0,3,S
2018-04-18 21:02:45,13315.0,8,1128,0,13315.0,3,13320.0,3,B
2018-04-18 21:02:48,13310.0,4,1132,4,13315.0,3,13320.0,3,S
2018-04-18 21:02:49,13310.0,10,1142,0,13315.0,3,13320.0,3,S
2018-04-18 21:02:50,13315.0,2,1144,2,13315.0,3,13320.0,3,B
2018-04-18 21:02:51,13315.0,2,1146,2,13315.0,3,13320.0,3,B
2018-04-18 21:02:52,13310.0,2,1148,2,13315.0,3,13320.0,3,S
2018-04-18 21:02:53,13310.0,2,1150,2,13315.0,3,13320.0,3,S
2018-04-18 21:02:55,13315.0,2,1152,2,13315.0,3,13320.0,3,B
2018-04-18 21:02:59,13315.0,10,1162,4,13315.0,3,13320.0,3,B
2018-04-18 21:03:00,13310.0,2,1164,0,13315.0,3,13320.0,3,S
2018-04-18 21:03:00,13310.0,4,1168,0,13315.0,3,13320.0,3,S
2018-04-18 21:03:01,13310.0,12,1180,0,13315.0,3,13320.0,3,S
2018-04-18 21:03:01,13310.0,16,1196,16,13315.0,3,13320.0,3,S
2018-04-18 21:03:02,13310.0,4,1200,4,13315.0,3,13320.0,3,S
2018-04-18 21:03:06,13305.0,8,1208,0,13315.0,3,13320.0,3,S
2018-04-18 21:03:06,13305.0,2,1210,-2,13315.0,3,13320.0,3,S
2018-04-18 21:03:09,13305.0,6,1216,6,13315.0,3,13320.0,3,S
2018-04-18 21:03:12,13305.0,2,1218,0,13315.0,3,13320.0,3,S
2018-04-18 21:03:13,13300.0,4,1222,-4,13315.0,3,13320.0,3,S
2018-04-18 21:03:14,13300.0,4,1226,-4,13315.0,3,13320.0,3,S
2018-04-18 21:03:15,13305.0,2,1228,0,13315.0,3,13320.0,3,B
2018-04-18 21:03:16,13305.0,2,1230,2,13315.0,3,13320.0,3,B
2018-04-18 21:03:17,13305.0,2,1232,2,13315.0,3,13320.0,3,B
2018-04-18 21:03:18,13305.0,2,1234,2,13315.0,3,13320.0,3,B
2018-04-18 21:03:29,13300.0,2,1236,-2,13300.0,6,13305.0,6,S
2018-04-18 21:03:30,13300.0,2,1238,-2,13300.0,9,13305.0,6,S
2018-04-18 21:03:38,13300.0,2,1240,-2,13300.0,8,13305.0,3,S
2018-04-18 21:03:40,13300.0,2,1242,0,13295.0,5,13305.0,3,S
2018-04-18 21:03:45,13300.0,2,1244,0,13300.0,5,13305.0,4,S
2018-04-18 21:03:51,13300.0,4,1248,2,13295.0,10,13300.0,9,S
2018-04-18 21:03:51,13300.0,2,1250,0,13295.0,10,13300.0,8,S
2018-04-18 21:03:52,13295.0,4,1254,0,13295.0,8,13300.0,8,S
2018-04-18 21:03:53,13300.0,16,1270,10,13295.0,14,13305.0,1,B
2018-04-18 21:03:59,13305.0,2,1272,2,13305.0,8,13310.0,4,B
2018-04-18 21:04:00,13310.0,8,1280,2,13305.0,5,13315.0,4,B
2018-04-18 21:04:01,13305.0,2,1282,0,13305.0,8,13310.0,1,S
2018-04-18 21:04:07,13305.0,2,1284,-2,13300.0,5,13310.0,3,S
2018-04-18 21:04:10,13305.0,2,1286,2,13305.0,1,13310.0,5,S
2018-04-18 21:04:17,13310.0,12,1298,-4,13305.0,56,13315.0,6,B
2018-04-18 21:04:18,13305.0,2,1300,0,13305.0,54,13315.0,8,S
2018-04-18 21:04:22,13310.0,16,1316,6,13305.0,53,13310.0,42,B
2018-04-18 21:04:23,13310.0,4,1320,0,13305.0,54,13310.0,40,B
2018-04-18 21:04:23,13310.0,16,1336,8,13305.0,54,13310.0,33,B
2018-04-18 21:04:24,13310.0,40,1376,20,13305.0,54,13310.0,13,B
2018-04-18 21:04:24,13310.0,26,1402,24,13310.0,3,13315.0,13,B
2018-04-18 21:04:25,13315.0,2,1404,0,13310.0,9,13315.0,12,B
2018-04-18 21:04:26,13310.0,2,1406,2,13310.0,2,13315.0,12,S
2018-04-18 21:04:28,13315.0,14,1420,-2,13310.0,3,13315.0,5,B
2018-04-18 21:04:32,13310.0,2,1422,-2,13310.0,3,13315.0,6,S
2018-04-18 21:04:33,13315.0,12,1434,-2,13310.0,6,13315.0,1,B
2018-04-18 21:04:34,13315.0,2,1436,2,13310.0,6,13315.0,1,B
2018-04-18 21:04:37,13315.0,2,1438,-2,13315.0,4,13320.0,18,B
2018-04-18 21:04:38,13315.0,8,1446,-8,13310.0,6,13315.0,6,B
2018-04-18 21:04:40,13310.0,2,1448,0,13310.0,5,13315.0,4,S
2018-04-18 21:04:42,13310.0,4,1452,0,13305.0,50,13310.0,1,S
2018-04-18 21:04:48,13310.0,6,1458,4,13305.0,53,13310.0,8,S
2018-04-18 21:04:50,13310.0,2,1460,2,13305.0,55,13310.0,7,S
2018-04-18 21:04:51,13305.0,20,1480,20,13305.0,45,13310.0,7,S
2018-04-18 21:04:53,13310.0,2,1482,2,13305.0,45,13310.0,7,B
2018-04-18 21:04:55,13310.0,12,1494,12,13305.0,46,13310.0,6,B
2018-04-18 21:04:55,13310.0,12,1506,10,13310.0,6,13315.0,13,B
2018-04-18 21:04:56,13315.0,12,1518,-4,13310.0,12,13315.0,7,B
2018-04-18 21:04:57,13315.0,14,1532,10,13315.0,4,13320.0,10,B
2018-04-18 21:05:00,13315.0,6,1538,-2,13310.0,18,13315.0,3,B
2018-04-18 21:05:02,13315.0,4,1542,2,13315.0,2,13320.0,10,B
2018-04-18 21:05:03,13315.0,4,1546,-2,13315.0,8,13320.0,10,B
2018-04-18 21:05:04,13320.0,2,1548,2,13315.0,13,13320.0,9,B
2018-04-18 21:05:07,13320.0,18,1566,-2,13320.0,11,13325.0,4,B
2018-04-18 21:05:10,13320.0,24,1590,2,13315.0,12,13320.0,8,B
2018-04-18 21:05:12,13320.0,2,1592,2,13315.0,12,13320.0,8,B
2018-04-18 21:05:13,13320.0,14,1606,12,13315.0,12,13320.0,8,B
2018-04-18 21:05:14,13325.0,4,1610,4,13315.0,12,13320.0,8,B
2018-04-18 21:05:14,13325.0,4,1614,0,13315.0,12,13320.0,8,B
2018-04-18 21:05:15,13325.0,2,1616,0,13315.0,12,13320.0,8,B
2018-04-18 21:05:16,13330.0,2,1618,0,13315.0,12,13320.0,8,B
2018-04-18 21:05:17,13330.0,2,1620,-2,13315.0,12,13320.0,8,B
2018-04-18 21:05:18,13330.0,4,1624,0,13315.0,12,13320.0,8,B
2018-04-18 21:05:21,13335.0,4,1628,4,13315.0,12,13320.0,8,B
2018-04-18 21:05:21,13340.0,2,1630,0,13315.0,12,13320.0,8,B
2018-04-18 21:05:23,13340.0,6,1636,2,13315.0,12,13320.0,8,B
2018-04-18 21:05:23,13345.0,12,1648,10,13315.0,12,13320.0,8,B
2018-04-18 21:05:24,13345.0,40,1688,36,13315.0,12,13320.0,8,B
2018-04-18 21:05:24,13355.0,120,1808,76,13315.0,12,13320.0,8,B
2018-04-18 21:05:25,13355.0,12,1820,-2,13315.0,12,13320.0,8,B
2018-04-18 21:05:25,13350.0,8,1828,4,13315.0,12,13320.0,8,S
2018-04-18 21:05:27,13355.0,2,1830,0,13315.0,12,13320.0,8,B
2018-04-18 21:05:29,13355.0,2,1832,-2,13315.0,12,13320.0,8,B
2018-04-18 21:05:29,13355.0,2,1834,0,13315.0,12,13320.0,8,B
2018-04-18 21:05:30,13355.0,2,1836,0,13315.0,12,13320.0,8,B
2018-04-18 21:05:32,13360.0,2,1838,0,13315.0,12,13320.0,8,B
2018-04-18 21:05:32,13360.0,2,1840,-2,13315.0,12,13320.0,8,B
2018-04-18 21:05:33,13360.0,2,1842,2,13315.0,12,13320.0,8,B
2018-04-18 21:05:34,13370.0,6,1848,6,13315.0,12,13320.0,8,B
2018-04-18 21:05:34,13365.0,16,1864,0,13315.0,12,13320.0,8,S
2018-04-18 21:05:35,13360.0,2,1866,2,13315.0,12,13320.0,8,S
2018-04-18 21:05:37,13370.0,4,1870,-4,13315.0,12,13320.0,8,B
2018-04-18 21:05:37,13370.0,4,1874,-4,13315.0,12,13320.0,8,B
2018-04-18 21:05:38,13370.0,2,1876,-2,13315.0,12,13320.0,8,B
2018-04-18 21:05:38,13385.0,6,1882,6,13315.0,12,13320.0,8,B
2018-04-18 21:05:39,13370.0,6,1888,4,13315.0,12,13320.0,8,S
2018-04-18 21:05:40,13380.0,2,1890,0,13315.0,12,13320.0,8,B
2018-04-18 21:05:41,13380.0,12,1902,-6,13315.0,12,13320.0,8,B
2018-04-18 21:05:42,13380.0,2,1904,-2,13315.0,12,13320.0,8,B
2018-04-18 21:05:43,13380.0,4,1908,-4,13315.0,12,13320.0,8,B
2018-04-18 21:05:44,13385.0,16,1924,0,13315.0,12,13320.0,8,B
2018-04-18 21:05:45,13395.0,10,1934,-2,13315.0,12,13320.0,8,B
2018-04-18 21:05:45,13410.0,48,1982,18,13315.0,12,13320.0,8,B
2018-04-18 21:05:46,13450.0,90,2072,-48,13315.0,12,13320.0,8,B
2018-04-18 21:05:46,13390.0,24,2096,-8,13315.0,12,13320.0,8,S
2018-04-18 21:05:47,13390.0,2,2098,2,13315.0,12,13320.0,8,S
2018-04-18 21:05:48,13390.0,2,2100,0,13315.0,12,13320.0,8,S
2018-04-18 21:05:48,13410.0,2,2102,0,13315.0,12,13320.0,8,B
2018-04-18 21:05:49,13410.0,2,2104,0,13315.0,12,13320.0,8,B
2018-04-18 21:05:49,13405.0,24,2128,18,13315.0,12,13320.0,8,S
2018-04-18 21:05:50,13415.0,8,2136,-2,13315.0,12,13320.0,8,B
2018-04-18 21:05:51,13420.0,2,2138,0,13315.0,12,13320.0,8,B
2018-04-18 21:05:51,13420.0,8,2146,-2,13315.0,12,13320.0,8,B
2018-04-18 21:05:52,13430.0,4,2150,0,13315.0,12,13320.0,8,B
2018-04-18 21:05:52,13430.0,2,2152,-2,13315.0,12,13320.0,8,B
2018-04-18 21:05:53,13430.0,6,2158,-4,13315.0,12,13320.0,8,B
2018-04-18 21:05:53,13435.0,4,2162,2,13315.0,12,13320.0,8,B
2018-04-18 21:05:54,13440.0,4,2166,0,13315.0,12,13320.0,8,B
2018-04-18 21:05:54,13435.0,20,2186,-4,13315.0,12,13320.0,8,S
2018-04-18 21:05:55,13435.0,2,2188,0,13315.0,12,13320.0,8,S
2018-04-18 21:05:55,13435.0,2,2190,0,13315.0,12,13320.0,8,S
2018-04-18 21:05:56,13440.0,8,2198,-6,13315.0,12,13320.0,8,B
2018-04-18 21:05:56,13440.0,2,2200,-2,13315.0,12,13320.0,8,B
2018-04-18 21:05:57,13435.0,6,2206,2,13315.0,12,13320.0,8,S
2018-04-18 21:05:57,13435.0,2,2208,2,13315.0,12,13320.0,8,S
2018-04-18 21:05:58,13440.0,16,2224,-10,13315.0,12,13320.0,8,B
2018-04-18 21:05:58,13440.0,16,2240,-10,13315.0,12,13320.0,8,B
2018-04-18 21:05:59,13435.0,34,2274,2,13315.0,12,13320.0,8,S
2018-04-18 21:06:00,13435.0,30,2304,-18,13315.0,12,13320.0,8,S
2018-04-18 21:06:01,13435.0,8,2312,0,13315.0,12,13320.0,8,S
2018-04-18 21:06:01,13440.0,8,2320,4,13315.0,12,13320.0,8,B
2018-04-18 21:06:02,13440.0,4,2324,-2,13315.0,12,13320.0,8,B
2018-04-18 21:06:02,13435.0,8,2332,-4,13315.0,12,13320.0,8,S
2018-04-18 21:06:03,13435.0,16,2348,-2,13315.0,12,13320.0,8,S
2018-04-18 21:06:04,13440.0,4,2352,-4,13315.0,12,13320.0,8,B
2018-04-18 21:06:04,13440.0,28,2380,-16,13315.0,12,13320.0,8,B
2018-04-18 21:06:05,13440.0,16,2396,-10,13315.0,12,13320.0,8,B
2018-04-18 21:06:06,13425.0,4,2400,0,13315.0,12,13320.0,8,S
2018-04-18 21:06:07,13440.0,40,2440,-24,13315.0,12,13320.0,8,B
2018-04-18 21:06:08,13435.0,110,2550,0,13315.0,12,13320.0,8,S
2018-04-18 21:06:09,13430.0,4,2554,2,13315.0,12,13320.0,8,S
2018-04-18 21:06:10,13425.0,4,2558,0,13315.0,12,13320.0,8,S
2018-04-18 21:06:10,13430.0,2,2560,0,13315.0,12,13320.0,8,B
2018-04-18 21:06:11,13435.0,4,2564,2,13315.0,12,13320.0,8,B
2018-04-18 21:06:12,13435.0,2,2566,0,13315.0,12,13320.0,8,B
2018-04-18 21:06:12,13430.0,4,2570,0,13315.0,12,13320.0,8,S
2018-04-18 21:06:13,13430.0,2,2572,0,13315.0,12,13320.0,8,S
2018-04-18 21:06:14,13430.0,4,2576,0,13315.0,12,13320.0,8,S
2018-04-18 21:06:14,13430.0,12,2588,0,13315.0,12,13320.0,8,S
2018-04-18 21:06:15,13430.0,8,2596,0,13315.0,12,13320.0,8,S
2018-04-18 21:06:16,13425.0,2,2598,-2,13315.0,12,13320.0,8,S
2018-04-18 21:06:17,13420.0,4,2602,-2,13315.0,12,13320.0,8,S
2018-04-18 21:06:17,13425.0,6,2608,6,13315.0,12,13320.0,8,B
2018-04-18 21:06:18,13420.0,22,2630,-6,13315.0,12,13320.0,8,S
2018-04-18 21:06:19,13420.0,2,2632,0,13315.0,12,13320.0,8,S
2018-04-18 21:06:20,13415.0,2,2634,-2,13315.0,12,13320.0,8,S
2018-04-18 21:06:22,13415.0,2,2636,2,13315.0,12,13320.0,8,S
2018-04-18 21:06:23,13415.0,2,2638,0,13315.0,12,13320.0,8,S
2018-04-18 21:06:25,13415.0,2,2640,-2,13315.0,12,13320.0,8,S
2018-04-18 21:06:26,13415.0,6,2646,-2,13315.0,12,13320.0,8,S
2018-04-18 21:06:27,13415.0,2,2648,0,13315.0,12,13320.0,8,S
2018-04-18 21:06:30,13415.0,2,2650,0,13315.0,12,13320.0,8,S
2018-04-18 21:06:31,13415.0,2,2652,2,13315.0,12,13320.0,8,S
2018-04-18 21:06:35,13415.0,2,2654,0,13315.0,12,13320.0,8,S
2018-04-18 21:06:38,13410.0,2,2656,-2,13315.0,12,13320.0,8,S
2018-04-18 21:06:39,13420.0,4,2660,0,13315.0,12,13320.0,8,B
2018-04-18 21:06:39,13415.0,2,2662,0,13315.0,12,13320.0,8,S
2018-04-18 21:06:40,13415.0,22,2684,-20,13315.0,12,13320.0,8,S
2018-04-18 21:06:40,13415.0,8,2692,-4,13315.0,12,13320.0,8,S
2018-04-18 21:06:42,13420.0,8,2700,0,13315.0,12,13320.0,8,B
2018-04-18 21:06:42,13420.0,2,2702,0,13315.0,12,13320.0,8,B
2018-04-18 21:06:43,13420.0,40,2742,-10,13315.0,12,13320.0,8,B
2018-04-18 21:06:43,13420.0,2,2744,-2,13315.0,12,13320.0,8,B
2018-04-18 21:06:44,13420.0,2,2746,-2,13315.0,12,13320.0,8,B
2018-04-18 21:06:44,13415.0,28,2774,-18,13315.0,12,13320.0,8,S
2018-04-18 21:06:45,13415.0,24,2798,-24,13315.0,12,13320.0,8,S
2018-04-18 21:06:45,13425.0,20,2818,0,13315.0,12,13320.0,8,B
2018-04-18 21:06:46,13405.0,48,2866,26,13315.0,12,13320.0,8,S
2018-04-18 21:06:46,13420.0,2,2868,0,13315.0,12,13320.0,8,B
2018-04-18 21:06:47,13415.0,8,2876,0,13315.0,12,13320.0,8,S
2018-04-18 21:06:47,13425.0,24,2900,20,13315.0,12,13320.0,8,B
2018-04-18 21:06:48,13425.0,14,2914,6,13315.0,12,13320.0,8,B
2018-04-18 21:06:48,13425.0,8,2922,6,13315.0,12,13320.0,8,B
2018-04-18 21:06:49,13425.0,8,2930,6,13315.0,12,13320.0,8,B
2018-04-18 21:06:50,13415.0,2,2932,-2,13315.0,12,13320.0,8,S
2018-04-18 21:06:50,13425.0,8,2940,-6,13315.0,12,13320.0,8,B
2018-04-18 21:06:53,13415.0,20,2960,6,13315.0,12,13320.0,8,S
2018-04-18 21:06:54,13420.0,4,2964,2,13315.0,12,13320.0,8,B
2018-04-18 21:06:57,13415.0,28,2992,-8,13315.0,12,13320.0,8,S
2018-04-18 21:06:57,13415.0,12,3004,0,13315.0,12,13320.0,8,S
2018-04-18 21:06:58,13415.0,6,3010,0,13315.0,12,13320.0,8,S
2018-04-18 21:06:59,13415.0,4,3014,-4,13315.0,12,13320.0,8,S
2018-04-18 21:07:00,13415.0,2,3016,0,13315.0,12,13320.0,8,S
2018-04-18 21:07:00,13415.0,20,3036,2,13315.0,12,13320.0,8,S
2018-04-18 21:07:01,13415.0,2,3038,0,13315.0,12,13320.0,8,S
2018-04-18 21:07:02,13415.0,2,3040,0,13315.0,12,13320.0,8,S
2018-04-18 21:07:03,13415.0,4,3044,0,13315.0,12,13320.0,8,S
2018-04-18 21:07:04,13420.0,26,3070,18,13315.0,12,13320.0,8,B
2018-04-18 21:07:05,13420.0,10,3080,0,13315.0,12,13320.0,8,B
2018-04-18 21:07:07,13420.0,8,3088,-8,13315.0,12,13320.0,8,B
2018-04-18 21:07:10,13420.0,4,3092,-4,13315.0,12,13320.0,8,B
2018-04-18 21:07:10,13415.0,6,3098,0,13315.0,12,13320.0,8,S
2018-04-18 21:07:12,13415.0,4,3102,0,13315.0,12,13320.0,8,S
2018-04-18 21:07:13,13410.0,2,3104,0,13315.0,12,13320.0,8,S
2018-04-18 21:07:14,13410.0,2,3106,-2,13315.0,12,13320.0,8,S
2018-04-18 21:07:14,13410.0,4,3110,0,13315.0,12,13320.0,8,S
2018-04-18 21:07:15,13405.0,2,3112,0,13315.0,12,13320.0,8,S
2018-04-18 21:07:19,13405.0,4,3116,0,13315.0,12,13320.0,8,S
2018-04-18 21:07:20,13410.0,6,3122,-2,13315.0,12,13320.0,8,B
2018-04-18 21:07:20,13410.0,4,3126,-2,13315.0,12,13320.0,8,B
2018-04-18 21:07:21,13405.0,4,3130,0,13315.0,12,13320.0,8,S
2018-04-18 21:07:23,13400.0,2,3132,-2,13315.0,12,13320.0,8,S
2018-04-18 21:07:23,13400.0,2,3134,2,13315.0,12,13320.0,8,S
2018-04-18 21:07:25,13405.0,16,3150,-16,13315.0,12,13320.0,8,B
2018-04-18 21:07:25,13405.0,4,3154,0,13315.0,12,13320.0,8,B
2018-04-18 21:07:29,13405.0,4,3158,2,13315.0,12,13320.0,8,B
2018-04-18 21:07:34,13405.0,4,3162,-2,13315.0,12,13320.0,8,B
2018-04-18 21:07:34,13405.0,4,3166,0,13315.0,12,13320.0,8,B
2018-04-18 21:07:36,13410.0,8,3174,2,13315.0,12,13320.0,8,B
2018-04-18 21:07:37,13410.0,2,3176,0,13315.0,12,13320.0,8,B
2018-04-18 21:07:39,13410.0,2,3178,2,13315.0,12,13320.0,8,B
2018-04-18 21:07:40,13415.0,4,3182,0,13315.0,12,13320.0,8,B
2018-04-18 21:07:41,13415.0,2,3184,2,13315.0,12,13320.0,8,B
2018-04-18 21:07:44,13410.0,2,3186,0,13410.0,9,13415.0,1,S
2018-04-18 21:07:47,13415.0,2,3188,-2,13410.0,10,13420.0,44,B
2018-04-18 21:07:48,13415.0,2,3190,0,13410.0,13,13420.0,44,B
2018-04-18 21:07:51,13415.0,2,3192,2,13415.0,5,13420.0,45,B
2018-04-18 21:07:52,13420.0,20,3212,-16,13415.0,5,13420.0,35,B
2018-04-18 21:07:53,13420.0,34,3246,8,13410.0,1,13420.0,26,B
2018-04-18 21:07:57,13420.0,20,3266,10,13415.0,11,13420.0,16,B
2018-04-18 21:08:04,13420.0,4,3270,-2,13415.0,10,13420.0,14,B
2018-04-18 21:08:05,13420.0,2,3272,0,13415.0,10,13420.0,15,B
2018-04-18 21:08:07,13415.0,10,3282,0,13410.0,18,13420.0,15,S
2018-04-18 21:08:08,13410.0,14,3296,6,13405.0,12,13410.0,3,S
2018-04-18 21:08:09,13410.0,6,3302,0,13410.0,16,13420.0,16,S
2018-04-18 21:08:10,13420.0,2,3304,-2,13415.0,1,13420.0,15,B
2018-04-18 21:08:12,13420.0,6,3310,-4,13415.0,14,13420.0,12,B
2018-04-18 21:08:12,13420.0,24,3334,-16,13420.0,1,13425.0,8,B
2018-04-18 21:08:13,13425.0,4,3338,0,13420.0,20,13425.0,4,B
2018-04-18 21:08:14,13420.0,26,3364,10,13420.0,10,13425.0,1,S
2018-04-18 21:08:15,13425.0,2,3366,-2,13420.0,10,13430.0,3,B
2018-04-18 21:08:15,13420.0,4,3370,-2,13420.0,8,13430.0,11,S
2018-04-18 21:08:18,13425.0,4,3374,-2,13420.0,10,13425.0,1,B
2018-04-18 21:08:21,13425.0,2,3376,0,13420.0,9,13425.0,1,B
2018-04-18 21:08:21,13430.0,2,3378,0,13420.0,9,13430.0,15,B
2018-04-18 21:08:24,13430.0,4,3382,-4,13420.0,8,13425.0,7,B
2018-04-18 21:08:25,13420.0,6,3388,-2,13420.0,5,13425.0,7,S
2018-04-18 21:08:26,13425.0,2,3390,0,13420.0,7,13430.0,16,B
2018-04-18 21:08:28,13430.0,4,3394,0,13430.0,8,13435.0,3,B
2018-04-18 21:08:30,13430.0,2,3396,0,13430.0,7,13435.0,9,B
2018-04-18 21:08:31,13430.0,12,3408,-12,13430.0,3,13435.0,8,B
2018-04-18 21:08:32,13430.0,6,3414,0,13425.0,1,13430.0,14,B
2018-04-18 21:08:33,13430.0,8,3422,-2,13420.0,9,13430.0,9,B
2018-04-18 21:08:35,13430.0,2,3424,0,13420.0,11,13430.0,8,B
2018-04-18 21:08:36,13420.0,4,3428,0,13420.0,15,13430.0,8,S
2018-04-18 21:08:40,13420.0,2,3430,2,13420.0,3,13425.0,4,S
2018-04-18 21:08:40,13420.0,6,3436,0,13415.0,4,13425.0,7,S
2018-04-18 21:08:42,13425.0,2,3438,-2,13425.0,1,13430.0,6,B
2018-04-18 21:08:43,13425.0,2,3440,0,13420.0,6,13425.0,7,B
2018-04-18 21:08:43,13425.0,2,3442,0,13415.0,7,13425.0,10,B
2018-04-18 21:08:44,13425.0,2,3444,2,13420.0,8,13430.0,5,B
2018-04-18 21:08:45,13420.0,2,3446,-2,13425.0,18,13430.0,3,S
2018-04-18 21:08:46,13430.0,2,3448,2,13425.0,25,13430.0,2,B
2018-04-18 21:08:47,13425.0,20,3468,-20,13425.0,15,13430.0,2,S
2018-04-18 21:08:48,13425.0,2,3470,-2,13425.0,7,13430.0,7,S
2018-04-18 21:08:48,13430.0,6,3476,4,13425.0,12,13435.0,4,B
2018-04-18 21:08:54,13430.0,4,3480,0,13430.0,7,13435.0,5,B
2018-04-18 21:08:55,13430.0,6,3486,2,13430.0,2,13435.0,7,B
2018-04-18 21:08:58,13435.0,6,3492,4,13430.0,14,13435.0,4,B
2018-04-18 21:08:58,13435.0,8,3500,-6,13435.0,1,13440.0,15,B
2018-04-18 21:09:01,13435.0,2,3502,-2,13430.0,15,13440.0,18,B
2018-04-18 21:09:01,13435.0,4,3506,-2,13435.0,7,13440.0,15,B
2018-04-18 21:09:02,13435.0,2,3508,0,13435.0,3,13440.0,15,B
2018-04-18 21:09:03,13440.0,6,3514,-2,13435.0,11,13440.0,11,B
2018-04-18 21:09:04,13440.0,10,3524,10,13435.0,12,13440.0,6,B
2018-04-18 21:09:04,13435.0,8,3532,6,13435.0,12,13440.0,4,S
2018-04-18 21:09:05,13440.0,8,3540,6,13440.0,4,13445.0,10,B
2018-04-18 21:09:07,13440.0,4,3544,4,13440.0,9,13445.0,7,B
2018-04-18 21:09:07,13440.0,2,3546,2,13440.0,8,13445.0,7,B
2018-04-18 21:09:08,13445.0,2,3548,0,13440.0,9,13445.0,6,B
2018-04-18 21:09:09,13440.0,16,3564,16,13440.0,6,13445.0,6,S
2018-04-18 21:09:10,13445.0,12,3576,12,13440.0,7,13450.0,41,B
2018-04-18 21:09:11,13445.0,4,3580,-2,13445.0,4,13450.0,34,B
2018-04-18 21:09:11,13450.0,6,3586,4,13445.0,10,13450.0,31,B
2018-04-18 21:09:12,13445.0,16,3602,-2,13445.0,12,13450.0,24,S
2018-04-18 21:09:12,13450.0,4,3606,2,13445.0,12,13450.0,23,B
2018-04-18 21:09:14,13445.0,20,3626,0,13445.0,1,13450.0,23,S
2018-04-18 21:09:14,13445.0,2,3628,0,13440.0,1,13445.0,3,S
2018-04-18 21:09:15,13445.0,6,3634,0,13440.0,1,13450.0,31,S
2018-04-18 21:09:16,13450.0,26,3660,20,13440.0,4,13450.0,21,B
2018-04-18 21:09:17,13450.0,4,3664,4,13445.0,4,13450.0,12,B
2018-04-18 21:09:17,13450.0,30,3694,-6,13445.0,3,13450.0,8,B
2018-04-18 21:09:18,13450.0,18,3712,10,13440.0,3,13450.0,13,B
2018-04-18 21:09:19,13445.0,4,3716,0,13440.0,2,13445.0,10,S
2018-04-18 21:09:21,13445.0,4,3720,2,13440.0,1,13445.0,7,S
2018-04-18 21:09:24,13440.0,4,3724,-2,13435.0,3,13445.0,11,S
2018-04-18 21:09:24,13445.0,2,3726,0,13435.0,5,13445.0,10,B
2018-04-18 21:09:25,13445.0,22,3748,12,13445.0,59,13450.0,15,B
2018-04-18 21:09:26,13445.0,48,3796,24,13445.0,35,13450.0,15,B
2018-04-18 21:09:26,13445.0,42,3838,38,13445.0,14,13450.0,21,B
2018-04-18 21:09:27,13445.0,28,3866,28,13435.0,4,13445.0,7,B
2018-04-18 21:09:29,13440.0,4,3870,0,13435.0,2,13440.0,8,S
2018-04-18 21:09:29,13440.0,4,3874,-2,13435.0,2,13440.0,2,S
2018-04-18 21:09:31,13440.0,2,3876,0,13435.0,2,13440.0,5,S
2018-04-18 21:09:37,13435.0,2,3878,2,13435.0,2,13440.0,3,S
2018-04-18 21:09:38,13440.0,2,3880,-2,13435.0,3,13440.0,2,B
2018-04-18 21:09:42,13435.0,2,3882,2,13430.0,5,13440.0,6,S
2018-04-18 21:09:46,13435.0,2,3884,0,13430.0,9,13435.0,9,S
2018-04-18 21:09:49,13430.0,2,3886,0,13430.0,3,13435.0,10,S
2018-04-18 21:09:49,13430.0,6,3892,2,13425.0,11,13430.0,1,S
2018-04-18 21:09:52,13430.0,12,3904,-6,13430.0,1,13435.0,11,S
2018-04-18 21:09:52,13435.0,4,3908,0,13430.0,2,13435.0,7,B
2018-04-18 21:09:56,13430.0,2,3910,-2,13425.0,19,13435.0,13,S
2018-04-18 21:10:00,13430.0,4,3914,-2,13425.0,20,13430.0,1,S
2018-04-18 21:10:01,13430.0,16,3930,12,13430.0,12,13435.0,16,S
2018-04-18 21:10:04,13430.0,4,3934,-4,13430.0,1,13435.0,16,S
2018-04-18 21:10:05,13430.0,2,3936,0,13425.0,13,13430.0,1,S
2018-04-18 21:10:09,13430.0,2,3938,-2,13425.0,19,13435.0,18,S
2018-04-18 21:10:12,13425.0,2,3940,-2,13425.0,11,13430.0,18,S
2018-04-18 21:10:13,13425.0,2,3942,-2,13425.0,10,13430.0,20,S
2018-04-18 21:10:15,13430.0,8,3950,0,13425.0,10,13430.0,16,B
2018-04-18 21:10:17,13425.0,2,3952,0,13425.0,15,13430.0,14,S
2018-04-18 21:10:21,13425.0,8,3960,-4,13425.0,6,13430.0,26,S
2018-04-18 21:10:22,13430.0,14,3974,0,13420.0,5,13430.0,27,B
2018-04-18 21:10:25,13430.0,20,3994,0,13420.0,2,13430.0,15,B
2018-04-18 21:10:27,13425.0,2,3996,0,13420.0,2,13425.0,5,S
2018-04-18 21:10:27,13420.0,2,3998,0,13420.0,1,13425.0,2,S
2018-04-18 21:10:32,13420.0,2,4000,-2,13415.0,2,13420.0,10,S
2018-04-18 21:10:40,13415.0,4,4004,0,13410.0,4,13415.0,7,S
2018-04-18 21:10:42,13415.0,8,4012,-8,13410.0,7,13420.0,17,S
2018-04-18 21:10:44,13420.0,6,4018,0,13415.0,15,13420.0,7,B
2018-04-18 21:10:45,13415.0,30,4048,16,13410.0,8,13415.0,25,S
2018-04-18 21:10:46,13415.0,10,4058,-8,13415.0,10,13420.0,8,S
2018-04-18 21:10:47,13415.0,2,4060,0,13415.0,3,13420.0,7,S
2018-04-18 21:10:47,13420.0,4,4064,2,13415.0,7,13420.0,5,B
2018-04-18 21:10:48,13420.0,4,4068,-2,13415.0,3,13420.0,3,B
2018-04-18 21:10:50,13415.0,2,4070,0,13410.0,12,13420.0,10,S
2018-04-18 21:10:51,13410.0,4,4074,0,13410.0,11,13420.0,13,S
2018-04-18 21:10:57,13420.0,2,4076,-2,13410.0,11,13420.0,13,B
2018-04-18 21:11:00,13415.0,2,4078,-2,13410.0,11,13420.0,13,S
2018-04-18 21:11:01,13420.0,2,4080,-2,13410.0,11,13420.0,13,B
2018-04-18 21:11:01,13420.0,6,4086,0,13410.0,11,13420.0,13,B
2018-04-18 21:11:02,13415.0,2,4088,0,13410.0,11,13420.0,13,S
2018-04-18 21:11:16,13410.0,2,4090,0,13410.0,11,13420.0,13,S
2018-04-18 21:11:16,13410.0,12,4102,-8,13410.0,11,13420.0,13,S
2018-04-18 21:11:25,13405.0,4,4106,2,13410.0,11,13420.0,13,S
2018-04-18 21:11:26,13405.0,2,4108,0,13410.0,11,13420.0,13,S
2018-04-18 21:11:28,13405.0,2,4110,0,13410.0,11,13420.0,13,S
2018-04-18 21:11:28,13405.0,2,4112,-2,13410.0,11,13420.0,13,S
2018-04-18 21:11:29,13400.0,4,4116,-2,13410.0,11,13420.0,13,S
2018-04-18 21:11:29,13400.0,4,4120,-2,13410.0,11,13420.0,13,S
2018-04-18 21:11:34,13395.0,14,4134,-14,13410.0,11,13420.0,13,S
2018-04-18 21:11:35,13395.0,4,4138,-2,13410.0,11,13420.0,13,S
2018-04-18 21:11:35,13395.0,2,4140,-2,13410.0,11,13420.0,13,S
2018-04-18 21:11:36,13400.0,2,4142,-2,13410.0,11,13420.0,13,B
2018-04-18 21:11:42,13395.0,2,4144,0,13410.0,11,13420.0,13,S
2018-04-18 21:11:44,13395.0,4,4148,4,13410.0,11,13420.0,13,S
2018-04-18 21:11:45,13400.0,2,4150,0,13410.0,11,13420.0,13,B
2018-04-18 21:11:46,13400.0,4,4154,4,13410.0,11,13420.0,13,B
2018-04-18 21:11:46,13400.0,2,4156,0,13410.0,11,13420.0,13,B
2018-04-18 21:11:48,13400.0,4,4160,-4,13410.0,11,13420.0,13,B
2018-04-18 21:11:53,13400.0,2,4162,0,13410.0,11,13420.0,13,B
2018-04-18 21:12:08,13400.0,2,4164,0,13400.0,3,13405.0,12,B
2018-04-18 21:12:09,13405.0,4,4168,0,13405.0,5,13410.0,9,B
2018-04-18 21:12:14,13410.0,2,4170,0,13405.0,1,13410.0,4,B
2018-04-18 21:12:18,13410.0,2,4172,-2,13400.0,6,13410.0,12,B
2018-04-18 21:12:22,13405.0,4,4176,4,13400.0,7,13410.0,3,S
2018-04-18 21:12:24,13410.0,4,4180,-2,13405.0,6,13410.0,1,B
2018-04-18 21:12:26,13410.0,6,4186,-4,13410.0,7,13415.0,2,B
2018-04-18 21:12:27,13410.0,2,4188,-2,13410.0,2,13420.0,19,B
2018-04-18 21:12:29,13410.0,2,4190,-2,13410.0,1,13415.0,11,B
2018-04-18 21:12:42,13415.0,2,4192,2,13410.0,2,13415.0,26,B
2018-04-18 21:12:43,13410.0,4,4196,-2,13405.0,6,13410.0,1,S
2018-04-18 21:12:45,13405.0,2,4198,2,13405.0,4,13410.0,1,S
2018-04-18 21:12:48,13410.0,10,4208,2,13405.0,4,13410.0,5,B
2018-04-18 21:12:49,13410.0,2,4210,2,13405.0,4,13410.0,5,B
2018-04-18 21:12:50,13405.0,2,4212,2,13405.0,1,13410.0,5,S
2018-04-18 21:12:55,13405.0,2,4214,2,13405.0,1,13410.0,5,S
2018-04-18 21:13:04,13405.0,2,4216,0,13405.0,5,13410.0,5,S
2018-04-18 21:13:04,13405.0,2,4218,2,13405.0,4,13410.0,5,S
2018-04-18 21:13:10,13410.0,2,4220,2,13405.0,5,13410.0,4,B
2018-04-18 21:13:12,13405.0,2,4222,0,13405.0,4,13410.0,5,S
2018-04-18 21:13:13,13405.0,6,4228,2,13405.0,1,13410.0,13,S
2018-04-18 21:13:13,13405.0,2,4230,0,13400.0,7,13405.0,1,S
2018-04-18 21:13:19,13405.0,2,4232,0,13400.0,7,13410.0,13,S
2018-04-18 21:13:22,13400.0,6,4238,2,13400.0,6,13410.0,11,S
2018-04-18 21:13:31,13400.0,6,4244,-2,13400.0,3,13405.0,2,S
2018-04-18 21:13:38,13400.0,2,4246,-2,13400.0,8,13405.0,2,S
2018-04-18 21:13:41,13405.0,2,4248,2,13400.0,8,13410.0,53,B
2018-04-18 21:13:46,13405.0,2,4250,2,13400.0,8,13410.0,32,B
2018-04-18 21:13:47,13410.0,2,4252,2,13405.0,1,13410.0,22,B
2018-04-18 21:13:54,13405.0,2,4254,-2,13405.0,2,13410.0,23,S
2018-04-18 21:13:58,13405.0,2,4256,-2,13405.0,2,13410.0,29,S
2018-04-18 21:14:00,13405.0,2,4258,2,13400.0,8,13405.0,3,S
2018-04-18 21:14:12,13405.0,4,4262,0,13400.0,8,13410.0,55,S
2018-04-18 21:14:23,13410.0,4,4266,0,13405.0,3,13410.0,28,B
2018-04-18 21:14:54,13410.0,4,4270,0,13405.0,7,13410.0,32,B
2018-04-18 21:14:56,13410.0,12,4282,8,13405.0,7,13410.0,20,B
2018-04-18 21:14:57,13410.0,12,4294,-12,13405.0,8,13410.0,14,B
2018-04-18 21:14:58,13410.0,2,4296,0,13405.0,8,13410.0,13,B
2018-04-18 21:14:59,13410.0,2,4298,-2,13405.0,8,13410.0,12,B
2018-04-18 21:15:00,13410.0,24,4322,-22,13405.0,8,13415.0,7,B
2018-04-18 21:15:01,13415.0,4,4326,0,13410.0,4,13415.0,1,B
2018-04-18 21:15:01,13415.0,2,4328,2,13415.0,5,13420.0,6,B
2018-04-18 21:15:07,13415.0,4,4332,4,13410.0,7,13420.0,5,B
2018-04-18 21:15:12,13415.0,12,4344,6,13410.0,8,13420.0,1,B
2018-04-18 21:15:14,13415.0,2,4346,-2,13410.0,12,13420.0,3,B
2018-04-18 21:15:19,13420.0,2,4348,-2,13410.0,18,13420.0,6,B
2018-04-18 21:15:21,13415.0,4,4352,2,13410.0,11,13420.0,7,S
2018-04-18 21:15:31,13415.0,2,4354,0,13415.0,5,13420.0,6,S
2018-04-18 21:15:33,13415.0,4,4358,2,13410.0,13,13420.0,5,S
2018-04-18 21:15:35,13415.0,4,4362,4,13410.0,17,13420.0,6,S
2018-04-18 21:15:38,13420.0,6,4368,0,13415.0,1,13420.0,7,B
2018-04-18 21:15:45,13425.0,10,4378,-10,13415.0,10,13425.0,2,B
2018-04-18 21:16:07,13415.0,2,4380,2,13415.0,2,13420.0,15,S
2018-04-18 21:16:08,13420.0,10,4390,8,13415.0,8,13420.0,5,B
2018-04-18 21:16:08,13420.0,4,4394,0,13415.0,9,13420.0,3,B
2018-04-18 21:16:09,13420.0,6,4400,6,13420.0,1,13425.0,5,B
2018-04-18 21:16:10,13420.0,4,4404,2,13415.0,8,13425.0,12,B
2018-04-18 21:16:11,13415.0,2,4406,2,13415.0,5,13425.0,12,S
2018-04-18 21:16:14,13420.0,2,4408,-2,13410.0,13,13420.0,12,B
2018-04-18 21:16:20,13415.0,2,4410,0,13410.0,12,13420.0,8,S
2018-04-18 21:16:24,13410.0,2,4412,2,13410.0,11,13420.0,8,S
2018-04-18 21:16:25,13415.0,12,4424,2,13410.0,3,13420.0,27,B
2018-04-18 21:16:31,13410.0,2,4426,0,13410.0,2,13415.0,5,S
2018-04-18 21:16:32,13415.0,10,4436,10,13410.0,2,13415.0,1,B
2018-04-18 21:16:44,13415.0,6,4442,4,13415.0,2,13420.0,12,B
2018-04-18 21:16:44,13415.0,4,4446,2,13410.0,3,13415.0,1,B
2018-04-18 21:16:50,13420.0,4,4450,-2,13415.0,17,13425.0,6,B
2018-04-18 21:16:53,13420.0,2,4452,0,13420.0,1,13425.0,3,B
2018-04-18 21:17:01,13425.0,4,4456,-2,13420.0,4,13430.0,28,B
2018-04-18 21:17:06,13425.0,2,4458,2,13420.0,15,13425.0,9,B
2018-04-18 21:17:06,13425.0,6,4464,4,13420.0,15,13425.0,6,B
2018-04-18 21:17:07,13425.0,4,4468,4,13420.0,15,13425.0,4,B
2018-04-18 21:17:07,13425.0,8,4476,0,13420.0,15,13430.0,9,B
2018-04-18 21:17:13,13420.0,10,4486,-2,13415.0,10,13420.0,5,S
2018-04-18 21:17:14,13420.0,2,4488,0,13420.0,8,13425.0,1,S
2018-04-18 21:17:20,13420.0,2,4490,2,13420.0,1,13425.0,4,S
2018-04-18 21:17:26,13425.0,4,4494,-4,13420.0,1,13425.0,11,B
2018-04-18 21:17:33,13425.0,4,4498,0,13420.0,1,13425.0,10,B
2018-04-18 21:17:33,13425.0,2,4500,2,13420.0,1,13425.0,9,B
2018-04-18 21:17:38,13415.0,10,4510,8,13410.0,4,13415.0,44,S
2018-04-18 21:17:39,13415.0,4,4514,-2,13415.0,1,13420.0,57,S
2018-04-18 21:17:39,13415.0,4,4518,-2,13410.0,8,13420.0,53,S
2018-04-18 21:17:52,13410.0,2,4520,-2,13410.0,2,13415.0,10,S
2018-04-18 21:17:53,13410.0,4,4524,0,13405.0,11,13410.0,2,S
2018-04-18 21:17:54,13415.0,4,4528,4,13405.0,20,13415.0,8,B
2018-04-18 21:18:11,13410.0,2,4530,0,13410.0,12,13415.0,7,S
2018-04-18 21:18:19,13410.0,2,4532,-2,13405.0,16,13410.0,2,S
2018-04-18 21:18:26,13410.0,2,4534,2,13405.0,22,13415.0,10,S
2018-04-18 21:18:33,13410.0,2,4536,0,13410.0,13,13415.0,9,S
2018-04-18 21:18:45,13410.0,2,4538,0,13410.0,6,13415.0,9,S
2018-04-18 21:18:49,13410.0,2,4540,0,13410.0,6,13415.0,9,S
2018-04-18 21:19:01,13410.0,2,4542,0,13410.0,3,13415.0,9,S
2018-04-18 21:19:03,13410.0,2,4544,2,13410.0,7,13415.0,8,S
2018-04-18 21:19:04,13415.0,2,4546,0,13410.0,10,13415.0,7,B
2018-04-18 21:19:04,13415.0,10,4556,8,13410.0,21,13415.0,2,B
2018-04-18 21:19:05,13415.0,4,4560,0,13415.0,1,13420.0,58,B
2018-04-18 21:19:06,13415.0,2,4562,2,13415.0,11,13420.0,55,B
2018-04-18 21:19:07,13415.0,22,4584,-14,13410.0,2,13415.0,1,B
2018-04-18 21:19:11,13415.0,4,4588,4,13410.0,21,13415.0,8,B
2018-04-18 21:19:12,13415.0,4,4592,4,13410.0,21,13415.0,6,B
2018-04-18 21:19:12,13415.0,8,4600,0,13410.0,21,13415.0,2,B
2018-04-18 21:19:17,13415.0,4,4604,4,13410.0,20,13415.0,1,B
2018-04-18 21:19:17,13415.0,2,4606,0,13410.0,20,13420.0,58,B
2018-04-18 21:19:27,13410.0,20,4626,8,13410.0,10,13420.0,55,S
2018-04-18 21:19:29,13420.0,4,4630,0,13410.0,10,13420.0,53,B
2018-04-18 21:19:30,13415.0,2,4632,0,13415.0,9,13420.0,50,S
2018-04-18 21:19:38,13415.0,2,4634,0,13415.0,4,13420.0,58,S
2018-04-18 21:19:39,13415.0,2,4636,0,13415.0,3,13420.0,50,S
2018-04-18 21:19:40,13420.0,2,4638,-2,13415.0,4,13420.0,49,B
2018-04-18 21:19:44,13420.0,6,4644,0,13415.0,4,13420.0,57,B
2018-04-18 21:19:53,13420.0,20,4664,0,13415.0,3,13420.0,43,B
2018-04-18 21:19:53,13415.0,2,4666,0,13415.0,2,13420.0,43,S
2018-04-18 21:19:54,13415.0,4,4670,4,13410.0,6,13420.0,43,S
2018-04-18 21:19:56,13420.0,10,4680,0,13410.0,16,13415.0,1,B
2018-04-18 21:19:56,13415.0,2,4682,0,13410.0,16,13420.0,41,S
2018-04-18 21:19:59,13420.0,4,4686,0,13410.0,18,13420.0,39,B
2018-04-18 21:20:07,13420.0,6,4692,-6,13415.0,12,13420.0,28,B
2018-04-18 21:20:09,13415.0,8,4700,8,13415.0,2,13420.0,36,S
2018-04-18 21:20:09,13415.0,4,4704,0,13410.0,17,13420.0,37,S
2018-04-18 21:20:12,13415.0,2,4706,0,13415.0,4,13420.0,31,S
2018-04-18 21:20:16,13415.0,4,4710,0,13415.0,2,13420.0,33,S
2018-04-18 21:20:25,13415.0,4,4714,2,13410.0,15,13420.0,37,S
2018-04-18 21:20:40,13410.0,2,4716,-2,13410.0,18,13420.0,37,S
2018-04-18 21:20:41,13410.0,2,4718,-2,13410.0,17,13420.0,36,S
2018-04-18 21:20:43,13415.0,2,4720,-2,13410.0,13,13420.0,36,B
2018-04-18 21:20:44,13420.0,2,4722,-2,13410.0,9,13420.0,36,B
2018-04-18 21:20:45,13420.0,2,4724,2,13410.0,3,13415.0,5,B
2018-04-18 21:20:46,13420.0,24,4748,-18,13410.0,1,13420.0,45,B
2018-04-18 21:20:48,13420.0,2,4750,0,13410.0,1,13415.0,1,B
2018-04-18 21:20:52,13415.0,8,4758,-6,13415.0,6,13420.0,45,S
2018-04-18 21:20:52,13415.0,4,4762,0,13415.0,4,13420.0,46,S
2018-04-18 21:20:53,13415.0,8,4770,0,13410.0,7,13420.0,33,S
2018-04-18 21:20:57,13415.0,6,4776,2,13415.0,2,13420.0,32,S
2018-04-18 21:20:57,13415.0,4,4780,0,13410.0,7,13420.0,33,S
2018-04-18 21:20:59,13410.0,4,4784,2,13410.0,2,13415.0,5,S
2018-04-18 21:21:04,13410.0,2,4786,2,13410.0,1,13415.0,1,S
2018-04-18 21:21:06,13410.0,2,4788,2,13410.0,1,13415.0,9,S
2018-04-18 21:21:10,13415.0,2,4790,2,13405.0,8,13415.0,8,B
2018-04-18 21:21:11,13405.0,2,4792,2,13405.0,7,13415.0,9,S
2018-04-18 21:21:13,13405.0,4,4796,0,13405.0,14,13415.0,9,S
2018-04-18 21:21:28,13405.0,2,4798,-2,13405.0,15,13415.0,9,S
2018-04-18 21:21:34,13415.0,2,4800,-2,13410.0,16,13420.0,39,B
2018-04-18 21:21:37,13410.0,30,4830,20,13405.0,6,13410.0,45,S
2018-04-18 21:21:37,13410.0,2,4832,0,13405.0,7,13410.0,44,S
2018-04-18 21:21:41,13410.0,2,4834,2,13405.0,8,13410.0,43,S
2018-04-18 21:21:42,13410.0,2,4836,0,13405.0,9,13410.0,42,S
2018-04-18 21:21:51,13405.0,4,4840,-2,13405.0,1,13410.0,45,S
2018-04-18 21:21:52,13405.0,2,4842,0,13400.0,12,13410.0,45,S
2018-04-18 21:21:58,13400.0,2,4844,0,13400.0,13,13410.0,47,S
2018-04-18 21:22:09,13400.0,2,4846,0,13400.0,9,13410.0,58,S
2018-04-18 21:22:10,13400.0,2,4848,0,13400.0,8,13410.0,58,S
2018-04-18 21:22:53,13400.0,2,4850,0,13400.0,8,13405.0,29,S
2018-04-18 21:22:56,13400.0,16,4866,8,13395.0,4,13405.0,36,S
2018-04-18 21:22:57,13400.0,8,4874,-4,13390.0,6,13400.0,22,S
2018-04-18 21:23:07,13395.0,2,4876,0,13390.0,5,13395.0,8,S
2018-04-18 21:23:09,13390.0,10,4886,2,13385.0,8,13390.0,1,S
2018-04-18 21:23:09,13385.0,4,4890,-2,13385.0,4,13390.0,13,S
2018-04-18 21:23:10,13385.0,8,4898,-2,13380.0,6,13385.0,4,S
2018-04-18 21:23:12,13385.0,2,4900,-2,13385.0,1,13390.0,19,S
2018-04-18 21:23:24,13380.0,6,4906,-4,13380.0,8,13385.0,1,S
2018-04-18 21:23:25,13385.0,4,4910,0,13385.0,11,13390.0,13,B
2018-04-18 21:23:26,13380.0,4,4914,0,13380.0,13,13390.0,13,S
2018-04-18 21:23:31,13390.0,4,4918,-2,13385.0,11,13390.0,5,B
2018-04-18 21:23:31,13390.0,2,4920,-2,13385.0,12,13390.0,4,B
2018-04-18 21:23:35,13390.0,6,4926,2,13390.0,2,13395.0,8,B
2018-04-18 21:23:38,13385.0,4,4930,-4,13385.0,9,13395.0,17,S
2018-04-18 21:23:40,13395.0,4,4934,0,13385.0,7,13395.0,16,B
2018-04-18 21:23:43,13390.0,2,4936,0,13385.0,10,13395.0,14,S
2018-04-18 21:23:50,13390.0,2,4938,0,13385.0,10,13395.0,14,S
2018-04-18 21:24:00,13395.0,6,4944,0,13385.0,12,13395.0,3,B
2018-04-18 21:24:04,13400.0,4,4948,-2,13395.0,5,13400.0,6,B
2018-04-18 21:24:04,13400.0,2,4950,-2,13395.0,6,13400.0,5,B
2018-04-18 21:24:07,13400.0,4,4954,0,13400.0,2,13405.0,19,B
2018-04-18 21:24:08,13405.0,6,4960,0,13400.0,4,13405.0,12,B
2018-04-18 21:24:08,13400.0,2,4962,0,13395.0,3,13400.0,1,S
2018-04-18 21:24:12,13405.0,2,4964,2,13395.0,3,13405.0,22,B
2018-04-18 21:24:27,13400.0,6,4970,4,13400.0,2,13405.0,22,S
2018-04-18 21:24:28,13400.0,2,4972,2,13400.0,1,13405.0,22,S
2018-04-18 21:24:31,13400.0,2,4974,0,13395.0,5,13405.0,22,S
2018-04-18 21:24:35,13400.0,2,4976,0,13400.0,1,13405.0,22,S
2018-04-18 21:24:36,13405.0,2,4978,0,13400.0,4,13405.0,12,B
2018-04-18 21:24:38,13400.0,2,4980,0,13400.0,3,13405.0,10,S
2018-04-18 21:24:42,13400.0,2,4982,2,13395.0,7,13405.0,22,S
2018-04-18 21:24:49,13400.0,4,4986,4,13395.0,11,13400.0,1,S
2018-04-18 21:24:50,13405.0,4,4990,2,13395.0,12,13405.0,14,B
2018-04-18 21:24:56,13395.0,20,5010,8,13395.0,1,13405.0,12,S
2018-04-18 21:24:58,13400.0,4,5014,4,13395.0,6,13400.0,8,B
2018-04-18 21:24:59,13405.0,18,5032,6,13395.0,7,13400.0,1,B
2018-04-18 21:24:59,13400.0,2,5034,0,13400.0,1,13405.0,13,S
2018-04-18 21:25:05,13395.0,16,5050,14,13390.0,21,13395.0,2,S
2018-04-18 21:25:05,13395.0,4,5054,4,13395.0,8,13400.0,1,S
2018-04-18 21:25:19,13395.0,2,5056,2,13390.0,9,13395.0,9,S
2018-04-18 21:25:28,13390.0,18,5074,16,13385.0,17,13390.0,1,S
2018-04-18 21:25:29,13390.0,2,5076,0,13390.0,1,13395.0,12,S
2018-04-18 21:25:29,13390.0,4,5080,0,13385.0,16,13395.0,12,S
2018-04-18 21:25:31,13385.0,10,5090,-4,13385.0,15,13395.0,12,S
2018-04-18 21:25:32,13390.0,2,5092,0,13385.0,6,13395.0,12,B
2018-04-18 21:25:38,13390.0,2,5094,2,13385.0,2,13390.0,3,B
2018-04-18 21:25:39,13390.0,4,5098,0,13385.0,7,13390.0,1,B
2018-04-18 21:25:39,13390.0,2,5100,0,13390.0,4,13395.0,15,B
2018-04-18 21:25:40,13390.0,2,5102,2,13385.0,10,13395.0,24,B
2018-04-18 21:25:48,13385.0,4,5106,2,13385.0,7,13395.0,26,S
2018-04-18 21:25:59,13385.0,2,5108,2,13385.0,2,13390.0,11,S
2018-04-18 21:25:59,13385.0,4,5112,-2,13380.0,15,13385.0,4,S
2018-04-18 21:26:01,13380.0,10,5122,0,13380.0,4,13385.0,18,S
2018-04-18 21:26:03,13385.0,2,5124,0,13380.0,9,13385.0,5,B
2018-04-18 21:26:06,13380.0,18,5142,12,13375.0,3,13380.0,1,S
2018-04-18 21:26:06,13380.0,2,5144,0,13380.0,1,13385.0,7,S
2018-04-18 21:26:20,13380.0,2,5146,0,13380.0,1,13385.0,21,S
2018-04-18 21:26:23,13385.0,2,5148,-2,13380.0,1,13385.0,3,B
2018-04-18 21:26:28,13380.0,2,5150,0,13380.0,1,13385.0,3,S
2018-04-18 21:26:32,13385.0,4,5154,2,13380.0,1,13385.0,3,B
2018-04-18 21:26:32,13380.0,2,5156,-2,13380.0,1,13385.0,3,S
2018-04-18 21:26:43,13380.0,2,5158,0,13380.0,1,13385.0,3,S
2018-04-18 21:26:49,13375.0,8,5166,0,13380.0,1,13385.0,3,S
2018-04-18 21:26:49,13370.0,2,5168,0,13380.0,1,13385.0,3,S
2018-04-18 21:26:53,13370.0,2,5170,0,13380.0,1,13385.0,3,S
2018-04-18 21:26:56,13370.0,10,5180,0,13380.0,1,13385.0,3,S
2018-04-18 21:26:56,13365.0,4,5184,-2,13380.0,1,13385.0,3,S
2018-04-18 21:26:59,13370.0,4,5188,4,13380.0,1,13385.0,3,B
2018-04-18 21:27:03,13365.0,2,5190,0,13380.0,1,13385.0,3,S
2018-04-18 21:27:04,13370.0,4,5194,4,13380.0,1,13385.0,3,B
2018-04-18 21:27:05,13365.0,2,5196,-2,13380.0,1,13385.0,3,S
2018-04-18 21:27:05,13370.0,4,5200,4,13380.0,1,13385.0,3,B
2018-04-18 21:27:08,13370.0,2,5202,-2,13380.0,1,13385.0,3,B
2018-04-18 21:27:15,13370.0,4,5206,0,13380.0,1,13385.0,3,B
2018-04-18 21:27:16,13365.0,2,5208,-2,13380.0,1,13385.0,3,S
2018-04-18 21:27:19,13365.0,6,5214,2,13380.0,1,13385.0,3,S
2018-04-18 21:27:20,13370.0,6,5220,2,13380.0,1,13385.0,3,B
2018-04-18 21:27:20,13375.0,2,5222,0,13380.0,1,13385.0,3,B
2018-04-18 21:27:22,13370.0,4,5226,-2,13370.0,4,13375.0,5,S
2018-04-18 21:27:23,13370.0,8,5234,2,13365.0,11,13370.0,3,S
2018-04-18 21:27:24,13370.0,6,5240,0,13365.0,10,13375.0,10,S
2018-04-18 21:27:28,13370.0,2,5242,-2,13365.0,10,13370.0,3,S
2018-04-18 21:27:28,13370.0,4,5246,-4,13365.0,11,13370.0,1,S
2018-04-18 21:27:29,13365.0,6,5252,-6,13365.0,8,13370.0,1,S
2018-04-18 21:27:33,13365.0,10,5262,6,13360.0,21,13365.0,5,S
2018-04-18 21:27:34,13365.0,8,5270,2,13360.0,30,13365.0,1,S
2018-04-18 21:27:34,13360.0,6,5276,0,13360.0,17,13370.0,5,S
2018-04-18 21:27:35,13370.0,4,5280,2,13360.0,21,13370.0,3,B
2018-04-18 21:27:37,13365.0,4,5284,4,13360.0,17,13365.0,4,S
2018-04-18 21:27:40,13365.0,4,5288,4,13360.0,19,13365.0,2,S
2018-04-18 21:27:40,13365.0,4,5292,4,13360.0,19,13370.0,5,S
2018-04-18 21:27:44,13365.0,2,5294,-2,13360.0,15,13365.0,1,S
2018-04-18 21:27:45,13370.0,6,5300,-2,13360.0,19,13370.0,5,B
2018-04-18 21:27:51,13360.0,2,5302,-2,13360.0,24,13370.0,12,S
2018-04-18 21:27:54,13360.0,4,5306,-2,13360.0,4,13365.0,5,S
2018-04-18 21:27:56,13365.0,4,5310,0,13360.0,4,13365.0,9,B
2018-04-18 21:28:03,13365.0,8,5318,6,13360.0,5,13365.0,6,B
2018-04-18 21:28:05,13365.0,4,5322,4,13360.0,5,13365.0,4,B
2018-04-18 21:28:07,13365.0,2,5324,2,13360.0,5,13365.0,6,B
2018-04-18 21:28:09,13365.0,2,5326,0,13360.0,5,13365.0,4,B
2018-04-18 21:28:15,13365.0,2,5328,2,13360.0,7,13365.0,1,B
2018-04-18 21:28:16,13365.0,2,5330,2,13365.0,3,13370.0,11,B
2018-04-18 21:28:17,13370.0,4,5334,2,13365.0,3,13370.0,9,B
2018-04-18 21:28:18,13370.0,8,5342,2,13365.0,3,13370.0,7,B
2018-04-18 21:28:18,13370.0,2,5344,0,13370.0,1,13375.0,8,B
2018-04-18 21:28:19,13370.0,2,5346,0,13365.0,5,13375.0,9,B
2018-04-18 21:28:23,13370.0,4,5350,0,13365.0,1,13370.0,9,B
2018-04-18 21:28:27,13370.0,4,5354,2,13365.0,4,13370.0,3,B
2018-04-18 21:28:28,13370.0,6,5360,2,13370.0,3,13375.0,9,B
2018-04-18 21:28:29,13375.0,6,5366,2,13375.0,1,13380.0,23,B
2018-04-18 21:28:30,13380.0,8,5374,0,13370.0,9,13375.0,1,B
2018-04-18 21:28:36,13375.0,4,5378,0,13375.0,2,13380.0,8,S
2018-04-18 21:28:39,13375.0,2,5380,0,13370.0,14,13380.0,9,S
2018-04-18 21:28:41,13375.0,2,5382,-2,13370.0,15,13380.0,9,S
2018-04-18 21:28:44,13370.0,2,5384,-2,13370.0,5,13375.0,4,S
2018-04-18 21:28:46,13375.0,2,5386,0,13370.0,5,13375.0,3,B
2018-04-18 21:28:48,13375.0,2,5388,-2,13375.0,1,13380.0,9,B
2018-04-18 21:29:07,13380.0,4,5392,0,13375.0,1,13380.0,5,B
2018-04-18 21:29:08,13375.0,2,5394,2,13370.0,16,13380.0,5,S
2018-04-18 21:29:09,13380.0,2,5396,-2,13370.0,15,13380.0,4,B
2018-04-18 21:29:19,13370.0,20,5416,6,13370.0,10,13380.0,8,S
2018-04-18 21:29:20,13380.0,2,5418,2,13375.0,1,13380.0,13,B
2018-04-18 21:29:23,13380.0,12,5430,8,13370.0,10,13380.0,8,B
2018-04-18 21:29:25,13380.0,8,5438,4,13375.0,1,13380.0,2,B
2018-04-18 21:29:26,13380.0,2,5440,0,13380.0,1,13385.0,4,B
2018-04-18 21:29:26,13385.0,2,5442,2,13385.0,3,13390.0,7,B
2018-04-18 21:29:27,13390.0,4,5446,2,13385.0,1,13390.0,1,B
2018-04-18 21:29:29,13385.0,2,5448,0,13380.0,3,13390.0,22,S
2018-04-18 21:29:31,13380.0,10,5458,6,13380.0,3,13390.0,24,S
2018-04-18 21:29:38,13380.0,2,5460,-2,13380.0,3,13390.0,24,S
2018-04-18 21:29:41,13375.0,2,5462,2,13380.0,3,13390.0,24,S
2018-04-18 21:29:41,13370.0,8,5470,4,13380.0,3,13390.0,24,S
2018-04-18 21:29:45,13375.0,2,5472,0,13380.0,3,13390.0,24,B
2018-04-18 21:29:47,13375.0,2,5474,2,13380.0,3,13390.0,24,B
2018-04-18 21:29:58,13370.0,2,5476,0,13380.0,3,13390.0,24,S
2018-04-18 21:30:03,13375.0,6,5482,-2,13380.0,3,13390.0,24,B
2018-04-18 21:30:17,13375.0,2,5484,2,13380.0,3,13390.0,24,B
2018-04-18 21:30:17,13375.0,2,5486,0,13380.0,3,13390.0,24,B
2018-04-18 21:30:18,13375.0,2,5488,2,13380.0,3,13390.0,24,B
2018-04-18 21:30:44,13370.0,2,5490,0,13380.0,3,13390.0,24,S
2018-04-18 21:30:58,13380.0,2,5492,-2,13375.0,10,13380.0,2,B
2018-04-18 21:31:03,13380.0,2,5494,-2,13375.0,10,13380.0,1,B
2018-04-18 21:31:07,13380.0,2,5496,0,13380.0,1,13385.0,14,B
2018-04-18 21:31:08,13380.0,2,5498,0,13375.0,22,13385.0,11,B
2018-04-18 21:31:10,13375.0,2,5500,0,13375.0,21,13385.0,11,S
2018-04-18 21:31:12,13385.0,10,5510,6,13375.0,21,13385.0,6,B
2018-04-18 21:31:31,13380.0,2,5512,-2,13375.0,21,13385.0,6,S
2018-04-18 21:31:37,13380.0,2,5514,0,13375.0,21,13385.0,6,S
2018-04-18 21:31:38,13380.0,4,5518,4,13375.0,21,13385.0,6,S
2018-04-18 21:31:45,13385.0,2,5520,0,13375.0,21,13385.0,6,B
2018-04-18 21:32:11,13380.0,16,5536,0,13375.0,21,13385.0,6,S
2018-04-18 21:32:11,13375.0,8,5544,6,13375.0,21,13385.0,6,S
2018-04-18 21:32:12,13375.0,6,5550,0,13375.0,21,13385.0,6,S
2018-04-18 21:32:12,13375.0,2,5552,2,13375.0,21,13385.0,6,S
2018-04-18 21:32:22,13370.0,2,5554,0,13375.0,21,13385.0,6,S
2018-04-18 21:32:24,13370.0,4,5558,4,13375.0,21,13385.0,6,S
2018-04-18 21:32:30,13365.0,12,5570,-6,13375.0,21,13385.0,6,S
2018-04-18 21:32:42,13365.0,2,5572,-2,13375.0,21,13385.0,6,S
2018-04-18 21:32:45,13365.0,2,5574,-2,13375.0,21,13385.0,6,S
2018-04-18 21:32:46,13370.0,4,5578,2,13375.0,21,13385.0,6,B
2018-04-18 21:32:47,13365.0,10,5588,-10,13375.0,21,13385.0,6,S
2018-04-18 21:32:49,13360.0,2,5590,0,13375.0,21,13385.0,6,S
2018-04-18 21:32:52,13365.0,2,5592,2,13375.0,21,13385.0,6,B
2018-04-18 21:32:53,13365.0,2,5594,-2,13375.0,21,13385.0,6,B
2018-04-18 21:32:53,13365.0,2,5596,0,13375.0,21,13385.0,6,B
2018-04-18 21:32:55,13360.0,2,5598,2,13375.0,21,13385.0,6,S
2018-04-18 21:32:56,13360.0,2,5600,0,13375.0,21,13385.0,6,S
2018-04-18 21:32:59,13365.0,2,5602,0,13375.0,21,13385.0,6,B
2018-04-18 21:33:07,13370.0,4,5606,0,13365.0,18,13375.0,4,B
2018-04-18 21:33:35,13370.0,4,5610,0,13365.0,18,13375.0,4,B
2018-04-18 21:33:36,13370.0,2,5612,0,13365.0,18,13375.0,4,B
2018-04-18 21:33:47,13370.0,2,5614,0,13365.0,18,13375.0,4,B
2018-04-18 21:33:49,13370.0,4,5618,2,13365.0,18,13375.0,4,B
2018-04-18 21:33:56,13365.0,4,5622,0,13365.0,18,13375.0,4,S
2018-04-18 21:33:57,13365.0,2,5624,0,13365.0,18,13375.0,4,S
2018-04-18 21:34:11,13370.0,2,5626,0,13365.0,18,13375.0,4,B
2018-04-18 21:34:13,13370.0,4,5630,-2,13365.0,18,13375.0,4,B
2018-04-18 21:34:14,13370.0,4,5634,0,13365.0,18,13375.0,4,B
2018-04-18 21:35:05,13370.0,4,5638,-4,13365.0,18,13375.0,4,B
2018-04-18 21:35:24,13370.0,2,5640,-2,13365.0,18,13375.0,4,B
2018-04-18 21:35:32,13370.0,2,5642,-2,13365.0,18,13375.0,4,B
2018-04-18 21:35:47,13365.0,4,5646,-4,13365.0,18,13375.0,4,S
2018-04-18 21:36:03,13365.0,6,5652,-6,13365.0,18,13375.0,4,S
2018-04-18 21:36:04,13365.0,2,5654,2,13365.0,18,13375.0,4,S
2018-04-18 21:36:08,13370.0,2,5656,-2,13365.0,18,13375.0,4,B
2018-04-18 21:36:25,13370.0,2,5658,0,13365.0,18,13375.0,4,B
2018-04-18 21:36:28,13365.0,2,5660,0,13365.0,18,13375.0,4,S
2018-04-18 21:36:28,13365.0,24,5684,14,13365.0,18,13375.0,4,S
2018-04-18 21:36:29,13365.0,4,5688,-2,13365.0,18,13375.0,4,S
2018-04-18 21:36:37,13360.0,6,5694,0,13365.0,18,13375.0,4,S
2018-04-18 21:36:37,13360.0,6,5700,-2,13365.0,18,13375.0,4,S
2018-04-18 21:36:38,13360.0,2,5702,-2,13365.0,18,13375.0,4,S
2018-04-18 21:36:39,13360.0,2,5704,0,13365.0,18,13375.0,4,S
2018-04-18 21:36:40,13355.0,8,5712,2,13365.0,18,13375.0,4,S
2018-04-18 21:36:41,13360.0,2,5714,2,13365.0,18,13375.0,4,B
2018-04-18 21:36:57,13355.0,2,5716,-2,13365.0,18,13375.0,4,S
2018-04-18 21:37:00,13355.0,2,5718,-2,13365.0,18,13375.0,4,S
2018-04-18 21:37:01,13355.0,18,5736,-8,13365.0,18,13375.0,4,S
2018-04-18 21:37:01,13350.0,4,5740,-2,13365.0,18,13375.0,4,S
2018-04-18 21:37:02,13345.0,2,5742,-2,13365.0,18,13375.0,4,S
2018-04-18 21:37:02,13345.0,20,5762,-16,13365.0,18,13375.0,4,S
2018-04-18 21:37:06,13345.0,2,5764,-2,13365.0,18,13375.0,4,S
2018-04-18 21:37:10,13345.0,2,5766,0,13365.0,18,13375.0,4,S
2018-04-18 21:37:13,13345.0,2,5768,0,13365.0,18,13375.0,4,S
2018-04-18 21:37:20,13350.0,8,5776,-2,13365.0,18,13375.0,4,B
2018-04-18 21:37:21,13350.0,4,5780,0,13365.0,18,13375.0,4,B
2018-04-18 21:37:22,13350.0,6,5786,0,13365.0,18,13375.0,4,B
2018-04-18 21:37:23,13350.0,6,5792,-4,13365.0,18,13375.0,4,B
2018-04-18 21:37:23,13345.0,10,5802,6,13365.0,18,13375.0,4,S
2018-04-18 21:37:24,13345.0,10,5812,0,13365.0,18,13375.0,4,S
2018-04-18 21:37:26,13345.0,4,5816,2,13365.0,18,13375.0,4,S
2018-04-18 21:37:29,13340.0,22,5838,-8,13365.0,18,13375.0,4,S
2018-04-18 21:37:29,13340.0,4,5842,0,13365.0,18,13375.0,4,S
2018-04-18 21:37:31,13340.0,10,5852,-6,13365.0,18,13375.0,4,S
2018-04-18 21:37:32,13335.0,6,5858,2,13365.0,18,13375.0,4,S
2018-04-18 21:37:32,13335.0,2,5860,0,13365.0,18,13375.0,4,S
2018-04-18 21:37:36,13335.0,2,5862,0,13365.0,18,13375.0,4,S
2018-04-18 21:37:37,13330.0,6,5868,-2,13365.0,18,13375.0,4,S
2018-04-18 21:37:42,13330.0,2,5870,0,13365.0,18,13375.0,4,S
2018-04-18 21:37:47,13330.0,2,5872,-2,13365.0,18,13375.0,4,S
2018-04-18 21:37:47,13330.0,2,5874,0,13365.0,18,13375.0,4,S
2018-04-18 21:37:49,13330.0,2,5876,0,13365.0,18,13375.0,4,S
2018-04-18 21:37:50,13330.0,2,5878,-2,13365.0,18,13375.0,4,S
2018-04-18 21:37:52,13330.0,2,5880,-2,13365.0,18,13375.0,4,S
2018-04-18 21:37:54,13330.0,2,5882,0,13365.0,18,13375.0,4,S
2018-04-18 21:37:56,13335.0,4,5886,2,13365.0,18,13375.0,4,B
2018-04-18 21:37:56,13330.0,8,5894,6,13365.0,18,13375.0,4,S
2018-04-18 21:37:57,13325.0,2,5896,-2,13365.0,18,13375.0,4,S
2018-04-18 21:37:57,13325.0,8,5904,6,13365.0,18,13375.0,4,S
2018-04-18 21:38:00,13320.0,2,5906,-2,13365.0,18,13375.0,4,S
2018-04-18 21:38:01,13320.0,10,5916,4,13365.0,18,13375.0,4,S
2018-04-18 21:38:01,13315.0,2,5918,0,13365.0,18,13375.0,4,S
2018-04-18 21:38:02,13315.0,2,5920,0,13365.0,18,13375.0,4,S
2018-04-18 21:38:03,13310.0,8,5928,0,13365.0,18,13375.0,4,S
2018-04-18 21:38:04,13310.0,4,5932,-4,13365.0,18,13375.0,4,S
2018-04-18 21:38:04,13310.0,4,5936,0,13365.0,18,13375.0,4,S
2018-04-18 21:38:06,13310.0,2,5938,0,13365.0,18,13375.0,4,S
2018-04-18 21:38:07,13310.0,4,5942,-4,13365.0,18,13375.0,4,S
2018-04-18 21:38:08,13315.0,12,5954,6,13365.0,18,13375.0,4,B
2018-04-18 21:38:09,13310.0,2,5956,0,13365.0,18,13375.0,4,S
2018-04-18 21:38:10,13310.0,2,5958,0,13365.0,18,13375.0,4,S
2018-04-18 21:38:11,13305.0,2,5960,2,13365.0,18,13375.0,4,S
2018-04-18 21:38:11,13305.0,10,5970,10,13365.0,18,13375.0,4,S
2018-04-18 21:38:12,13305.0,4,5974,4,13365.0,18,13375.0,4,S
2018-04-18 21:38:15,13305.0,10,5984,4,13365.0,18,13375.0,4,S
2018-04-18 21:38:16,13315.0,6,5990,-4,13365.0,18,13375.0,4,B
2018-04-18 21:38:17,13315.0,4,5994,-4,13365.0,18,13375.0,4,B
2018-04-18 21:38:23,13315.0,2,5996,-2,13365.0,18,13375.0,4,B
2018-04-18 21:38:24,13320.0,6,6002,2,13365.0,18,13375.0,4,B
2018-04-18 21:38:25,13320.0,2,6004,0,13365.0,18,13375.0,4,B
2018-04-18 21:38:27,13325.0,6,6010,-2,13365.0,18,13375.0,4,B
2018-04-18 21:38:31,13320.0,2,6012,2,13365.0,18,13375.0,4,S
2018-04-18 21:38:33,13330.0,4,6016,0,13365.0,18,13375.0,4,B
2018-04-18 21:38:37,13330.0,2,6018,2,13365.0,18,13375.0,4,B
2018-04-18 21:38:39,13325.0,4,6022,4,13365.0,18,13375.0,4,S
2018-04-18 21:38:41,13330.0,4,6026,-2,13365.0,18,13375.0,4,B
2018-04-18 21:38:43,13330.0,2,6028,-2,13365.0,18,13375.0,4,B
2018-04-18 21:38:45,13325.0,2,6030,2,13365.0,18,13375.0,4,S
2018-04-18 21:38:47,13325.0,10,6040,-4,13365.0,18,13375.0,4,S
2018-04-18 21:38:48,13325.0,2,6042,0,13365.0,18,13375.0,4,S
2018-04-18 21:38:51,13330.0,2,6044,0,13365.0,18,13375.0,4,B
2018-04-18 21:38:53,13335.0,2,6046,0,13365.0,18,13375.0,4,B
2018-04-18 21:38:54,13335.0,2,6048,-2,13365.0,18,13375.0,4,B
2018-04-18 21:38:56,13325.0,2,6050,-2,13365.0,18,13375.0,4,S
2018-04-18 21:38:57,13325.0,2,6052,2,13365.0,18,13375.0,4,S
2018-04-18 21:38:59,13325.0,12,6064,-4,13365.0,18,13375.0,4,S
2018-04-18 21:39:06,13335.0,2,6066,2,13365.0,18,13375.0,4,B
2018-04-18 21:39:07,13335.0,2,6068,-2,13365.0,18,13375.0,4,B
2018-04-18 21:39:13,13330.0,2,6070,2,13365.0,18,13375.0,4,S
2018-04-18 21:39:17,13330.0,2,6072,0,13365.0,18,13375.0,4,S
2018-04-18 21:39:19,13335.0,2,6074,0,13365.0,18,13375.0,4,B
2018-04-18 21:39:27,13335.0,2,6076,2,13365.0,18,13375.0,4,B
2018-04-18 21:39:28,13330.0,6,6082,-4,13365.0,18,13375.0,4,S
2018-04-18 21:39:30,13330.0,2,6084,0,13365.0,18,13375.0,4,S
2018-04-18 21:39:31,13330.0,2,6086,0,13365.0,18,13375.0,4,S
2018-04-18 21:39:32,13330.0,2,6088,2,13365.0,18,13375.0,4,S
2018-04-18 21:39:32,13330.0,2,6090,0,13365.0,18,13375.0,4,S
2018-04-18 21:39:33,13330.0,2,6092,0,13365.0,18,13375.0,4,S
2018-04-18 21:39:34,13335.0,10,6102,-4,13365.0,18,13375.0,4,B
2018-04-18 21:39:36,13335.0,2,6104,0,13365.0,18,13375.0,4,B
2018-04-18 21:39:39,13335.0,2,6106,0,13365.0,18,13375.0,4,B
2018-04-18 21:39:40,13335.0,2,6108,2,13365.0,18,13375.0,4,B
2018-04-18 21:39:41,13325.0,16,6124,10,13365.0,18,13375.0,4,S
2018-04-18 21:39:41,13325.0,4,6128,4,13365.0,18,13375.0,4,S
2018-04-18 21:39:46,13320.0,2,6130,2,13365.0,18,13375.0,4,S
2018-04-18 21:39:46,13320.0,4,6134,0,13365.0,18,13375.0,4,S
2018-04-18 21:39:47,13320.0,2,6136,0,13365.0,18,13375.0,4,S
2018-04-18 21:39:48,13315.0,14,6150,-8,13365.0,18,13375.0,4,S
2018-04-18 21:39:51,13320.0,2,6152,0,13365.0,18,13375.0,4,B
2018-04-18 21:39:58,13320.0,2,6154,2,13365.0,18,13375.0,4,B
2018-04-18 21:39:59,13320.0,2,6156,0,13365.0,18,13375.0,4,B
2018-04-18 21:40:02,13315.0,4,6160,2,13365.0,18,13375.0,4,S
2018-04-18 21:40:08,13325.0,4,6164,-2,13365.0,18,13375.0,4,B
2018-04-18 21:40:25,13325.0,2,6166,2,13365.0,18,13375.0,4,B
2018-04-18 21:40:37,13330.0,4,6170,0,13365.0,18,13375.0,4,B
2018-04-18 21:40:41,13330.0,40,6210,12,13365.0,18,13375.0,4,B
2018-04-18 21:40:43,13330.0,2,6212,0,13365.0,18,13375.0,4,B
2018-04-18 21:40:52,13335.0,6,6218,-6,13365.0,18,13375.0,4,B
2018-04-18 21:40:55,13330.0,2,6220,0,13365.0,18,13375.0,4,S
2018-04-18 21:40:56,13330.0,2,6222,-2,13365.0,18,13375.0,4,S
2018-04-18 21:41:00,13335.0,4,6226,0,13365.0,18,13375.0,4,B
2018-04-18 21:41:00,13340.0,2,6228,2,13365.0,18,13375.0,4,B
2018-04-18 21:41:04,13340.0,12,6240,6,13365.0,18,13375.0,4,B
2018-04-18 21:41:11,13340.0,2,6242,-2,13365.0,18,13375.0,4,B
2018-04-18 21:41:12,13340.0,2,6244,0,13365.0,18,13375.0,4,B
2018-04-18 21:41:13,13340.0,2,6246,-2,13365.0,18,13375.0,4,B
2018-04-18 21:41:13,13340.0,8,6254,-2,13365.0,18,13375.0,4,B
2018-04-18 21:41:14,13340.0,6,6260,-6,13365.0,18,13375.0,4,B
2018-04-18 21:41:16,13340.0,2,6262,0,13365.0,18,13375.0,4,B
2018-04-18 21:41:20,13345.0,4,6266,-2,13365.0,18,13375.0,4,B
2018-04-18 21:41:20,13345.0,2,6268,-2,13365.0,18,13375.0,4,B
2018-04-18 21:41:23,13350.0,4,6272,-2,13365.0,18,13375.0,4,B
2018-04-18 21:41:24,13345.0,20,6292,2,13365.0,18,13375.0,4,S
2018-04-18 21:41:25,13345.0,2,6294,2,13365.0,18,13375.0,4,S
2018-04-18 21:41:32,13340.0,16,6310,-4,13365.0,18,13375.0,4,S
2018-04-18 21:41:33,13340.0,4,6314,2,13365.0,18,13375.0,4,S
2018-04-18 21:41:40,13340.0,2,6316,0,13365.0,18,13375.0,4,S
2018-04-18 21:41:58,13345.0,20,6336,-6,13365.0,18,13375.0,4,B
2018-04-18 21:42:01,13335.0,2,6338,0,13365.0,18,13375.0,4,S
2018-04-18 21:42:02,13335.0,2,6340,0,13365.0,18,13375.0,4,S
2018-04-18 21:42:05,13330.0,2,6342,2,13365.0,18,13375.0,4,S
2018-04-18 21:42:12,13335.0,20,6362,-8,13365.0,18,13375.0,4,B
2018-04-18 21:42:12,13335.0,6,6368,-2,13365.0,18,13375.0,4,B
2018-04-18 21:42:13,13335.0,4,6372,-4,13365.0,18,13375.0,4,B
2018-04-18 21:42:30,13335.0,2,6374,0,13365.0,18,13375.0,4,B
2018-04-18 21:42:32,13330.0,6,6380,4,13365.0,18,13375.0,4,S
2018-04-18 21:43:02,13330.0,6,6386,0,13365.0,18,13375.0,4,S
2018-04-18 21:43:14,13330.0,2,6388,-2,13365.0,18,13375.0,4,S
2018-04-18 21:43:15,13340.0,2,6390,0,13365.0,18,13375.0,4,B
2018-04-18 21:43:23,13340.0,2,6392,0,13365.0,18,13375.0,4,B
2018-04-18 21:43:35,13345.0,4,6396,2,13365.0,18,13375.0,4,B
2018-04-18 21:43:40,13340.0,6,6402,0,13365.0,18,13375.0,4,S
2018-04-18 21:43:43,13345.0,2,6404,2,13365.0,18,13375.0,4,B
2018-04-18 21:44:03,13350.0,2,6406,0,13365.0,18,13375.0,4,B
2018-04-18 21:44:16,13345.0,4,6410,-4,13365.0,18,13375.0,4,S
2018-04-18 21:44:20,13350.0,2,6412,0,13365.0,18,13375.0,4,B
2018-04-18 21:44:21,13345.0,2,6414,0,13365.0,18,13375.0,4,S
2018-04-18 21:44:24,13345.0,4,6418,-4,13365.0,18,13375.0,4,S
2018-04-18 21:44:28,13345.0,2,6420,0,13365.0,18,13375.0,4,S
2018-04-18 21:44:36,13345.0,2,6422,0,13365.0,18,13375.0,4,S
2018-04-18 21:44:45,13350.0,8,6430,0,13365.0,18,13375.0,4,B
2018-04-18 21:44:45,13350.0,4,6434,2,13365.0,18,13375.0,4,B
2018-04-18 21:44:53,13350.0,2,6436,0,13365.0,18,13375.0,4,B
2018-04-18 21:45:01,13350.0,2,6438,2,13365.0,18,13375.0,4,B
2018-04-18 21:45:04,13340.0,72,6510,38,13365.0,18,13375.0,4,S
2018-04-18 21:45:04,13340.0,90,6600,64,13365.0,18,13375.0,4,S
2018-04-18 21:45:05,13340.0,90,6690,64,13365.0,18,13375.0,4,S
2018-04-18 21:45:06,13345.0,2,6692,2,13365.0,18,13375.0,4,B
2018-04-18 21:45:07,13345.0,2,6694,0,13365.0,18,13375.0,4,B
2018-04-18 21:45:09,13350.0,4,6698,2,13365.0,18,13375.0,4,B
2018-04-18 21:45:17,13345.0,2,6700,2,13365.0,18,13375.0,4,S
2018-04-18 21:45:25,13350.0,2,6702,0,13365.0,18,13375.0,4,B
2018-04-18 21:45:31,13360.0,44,6746,-24,13365.0,18,13375.0,4,B
2018-04-18 21:45:32,13360.0,106,6852,-78,13365.0,18,13375.0,4,B
2018-04-18 21:45:32,13360.0,76,6928,-50,13365.0,18,13375.0,4,B
2018-04-18 21:45:33,13360.0,26,6954,-12,13365.0,18,13375.0,4,B
2018-04-18 21:45:33,13360.0,4,6958,2,13365.0,18,13375.0,4,B
2018-04-18 21:45:36,13360.0,8,6966,4,13365.0,18,13375.0,4,B
2018-04-18 21:45:42,13355.0,2,6968,-2,13365.0,18,13375.0,4,S
2018-04-18 21:45:45,13355.0,4,6972,-4,13365.0,18,13375.0,4,S
2018-04-18 21:45:46,13355.0,2,6974,0,13365.0,18,13375.0,4,S
2018-04-18 21:45:48,13350.0,8,6982,-6,13365.0,18,13375.0,4,S
2018-04-18 21:45:50,13350.0,4,6986,-4,13365.0,18,13375.0,4,S
2018-04-18 21:45:57,13350.0,4,6990,2,13365.0,18,13375.0,4,S
2018-04-18 21:45:59,13350.0,2,6992,0,13365.0,18,13375.0,4,S
2018-04-18 21:46:00,13350.0,12,7004,2,13365.0,18,13375.0,4,S
2018-04-18 21:46:08,13345.0,2,7006,0,13365.0,18,13375.0,4,S
2018-04-18 21:46:09,13350.0,18,7024,0,13365.0,18,13375.0,4,B
2018-04-18 21:46:09,13345.0,14,7038,2,13365.0,18,13375.0,4,S
2018-04-18 21:46:11,13350.0,2,7040,0,13365.0,18,13375.0,4,B
2018-04-18 21:46:14,13345.0,4,7044,-4,13365.0,18,13375.0,4,S
2018-04-18 21:46:21,13345.0,2,7046,0,13365.0,18,13375.0,4,S
2018-04-18 21:46:29,13345.0,2,7048,-2,13365.0,18,13375.0,4,S
2018-04-18 21:46:37,13345.0,2,7050,0,13365.0,18,13375.0,4,S
2018-04-18 21:46:48,13345.0,2,7052,-2,13365.0,18,13375.0,4,S
2018-04-18 21:47:12,13350.0,4,7056,4,13365.0,18,13375.0,4,B
2018-04-18 21:47:12,13350.0,16,7072,-6,13365.0,18,13375.0,4,B
2018-04-18 21:47:17,13355.0,2,7074,0,13365.0,18,13375.0,4,B
2018-04-18 21:47:25,13350.0,2,7076,-2,13365.0,18,13375.0,4,S
2018-04-18 21:47:27,13350.0,2,7078,-2,13365.0,18,13375.0,4,S
2018-04-18 21:47:27,13350.0,4,7082,-4,13365.0,18,13375.0,4,S
2018-04-18 21:47:38,13350.0,2,7084,-2,13365.0,18,13375.0,4,S
2018-04-18 21:47:38,13350.0,16,7100,-8,13365.0,18,13375.0,4,S
2018-04-18 21:47:39,13350.0,2,7102,-2,13365.0,18,13375.0,4,S
2018-04-18 21:48:12,13350.0,2,7104,-2,13365.0,18,13375.0,4,S
2018-04-18 21:48:17,13345.0,8,7112,0,13365.0,18,13375.0,4,S
2018-04-18 21:48:18,13345.0,6,7118,-2,13365.0,18,13375.0,4,S
2018-04-18 21:48:30,13345.0,4,7122,2,13365.0,18,13375.0,4,S
2018-04-18 21:48:41,13345.0,2,7124,2,13365.0,18,13375.0,4,S
2018-04-18 21:48:41,13345.0,2,7126,2,13365.0,18,13375.0,4,S
2018-04-18 21:48:52,13345.0,2,7128,0,13365.0,18,13375.0,4,S
2018-04-18 21:49:02,13345.0,2,7130,2,13365.0,18,13375.0,4,S
2018-04-18 21:49:03,13345.0,2,7132,0,13365.0,18,13375.0,4,S
2018-04-18 21:49:22,13345.0,2,7134,-2,13365.0,18,13375.0,4,S
2018-04-18 21:49:24,13350.0,4,7138,0,13365.0,18,13375.0,4,B
2018-04-18 21:49:38,13350.0,4,7142,0,13365.0,18,13375.0,4,B
2018-04-18 21:50:24,13350.0,60,7202,-60,13365.0,18,13375.0,4,B
2018-04-18 21:50:43,13345.0,2,7204,0,13365.0,18,13375.0,4,S
2018-04-18 21:50:52,13345.0,4,7208,-4,13365.0,18,13375.0,4,S
2018-04-18 21:51:13,13350.0,20,7228,0,13365.0,18,13375.0,4,B
2018-04-18 21:51:19,13350.0,2,7230,-2,13365.0,18,13375.0,4,B
2018-04-18 21:51:22,13345.0,2,7232,0,13365.0,18,13375.0,4,S
2018-04-18 21:51:23,13345.0,10,7242,-10,13365.0,18,13375.0,4,S
2018-04-18 21:51:30,13345.0,2,7244,-2,13365.0,18,13375.0,4,S
2018-04-18 21:52:05,13345.0,2,7246,0,13365.0,18,13375.0,4,S
2018-04-18 21:52:10,13345.0,4,7250,2,13365.0,18,13375.0,4,S
2018-04-18 21:52:11,13345.0,8,7258,8,13365.0,18,13375.0,4,S
2018-04-18 21:52:16,13345.0,4,7262,0,13365.0,18,13375.0,4,S
2018-04-18 21:52:19,13340.0,4,7266,2,13365.0,18,13375.0,4,S
2018-04-18 21:52:29,13340.0,2,7268,-2,13365.0,18,13375.0,4,S
2018-04-18 21:52:31,13340.0,8,7276,-4,13365.0,18,13375.0,4,S
2018-04-18 21:52:47,13340.0,2,7278,0,13365.0,18,13375.0,4,S
2018-04-18 21:52:49,13340.0,2,7280,-2,13365.0,18,13375.0,4,S
2018-04-18 21:53:11,13345.0,2,7282,0,13365.0,18,13375.0,4,B
2018-04-18 21:53:11,13345.0,6,7288,-4,13365.0,18,13375.0,4,B
2018-04-18 21:53:12,13340.0,2,7290,0,13365.0,18,13375.0,4,S
2018-04-18 21:53:37,13340.0,4,7294,-4,13365.0,18,13375.0,4,S
2018-04-18 21:53:45,13340.0,2,7296,0,13365.0,18,13375.0,4,S
2018-04-18 21:54:04,13345.0,2,7298,0,13365.0,18,13375.0,4,B
2018-04-18 21:54:12,13340.0,2,7300,0,13365.0,18,13375.0,4,S
2018-04-18 21:54:42,13345.0,2,7302,0,13365.0,18,13375.0,4,B
2018-04-18 21:54:51,13345.0,4,7306,4,13365.0,18,13375.0,4,B
2018-04-18 21:54:56,13345.0,2,7308,2,13365.0,18,13375.0,4,B
2018-04-18 21:54:57,13345.0,4,7312,4,13365.0,18,13375.0,4,B
2018-04-18 21:55:03,13345.0,10,7322,4,13365.0,18,13375.0,4,B
2018-04-18 21:55:10,13345.0,2,7324,0,13365.0,18,13375.0,4,B
2018-04-18 21:55:23,13350.0,24,7348,16,13365.0,18,13375.0,4,B
2018-04-18 21:55:24,13350.0,2,7350,2,13365.0,18,13375.0,4,B
2018-04-18 21:55:24,13350.0,8,7358,8,13365.0,18,13375.0,4,B
2018-04-18 21:55:57,13350.0,2,7360,2,13365.0,18,13375.0,4,B
2018-04-18 21:56:10,13350.0,4,7364,0,13365.0,18,13375.0,4,B
2018-04-18 21:56:13,13350.0,4,7368,0,13365.0,18,13375.0,4,B
2018-04-18 21:56:29,13355.0,32,7400,22,13365.0,18,13375.0,4,B
2018-04-18 21:56:29,13355.0,8,7408,4,13365.0,18,13375.0,4,B
2018-04-18 21:56:30,13355.0,4,7412,-4,13365.0,18,13375.0,4,B
2018-04-18 21:57:14,13350.0,2,7414,0,13365.0,18,13375.0,4,S
2018-04-18 21:57:25,13350.0,2,7416,2,13365.0,18,13375.0,4,S
2018-04-18 21:57:44,13350.0,2,7418,0,13365.0,18,13375.0,4,S
2018-04-18 21:57:48,13350.0,8,7426,0,13365.0,18,13375.0,4,S
2018-04-18 21:57:49,13350.0,4,7430,4,13365.0,18,13375.0,4,S
2018-04-18 21:57:51,13350.0,8,7438,2,13365.0,18,13375.0,4,S
2018-04-18 21:57:52,13345.0,4,7442,-4,13365.0,18,13375.0,4,S
2018-04-18 21:57:54,13345.0,4,7446,-4,13365.0,18,13375.0,4,S
2018-04-18 21:57:58,13345.0,2,7448,-2,13365.0,18,13375.0,4,S
2018-04-18 21:58:32,13345.0,4,7452,-4,13365.0,18,13375.0,4,S
2018-04-18 21:59:07,13345.0,4,7456,-2,13365.0,18,13375.0,4,S
2018-04-18 21:59:08,13340.0,4,7460,0,13365.0,18,13375.0,4,S
2018-04-18 21:59:18,13345.0,2,7462,-2,13365.0,18,13375.0,4,B
2018-04-18 21:59:19,13345.0,2,7464,0,13365.0,18,13375.0,4,B
2018-04-18 21:59:20,13345.0,4,7468,-4,13365.0,18,13375.0,4,B
2018-04-18 21:59:25,13350.0,2,7470,0,13365.0,18,13375.0,4,B
2018-04-18 21:59:30,13350.0,10,7480,2,13365.0,18,13375.0,4,B
2018-04-18 21:59:30,13350.0,16,7496,-10,13365.0,18,13375.0,4,B
2018-04-18 21:59:33,13350.0,2,7498,-2,13365.0,18,13375.0,4,B
2018-04-18 21:59:50,13345.0,4,7502,0,13365.0,18,13375.0,4,S
2018-04-18 21:59:51,13350.0,4,7506,-4,13365.0,18,13375.0,4,B
2018-04-18 21:59:51,13345.0,2,7508,0,13365.0,18,13375.0,4,S
2018-04-18 22:00:13,13345.0,2,7510,2,13365.0,18,13375.0,4,S
2018-04-18 22:00:16,13345.0,2,7512,0,13365.0,18,13375.0,4,S
2018-04-18 22:00:30,13345.0,2,7514,2,13365.0,18,13375.0,4,S
2018-04-18 22:01:26,13345.0,2,7516,0,13365.0,18,13375.0,4,S
2018-04-18 22:01:28,13340.0,4,7520,-4,13365.0,18,13375.0,4,S
2018-04-18 22:01:32,13340.0,2,7522,0,13365.0,18,13375.0,4,S
2018-04-18 22:01:39,13340.0,4,7526,0,13365.0,18,13375.0,4,S
2018-04-18 22:01:40,13340.0,2,7528,-2,13365.0,18,13375.0,4,S
2018-04-18 22:01:41,13340.0,2,7530,0,13365.0,18,13375.0,4,S
2018-04-18 22:01:42,13340.0,4,7534,0,13365.0,18,13375.0,4,S
2018-04-18 22:01:47,13340.0,2,7536,2,13365.0,18,13375.0,4,S
2018-04-18 22:01:51,13340.0,2,7538,0,13365.0,18,13375.0,4,S
2018-04-18 22:01:56,13340.0,4,7542,-4,13365.0,18,13375.0,4,S
2018-04-18 22:02:01,13335.0,40,7582,-2,13365.0,18,13375.0,4,S
2018-04-18 22:02:07,13340.0,2,7584,-2,13365.0,18,13375.0,4,B
2018-04-18 22:02:07,13340.0,2,7586,0,13365.0,18,13375.0,4,B
2018-04-18 22:02:09,13335.0,20,7606,20,13365.0,18,13375.0,4,S
2018-04-18 22:02:30,13340.0,8,7614,0,13365.0,18,13375.0,4,B
2018-04-18 22:02:31,13335.0,2,7616,2,13365.0,18,13375.0,4,S
2018-04-18 22:02:55,13345.0,2,7618,-2,13365.0,18,13375.0,4,B
2018-04-18 22:03:06,13340.0,2,7620,0,13365.0,18,13375.0,4,S
2018-04-18 22:03:10,13345.0,2,7622,2,13365.0,18,13375.0,4,B
2018-04-18 22:03:25,13340.0,2,7624,2,13365.0,18,13375.0,4,S
2018-04-18 22:03:25,13340.0,2,7626,2,13365.0,18,13375.0,4,S
2018-04-18 22:04:19,13350.0,12,7638,8,13365.0,18,13375.0,4,B
2018-04-18 22:04:19,13350.0,6,7644,2,13365.0,18,13375.0,4,B
2018-04-18 22:04:20,13350.0,4,7648,2,13365.0,18,13375.0,4,B
2018-04-18 22:04:20,13350.0,2,7650,2,13365.0,18,13375.0,4,B
2018-04-18 22:04:22,13350.0,16,7666,0,13365.0,18,13375.0,4,B
2018-04-18 22:04:23,13350.0,2,7668,-2,13365.0,18,13375.0,4,B
2018-04-18 22:04:23,13350.0,4,7672,2,13365.0,18,13375.0,4,B
2018-04-18 22:04:24,13355.0,18,7690,16,13365.0,18,13375.0,4,B
2018-04-18 22:04:24,13355.0,2,7692,2,13365.0,18,13375.0,4,B
2018-04-18 22:04:31,13350.0,2,7694,0,13365.0,18,13375.0,4,S
2018-04-18 22:04:36,13350.0,6,7700,0,13365.0,18,13375.0,4,S
2018-04-18 22:04:37,13350.0,4,7704,4,13365.0,18,13375.0,4,S
2018-04-18 22:04:44,13355.0,4,7708,0,13365.0,18,13375.0,4,B
2018-04-18 22:05:00,13350.0,4,7712,-4,13365.0,18,13375.0,4,S
2018-04-18 22:05:01,13350.0,6,7718,0,13365.0,18,13375.0,4,S
2018-04-18 22:05:02,13350.0,10,7728,-2,13365.0,18,13375.0,4,S
2018-04-18 22:05:02,13355.0,2,7730,-2,13365.0,18,13375.0,4,B
2018-04-18 22:05:03,13355.0,2,7732,-2,13365.0,18,13375.0,4,B
2018-04-18 22:05:04,13355.0,2,7734,-2,13365.0,18,13375.0,4,B
2018-04-18 22:05:07,13355.0,2,7736,-2,13365.0,18,13375.0,4,B
2018-04-18 22:05:15,13360.0,20,7756,-12,13365.0,18,13375.0,4,B
2018-04-18 22:05:20,13355.0,4,7760,2,13365.0,18,13375.0,4,S
2018-04-18 22:05:34,13355.0,10,7770,4,13365.0,18,13375.0,4,S
2018-04-18 22:05:40,13355.0,2,7772,0,13365.0,18,13375.0,4,S
2018-04-18 22:05:47,13355.0,8,7780,6,13365.0,18,13375.0,4,S
2018-04-18 22:05:50,13355.0,2,7782,0,13365.0,18,13375.0,4,S
2018-04-18 22:06:00,13355.0,2,7784,2,13365.0,18,13375.0,4,S
2018-04-18 22:06:02,13360.0,2,7786,-2,13365.0,18,13375.0,4,B
2018-04-18 22:06:17,13365.0,4,7790,-2,13365.0,18,13375.0,4,B
2018-04-18 22:06:20,13360.0,2,7792,-2,13365.0,18,13375.0,4,S
2018-04-18 22:06:25,13365.0,2,7794,0,13365.0,18,13375.0,4,B
2018-04-18 22:06:45,13360.0,2,7796,0,13365.0,18,13375.0,4,S
2018-04-18 22:06:49,13360.0,2,7798,-2,13365.0,18,13375.0,4,S
2018-04-18 22:06:52,13365.0,2,7800,2,13365.0,18,13375.0,4,B
2018-04-18 22:07:04,13355.0,10,7810,0,13365.0,18,13375.0,4,S
2018-04-18 22:07:29,13365.0,8,7818,6,13365.0,18,13375.0,4,B
2018-04-18 22:07:31,13360.0,2,7820,2,13365.0,18,13375.0,4,S
2018-04-18 22:07:32,13360.0,2,7822,0,13365.0,18,13375.0,4,S
2018-04-18 22:07:42,13365.0,6,7828,2,13365.0,18,13375.0,4,B
2018-04-18 22:07:46,13365.0,2,7830,0,13365.0,18,13375.0,4,B
2018-04-18 22:07:53,13360.0,10,7840,2,13365.0,18,13375.0,4,S
2018-04-18 22:07:56,13360.0,10,7850,2,13365.0,18,13375.0,4,S
2018-04-18 22:08:03,13365.0,6,7856,0,13365.0,18,13375.0,4,B
2018-04-18 22:08:04,13365.0,2,7858,0,13365.0,18,13375.0,4,B
2018-04-18 22:08:05,13365.0,12,7870,-4,13365.0,18,13375.0,4,B
2018-04-18 22:08:09,13365.0,10,7880,2,13365.0,18,13375.0,4,B
2018-04-18 22:08:12,13365.0,10,7890,0,13365.0,18,13375.0,4,B
2018-04-18 22:08:30,13365.0,2,7892,-2,13365.0,18,13375.0,4,B
2018-04-18 22:08:48,13370.0,12,7904,2,13365.0,18,13375.0,4,B
2018-04-18 22:08:53,13370.0,6,7910,-2,13365.0,18,13375.0,4,B
2018-04-18 22:08:53,13370.0,4,7914,-4,13365.0,18,13375.0,4,B
2018-04-18 22:08:55,13375.0,4,7918,2,13365.0,18,13375.0,4,B
2018-04-18 22:09:03,13370.0,2,7920,0,13365.0,18,13375.0,4,S
2018-04-18 22:09:05,13370.0,2,7922,-2,13365.0,18,13375.0,4,S
2018-04-18 22:09:08,13370.0,2,7924,0,13365.0,18,13375.0,4,S
2018-04-18 22:09:09,13370.0,2,7926,0,13365.0,18,13375.0,4,S
2018-04-18 22:09:11,13370.0,2,7928,-2,13365.0,18,13375.0,4,S
2018-04-18 22:09:12,13370.0,2,7930,0,13365.0,18,13375.0,4,S
2018-04-18 22:09:15,13365.0,8,7938,-6,13365.0,18,13375.0,4,S
2018-04-18 22:09:16,13365.0,8,7946,4,13365.0,18,13375.0,4,S
2018-04-18 22:09:19,13365.0,2,7948,0,13365.0,18,13375.0,4,S
2018-04-18 22:09:26,13360.0,16,7964,-10,13365.0,18,13375.0,4,S
2018-04-18 22:09:37,13360.0,4,7968,0,13365.0,18,13375.0,4,S
2018-04-18 22:10:14,13365.0,6,7974,2,13365.0,18,13375.0,4,B
2018-04-18 22:10:23,13365.0,2,7976,0,13365.0,18,13375.0,4,B
2018-04-18 22:10:28,13360.0,2,7978,2,13365.0,18,13375.0,4,S
2018-04-18 22:11:00,13360.0,6,7984,4,13365.0,18,13375.0,4,S
2018-04-18 22:11:29,13360.0,2,7986,0,13365.0,18,13375.0,4,S
2018-04-18 22:11:29,13360.0,2,7988,0,13365.0,18,13375.0,4,S
2018-04-18 22:11:47,13355.0,10,7998,0,13365.0,18,13375.0,4,S
2018-04-18 22:12:02,13365.0,10,8008,2,13365.0,18,13375.0,4,B
2018-04-18 22:12:26,13355.0,2,8010,0,13365.0,18,13375.0,4,S
2018-04-18 22:12:47,13360.0,2,8012,0,13365.0,18,13375.0,4,B
2018-04-18 22:13:09,13365.0,6,8018,0,13365.0,18,13375.0,4,B
2018-04-18 22:13:10,13365.0,18,8036,-4,13365.0,18,13375.0,4,B
2018-04-18 22:13:22,13365.0,2,8038,0,13365.0,18,13375.0,4,B
2018-04-18 22:13:26,13365.0,2,8040,-2,13365.0,18,13375.0,4,B
2018-04-18 22:13:33,13370.0,20,8060,6,13365.0,18,13375.0,4,B
2018-04-18 22:13:36,13370.0,20,8080,2,13365.0,18,13375.0,4,B
2018-04-18 22:13:43,13365.0,2,8082,0,13365.0,18,13375.0,4,S
2018-04-18 22:13:52,13365.0,2,8084,-2,13365.0,18,13375.0,4,S
2018-04-18 22:14:04,13360.0,4,8088,4,13365.0,18,13375.0,4,S
2018-04-18 22:14:19,13360.0,6,8094,6,13365.0,18,13375.0,4,S
2018-04-18 22:14:48,13355.0,10,8104,8,13365.0,18,13375.0,4,S
2018-04-18 22:14:49,13355.0,4,8108,0,13365.0,18,13375.0,4,S
2018-04-18 22:14:55,13355.0,2,8110,2,13365.0,18,13375.0,4,S
2018-04-18 22:14:59,13355.0,4,8114,2,13365.0,18,13375.0,4,S
2018-04-18 22:15:00,13355.0,20,8134,4,13365.0,18,13375.0,4,S
2018-04-18 22:15:01,13350.0,2,8136,2,13365.0,18,13375.0,4,S
2018-04-18 22:15:11,13350.0,2,8138,2,13365.0,18,13375.0,4,S
2018-04-18 22:15:12,13350.0,2,8140,-2,13365.0,18,13375.0,4,S
2018-04-18 22:15:15,13345.0,4,8144,0,13365.0,18,13375.0,4,S
2018-04-18 22:15:17,13345.0,2,8146,0,13365.0,18,13375.0,4,S
2018-04-18 22:15:25,13345.0,10,8156,-8,13365.0,18,13375.0,4,S
2018-04-18 22:15:49,13350.0,2,8158,0,13365.0,18,13375.0,4,B
2018-04-18 22:15:50,13340.0,10,8168,-6,13365.0,18,13375.0,4,S
2018-04-18 22:17:04,13345.0,2,8170,2,13365.0,18,13375.0,4,B
2018-04-18 22:17:05,13350.0,4,8174,0,13365.0,18,13375.0,4,B
2018-04-18 22:17:05,13350.0,2,8176,2,13365.0,18,13375.0,4,B
2018-04-18 22:17:06,13355.0,2,8178,2,13365.0,18,13375.0,4,B
2018-04-18 22:17:33,13355.0,6,8184,2,13365.0,18,13375.0,4,B
2018-04-18 22:17:42,13355.0,2,8186,0,13365.0,18,13375.0,4,B
2018-04-18 22:17:53,13355.0,2,8188,0,13365.0,18,13375.0,4,B
2018-04-18 22:19:38,13355.0,6,8194,-4,13365.0,18,13375.0,4,B
2018-04-18 22:20:00,13350.0,6,8200,-2,13365.0,18,13375.0,4,S
2018-04-18 22:20:00,13350.0,4,8204,4,13365.0,18,13375.0,4,S
2018-04-18 22:20:02,13350.0,2,8206,0,13365.0,18,13375.0,4,S
2018-04-18 22:20:04,13350.0,4,8210,4,13365.0,18,13375.0,4,S
2018-04-18 22:20:04,13350.0,2,8212,0,13365.0,18,13375.0,4,S
2018-04-18 22:20:33,13350.0,2,8214,0,13365.0,18,13375.0,4,S
2018-04-18 22:21:24,13355.0,6,8220,0,13365.0,18,13375.0,4,B
2018-04-18 22:21:25,13355.0,2,8222,0,13365.0,18,13375.0,4,B
2018-04-18 22:21:33,13360.0,2,8224,0,13365.0,18,13375.0,4,B
2018-04-18 22:22:51,13355.0,2,8226,-2,13365.0,18,13375.0,4,S
2018-04-18 22:23:08,13355.0,2,8228,0,13365.0,18,13375.0,4,S
2018-04-18 22:23:38,13360.0,4,8232,0,13365.0,18,13375.0,4,B
2018-04-18 22:23:59,13350.0,40,8272,18,13365.0,18,13375.0,4,S
2018-04-18 22:24:00,13350.0,26,8298,18,13365.0,18,13375.0,4,S
2018-04-18 22:24:00,13350.0,12,8310,12,13365.0,18,13375.0,4,S
2018-04-18 22:24:01,13350.0,22,8332,22,13365.0,18,13375.0,4,S
2018-04-18 22:24:06,13345.0,50,8382,42,13365.0,18,13375.0,4,S
2018-04-18 22:24:07,13345.0,6,8388,2,13365.0,18,13375.0,4,S
2018-04-18 22:24:07,13345.0,4,8392,4,13365.0,18,13375.0,4,S
2018-04-18 22:24:18,13340.0,40,8432,30,13365.0,18,13375.0,4,S
2018-04-18 22:24:43,13345.0,2,8434,0,13365.0,18,13375.0,4,B
2018-04-18 22:25:37,13350.0,2,8436,-2,13365.0,18,13375.0,4,B
2018-04-18 22:26:39,13345.0,2,8438,-2,13365.0,18,13375.0,4,S
2018-04-18 22:26:39,13345.0,4,8442,-4,13365.0,18,13375.0,4,S
2018-04-18 22:26:40,13345.0,6,8448,-6,13365.0,18,13375.0,4,S
2018-04-18 22:27:01,13345.0,2,8450,0,13365.0,18,13375.0,4,S
2018-04-18 22:28:45,13345.0,6,8456,-4,13365.0,18,13375.0,4,S
2018-04-18 22:30:02,13350.0,6,8462,0,13365.0,18,13375.0,4,B
2018-04-18 22:30:02,13350.0,2,8464,0,13365.0,18,13375.0,4,B
2018-04-18 22:30:11,13355.0,4,8468,-4,13365.0,18,13375.0,4,B
2018-04-18 22:30:14,13350.0,6,8474,-6,13365.0,18,13375.0,4,S
2018-04-18 22:30:15,13350.0,6,8480,-6,13365.0,18,13375.0,4,S
2018-04-18 22:30:30,13345.0,2,8482,-2,13365.0,18,13375.0,4,S
2018-04-18 22:30:31,13345.0,2,8484,-2,13365.0,18,13375.0,4,S
2018-04-18 22:30:40,13345.0,4,8488,0,13365.0,18,13375.0,4,S
2018-04-18 22:30:44,13345.0,10,8498,-8,13365.0,18,13375.0,4,S
2018-04-18 22:30:49,13340.0,10,8508,0,13365.0,18,13375.0,4,S
2018-04-18 22:31:07,13345.0,2,8510,2,13365.0,18,13375.0,4,B
2018-04-18 22:31:22,13345.0,6,8516,4,13365.0,18,13375.0,4,B
2018-04-18 22:31:23,13350.0,2,8518,-2,13365.0,18,13375.0,4,B
2018-04-18 22:31:23,13350.0,8,8526,0,13365.0,18,13375.0,4,B
2018-04-18 22:31:30,13350.0,2,8528,0,13365.0,18,13375.0,4,B
2018-04-18 22:31:42,13355.0,2,8530,2,13365.0,18,13375.0,4,B
2018-04-18 22:32:18,13355.0,4,8534,4,13365.0,18,13375.0,4,B
2018-04-18 22:33:50,13355.0,2,8536,2,13365.0,18,13375.0,4,B
2018-04-18 22:34:08,13355.0,6,8542,4,13365.0,18,13375.0,4,B
2018-04-18 22:34:11,13350.0,2,8544,0,13365.0,18,13375.0,4,S
2018-04-18 22:34:16,13350.0,2,8546,2,13365.0,18,13375.0,4,S
2018-04-18 22:34:17,13350.0,2,8548,0,13365.0,18,13375.0,4,S
2018-04-18 22:34:26,13355.0,2,8550,0,13365.0,18,13375.0,4,B
2018-04-18 22:35:00,13350.0,2,8552,0,13365.0,18,13375.0,4,S
2018-04-18 22:35:15,13345.0,2,8554,0,13365.0,18,13375.0,4,S
2018-04-18 22:35:26,13345.0,2,8556,2,13365.0,18,13375.0,4,S
2018-04-18 22:36:06,13350.0,12,8568,-2,13365.0,18,13375.0,4,B
2018-04-18 22:36:07,13350.0,6,8574,0,13365.0,18,13375.0,4,B
2018-04-18 22:36:07,13350.0,2,8576,-2,13365.0,18,13375.0,4,B
2018-04-18 22:36:09,13350.0,4,8580,4,13365.0,18,13375.0,4,B
2018-04-18 22:36:11,13350.0,2,8582,0,13365.0,18,13375.0,4,B
2018-04-18 22:36:48,13350.0,4,8586,0,13365.0,18,13375.0,4,B
2018-04-18 22:37:06,13350.0,2,8588,2,13365.0,18,13375.0,4,B
2018-04-18 22:37:14,13350.0,2,8590,2,13365.0,18,13375.0,4,B
2018-04-18 22:37:26,13355.0,2,8592,-2,13365.0,18,13375.0,4,B
2018-04-18 22:37:28,13350.0,2,8594,-2,13365.0,18,13375.0,4,S
2018-04-18 22:37:54,13355.0,10,8604,4,13365.0,18,13375.0,4,B
2018-04-18 22:38:22,13355.0,2,8606,-2,13365.0,18,13375.0,4,B
2018-04-18 22:38:26,13355.0,2,8608,0,13365.0,18,13375.0,4,B
2018-04-18 22:39:04,13355.0,2,8610,0,13365.0,18,13375.0,4,B
2018-04-18 22:39:42,13360.0,24,8634,18,13365.0,18,13375.0,4,B
2018-04-18 22:39:53,13350.0,2,8636,2,13365.0,18,13375.0,4,S
2018-04-18 22:40:01,13350.0,2,8638,2,13365.0,18,13375.0,4,S
2018-04-18 22:41:01,13360.0,2,8640,0,13365.0,18,13375.0,4,B
2018-04-18 22:41:13,13355.0,2,8642,2,13365.0,18,13375.0,4,S
2018-04-18 22:41:17,13355.0,2,8644,2,13365.0,18,13375.0,4,S
2018-04-18 22:41:25,13355.0,2,8646,0,13365.0,18,13375.0,4,S
2018-04-18 22:42:16,13350.0,2,8648,0,13365.0,18,13375.0,4,S
2018-04-18 22:43:35,13355.0,2,8650,2,13365.0,18,13375.0,4,B
2018-04-18 22:44:11,13350.0,2,8652,0,13365.0,18,13375.0,4,S
2018-04-18 22:44:16,13350.0,2,8654,0,13365.0,18,13375.0,4,S
2018-04-18 22:44:25,13350.0,2,8656,2,13365.0,18,13375.0,4,S
2018-04-18 22:44:36,13355.0,2,8658,0,13365.0,18,13375.0,4,B
2018-04-18 22:44:58,13350.0,4,8662,0,13365.0,18,13375.0,4,S
2018-04-18 22:46:11,13355.0,2,8664,0,13365.0,18,13375.0,4,B
2018-04-18 22:46:18,13355.0,2,8666,0,13365.0,18,13375.0,4,B
2018-04-18 22:46:23,13355.0,6,8672,-4,13365.0,18,13375.0,4,B
2018-04-18 22:46:24,13355.0,4,8676,-4,13365.0,18,13375.0,4,B
2018-04-18 22:46:33,13360.0,6,8682,6,13365.0,18,13375.0,4,B
2018-04-18 22:46:33,13360.0,20,8702,-8,13365.0,18,13375.0,4,B
2018-04-18 22:46:52,13355.0,2,8704,0,13365.0,18,13375.0,4,S
2018-04-18 22:47:28,13355.0,2,8706,0,13365.0,18,13375.0,4,S
2018-04-18 22:47:31,13355.0,2,8708,2,13365.0,18,13375.0,4,S
2018-04-18 22:47:54,13360.0,4,8712,2,13365.0,18,13375.0,4,B
2018-04-18 22:47:58,13355.0,2,8714,0,13365.0,18,13375.0,4,S
2018-04-18 22:48:13,13355.0,2,8716,2,13365.0,18,13375.0,4,S
2018-04-18 22:48:26,13355.0,2,8718,2,13365.0,18,13375.0,4,S
2018-04-18 22:48:32,13355.0,2,8720,0,13365.0,18,13375.0,4,S
2018-04-18 22:48:38,13355.0,2,8722,0,13365.0,18,13375.0,4,S
2018-04-18 22:48:38,13355.0,2,8724,-2,13365.0,18,13375.0,4,S
2018-04-18 22:48:55,13355.0,2,8726,0,13365.0,18,13375.0,4,S
2018-04-18 22:49:07,13355.0,2,8728,-2,13365.0,18,13375.0,4,S
2018-04-18 22:49:31,13355.0,6,8734,-6,13365.0,18,13375.0,4,S
2018-04-18 22:49:34,13355.0,12,8746,4,13365.0,18,13375.0,4,S
2018-04-18 22:49:35,13350.0,2,8748,-2,13365.0,18,13375.0,4,S
2018-04-18 22:49:37,13355.0,2,8750,0,13365.0,18,13375.0,4,B
2018-04-18 22:49:57,13355.0,2,8752,2,13365.0,18,13375.0,4,B
2018-04-18 22:50:01,13350.0,2,8754,0,13365.0,18,13375.0,4,S
2018-04-18 22:50:08,13355.0,10,8764,0,13365.0,18,13375.0,4,B
2018-04-18 22:50:08,13355.0,10,8774,2,13365.0,18,13375.0,4,B
2018-04-18 22:50:09,13355.0,2,8776,0,13365.0,18,13375.0,4,B
2018-04-18 22:50:20,13355.0,2,8778,2,13365.0,18,13375.0,4,B
2018-04-18 22:50:21,13355.0,2,8780,0,13365.0,18,13375.0,4,B
2018-04-18 22:50:25,13355.0,2,8782,0,13365.0,18,13375.0,4,B
2018-04-18 22:52:17,13355.0,2,8784,0,13365.0,18,13375.0,4,B
2018-04-18 22:52:22,13360.0,8,8792,2,13365.0,18,13375.0,4,B
2018-04-18 22:52:29,13360.0,2,8794,-2,13365.0,18,13375.0,4,B
2018-04-18 22:52:31,13360.0,4,8798,0,13365.0,18,13375.0,4,B
2018-04-18 22:52:43,13360.0,2,8800,2,13365.0,18,13375.0,4,B
2018-04-18 22:53:07,13360.0,2,8802,0,13365.0,18,13375.0,4,B
2018-04-18 22:53:24,13360.0,2,8804,-2,13365.0,18,13375.0,4,B
2018-04-18 22:53:30,13360.0,4,8808,0,13365.0,18,13375.0,4,B
2018-04-18 22:53:30,13360.0,2,8810,2,13365.0,18,13375.0,4,B
2018-04-18 22:53:32,13360.0,2,8812,2,13365.0,18,13375.0,4,B
2018-04-18 22:53:52,13360.0,2,8814,0,13365.0,18,13375.0,4,B
2018-04-18 22:54:22,13360.0,2,8816,2,13365.0,18,13375.0,4,B
2018-04-18 22:54:30,13355.0,20,8836,0,13365.0,18,13375.0,4,S
2018-04-18 22:54:31,13355.0,6,8842,4,13365.0,18,13375.0,4,S
2018-04-18 22:54:31,13355.0,12,8854,-4,13365.0,18,13375.0,4,S
2018-04-18 22:55:22,13355.0,4,8858,-4,13365.0,18,13375.0,4,S
2018-04-18 22:55:44,13360.0,2,8860,0,13365.0,18,13375.0,4,B
2018-04-18 22:56:44,13360.0,2,8862,2,13365.0,18,13375.0,4,B
2018-04-18 22:56:57,13360.0,2,8864,0,13365.0,18,13375.0,4,B
2018-04-18 22:56:58,13365.0,2,8866,0,13365.0,18,13375.0,4,B
2018-04-18 22:57:01,13365.0,10,8876,-6,13365.0,18,13375.0,4,B
2018-04-18 22:57:02,13360.0,2,8878,-2,13365.0,18,13375.0,4,S
2018-04-18 22:57:28,13360.0,4,8882,-2,13365.0,18,13375.0,4,S
2018-04-18 22:57:40,13360.0,2,8884,-2,13365.0,18,13375.0,4,S
2018-04-18 22:58:05,13360.0,2,8886,-2,13365.0,18,13375.0,4,S
2018-04-18 22:58:38,13360.0,2,8888,0,13365.0,18,13375.0,4,S
2018-04-18 22:58:38,13360.0,4,8892,-4,13365.0,18,13375.0,4,S
2018-04-18 22:58:39,13360.0,2,8894,0,13365.0,18,13375.0,4,S
2018-04-18 22:58:40,13360.0,2,8896,-2,13365.0,18,13375.0,4,S
2018-04-18 22:58:53,13365.0,2,8898,0,13365.0,18,13375.0,4,B
2018-04-18 22:59:02,13365.0,2,8900,2,13365.0,18,13375.0,4,B
2018-04-18 22:59:04,13365.0,2,8902,-2,13365.0,18,13375.0,4,B
2018-04-18 22:59:06,13365.0,2,8904,0,13365.0,18,13375.0,4,B
2018-04-18 22:59:12,13370.0,2,8906,2,13365.0,18,13375.0,4,B
2018-04-18 22:59:16,13370.0,6,8912,-2,13365.0,18,13375.0,4,B
2018-04-18 22:59:21,13375.0,8,8920,0,13365.0,18,13375.0,4,B
2018-04-18 22:59:28,13380.0,2,8922,0,13365.0,18,13375.0,4,B
2018-04-18 22:59:28,13380.0,2,8924,0,13365.0,18,13375.0,4,B
2018-04-18 22:59:29,13380.0,2,8926,2,13365.0,18,13375.0,4,B
2018-04-18 22:59:29,13380.0,2,8928,2,13365.0,18,13375.0,4,B
2018-04-18 22:59:36,13380.0,2,8930,2,13365.0,18,13375.0,4,B
2018-04-18 22:59:38,13385.0,4,8934,-4,13365.0,18,13375.0,4,B
2018-04-18 22:59:39,13380.0,2,8936,2,13365.0,18,13375.0,4,S
2018-04-18 22:59:40,13370.0,2,8938,-2,13365.0,18,13375.0,4,S
2018-04-18 22:59:42,13385.0,2,8940,-2,13365.0,18,13375.0,4,B
2018-04-18 22:59:47,13375.0,2,8942,0,13365.0,18,13375.0,4,S
2018-04-18 22:59:48,13375.0,8,8950,-2,13365.0,18,13375.0,4,S
2018-04-18 22:59:57,13380.0,4,8954,-4,13365.0,18,13375.0,4,B
2018-04-18 22:59:58,13380.0,2,8956,0,13365.0,18,13375.0,4,B
2018-04-19 09:00:00,13385.0,4,8960,0,13365.0,18,13375.0,4,B
2018-04-19 09:00:01,13380.0,4,8964,0,13365.0,18,13375.0,4,S
2018-04-19 09:00:03,13385.0,6,8970,0,13365.0,18,13375.0,4,B
2018-04-19 09:00:03,13385.0,6,8976,6,13365.0,18,13375.0,4,B
2018-04-19 09:00:04,13390.0,12,8988,10,13365.0,18,13375.0,4,B
2018-04-19 09:00:04,13390.0,2,8990,0,13365.0,18,13375.0,4,B
2018-04-19 09:00:05,13390.0,2,8992,2,13365.0,18,13375.0,4,B
2018-04-19 09:00:06,13395.0,2,8994,2,13365.0,18,13375.0,4,B
2018-04-19 09:00:07,13395.0,8,9002,2,13365.0,18,13375.0,4,B
2018-04-19 09:00:08,13395.0,2,9004,0,13365.0,18,13375.0,4,B
2018-04-19 09:00:08,13395.0,4,9008,4,13365.0,18,13375.0,4,B
2018-04-19 09:00:09,13395.0,4,9012,0,13365.0,18,13375.0,4,B
2018-04-19 09:00:11,13400.0,2,9014,0,13365.0,18,13375.0,4,B
2018-04-19 09:00:12,13395.0,4,9018,0,13365.0,18,13375.0,4,S
2018-04-19 09:00:13,13395.0,6,9024,6,13365.0,18,13375.0,4,S
2018-04-19 09:00:13,13395.0,2,9026,0,13365.0,18,13375.0,4,S
2018-04-19 09:00:14,13400.0,2,9028,2,13365.0,18,13375.0,4,B
2018-04-19 09:00:16,13395.0,8,9036,8,13365.0,18,13375.0,4,S
2018-04-19 09:00:16,13395.0,2,9038,0,13365.0,18,13375.0,4,S
2018-04-19 09:00:18,13395.0,2,9040,0,13365.0,18,13375.0,4,S
2018-04-19 09:00:19,13395.0,4,9044,2,13365.0,18,13375.0,4,S
2018-04-19 09:00:21,13395.0,10,9054,2,13365.0,18,13375.0,4,S
2018-04-19 09:00:26,13390.0,2,9056,2,13365.0,18,13375.0,4,S
2018-04-19 09:00:27,13390.0,10,9066,-2,13365.0,18,13375.0,4,S
2018-04-19 09:00:29,13385.0,4,9070,2,13365.0,18,13375.0,4,S
2018-04-19 09:00:30,13380.0,6,9076,-2,13365.0,18,13375.0,4,S
2018-04-19 09:00:32,13380.0,2,9078,0,13365.0,18,13375.0,4,S
2018-04-19 09:00:32,13380.0,6,9084,-6,13365.0,18,13375.0,4,S
2018-04-19 09:00:34,13380.0,76,9160,-76,13365.0,18,13375.0,4,S
2018-04-19 09:00:34,13380.0,2,9162,-2,13365.0,18,13375.0,4,S
2018-04-19 09:00:39,13375.0,20,9182,-14,13365.0,18,13375.0,4,S
2018-04-19 09:00:40,13385.0,2,9184,0,13365.0,18,13375.0,4,B
2018-04-19 09:00:45,13385.0,2,9186,0,13365.0,18,13375.0,4,B
2018-04-19 09:00:49,13385.0,2,9188,2,13365.0,18,13375.0,4,B
2018-04-19 09:00:52,13380.0,2,9190,2,13365.0,18,13375.0,4,S
2018-04-19 09:00:53,13380.0,2,9192,2,13365.0,18,13375.0,4,S
2018-04-19 09:00:54,13375.0,2,9194,2,13365.0,18,13375.0,4,S
2018-04-19 09:00:55,13375.0,6,9200,2,13365.0,18,13375.0,4,S
2018-04-19 09:01:00,13370.0,6,9206,4,13365.0,18,13375.0,4,S
2018-04-19 09:01:00,13365.0,2,9208,0,13365.0,18,13375.0,4,S
2018-04-19 09:01:01,13365.0,8,9216,8,13365.0,18,13375.0,4,S
2018-04-19 09:01:02,13360.0,4,9220,4,13365.0,18,13375.0,4,S
2018-04-19 09:01:03,13355.0,4,9224,4,13365.0,18,13375.0,4,S
2018-04-19 09:01:06,13365.0,14,9238,-8,13365.0,18,13375.0,4,B
2018-04-19 09:01:07,13360.0,20,9258,-12,13365.0,18,13375.0,4,S
2018-04-19 09:01:08,13365.0,2,9260,0,13365.0,18,13375.0,4,B
2018-04-19 09:01:09,13365.0,2,9262,0,13365.0,18,13375.0,4,B
2018-04-19 09:01:10,13360.0,2,9264,0,13365.0,18,13375.0,4,S
2018-04-19 09:01:11,13365.0,2,9266,2,13365.0,18,13375.0,4,B
2018-04-19 09:01:12,13365.0,2,9268,2,13365.0,18,13375.0,4,B
2018-04-19 09:01:13,13365.0,4,9272,0,13365.0,18,13375.0,4,B
2018-04-19 09:01:15,13365.0,22,9294,0,13365.0,18,13375.0,4,B
2018-04-19 09:01:17,13365.0,6,9300,-4,13365.0,18,13375.0,4,B
2018-04-19 09:01:19,13360.0,18,9318,0,13365.0,18,13375.0,4,S
2018-04-19 09:01:29,13370.0,12,9330,-4,13365.0,18,13375.0,4,B
2018-04-19 09:01:29,13370.0,8,9338,-2,13365.0,18,13375.0,4,B
2018-04-19 09:01:33,13375.0,2,9340,2,13365.0,18,13375.0,4,B
2018-04-19 09:01:37,13375.0,4,9344,-4,13365.0,18,13375.0,4,B
2018-04-19 09:01:45,13375.0,2,9346,0,13365.0,18,13375.0,4,B
2018-04-19 09:01:46,13380.0,2,9348,0,13365.0,18,13375.0,4,B
2018-04-19 09:01:54,13380.0,4,9352,4,13365.0,18,13375.0,4,B
2018-04-19 09:01:59,13380.0,2,9354,2,13365.0,18,13375.0,4,B
2018-04-19 09:02:04,13390.0,20,9374,-8,13365.0,18,13375.0,4,B
2018-04-19 09:02:10,13385.0,2,9376,2,13365.0,18,13375.0,4,S
2018-04-19 09:02:10,13390.0,8,9384,2,13365.0,18,13375.0,4,B
2018-04-19 09:02:11,13395.0,8,9392,4,13365.0,18,13375.0,4,B
2018-04-19 09:02:11,13395.0,2,9394,0,13365.0,18,13375.0,4,B
2018-04-19 09:02:13,13395.0,4,9398,4,13365.0,18,13375.0,4,B
2018-04-19 09:02:14,13395.0,2,9400,0,13365.0,18,13375.0,4,B
2018-04-19 09:02:15,13390.0,4,9404,2,13365.0,18,13375.0,4,S
2018-04-19 09:02:16,13390.0,2,9406,2,13365.0,18,13375.0,4,S
2018-04-19 09:02:17,13385.0,2,9408,0,13365.0,18,13375.0,4,S
2018-04-19 09:02:18,13385.0,2,9410,-2,13365.0,18,13375.0,4,S
2018-04-19 09:02:24,13390.0,10,9420,-8,13365.0,18,13375.0,4,B
2018-04-19 09:02:25,13390.0,4,9424,0,13365.0,18,13375.0,4,B
2018-04-19 09:02:32,13390.0,2,9426,2,13365.0,18,13375.0,4,B
2018-04-19 09:02:40,13390.0,2,9428,0,13365.0,18,13375.0,4,B
2018-04-19 09:02:43,13385.0,6,9434,-4,13365.0,18,13375.0,4,S
2018-04-19 09:02:49,13390.0,2,9436,0,13365.0,18,13375.0,4,B
2018-04-19 09:02:49,13390.0,2,9438,2,13365.0,18,13375.0,4,B
2018-04-19 09:02:59,13390.0,2,9440,0,13365.0,18,13375.0,4,B
2018-04-19 09:03:07,13390.0,8,9448,6,13365.0,18,13375.0,4,B
2018-04-19 09:03:08,13390.0,2,9450,2,13365.0,18,13375.0,4,B
2018-04-19 09:03:11,13390.0,4,9454,4,13365.0,18,13375.0,4,B
2018-04-19 09:03:18,13385.0,2,9456,0,13365.0,18,13375.0,4,S
2018-04-19 09:03:21,13385.0,4,9460,4,13365.0,18,13375.0,4,S
2018-04-19 09:03:21,13385.0,8,9468,-4,13365.0,18,13375.0,4,S
2018-04-19 09:03:22,13380.0,6,9474,-4,13365.0,18,13375.0,4,S
2018-04-19 09:03:22,13380.0,6,9480,2,13365.0,18,13375.0,4,S
2018-04-19 09:03:24,13380.0,2,9482,-2,13365.0,18,13375.0,4,S
2018-04-19 09:03:24,13380.0,2,9484,0,13365.0,18,13375.0,4,S
2018-04-19 09:03:26,13385.0,4,9488,4,13365.0,18,13375.0,4,B
2018-04-19 09:03:30,13385.0,2,9490,-2,13365.0,18,13375.0,4,B
2018-04-19 09:03:46,13385.0,4,9494,0,13365.0,18,13375.0,4,B
2018-04-19 09:03:57,13380.0,2,9496,0,13365.0,18,13375.0,4,S
2018-04-19 09:04:13,13375.0,4,9500,0,13365.0,18,13375.0,4,S
2018-04-19 09:04:14,13380.0,2,9502,0,13365.0,18,13375.0,4,B
2018-04-19 09:04:20,13380.0,2,9504,0,13365.0,18,13375.0,4,B
2018-04-19 09:04:21,13375.0,2,9506,0,13365.0,18,13375.0,4,S
2018-04-19 09:04:26,13380.0,2,9508,-2,13365.0,18,13375.0,4,B
2018-04-19 09:04:35,13380.0,2,9510,2,13365.0,18,13375.0,4,B
2018-04-19 09:04:35,13380.0,2,9512,2,13365.0,18,13375.0,4,B
2018-04-19 09:04:44,13380.0,8,9520,-2,13365.0,18,13375.0,4,B
2018-04-19 09:04:45,13380.0,2,9522,0,13365.0,18,13375.0,4,B
2018-04-19 09:04:48,13385.0,4,9526,4,13365.0,18,13375.0,4,B
2018-04-19 09:04:52,13380.0,4,9530,4,13365.0,18,13375.0,4,S
2018-04-19 09:04:56,13375.0,2,9532,2,13365.0,18,13375.0,4,S
2018-04-19 09:05:08,13375.0,2,9534,2,13365.0,18,13375.0,4,S
2018-04-19 09:05:10,13375.0,16,9550,0,13365.0,18,13375.0,4,S
2018-04-19 09:05:11,13375.0,4,9554,2,13365.0,18,13375.0,4,S
2018-04-19 09:05:12,13375.0,2,9556,2,13365.0,18,13375.0,4,S
2018-04-19 09:05:13,13380.0,6,9562,0,13365.0,18,13375.0,4,B
2018-04-19 09:05:29,13380.0,4,9566,0,13365.0,18,13375.0,4,B
2018-04-19 09:05:35,13380.0,14,9580,0,13365.0,18,13375.0,4,B
2018-04-19 09:05:35,13385.0,2,9582,0,13365.0,18,13375.0,4,B
2018-04-19 09:05:36,13385.0,8,9590,0,13365.0,18,13375.0,4,B
2018-04-19 09:05:40,13385.0,2,9592,-2,13365.0,18,13375.0,4,B
2018-04-19 09:05:51,13380.0,2,9594,-2,13365.0,18,13375.0,4,S
2018-04-19 09:05:58,13380.0,2,9596,2,13365.0,18,13375.0,4,S
2018-04-19 09:06:12,13385.0,2,9598,0,13365.0,18,13375.0,4,B
2018-04-19 09:06:13,13385.0,2,9600,0,13365.0,18,13375.0,4,B
2018-04-19 09:06:37,13385.0,14,9614,-10,13365.0,18,13375.0,4,B
2018-04-19 09:06:38,13385.0,10,9624,-6,13365.0,18,13375.0,4,B
2018-04-19 09:06:41,13385.0,2,9626,0,13365.0,18,13375.0,4,B
2018-04-19 09:06:50,13380.0,4,9630,-4,13365.0,18,13375.0,4,S
2018-04-19 09:06:56,13380.0,6,9636,-2,13365.0,18,13375.0,4,S
2018-04-19 09:06:59,13380.0,2,9638,0,13365.0,18,13375.0,4,S
2018-04-19 09:07:04,13385.0,2,9640,0,13365.0,18,13375.0,4,B
2018-04-19 09:07:09,13385.0,2,9642,0,13365.0,18,13375.0,4,B
2018-04-19 09:07:19,13380.0,2,9644,0,13365.0,18,13375.0,4,S
2018-04-19 09:07:19,13380.0,8,9652,6,13365.0,18,13375.0,4,S
2018-04-19 09:07:22,13390.0,10,9662,10,13365.0,18,13375.0,4,B
2018-04-19 09:07:29,13385.0,4,9666,0,13365.0,18,13375.0,4,S
2018-04-19 09:07:29,13385.0,2,9668,-2,13365.0,18,13375.0,4,S
2018-04-19 09:07:33,13385.0,2,9670,-2,13365.0,18,13375.0,4,S
2018-04-19 09:07:49,13385.0,2,9672,-2,13365.0,18,13375.0,4,S
2018-04-19 09:07:50,13385.0,8,9680,-8,13365.0,18,13375.0,4,S
2018-04-19 09:07:51,13385.0,2,9682,0,13365.0,18,13375.0,4,S
2018-04-19 09:07:59,13390.0,40,9722,4,13365.0,18,13375.0,4,B
2018-04-19 09:08:06,13395.0,2,9724,-2,13365.0,18,13375.0,4,B
2018-04-19 09:08:21,13390.0,2,9726,0,13365.0,18,13375.0,4,S
2018-04-19 09:08:25,13395.0,4,9730,-2,13365.0,18,13375.0,4,B
2018-04-19 09:08:25,13395.0,10,9740,-4,13365.0,18,13375.0,4,B
2018-04-19 09:08:26,13395.0,14,9754,12,13365.0,18,13375.0,4,B
2018-04-19 09:08:32,13395.0,2,9756,0,13365.0,18,13375.0,4,B
2018-04-19 09:08:33,13395.0,2,9758,0,13365.0,18,13375.0,4,B
2018-04-19 09:08:35,13400.0,2,9760,0,13365.0,18,13375.0,4,B
2018-04-19 09:08:40,13395.0,2,9762,0,13365.0,18,13375.0,4,S
2018-04-19 09:08:42,13395.0,2,9764,0,13365.0,18,13375.0,4,S
2018-04-19 09:08:45,13395.0,2,9766,0,13365.0,18,13375.0,4,S
2018-04-19 09:09:03,13395.0,10,9776,8,13365.0,18,13375.0,4,S
2018-04-19 09:09:03,13395.0,38,9814,-2,13365.0,18,13375.0,4,S
2018-04-19 09:09:04,13390.0,2,9816,0,13365.0,18,13375.0,4,S
2018-04-19 09:09:12,13395.0,8,9824,8,13365.0,18,13375.0,4,B
2018-04-19 09:09:12,13395.0,10,9834,6,13365.0,18,13375.0,4,B
2018-04-19 09:09:13,13395.0,100,9934,74,13365.0,18,13375.0,4,B
2018-04-19 09:09:13,13395.0,292,10226,274,13365.0,18,13375.0,4,B
2018-04-19 09:09:14,13395.0,78,10304,78,13365.0,18,13375.0,4,B
2018-04-19 09:09:15,13395.0,24,10328,18,13365.0,18,13375.0,4,B
2018-04-19 09:09:15,13395.0,2,10330,2,13365.0,18,13375.0,4,B
2018-04-19 09:09:17,13395.0,4,10334,0,13365.0,18,13375.0,4,B
2018-04-19 09:09:18,13395.0,18,10352,18,13365.0,18,13375.0,4,B
2018-04-19 09:09:21,13395.0,16,10368,16,13365.0,18,13375.0,4,B
2018-04-19 09:09:21,13395.0,8,10376,8,13365.0,18,13375.0,4,B
2018-04-19 09:09:22,13395.0,90,10466,80,13365.0,18,13375.0,4,B
2018-04-19 09:09:22,13395.0,2,10468,2,13365.0,18,13375.0,4,B
2018-04-19 09:09:25,13390.0,8,10476,-2,13365.0,18,13375.0,4,S
2018-04-19 09:09:26,13395.0,8,10484,8,13365.0,18,13375.0,4,B
2018-04-19 09:09:27,13395.0,4,10488,0,13365.0,18,13375.0,4,B
2018-04-19 09:09:28,13400.0,16,10504,-4,13365.0,18,13375.0,4,B
2018-04-19 09:09:28,13395.0,4,10508,0,13365.0,18,13375.0,4,S
2018-04-19 09:09:29,13395.0,2,10510,0,13365.0,18,13375.0,4,S
2018-04-19 09:09:29,13395.0,4,10514,0,13365.0,18,13375.0,4,S
2018-04-19 09:09:31,13395.0,4,10518,0,13365.0,18,13375.0,4,S
2018-04-19 09:09:31,13395.0,2,10520,0,13365.0,18,13375.0,4,S
2018-04-19 09:09:32,13395.0,6,10526,4,13365.0,18,13375.0,4,S
2018-04-19 09:09:32,13400.0,6,10532,-6,13365.0,18,13375.0,4,B
2018-04-19 09:09:33,13390.0,38,10570,-16,13365.0,18,13375.0,4,S
2018-04-19 09:09:34,13385.0,4,10574,0,13365.0,18,13375.0,4,S
2018-04-19 09:09:35,13390.0,4,10578,0,13365.0,18,13375.0,4,B
2018-04-19 09:09:37,13390.0,4,10582,0,13365.0,18,13375.0,4,B
2018-04-19 09:09:38,13390.0,24,10606,-20,13365.0,18,13375.0,4,B
2018-04-19 09:09:38,13390.0,2,10608,0,13365.0,18,13375.0,4,B
2018-04-19 09:09:42,13390.0,2,10610,-2,13365.0,18,13375.0,4,B
2018-04-19 09:09:46,13390.0,2,10612,0,13365.0,18,13375.0,4,B
2018-04-19 09:09:47,13395.0,2,10614,-2,13365.0,18,13375.0,4,B
2018-04-19 09:09:49,13395.0,4,10618,0,13365.0,18,13375.0,4,B
2018-04-19 09:09:50,13395.0,4,10622,0,13365.0,18,13375.0,4,B
2018-04-19 09:09:51,13395.0,2,10624,-2,13365.0,18,13375.0,4,B
2018-04-19 09:09:53,13395.0,4,10628,4,13365.0,18,13375.0,4,B
2018-04-19 09:09:54,13395.0,4,10632,4,13365.0,18,13375.0,4,B
2018-04-19 09:09:59,13395.0,4,10636,0,13365.0,18,13375.0,4,B
2018-04-19 09:10:00,13400.0,4,10640,0,13365.0,18,13375.0,4,B
2018-04-19 09:10:03,13400.0,4,10644,0,13365.0,18,13375.0,4,B
2018-04-19 09:10:07,13395.0,2,10646,0,13365.0,18,13375.0,4,S
2018-04-19 09:10:10,13400.0,46,10692,0,13365.0,18,13375.0,4,B
2018-04-19 09:10:11,13400.0,8,10700,0,13365.0,18,13375.0,4,B
2018-04-19 09:10:24,13395.0,6,10706,6,13365.0,18,13375.0,4,S
2018-04-19 09:10:25,13395.0,2,10708,2,13365.0,18,13375.0,4,S
2018-04-19 09:10:29,13395.0,2,10710,0,13365.0,18,13375.0,4,S
2018-04-19 09:10:37,13395.0,2,10712,0,13365.0,18,13375.0,4,S
2018-04-19 09:10:39,13390.0,2,10714,2,13365.0,18,13375.0,4,S
2018-04-19 09:10:40,13395.0,2,10716,-2,13365.0,18,13375.0,4,B
2018-04-19 09:10:49,13395.0,2,10718,0,13365.0,18,13375.0,4,B
2018-04-19 09:10:52,13400.0,62,10780,-2,13365.0,18,13375.0,4,B
2018-04-19 09:10:52,13400.0,4,10784,-4,13365.0,18,13375.0,4,B
2018-04-19 09:10:53,13395.0,2,10786,0,13365.0,18,13375.0,4,S
2018-04-19 09:11:11,13395.0,2,10788,0,13365.0,18,13375.0,4,S
2018-04-19 09:11:12,13395.0,4,10792,0,13365.0,18,13375.0,4,S
2018-04-19 09:11:15,13395.0,2,10794,0,13365.0,18,13375.0,4,S
2018-04-19 09:11:21,13395.0,16,10810,0,13365.0,18,13375.0,4,S
2018-04-19 09:11:41,13390.0,2,10812,0,13365.0,18,13375.0,4,S
2018-04-19 09:11:56,13390.0,20,10832,-20,13365.0,18,13375.0,4,S
2018-04-19 09:11:57,13385.0,8,10840,-2,13365.0,18,13375.0,4,S
2018-04-19 09:11:57,13380.0,2,10842,-2,13365.0,18,13375.0,4,S
2018-04-19 09:12:03,13390.0,4,10846,-4,13365.0,18,13375.0,4,B
2018-04-19 09:12:06,13390.0,6,10852,0,13365.0,18,13375.0,4,B
2018-04-19 09:12:09,13390.0,2,10854,0,13365.0,18,13375.0,4,B
2018-04-19 09:12:13,13390.0,2,10856,2,13365.0,18,13375.0,4,B
2018-04-19 09:12:13,13390.0,2,10858,2,13365.0,18,13375.0,4,B
2018-04-19 09:12:14,13390.0,2,10860,2,13365.0,18,13375.0,4,B
2018-04-19 09:12:14,13390.0,2,10862,2,13365.0,18,13375.0,4,B
2018-04-19 09:12:15,13390.0,2,10864,2,13365.0,18,13375.0,4,B
2018-04-19 09:12:15,13390.0,2,10866,0,13365.0,18,13375.0,4,B
2018-04-19 09:12:17,13390.0,2,10868,0,13365.0,18,13375.0,4,B
2018-04-19 09:12:18,13385.0,2,10870,2,13365.0,18,13375.0,4,S
2018-04-19 09:12:18,13385.0,2,10872,2,13365.0,18,13375.0,4,S
2018-04-19 09:12:19,13385.0,2,10874,2,13365.0,18,13375.0,4,S
2018-04-19 09:12:19,13385.0,2,10876,2,13365.0,18,13375.0,4,S
2018-04-19 09:12:20,13385.0,2,10878,2,13365.0,18,13375.0,4,S
2018-04-19 09:12:20,13385.0,2,10880,2,13365.0,18,13375.0,4,S
2018-04-19 09:12:21,13385.0,4,10884,2,13365.0,18,13375.0,4,S
2018-04-19 09:12:21,13385.0,2,10886,2,13365.0,18,13375.0,4,S
2018-04-19 09:12:22,13385.0,2,10888,2,13365.0,18,13375.0,4,S
2018-04-19 09:12:22,13385.0,2,10890,2,13365.0,18,13375.0,4,S
2018-04-19 09:12:23,13385.0,2,10892,2,13365.0,18,13375.0,4,S
2018-04-19 09:12:23,13385.0,2,10894,2,13365.0,18,13375.0,4,S
2018-04-19 09:12:29,13395.0,18,10912,0,13365.0,18,13375.0,4,B
2018-04-19 09:12:30,13385.0,2,10914,2,13365.0,18,13375.0,4,S
2018-04-19 09:12:31,13385.0,2,10916,0,13365.0,18,13375.0,4,S
2018-04-19 09:12:33,13390.0,2,10918,0,13365.0,18,13375.0,4,B
2018-04-19 09:12:33,13390.0,2,10920,0,13365.0,18,13375.0,4,B
2018-04-19 09:12:34,13390.0,2,10922,0,13365.0,18,13375.0,4,B
2018-04-19 09:12:40,13395.0,2,10924,-2,13365.0,18,13375.0,4,B
2018-04-19 09:12:47,13400.0,12,10936,0,13365.0,18,13375.0,4,B
2018-04-19 09:12:48,13400.0,2,10938,-2,13365.0,18,13375.0,4,B
2018-04-19 09:12:49,13400.0,34,10972,0,13365.0,18,13375.0,4,B
2018-04-19 09:12:49,13405.0,34,11006,8,13365.0,18,13375.0,4,B
2018-04-19 09:12:50,13405.0,2,11008,0,13365.0,18,13375.0,4,B
2018-04-19 09:12:51,13400.0,6,11014,2,13365.0,18,13375.0,4,S
2018-04-19 09:12:51,13405.0,2,11016,2,13365.0,18,13375.0,4,B
2018-04-19 09:12:52,13405.0,2,11018,0,13365.0,18,13375.0,4,B
2018-04-19 09:12:54,13400.0,2,11020,2,13365.0,18,13375.0,4,S
2018-04-19 09:12:56,13400.0,2,11022,2,13365.0,18,13375.0,4,S
2018-04-19 09:12:56,13400.0,2,11024,2,13365.0,18,13375.0,4,S
2018-04-19 09:12:58,13405.0,6,11030,2,13365.0,18,13375.0,4,B
2018-04-19 09:13:02,13400.0,4,11034,0,13365.0,18,13375.0,4,S
2018-04-19 09:13:02,13400.0,2,11036,2,13365.0,18,13375.0,4,S
2018-04-19 09:13:03,13400.0,2,11038,2,13365.0,18,13375.0,4,S
2018-04-19 09:13:03,13400.0,2,11040,2,13365.0,18,13375.0,4,S
2018-04-19 09:13:06,13405.0,4,11044,-2,13365.0,18,13375.0,4,B
2018-04-19 09:13:08,13400.0,2,11046,2,13365.0,18,13375.0,4,S
2018-04-19 09:13:10,13395.0,2,11048,0,13365.0,18,13375.0,4,S
2018-04-19 09:13:11,13395.0,2,11050,2,13365.0,18,13375.0,4,S
2018-04-19 09:13:11,13400.0,2,11052,0,13365.0,18,13375.0,4,B
2018-04-19 09:13:12,13400.0,2,11054,2,13365.0,18,13375.0,4,B
2018-04-19 09:13:12,13400.0,2,11056,2,13365.0,18,13375.0,4,B
2018-04-19 09:13:13,13400.0,4,11060,4,13365.0,18,13375.0,4,B
2018-04-19 09:13:13,13400.0,2,11062,2,13365.0,18,13375.0,4,B
2018-04-19 09:13:15,13395.0,2,11064,2,13365.0,18,13375.0,4,S
2018-04-19 09:13:15,13400.0,4,11068,0,13365.0,18,13375.0,4,B
2018-04-19 09:13:16,13395.0,2,11070,0,13365.0,18,13375.0,4,S
2018-04-19 09:13:17,13395.0,2,11072,0,13365.0,18,13375.0,4,S
2018-04-19 09:13:17,13395.0,2,11074,2,13365.0,18,13375.0,4,S
2018-04-19 09:13:18,13395.0,2,11076,2,13365.0,18,13375.0,4,S
2018-04-19 09:13:20,13395.0,2,11078,2,13365.0,18,13375.0,4,S
2018-04-19 09:13:21,13395.0,2,11080,2,13365.0,18,13375.0,4,S
2018-04-19 09:13:22,13400.0,2,11082,-2,13365.0,18,13375.0,4,B
2018-04-19 09:13:24,13400.0,6,11088,-4,13365.0,18,13375.0,4,B
2018-04-19 09:13:25,13400.0,6,11094,-2,13365.0,18,13375.0,4,B
2018-04-19 09:13:26,13400.0,4,11098,-2,13365.0,18,13375.0,4,B
2018-04-19 09:13:26,13410.0,24,11122,20,13365.0,18,13375.0,4,B
2018-04-19 09:13:27,13405.0,18,11140,10,13365.0,18,13375.0,4,S
2018-04-19 09:13:27,13405.0,8,11148,6,13365.0,18,13375.0,4,S
2018-04-19 09:13:28,13415.0,26,11174,12,13365.0,18,13375.0,4,B
2018-04-19 09:13:28,13420.0,2,11176,-2,13365.0,18,13375.0,4,B
2018-04-19 09:13:29,13420.0,20,11196,0,13365.0,18,13375.0,4,B
2018-04-19 09:13:29,13420.0,18,11214,0,13365.0,18,13375.0,4,B
2018-04-19 09:13:30,13420.0,48,11262,26,13365.0,18,13375.0,4,B
2018-04-19 09:13:30,13415.0,4,11266,0,13365.0,18,13375.0,4,S
2018-04-19 09:13:31,13415.0,2,11268,2,13365.0,18,13375.0,4,S
2018-04-19 09:13:32,13420.0,4,11272,0,13365.0,18,13375.0,4,B
2018-04-19 09:13:33,13420.0,36,11308,22,13365.0,18,13375.0,4,B
2018-04-19 09:13:33,13415.0,2,11310,2,13365.0,18,13375.0,4,S
2018-04-19 09:13:34,13420.0,6,11316,6,13365.0,18,13375.0,4,B
2018-04-19 09:13:35,13420.0,8,11324,8,13365.0,18,13375.0,4,B
2018-04-19 09:13:36,13420.0,2,11326,2,13365.0,18,13375.0,4,B
2018-04-19 09:13:37,13420.0,4,11330,4,13365.0,18,13375.0,4,B
2018-04-19 09:13:39,13420.0,2,11332,2,13365.0,18,13375.0,4,B
2018-04-19 09:13:40,13420.0,8,11340,6,13365.0,18,13375.0,4,B
2018-04-19 09:13:41,13420.0,4,11344,2,13365.0,18,13375.0,4,B
2018-04-19 09:13:43,13425.0,2,11346,2,13365.0,18,13375.0,4,B
2018-04-19 09:13:44,13420.0,2,11348,2,13365.0,18,13375.0,4,S
2018-04-19 09:13:44,13420.0,2,11350,2,13365.0,18,13375.0,4,S
2018-04-19 09:13:45,13420.0,2,11352,2,13365.0,18,13375.0,4,S
2018-04-19 09:13:45,13425.0,4,11356,2,13365.0,18,13375.0,4,B
2018-04-19 09:13:46,13420.0,2,11358,2,13365.0,18,13375.0,4,S
2018-04-19 09:13:47,13420.0,2,11360,0,13365.0,18,13375.0,4,S
2018-04-19 09:13:47,13420.0,2,11362,2,13365.0,18,13375.0,4,S
2018-04-19 09:13:50,13420.0,2,11364,-2,13365.0,18,13375.0,4,S
2018-04-19 09:13:50,13415.0,2,11366,2,13365.0,18,13375.0,4,S
2018-04-19 09:13:53,13415.0,2,11368,0,13365.0,18,13375.0,4,S
2018-04-19 09:13:55,13415.0,2,11370,2,13365.0,18,13375.0,4,S
2018-04-19 09:13:55,13415.0,2,11372,2,13365.0,18,13375.0,4,S
2018-04-19 09:13:57,13420.0,10,11382,6,13365.0,18,13375.0,4,B
2018-04-19 09:13:58,13415.0,10,11392,-4,13365.0,18,13375.0,4,S
2018-04-19 09:14:00,13410.0,2,11394,0,13365.0,18,13375.0,4,S
2018-04-19 09:14:01,13410.0,2,11396,2,13365.0,18,13375.0,4,S
2018-04-19 09:14:01,13410.0,2,11398,2,13365.0,18,13375.0,4,S
2018-04-19 09:14:02,13405.0,2,11400,-2,13365.0,18,13375.0,4,S
2018-04-19 09:14:02,13415.0,2,11402,0,13365.0,18,13375.0,4,B
2018-04-19 09:14:07,13415.0,2,11404,0,13365.0,18,13375.0,4,B
2018-04-19 09:14:08,13415.0,2,11406,2,13365.0,18,13375.0,4,B
2018-04-19 09:14:11,13410.0,4,11410,-2,13365.0,18,13375.0,4,S
2018-04-19 09:14:12,13410.0,2,11412,2,13365.0,18,13375.0,4,S
2018-04-19 09:14:13,13405.0,2,11414,2,13365.0,18,13375.0,4,S
2018-04-19 09:14:14,13410.0,12,11426,6,13365.0,18,13375.0,4,B
2018-04-19 09:14:18,13400.0,8,11434,4,13365.0,18,13375.0,4,S
2018-04-19 09:14:20,13400.0,2,11436,2,13365.0,18,13375.0,4,S
2018-04-19 09:14:29,13400.0,24,11460,-2,13365.0,18,13375.0,4,S
2018-04-19 09:14:30,13395.0,2,11462,0,13365.0,18,13375.0,4,S
2018-04-19 09:14:31,13390.0,2,11464,-2,13365.0,18,13375.0,4,S
2018-04-19 09:14:31,13395.0,4,11468,-4,13365.0,18,13375.0,4,B
2018-04-19 09:14:34,13395.0,2,11470,0,13365.0,18,13375.0,4,B
2018-04-19 09:14:35,13395.0,2,11472,0,13365.0,18,13375.0,4,B
2018-04-19 09:14:44,13400.0,2,11474,2,13365.0,18,13375.0,4,B
2018-04-19 09:14:44,13400.0,2,11476,2,13365.0,18,13375.0,4,B
2018-04-19 09:14:45,13400.0,2,11478,2,13365.0,18,13375.0,4,B
2018-04-19 09:14:45,13400.0,2,11480,2,13365.0,18,13375.0,4,B
2018-04-19 09:14:46,13400.0,2,11482,2,13365.0,18,13375.0,4,B
2018-04-19 09:14:46,13400.0,2,11484,2,13365.0,18,13375.0,4,B
2018-04-19 09:14:47,13400.0,2,11486,2,13365.0,18,13375.0,4,B
2018-04-19 09:14:47,13400.0,2,11488,2,13365.0,18,13375.0,4,B
2018-04-19 09:14:48,13400.0,4,11492,4,13365.0,18,13375.0,4,B
2018-04-19 09:14:48,13400.0,2,11494,2,13365.0,18,13375.0,4,B
2018-04-19 09:14:49,13400.0,2,11496,2,13365.0,18,13375.0,4,B
2018-04-19 09:14:49,13400.0,2,11498,2,13365.0,18,13375.0,4,B
2018-04-19 09:14:50,13400.0,2,11500,2,13365.0,18,13375.0,4,B
2018-04-19 09:14:50,13400.0,2,11502,2,13365.0,18,13375.0,4,B
2018-04-19 09:14:51,13400.0,2,11504,2,13365.0,18,13375.0,4,B
2018-04-19 09:14:52,13405.0,2,11506,-2,13365.0,18,13375.0,4,B
2018-04-19 09:14:57,13395.0,2,11508,2,13365.0,18,13375.0,4,S
2018-04-19 09:15:01,13395.0,4,11512,2,13365.0,18,13375.0,4,S
2018-04-19 09:15:02,13395.0,4,11516,4,13365.0,18,13375.0,4,S
2018-04-19 09:15:02,13395.0,2,11518,2,13365.0,18,13375.0,4,S
2018-04-19 09:15:03,13395.0,2,11520,0,13365.0,18,13375.0,4,S
2018-04-19 09:15:05,13390.0,2,11522,2,13365.0,18,13375.0,4,S
2018-04-19 09:15:05,13390.0,2,11524,0,13365.0,18,13375.0,4,S
2018-04-19 09:15:06,13390.0,2,11526,0,13365.0,18,13375.0,4,S
2018-04-19 09:15:06,13390.0,2,11528,0,13365.0,18,13375.0,4,S
2018-04-19 09:15:07,13390.0,2,11530,2,13365.0,18,13375.0,4,S
2018-04-19 09:15:08,13390.0,2,11532,2,13365.0,18,13375.0,4,S
2018-04-19 09:15:09,13390.0,2,11534,2,13365.0,18,13375.0,4,S
2018-04-19 09:15:09,13390.0,2,11536,2,13365.0,18,13375.0,4,S
2018-04-19 09:15:10,13390.0,44,11580,22,13365.0,18,13375.0,4,S
2018-04-19 09:15:10,13390.0,4,11584,-2,13365.0,18,13375.0,4,S
2018-04-19 09:15:12,13390.0,16,11600,-8,13365.0,18,13375.0,4,S
2018-04-19 09:15:27,13390.0,2,11602,0,13365.0,18,13375.0,4,S
2018-04-19 09:15:29,13390.0,2,11604,2,13365.0,18,13375.0,4,S
2018-04-19 09:15:29,13390.0,2,11606,2,13365.0,18,13375.0,4,S
2018-04-19 09:15:30,13390.0,2,11608,2,13365.0,18,13375.0,4,S
2018-04-19 09:15:30,13390.0,4,11612,4,13365.0,18,13375.0,4,S
2018-04-19 09:15:31,13390.0,4,11616,2,13365.0,18,13375.0,4,S
2018-04-19 09:15:34,13395.0,4,11620,0,13365.0,18,13375.0,4,B
2018-04-19 09:15:35,13395.0,2,11622,0,13365.0,18,13375.0,4,B
2018-04-19 09:15:36,13395.0,2,11624,0,13365.0,18,13375.0,4,B
2018-04-19 09:15:37,13395.0,2,11626,0,13365.0,18,13375.0,4,B
2018-04-19 09:15:39,13390.0,10,11636,-6,13365.0,18,13375.0,4,S
2018-04-19 09:15:40,13395.0,6,11642,6,13365.0,18,13375.0,4,B
2018-04-19 09:15:43,13390.0,2,11644,2,13365.0,18,13375.0,4,S
2018-04-19 09:15:43,13390.0,2,11646,2,13365.0,18,13375.0,4,S
2018-04-19 09:15:52,13395.0,6,11652,2,13365.0,18,13375.0,4,B
2018-04-19 09:15:52,13395.0,10,11662,8,13365.0,18,13375.0,4,B
2018-04-19 09:15:57,13390.0,2,11664,2,13365.0,18,13375.0,4,S
2018-04-19 09:15:57,13390.0,2,11666,2,13365.0,18,13375.0,4,S
2018-04-19 09:15:58,13385.0,10,11676,-2,13365.0,18,13375.0,4,S
2018-04-19 09:16:02,13390.0,2,11678,2,13365.0,18,13375.0,4,B
2018-04-19 09:16:02,13390.0,2,11680,0,13365.0,18,13375.0,4,B
2018-04-19 09:16:03,13390.0,2,11682,0,13365.0,18,13375.0,4,B
2018-04-19 09:16:03,13390.0,2,11684,0,13365.0,18,13375.0,4,B
2018-04-19 09:16:04,13390.0,2,11686,0,13365.0,18,13375.0,4,B
2018-04-19 09:16:04,13390.0,2,11688,0,13365.0,18,13375.0,4,B
2018-04-19 09:16:10,13395.0,6,11694,0,13365.0,18,13375.0,4,B
2018-04-19 09:16:10,13395.0,2,11696,0,13365.0,18,13375.0,4,B
2018-04-19 09:16:16,13390.0,2,11698,2,13365.0,18,13375.0,4,S
2018-04-19 09:16:16,13390.0,2,11700,0,13365.0,18,13375.0,4,S
2018-04-19 09:16:17,13390.0,2,11702,0,13365.0,18,13375.0,4,S
2018-04-19 09:16:17,13390.0,2,11704,0,13365.0,18,13375.0,4,S
2018-04-19 09:16:23,13390.0,2,11706,0,13365.0,18,13375.0,4,S
2018-04-19 09:16:25,13390.0,2,11708,0,13365.0,18,13375.0,4,S
2018-04-19 09:16:31,13395.0,8,11716,-8,13365.0,18,13375.0,4,B
2018-04-19 09:16:32,13395.0,12,11728,-12,13365.0,18,13375.0,4,B
2018-04-19 09:16:34,13390.0,2,11730,0,13365.0,18,13375.0,4,S
2018-04-19 09:16:35,13390.0,2,11732,2,13365.0,18,13375.0,4,S
2018-04-19 09:16:35,13390.0,2,11734,2,13365.0,18,13375.0,4,S
2018-04-19 09:16:36,13390.0,2,11736,2,13365.0,18,13375.0,4,S
2018-04-19 09:16:36,13390.0,2,11738,2,13365.0,18,13375.0,4,S
2018-04-19 09:16:37,13390.0,2,11740,2,13365.0,18,13375.0,4,S
2018-04-19 09:16:37,13390.0,2,11742,2,13365.0,18,13375.0,4,S
2018-04-19 09:16:38,13400.0,6,11748,4,13365.0,18,13375.0,4,B
2018-04-19 09:16:43,13400.0,2,11750,0,13365.0,18,13375.0,4,B
2018-04-19 09:16:44,13390.0,2,11752,2,13365.0,18,13375.0,4,S
2018-04-19 09:16:45,13390.0,2,11754,2,13365.0,18,13375.0,4,S
2018-04-19 09:16:45,13390.0,2,11756,2,13365.0,18,13375.0,4,S
2018-04-19 09:16:46,13390.0,2,11758,2,13365.0,18,13375.0,4,S
2018-04-19 09:16:46,13390.0,2,11760,0,13365.0,18,13375.0,4,S
2018-04-19 09:16:47,13390.0,2,11762,0,13365.0,18,13375.0,4,S
2018-04-19 09:16:47,13400.0,2,11764,2,13365.0,18,13375.0,4,B
2018-04-19 09:16:48,13390.0,2,11766,2,13365.0,18,13375.0,4,S
2018-04-19 09:16:48,13390.0,2,11768,2,13365.0,18,13375.0,4,S
2018-04-19 09:16:49,13390.0,2,11770,2,13365.0,18,13375.0,4,S
2018-04-19 09:16:49,13390.0,2,11772,2,13365.0,18,13375.0,4,S
2018-04-19 09:16:50,13390.0,2,11774,2,13365.0,18,13375.0,4,S
2018-04-19 09:16:51,13390.0,2,11776,0,13365.0,18,13375.0,4,S
2018-04-19 09:17:00,13395.0,2,11778,0,13365.0,18,13375.0,4,B
2018-04-19 09:17:09,13390.0,2,11780,0,13365.0,18,13375.0,4,S
2018-04-19 09:17:10,13395.0,4,11784,2,13365.0,18,13375.0,4,B
2018-04-19 09:17:10,13395.0,2,11786,2,13365.0,18,13375.0,4,B
2018-04-19 09:17:11,13400.0,14,11800,10,13365.0,18,13375.0,4,B
2018-04-19 09:17:11,13400.0,4,11804,0,13365.0,18,13375.0,4,B
2018-04-19 09:17:14,13395.0,2,11806,0,13365.0,18,13375.0,4,S
2018-04-19 09:17:14,13395.0,2,11808,2,13365.0,18,13375.0,4,S
2018-04-19 09:17:15,13395.0,2,11810,2,13365.0,18,13375.0,4,S
2018-04-19 09:17:16,13400.0,6,11816,2,13365.0,18,13375.0,4,B
2018-04-19 09:17:16,13400.0,4,11820,4,13365.0,18,13375.0,4,B
2018-04-19 09:17:17,13405.0,16,11836,4,13365.0,18,13375.0,4,B
2018-04-19 09:17:17,13405.0,8,11844,2,13365.0,18,13375.0,4,B
2018-04-19 09:17:18,13405.0,16,11860,12,13365.0,18,13375.0,4,B
2018-04-19 09:17:18,13405.0,14,11874,4,13365.0,18,13375.0,4,B
2018-04-19 09:17:19,13405.0,6,11880,4,13365.0,18,13375.0,4,B
2018-04-19 09:17:22,13395.0,2,11882,0,13365.0,18,13375.0,4,S
2018-04-19 09:17:24,13395.0,2,11884,0,13365.0,18,13375.0,4,S
2018-04-19 09:17:25,13395.0,2,11886,-2,13365.0,18,13375.0,4,S
2018-04-19 09:17:26,13400.0,2,11888,-2,13365.0,18,13375.0,4,B
2018-04-19 09:17:27,13395.0,2,11890,2,13365.0,18,13375.0,4,S
2018-04-19 09:17:27,13395.0,2,11892,2,13365.0,18,13375.0,4,S
2018-04-19 09:17:28,13405.0,8,11900,6,13365.0,18,13375.0,4,B
2018-04-19 09:17:28,13400.0,16,11916,16,13365.0,18,13375.0,4,S
2018-04-19 09:17:41,13400.0,6,11922,-6,13365.0,18,13375.0,4,S
2018-04-19 09:17:42,13395.0,2,11924,0,13365.0,18,13375.0,4,S
2018-04-19 09:17:46,13395.0,2,11926,0,13365.0,18,13375.0,4,S
2018-04-19 09:17:46,13395.0,2,11928,0,13365.0,18,13375.0,4,S
2018-04-19 09:17:52,13390.0,4,11932,0,13365.0,18,13375.0,4,S
2018-04-19 09:17:52,13390.0,2,11934,0,13365.0,18,13375.0,4,S
2018-04-19 09:17:53,13390.0,2,11936,0,13365.0,18,13375.0,4,S
2018-04-19 09:17:53,13395.0,6,11942,-2,13365.0,18,13375.0,4,B
2018-04-19 09:17:54,13395.0,2,11944,0,13365.0,18,13375.0,4,B
2018-04-19 09:17:54,13395.0,2,11946,0,13365.0,18,13375.0,4,B
2018-04-19 09:17:55,13395.0,2,11948,0,13365.0,18,13375.0,4,B
2018-04-19 09:18:01,13390.0,2,11950,2,13365.0,18,13375.0,4,S
2018-04-19 09:18:02,13390.0,2,11952,0,13365.0,18,13375.0,4,S
2018-04-19 09:18:02,13390.0,2,11954,0,13365.0,18,13375.0,4,S
2018-04-19 09:18:03,13390.0,2,11956,0,13365.0,18,13375.0,4,S
2018-04-19 09:18:03,13390.0,2,11958,2,13365.0,18,13375.0,4,S
2018-04-19 09:18:04,13390.0,2,11960,2,13365.0,18,13375.0,4,S
2018-04-19 09:18:18,13385.0,2,11962,0,13365.0,18,13375.0,4,S
2018-04-19 09:18:18,13385.0,2,11964,0,13365.0,18,13375.0,4,S
2018-04-19 09:18:19,13385.0,2,11966,0,13365.0,18,13375.0,4,S
2018-04-19 09:18:19,13385.0,2,11968,0,13365.0,18,13375.0,4,S
2018-04-19 09:18:20,13385.0,2,11970,0,13365.0,18,13375.0,4,S
2018-04-19 09:18:20,13385.0,6,11976,-4,13365.0,18,13375.0,4,S
2018-04-19 09:18:21,13385.0,10,11986,4,13365.0,18,13375.0,4,S
2018-04-19 09:18:21,13380.0,2,11988,0,13365.0,18,13375.0,4,S
2018-04-19 09:18:22,13380.0,2,11990,0,13365.0,18,13375.0,4,S
2018-04-19 09:18:22,13380.0,2,11992,0,13365.0,18,13375.0,4,S
2018-04-19 09:18:24,13385.0,2,11994,2,13365.0,18,13375.0,4,B
2018-04-19 09:18:25,13385.0,2,11996,0,13365.0,18,13375.0,4,B
2018-04-19 09:18:27,13385.0,2,11998,2,13365.0,18,13375.0,4,B
2018-04-19 09:18:27,13385.0,2,12000,-2,13365.0,18,13375.0,4,B
2018-04-19 09:18:30,13380.0,2,12002,0,13365.0,18,13375.0,4,S
2018-04-19 09:18:31,13380.0,2,12004,0,13365.0,18,13375.0,4,S
2018-04-19 09:18:31,13380.0,2,12006,2,13365.0,18,13375.0,4,S
2018-04-19 09:18:32,13380.0,2,12008,2,13365.0,18,13375.0,4,S
2018-04-19 09:18:32,13380.0,2,12010,0,13365.0,18,13375.0,4,S
2018-04-19 09:18:33,13380.0,2,12012,2,13365.0,18,13375.0,4,S
2018-04-19 09:18:33,13385.0,8,12020,-2,13365.0,18,13375.0,4,B
2018-04-19 09:18:34,13380.0,2,12022,0,13365.0,18,13375.0,4,S
2018-04-19 09:18:36,13385.0,2,12024,2,13365.0,18,13375.0,4,B
2018-04-19 09:18:36,13385.0,4,12028,0,13365.0,18,13375.0,4,B
2018-04-19 09:18:37,13385.0,2,12030,2,13365.0,18,13375.0,4,B
2018-04-19 09:18:39,13380.0,2,12032,2,13365.0,18,13375.0,4,S
2018-04-19 09:18:39,13380.0,2,12034,0,13365.0,18,13375.0,4,S
2018-04-19 09:18:40,13380.0,2,12036,0,13365.0,18,13375.0,4,S
2018-04-19 09:18:40,13380.0,2,12038,0,13365.0,18,13375.0,4,S
2018-04-19 09:18:41,13380.0,2,12040,0,13365.0,18,13375.0,4,S
2018-04-19 09:18:41,13380.0,2,12042,0,13365.0,18,13375.0,4,S
2018-04-19 09:18:42,13380.0,2,12044,0,13365.0,18,13375.0,4,S
2018-04-19 09:18:42,13380.0,2,12046,0,13365.0,18,13375.0,4,S
2018-04-19 09:18:46,13380.0,8,12054,-8,13365.0,18,13375.0,4,S
2018-04-19 09:18:47,13380.0,10,12064,-10,13365.0,18,13375.0,4,S
2018-04-19 09:18:47,13380.0,12,12076,0,13365.0,18,13375.0,4,S
2018-04-19 09:18:50,13380.0,2,12078,-2,13365.0,18,13375.0,4,S
2018-04-19 09:18:56,13380.0,2,12080,2,13365.0,18,13375.0,4,S
2018-04-19 09:19:01,13380.0,2,12082,-2,13365.0,18,13375.0,4,S
2018-04-19 09:19:04,13385.0,8,12090,-6,13365.0,18,13375.0,4,B
2018-04-19 09:19:05,13385.0,2,12092,-2,13365.0,18,13375.0,4,B
2018-04-19 09:19:25,13380.0,2,12094,0,13365.0,18,13375.0,4,S
2018-04-19 09:19:28,13380.0,2,12096,-2,13365.0,18,13375.0,4,S
2018-04-19 09:19:30,13380.0,10,12106,-6,13365.0,18,13375.0,4,S
2018-04-19 09:19:31,13380.0,2,12108,0,13365.0,18,13375.0,4,S
2018-04-19 09:19:34,13375.0,4,12112,4,13365.0,18,13375.0,4,S
2018-04-19 09:19:35,13375.0,2,12114,0,13365.0,18,13375.0,4,S
2018-04-19 09:19:35,13375.0,12,12126,0,13365.0,18,13375.0,4,S
2018-04-19 09:19:42,13375.0,2,12128,0,13365.0,18,13375.0,4,S
2018-04-19 09:19:43,13375.0,2,12130,2,13365.0,18,13375.0,4,S
2018-04-19 09:19:49,13380.0,4,12134,2,13365.0,18,13375.0,4,B
2018-04-19 09:19:55,13375.0,12,12146,0,13365.0,18,13375.0,4,S
2018-04-19 09:19:57,13375.0,2,12148,0,13365.0,18,13375.0,4,S
2018-04-19 09:20:01,13375.0,32,12180,32,13365.0,18,13375.0,4,S
2018-04-19 09:20:01,13375.0,54,12234,44,13365.0,18,13375.0,4,S
2018-04-19 09:20:02,13370.0,16,12250,4,13365.0,18,13375.0,4,S
2018-04-19 09:20:02,13370.0,30,12280,-18,13365.0,18,13375.0,4,S
2018-04-19 09:20:04,13370.0,8,12288,0,13365.0,18,13375.0,4,S
2018-04-19 09:20:05,13370.0,2,12290,0,13365.0,18,13375.0,4,S
2018-04-19 09:20:05,13375.0,8,12298,0,13365.0,18,13375.0,4,B
2018-04-19 09:20:16,13375.0,14,12312,4,13365.0,18,13375.0,4,B
2018-04-19 09:20:17,13375.0,2,12314,0,13365.0,18,13375.0,4,B
2018-04-19 09:20:30,13380.0,2,12316,0,13365.0,18,13375.0,4,B
2018-04-19 09:20:33,13380.0,6,12322,0,13365.0,18,13375.0,4,B
2018-04-19 09:20:35,13375.0,2,12324,-2,13365.0,18,13375.0,4,S
2018-04-19 09:20:35,13375.0,2,12326,-2,13365.0,18,13375.0,4,S
2018-04-19 09:20:37,13375.0,2,12328,2,13365.0,18,13375.0,4,S
2018-04-19 09:20:45,13385.0,6,12334,0,13365.0,18,13375.0,4,B
2018-04-19 09:20:52,13380.0,20,12354,-16,13365.0,18,13375.0,4,S
2018-04-19 09:20:54,13385.0,2,12356,-2,13365.0,18,13375.0,4,B
2018-04-19 09:21:11,13390.0,2,12358,-2,13365.0,18,13375.0,4,B
2018-04-19 09:21:12,13390.0,6,12364,-2,13365.0,18,13375.0,4,B
2018-04-19 09:21:14,13385.0,2,12366,2,13365.0,18,13375.0,4,S
2018-04-19 09:21:22,13385.0,16,12382,4,13365.0,18,13375.0,4,S
2018-04-19 09:21:23,13385.0,2,12384,2,13365.0,18,13375.0,4,S
2018-04-19 09:21:35,13385.0,2,12386,0,13365.0,18,13375.0,4,S
2018-04-19 09:22:12,13385.0,14,12400,4,13365.0,18,13375.0,4,S
2018-04-19 09:22:12,13385.0,8,12408,6,13365.0,18,13375.0,4,S
2018-04-19 09:22:51,13385.0,2,12410,0,13365.0,18,13375.0,4,S
2018-04-19 09:23:16,13380.0,12,12422,-4,13365.0,18,13375.0,4,S
2018-04-19 09:23:33,13380.0,2,12424,2,13365.0,18,13375.0,4,S
2018-04-19 09:23:41,13380.0,6,12430,4,13365.0,18,13375.0,4,S
2018-04-19 09:23:42,13380.0,2,12432,0,13365.0,18,13375.0,4,S
2018-04-19 09:23:44,13375.0,18,12450,12,13365.0,18,13375.0,4,S
2018-04-19 09:23:45,13375.0,2,12452,2,13365.0,18,13375.0,4,S
2018-04-19 09:23:59,13375.0,2,12454,-2,13365.0,18,13375.0,4,S
2018-04-19 09:23:59,13375.0,2,12456,-2,13365.0,18,13375.0,4,S
2018-04-19 09:24:28,13375.0,2,12458,0,13365.0,18,13375.0,4,S
2018-04-19 09:24:31,13375.0,2,12460,-2,13365.0,18,13375.0,4,S
2018-04-19 09:24:33,13375.0,2,12462,2,13365.0,18,13375.0,4,S
2018-04-19 09:24:56,13375.0,2,12464,2,13365.0,18,13375.0,4,S
2018-04-19 09:25:17,13375.0,2,12466,0,13365.0,18,13375.0,4,S
2018-04-19 09:25:19,13375.0,8,12474,2,13365.0,18,13375.0,4,S
2018-04-19 09:25:21,13370.0,2,12476,2,13365.0,18,13375.0,4,S
2018-04-19 09:25:29,13370.0,4,12480,2,13365.0,18,13375.0,4,S
2018-04-19 09:25:30,13375.0,2,12482,0,13365.0,18,13375.0,4,B
2018-04-19 09:25:46,13370.0,20,12502,6,13365.0,18,13375.0,4,S
2018-04-19 09:25:52,13365.0,6,12508,4,13365.0,18,13375.0,4,S
2018-04-19 09:25:53,13360.0,2,12510,-2,13365.0,18,13375.0,4,S
2018-04-19 09:25:55,13360.0,2,12512,0,13365.0,18,13375.0,4,S
2018-04-19 09:25:55,13360.0,2,12514,-2,13365.0,18,13375.0,4,S
2018-04-19 09:25:57,13355.0,14,12528,4,13365.0,18,13375.0,4,S
2018-04-19 09:25:58,13355.0,6,12534,0,13365.0,18,13375.0,4,S
2018-04-19 09:26:03,13355.0,2,12536,0,13365.0,18,13375.0,4,S
2018-04-19 09:26:03,13350.0,2,12538,-2,13365.0,18,13375.0,4,S
2018-04-19 09:26:04,13350.0,2,12540,-2,13365.0,18,13375.0,4,S
2018-04-19 09:26:06,13355.0,2,12542,-2,13365.0,18,13375.0,4,B
2018-04-19 09:26:08,13355.0,4,12546,0,13365.0,18,13375.0,4,B
2018-04-19 09:26:09,13355.0,6,12552,0,13365.0,18,13375.0,4,B
2018-04-19 09:26:12,13355.0,10,12562,0,13365.0,18,13375.0,4,B
2018-04-19 09:26:12,13355.0,2,12564,0,13365.0,18,13375.0,4,B
2018-04-19 09:26:13,13355.0,10,12574,-4,13365.0,18,13375.0,4,B
2018-04-19 09:26:13,13355.0,16,12590,-8,13365.0,18,13375.0,4,B
2018-04-19 09:26:15,13350.0,2,12592,0,13365.0,18,13375.0,4,S
2018-04-19 09:26:18,13355.0,2,12594,0,13365.0,18,13375.0,4,B
2018-04-19 09:26:19,13355.0,2,12596,0,13365.0,18,13375.0,4,B
2018-04-19 09:26:27,13355.0,4,12600,0,13365.0,18,13375.0,4,B
2018-04-19 09:26:39,13360.0,2,12602,0,13365.0,18,13375.0,4,B
2018-04-19 09:26:42,13360.0,2,12604,0,13365.0,18,13375.0,4,B
2018-04-19 09:26:45,13355.0,2,12606,0,13365.0,18,13375.0,4,S
2018-04-19 09:26:48,13360.0,2,12608,-2,13365.0,18,13375.0,4,B
2018-04-19 09:26:48,13365.0,8,12616,4,13365.0,18,13375.0,4,B
2018-04-19 09:26:50,13360.0,10,12626,0,13365.0,18,13375.0,4,S
2018-04-19 09:26:51,13365.0,2,12628,0,13365.0,18,13375.0,4,B
2018-04-19 09:27:08,13365.0,2,12630,0,13365.0,18,13375.0,4,B
2018-04-19 09:27:08,13365.0,2,12632,2,13365.0,18,13375.0,4,B
2018-04-19 09:27:10,13370.0,8,12640,0,13365.0,18,13375.0,4,B
2018-04-19 09:27:12,13370.0,2,12642,0,13365.0,18,13375.0,4,B
2018-04-19 09:27:21,13360.0,2,12644,0,13365.0,18,13375.0,4,S
2018-04-19 09:27:22,13360.0,2,12646,2,13365.0,18,13375.0,4,S
2018-04-19 09:27:22,13360.0,2,12648,0,13365.0,18,13375.0,4,S
2018-04-19 09:27:33,13360.0,2,12650,2,13365.0,18,13375.0,4,S
2018-04-19 09:27:38,13360.0,8,12658,-6,13365.0,18,13375.0,4,S
2018-04-19 09:28:05,13365.0,2,12660,-2,13365.0,18,13375.0,4,B
2018-04-19 09:28:09,13365.0,2,12662,0,13365.0,18,13375.0,4,B
2018-04-19 09:28:31,13365.0,2,12664,-2,13365.0,18,13375.0,4,B
2018-04-19 09:28:50,13365.0,2,12666,0,13365.0,18,13375.0,4,B
2018-04-19 09:28:50,13365.0,2,12668,-2,13365.0,18,13375.0,4,B
2018-04-19 09:28:51,13370.0,2,12670,0,13365.0,18,13375.0,4,B
2018-04-19 09:29:01,13365.0,2,12672,0,13365.0,18,13375.0,4,S
2018-04-19 09:29:21,13365.0,2,12674,2,13365.0,18,13375.0,4,S
2018-04-19 09:29:22,13365.0,4,12678,4,13365.0,18,13375.0,4,S
2018-04-19 09:29:23,13365.0,4,12682,4,13365.0,18,13375.0,4,S
2018-04-19 09:29:27,13365.0,2,12684,2,13365.0,18,13375.0,4,S
2018-04-19 09:30:21,13365.0,2,12686,0,13365.0,18,13375.0,4,S
2018-04-19 09:30:40,13365.0,2,12688,2,13365.0,18,13375.0,4,S
2018-04-19 09:30:53,13365.0,2,12690,0,13365.0,18,13375.0,4,S
2018-04-19 09:30:53,13365.0,4,12694,-4,13365.0,18,13375.0,4,S
2018-04-19 09:31:09,13365.0,2,12696,2,13365.0,18,13375.0,4,S
2018-04-19 09:31:27,13360.0,2,12698,2,13365.0,18,13375.0,4,S
2018-04-19 09:31:28,13360.0,2,12700,2,13365.0,18,13375.0,4,S
2018-04-19 09:31:29,13360.0,2,12702,2,13365.0,18,13375.0,4,S
2018-04-19 09:31:37,13360.0,4,12706,0,13365.0,18,13375.0,4,S
2018-04-19 09:31:51,13360.0,8,12714,8,13365.0,18,13375.0,4,S
2018-04-19 09:31:52,13365.0,2,12716,2,13365.0,18,13375.0,4,B
2018-04-19 09:32:22,13360.0,8,12724,4,13365.0,18,13375.0,4,S
2018-04-19 09:32:22,13360.0,14,12738,12,13365.0,18,13375.0,4,S
2018-04-19 09:32:25,13355.0,4,12742,0,13365.0,18,13375.0,4,S
2018-04-19 09:32:28,13360.0,2,12744,0,13365.0,18,13375.0,4,B
2018-04-19 09:32:32,13360.0,2,12746,-2,13365.0,18,13375.0,4,B
2018-04-19 09:32:35,13355.0,2,12748,-2,13365.0,18,13375.0,4,S
2018-04-19 09:32:42,13355.0,2,12750,0,13365.0,18,13375.0,4,S
2018-04-19 09:32:43,13360.0,2,12752,-2,13365.0,18,13375.0,4,B
2018-04-19 09:32:43,13355.0,4,12756,4,13365.0,18,13375.0,4,S
2018-04-19 09:32:44,13355.0,2,12758,2,13365.0,18,13375.0,4,S
2018-04-19 09:32:47,13355.0,2,12760,2,13365.0,18,13375.0,4,S
2018-04-19 09:32:54,13360.0,2,12762,-2,13365.0,18,13375.0,4,B
2018-04-19 09:32:57,13355.0,2,12764,0,13365.0,18,13375.0,4,S
2018-04-19 09:32:58,13355.0,2,12766,0,13365.0,18,13375.0,4,S
2018-04-19 09:32:59,13355.0,2,12768,2,13365.0,18,13375.0,4,S
2018-04-19 09:33:00,13355.0,2,12770,2,13365.0,18,13375.0,4,S
2018-04-19 09:33:02,13355.0,2,12772,2,13365.0,18,13375.0,4,S
2018-04-19 09:33:03,13355.0,2,12774,2,13365.0,18,13375.0,4,S
2018-04-19 09:33:04,13360.0,4,12778,-2,13365.0,18,13375.0,4,B
2018-04-19 09:33:10,13360.0,2,12780,0,13365.0,18,13375.0,4,B
2018-04-19 09:33:19,13360.0,2,12782,2,13365.0,18,13375.0,4,B
2018-04-19 09:33:23,13360.0,2,12784,-2,13365.0,18,13375.0,4,B
2018-04-19 09:33:28,13360.0,2,12786,0,13365.0,18,13375.0,4,B
2018-04-19 09:33:50,13355.0,2,12788,2,13365.0,18,13375.0,4,S
2018-04-19 09:33:51,13355.0,2,12790,2,13365.0,18,13375.0,4,S
2018-04-19 09:33:59,13360.0,2,12792,-2,13365.0,18,13375.0,4,B
2018-04-19 09:34:15,13355.0,22,12814,22,13365.0,18,13375.0,4,S
2018-04-19 09:34:16,13355.0,10,12824,6,13365.0,18,13375.0,4,S
2018-04-19 09:34:17,13350.0,2,12826,0,13365.0,18,13375.0,4,S
2018-04-19 09:34:18,13350.0,6,12832,-4,13365.0,18,13375.0,4,S
2018-04-19 09:34:19,13355.0,4,12836,-4,13365.0,18,13375.0,4,B
2018-04-19 09:34:22,13350.0,8,12844,0,13365.0,18,13375.0,4,S
2018-04-19 09:34:24,13350.0,2,12846,0,13365.0,18,13375.0,4,S
2018-04-19 09:34:25,13355.0,2,12848,2,13365.0,18,13375.0,4,B
2018-04-19 09:34:29,13360.0,4,12852,0,13365.0,18,13375.0,4,B
2018-04-19 09:34:30,13360.0,4,12856,-2,13365.0,18,13375.0,4,B
2018-04-19 09:34:34,13360.0,2,12858,0,13365.0,18,13375.0,4,B
2018-04-19 09:34:37,13360.0,2,12860,0,13365.0,18,13375.0,4,B
2018-04-19 09:34:45,13360.0,2,12862,2,13365.0,18,13375.0,4,B
2018-04-19 09:35:09,13360.0,4,12866,2,13365.0,18,13375.0,4,B
2018-04-19 09:35:17,13360.0,6,12872,6,13365.0,18,13375.0,4,B
2018-04-19 09:35:21,13360.0,2,12874,-2,13365.0,18,13375.0,4,B
2018-04-19 09:35:29,13365.0,4,12878,-4,13365.0,18,13375.0,4,B
2018-04-19 09:35:30,13365.0,2,12880,2,13365.0,18,13375.0,4,B
2018-04-19 09:35:40,13365.0,2,12882,2,13365.0,18,13375.0,4,B
2018-04-19 09:35:55,13365.0,8,12890,2,13365.0,18,13375.0,4,B
2018-04-19 09:35:55,13365.0,2,12892,0,13365.0,18,13375.0,4,B
2018-04-19 09:35:56,13365.0,4,12896,4,13365.0,18,13375.0,4,B
2018-04-19 09:36:02,13365.0,2,12898,-2,13365.0,18,13375.0,4,B
2018-04-19 09:36:05,13370.0,2,12900,0,13365.0,18,13375.0,4,B
2018-04-19 09:36:06,13365.0,2,12902,0,13365.0,18,13375.0,4,S
2018-04-19 09:36:10,13365.0,2,12904,-2,13365.0,18,13375.0,4,S
2018-04-19 09:36:27,13360.0,4,12908,2,13365.0,18,13375.0,4,S
2018-04-19 09:36:28,13360.0,2,12910,0,13365.0,18,13375.0,4,S
2018-04-19 09:36:28,13360.0,2,12912,2,13365.0,18,13375.0,4,S
2018-04-19 09:36:29,13360.0,2,12914,0,13365.0,18,13375.0,4,S
2018-04-19 09:36:30,13365.0,2,12916,2,13365.0,18,13375.0,4,B
2018-04-19 09:36:33,13365.0,2,12918,2,13365.0,18,13375.0,4,B
2018-04-19 09:36:35,13360.0,2,12920,2,13365.0,18,13375.0,4,S
2018-04-19 09:37:11,13360.0,4,12924,-2,13365.0,18,13375.0,4,S
2018-04-19 09:37:17,13365.0,2,12926,0,13365.0,18,13375.0,4,B
2018-04-19 09:37:33,13370.0,2,12928,-2,13365.0,18,13375.0,4,B
2018-04-19 09:37:44,13370.0,2,12930,-2,13365.0,18,13375.0,4,B
2018-04-19 09:37:46,13370.0,2,12932,0,13365.0,18,13375.0,4,B
2018-04-19 09:37:47,13370.0,2,12934,-2,13365.0,18,13375.0,4,B
2018-04-19 09:37:55,13370.0,2,12936,0,13365.0,18,13375.0,4,B
2018-04-19 09:37:58,13370.0,2,12938,-2,13365.0,18,13375.0,4,B
2018-04-19 09:38:04,13370.0,4,12942,4,13365.0,18,13375.0,4,B
2018-04-19 09:38:07,13370.0,4,12946,0,13365.0,18,13375.0,4,B
2018-04-19 09:38:29,13365.0,2,12948,2,13365.0,18,13375.0,4,S
2018-04-19 09:38:42,13365.0,6,12954,-2,13365.0,18,13375.0,4,S
2018-04-19 09:38:45,13360.0,2,12956,2,13365.0,18,13375.0,4,S
2018-04-19 09:38:50,13370.0,2,12958,0,13365.0,18,13375.0,4,B
2018-04-19 09:39:22,13365.0,2,12960,0,13365.0,18,13375.0,4,S
2018-04-19 09:39:26,13370.0,2,12962,0,13365.0,18,13375.0,4,B
2018-04-19 09:39:27,13365.0,2,12964,0,13365.0,18,13375.0,4,S
2018-04-19 09:39:27,13370.0,2,12966,0,13365.0,18,13375.0,4,B
2018-04-19 09:39:48,13370.0,2,12968,2,13365.0,18,13375.0,4,B
2018-04-19 09:40:09,13370.0,4,12972,0,13365.0,18,13375.0,4,B
2018-04-19 09:40:53,13365.0,2,12974,0,13365.0,18,13375.0,4,S
2018-04-19 09:41:00,13365.0,2,12976,2,13365.0,18,13375.0,4,S
2018-04-19 09:41:27,13370.0,24,13000,12,13365.0,18,13375.0,4,B
2018-04-19 09:41:27,13370.0,4,13004,4,13365.0,18,13375.0,4,B
2018-04-19 09:41:40,13370.0,2,13006,2,13365.0,18,13375.0,4,B
2018-04-19 09:41:41,13375.0,2,13008,-2,13365.0,18,13375.0,4,B
2018-04-19 09:41:45,13375.0,2,13010,0,13365.0,18,13375.0,4,B
2018-04-19 09:41:53,13370.0,12,13022,0,13365.0,18,13375.0,4,S
2018-04-19 09:41:54,13370.0,28,13050,18,13365.0,18,13375.0,4,S
2018-04-19 09:42:04,13370.0,4,13054,4,13365.0,18,13375.0,4,S
2018-04-19 09:42:16,13375.0,2,13056,0,13365.0,18,13375.0,4,B
2018-04-19 09:42:19,13370.0,2,13058,0,13365.0,18,13375.0,4,S
2018-04-19 09:42:20,13370.0,2,13060,0,13365.0,18,13375.0,4,S
2018-04-19 09:42:36,13370.0,2,13062,2,13365.0,18,13375.0,4,S
2018-04-19 09:42:42,13370.0,2,13064,0,13365.0,18,13375.0,4,S
2018-04-19 09:43:13,13375.0,18,13082,12,13365.0,18,13375.0,4,B
2018-04-19 09:43:14,13375.0,8,13090,-2,13365.0,18,13375.0,4,B
2018-04-19 09:43:33,13375.0,2,13092,0,13365.0,18,13375.0,4,B
2018-04-19 09:43:45,13370.0,4,13096,2,13365.0,18,13375.0,4,S
2018-04-19 09:44:12,13370.0,2,13098,2,13365.0,18,13375.0,4,S
2018-04-19 09:44:22,13365.0,2,13100,2,13365.0,18,13375.0,4,S
2018-04-19 09:44:26,13370.0,2,13102,0,13365.0,18,13375.0,4,B
2018-04-19 09:44:27,13370.0,2,13104,0,13365.0,18,13375.0,4,B
2018-04-19 09:44:27,13370.0,2,13106,2,13365.0,18,13375.0,4,B
2018-04-19 09:45:07,13370.0,2,13108,0,13365.0,18,13375.0,4,B
2018-04-19 09:45:08,13380.0,18,13126,12,13365.0,18,13375.0,4,B
2018-04-19 09:45:15,13370.0,2,13128,0,13365.0,18,13375.0,4,S
2018-04-19 09:45:18,13380.0,2,13130,2,13365.0,18,13375.0,4,B
2018-04-19 09:45:23,13380.0,4,13134,2,13365.0,18,13375.0,4,B
2018-04-19 09:45:24,13375.0,2,13136,0,13365.0,18,13375.0,4,S
2018-04-19 09:45:25,13375.0,2,13138,2,13365.0,18,13375.0,4,S
2018-04-19 09:45:25,13375.0,2,13140,2,13365.0,18,13375.0,4,S
2018-04-19 09:45:26,13375.0,2,13142,0,13365.0,18,13375.0,4,S
2018-04-19 09:45:26,13375.0,2,13144,0,13365.0,18,13375.0,4,S
2018-04-19 09:45:58,13375.0,2,13146,2,13365.0,18,13375.0,4,S
2018-04-19 09:46:01,13380.0,2,13148,0,13365.0,18,13375.0,4,B
2018-04-19 09:46:02,13385.0,12,13160,-4,13365.0,18,13375.0,4,B
2018-04-19 09:46:02,13385.0,4,13164,4,13365.0,18,13375.0,4,B
2018-04-19 09:46:03,13385.0,4,13168,4,13365.0,18,13375.0,4,B
2018-04-19 09:46:03,13385.0,2,13170,2,13365.0,18,13375.0,4,B
2018-04-19 09:46:04,13385.0,2,13172,2,13365.0,18,13375.0,4,B
2018-04-19 09:46:04,13385.0,4,13176,2,13365.0,18,13375.0,4,B
2018-04-19 09:46:05,13385.0,2,13178,2,13365.0,18,13375.0,4,B
2018-04-19 09:46:07,13385.0,2,13180,0,13365.0,18,13375.0,4,B
2018-04-19 09:46:07,13385.0,2,13182,2,13365.0,18,13375.0,4,B
2018-04-19 09:46:15,13385.0,2,13184,0,13365.0,18,13375.0,4,B
2018-04-19 09:46:19,13385.0,2,13186,2,13365.0,18,13375.0,4,B
2018-04-19 09:46:51,13390.0,20,13206,12,13365.0,18,13375.0,4,B
2018-04-19 09:46:52,13390.0,20,13226,0,13365.0,18,13375.0,4,B
2018-04-19 09:46:52,13390.0,20,13246,8,13365.0,18,13375.0,4,B
2018-04-19 09:46:56,13390.0,8,13254,2,13365.0,18,13375.0,4,B
2018-04-19 09:46:57,13390.0,2,13256,2,13365.0,18,13375.0,4,B
2018-04-19 09:47:03,13390.0,2,13258,2,13365.0,18,13375.0,4,B
2018-04-19 09:47:04,13390.0,2,13260,0,13365.0,18,13375.0,4,B
2018-04-19 09:47:06,13390.0,4,13264,4,13365.0,18,13375.0,4,B
2018-04-19 09:47:13,13390.0,42,13306,20,13365.0,18,13375.0,4,B
2018-04-19 09:47:20,13380.0,6,13312,-4,13365.0,18,13375.0,4,S
2018-04-19 09:47:20,13380.0,2,13314,0,13365.0,18,13375.0,4,S
2018-04-19 09:47:36,13385.0,2,13316,0,13365.0,18,13375.0,4,B
2018-04-19 09:48:04,13385.0,2,13318,2,13365.0,18,13375.0,4,B
2018-04-19 09:48:18,13380.0,2,13320,0,13365.0,18,13375.0,4,S
2018-04-19 09:48:18,13380.0,2,13322,-2,13365.0,18,13375.0,4,S
2018-04-19 09:48:46,13380.0,2,13324,-2,13365.0,18,13375.0,4,S
2018-04-19 09:49:22,13385.0,6,13330,-4,13365.0,18,13375.0,4,B
2018-04-19 09:49:26,13385.0,2,13332,2,13365.0,18,13375.0,4,B
2018-04-19 09:49:32,13385.0,4,13336,0,13365.0,18,13375.0,4,B
2018-04-19 09:49:53,13385.0,2,13338,2,13365.0,18,13375.0,4,B
2018-04-19 09:49:53,13385.0,2,13340,0,13365.0,18,13375.0,4,B
2018-04-19 09:49:54,13385.0,2,13342,0,13365.0,18,13375.0,4,B
2018-04-19 09:50:10,13385.0,2,13344,0,13365.0,18,13375.0,4,B
2018-04-19 09:50:20,13385.0,4,13348,0,13365.0,18,13375.0,4,B
2018-04-19 09:50:23,13385.0,2,13350,-2,13365.0,18,13375.0,4,B
2018-04-19 09:51:00,13390.0,6,13356,4,13365.0,18,13375.0,4,B
2018-04-19 09:51:14,13395.0,4,13360,0,13365.0,18,13375.0,4,B
2018-04-19 09:51:22,13395.0,2,13362,2,13365.0,18,13375.0,4,B
2018-04-19 09:51:23,13400.0,8,13370,0,13365.0,18,13375.0,4,B
2018-04-19 09:51:24,13400.0,4,13374,-2,13365.0,18,13375.0,4,B
2018-04-19 09:51:30,13395.0,2,13376,0,13365.0,18,13375.0,4,S
2018-04-19 09:51:34,13400.0,4,13380,-2,13365.0,18,13375.0,4,B
2018-04-19 09:51:35,13395.0,2,13382,-2,13365.0,18,13375.0,4,S
2018-04-19 09:52:09,13390.0,2,13384,2,13365.0,18,13375.0,4,S
2018-04-19 09:52:10,13390.0,12,13396,0,13365.0,18,13375.0,4,S
2018-04-19 09:52:11,13390.0,46,13442,-28,13365.0,18,13375.0,4,S
2018-04-19 09:52:16,13390.0,2,13444,2,13365.0,18,13375.0,4,S
2018-04-19 09:52:35,13385.0,2,13446,-2,13365.0,18,13375.0,4,S
2018-04-19 09:52:42,13385.0,2,13448,0,13365.0,18,13375.0,4,S
2018-04-19 09:53:09,13390.0,4,13452,4,13365.0,18,13375.0,4,B
2018-04-19 09:53:12,13395.0,4,13456,2,13365.0,18,13375.0,4,B
2018-04-19 09:53:24,13395.0,8,13464,6,13365.0,18,13375.0,4,B
2018-04-19 09:53:33,13395.0,2,13466,2,13365.0,18,13375.0,4,B
2018-04-19 09:53:34,13390.0,2,13468,0,13365.0,18,13375.0,4,S
2018-04-19 09:53:35,13395.0,4,13472,2,13365.0,18,13375.0,4,B
2018-04-19 09:53:35,13395.0,80,13552,-74,13365.0,18,13375.0,4,B
2018-04-19 09:53:36,13390.0,22,13574,-22,13365.0,18,13375.0,4,S
2018-04-19 09:53:37,13390.0,2,13576,2,13365.0,18,13375.0,4,S
2018-04-19 09:54:16,13395.0,2,13578,-2,13365.0,18,13375.0,4,B
2018-04-19 09:54:20,13390.0,4,13582,-4,13365.0,18,13375.0,4,S
2018-04-19 09:55:29,13385.0,2,13584,2,13365.0,18,13375.0,4,S
2018-04-19 09:55:41,13385.0,2,13586,-2,13365.0,18,13375.0,4,S
2018-04-19 09:56:09,13390.0,8,13594,-8,13365.0,18,13375.0,4,B
2018-04-19 09:56:31,13385.0,2,13596,0,13365.0,18,13375.0,4,S
2018-04-19 09:56:34,13390.0,6,13602,0,13365.0,18,13375.0,4,B
2018-04-19 09:56:36,13385.0,4,13606,4,13365.0,18,13375.0,4,S
2018-04-19 09:56:36,13385.0,6,13612,4,13365.0,18,13375.0,4,S
2018-04-19 09:56:37,13385.0,4,13616,2,13365.0,18,13375.0,4,S
2018-04-19 09:56:37,13385.0,4,13620,2,13365.0,18,13375.0,4,S
2018-04-19 09:56:40,13385.0,2,13622,2,13365.0,18,13375.0,4,S
2018-04-19 09:57:37,13385.0,6,13628,-4,13365.0,18,13375.0,4,S
2018-04-19 09:58:11,13385.0,4,13632,-2,13365.0,18,13375.0,4,S
2018-04-19 09:58:28,13385.0,4,13636,0,13365.0,18,13375.0,4,S
2018-04-19 09:58:49,13385.0,2,13638,2,13365.0,18,13375.0,4,S
2018-04-19 09:59:00,13385.0,4,13642,-4,13365.0,18,13375.0,4,S
2018-04-19 09:59:27,13385.0,2,13644,2,13365.0,18,13375.0,4,S
2018-04-19 09:59:28,13385.0,2,13646,0,13365.0,18,13375.0,4,S
2018-04-19 09:59:48,13385.0,2,13648,2,13365.0,18,13375.0,4,S
2018-04-19 10:00:01,13390.0,10,13658,2,13365.0,18,13375.0,4,B
2018-04-19 10:00:02,13390.0,8,13666,4,13365.0,18,13375.0,4,B
2018-04-19 10:00:03,13390.0,4,13670,0,13365.0,18,13375.0,4,B
2018-04-19 10:00:06,13390.0,2,13672,2,13365.0,18,13375.0,4,B
2018-04-19 10:00:16,13390.0,2,13674,2,13365.0,18,13375.0,4,B
2018-04-19 10:00:22,13390.0,2,13676,2,13365.0,18,13375.0,4,B
2018-04-19 10:00:29,13395.0,2,13678,0,13365.0,18,13375.0,4,B
2018-04-19 10:00:31,13395.0,2,13680,2,13365.0,18,13375.0,4,B
2018-04-19 10:00:31,13395.0,2,13682,2,13365.0,18,13375.0,4,B
2018-04-19 10:00:32,13395.0,2,13684,2,13365.0,18,13375.0,4,B
2018-04-19 10:00:35,13395.0,20,13704,4,13365.0,18,13375.0,4,B
2018-04-19 10:00:36,13400.0,4,13708,4,13365.0,18,13375.0,4,B
2018-04-19 10:00:36,13400.0,40,13748,34,13365.0,18,13375.0,4,B
2018-04-19 10:00:46,13395.0,2,13750,0,13365.0,18,13375.0,4,S
2018-04-19 10:00:47,13400.0,2,13752,0,13365.0,18,13375.0,4,B
2018-04-19 10:00:48,13400.0,2,13754,2,13365.0,18,13375.0,4,B
2018-04-19 10:00:49,13400.0,4,13758,2,13365.0,18,13375.0,4,B
2018-04-19 10:00:50,13400.0,2,13760,0,13365.0,18,13375.0,4,B
2018-04-19 10:00:51,13395.0,2,13762,0,13365.0,18,13375.0,4,S
2018-04-19 10:01:07,13400.0,2,13764,0,13365.0,18,13375.0,4,B
2018-04-19 10:01:08,13400.0,2,13766,2,13365.0,18,13375.0,4,B
2018-04-19 10:01:11,13395.0,10,13776,4,13365.0,18,13375.0,4,S
2018-04-19 10:01:12,13400.0,6,13782,4,13365.0,18,13375.0,4,B
2018-04-19 10:01:15,13405.0,2,13784,2,13365.0,18,13375.0,4,B
2018-04-19 10:01:15,13400.0,18,13802,-2,13365.0,18,13375.0,4,S
2018-04-19 10:01:18,13400.0,2,13804,2,13365.0,18,13375.0,4,S
2018-04-19 10:01:18,13400.0,4,13808,4,13365.0,18,13375.0,4,S
2018-04-19 10:01:19,13400.0,2,13810,2,13365.0,18,13375.0,4,S
2018-04-19 10:01:19,13405.0,4,13814,2,13365.0,18,13375.0,4,B
2018-04-19 10:01:20,13410.0,2,13816,0,13365.0,18,13375.0,4,B
2018-04-19 10:01:20,13410.0,12,13828,8,13365.0,18,13375.0,4,B
2018-04-19 10:01:22,13410.0,2,13830,2,13365.0,18,13375.0,4,B
2018-04-19 10:01:36,13410.0,4,13834,0,13365.0,18,13375.0,4,B
2018-04-19 10:01:44,13400.0,2,13836,2,13365.0,18,13375.0,4,S
2018-04-19 10:01:56,13405.0,4,13840,0,13365.0,18,13375.0,4,B
2018-04-19 10:02:18,13405.0,2,13842,0,13365.0,18,13375.0,4,B
2018-04-19 10:02:26,13405.0,2,13844,2,13365.0,18,13375.0,4,B
2018-04-19 10:02:30,13400.0,2,13846,2,13365.0,18,13375.0,4,S
2018-04-19 10:02:33,13405.0,2,13848,0,13365.0,18,13375.0,4,B
2018-04-19 10:02:35,13405.0,4,13852,0,13365.0,18,13375.0,4,B
2018-04-19 10:02:37,13405.0,2,13854,-2,13365.0,18,13375.0,4,B
2018-04-19 10:02:37,13400.0,2,13856,2,13365.0,18,13375.0,4,S
2018-04-19 10:02:42,13400.0,2,13858,0,13365.0,18,13375.0,4,S
2018-04-19 10:02:44,13405.0,2,13860,0,13365.0,18,13375.0,4,B
2018-04-19 10:02:45,13405.0,2,13862,2,13365.0,18,13375.0,4,B
2018-04-19 10:02:45,13410.0,2,13864,2,13365.0,18,13375.0,4,B
2018-04-19 10:02:46,13410.0,14,13878,2,13365.0,18,13375.0,4,B
2018-04-19 10:02:46,13410.0,2,13880,0,13365.0,18,13375.0,4,B
2018-04-19 10:02:47,13410.0,4,13884,0,13365.0,18,13375.0,4,B
2018-04-19 10:02:47,13410.0,4,13888,2,13365.0,18,13375.0,4,B
2018-04-19 10:02:48,13410.0,2,13890,2,13365.0,18,13375.0,4,B
2018-04-19 10:02:50,13415.0,8,13898,-2,13365.0,18,13375.0,4,B
2018-04-19 10:02:51,13420.0,2,13900,0,13365.0,18,13375.0,4,B
2018-04-19 10:03:00,13410.0,4,13904,-4,13365.0,18,13375.0,4,S
2018-04-19 10:03:03,13410.0,2,13906,0,13365.0,18,13375.0,4,S
2018-04-19 10:03:23,13410.0,2,13908,0,13365.0,18,13375.0,4,S
2018-04-19 10:03:35,13410.0,2,13910,0,13365.0,18,13375.0,4,S
2018-04-19 10:03:37,13410.0,2,13912,-2,13365.0,18,13375.0,4,S
2018-04-19 10:03:39,13410.0,2,13914,0,13365.0,18,13375.0,4,S
2018-04-19 10:03:53,13410.0,2,13916,0,13365.0,18,13375.0,4,S
2018-04-19 10:03:56,13415.0,2,13918,0,13365.0,18,13375.0,4,B
2018-04-19 10:03:56,13415.0,4,13922,0,13365.0,18,13375.0,4,B
2018-04-19 10:03:57,13415.0,4,13926,4,13365.0,18,13375.0,4,B
2018-04-19 10:04:01,13410.0,2,13928,0,13365.0,18,13375.0,4,S
2018-04-19 10:04:05,13410.0,2,13930,-2,13365.0,18,13375.0,4,S
2018-04-19 10:04:10,13415.0,4,13934,0,13365.0,18,13375.0,4,B
2018-04-19 10:04:10,13415.0,30,13964,20,13365.0,18,13375.0,4,B
2018-04-19 10:04:11,13420.0,24,13988,14,13365.0,18,13375.0,4,B
2018-04-19 10:04:12,13420.0,8,13996,8,13365.0,18,13375.0,4,B
2018-04-19 10:04:12,13420.0,10,14006,10,13365.0,18,13375.0,4,B
2018-04-19 10:04:13,13425.0,12,14018,2,13365.0,18,13375.0,4,B
2018-04-19 10:04:13,13425.0,4,14022,0,13365.0,18,13375.0,4,B
2018-04-19 10:04:14,13420.0,14,14036,10,13365.0,18,13375.0,4,S
2018-04-19 10:04:15,13420.0,4,14040,4,13365.0,18,13375.0,4,S
2018-04-19 10:04:15,13420.0,2,14042,2,13365.0,18,13375.0,4,S
2018-04-19 10:04:17,13430.0,2,14044,2,13365.0,18,13375.0,4,B
2018-04-19 10:04:19,13420.0,2,14046,2,13365.0,18,13375.0,4,S
2018-04-19 10:04:20,13420.0,2,14048,2,13365.0,18,13375.0,4,S
2018-04-19 10:04:32,13425.0,4,14052,2,13365.0,18,13375.0,4,B
2018-04-19 10:04:34,13420.0,12,14064,0,13365.0,18,13375.0,4,S
2018-04-19 10:04:35,13420.0,2,14066,0,13365.0,18,13375.0,4,S
2018-04-19 10:04:37,13415.0,12,14078,6,13365.0,18,13375.0,4,S
2018-04-19 10:04:48,13415.0,4,14082,0,13365.0,18,13375.0,4,S
2018-04-19 10:04:49,13410.0,2,14084,0,13365.0,18,13375.0,4,S
2018-04-19 10:05:01,13415.0,4,14088,0,13365.0,18,13375.0,4,B
2018-04-19 10:05:01,13415.0,8,14096,6,13365.0,18,13375.0,4,B
2018-04-19 10:05:03,13420.0,4,14100,4,13365.0,18,13375.0,4,B
2018-04-19 10:05:09,13420.0,2,14102,0,13365.0,18,13375.0,4,B
2018-04-19 10:05:26,13415.0,14,14116,-2,13365.0,18,13375.0,4,S
2018-04-19 10:05:26,13415.0,4,14120,0,13365.0,18,13375.0,4,S
2018-04-19 10:05:40,13415.0,2,14122,2,13365.0,18,13375.0,4,S
2018-04-19 10:05:46,13410.0,2,14124,-2,13365.0,18,13375.0,4,S
2018-04-19 10:05:48,13410.0,2,14126,-2,13365.0,18,13375.0,4,S
2018-04-19 10:05:51,13415.0,4,14130,0,13365.0,18,13375.0,4,B
2018-04-19 10:05:58,13420.0,4,14134,2,13365.0,18,13375.0,4,B
2018-04-19 10:06:10,13420.0,6,14140,2,13365.0,18,13375.0,4,B
2018-04-19 10:06:10,13420.0,8,14148,0,13365.0,18,13375.0,4,B
2018-04-19 10:06:11,13420.0,6,14154,0,13365.0,18,13375.0,4,B
2018-04-19 10:06:38,13420.0,4,14158,2,13365.0,18,13375.0,4,B
2018-04-19 10:06:41,13415.0,2,14160,0,13365.0,18,13375.0,4,S
2018-04-19 10:06:49,13420.0,2,14162,0,13365.0,18,13375.0,4,B
2018-04-19 10:06:55,13415.0,2,14164,0,13365.0,18,13375.0,4,S
2018-04-19 10:06:58,13415.0,12,14176,12,13365.0,18,13375.0,4,S
2018-04-19 10:06:58,13415.0,4,14180,4,13365.0,18,13375.0,4,S
2018-04-19 10:06:59,13415.0,2,14182,2,13365.0,18,13375.0,4,S
2018-04-19 10:06:59,13415.0,2,14184,2,13365.0,18,13375.0,4,S
2018-04-19 10:07:00,13420.0,2,14186,0,13365.0,18,13375.0,4,B
2018-04-19 10:07:05,13420.0,4,14190,-4,13365.0,18,13375.0,4,B
2018-04-19 10:07:06,13420.0,16,14206,-8,13365.0,18,13375.0,4,B
2018-04-19 10:07:08,13420.0,8,14214,2,13365.0,18,13375.0,4,B
2018-04-19 10:07:11,13420.0,10,14224,4,13365.0,18,13375.0,4,B
2018-04-19 10:07:16,13415.0,2,14226,0,13365.0,18,13375.0,4,S
2018-04-19 10:07:16,13415.0,2,14228,2,13365.0,18,13375.0,4,S
2018-04-19 10:07:22,13415.0,6,14234,2,13365.0,18,13375.0,4,S
2018-04-19 10:07:30,13410.0,4,14238,2,13365.0,18,13375.0,4,S
2018-04-19 10:07:35,13420.0,4,14242,-4,13365.0,18,13375.0,4,B
2018-04-19 10:07:38,13415.0,4,14246,0,13365.0,18,13375.0,4,S
2018-04-19 10:07:53,13420.0,2,14248,0,13365.0,18,13375.0,4,B
2018-04-19 10:07:55,13415.0,2,14250,-2,13365.0,18,13375.0,4,S
2018-04-19 10:07:58,13420.0,52,14302,-28,13365.0,18,13375.0,4,B
2018-04-19 10:08:01,13410.0,2,14304,2,13365.0,18,13375.0,4,S
2018-04-19 10:08:02,13410.0,32,14336,-2,13365.0,18,13375.0,4,S
2018-04-19 10:08:04,13415.0,4,14340,-4,13365.0,18,13375.0,4,B
2018-04-19 10:08:05,13405.0,4,14344,-2,13365.0,18,13375.0,4,S
2018-04-19 10:08:13,13400.0,2,14346,0,13365.0,18,13375.0,4,S
2018-04-19 10:08:18,13405.0,2,14348,2,13365.0,18,13375.0,4,B
2018-04-19 10:08:20,13400.0,6,14354,2,13365.0,18,13375.0,4,S
2018-04-19 10:08:21,13395.0,6,14360,-4,13365.0,18,13375.0,4,S
2018-04-19 10:08:21,13395.0,2,14362,-2,13365.0,18,13375.0,4,S
2018-04-19 10:08:23,13400.0,4,14366,0,13365.0,18,13375.0,4,B
2018-04-19 10:08:38,13395.0,12,14378,6,13365.0,18,13375.0,4,S
2018-04-19 10:08:38,13395.0,16,14394,10,13365.0,18,13375.0,4,S
2018-04-19 10:08:39,13395.0,2,14396,2,13365.0,18,13375.0,4,S
2018-04-19 10:08:39,13395.0,2,14398,2,13365.0,18,13375.0,4,S
2018-04-19 10:08:40,13395.0,2,14400,2,13365.0,18,13375.0,4,S
2018-04-19 10:08:40,13395.0,2,14402,2,13365.0,18,13375.0,4,S
2018-04-19 10:08:41,13395.0,2,14404,2,13365.0,18,13375.0,4,S
2018-04-19 10:08:41,13395.0,2,14406,2,13365.0,18,13375.0,4,S
2018-04-19 10:08:42,13395.0,2,14408,2,13365.0,18,13375.0,4,S
2018-04-19 10:08:42,13395.0,2,14410,2,13365.0,18,13375.0,4,S
2018-04-19 10:08:43,13395.0,2,14412,2,13365.0,18,13375.0,4,S
2018-04-19 10:08:43,13395.0,2,14414,2,13365.0,18,13375.0,4,S
2018-04-19 10:08:44,13395.0,2,14416,2,13365.0,18,13375.0,4,S
2018-04-19 10:08:44,13395.0,2,14418,2,13365.0,18,13375.0,4,S
2018-04-19 10:08:45,13395.0,2,14420,2,13365.0,18,13375.0,4,S
2018-04-19 10:08:45,13395.0,2,14422,2,13365.0,18,13375.0,4,S
2018-04-19 10:08:46,13395.0,2,14424,2,13365.0,18,13375.0,4,S
2018-04-19 10:08:46,13395.0,2,14426,2,13365.0,18,13375.0,4,S
2018-04-19 10:08:47,13395.0,4,14430,2,13365.0,18,13375.0,4,S
2018-04-19 10:08:47,13395.0,2,14432,2,13365.0,18,13375.0,4,S
2018-04-19 10:08:48,13395.0,2,14434,2,13365.0,18,13375.0,4,S
2018-04-19 10:08:48,13395.0,2,14436,2,13365.0,18,13375.0,4,S
2018-04-19 10:08:49,13395.0,2,14438,2,13365.0,18,13375.0,4,S
2018-04-19 10:08:49,13395.0,2,14440,2,13365.0,18,13375.0,4,S
2018-04-19 10:08:50,13395.0,8,14448,8,13365.0,18,13375.0,4,S
2018-04-19 10:08:50,13395.0,2,14450,2,13365.0,18,13375.0,4,S
2018-04-19 10:08:53,13390.0,2,14452,-2,13365.0,18,13375.0,4,S
2018-04-19 10:08:59,13395.0,8,14460,8,13365.0,18,13375.0,4,B
2018-04-19 10:09:02,13395.0,8,14468,4,13365.0,18,13375.0,4,B
2018-04-19 10:09:17,13390.0,2,14470,0,13365.0,18,13375.0,4,S
2018-04-19 10:09:22,13390.0,2,14472,0,13365.0,18,13375.0,4,S
2018-04-19 10:09:23,13390.0,4,14476,-4,13365.0,18,13375.0,4,S
2018-04-19 10:09:23,13390.0,28,14504,22,13365.0,18,13375.0,4,S
2018-04-19 10:09:54,13395.0,2,14506,2,13365.0,18,13375.0,4,B
2018-04-19 10:09:57,13395.0,10,14516,10,13365.0,18,13375.0,4,B
2018-04-19 10:10:00,13395.0,2,14518,2,13365.0,18,13375.0,4,B
2018-04-19 10:10:02,13395.0,8,14526,8,13365.0,18,13375.0,4,B
2018-04-19 10:10:02,13395.0,4,14530,4,13365.0,18,13375.0,4,B
2018-04-19 10:10:04,13395.0,20,14550,20,13365.0,18,13375.0,4,B
2018-04-19 10:10:04,13400.0,58,14608,32,13365.0,18,13375.0,4,B
2018-04-19 10:10:14,13400.0,2,14610,0,13365.0,18,13375.0,4,B
2018-04-19 10:10:15,13405.0,2,14612,0,13365.0,18,13375.0,4,B
2018-04-19 10:10:26,13405.0,6,14618,-4,13365.0,18,13375.0,4,B
2018-04-19 10:10:30,13405.0,10,14628,0,13365.0,18,13375.0,4,B
2018-04-19 10:10:30,13405.0,8,14636,-8,13365.0,18,13375.0,4,B
2018-04-19 10:10:31,13405.0,42,14678,-26,13365.0,18,13375.0,4,B
2018-04-19 10:10:31,13405.0,44,14722,-26,13365.0,18,13375.0,4,B
2018-04-19 10:10:32,13400.0,2,14724,0,13365.0,18,13375.0,4,S
2018-04-19 10:10:41,13400.0,2,14726,0,13365.0,18,13375.0,4,S
2018-04-19 10:10:57,13400.0,2,14728,2,13365.0,18,13375.0,4,S
2018-04-19 10:10:58,13400.0,14,14742,0,13365.0,18,13375.0,4,S
2018-04-19 10:10:58,13400.0,2,14744,0,13365.0,18,13375.0,4,S
2018-04-19 10:11:05,13400.0,2,14746,2,13365.0,18,13375.0,4,S
2018-04-19 10:11:14,13400.0,2,14748,2,13365.0,18,13375.0,4,S
2018-04-19 10:11:46,13400.0,4,14752,0,13365.0,18,13375.0,4,S
2018-04-19 10:11:54,13405.0,2,14754,0,13365.0,18,13375.0,4,B
2018-04-19 10:12:13,13405.0,2,14756,0,13365.0,18,13375.0,4,B
2018-04-19 10:12:26,13400.0,4,14760,-2,13365.0,18,13375.0,4,S
2018-04-19 10:12:33,13405.0,2,14762,-2,13365.0,18,13375.0,4,B
2018-04-19 10:12:44,13400.0,2,14764,0,13365.0,18,13375.0,4,S
2018-04-19 10:12:45,13395.0,2,14766,2,13365.0,18,13375.0,4,S
2018-04-19 10:12:46,13405.0,2,14768,-2,13365.0,18,13375.0,4,B
2018-04-19 10:13:37,13400.0,18,14786,2,13365.0,18,13375.0,4,S
2018-04-19 10:13:37,13400.0,12,14798,12,13365.0,18,13375.0,4,S
2018-04-19 10:14:08,13400.0,2,14800,0,13365.0,18,13375.0,4,S
2018-04-19 10:14:08,13400.0,2,14802,0,13365.0,18,13375.0,4,S
2018-04-19 10:14:29,13400.0,2,14804,-2,13365.0,18,13375.0,4,S
2018-04-19 10:30:00,13395.0,4,14808,0,13365.0,18,13375.0,4,S
2018-04-19 10:30:01,13395.0,2,14810,-2,13365.0,18,13375.0,4,S
2018-04-19 10:30:02,13395.0,2,14812,-2,13365.0,18,13375.0,4,S
2018-04-19 10:30:06,13400.0,2,14814,0,13365.0,18,13375.0,4,B
2018-04-19 10:30:19,13400.0,2,14816,2,13365.0,18,13375.0,4,B
2018-04-19 10:30:34,13395.0,2,14818,-2,13365.0,18,13375.0,4,S
2018-04-19 10:30:48,13400.0,2,14820,2,13365.0,18,13375.0,4,B
2018-04-19 10:30:49,13400.0,2,14822,2,13365.0,18,13375.0,4,B
2018-04-19 10:31:01,13405.0,2,14824,2,13365.0,18,13375.0,4,B
2018-04-19 10:31:01,13405.0,2,14826,2,13365.0,18,13375.0,4,B
2018-04-19 10:31:02,13405.0,4,14830,0,13365.0,18,13375.0,4,B
2018-04-19 10:31:02,13405.0,4,14834,4,13365.0,18,13375.0,4,B
2018-04-19 10:31:03,13405.0,2,14836,0,13365.0,18,13375.0,4,B
2018-04-19 10:31:03,13405.0,2,14838,2,13365.0,18,13375.0,4,B
2018-04-19 10:31:04,13405.0,4,14842,4,13365.0,18,13375.0,4,B
2018-04-19 10:31:05,13405.0,2,14844,0,13365.0,18,13375.0,4,B
2018-04-19 10:31:10,13410.0,6,14850,4,13365.0,18,13375.0,4,B
2018-04-19 10:31:10,13410.0,4,14854,0,13365.0,18,13375.0,4,B
2018-04-19 10:31:15,13410.0,2,14856,0,13365.0,18,13375.0,4,B
2018-04-19 10:31:23,13415.0,20,14876,20,13365.0,18,13375.0,4,B
2018-04-19 10:31:24,13415.0,2,14878,2,13365.0,18,13375.0,4,B
2018-04-19 10:31:24,13415.0,2,14880,2,13365.0,18,13375.0,4,B
2018-04-19 10:31:29,13415.0,2,14882,2,13365.0,18,13375.0,4,B
2018-04-19 10:31:31,13415.0,2,14884,2,13365.0,18,13375.0,4,B
2018-04-19 10:31:32,13420.0,2,14886,0,13365.0,18,13375.0,4,B
2018-04-19 10:31:33,13415.0,2,14888,2,13365.0,18,13375.0,4,S
2018-04-19 10:31:33,13415.0,2,14890,2,13365.0,18,13375.0,4,S
2018-04-19 10:31:34,13415.0,2,14892,2,13365.0,18,13375.0,4,S
2018-04-19 10:31:35,13420.0,2,14894,0,13365.0,18,13375.0,4,B
2018-04-19 10:31:36,13415.0,2,14896,2,13365.0,18,13375.0,4,S
2018-04-19 10:31:38,13420.0,2,14898,0,13365.0,18,13375.0,4,B
2018-04-19 10:31:43,13420.0,2,14900,-2,13365.0,18,13375.0,4,B
2018-04-19 10:31:45,13420.0,2,14902,-2,13365.0,18,13375.0,4,B
2018-04-19 10:31:49,13415.0,8,14910,0,13365.0,18,13375.0,4,S
2018-04-19 10:31:52,13415.0,2,14912,2,13365.0,18,13375.0,4,S
2018-04-19 10:32:02,13420.0,4,14916,0,13365.0,18,13375.0,4,B
2018-04-19 10:32:03,13425.0,12,14928,10,13365.0,18,13375.0,4,B
2018-04-19 10:32:03,13430.0,8,14936,0,13365.0,18,13375.0,4,B
2018-04-19 10:32:04,13430.0,28,14964,16,13365.0,18,13375.0,4,B
2018-04-19 10:32:04,13435.0,30,14994,16,13365.0,18,13375.0,4,B
2018-04-19 10:32:05,13440.0,28,15022,26,13365.0,18,13375.0,4,B
2018-04-19 10:32:06,13430.0,4,15026,2,13365.0,18,13375.0,4,S
2018-04-19 10:32:06,13430.0,4,15030,4,13365.0,18,13375.0,4,S
2018-04-19 10:32:07,13430.0,2,15032,0,13365.0,18,13375.0,4,S
2018-04-19 10:32:08,13435.0,2,15034,2,13365.0,18,13375.0,4,B
2018-04-19 10:32:09,13435.0,2,15036,2,13365.0,18,13375.0,4,B
2018-04-19 10:32:09,13430.0,8,15044,2,13365.0,18,13375.0,4,S
2018-04-19 10:32:10,13435.0,2,15046,2,13365.0,18,13375.0,4,B
2018-04-19 10:32:11,13430.0,2,15048,2,13365.0,18,13375.0,4,S
2018-04-19 10:32:12,13430.0,2,15050,0,13365.0,18,13375.0,4,S
2018-04-19 10:32:13,13430.0,2,15052,2,13365.0,18,13375.0,4,S
2018-04-19 10:32:14,13435.0,2,15054,-2,13365.0,18,13375.0,4,B
2018-04-19 10:32:15,13440.0,4,15058,-2,13365.0,18,13375.0,4,B
2018-04-19 10:32:18,13435.0,12,15070,0,13365.0,18,13375.0,4,S
2018-04-19 10:32:21,13435.0,4,15074,0,13365.0,18,13375.0,4,S
2018-04-19 10:32:29,13430.0,4,15078,2,13365.0,18,13375.0,4,S
2018-04-19 10:32:29,13430.0,10,15088,0,13365.0,18,13375.0,4,S
2018-04-19 10:32:40,13430.0,4,15092,2,13365.0,18,13375.0,4,S
2018-04-19 10:32:47,13425.0,4,15096,4,13365.0,18,13375.0,4,S
2018-04-19 10:32:48,13430.0,2,15098,0,13365.0,18,13375.0,4,B
2018-04-19 10:32:50,13430.0,2,15100,2,13365.0,18,13375.0,4,B
2018-04-19 10:32:59,13430.0,2,15102,0,13365.0,18,13375.0,4,B
2018-04-19 10:33:01,13435.0,4,15106,0,13365.0,18,13375.0,4,B
2018-04-19 10:33:01,13435.0,22,15128,20,13365.0,18,13375.0,4,B
2018-04-19 10:33:04,13435.0,8,15136,2,13365.0,18,13375.0,4,B
2018-04-19 10:33:05,13440.0,10,15146,0,13365.0,18,13375.0,4,B
2018-04-19 10:33:13,13435.0,8,15154,8,13365.0,18,13375.0,4,S
2018-04-19 10:33:13,13435.0,2,15156,0,13365.0,18,13375.0,4,S
2018-04-19 10:33:14,13430.0,12,15168,0,13365.0,18,13375.0,4,S
2018-04-19 10:33:14,13430.0,6,15174,0,13365.0,18,13375.0,4,S
2018-04-19 10:33:16,13430.0,4,15178,0,13365.0,18,13375.0,4,S
2018-04-19 10:33:22,13425.0,2,15180,0,13365.0,18,13375.0,4,S
2018-04-19 10:33:23,13425.0,2,15182,-2,13365.0,18,13375.0,4,S
2018-04-19 10:33:26,13420.0,2,15184,-2,13365.0,18,13375.0,4,S
2018-04-19 10:33:26,13420.0,2,15186,0,13365.0,18,13375.0,4,S
2018-04-19 10:33:27,13425.0,6,15192,-2,13365.0,18,13375.0,4,B
2018-04-19 10:33:27,13420.0,2,15194,0,13365.0,18,13375.0,4,S
2018-04-19 10:33:31,13420.0,2,15196,-2,13365.0,18,13375.0,4,S
2018-04-19 10:33:36,13415.0,2,15198,0,13365.0,18,13375.0,4,S
2018-04-19 10:33:36,13415.0,2,15200,0,13365.0,18,13375.0,4,S
2018-04-19 10:33:37,13415.0,2,15202,0,13365.0,18,13375.0,4,S
2018-04-19 10:33:38,13420.0,2,15204,0,13365.0,18,13375.0,4,B
2018-04-19 10:33:39,13420.0,2,15206,-2,13365.0,18,13375.0,4,B
2018-04-19 10:33:39,13420.0,2,15208,-2,13365.0,18,13375.0,4,B
2018-04-19 10:33:41,13425.0,4,15212,0,13365.0,18,13375.0,4,B
2018-04-19 10:33:42,13425.0,2,15214,0,13365.0,18,13375.0,4,B
2018-04-19 10:33:50,13420.0,2,15216,-2,13365.0,18,13375.0,4,S
2018-04-19 10:33:58,13425.0,2,15218,-2,13365.0,18,13375.0,4,B
2018-04-19 10:34:04,13425.0,4,15222,0,13365.0,18,13375.0,4,B
2018-04-19 10:34:07,13430.0,4,15226,-4,13365.0,18,13375.0,4,B
2018-04-19 10:34:09,13425.0,2,15228,0,13365.0,18,13375.0,4,S
2018-04-19 10:34:14,13430.0,2,15230,2,13365.0,18,13375.0,4,B
2018-04-19 10:34:19,13430.0,2,15232,0,13365.0,18,13375.0,4,B
2018-04-19 10:34:19,13430.0,2,15234,2,13365.0,18,13375.0,4,B
2018-04-19 10:34:26,13435.0,2,15236,0,13365.0,18,13375.0,4,B
2018-04-19 10:34:36,13430.0,2,15238,0,13365.0,18,13375.0,4,S
2018-04-19 10:34:37,13430.0,2,15240,0,13365.0,18,13375.0,4,S
2018-04-19 10:34:46,13420.0,10,15250,8,13365.0,18,13375.0,4,S
2018-04-19 10:35:04,13415.0,2,15252,2,13365.0,18,13375.0,4,S
2018-04-19 10:35:06,13425.0,2,15254,2,13365.0,18,13375.0,4,B
2018-04-19 10:35:06,13425.0,4,15258,2,13365.0,18,13375.0,4,B
2018-04-19 10:35:08,13425.0,2,15260,0,13365.0,18,13375.0,4,B
2018-04-19 10:35:17,13425.0,2,15262,0,13365.0,18,13375.0,4,B
2018-04-19 10:35:31,13420.0,14,15276,14,13365.0,18,13375.0,4,S
2018-04-19 10:35:32,13420.0,6,15282,6,13365.0,18,13375.0,4,S
2018-04-19 10:35:33,13420.0,2,15284,0,13365.0,18,13375.0,4,S
2018-04-19 10:35:33,13425.0,4,15288,2,13365.0,18,13375.0,4,B
2018-04-19 10:35:38,13425.0,8,15296,4,13365.0,18,13375.0,4,B
2018-04-19 10:35:38,13425.0,2,15298,2,13365.0,18,13375.0,4,B
2018-04-19 10:35:44,13425.0,10,15308,2,13365.0,18,13375.0,4,B
2018-04-19 10:35:45,13420.0,2,15310,-2,13365.0,18,13375.0,4,S
2018-04-19 10:36:02,13420.0,2,15312,2,13365.0,18,13375.0,4,S
2018-04-19 10:36:09,13415.0,14,15326,0,13365.0,18,13375.0,4,S
2018-04-19 10:36:09,13410.0,10,15336,4,13365.0,18,13375.0,4,S
2018-04-19 10:36:13,13405.0,2,15338,-2,13365.0,18,13375.0,4,S
2018-04-19 10:36:19,13405.0,6,15344,-2,13365.0,18,13375.0,4,S
2018-04-19 10:36:20,13405.0,2,15346,2,13365.0,18,13375.0,4,S
2018-04-19 10:36:21,13405.0,2,15348,0,13365.0,18,13375.0,4,S
2018-04-19 10:36:24,13400.0,12,15360,-10,13365.0,18,13375.0,4,S
2018-04-19 10:36:34,13405.0,2,15362,2,13365.0,18,13375.0,4,B
2018-04-19 10:36:34,13400.0,4,15366,-4,13365.0,18,13375.0,4,S
2018-04-19 10:36:38,13400.0,2,15368,0,13365.0,18,13375.0,4,S
2018-04-19 10:36:54,13400.0,12,15380,6,13365.0,18,13375.0,4,S
2018-04-19 10:36:54,13395.0,2,15382,-2,13365.0,18,13375.0,4,S
2018-04-19 10:36:55,13395.0,6,15388,-4,13365.0,18,13375.0,4,S
2018-04-19 10:36:55,13390.0,12,15400,8,13365.0,18,13375.0,4,S
2018-04-19 10:36:58,13385.0,28,15428,-18,13365.0,18,13375.0,4,S
2018-04-19 10:36:58,13385.0,2,15430,-2,13365.0,18,13375.0,4,S
2018-04-19 10:36:59,13385.0,18,15448,-10,13365.0,18,13375.0,4,S
2018-04-19 10:36:59,13385.0,22,15470,20,13365.0,18,13375.0,4,S
2018-04-19 10:37:01,13385.0,4,15474,4,13365.0,18,13375.0,4,S
2018-04-19 10:37:02,13390.0,2,15476,2,13365.0,18,13375.0,4,B
2018-04-19 10:37:06,13385.0,2,15478,-2,13365.0,18,13375.0,4,S
2018-04-19 10:37:06,13385.0,26,15504,0,13365.0,18,13375.0,4,S
2018-04-19 10:37:07,13385.0,12,15516,-6,13365.0,18,13375.0,4,S
2018-04-19 10:37:08,13390.0,2,15518,0,13365.0,18,13375.0,4,B
2018-04-19 10:37:10,13395.0,2,15520,0,13365.0,18,13375.0,4,B
2018-04-19 10:37:23,13395.0,2,15522,-2,13365.0,18,13375.0,4,B
2018-04-19 10:37:25,13390.0,4,15526,0,13365.0,18,13375.0,4,S
2018-04-19 10:37:26,13395.0,2,15528,0,13365.0,18,13375.0,4,B
2018-04-19 10:37:26,13395.0,2,15530,2,13365.0,18,13375.0,4,B
2018-04-19 10:37:27,13395.0,2,15532,2,13365.0,18,13375.0,4,B
2018-04-19 10:37:28,13395.0,2,15534,0,13365.0,18,13375.0,4,B
2018-04-19 10:37:29,13395.0,2,15536,0,13365.0,18,13375.0,4,B
2018-04-19 10:37:29,13395.0,2,15538,0,13365.0,18,13375.0,4,B
2018-04-19 10:37:30,13395.0,2,15540,0,13365.0,18,13375.0,4,B
2018-04-19 10:37:31,13395.0,2,15542,0,13365.0,18,13375.0,4,B
2018-04-19 10:37:32,13395.0,2,15544,0,13365.0,18,13375.0,4,B
2018-04-19 10:37:37,13385.0,2,15546,0,13365.0,18,13375.0,4,S
2018-04-19 10:37:39,13390.0,2,15548,2,13365.0,18,13375.0,4,B
2018-04-19 10:37:44,13390.0,2,15550,-2,13365.0,18,13375.0,4,B
2018-04-19 10:37:45,13395.0,2,15552,0,13365.0,18,13375.0,4,B
2018-04-19 10:37:46,13395.0,2,15554,0,13365.0,18,13375.0,4,B
2018-04-19 10:37:47,13395.0,2,15556,0,13365.0,18,13375.0,4,B
2018-04-19 10:37:48,13395.0,2,15558,0,13365.0,18,13375.0,4,B
2018-04-19 10:37:49,13395.0,2,15560,0,13365.0,18,13375.0,4,B
2018-04-19 10:37:51,13395.0,2,15562,0,13365.0,18,13375.0,4,B
2018-04-19 10:37:52,13395.0,4,15566,0,13365.0,18,13375.0,4,B
2018-04-19 10:37:52,13395.0,2,15568,0,13365.0,18,13375.0,4,B
2018-04-19 10:37:58,13395.0,2,15570,2,13365.0,18,13375.0,4,B
2018-04-19 10:37:59,13400.0,2,15572,2,13365.0,18,13375.0,4,B
2018-04-19 10:38:00,13400.0,2,15574,0,13365.0,18,13375.0,4,B
2018-04-19 10:38:06,13395.0,2,15576,0,13365.0,18,13375.0,4,S
2018-04-19 10:38:07,13395.0,2,15578,0,13365.0,18,13375.0,4,S
2018-04-19 10:38:07,13395.0,2,15580,0,13365.0,18,13375.0,4,S
2018-04-19 10:38:08,13395.0,2,15582,0,13365.0,18,13375.0,4,S
2018-04-19 10:38:09,13395.0,2,15584,0,13365.0,18,13375.0,4,S
2018-04-19 10:38:09,13395.0,2,15586,0,13365.0,18,13375.0,4,S
2018-04-19 10:38:10,13390.0,2,15588,0,13365.0,18,13375.0,4,S
2018-04-19 10:38:11,13390.0,2,15590,2,13365.0,18,13375.0,4,S
2018-04-19 10:38:12,13395.0,2,15592,0,13365.0,18,13375.0,4,B
2018-04-19 10:38:13,13395.0,2,15594,0,13365.0,18,13375.0,4,B
2018-04-19 10:38:14,13395.0,2,15596,2,13365.0,18,13375.0,4,B
2018-04-19 10:38:22,13385.0,2,15598,0,13365.0,18,13375.0,4,S
2018-04-19 10:38:23,13390.0,2,15600,2,13365.0,18,13375.0,4,B
2018-04-19 10:38:24,13390.0,2,15602,0,13365.0,18,13375.0,4,B
2018-04-19 10:38:26,13390.0,2,15604,0,13365.0,18,13375.0,4,B
2018-04-19 10:38:28,13390.0,2,15606,0,13365.0,18,13375.0,4,B
2018-04-19 10:38:29,13390.0,6,15612,0,13365.0,18,13375.0,4,B
2018-04-19 10:38:30,13390.0,2,15614,0,13365.0,18,13375.0,4,B
2018-04-19 10:38:31,13390.0,4,15618,-2,13365.0,18,13375.0,4,B
2018-04-19 10:38:35,13385.0,2,15620,0,13365.0,18,13375.0,4,S
2018-04-19 10:38:37,13390.0,2,15622,2,13365.0,18,13375.0,4,B
2018-04-19 10:38:37,13390.0,2,15624,0,13365.0,18,13375.0,4,B
2018-04-19 10:38:51,13385.0,2,15626,0,13365.0,18,13375.0,4,S
2018-04-19 10:39:03,13385.0,10,15636,10,13365.0,18,13375.0,4,S
2018-04-19 10:39:03,13385.0,18,15654,0,13365.0,18,13375.0,4,S
2018-04-19 10:39:04,13385.0,2,15656,0,13365.0,18,13375.0,4,S
2018-04-19 10:39:11,13380.0,2,15658,-2,13365.0,18,13375.0,4,S
2018-04-19 10:39:11,13380.0,16,15674,-4,13365.0,18,13375.0,4,S
2018-04-19 10:39:13,13380.0,2,15676,0,13365.0,18,13375.0,4,S
2018-04-19 10:39:13,13380.0,4,15680,0,13365.0,18,13375.0,4,S
2018-04-19 10:39:15,13385.0,8,15688,0,13365.0,18,13375.0,4,B
2018-04-19 10:39:17,13380.0,4,15692,-4,13365.0,18,13375.0,4,S
2018-04-19 10:39:18,13380.0,12,15704,-10,13365.0,18,13375.0,4,S
2018-04-19 10:39:19,13380.0,2,15706,-2,13365.0,18,13375.0,4,S
2018-04-19 10:39:20,13385.0,2,15708,0,13365.0,18,13375.0,4,B
2018-04-19 10:39:20,13385.0,2,15710,2,13365.0,18,13375.0,4,B
2018-04-19 10:39:21,13380.0,4,15714,0,13365.0,18,13375.0,4,S
2018-04-19 10:39:23,13380.0,16,15730,-10,13365.0,18,13375.0,4,S
2018-04-19 10:39:32,13385.0,8,15738,-2,13365.0,18,13375.0,4,B
2018-04-19 10:39:36,13380.0,4,15742,2,13365.0,18,13375.0,4,S
2018-04-19 10:39:39,13385.0,2,15744,-2,13365.0,18,13375.0,4,B
2018-04-19 10:39:41,13385.0,2,15746,0,13365.0,18,13375.0,4,B
2018-04-19 10:39:43,13380.0,2,15748,-2,13365.0,18,13375.0,4,S
2018-04-19 10:39:48,13385.0,2,15750,0,13365.0,18,13375.0,4,B
2018-04-19 10:39:56,13385.0,2,15752,0,13365.0,18,13375.0,4,B
2018-04-19 10:39:58,13380.0,4,15756,-4,13365.0,18,13375.0,4,S
2018-04-19 10:40:01,13385.0,2,15758,2,13365.0,18,13375.0,4,B
2018-04-19 10:40:07,13390.0,2,15760,0,13365.0,18,13375.0,4,B
2018-04-19 10:40:07,13385.0,2,15762,0,13365.0,18,13375.0,4,S
2018-04-19 10:40:09,13385.0,2,15764,2,13365.0,18,13375.0,4,S
2018-04-19 10:40:13,13385.0,2,15766,2,13365.0,18,13375.0,4,S
2018-04-19 10:40:17,13385.0,2,15768,0,13365.0,18,13375.0,4,S
2018-04-19 10:40:23,13390.0,2,15770,0,13365.0,18,13375.0,4,B
2018-04-19 10:40:24,13390.0,2,15772,0,13365.0,18,13375.0,4,B
2018-04-19 10:40:25,13390.0,2,15774,0,13365.0,18,13375.0,4,B
2018-04-19 10:40:26,13390.0,2,15776,0,13365.0,18,13375.0,4,B
2018-04-19 10:40:26,13390.0,2,15778,2,13365.0,18,13375.0,4,B
2018-04-19 10:40:27,13390.0,2,15780,0,13365.0,18,13375.0,4,B
2018-04-19 10:40:31,13385.0,2,15782,0,13365.0,18,13375.0,4,S
2018-04-19 10:41:04,13385.0,4,15786,0,13365.0,18,13375.0,4,S
2018-04-19 10:41:09,13385.0,6,15792,-6,13365.0,18,13375.0,4,S
2018-04-19 10:41:13,13385.0,4,15796,-4,13365.0,18,13375.0,4,S
2018-04-19 10:41:15,13385.0,4,15800,0,13365.0,18,13375.0,4,S
2018-04-19 10:41:36,13380.0,8,15808,0,13365.0,18,13375.0,4,S
2018-04-19 10:41:36,13380.0,22,15830,-2,13365.0,18,13375.0,4,S
2018-04-19 10:41:46,13380.0,2,15832,-2,13365.0,18,13375.0,4,S
2018-04-19 10:41:48,13375.0,2,15834,-2,13365.0,18,13375.0,4,S
2018-04-19 10:41:51,13375.0,2,15836,0,13365.0,18,13375.0,4,S
2018-04-19 10:41:54,13380.0,2,15838,0,13365.0,18,13375.0,4,B
2018-04-19 10:42:01,13385.0,4,15842,0,13365.0,18,13375.0,4,B
2018-04-19 10:42:01,13375.0,12,15854,0,13365.0,18,13375.0,4,S
2018-04-19 10:42:05,13385.0,2,15856,0,13365.0,18,13375.0,4,B
2018-04-19 10:42:26,13390.0,4,15860,2,13365.0,18,13375.0,4,B
2018-04-19 10:42:32,13395.0,2,15862,2,13365.0,18,13375.0,4,B
2018-04-19 10:42:39,13395.0,2,15864,0,13365.0,18,13375.0,4,B
2018-04-19 10:42:43,13400.0,2,15866,-2,13365.0,18,13375.0,4,B
2018-04-19 10:42:47,13400.0,2,15868,2,13365.0,18,13375.0,4,B
2018-04-19 10:42:51,13395.0,10,15878,-10,13365.0,18,13375.0,4,S
2018-04-19 10:42:52,13395.0,2,15880,0,13365.0,18,13375.0,4,S
2018-04-19 10:42:52,13390.0,4,15884,4,13365.0,18,13375.0,4,S
2018-04-19 10:42:56,13390.0,12,15896,8,13365.0,18,13375.0,4,S
2018-04-19 10:42:56,13390.0,4,15900,4,13365.0,18,13375.0,4,S
2018-04-19 10:43:09,13385.0,2,15902,2,13365.0,18,13375.0,4,S
2018-04-19 10:43:47,13390.0,2,15904,0,13365.0,18,13375.0,4,B
2018-04-19 10:43:57,13390.0,2,15906,2,13365.0,18,13375.0,4,B
2018-04-19 10:44:28,13385.0,2,15908,2,13365.0,18,13375.0,4,S
2018-04-19 10:44:29,13390.0,2,15910,0,13365.0,18,13375.0,4,B
2018-04-19 10:44:35,13390.0,6,15916,4,13365.0,18,13375.0,4,B
2018-04-19 10:45:14,13385.0,4,15920,-4,13365.0,18,13375.0,4,S
2018-04-19 10:45:23,13385.0,2,15922,-2,13365.0,18,13375.0,4,S
2018-04-19 10:45:23,13390.0,2,15924,0,13365.0,18,13375.0,4,B
2018-04-19 10:45:30,13385.0,2,15926,0,13365.0,18,13375.0,4,S
2018-04-19 10:45:31,13390.0,2,15928,0,13365.0,18,13375.0,4,B
2018-04-19 10:47:18,13380.0,20,15948,6,13365.0,18,13375.0,4,S
2018-04-19 10:47:38,13385.0,2,15950,0,13365.0,18,13375.0,4,B
2018-04-19 10:47:39,13385.0,2,15952,0,13365.0,18,13375.0,4,B
2018-04-19 10:47:57,13385.0,2,15954,0,13365.0,18,13375.0,4,B
2018-04-19 10:48:35,13385.0,2,15956,0,13365.0,18,13375.0,4,B
2018-04-19 10:49:02,13385.0,4,15960,0,13365.0,18,13375.0,4,B
2018-04-19 10:49:05,13385.0,2,15962,-2,13365.0,18,13375.0,4,B
2018-04-19 10:49:08,13385.0,2,15964,0,13365.0,18,13375.0,4,B
2018-04-19 10:49:08,13385.0,2,15966,2,13365.0,18,13375.0,4,B
2018-04-19 10:49:22,13385.0,2,15968,0,13365.0,18,13375.0,4,B
2018-04-19 10:49:22,13385.0,4,15972,2,13365.0,18,13375.0,4,B
2018-04-19 10:49:31,13380.0,4,15976,-4,13365.0,18,13375.0,4,S
2018-04-19 10:49:32,13390.0,2,15978,0,13365.0,18,13375.0,4,B
2018-04-19 10:49:38,13385.0,4,15982,2,13365.0,18,13375.0,4,S
2018-04-19 10:49:44,13390.0,2,15984,0,13365.0,18,13375.0,4,B
2018-04-19 10:49:57,13385.0,2,15986,-2,13365.0,18,13375.0,4,S
2018-04-19 10:51:10,13385.0,2,15988,-2,13365.0,18,13375.0,4,S
2018-04-19 10:51:59,13395.0,2,15990,-2,13365.0,18,13375.0,4,B
2018-04-19 10:52:06,13390.0,2,15992,0,13365.0,18,13375.0,4,S
2018-04-19 10:52:07,13385.0,2,15994,2,13365.0,18,13375.0,4,S
2018-04-19 10:53:12,13385.0,4,15998,4,13365.0,18,13375.0,4,S
2018-04-19 10:53:12,13385.0,4,16002,0,13365.0,18,13375.0,4,S
2018-04-19 10:53:48,13380.0,2,16004,2,13365.0,18,13375.0,4,S
2018-04-19 10:53:49,13380.0,2,16006,-2,13365.0,18,13375.0,4,S
2018-04-19 10:53:57,13380.0,10,16016,6,13365.0,18,13375.0,4,S
2018-04-19 10:54:50,13380.0,2,16018,2,13365.0,18,13375.0,4,S
2018-04-19 10:55:07,13380.0,6,16024,6,13365.0,18,13375.0,4,S
2018-04-19 10:55:09,13380.0,26,16050,14,13365.0,18,13375.0,4,S
2018-04-19 10:55:35,13380.0,2,16052,2,13365.0,18,13375.0,4,S
2018-04-19 10:55:36,13385.0,12,16064,12,13365.0,18,13375.0,4,B
2018-04-19 10:55:37,13385.0,4,16068,4,13365.0,18,13375.0,4,B
2018-04-19 10:55:37,13385.0,2,16070,2,13365.0,18,13375.0,4,B
2018-04-19 10:55:50,13385.0,6,16076,6,13365.0,18,13375.0,4,B
2018-04-19 10:55:52,13385.0,2,16078,2,13365.0,18,13375.0,4,B
2018-04-19 10:55:55,13385.0,2,16080,2,13365.0,18,13375.0,4,B
2018-04-19 10:55:58,13380.0,36,16116,36,13365.0,18,13375.0,4,S
2018-04-19 10:55:58,13380.0,4,16120,0,13365.0,18,13375.0,4,S
2018-04-19 10:56:00,13385.0,4,16124,0,13365.0,18,13375.0,4,B
2018-04-19 10:56:04,13385.0,20,16144,0,13365.0,18,13375.0,4,B
2018-04-19 10:56:06,13385.0,4,16148,4,13365.0,18,13375.0,4,B
2018-04-19 10:56:11,13385.0,2,16150,2,13365.0,18,13375.0,4,B
2018-04-19 10:56:15,13385.0,10,16160,10,13365.0,18,13375.0,4,B
2018-04-19 10:56:16,13385.0,12,16172,0,13365.0,18,13375.0,4,B
2018-04-19 10:56:17,13390.0,2,16174,2,13365.0,18,13375.0,4,B
2018-04-19 10:56:17,13390.0,2,16176,0,13365.0,18,13375.0,4,B
2018-04-19 10:56:26,13395.0,2,16178,-2,13365.0,18,13375.0,4,B
2018-04-19 10:56:30,13395.0,2,16180,2,13365.0,18,13375.0,4,B
2018-04-19 10:56:32,13395.0,2,16182,0,13365.0,18,13375.0,4,B
2018-04-19 10:56:49,13385.0,12,16194,10,13365.0,18,13375.0,4,S
2018-04-19 10:56:49,13385.0,4,16198,2,13365.0,18,13375.0,4,S
2018-04-19 10:56:50,13385.0,2,16200,0,13365.0,18,13375.0,4,S
2018-04-19 10:56:56,13385.0,2,16202,0,13365.0,18,13375.0,4,S
2018-04-19 10:57:26,13390.0,2,16204,0,13365.0,18,13375.0,4,B
2018-04-19 10:57:42,13390.0,16,16220,4,13365.0,18,13375.0,4,B
2018-04-19 10:57:48,13390.0,2,16222,0,13365.0,18,13375.0,4,B
2018-04-19 10:58:37,13395.0,2,16224,0,13365.0,18,13375.0,4,B
2018-04-19 10:58:39,13395.0,4,16228,-2,13365.0,18,13375.0,4,B
2018-04-19 10:58:41,13395.0,2,16230,-2,13365.0,18,13375.0,4,B
2018-04-19 10:59:03,13395.0,2,16232,0,13365.0,18,13375.0,4,B
2018-04-19 10:59:26,13390.0,10,16242,10,13365.0,18,13375.0,4,S
2018-04-19 10:59:37,13390.0,14,16256,12,13365.0,18,13375.0,4,S
2018-04-19 10:59:37,13390.0,2,16258,0,13365.0,18,13375.0,4,S
2018-04-19 10:59:38,13390.0,18,16276,4,13365.0,18,13375.0,4,S
2018-04-19 10:59:38,13390.0,6,16282,6,13365.0,18,13375.0,4,S
2018-04-19 10:59:44,13385.0,2,16284,0,13365.0,18,13375.0,4,S
2018-04-19 10:59:45,13385.0,2,16286,2,13365.0,18,13375.0,4,S
2018-04-19 10:59:46,13385.0,48,16334,38,13365.0,18,13375.0,4,S
2018-04-19 10:59:47,13385.0,20,16354,20,13365.0,18,13375.0,4,S
2018-04-19 10:59:48,13385.0,8,16362,8,13365.0,18,13375.0,4,S
2018-04-19 10:59:58,13385.0,2,16364,2,13365.0,18,13375.0,4,S
2018-04-19 11:00:21,13385.0,2,16366,0,13365.0,18,13375.0,4,S
2018-04-19 11:00:45,13385.0,2,16368,2,13365.0,18,13375.0,4,S
2018-04-19 11:00:48,13380.0,2,16370,0,13365.0,18,13375.0,4,S
2018-04-19 11:00:55,13380.0,38,16408,30,13365.0,18,13375.0,4,S
2018-04-19 11:00:55,13380.0,14,16422,10,13365.0,18,13375.0,4,S
2018-04-19 11:00:56,13380.0,50,16472,10,13365.0,18,13375.0,4,S
2018-04-19 11:01:03,13380.0,2,16474,0,13365.0,18,13375.0,4,S
2018-04-19 11:01:03,13380.0,12,16486,12,13365.0,18,13375.0,4,S
2018-04-19 11:01:06,13395.0,8,16494,2,13365.0,18,13375.0,4,B
2018-04-19 11:01:09,13400.0,2,16496,2,13365.0,18,13375.0,4,B
2018-04-19 11:01:10,13400.0,28,16524,20,13365.0,18,13375.0,4,B
2018-04-19 11:01:22,13400.0,2,16526,0,13365.0,18,13375.0,4,B
2018-04-19 11:01:30,13405.0,10,16536,-6,13365.0,18,13375.0,4,B
2018-04-19 11:01:32,13405.0,2,16538,0,13365.0,18,13375.0,4,B
2018-04-19 11:02:02,13405.0,2,16540,0,13365.0,18,13375.0,4,B
2018-04-19 11:02:02,13405.0,6,16546,2,13365.0,18,13375.0,4,B
2018-04-19 11:02:03,13405.0,2,16548,2,13365.0,18,13375.0,4,B
2018-04-19 11:02:38,13405.0,2,16550,0,13365.0,18,13375.0,4,B
2018-04-19 11:02:43,13405.0,2,16552,0,13365.0,18,13375.0,4,B
2018-04-19 11:02:47,13405.0,4,16556,4,13365.0,18,13375.0,4,B
2018-04-19 11:03:00,13405.0,2,16558,0,13365.0,18,13375.0,4,B
2018-04-19 11:03:01,13405.0,2,16560,0,13365.0,18,13375.0,4,B
2018-04-19 11:03:04,13405.0,2,16562,-2,13365.0,18,13375.0,4,B
2018-04-19 11:03:04,13405.0,2,16564,-2,13365.0,18,13375.0,4,B
2018-04-19 11:03:07,13400.0,10,16574,-4,13365.0,18,13375.0,4,S
2018-04-19 11:03:08,13400.0,2,16576,-2,13365.0,18,13375.0,4,S
2018-04-19 11:03:10,13410.0,2,16578,-2,13365.0,18,13375.0,4,B
2018-04-19 11:03:15,13405.0,2,16580,0,13365.0,18,13375.0,4,S
2018-04-19 11:03:15,13405.0,2,16582,0,13365.0,18,13375.0,4,S
2018-04-19 11:03:20,13410.0,2,16584,2,13365.0,18,13375.0,4,B
2018-04-19 11:03:21,13410.0,2,16586,2,13365.0,18,13375.0,4,B
2018-04-19 11:03:23,13405.0,2,16588,0,13365.0,18,13375.0,4,S
2018-04-19 11:03:24,13405.0,2,16590,0,13365.0,18,13375.0,4,S
2018-04-19 11:04:06,13405.0,2,16592,0,13365.0,18,13375.0,4,S
2018-04-19 11:04:12,13400.0,4,16596,0,13365.0,18,13375.0,4,S
2018-04-19 11:04:13,13400.0,12,16608,8,13365.0,18,13375.0,4,S
2018-04-19 11:04:13,13400.0,6,16614,0,13365.0,18,13375.0,4,S
2018-04-19 11:04:20,13400.0,2,16616,0,13365.0,18,13375.0,4,S
2018-04-19 11:04:22,13400.0,2,16618,0,13365.0,18,13375.0,4,S
2018-04-19 11:04:23,13395.0,4,16622,-2,13365.0,18,13375.0,4,S
2018-04-19 11:04:31,13395.0,6,16628,-2,13365.0,18,13375.0,4,S
2018-04-19 11:04:51,13400.0,2,16630,0,13365.0,18,13375.0,4,B
2018-04-19 11:04:52,13400.0,4,16634,-2,13365.0,18,13375.0,4,B
2018-04-19 11:05:03,13400.0,2,16636,0,13365.0,18,13375.0,4,B
2018-04-19 11:05:11,13400.0,2,16638,2,13365.0,18,13375.0,4,B
2018-04-19 11:05:12,13405.0,2,16640,0,13365.0,18,13375.0,4,B
2018-04-19 11:05:13,13405.0,2,16642,0,13365.0,18,13375.0,4,B
2018-04-19 11:05:20,13410.0,4,16646,2,13365.0,18,13375.0,4,B
2018-04-19 11:05:21,13410.0,4,16650,-2,13365.0,18,13375.0,4,B
2018-04-19 11:05:22,13410.0,2,16652,2,13365.0,18,13375.0,4,B
2018-04-19 11:05:22,13415.0,8,16660,2,13365.0,18,13375.0,4,B
2018-04-19 11:05:23,13415.0,4,16664,2,13365.0,18,13375.0,4,B
2018-04-19 11:05:24,13420.0,2,16666,0,13365.0,18,13375.0,4,B
2018-04-19 11:05:25,13420.0,12,16678,8,13365.0,18,13375.0,4,B
2018-04-19 11:05:25,13415.0,2,16680,0,13365.0,18,13375.0,4,S
2018-04-19 11:05:31,13425.0,2,16682,0,13365.0,18,13375.0,4,B
2018-04-19 11:05:31,13420.0,6,16688,4,13365.0,18,13375.0,4,S
2018-04-19 11:05:32,13420.0,8,16696,-2,13365.0,18,13375.0,4,S
2018-04-19 11:05:33,13420.0,2,16698,0,13365.0,18,13375.0,4,S
2018-04-19 11:05:34,13420.0,2,16700,0,13365.0,18,13375.0,4,S
2018-04-19 11:05:43,13420.0,2,16702,2,13365.0,18,13375.0,4,S
2018-04-19 11:05:48,13420.0,16,16718,10,13365.0,18,13375.0,4,S
2018-04-19 11:05:49,13420.0,4,16722,0,13365.0,18,13375.0,4,S
2018-04-19 11:05:54,13415.0,2,16724,0,13365.0,18,13375.0,4,S
2018-04-19 11:05:56,13420.0,2,16726,-2,13365.0,18,13375.0,4,B
2018-04-19 11:06:02,13425.0,2,16728,2,13365.0,18,13375.0,4,B
2018-04-19 11:06:02,13425.0,2,16730,2,13365.0,18,13375.0,4,B
2018-04-19 11:06:03,13425.0,2,16732,2,13365.0,18,13375.0,4,B
2018-04-19 11:06:03,13425.0,2,16734,2,13365.0,18,13375.0,4,B
2018-04-19 11:06:04,13425.0,2,16736,2,13365.0,18,13375.0,4,B
2018-04-19 11:06:04,13425.0,2,16738,2,13365.0,18,13375.0,4,B
2018-04-19 11:06:05,13425.0,2,16740,2,13365.0,18,13375.0,4,B
2018-04-19 11:06:05,13425.0,2,16742,2,13365.0,18,13375.0,4,B
2018-04-19 11:06:06,13425.0,2,16744,2,13365.0,18,13375.0,4,B
2018-04-19 11:06:09,13430.0,24,16768,18,13365.0,18,13375.0,4,B
2018-04-19 11:06:10,13430.0,6,16774,6,13365.0,18,13375.0,4,B
2018-04-19 11:06:10,13435.0,24,16798,10,13365.0,18,13375.0,4,B
2018-04-19 11:06:11,13435.0,16,16814,8,13365.0,18,13375.0,4,B
2018-04-19 11:06:11,13425.0,2,16816,2,13365.0,18,13375.0,4,S
2018-04-19 11:06:14,13425.0,4,16820,-2,13365.0,18,13375.0,4,S
2018-04-19 11:06:20,13430.0,8,16828,4,13365.0,18,13375.0,4,B
2018-04-19 11:06:20,13430.0,6,16834,6,13365.0,18,13375.0,4,B
2018-04-19 11:06:23,13435.0,2,16836,2,13365.0,18,13375.0,4,B
2018-04-19 11:06:23,13435.0,6,16842,4,13365.0,18,13375.0,4,B
2018-04-19 11:06:24,13440.0,14,16856,0,13365.0,18,13375.0,4,B
2018-04-19 11:06:26,13445.0,22,16878,10,13365.0,18,13375.0,4,B
2018-04-19 11:06:26,13450.0,12,16890,8,13365.0,18,13375.0,4,B
2018-04-19 11:06:27,13450.0,16,16906,10,13365.0,18,13375.0,4,B
2018-04-19 11:06:27,13445.0,14,16920,2,13365.0,18,13375.0,4,S
2018-04-19 11:06:28,13450.0,6,16926,0,13365.0,18,13375.0,4,B
2018-04-19 11:06:30,13450.0,2,16928,0,13365.0,18,13375.0,4,B
2018-04-19 11:06:30,13450.0,126,17054,48,13365.0,18,13375.0,4,B
2018-04-19 11:06:31,13450.0,14,17068,0,13365.0,18,13375.0,4,B
2018-04-19 11:06:31,13445.0,2,17070,0,13365.0,18,13375.0,4,S
2018-04-19 11:06:35,13445.0,4,17074,-2,13365.0,18,13375.0,4,S
2018-04-19 11:06:38,13450.0,2,17076,2,13365.0,18,13375.0,4,B
2018-04-19 11:06:42,13450.0,10,17086,0,13365.0,18,13375.0,4,B
2018-04-19 11:06:42,13450.0,4,17090,2,13365.0,18,13375.0,4,B
2018-04-19 11:06:43,13450.0,10,17100,-2,13365.0,18,13375.0,4,B
2018-04-19 11:06:45,13445.0,2,17102,0,13365.0,18,13375.0,4,S
2018-04-19 11:06:48,13445.0,2,17104,0,13365.0,18,13375.0,4,S
2018-04-19 11:06:52,13445.0,2,17106,0,13365.0,18,13375.0,4,S
2018-04-19 11:06:53,13445.0,8,17114,0,13365.0,18,13375.0,4,S
2018-04-19 11:06:55,13440.0,2,17116,0,13365.0,18,13375.0,4,S
2018-04-19 11:06:55,13445.0,2,17118,0,13365.0,18,13375.0,4,B
2018-04-19 11:06:58,13445.0,6,17124,-2,13365.0,18,13375.0,4,B
2018-04-19 11:07:00,13440.0,2,17126,2,13365.0,18,13375.0,4,S
2018-04-19 11:07:01,13440.0,4,17130,4,13365.0,18,13375.0,4,S
2018-04-19 11:07:03,13450.0,24,17154,12,13365.0,18,13375.0,4,B
2018-04-19 11:07:03,13450.0,6,17160,4,13365.0,18,13375.0,4,B
2018-04-19 11:07:04,13460.0,40,17200,10,13365.0,18,13375.0,4,B
2018-04-19 11:07:04,13460.0,22,17222,-6,13365.0,18,13375.0,4,B
2018-04-19 11:07:05,13460.0,2,17224,2,13365.0,18,13375.0,4,B
2018-04-19 11:07:05,13460.0,2,17226,0,13365.0,18,13375.0,4,B
2018-04-19 11:07:06,13455.0,2,17228,-2,13365.0,18,13375.0,4,S
2018-04-19 11:07:06,13460.0,14,17242,-12,13365.0,18,13375.0,4,B
2018-04-19 11:07:08,13460.0,6,17248,-4,13365.0,18,13375.0,4,B
2018-04-19 11:07:13,13460.0,2,17250,0,13365.0,18,13375.0,4,B
2018-04-19 11:07:14,13460.0,4,17254,0,13365.0,18,13375.0,4,B
2018-04-19 11:07:14,13455.0,8,17262,-4,13365.0,18,13375.0,4,S
2018-04-19 11:07:16,13460.0,4,17266,2,13365.0,18,13375.0,4,B
2018-04-19 11:07:18,13460.0,4,17270,2,13365.0,18,13375.0,4,B
2018-04-19 11:07:19,13465.0,10,17280,4,13365.0,18,13375.0,4,B
2018-04-19 11:07:19,13465.0,4,17284,0,13365.0,18,13375.0,4,B
2018-04-19 11:07:21,13460.0,2,17286,0,13365.0,18,13375.0,4,S
2018-04-19 11:07:21,13460.0,2,17288,0,13365.0,18,13375.0,4,S
2018-04-19 11:07:22,13465.0,4,17292,4,13365.0,18,13375.0,4,B
2018-04-19 11:07:23,13460.0,2,17294,0,13365.0,18,13375.0,4,S
2018-04-19 11:07:27,13460.0,14,17308,14,13365.0,18,13375.0,4,S
2018-04-19 11:07:28,13455.0,2,17310,0,13365.0,18,13375.0,4,S
2018-04-19 11:07:28,13460.0,4,17314,0,13365.0,18,13375.0,4,B
2018-04-19 11:07:29,13460.0,2,17316,0,13365.0,18,13375.0,4,B
2018-04-19 11:07:30,13460.0,2,17318,0,13365.0,18,13375.0,4,B
2018-04-19 11:07:33,13455.0,2,17320,2,13365.0,18,13375.0,4,S
2018-04-19 11:07:34,13455.0,2,17322,2,13365.0,18,13375.0,4,S
2018-04-19 11:07:38,13455.0,2,17324,-2,13365.0,18,13375.0,4,S
2018-04-19 11:07:39,13455.0,4,17328,0,13365.0,18,13375.0,4,S
2018-04-19 11:07:39,13455.0,2,17330,2,13365.0,18,13375.0,4,S
2018-04-19 11:07:40,13455.0,2,17332,2,13365.0,18,13375.0,4,S
2018-04-19 11:07:43,13450.0,2,17334,2,13365.0,18,13375.0,4,S
2018-04-19 11:07:45,13455.0,2,17336,2,13365.0,18,13375.0,4,B
2018-04-19 11:07:46,13455.0,2,17338,-2,13365.0,18,13375.0,4,B
2018-04-19 11:07:46,13455.0,6,17344,2,13365.0,18,13375.0,4,B
2018-04-19 11:07:47,13460.0,2,17346,0,13365.0,18,13375.0,4,B
2018-04-19 11:07:49,13460.0,8,17354,-2,13365.0,18,13375.0,4,B
2018-04-19 11:07:50,13455.0,2,17356,2,13365.0,18,13375.0,4,S
2018-04-19 11:07:51,13455.0,6,17362,6,13365.0,18,13375.0,4,S
2018-04-19 11:07:51,13460.0,2,17364,-2,13365.0,18,13375.0,4,B
2018-04-19 11:07:53,13460.0,2,17366,0,13365.0,18,13375.0,4,B
2018-04-19 11:07:55,13460.0,10,17376,-10,13365.0,18,13375.0,4,B
2018-04-19 11:07:57,13460.0,2,17378,-2,13365.0,18,13375.0,4,B
2018-04-19 11:07:59,13460.0,4,17382,2,13365.0,18,13375.0,4,B
2018-04-19 11:08:02,13465.0,2,17384,2,13365.0,18,13375.0,4,B
2018-04-19 11:08:03,13465.0,22,17406,10,13365.0,18,13375.0,4,B
2018-04-19 11:08:06,13465.0,2,17408,-2,13365.0,18,13375.0,4,B
2018-04-19 11:08:12,13465.0,2,17410,2,13365.0,18,13375.0,4,B
2018-04-19 11:08:16,13470.0,36,17446,22,13365.0,18,13375.0,4,B
2018-04-19 11:08:16,13470.0,4,17450,2,13365.0,18,13375.0,4,B
2018-04-19 11:08:17,13470.0,22,17472,16,13365.0,18,13375.0,4,B
2018-04-19 11:08:17,13475.0,46,17518,26,13365.0,18,13375.0,4,B
2018-04-19 11:08:18,13475.0,44,17562,28,13365.0,18,13375.0,4,B
2018-04-19 11:08:18,13470.0,8,17570,4,13365.0,18,13375.0,4,S
2018-04-19 11:08:19,13470.0,2,17572,0,13365.0,18,13375.0,4,S
2018-04-19 11:08:20,13470.0,12,17584,2,13365.0,18,13375.0,4,S
2018-04-19 11:08:21,13470.0,2,17586,2,13365.0,18,13375.0,4,S
2018-04-19 11:08:25,13460.0,10,17596,0,13365.0,18,13375.0,4,S
2018-04-19 11:08:29,13465.0,10,17606,-10,13365.0,18,13375.0,4,B
2018-04-19 11:08:32,13465.0,2,17608,2,13365.0,18,13375.0,4,B
2018-04-19 11:08:35,13470.0,20,17628,-18,13365.0,18,13375.0,4,B
2018-04-19 11:08:38,13465.0,4,17632,2,13365.0,18,13375.0,4,S
2018-04-19 11:08:40,13465.0,2,17634,2,13365.0,18,13375.0,4,S
2018-04-19 11:08:46,13465.0,4,17638,-2,13365.0,18,13375.0,4,S
2018-04-19 11:08:56,13460.0,4,17642,-4,13365.0,18,13375.0,4,S
2018-04-19 11:08:57,13460.0,10,17652,-10,13365.0,18,13375.0,4,S
2018-04-19 11:09:01,13460.0,2,17654,2,13365.0,18,13375.0,4,S
2018-04-19 11:09:02,13460.0,2,17656,2,13365.0,18,13375.0,4,S
2018-04-19 11:09:13,13450.0,2,17658,2,13365.0,18,13375.0,4,S
2018-04-19 11:09:14,13460.0,2,17660,0,13365.0,18,13375.0,4,B
2018-04-19 11:09:15,13450.0,2,17662,0,13365.0,18,13375.0,4,S
2018-04-19 11:09:19,13450.0,2,17664,0,13365.0,18,13375.0,4,S
2018-04-19 11:09:21,13450.0,2,17666,2,13365.0,18,13375.0,4,S
2018-04-19 11:09:24,13450.0,2,17668,0,13365.0,18,13375.0,4,S
2018-04-19 11:09:27,13455.0,14,17682,-6,13365.0,18,13375.0,4,B
2018-04-19 11:09:28,13455.0,4,17686,-4,13365.0,18,13375.0,4,B
2018-04-19 11:09:28,13455.0,2,17688,0,13365.0,18,13375.0,4,B
2018-04-19 11:09:29,13450.0,10,17698,6,13365.0,18,13375.0,4,S
2018-04-19 11:09:30,13460.0,4,17702,0,13365.0,18,13375.0,4,B
2018-04-19 11:09:32,13455.0,6,17708,2,13365.0,18,13375.0,4,S
2018-04-19 11:09:33,13455.0,4,17712,0,13365.0,18,13375.0,4,S
2018-04-19 11:09:34,13450.0,10,17722,8,13365.0,18,13375.0,4,S
2018-04-19 11:09:37,13455.0,2,17724,2,13365.0,18,13375.0,4,B
2018-04-19 11:09:40,13455.0,8,17732,0,13365.0,18,13375.0,4,B
2018-04-19 11:09:44,13460.0,4,17736,0,13365.0,18,13375.0,4,B
2018-04-19 11:09:45,13460.0,2,17738,0,13365.0,18,13375.0,4,B
2018-04-19 11:09:46,13465.0,4,17742,-2,13365.0,18,13375.0,4,B
2018-04-19 11:09:48,13460.0,10,17752,10,13365.0,18,13375.0,4,S
2018-04-19 11:09:50,13465.0,2,17754,2,13365.0,18,13375.0,4,B
2018-04-19 11:09:52,13465.0,10,17764,0,13365.0,18,13375.0,4,B
2018-04-19 11:09:54,13470.0,2,17766,0,13365.0,18,13375.0,4,B
2018-04-19 11:09:55,13460.0,12,17778,-6,13365.0,18,13375.0,4,S
2018-04-19 11:09:55,13465.0,2,17780,0,13365.0,18,13375.0,4,B
2018-04-19 11:09:56,13465.0,8,17788,0,13365.0,18,13375.0,4,B
2018-04-19 11:09:59,13465.0,6,17794,4,13365.0,18,13375.0,4,B
2018-04-19 11:10:03,13465.0,6,17800,0,13365.0,18,13375.0,4,B
2018-04-19 11:10:04,13465.0,2,17802,0,13365.0,18,13375.0,4,B
2018-04-19 11:10:05,13465.0,4,17806,0,13365.0,18,13375.0,4,B
2018-04-19 11:10:05,13465.0,4,17810,4,13365.0,18,13375.0,4,B
2018-04-19 11:10:07,13465.0,2,17812,2,13365.0,18,13375.0,4,B
2018-04-19 11:10:07,13465.0,2,17814,2,13365.0,18,13375.0,4,B
2018-04-19 11:10:12,13460.0,2,17816,0,13365.0,18,13375.0,4,S
2018-04-19 11:10:16,13460.0,2,17818,0,13365.0,18,13375.0,4,S
2018-04-19 11:10:19,13460.0,2,17820,0,13365.0,18,13375.0,4,S
2018-04-19 11:10:22,13465.0,6,17826,6,13365.0,18,13375.0,4,B
2018-04-19 11:10:23,13465.0,10,17836,10,13365.0,18,13375.0,4,B
2018-04-19 11:10:25,13470.0,8,17844,8,13365.0,18,13375.0,4,B
2018-04-19 11:10:25,13475.0,18,17862,12,13365.0,18,13375.0,4,B
2018-04-19 11:10:26,13470.0,12,17874,4,13365.0,18,13375.0,4,S
2018-04-19 11:10:27,13475.0,4,17878,-4,13365.0,18,13375.0,4,B
2018-04-19 11:10:28,13470.0,10,17888,8,13365.0,18,13375.0,4,S
2018-04-19 11:10:28,13470.0,4,17892,-2,13365.0,18,13375.0,4,S
2018-04-19 11:10:30,13470.0,2,17894,-2,13365.0,18,13375.0,4,S
2018-04-19 11:10:30,13475.0,2,17896,-2,13365.0,18,13375.0,4,B
2018-04-19 11:10:31,13475.0,8,17904,-8,13365.0,18,13375.0,4,B
2018-04-19 11:10:35,13475.0,4,17908,2,13365.0,18,13375.0,4,B
2018-04-19 11:10:36,13475.0,2,17910,0,13365.0,18,13375.0,4,B
2018-04-19 11:10:36,13480.0,2,17912,0,13365.0,18,13375.0,4,B
2018-04-19 11:10:37,13480.0,18,17930,8,13365.0,18,13375.0,4,B
2018-04-19 11:10:37,13480.0,4,17934,2,13365.0,18,13375.0,4,B
2018-04-19 11:10:38,13480.0,4,17938,2,13365.0,18,13375.0,4,B
2018-04-19 11:10:40,13480.0,6,17944,6,13365.0,18,13375.0,4,B
2018-04-19 11:10:41,13480.0,2,17946,0,13365.0,18,13375.0,4,B
2018-04-19 11:10:42,13480.0,2,17948,0,13365.0,18,13375.0,4,B
2018-04-19 11:10:42,13480.0,2,17950,-2,13365.0,18,13375.0,4,B
2018-04-19 11:10:45,13475.0,14,17964,10,13365.0,18,13375.0,4,S
2018-04-19 11:10:46,13475.0,2,17966,0,13365.0,18,13375.0,4,S
2018-04-19 11:10:53,13475.0,2,17968,0,13365.0,18,13375.0,4,S
2018-04-19 11:10:53,13475.0,2,17970,0,13365.0,18,13375.0,4,S
2018-04-19 11:10:54,13475.0,2,17972,0,13365.0,18,13375.0,4,S
2018-04-19 11:10:54,13475.0,2,17974,0,13365.0,18,13375.0,4,S
2018-04-19 11:10:55,13475.0,2,17976,0,13365.0,18,13375.0,4,S
2018-04-19 11:10:55,13475.0,2,17978,0,13365.0,18,13375.0,4,S
2018-04-19 11:10:56,13475.0,2,17980,0,13365.0,18,13375.0,4,S
2018-04-19 11:10:56,13475.0,2,17982,0,13365.0,18,13375.0,4,S
2018-04-19 11:10:57,13470.0,16,17998,-8,13365.0,18,13375.0,4,S
2018-04-19 11:10:58,13475.0,2,18000,0,13365.0,18,13375.0,4,B
2018-04-19 11:10:58,13475.0,2,18002,0,13365.0,18,13375.0,4,B
2018-04-19 11:11:03,13470.0,2,18004,-2,13365.0,18,13375.0,4,S
2018-04-19 11:11:04,13470.0,6,18010,-2,13365.0,18,13375.0,4,S
2018-04-19 11:11:11,13465.0,2,18012,-2,13365.0,18,13375.0,4,S
2018-04-19 11:11:11,13465.0,2,18014,-2,13365.0,18,13375.0,4,S
2018-04-19 11:11:12,13465.0,2,18016,0,13365.0,18,13375.0,4,S
2018-04-19 11:11:14,13465.0,2,18018,0,13365.0,18,13375.0,4,S
2018-04-19 11:11:14,13460.0,4,18022,4,13365.0,18,13375.0,4,S
2018-04-19 11:11:15,13465.0,2,18024,2,13365.0,18,13375.0,4,B
2018-04-19 11:11:16,13465.0,2,18026,0,13365.0,18,13375.0,4,B
2018-04-19 11:11:17,13460.0,2,18028,0,13365.0,18,13375.0,4,S
2018-04-19 11:11:20,13465.0,2,18030,0,13365.0,18,13375.0,4,B
2018-04-19 11:11:23,13465.0,2,18032,0,13365.0,18,13375.0,4,B
2018-04-19 11:11:25,13465.0,2,18034,0,13365.0,18,13375.0,4,B
2018-04-19 11:11:25,13465.0,2,18036,2,13365.0,18,13375.0,4,B
2018-04-19 11:11:28,13465.0,2,18038,2,13365.0,18,13375.0,4,B
2018-04-19 11:11:29,13465.0,2,18040,2,13365.0,18,13375.0,4,B
2018-04-19 11:11:30,13465.0,2,18042,2,13365.0,18,13375.0,4,B
2018-04-19 11:11:30,13465.0,2,18044,2,13365.0,18,13375.0,4,B
2018-04-19 11:11:31,13465.0,2,18046,2,13365.0,18,13375.0,4,B
2018-04-19 11:11:32,13465.0,2,18048,0,13365.0,18,13375.0,4,B
2018-04-19 11:11:33,13465.0,4,18052,4,13365.0,18,13375.0,4,B
2018-04-19 11:11:33,13465.0,2,18054,2,13365.0,18,13375.0,4,B
2018-04-19 11:11:34,13465.0,2,18056,2,13365.0,18,13375.0,4,B
2018-04-19 11:11:35,13465.0,2,18058,2,13365.0,18,13375.0,4,B
2018-04-19 11:11:41,13465.0,2,18060,2,13365.0,18,13375.0,4,B
2018-04-19 11:11:45,13465.0,2,18062,0,13365.0,18,13375.0,4,B
2018-04-19 11:11:48,13465.0,2,18064,2,13365.0,18,13375.0,4,B
2018-04-19 11:11:49,13465.0,2,18066,0,13365.0,18,13375.0,4,B
2018-04-19 11:11:50,13465.0,2,18068,0,13365.0,18,13375.0,4,B
2018-04-19 11:11:52,13460.0,10,18078,4,13365.0,18,13375.0,4,S
2018-04-19 11:11:52,13470.0,12,18090,12,13365.0,18,13375.0,4,B
2018-04-19 11:11:54,13465.0,2,18092,0,13365.0,18,13375.0,4,S
2018-04-19 11:11:56,13470.0,20,18112,18,13365.0,18,13375.0,4,B
2018-04-19 11:11:57,13475.0,4,18116,-2,13365.0,18,13375.0,4,B
2018-04-19 11:12:01,13475.0,4,18120,2,13365.0,18,13375.0,4,B
2018-04-19 11:12:04,13475.0,14,18134,-4,13365.0,18,13375.0,4,B
2018-04-19 11:12:07,13465.0,2,18136,2,13365.0,18,13375.0,4,S
2018-04-19 11:12:08,13475.0,2,18138,0,13365.0,18,13375.0,4,B
2018-04-19 11:12:09,13475.0,2,18140,2,13365.0,18,13375.0,4,B
2018-04-19 11:12:11,13470.0,2,18142,0,13365.0,18,13375.0,4,S
2018-04-19 11:12:11,13475.0,2,18144,0,13365.0,18,13375.0,4,B
2018-04-19 11:12:12,13470.0,2,18146,0,13365.0,18,13375.0,4,S
2018-04-19 11:12:12,13470.0,2,18148,0,13365.0,18,13375.0,4,S
2018-04-19 11:12:13,13475.0,2,18150,-2,13365.0,18,13375.0,4,B
2018-04-19 11:12:14,13465.0,2,18152,2,13365.0,18,13375.0,4,S
2018-04-19 11:12:18,13475.0,4,18156,2,13365.0,18,13375.0,4,B
2018-04-19 11:12:19,13470.0,2,18158,0,13365.0,18,13375.0,4,S
2018-04-19 11:12:20,13475.0,2,18160,0,13365.0,18,13375.0,4,B
2018-04-19 11:12:24,13475.0,2,18162,2,13365.0,18,13375.0,4,B
2018-04-19 11:12:25,13475.0,2,18164,2,13365.0,18,13375.0,4,B
2018-04-19 11:12:29,13480.0,4,18168,0,13365.0,18,13375.0,4,B
2018-04-19 11:12:30,13480.0,6,18174,6,13365.0,18,13375.0,4,B
2018-04-19 11:12:31,13480.0,10,18184,8,13365.0,18,13375.0,4,B
2018-04-19 11:12:31,13480.0,2,18186,2,13365.0,18,13375.0,4,B
2018-04-19 11:12:33,13485.0,2,18188,0,13365.0,18,13375.0,4,B
2018-04-19 11:12:34,13480.0,10,18198,10,13365.0,18,13375.0,4,S
2018-04-19 11:12:35,13480.0,6,18204,4,13365.0,18,13375.0,4,S
2018-04-19 11:12:36,13485.0,2,18206,0,13365.0,18,13375.0,4,B
2018-04-19 11:12:37,13485.0,2,18208,2,13365.0,18,13375.0,4,B
2018-04-19 11:12:39,13485.0,8,18216,0,13365.0,18,13375.0,4,B
2018-04-19 11:12:39,13485.0,2,18218,2,13365.0,18,13375.0,4,B
2018-04-19 11:12:41,13485.0,12,18230,0,13365.0,18,13375.0,4,B
2018-04-19 11:12:41,13485.0,2,18232,0,13365.0,18,13375.0,4,B
2018-04-19 11:12:42,13485.0,4,18236,0,13365.0,18,13375.0,4,B
2018-04-19 11:12:42,13485.0,4,18240,2,13365.0,18,13375.0,4,B
2018-04-19 11:12:45,13490.0,10,18250,8,13365.0,18,13375.0,4,B
2018-04-19 11:12:45,13500.0,68,18318,44,13365.0,18,13375.0,4,B
2018-04-19 11:12:46,13485.0,6,18324,2,13365.0,18,13375.0,4,S
2018-04-19 11:12:47,13485.0,2,18326,0,13365.0,18,13375.0,4,S
2018-04-19 11:12:48,13485.0,4,18330,2,13365.0,18,13375.0,4,S
2018-04-19 11:12:50,13485.0,2,18332,0,13365.0,18,13375.0,4,S
2018-04-19 11:12:51,13500.0,60,18392,22,13365.0,18,13375.0,4,B
2018-04-19 11:12:55,13490.0,2,18394,0,13365.0,18,13375.0,4,S
2018-04-19 11:12:55,13485.0,2,18396,2,13365.0,18,13375.0,4,S
2018-04-19 11:12:56,13490.0,6,18402,0,13365.0,18,13375.0,4,B
2018-04-19 11:12:58,13490.0,2,18404,0,13365.0,18,13375.0,4,B
2018-04-19 11:12:59,13495.0,2,18406,-2,13365.0,18,13375.0,4,B
2018-04-19 11:13:01,13490.0,2,18408,2,13365.0,18,13375.0,4,S
2018-04-19 11:13:01,13495.0,4,18412,-4,13365.0,18,13375.0,4,B
2018-04-19 11:13:03,13495.0,2,18414,0,13365.0,18,13375.0,4,B
2018-04-19 11:13:06,13500.0,60,18474,34,13365.0,18,13375.0,4,B
2018-04-19 11:13:07,13500.0,6,18480,0,13365.0,18,13375.0,4,B
2018-04-19 11:13:07,13495.0,2,18482,0,13365.0,18,13375.0,4,S
2018-04-19 11:13:08,13500.0,6,18488,0,13365.0,18,13375.0,4,B
2018-04-19 11:13:09,13495.0,4,18492,2,13365.0,18,13375.0,4,S
2018-04-19 11:13:09,13495.0,8,18500,4,13365.0,18,13375.0,4,S
2018-04-19 11:13:10,13495.0,6,18506,-6,13365.0,18,13375.0,4,S
2018-04-19 11:13:11,13495.0,4,18510,-4,13365.0,18,13375.0,4,S
2018-04-19 11:13:13,13500.0,4,18514,4,13365.0,18,13375.0,4,B
2018-04-19 11:13:14,13500.0,2,18516,0,13365.0,18,13375.0,4,B
2018-04-19 11:13:16,13500.0,2,18518,0,13365.0,18,13375.0,4,B
2018-04-19 11:13:16,13495.0,2,18520,-2,13365.0,18,13375.0,4,S
2018-04-19 11:13:18,13505.0,2,18522,0,13365.0,18,13375.0,4,B
2018-04-19 11:13:19,13495.0,16,18538,4,13365.0,18,13375.0,4,S
2018-04-19 11:13:19,13505.0,8,18546,4,13365.0,18,13375.0,4,B
2018-04-19 11:13:20,13500.0,2,18548,0,13365.0,18,13375.0,4,S
2018-04-19 11:13:21,13500.0,2,18550,2,13365.0,18,13375.0,4,S
2018-04-19 11:13:27,13505.0,4,18554,0,13365.0,18,13375.0,4,B
2018-04-19 11:13:30,13495.0,2,18556,-2,13365.0,18,13375.0,4,S
2018-04-19 11:13:31,13500.0,8,18564,4,13365.0,18,13375.0,4,B
2018-04-19 11:13:34,13500.0,2,18566,0,13365.0,18,13375.0,4,B
2018-04-19 11:13:35,13505.0,10,18576,0,13365.0,18,13375.0,4,B
2018-04-19 11:13:35,13505.0,8,18584,8,13365.0,18,13375.0,4,B
2018-04-19 11:13:36,13505.0,14,18598,8,13365.0,18,13375.0,4,B
2018-04-19 11:13:36,13505.0,2,18600,2,13365.0,18,13375.0,4,B
2018-04-19 11:13:37,13505.0,18,18618,14,13365.0,18,13375.0,4,B
2018-04-19 11:13:37,13505.0,8,18626,0,13365.0,18,13375.0,4,B
2018-04-19 11:13:38,13505.0,2,18628,0,13365.0,18,13375.0,4,B
2018-04-19 11:13:38,13500.0,2,18630,0,13365.0,18,13375.0,4,S
2018-04-19 11:13:40,13500.0,6,18636,0,13365.0,18,13375.0,4,S
2018-04-19 11:13:42,13505.0,4,18640,-2,13365.0,18,13375.0,4,B
2018-04-19 11:13:43,13505.0,2,18642,-2,13365.0,18,13375.0,4,B
2018-04-19 11:13:45,13500.0,4,18646,-2,13365.0,18,13375.0,4,S
2018-04-19 11:13:48,13500.0,2,18648,0,13365.0,18,13375.0,4,S
2018-04-19 11:13:48,13500.0,18,18666,14,13365.0,18,13375.0,4,S
2018-04-19 11:13:49,13495.0,4,18670,-4,13365.0,18,13375.0,4,S
2018-04-19 11:13:51,13495.0,4,18674,2,13365.0,18,13375.0,4,S
2018-04-19 11:13:52,13495.0,2,18676,0,13365.0,18,13375.0,4,S
2018-04-19 11:13:53,13495.0,2,18678,-2,13365.0,18,13375.0,4,S
2018-04-19 11:13:54,13495.0,2,18680,-2,13365.0,18,13375.0,4,S
2018-04-19 11:13:55,13495.0,2,18682,0,13365.0,18,13375.0,4,S
2018-04-19 11:13:55,13495.0,4,18686,0,13365.0,18,13375.0,4,S
2018-04-19 11:13:58,13500.0,24,18710,10,13365.0,18,13375.0,4,B
2018-04-19 11:13:59,13495.0,10,18720,6,13365.0,18,13375.0,4,S
2018-04-19 11:14:01,13495.0,4,18724,-4,13365.0,18,13375.0,4,S
2018-04-19 11:14:04,13495.0,10,18734,0,13365.0,18,13375.0,4,S
2018-04-19 11:14:06,13510.0,60,18794,56,13365.0,18,13375.0,4,B
2018-04-19 11:14:07,13510.0,14,18808,-6,13365.0,18,13375.0,4,B
2018-04-19 11:14:09,13505.0,2,18810,-2,13365.0,18,13375.0,4,S
2018-04-19 11:14:12,13505.0,14,18824,2,13365.0,18,13375.0,4,S
2018-04-19 11:14:12,13510.0,2,18826,0,13365.0,18,13375.0,4,B
2018-04-19 11:14:14,13510.0,12,18838,10,13365.0,18,13375.0,4,B
2018-04-19 11:14:15,13510.0,48,18886,20,13365.0,18,13375.0,4,B
2018-04-19 11:14:17,13510.0,4,18890,0,13365.0,18,13375.0,4,B
2018-04-19 11:14:17,13510.0,6,18896,-4,13365.0,18,13375.0,4,B
2018-04-19 11:14:20,13515.0,4,18900,-2,13365.0,18,13375.0,4,B
2018-04-19 11:14:24,13515.0,60,18960,0,13365.0,18,13375.0,4,B
2018-04-19 11:14:27,13510.0,4,18964,2,13365.0,18,13375.0,4,S
2018-04-19 11:14:28,13510.0,2,18966,0,13365.0,18,13375.0,4,S
2018-04-19 11:14:29,13510.0,2,18968,0,13365.0,18,13375.0,4,S
2018-04-19 11:14:31,13510.0,4,18972,-4,13365.0,18,13375.0,4,S
2018-04-19 11:14:32,13515.0,60,19032,0,13365.0,18,13375.0,4,B
2018-04-19 11:14:34,13515.0,10,19042,-10,13365.0,18,13375.0,4,B
2018-04-19 11:14:34,13510.0,2,19044,2,13365.0,18,13375.0,4,S
2018-04-19 11:14:35,13515.0,32,19076,-22,13365.0,18,13375.0,4,B
2018-04-19 11:14:36,13515.0,2,19078,2,13365.0,18,13375.0,4,B
2018-04-19 11:14:36,13520.0,42,19120,4,13365.0,18,13375.0,4,B
2018-04-19 11:14:37,13525.0,38,19158,2,13365.0,18,13375.0,4,B
2018-04-19 11:14:38,13530.0,2,19160,2,13365.0,18,13375.0,4,B
2018-04-19 11:14:38,13530.0,4,19164,0,13365.0,18,13375.0,4,B
2018-04-19 11:14:39,13520.0,8,19172,0,13365.0,18,13375.0,4,S
2018-04-19 11:14:40,13520.0,2,19174,2,13365.0,18,13375.0,4,S
2018-04-19 11:14:43,13525.0,2,19176,2,13365.0,18,13375.0,4,B
2018-04-19 11:14:45,13530.0,46,19222,30,13365.0,18,13375.0,4,B
2018-04-19 11:14:46,13530.0,18,19240,2,13365.0,18,13375.0,4,B
2018-04-19 11:14:46,13525.0,4,19244,0,13365.0,18,13375.0,4,S
2018-04-19 11:14:47,13525.0,8,19252,4,13365.0,18,13375.0,4,S
2018-04-19 11:14:49,13520.0,2,19254,0,13365.0,18,13375.0,4,S
2018-04-19 11:14:49,13520.0,2,19256,2,13365.0,18,13375.0,4,S
2018-04-19 11:14:51,13515.0,4,19260,-2,13365.0,18,13375.0,4,S
2018-04-19 11:14:51,13520.0,2,19262,2,13365.0,18,13375.0,4,B
2018-04-19 11:14:52,13520.0,6,19268,4,13365.0,18,13375.0,4,B
2018-04-19 11:14:55,13520.0,4,19272,4,13365.0,18,13375.0,4,B
2018-04-19 11:14:56,13515.0,2,19274,0,13365.0,18,13375.0,4,S
2018-04-19 11:14:57,13520.0,6,19280,-4,13365.0,18,13375.0,4,B
2018-04-19 11:14:58,13520.0,2,19282,-2,13365.0,18,13375.0,4,B
2018-04-19 11:14:59,13520.0,2,19284,0,13365.0,18,13375.0,4,B
2018-04-19 11:15:01,13520.0,6,19290,2,13365.0,18,13375.0,4,B
2018-04-19 11:15:03,13525.0,4,19294,2,13365.0,18,13375.0,4,B
2018-04-19 11:15:05,13525.0,2,19296,2,13365.0,18,13375.0,4,B
2018-04-19 11:15:06,13520.0,2,19298,0,13365.0,18,13375.0,4,S
2018-04-19 11:15:08,13530.0,38,19336,8,13365.0,18,13375.0,4,B
2018-04-19 11:15:09,13525.0,4,19340,0,13365.0,18,13375.0,4,S
2018-04-19 11:15:09,13520.0,10,19350,2,13365.0,18,13375.0,4,S
2018-04-19 11:15:11,13520.0,8,19358,8,13365.0,18,13375.0,4,S
2018-04-19 11:15:15,13515.0,4,19362,-4,13365.0,18,13375.0,4,S
2018-04-19 11:15:16,13515.0,2,19364,-2,13365.0,18,13375.0,4,S
2018-04-19 11:15:19,13510.0,2,19366,0,13365.0,18,13375.0,4,S
2018-04-19 11:15:24,13510.0,2,19368,0,13365.0,18,13375.0,4,S
2018-04-19 11:15:24,13510.0,6,19374,0,13365.0,18,13375.0,4,S
2018-04-19 11:15:25,13510.0,28,19402,-6,13365.0,18,13375.0,4,S
2018-04-19 11:15:25,13505.0,10,19412,0,13365.0,18,13375.0,4,S
2018-04-19 11:15:26,13505.0,8,19420,4,13365.0,18,13375.0,4,S
2018-04-19 11:15:29,13500.0,2,19422,2,13365.0,18,13375.0,4,S
2018-04-19 11:15:30,13500.0,4,19426,4,13365.0,18,13375.0,4,S
2018-04-19 11:15:30,13500.0,2,19428,0,13365.0,18,13375.0,4,S
2018-04-19 11:15:32,13505.0,4,19432,0,13365.0,18,13375.0,4,B
2018-04-19 11:15:33,13500.0,4,19436,2,13365.0,18,13375.0,4,S
2018-04-19 11:15:34,13505.0,4,19440,-4,13365.0,18,13375.0,4,B
2018-04-19 11:15:36,13505.0,12,19452,-2,13365.0,18,13375.0,4,B
2018-04-19 11:15:37,13505.0,2,19454,0,13365.0,18,13375.0,4,B
2018-04-19 11:15:39,13505.0,4,19458,-4,13365.0,18,13375.0,4,B
2018-04-19 11:15:39,13500.0,2,19460,0,13365.0,18,13375.0,4,S
2018-04-19 11:15:42,13500.0,2,19462,0,13365.0,18,13375.0,4,S
2018-04-19 11:15:43,13505.0,2,19464,0,13365.0,18,13375.0,4,B
2018-04-19 11:15:44,13505.0,2,19466,0,13365.0,18,13375.0,4,B
2018-04-19 11:15:47,13500.0,2,19468,2,13365.0,18,13375.0,4,S
2018-04-19 11:15:48,13505.0,2,19470,-2,13365.0,18,13375.0,4,B
2018-04-19 11:15:49,13500.0,2,19472,0,13365.0,18,13375.0,4,S
2018-04-19 11:15:49,13500.0,2,19474,0,13365.0,18,13375.0,4,S
2018-04-19 11:15:50,13505.0,2,19476,0,13365.0,18,13375.0,4,B
2018-04-19 11:15:54,13500.0,42,19518,-8,13365.0,18,13375.0,4,S
2018-04-19 11:15:55,13500.0,2,19520,-2,13365.0,18,13375.0,4,S
2018-04-19 11:15:56,13500.0,2,19522,0,13365.0,18,13375.0,4,S
2018-04-19 11:15:57,13500.0,4,19526,-4,13365.0,18,13375.0,4,S
2018-04-19 11:15:57,13500.0,18,19544,-6,13365.0,18,13375.0,4,S
2018-04-19 11:15:58,13495.0,4,19548,0,13365.0,18,13375.0,4,S
2018-04-19 11:16:01,13495.0,10,19558,-10,13365.0,18,13375.0,4,S
2018-04-19 11:16:02,13490.0,10,19568,6,13365.0,18,13375.0,4,S
2018-04-19 11:16:05,13490.0,4,19572,-4,13365.0,18,13375.0,4,S
2018-04-19 11:16:05,13490.0,10,19582,8,13365.0,18,13375.0,4,S
2018-04-19 11:16:08,13495.0,10,19592,10,13365.0,18,13375.0,4,B
2018-04-19 11:16:22,13495.0,2,19594,2,13365.0,18,13375.0,4,B
2018-04-19 11:16:25,13495.0,6,19600,0,13365.0,18,13375.0,4,B
2018-04-19 11:16:27,13495.0,18,19618,14,13365.0,18,13375.0,4,B
2018-04-19 11:16:31,13495.0,4,19622,4,13365.0,18,13375.0,4,B
2018-04-19 11:16:32,13495.0,2,19624,2,13365.0,18,13375.0,4,B
2018-04-19 11:16:33,13500.0,6,19630,-4,13365.0,18,13375.0,4,B
2018-04-19 11:16:35,13500.0,4,19634,0,13365.0,18,13375.0,4,B
2018-04-19 11:16:35,13495.0,2,19636,2,13365.0,18,13375.0,4,S
2018-04-19 11:16:41,13495.0,10,19646,10,13365.0,18,13375.0,4,S
2018-04-19 11:16:46,13500.0,12,19658,2,13365.0,18,13375.0,4,B
2018-04-19 11:16:47,13500.0,14,19672,-12,13365.0,18,13375.0,4,B
2018-04-19 11:16:47,13500.0,6,19678,2,13365.0,18,13375.0,4,B
2018-04-19 11:16:48,13495.0,4,19682,4,13365.0,18,13375.0,4,S
2018-04-19 11:17:04,13500.0,2,19684,-2,13365.0,18,13375.0,4,B
2018-04-19 11:17:09,13500.0,40,19724,4,13365.0,18,13375.0,4,B
2018-04-19 11:17:18,13500.0,2,19726,0,13365.0,18,13375.0,4,B
2018-04-19 11:17:20,13500.0,10,19736,-10,13365.0,18,13375.0,4,B
2018-04-19 11:17:27,13495.0,4,19740,-4,13365.0,18,13375.0,4,S
2018-04-19 11:17:28,13495.0,24,19764,-18,13365.0,18,13375.0,4,S
2018-04-19 11:17:28,13495.0,8,19772,4,13365.0,18,13375.0,4,S
2018-04-19 11:17:32,13490.0,2,19774,2,13365.0,18,13375.0,4,S
2018-04-19 11:17:33,13490.0,24,19798,12,13365.0,18,13375.0,4,S
2018-04-19 11:17:33,13490.0,38,19836,8,13365.0,18,13375.0,4,S
2018-04-19 11:17:35,13490.0,6,19842,-2,13365.0,18,13375.0,4,S
2018-04-19 11:17:41,13485.0,2,19844,2,13365.0,18,13375.0,4,S
2018-04-19 11:17:46,13490.0,2,19846,0,13365.0,18,13375.0,4,B
2018-04-19 11:17:48,13485.0,2,19848,0,13365.0,18,13375.0,4,S
2018-04-19 11:17:51,13485.0,2,19850,0,13365.0,18,13375.0,4,S
2018-04-19 11:17:54,13485.0,2,19852,-2,13365.0,18,13375.0,4,S
2018-04-19 11:17:55,13485.0,2,19854,0,13365.0,18,13375.0,4,S
2018-04-19 11:17:56,13490.0,4,19858,0,13365.0,18,13375.0,4,B
2018-04-19 11:18:01,13490.0,12,19870,-2,13365.0,18,13375.0,4,B
2018-04-19 11:18:01,13475.0,56,19926,-8,13365.0,18,13375.0,4,S
2018-04-19 11:18:02,13480.0,30,19956,2,13365.0,18,13375.0,4,B
2018-04-19 11:18:02,13485.0,2,19958,-2,13365.0,18,13375.0,4,B
2018-04-19 11:18:03,13490.0,2,19960,0,13365.0,18,13375.0,4,B
2018-04-19 11:18:04,13485.0,10,19970,0,13365.0,18,13375.0,4,S
2018-04-19 11:18:08,13490.0,2,19972,0,13365.0,18,13375.0,4,B
2018-04-19 11:18:11,13490.0,4,19976,0,13365.0,18,13375.0,4,B
2018-04-19 11:18:13,13470.0,16,19992,4,13365.0,18,13375.0,4,S
2018-04-19 11:18:14,13465.0,14,20006,4,13365.0,18,13375.0,4,S
2018-04-19 11:18:14,13465.0,12,20018,0,13365.0,18,13375.0,4,S
2018-04-19 11:18:15,13470.0,4,20022,-2,13365.0,18,13375.0,4,B
2018-04-19 11:18:18,13475.0,2,20024,0,13365.0,18,13375.0,4,B
2018-04-19 11:18:19,13475.0,2,20026,-2,13365.0,18,13375.0,4,B
2018-04-19 11:18:23,13475.0,2,20028,0,13365.0,18,13375.0,4,B
2018-04-19 11:18:26,13475.0,2,20030,-2,13365.0,18,13375.0,4,B
2018-04-19 11:18:27,13480.0,4,20034,0,13365.0,18,13375.0,4,B
2018-04-19 11:18:30,13475.0,2,20036,0,13365.0,18,13375.0,4,S
2018-04-19 11:18:35,13475.0,6,20042,-2,13365.0,18,13375.0,4,S
2018-04-19 11:18:44,13475.0,2,20044,0,13365.0,18,13375.0,4,S
2018-04-19 11:18:50,13470.0,36,20080,-24,13365.0,18,13375.0,4,S
2018-04-19 11:18:50,13470.0,90,20170,-20,13365.0,18,13375.0,4,S
2018-04-19 11:18:51,13470.0,74,20244,-28,13365.0,18,13375.0,4,S
2018-04-19 11:18:58,13470.0,16,20260,-12,13365.0,18,13375.0,4,S
2018-04-19 11:18:58,13470.0,2,20262,0,13365.0,18,13375.0,4,S
2018-04-19 11:19:10,13470.0,6,20268,0,13365.0,18,13375.0,4,S
2018-04-19 11:19:14,13465.0,10,20278,-10,13365.0,18,13375.0,4,S
2018-04-19 11:19:16,13470.0,2,20280,2,13365.0,18,13375.0,4,B
2018-04-19 11:19:20,13470.0,12,20292,0,13365.0,18,13375.0,4,B
2018-04-19 11:19:20,13470.0,8,20300,-8,13365.0,18,13375.0,4,B
2018-04-19 11:19:22,13465.0,2,20302,0,13365.0,18,13375.0,4,S
2018-04-19 11:19:24,13465.0,2,20304,2,13365.0,18,13375.0,4,S
2018-04-19 11:19:28,13460.0,2,20306,0,13365.0,18,13375.0,4,S
2018-04-19 11:19:28,13460.0,2,20308,0,13365.0,18,13375.0,4,S
2018-04-19 11:19:34,13475.0,40,20348,12,13365.0,18,13375.0,4,B
2018-04-19 11:19:34,13475.0,158,20506,62,13365.0,18,13375.0,4,B
2018-04-19 11:19:35,13470.0,4,20510,-2,13365.0,18,13375.0,4,S
2018-04-19 11:19:39,13475.0,20,20530,12,13365.0,18,13375.0,4,B
2018-04-19 11:19:40,13475.0,24,20554,24,13365.0,18,13375.0,4,B
2018-04-19 11:19:42,13480.0,2,20556,-2,13365.0,18,13375.0,4,B
2018-04-19 11:19:43,13480.0,10,20566,0,13365.0,18,13375.0,4,B
2018-04-19 11:19:45,13475.0,4,20570,0,13365.0,18,13375.0,4,S
2018-04-19 11:19:46,13485.0,2,20572,0,13365.0,18,13375.0,4,B
2018-04-19 11:19:50,13480.0,6,20578,-6,13365.0,18,13375.0,4,S
2018-04-19 11:19:52,13485.0,2,20580,0,13365.0,18,13375.0,4,B
2018-04-19 11:19:59,13480.0,2,20582,-2,13365.0,18,13375.0,4,S
2018-04-19 11:20:00,13485.0,10,20592,8,13365.0,18,13375.0,4,B
2018-04-19 11:20:05,13480.0,2,20594,-2,13365.0,18,13375.0,4,S
2018-04-19 11:20:09,13480.0,2,20596,-2,13365.0,18,13375.0,4,S
2018-04-19 11:20:09,13485.0,2,20598,0,13365.0,18,13375.0,4,B
2018-04-19 11:20:18,13485.0,20,20618,-8,13365.0,18,13375.0,4,B
2018-04-19 11:20:19,13490.0,18,20636,12,13365.0,18,13375.0,4,B
2018-04-19 11:20:20,13490.0,28,20664,14,13365.0,18,13375.0,4,B
2018-04-19 11:20:20,13490.0,4,20668,0,13365.0,18,13375.0,4,B
2018-04-19 11:20:21,13490.0,4,20672,0,13365.0,18,13375.0,4,B
2018-04-19 11:20:21,13490.0,2,20674,2,13365.0,18,13375.0,4,B
2018-04-19 11:20:22,13495.0,4,20678,0,13365.0,18,13375.0,4,B
2018-04-19 11:20:26,13495.0,4,20682,2,13365.0,18,13375.0,4,B
2018-04-19 11:20:26,13495.0,4,20686,4,13365.0,18,13375.0,4,B
2018-04-19 11:20:27,13495.0,2,20688,2,13365.0,18,13375.0,4,B
2018-04-19 11:20:33,13500.0,2,20690,2,13365.0,18,13375.0,4,B
2018-04-19 11:20:35,13495.0,2,20692,-2,13365.0,18,13375.0,4,S
2018-04-19 11:20:36,13500.0,2,20694,2,13365.0,18,13375.0,4,B
2018-04-19 11:20:38,13500.0,10,20704,0,13365.0,18,13375.0,4,B
2018-04-19 11:20:38,13500.0,2,20706,0,13365.0,18,13375.0,4,B
2018-04-19 11:20:41,13500.0,2,20708,2,13365.0,18,13375.0,4,B
2018-04-19 11:20:42,13500.0,2,20710,2,13365.0,18,13375.0,4,B
2018-04-19 11:20:44,13500.0,2,20712,-2,13365.0,18,13375.0,4,B
2018-04-19 11:20:45,13495.0,4,20716,-4,13365.0,18,13375.0,4,S
2018-04-19 11:20:45,13495.0,8,20724,-2,13365.0,18,13375.0,4,S
2018-04-19 11:20:46,13490.0,12,20736,-10,13365.0,18,13375.0,4,S
2018-04-19 11:20:46,13495.0,6,20742,0,13365.0,18,13375.0,4,B
2018-04-19 11:20:54,13500.0,108,20850,10,13365.0,18,13375.0,4,B
2018-04-19 11:20:57,13495.0,8,20858,-4,13365.0,18,13375.0,4,S
2018-04-19 11:20:59,13490.0,8,20866,-2,13365.0,18,13375.0,4,S
2018-04-19 11:20:59,13490.0,2,20868,-2,13365.0,18,13375.0,4,S
2018-04-19 11:21:04,13495.0,4,20872,2,13365.0,18,13375.0,4,B
2018-04-19 11:21:05,13495.0,14,20886,-2,13365.0,18,13375.0,4,B
2018-04-19 11:21:27,13505.0,6,20892,0,13365.0,18,13375.0,4,B
2018-04-19 11:21:38,13505.0,2,20894,-2,13365.0,18,13375.0,4,B
2018-04-19 11:21:41,13505.0,6,20900,-6,13365.0,18,13375.0,4,B
2018-04-19 11:21:41,13510.0,10,20910,6,13365.0,18,13375.0,4,B
2018-04-19 11:21:46,13510.0,8,20918,4,13365.0,18,13375.0,4,B
2018-04-19 11:21:46,13515.0,4,20922,0,13365.0,18,13375.0,4,B
2018-04-19 11:21:47,13510.0,4,20926,0,13365.0,18,13375.0,4,S
2018-04-19 11:21:48,13515.0,4,20930,0,13365.0,18,13375.0,4,B
2018-04-19 11:21:52,13515.0,4,20934,4,13365.0,18,13375.0,4,B
2018-04-19 11:21:53,13520.0,2,20936,-2,13365.0,18,13375.0,4,B
2018-04-19 11:21:58,13510.0,2,20938,-2,13365.0,18,13375.0,4,S
2018-04-19 11:22:01,13515.0,2,20940,0,13365.0,18,13375.0,4,B
2018-04-19 11:22:03,13520.0,4,20944,4,13365.0,18,13375.0,4,B
2018-04-19 11:22:05,13515.0,2,20946,0,13365.0,18,13375.0,4,S
2018-04-19 11:22:06,13515.0,2,20948,-2,13365.0,18,13375.0,4,S
2018-04-19 11:22:08,13520.0,2,20950,-2,13365.0,18,13375.0,4,B
2018-04-19 11:22:12,13515.0,2,20952,0,13365.0,18,13375.0,4,S
2018-04-19 11:22:16,13520.0,2,20954,0,13365.0,18,13375.0,4,B
2018-04-19 11:22:18,13520.0,2,20956,2,13365.0,18,13375.0,4,B
2018-04-19 11:22:22,13525.0,20,20976,-4,13365.0,18,13375.0,4,B
2018-04-19 11:22:23,13530.0,6,20982,-2,13365.0,18,13375.0,4,B
2018-04-19 11:22:23,13530.0,6,20988,-2,13365.0,18,13375.0,4,B
2018-04-19 11:22:24,13530.0,14,21002,12,13365.0,18,13375.0,4,B
2018-04-19 11:22:26,13535.0,10,21012,2,13365.0,18,13375.0,4,B
2018-04-19 11:22:26,13535.0,2,21014,0,13365.0,18,13375.0,4,B
2018-04-19 11:22:28,13530.0,4,21018,4,13365.0,18,13375.0,4,S
2018-04-19 11:22:29,13530.0,6,21024,6,13365.0,18,13375.0,4,S
2018-04-19 11:22:31,13535.0,2,21026,0,13365.0,18,13375.0,4,B
2018-04-19 11:22:31,13535.0,8,21034,6,13365.0,18,13375.0,4,B
2018-04-19 11:22:32,13530.0,22,21056,22,13365.0,18,13375.0,4,S
2018-04-19 11:22:32,13535.0,10,21066,-10,13365.0,18,13375.0,4,B
2018-04-19 11:22:33,13530.0,6,21072,2,13365.0,18,13375.0,4,S
2018-04-19 11:22:33,13530.0,22,21094,0,13365.0,18,13375.0,4,S
2018-04-19 11:22:34,13540.0,20,21114,-2,13365.0,18,13375.0,4,B
2018-04-19 11:22:34,13535.0,6,21120,-2,13365.0,18,13375.0,4,S
2018-04-19 11:22:35,13540.0,22,21142,18,13365.0,18,13375.0,4,B
2018-04-19 11:22:35,13545.0,16,21158,14,13365.0,18,13375.0,4,B
2018-04-19 11:22:36,13550.0,10,21168,10,13365.0,18,13375.0,4,B
2018-04-19 11:22:37,13545.0,2,21170,2,13365.0,18,13375.0,4,S
2018-04-19 11:22:38,13540.0,4,21174,2,13365.0,18,13375.0,4,S
2018-04-19 11:22:40,13545.0,10,21184,8,13365.0,18,13375.0,4,B
2018-04-19 11:22:41,13550.0,2,21186,0,13365.0,18,13375.0,4,B
2018-04-19 11:22:41,13545.0,20,21206,14,13365.0,18,13375.0,4,S
2018-04-19 11:22:44,13545.0,4,21210,2,13365.0,18,13375.0,4,S
2018-04-19 11:22:45,13545.0,4,21214,-2,13365.0,18,13375.0,4,S
2018-04-19 11:22:45,13545.0,2,21216,-2,13365.0,18,13375.0,4,S
2018-04-19 11:22:46,13545.0,2,21218,0,13365.0,18,13375.0,4,S
2018-04-19 11:22:46,13545.0,2,21220,-2,13365.0,18,13375.0,4,S
2018-04-19 11:22:48,13550.0,2,21222,0,13365.0,18,13375.0,4,B
2018-04-19 11:22:49,13545.0,2,21224,0,13365.0,18,13375.0,4,S
2018-04-19 11:22:50,13545.0,4,21228,0,13365.0,18,13375.0,4,S
2018-04-19 11:22:50,13550.0,4,21232,2,13365.0,18,13375.0,4,B
2018-04-19 11:22:53,13550.0,2,21234,0,13365.0,18,13375.0,4,B
2018-04-19 11:22:54,13550.0,2,21236,2,13365.0,18,13375.0,4,B
2018-04-19 11:22:55,13555.0,16,21252,0,13365.0,18,13375.0,4,B
2018-04-19 11:22:55,13555.0,18,21270,-2,13365.0,18,13375.0,4,B
2018-04-19 11:22:58,13545.0,44,21314,-16,13365.0,18,13375.0,4,S
2018-04-19 11:23:00,13555.0,2,21316,0,13365.0,18,13375.0,4,B
2018-04-19 11:23:02,13545.0,4,21320,0,13365.0,18,13375.0,4,S
2018-04-19 11:23:05,13550.0,2,21322,-2,13365.0,18,13375.0,4,B
2018-04-19 11:23:06,13555.0,4,21326,4,13365.0,18,13375.0,4,B
2018-04-19 11:23:12,13545.0,8,21334,-2,13365.0,18,13375.0,4,S
2018-04-19 11:23:12,13545.0,2,21336,-2,13365.0,18,13375.0,4,S
2018-04-19 11:23:16,13545.0,10,21346,-10,13365.0,18,13375.0,4,S
2018-04-19 11:23:18,13540.0,6,21352,-2,13365.0,18,13375.0,4,S
2018-04-19 11:23:22,13535.0,4,21356,4,13365.0,18,13375.0,4,S
2018-04-19 11:23:24,13530.0,2,21358,2,13365.0,18,13375.0,4,S
2018-04-19 11:23:25,13535.0,6,21364,0,13365.0,18,13375.0,4,B
2018-04-19 11:23:27,13535.0,4,21368,0,13365.0,18,13375.0,4,B
2018-04-19 11:23:29,13535.0,4,21372,2,13365.0,18,13375.0,4,B
2018-04-19 11:23:30,13535.0,16,21388,4,13365.0,18,13375.0,4,B
2018-04-19 11:23:31,13535.0,2,21390,0,13365.0,18,13375.0,4,B
2018-04-19 11:23:34,13535.0,4,21394,-4,13365.0,18,13375.0,4,B
2018-04-19 11:23:34,13535.0,8,21402,-6,13365.0,18,13375.0,4,B
2018-04-19 11:23:35,13535.0,10,21412,-10,13365.0,18,13375.0,4,B
2018-04-19 11:23:39,13535.0,10,21422,0,13365.0,18,13375.0,4,B
2018-04-19 11:23:40,13535.0,92,21514,-92,13365.0,18,13375.0,4,B
2018-04-19 11:23:42,13535.0,2,21516,0,13365.0,18,13375.0,4,B
2018-04-19 11:23:45,13540.0,10,21526,-6,13365.0,18,13375.0,4,B
2018-04-19 11:23:46,13540.0,2,21528,2,13365.0,18,13375.0,4,B
2018-04-19 11:23:48,13550.0,12,21540,-6,13365.0,18,13375.0,4,B
2018-04-19 11:23:48,13545.0,4,21544,2,13365.0,18,13375.0,4,S
2018-04-19 11:23:49,13545.0,8,21552,-4,13365.0,18,13375.0,4,S
2018-04-19 11:23:50,13545.0,4,21556,2,13365.0,18,13375.0,4,S
2018-04-19 11:23:51,13545.0,24,21580,0,13365.0,18,13375.0,4,S
2018-04-19 11:23:53,13550.0,2,21582,0,13365.0,18,13375.0,4,B
2018-04-19 11:23:54,13550.0,2,21584,0,13365.0,18,13375.0,4,B
2018-04-19 11:23:56,13550.0,2,21586,0,13365.0,18,13375.0,4,B
2018-04-19 11:23:56,13550.0,2,21588,0,13365.0,18,13375.0,4,B
2018-04-19 11:23:57,13555.0,6,21594,0,13365.0,18,13375.0,4,B
2018-04-19 11:23:58,13545.0,12,21606,-8,13365.0,18,13375.0,4,S
2018-04-19 11:23:58,13545.0,4,21610,0,13365.0,18,13375.0,4,S
2018-04-19 11:23:59,13550.0,4,21614,0,13365.0,18,13375.0,4,B
2018-04-19 11:24:01,13545.0,8,21622,-4,13365.0,18,13375.0,4,S
2018-04-19 11:24:02,13545.0,4,21626,-2,13365.0,18,13375.0,4,S
2018-04-19 11:24:03,13550.0,2,21628,0,13365.0,18,13375.0,4,B
2018-04-19 11:24:04,13545.0,6,21634,-4,13365.0,18,13375.0,4,S
2018-04-19 11:24:05,13545.0,2,21636,0,13365.0,18,13375.0,4,S
2018-04-19 11:24:05,13550.0,2,21638,0,13365.0,18,13375.0,4,B
2018-04-19 11:24:06,13550.0,4,21642,-2,13365.0,18,13375.0,4,B
2018-04-19 11:24:08,13555.0,10,21652,10,13365.0,18,13375.0,4,B
2018-04-19 11:24:13,13550.0,2,21654,-2,13365.0,18,13375.0,4,S
2018-04-19 11:24:13,13550.0,2,21656,0,13365.0,18,13375.0,4,S
2018-04-19 11:24:17,13550.0,2,21658,0,13365.0,18,13375.0,4,S
2018-04-19 11:24:17,13555.0,4,21662,0,13365.0,18,13375.0,4,B
2018-04-19 11:24:20,13550.0,2,21664,-2,13365.0,18,13375.0,4,S
2018-04-19 11:24:22,13550.0,2,21666,-2,13365.0,18,13375.0,4,S
2018-04-19 11:24:25,13555.0,8,21674,0,13365.0,18,13375.0,4,B
2018-04-19 11:24:25,13550.0,18,21692,4,13365.0,18,13375.0,4,S
2018-04-19 11:24:26,13555.0,14,21706,0,13365.0,18,13375.0,4,B
2018-04-19 11:24:26,13555.0,4,21710,4,13365.0,18,13375.0,4,B
2018-04-19 11:24:27,13560.0,2,21712,0,13365.0,18,13375.0,4,B
2018-04-19 11:24:28,13550.0,2,21714,0,13365.0,18,13375.0,4,S
2018-04-19 11:24:29,13550.0,8,21722,-6,13365.0,18,13375.0,4,S
2018-04-19 11:24:30,13560.0,2,21724,2,13365.0,18,13375.0,4,B
2018-04-19 11:24:31,13560.0,2,21726,0,13365.0,18,13375.0,4,B
2018-04-19 11:24:32,13560.0,4,21730,4,13365.0,18,13375.0,4,B
2018-04-19 11:24:32,13560.0,18,21748,4,13365.0,18,13375.0,4,B
2018-04-19 11:24:34,13560.0,2,21750,2,13365.0,18,13375.0,4,B
2018-04-19 11:24:36,13560.0,2,21752,-2,13365.0,18,13375.0,4,B
2018-04-19 11:24:37,13565.0,2,21754,0,13365.0,18,13375.0,4,B
2018-04-19 11:24:37,13565.0,8,21762,2,13365.0,18,13375.0,4,B
2018-04-19 11:24:39,13565.0,4,21766,0,13365.0,18,13375.0,4,B
2018-04-19 11:24:40,13565.0,2,21768,0,13365.0,18,13375.0,4,B
2018-04-19 11:24:41,13565.0,4,21772,0,13365.0,18,13375.0,4,B
2018-04-19 11:24:42,13570.0,2,21774,2,13365.0,18,13375.0,4,B
2018-04-19 11:24:43,13570.0,2,21776,0,13365.0,18,13375.0,4,B
2018-04-19 11:24:43,13565.0,18,21794,-18,13365.0,18,13375.0,4,S
2018-04-19 11:24:44,13565.0,34,21828,-12,13365.0,18,13375.0,4,S
2018-04-19 11:24:50,13565.0,2,21830,-2,13365.0,18,13375.0,4,S
2018-04-19 11:24:50,13565.0,4,21834,0,13365.0,18,13375.0,4,S
2018-04-19 11:24:52,13565.0,4,21838,4,13365.0,18,13375.0,4,S
2018-04-19 11:24:52,13565.0,6,21844,0,13365.0,18,13375.0,4,S
2018-04-19 11:24:55,13570.0,8,21852,0,13365.0,18,13375.0,4,B
2018-04-19 11:24:58,13565.0,14,21866,-12,13365.0,18,13375.0,4,S
2018-04-19 11:24:59,13560.0,20,21886,-6,13365.0,18,13375.0,4,S
2018-04-19 11:24:59,13565.0,4,21890,-2,13365.0,18,13375.0,4,B
2018-04-19 11:25:00,13565.0,4,21894,0,13365.0,18,13375.0,4,B
2018-04-19 11:25:01,13570.0,6,21900,0,13365.0,18,13375.0,4,B
2018-04-19 11:25:01,13575.0,2,21902,2,13365.0,18,13375.0,4,B
2018-04-19 11:25:02,13580.0,4,21906,0,13365.0,18,13375.0,4,B
2018-04-19 11:25:02,13580.0,4,21910,4,13365.0,18,13375.0,4,B
2018-04-19 11:25:03,13580.0,14,21924,14,13365.0,18,13375.0,4,B
2018-04-19 11:25:04,13580.0,4,21928,0,13365.0,18,13375.0,4,B
2018-04-19 11:25:04,13575.0,16,21944,-14,13365.0,18,13375.0,4,S
2018-04-19 11:25:05,13575.0,2,21946,0,13365.0,18,13375.0,4,S
2018-04-19 11:25:05,13580.0,2,21948,0,13365.0,18,13375.0,4,B
2018-04-19 11:25:08,13580.0,2,21950,2,13365.0,18,13375.0,4,B
2018-04-19 11:25:08,13585.0,26,21976,-10,13365.0,18,13375.0,4,B
2018-04-19 11:25:09,13585.0,12,21988,12,13365.0,18,13375.0,4,B
2018-04-19 11:25:11,13585.0,2,21990,0,13365.0,18,13375.0,4,B
2018-04-19 11:25:12,13585.0,2,21992,-2,13365.0,18,13375.0,4,B
2018-04-19 11:25:15,13500.0,82,22074,50,13365.0,18,13375.0,4,S
2018-04-19 11:25:15,13565.0,108,22182,74,13365.0,18,13375.0,4,B
2018-04-19 11:25:16,13570.0,14,22196,-2,13365.0,18,13375.0,4,B
2018-04-19 11:25:16,13570.0,22,22218,-10,13365.0,18,13375.0,4,B
2018-04-19 11:25:17,13570.0,12,22230,2,13365.0,18,13375.0,4,B
2018-04-19 11:25:17,13570.0,2,22232,2,13365.0,18,13375.0,4,B
2018-04-19 11:25:18,13575.0,14,22246,12,13365.0,18,13375.0,4,B
2018-04-19 11:25:18,13575.0,6,22252,4,13365.0,18,13375.0,4,B
2018-04-19 11:25:19,13575.0,8,22260,8,13365.0,18,13375.0,4,B
2018-04-19 11:25:19,13580.0,2,22262,0,13365.0,18,13375.0,4,B
2018-04-19 11:25:20,13575.0,2,22264,2,13365.0,18,13375.0,4,S
2018-04-19 11:25:20,13575.0,16,22280,6,13365.0,18,13375.0,4,S
2018-04-19 11:25:21,13575.0,6,22286,0,13365.0,18,13375.0,4,S
2018-04-19 11:25:21,13575.0,2,22288,0,13365.0,18,13375.0,4,S
2018-04-19 11:25:22,13575.0,8,22296,0,13365.0,18,13375.0,4,S
2018-04-19 11:25:23,13565.0,2,22298,0,13365.0,18,13375.0,4,S
2018-04-19 11:25:24,13560.0,4,22302,4,13365.0,18,13375.0,4,S
2018-04-19 11:25:25,13555.0,4,22306,4,13365.0,18,13375.0,4,S
2018-04-19 11:25:25,13555.0,24,22330,2,13365.0,18,13375.0,4,S
2018-04-19 11:25:26,13560.0,2,22332,0,13365.0,18,13375.0,4,B
2018-04-19 11:25:30,13555.0,2,22334,-2,13365.0,18,13375.0,4,S
2018-04-19 11:25:30,13555.0,2,22336,0,13365.0,18,13375.0,4,S
2018-04-19 11:25:31,13560.0,2,22338,-2,13365.0,18,13375.0,4,B
2018-04-19 11:25:36,13565.0,2,22340,-2,13365.0,18,13375.0,4,B
2018-04-19 11:25:37,13555.0,2,22342,0,13365.0,18,13375.0,4,S
2018-04-19 11:25:39,13555.0,2,22344,0,13365.0,18,13375.0,4,S
2018-04-19 11:25:40,13565.0,2,22346,-2,13365.0,18,13375.0,4,B
2018-04-19 11:25:41,13555.0,6,22352,0,13365.0,18,13375.0,4,S
2018-04-19 11:25:43,13555.0,10,22362,0,13365.0,18,13375.0,4,S
2018-04-19 11:25:44,13560.0,14,22376,2,13365.0,18,13375.0,4,B
2018-04-19 11:25:47,13560.0,2,22378,0,13365.0,18,13375.0,4,B
2018-04-19 11:25:49,13565.0,2,22380,0,13365.0,18,13375.0,4,B
2018-04-19 11:25:49,13565.0,6,22386,2,13365.0,18,13375.0,4,B
2018-04-19 11:25:50,13570.0,2,22388,-2,13365.0,18,13375.0,4,B
2018-04-19 11:25:50,13565.0,4,22392,4,13365.0,18,13375.0,4,S
2018-04-19 11:25:51,13565.0,10,22402,8,13365.0,18,13375.0,4,S
2018-04-19 11:25:51,13565.0,16,22418,2,13365.0,18,13375.0,4,S
2018-04-19 11:25:52,13560.0,24,22442,22,13365.0,18,13375.0,4,S
2018-04-19 11:25:53,13565.0,24,22466,22,13365.0,18,13375.0,4,B
2018-04-19 11:25:53,13570.0,108,22574,96,13365.0,18,13375.0,4,B
2018-04-19 11:25:54,13570.0,6,22580,4,13365.0,18,13375.0,4,B
2018-04-19 11:25:55,13570.0,6,22586,6,13365.0,18,13375.0,4,B
2018-04-19 11:25:55,13570.0,4,22590,-2,13365.0,18,13375.0,4,B
2018-04-19 11:25:56,13575.0,8,22598,4,13365.0,18,13375.0,4,B
2018-04-19 11:25:57,13575.0,4,22602,4,13365.0,18,13375.0,4,B
2018-04-19 11:25:57,13580.0,4,22606,0,13365.0,18,13375.0,4,B
2018-04-19 11:25:58,13590.0,16,22622,6,13365.0,18,13375.0,4,B
2018-04-19 11:25:58,13580.0,26,22648,4,13365.0,18,13375.0,4,S
2018-04-19 11:25:59,13575.0,2,22650,2,13365.0,18,13375.0,4,S
2018-04-19 11:25:59,13585.0,2,22652,0,13365.0,18,13375.0,4,B
2018-04-19 11:26:00,13590.0,10,22662,4,13365.0,18,13375.0,4,B
2018-04-19 11:26:00,13585.0,14,22676,2,13365.0,18,13375.0,4,S
2018-04-19 11:26:01,13585.0,4,22680,-4,13365.0,18,13375.0,4,S
2018-04-19 11:26:01,13590.0,6,22686,2,13365.0,18,13375.0,4,B
2018-04-19 11:26:02,13590.0,4,22690,0,13365.0,18,13375.0,4,B
2018-04-19 11:26:03,13590.0,8,22698,-8,13365.0,18,13375.0,4,B
2018-04-19 11:26:03,13595.0,2,22700,2,13365.0,18,13375.0,4,B
2018-04-19 11:26:04,13595.0,16,22716,14,13365.0,18,13375.0,4,B
2018-04-19 11:26:04,13595.0,4,22720,4,13365.0,18,13375.0,4,B
2018-04-19 11:26:05,13600.0,14,22734,10,13365.0,18,13375.0,4,B
2018-04-19 11:26:05,13600.0,6,22740,-2,13365.0,18,13375.0,4,B
2018-04-19 11:26:06,13600.0,2,22742,-2,13365.0,18,13375.0,4,B
2018-04-19 11:26:06,13600.0,42,22784,38,13365.0,18,13375.0,4,B
2018-04-19 11:26:07,13600.0,14,22798,4,13365.0,18,13375.0,4,B
2018-04-19 11:26:07,13605.0,6,22804,2,13365.0,18,13375.0,4,B
2018-04-19 11:26:08,13600.0,12,22816,12,13365.0,18,13375.0,4,S
2018-04-19 11:26:08,13600.0,2,22818,0,13365.0,18,13375.0,4,S
2018-04-19 11:26:09,13600.0,2,22820,0,13365.0,18,13375.0,4,S
2018-04-19 11:26:11,13615.0,4,22824,4,13365.0,18,13375.0,4,B
2018-04-19 11:26:12,13615.0,2,22826,2,13365.0,18,13375.0,4,B
2018-04-19 11:26:13,13620.0,4,22830,2,13365.0,18,13375.0,4,B
2018-04-19 11:26:14,13630.0,4,22834,-2,13365.0,18,13375.0,4,B
2018-04-19 11:26:14,13625.0,8,22842,-6,13365.0,18,13375.0,4,S
2018-04-19 11:26:15,13620.0,4,22846,2,13365.0,18,13375.0,4,S
2018-04-19 11:26:15,13620.0,18,22864,0,13365.0,18,13375.0,4,S
2018-04-19 11:26:16,13620.0,24,22888,0,13365.0,18,13375.0,4,S
2018-04-19 11:26:16,13620.0,92,22980,-52,13365.0,18,13375.0,4,S
2018-04-19 11:26:17,13620.0,2,22982,0,13365.0,18,13375.0,4,S
2018-04-19 11:26:17,13620.0,4,22986,0,13365.0,18,13375.0,4,S
2018-04-19 11:26:18,13620.0,2,22988,-2,13365.0,18,13375.0,4,S
2018-04-19 11:26:18,13620.0,16,23004,0,13365.0,18,13375.0,4,S
2018-04-19 11:26:19,13615.0,22,23026,0,13365.0,18,13375.0,4,S
2018-04-19 11:26:19,13600.0,24,23050,0,13365.0,18,13375.0,4,S
2018-04-19 11:26:20,13620.0,2,23052,0,13365.0,18,13375.0,4,B
2018-04-19 11:26:21,13615.0,2,23054,-2,13365.0,18,13375.0,4,S
2018-04-19 11:26:21,13615.0,2,23056,-2,13365.0,18,13375.0,4,S
2018-04-19 11:26:22,13615.0,8,23064,2,13365.0,18,13375.0,4,S
2018-04-19 11:26:24,13605.0,28,23092,-6,13365.0,18,13375.0,4,S
2018-04-19 11:26:27,13610.0,2,23094,0,13365.0,18,13375.0,4,B
2018-04-19 11:26:29,13600.0,8,23102,8,13365.0,18,13375.0,4,S
2018-04-19 11:26:29,13610.0,2,23104,0,13365.0,18,13375.0,4,B
2018-04-19 11:26:31,13600.0,2,23106,0,13365.0,18,13375.0,4,S
2018-04-19 11:26:31,13600.0,2,23108,0,13365.0,18,13375.0,4,S
2018-04-19 11:26:32,13605.0,2,23110,2,13365.0,18,13375.0,4,B
2018-04-19 11:26:32,13605.0,8,23118,4,13365.0,18,13375.0,4,B
2018-04-19 11:26:33,13605.0,8,23126,6,13365.0,18,13375.0,4,B
2018-04-19 11:26:33,13605.0,4,23130,4,13365.0,18,13375.0,4,B
2018-04-19 11:26:35,13600.0,6,23136,-4,13365.0,18,13375.0,4,S
2018-04-19 11:26:37,13600.0,2,23138,2,13365.0,18,13375.0,4,S
2018-04-19 11:26:38,13595.0,12,23150,-4,13365.0,18,13375.0,4,S
2018-04-19 11:26:41,13590.0,2,23152,0,13365.0,18,13375.0,4,S
2018-04-19 11:26:42,13600.0,6,23158,2,13365.0,18,13375.0,4,B
2018-04-19 11:26:43,13600.0,34,23192,26,13365.0,18,13375.0,4,B
2018-04-19 11:26:44,13590.0,2,23194,2,13365.0,18,13375.0,4,S
2018-04-19 11:26:44,13590.0,2,23196,0,13365.0,18,13375.0,4,S
2018-04-19 11:26:48,13590.0,10,23206,-6,13365.0,18,13375.0,4,S
2018-04-19 11:26:48,13590.0,4,23210,-4,13365.0,18,13375.0,4,S
2018-04-19 11:26:49,13590.0,2,23212,0,13365.0,18,13375.0,4,S
2018-04-19 11:26:49,13590.0,2,23214,-2,13365.0,18,13375.0,4,S
2018-04-19 11:26:50,13590.0,2,23216,-2,13365.0,18,13375.0,4,S
2018-04-19 11:26:51,13590.0,8,23224,-8,13365.0,18,13375.0,4,S
2018-04-19 11:26:52,13590.0,2,23226,2,13365.0,18,13375.0,4,S
2018-04-19 11:26:53,13590.0,2,23228,2,13365.0,18,13375.0,4,S
2018-04-19 11:26:53,13595.0,18,23246,-12,13365.0,18,13375.0,4,B
2018-04-19 11:26:54,13595.0,2,23248,0,13365.0,18,13375.0,4,B
2018-04-19 11:26:56,13590.0,4,23252,-4,13365.0,18,13375.0,4,S
2018-04-19 11:26:56,13590.0,2,23254,-2,13365.0,18,13375.0,4,S
2018-04-19 11:26:58,13600.0,22,23276,-12,13365.0,18,13375.0,4,B
2018-04-19 11:26:59,13590.0,8,23284,-2,13365.0,18,13375.0,4,S
2018-04-19 11:27:02,13600.0,6,23290,-2,13365.0,18,13375.0,4,B
2018-04-19 11:27:04,13610.0,4,23294,-2,13365.0,18,13375.0,4,B
2018-04-19 11:27:05,13610.0,12,23306,-4,13365.0,18,13375.0,4,B
2018-04-19 11:27:05,13610.0,2,23308,2,13365.0,18,13375.0,4,B
2018-04-19 11:27:06,13615.0,6,23314,0,13365.0,18,13375.0,4,B
2018-04-19 11:27:07,13605.0,8,23322,2,13365.0,18,13375.0,4,S
2018-04-19 11:27:07,13615.0,2,23324,2,13365.0,18,13375.0,4,B
2018-04-19 11:27:09,13615.0,2,23326,-2,13365.0,18,13375.0,4,B
2018-04-19 11:27:09,13615.0,2,23328,0,13365.0,18,13375.0,4,B
2018-04-19 11:27:10,13615.0,2,23330,0,13365.0,18,13375.0,4,B
2018-04-19 11:27:11,13615.0,2,23332,0,13365.0,18,13375.0,4,B
2018-04-19 11:27:12,13620.0,30,23362,0,13365.0,18,13375.0,4,B
2018-04-19 11:27:12,13620.0,28,23390,-14,13365.0,18,13375.0,4,B
2018-04-19 11:27:14,13625.0,4,23394,4,13365.0,18,13375.0,4,B
2018-04-19 11:27:15,13620.0,6,23400,0,13365.0,18,13375.0,4,S
2018-04-19 11:27:15,13620.0,4,23404,0,13365.0,18,13375.0,4,S
2018-04-19 11:27:16,13620.0,2,23406,0,13365.0,18,13375.0,4,S
2018-04-19 11:27:18,13620.0,2,23408,0,13365.0,18,13375.0,4,S
2018-04-19 11:27:19,13620.0,4,23412,4,13365.0,18,13375.0,4,S
2018-04-19 11:27:20,13630.0,22,23434,-10,13365.0,18,13375.0,4,B
2018-04-19 11:27:22,13625.0,2,23436,0,13365.0,18,13375.0,4,S
2018-04-19 11:27:26,13620.0,6,23442,-2,13365.0,18,13375.0,4,S
2018-04-19 11:27:27,13620.0,30,23472,-16,13365.0,18,13375.0,4,S
2018-04-19 11:27:29,13615.0,4,23476,2,13365.0,18,13375.0,4,S
2018-04-19 11:27:30,13620.0,4,23480,4,13365.0,18,13375.0,4,B
2018-04-19 11:27:31,13625.0,4,23484,2,13365.0,18,13375.0,4,B
2018-04-19 11:27:32,13625.0,4,23488,-2,13365.0,18,13375.0,4,B
2018-04-19 11:27:34,13630.0,4,23492,0,13365.0,18,13375.0,4,B
2018-04-19 11:27:35,13630.0,2,23494,2,13365.0,18,13375.0,4,B
2018-04-19 11:27:36,13625.0,2,23496,2,13365.0,18,13375.0,4,S
2018-04-19 11:27:38,13620.0,2,23498,-2,13365.0,18,13375.0,4,S
2018-04-19 11:27:39,13620.0,2,23500,-2,13365.0,18,13375.0,4,S
2018-04-19 11:27:39,13620.0,2,23502,0,13365.0,18,13375.0,4,S
2018-04-19 11:27:40,13620.0,6,23508,-6,13365.0,18,13375.0,4,S
2018-04-19 11:27:52,13620.0,2,23510,0,13365.0,18,13375.0,4,S
2018-04-19 11:27:52,13620.0,2,23512,2,13365.0,18,13375.0,4,S
2018-04-19 11:27:56,13620.0,2,23514,0,13365.0,18,13375.0,4,S
2018-04-19 11:27:58,13620.0,12,23526,10,13365.0,18,13375.0,4,S
2018-04-19 11:27:58,13620.0,14,23540,8,13365.0,18,13375.0,4,S
2018-04-19 11:28:00,13620.0,2,23542,0,13365.0,18,13375.0,4,S
2018-04-19 11:28:01,13620.0,14,23556,0,13365.0,18,13375.0,4,S
2018-04-19 11:28:02,13620.0,4,23560,0,13365.0,18,13375.0,4,S
2018-04-19 11:28:04,13615.0,2,23562,2,13365.0,18,13375.0,4,S
2018-04-19 11:28:04,13610.0,34,23596,20,13365.0,18,13375.0,4,S
2018-04-19 11:28:05,13610.0,30,23626,0,13365.0,18,13375.0,4,S
2018-04-19 11:28:07,13615.0,2,23628,0,13365.0,18,13375.0,4,B
2018-04-19 11:28:08,13610.0,2,23630,0,13365.0,18,13375.0,4,S
2018-04-19 11:28:08,13610.0,2,23632,2,13365.0,18,13375.0,4,S
2018-04-19 11:28:10,13615.0,2,23634,2,13365.0,18,13375.0,4,B
2018-04-19 11:28:11,13615.0,4,23638,-2,13365.0,18,13375.0,4,B
2018-04-19 11:28:12,13620.0,4,23642,-4,13365.0,18,13375.0,4,B
2018-04-19 11:28:15,13615.0,2,23644,-2,13365.0,18,13375.0,4,S
2018-04-19 11:28:17,13615.0,2,23646,-2,13365.0,18,13375.0,4,S
2018-04-19 11:28:18,13615.0,4,23650,0,13365.0,18,13375.0,4,S
2018-04-19 11:28:19,13615.0,2,23652,0,13365.0,18,13375.0,4,S
2018-04-19 11:28:22,13620.0,6,23658,0,13365.0,18,13375.0,4,B
2018-04-19 11:28:22,13620.0,12,23670,0,13365.0,18,13375.0,4,B
2018-04-19 11:28:23,13620.0,18,23688,-10,13365.0,18,13375.0,4,B
2018-04-19 11:28:24,13630.0,4,23692,0,13365.0,18,13375.0,4,B
2018-04-19 11:28:24,13630.0,4,23696,0,13365.0,18,13375.0,4,B
2018-04-19 11:28:25,13630.0,6,23702,2,13365.0,18,13375.0,4,B
2018-04-19 11:28:27,13635.0,2,23704,0,13365.0,18,13375.0,4,B
2018-04-19 11:28:27,13625.0,2,23706,-2,13365.0,18,13375.0,4,S
2018-04-19 11:28:29,13635.0,4,23710,4,13365.0,18,13375.0,4,B
2018-04-19 11:28:30,13625.0,2,23712,0,13365.0,18,13375.0,4,S
2018-04-19 11:28:31,13625.0,10,23722,0,13365.0,18,13375.0,4,S
2018-04-19 11:28:33,13630.0,2,23724,0,13365.0,18,13375.0,4,B
2018-04-19 11:28:33,13635.0,14,23738,-10,13365.0,18,13375.0,4,B
2018-04-19 11:28:34,13640.0,10,23748,2,13365.0,18,13375.0,4,B
2018-04-19 11:28:34,13645.0,2,23750,0,13365.0,18,13375.0,4,B
2018-04-19 11:28:35,13635.0,4,23754,4,13365.0,18,13375.0,4,S
2018-04-19 11:28:36,13635.0,32,23786,-10,13365.0,18,13375.0,4,S
2018-04-19 11:28:36,13635.0,6,23792,-4,13365.0,18,13375.0,4,S
2018-04-19 11:28:37,13635.0,30,23822,-6,13365.0,18,13375.0,4,S
2018-04-19 11:28:38,13645.0,14,23836,12,13365.0,18,13375.0,4,B
2018-04-19 11:28:38,13645.0,4,23840,2,13365.0,18,13375.0,4,B
2018-04-19 11:28:41,13640.0,2,23842,0,13365.0,18,13375.0,4,S
2018-04-19 11:28:41,13635.0,6,23848,4,13365.0,18,13375.0,4,S
2018-04-19 11:28:42,13645.0,4,23852,2,13365.0,18,13375.0,4,B
2018-04-19 11:28:43,13635.0,6,23858,0,13365.0,18,13375.0,4,S
2018-04-19 11:28:45,13635.0,2,23860,-2,13365.0,18,13375.0,4,S
2018-04-19 11:28:54,13630.0,10,23870,-2,13365.0,18,13375.0,4,S
2018-04-19 11:28:55,13630.0,6,23876,-2,13365.0,18,13375.0,4,S
2018-04-19 11:28:56,13630.0,4,23880,-4,13365.0,18,13375.0,4,S
2018-04-19 11:28:56,13625.0,6,23886,0,13365.0,18,13375.0,4,S
2018-04-19 11:28:58,13625.0,4,23890,4,13365.0,18,13375.0,4,S
2018-04-19 11:29:00,13635.0,22,23912,16,13365.0,18,13375.0,4,B
2018-04-19 11:29:00,13630.0,36,23948,14,13365.0,18,13375.0,4,S
2018-04-19 11:29:01,13630.0,22,23970,0,13365.0,18,13375.0,4,S
2018-04-19 11:29:02,13630.0,6,23976,2,13365.0,18,13375.0,4,S
2018-04-19 11:29:03,13630.0,4,23980,-2,13365.0,18,13375.0,4,S
2018-04-19 11:29:04,13630.0,2,23982,0,13365.0,18,13375.0,4,S
2018-04-19 11:29:05,13630.0,2,23984,2,13365.0,18,13375.0,4,S
2018-04-19 11:29:06,13625.0,2,23986,-2,13365.0,18,13375.0,4,S
2018-04-19 11:29:08,13625.0,2,23988,0,13365.0,18,13375.0,4,S
2018-04-19 11:29:09,13630.0,12,24000,12,13365.0,18,13375.0,4,B
2018-04-19 11:29:10,13635.0,6,24006,0,13365.0,18,13375.0,4,B
2018-04-19 11:29:11,13635.0,6,24012,-4,13365.0,18,13375.0,4,B
2018-04-19 11:29:12,13635.0,4,24016,0,13365.0,18,13375.0,4,B
2018-04-19 11:29:12,13635.0,14,24030,-12,13365.0,18,13375.0,4,B
2018-04-19 11:29:14,13635.0,4,24034,0,13365.0,18,13375.0,4,B
2018-04-19 11:29:15,13630.0,2,24036,0,13365.0,18,13375.0,4,S
2018-04-19 11:29:17,13630.0,30,24066,0,13365.0,18,13375.0,4,S
2018-04-19 11:29:18,13630.0,2,24068,0,13365.0,18,13375.0,4,S
2018-04-19 11:29:18,13630.0,26,24094,-4,13365.0,18,13375.0,4,S
2018-04-19 11:29:19,13635.0,4,24098,0,13365.0,18,13375.0,4,B
2018-04-19 11:29:20,13640.0,6,24104,4,13365.0,18,13375.0,4,B
2018-04-19 11:29:22,13640.0,4,24108,2,13365.0,18,13375.0,4,B
2018-04-19 11:29:22,13635.0,4,24112,2,13365.0,18,13375.0,4,S
2018-04-19 11:29:23,13640.0,4,24116,0,13365.0,18,13375.0,4,B
2018-04-19 11:29:24,13640.0,2,24118,0,13365.0,18,13375.0,4,B
2018-04-19 11:29:25,13640.0,4,24122,2,13365.0,18,13375.0,4,B
2018-04-19 11:29:26,13640.0,8,24130,2,13365.0,18,13375.0,4,B
2018-04-19 11:29:28,13640.0,2,24132,-2,13365.0,18,13375.0,4,B
2018-04-19 11:29:28,13640.0,2,24134,-2,13365.0,18,13375.0,4,B
2018-04-19 11:29:29,13640.0,16,24150,4,13365.0,18,13375.0,4,B
2018-04-19 11:29:30,13635.0,4,24154,0,13365.0,18,13375.0,4,S
2018-04-19 11:29:30,13640.0,6,24160,4,13365.0,18,13375.0,4,B
2018-04-19 11:29:31,13645.0,6,24166,0,13365.0,18,13375.0,4,B
2018-04-19 11:29:33,13645.0,10,24176,4,13365.0,18,13375.0,4,B
2018-04-19 11:29:34,13645.0,14,24190,2,13365.0,18,13375.0,4,B
2018-04-19 11:29:34,13645.0,2,24192,0,13365.0,18,13375.0,4,B
2018-04-19 11:29:35,13640.0,2,24194,-2,13365.0,18,13375.0,4,S
2018-04-19 11:29:35,13650.0,2,24196,2,13365.0,18,13375.0,4,B
2018-04-19 11:29:36,13645.0,2,24198,2,13365.0,18,13375.0,4,S
2018-04-19 11:29:37,13650.0,12,24210,-2,13365.0,18,13375.0,4,B
2018-04-19 11:29:39,13640.0,2,24212,-2,13365.0,18,13375.0,4,S
2018-04-19 11:29:41,13640.0,2,24214,2,13365.0,18,13375.0,4,S
2018-04-19 11:29:41,13650.0,12,24226,-4,13365.0,18,13375.0,4,B
2018-04-19 11:29:44,13645.0,4,24230,4,13365.0,18,13375.0,4,S
2018-04-19 11:29:45,13650.0,12,24242,-6,13365.0,18,13375.0,4,B
2018-04-19 11:29:48,13650.0,12,24254,-6,13365.0,18,13375.0,4,B
2018-04-19 11:29:50,13650.0,2,24256,0,13365.0,18,13375.0,4,B
2018-04-19 11:29:53,13640.0,14,24270,-10,13365.0,18,13375.0,4,S
2018-04-19 11:29:55,13660.0,14,24284,-4,13365.0,18,13375.0,4,B
2018-04-19 11:29:55,13660.0,10,24294,-4,13365.0,18,13375.0,4,B
2018-04-19 11:29:57,13655.0,2,24296,0,13365.0,18,13375.0,4,S
2018-04-19 13:30:00,13665.0,146,24442,84,13365.0,18,13375.0,4,B
2018-04-19 13:30:01,13695.0,8,24450,0,13365.0,18,13375.0,4,B
2018-04-19 13:30:01,13700.0,68,24518,-20,13365.0,18,13375.0,4,B
2018-04-19 13:30:02,13755.0,92,24610,18,13365.0,18,13375.0,4,B
2018-04-19 13:30:02,13800.0,56,24666,10,13365.0,18,13375.0,4,B
2018-04-19 13:30:03,13760.0,16,24682,-4,13365.0,18,13375.0,4,S
2018-04-19 13:30:03,13710.0,40,24722,8,13365.0,18,13375.0,4,S
2018-04-19 13:30:04,13745.0,16,24738,6,13365.0,18,13375.0,4,B
2018-04-19 13:30:04,13770.0,24,24762,6,13365.0,18,13375.0,4,B
2018-04-19 13:30:05,13755.0,36,24798,4,13365.0,18,13375.0,4,S
2018-04-19 13:30:05,13760.0,6,24804,6,13365.0,18,13375.0,4,B
2018-04-19 13:30:06,13785.0,4,24808,-2,13365.0,18,13375.0,4,B
2018-04-19 13:30:06,13775.0,10,24818,0,13365.0,18,13375.0,4,S
2018-04-19 13:30:07,13760.0,12,24830,-4,13365.0,18,13375.0,4,S
2018-04-19 13:30:07,13755.0,22,24852,8,13365.0,18,13375.0,4,S
2018-04-19 13:30:08,13765.0,10,24862,8,13365.0,18,13375.0,4,B
2018-04-19 13:30:09,13790.0,12,24874,4,13365.0,18,13375.0,4,B
2018-04-19 13:30:09,13795.0,20,24894,4,13365.0,18,13375.0,4,B
2018-04-19 13:30:10,13785.0,24,24918,0,13365.0,18,13375.0,4,S
2018-04-19 13:30:10,13785.0,2,24920,0,13365.0,18,13375.0,4,S
2018-04-19 13:30:11,13805.0,40,24960,32,13365.0,18,13375.0,4,B
2018-04-19 13:30:11,13805.0,26,24986,4,13365.0,18,13375.0,4,B
2018-04-19 13:30:12,13815.0,16,25002,2,13365.0,18,13375.0,4,B
2018-04-19 13:30:12,13815.0,2,25004,-2,13365.0,18,13375.0,4,B
2018-04-19 13:30:13,13805.0,26,25030,0,13365.0,18,13375.0,4,S
2018-04-19 13:30:13,13800.0,14,25044,2,13365.0,18,13375.0,4,S
2018-04-19 13:30:14,13810.0,4,25048,-2,13365.0,18,13375.0,4,B
2018-04-19 13:30:14,13815.0,16,25064,-12,13365.0,18,13375.0,4,B
2018-04-19 13:30:15,13800.0,22,25086,2,13365.0,18,13375.0,4,S
2018-04-19 13:30:15,13805.0,6,25092,0,13365.0,18,13375.0,4,B
2018-04-19 13:30:16,13795.0,44,25136,30,13365.0,18,13375.0,4,S
2018-04-19 13:30:17,13795.0,8,25144,0,13365.0,18,13375.0,4,S
2018-04-19 13:30:17,13795.0,20,25164,-4,13365.0,18,13375.0,4,S
2018-04-19 13:30:18,13795.0,44,25208,-42,13365.0,18,13375.0,4,S
2018-04-19 13:30:19,13795.0,42,25250,-10,13365.0,18,13375.0,4,S
2018-04-19 13:30:20,13795.0,2,25252,2,13365.0,18,13375.0,4,S
2018-04-19 13:30:20,13775.0,6,25258,0,13365.0,18,13375.0,4,S
2018-04-19 13:30:21,13780.0,4,25262,0,13365.0,18,13375.0,4,B
2018-04-19 13:30:23,13780.0,2,25264,0,13365.0,18,13375.0,4,B
2018-04-19 13:30:23,13785.0,4,25268,-2,13365.0,18,13375.0,4,B
2018-04-19 13:30:24,13770.0,2,25270,-2,13365.0,18,13375.0,4,S
2018-04-19 13:30:24,13775.0,12,25282,-4,13365.0,18,13375.0,4,B
2018-04-19 13:30:25,13785.0,8,25290,6,13365.0,18,13375.0,4,B
2018-04-19 13:30:25,13775.0,2,25292,0,13365.0,18,13375.0,4,S
2018-04-19 13:30:27,13770.0,30,25322,6,13365.0,18,13375.0,4,S
2018-04-19 13:30:27,13770.0,2,25324,0,13365.0,18,13375.0,4,S
2018-04-19 13:30:28,13775.0,4,25328,0,13365.0,18,13375.0,4,B
2018-04-19 13:30:29,13775.0,8,25336,8,13365.0,18,13375.0,4,B
2018-04-19 13:30:29,13770.0,18,25354,-4,13365.0,18,13375.0,4,S
2018-04-19 13:30:30,13785.0,4,25358,4,13365.0,18,13375.0,4,B
2018-04-19 13:30:30,13790.0,16,25374,0,13365.0,18,13375.0,4,B
2018-04-19 13:30:32,13790.0,6,25380,0,13365.0,18,13375.0,4,B
2018-04-19 13:30:32,13775.0,2,25382,-2,13365.0,18,13375.0,4,S
2018-04-19 13:30:33,13785.0,16,25398,4,13365.0,18,13375.0,4,B
2018-04-19 13:30:33,13785.0,2,25400,0,13365.0,18,13375.0,4,B
2018-04-19 13:30:34,13790.0,14,25414,0,13365.0,18,13375.0,4,B
2018-04-19 13:30:34,13770.0,12,25426,-10,13365.0,18,13375.0,4,S
2018-04-19 13:30:35,13795.0,10,25436,-8,13365.0,18,13375.0,4,B
2018-04-19 13:30:36,13790.0,12,25448,-4,13365.0,18,13375.0,4,S
2018-04-19 13:30:36,13795.0,4,25452,0,13365.0,18,13375.0,4,B
2018-04-19 13:30:37,13795.0,6,25458,6,13365.0,18,13375.0,4,B
2018-04-19 13:30:37,13790.0,2,25460,0,13365.0,18,13375.0,4,S
2018-04-19 13:30:38,13790.0,2,25462,-2,13365.0,18,13375.0,4,S
2018-04-19 13:30:38,13795.0,18,25480,-2,13365.0,18,13375.0,4,B
2018-04-19 13:30:39,13800.0,10,25490,-8,13365.0,18,13375.0,4,B
2018-04-19 13:30:40,13790.0,2,25492,-2,13365.0,18,13375.0,4,S
2018-04-19 13:30:41,13795.0,8,25500,0,13365.0,18,13375.0,4,B
2018-04-19 13:30:42,13795.0,28,25528,18,13365.0,18,13375.0,4,B
2018-04-19 13:30:42,13800.0,12,25540,6,13365.0,18,13375.0,4,B
2018-04-19 13:30:43,13800.0,4,25544,-2,13365.0,18,13375.0,4,B
2018-04-19 13:30:44,13800.0,2,25546,-2,13365.0,18,13375.0,4,B
2018-04-19 13:30:45,13805.0,2,25548,-2,13365.0,18,13375.0,4,B
2018-04-19 13:30:45,13810.0,2,25550,0,13365.0,18,13375.0,4,B
2018-04-19 13:30:46,13810.0,2,25552,2,13365.0,18,13375.0,4,B
2018-04-19 13:30:46,13815.0,4,25556,4,13365.0,18,13375.0,4,B
2018-04-19 13:30:47,13795.0,18,25574,-2,13365.0,18,13375.0,4,S
2018-04-19 13:30:47,13820.0,4,25578,2,13365.0,18,13375.0,4,B
2018-04-19 13:30:48,13830.0,2,25580,0,13365.0,18,13375.0,4,B
2018-04-19 13:30:48,13830.0,8,25588,-2,13365.0,18,13375.0,4,B
2018-04-19 13:30:49,13825.0,2,25590,0,13365.0,18,13375.0,4,S
2018-04-19 13:30:49,13850.0,20,25610,14,13365.0,18,13375.0,4,B
2018-04-19 13:30:50,13835.0,4,25614,0,13365.0,18,13375.0,4,S
2018-04-19 13:30:50,13830.0,6,25620,6,13365.0,18,13375.0,4,S
2018-04-19 13:30:51,13835.0,14,25634,8,13365.0,18,13375.0,4,B
2018-04-19 13:30:51,13830.0,4,25638,4,13365.0,18,13375.0,4,S
2018-04-19 13:30:52,13835.0,4,25642,-4,13365.0,18,13375.0,4,B
2018-04-19 13:30:54,13835.0,18,25660,10,13365.0,18,13375.0,4,B
2018-04-19 13:30:54,13835.0,6,25666,-2,13365.0,18,13375.0,4,B
2018-04-19 13:30:55,13830.0,2,25668,2,13365.0,18,13375.0,4,S
2018-04-19 13:30:55,13825.0,4,25672,4,13365.0,18,13375.0,4,S
2018-04-19 13:30:56,13830.0,2,25674,0,13365.0,18,13375.0,4,B
2018-04-19 13:30:56,13830.0,6,25680,-2,13365.0,18,13375.0,4,B
2018-04-19 13:30:58,13820.0,2,25682,0,13365.0,18,13375.0,4,S
2018-04-19 13:30:59,13820.0,22,25704,-18,13365.0,18,13375.0,4,S
2018-04-19 13:31:00,13810.0,2,25706,2,13365.0,18,13375.0,4,S
2018-04-19 13:31:02,13805.0,10,25716,0,13365.0,18,13375.0,4,S
2018-04-19 13:31:03,13805.0,16,25732,2,13365.0,18,13375.0,4,S
2018-04-19 13:31:03,13800.0,2,25734,2,13365.0,18,13375.0,4,S
2018-04-19 13:31:04,13800.0,2,25736,2,13365.0,18,13375.0,4,S
2018-04-19 13:31:04,13800.0,6,25742,4,13365.0,18,13375.0,4,S
2018-04-19 13:31:05,13795.0,4,25746,4,13365.0,18,13375.0,4,S
2018-04-19 13:31:05,13795.0,10,25756,8,13365.0,18,13375.0,4,S
2018-04-19 13:31:06,13765.0,12,25768,-4,13365.0,18,13375.0,4,S
2018-04-19 13:31:07,13790.0,2,25770,0,13365.0,18,13375.0,4,B
2018-04-19 13:31:08,13785.0,2,25772,2,13365.0,18,13375.0,4,S
2018-04-19 13:31:08,13780.0,2,25774,-2,13365.0,18,13375.0,4,S
2018-04-19 13:31:09,13780.0,10,25784,0,13365.0,18,13375.0,4,S
2018-04-19 13:31:10,13780.0,4,25788,0,13365.0,18,13375.0,4,S
2018-04-19 13:31:11,13780.0,2,25790,-2,13365.0,18,13375.0,4,S
2018-04-19 13:31:11,13780.0,2,25792,0,13365.0,18,13375.0,4,S
2018-04-19 13:31:13,13780.0,2,25794,-2,13365.0,18,13375.0,4,S
2018-04-19 13:31:13,13770.0,20,25814,6,13365.0,18,13375.0,4,S
2018-04-19 13:31:14,13785.0,2,25816,0,13365.0,18,13375.0,4,B
2018-04-19 13:31:16,13770.0,4,25820,0,13365.0,18,13375.0,4,S
2018-04-19 13:31:18,13785.0,22,25842,-14,13365.0,18,13375.0,4,B
2018-04-19 13:31:21,13785.0,2,25844,0,13365.0,18,13375.0,4,B
2018-04-19 13:31:21,13780.0,2,25846,0,13365.0,18,13375.0,4,S
2018-04-19 13:31:22,13770.0,4,25850,0,13365.0,18,13375.0,4,S
2018-04-19 13:31:22,13780.0,20,25870,-6,13365.0,18,13375.0,4,B
2018-04-19 13:31:23,13775.0,4,25874,4,13365.0,18,13375.0,4,S
2018-04-19 13:31:24,13775.0,28,25902,26,13365.0,18,13375.0,4,S
2018-04-19 13:31:25,13775.0,8,25910,8,13365.0,18,13375.0,4,S
2018-04-19 13:31:26,13775.0,12,25922,8,13365.0,18,13375.0,4,S
2018-04-19 13:31:26,13780.0,14,25936,0,13365.0,18,13375.0,4,B
2018-04-19 13:31:27,13775.0,28,25964,0,13365.0,18,13375.0,4,S
2018-04-19 13:31:28,13770.0,2,25966,0,13365.0,18,13375.0,4,S
2018-04-19 13:31:30,13765.0,4,25970,2,13365.0,18,13375.0,4,S
2018-04-19 13:31:30,13760.0,6,25976,0,13365.0,18,13375.0,4,S
2018-04-19 13:31:31,13770.0,2,25978,2,13365.0,18,13375.0,4,B
2018-04-19 13:31:31,13765.0,4,25982,-2,13365.0,18,13375.0,4,S
2018-04-19 13:31:32,13760.0,4,25986,-2,13365.0,18,13375.0,4,S
2018-04-19 13:31:32,13760.0,2,25988,-2,13365.0,18,13375.0,4,S
2018-04-19 13:31:33,13755.0,8,25996,0,13365.0,18,13375.0,4,S
2018-04-19 13:31:35,13755.0,6,26002,2,13365.0,18,13375.0,4,S
2018-04-19 13:31:36,13755.0,4,26006,0,13365.0,18,13375.0,4,S
2018-04-19 13:31:36,13755.0,4,26010,-4,13365.0,18,13375.0,4,S
2018-04-19 13:31:37,13755.0,2,26012,0,13365.0,18,13375.0,4,S
2018-04-19 13:31:37,13750.0,2,26014,-2,13365.0,18,13375.0,4,S
2018-04-19 13:31:38,13750.0,2,26016,0,13365.0,18,13375.0,4,S
2018-04-19 13:31:38,13750.0,8,26024,-4,13365.0,18,13375.0,4,S
2018-04-19 13:31:39,13755.0,6,26030,-4,13365.0,18,13375.0,4,B
2018-04-19 13:31:39,13750.0,2,26032,-2,13365.0,18,13375.0,4,S
2018-04-19 13:31:40,13750.0,2,26034,-2,13365.0,18,13375.0,4,S
2018-04-19 13:31:40,13755.0,2,26036,0,13365.0,18,13375.0,4,B
2018-04-19 13:31:43,13755.0,6,26042,-4,13365.0,18,13375.0,4,B
2018-04-19 13:31:44,13760.0,12,26054,-4,13365.0,18,13375.0,4,B
2018-04-19 13:31:44,13755.0,8,26062,0,13365.0,18,13375.0,4,S
2018-04-19 13:31:46,13755.0,2,26064,-2,13365.0,18,13375.0,4,S
2018-04-19 13:31:46,13760.0,10,26074,6,13365.0,18,13375.0,4,B
2018-04-19 13:31:47,13760.0,2,26076,-2,13365.0,18,13375.0,4,B
2018-04-19 13:31:47,13755.0,2,26078,0,13365.0,18,13375.0,4,S
2018-04-19 13:31:48,13755.0,12,26090,0,13365.0,18,13375.0,4,S
2018-04-19 13:31:51,13765.0,4,26094,-2,13365.0,18,13375.0,4,B
2018-04-19 13:31:51,13760.0,4,26098,0,13365.0,18,13375.0,4,S
2018-04-19 13:31:52,13760.0,8,26106,0,13365.0,18,13375.0,4,S
2018-04-19 13:31:53,13760.0,6,26112,-2,13365.0,18,13375.0,4,S
2018-04-19 13:31:54,13755.0,4,26116,-2,13365.0,18,13375.0,4,S
2018-04-19 13:31:55,13755.0,2,26118,-2,13365.0,18,13375.0,4,S
2018-04-19 13:31:56,13755.0,2,26120,-2,13365.0,18,13375.0,4,S
2018-04-19 13:31:57,13760.0,2,26122,-2,13365.0,18,13375.0,4,B
2018-04-19 13:31:58,13755.0,26,26148,-18,13365.0,18,13375.0,4,S
2018-04-19 13:31:58,13750.0,18,26166,-2,13365.0,18,13375.0,4,S
2018-04-19 13:31:59,13755.0,2,26168,0,13365.0,18,13375.0,4,B
2018-04-19 13:32:01,13750.0,4,26172,0,13365.0,18,13375.0,4,S
2018-04-19 13:32:02,13755.0,14,26186,0,13365.0,18,13375.0,4,B
2018-04-19 13:32:02,13755.0,6,26192,-2,13365.0,18,13375.0,4,B
2018-04-19 13:32:04,13755.0,2,26194,2,13365.0,18,13375.0,4,B
2018-04-19 13:32:07,13750.0,2,26196,2,13365.0,18,13375.0,4,S
2018-04-19 13:32:08,13750.0,4,26200,2,13365.0,18,13375.0,4,S
2018-04-19 13:32:10,13755.0,20,26220,6,13365.0,18,13375.0,4,B
2018-04-19 13:32:10,13750.0,12,26232,0,13365.0,18,13375.0,4,S
2018-04-19 13:32:13,13750.0,6,26238,0,13365.0,18,13375.0,4,S
2018-04-19 13:32:16,13750.0,2,26240,0,13365.0,18,13375.0,4,S
2018-04-19 13:32:16,13760.0,20,26260,16,13365.0,18,13375.0,4,B
2018-04-19 13:32:17,13760.0,4,26264,-4,13365.0,18,13375.0,4,B
2018-04-19 13:32:19,13765.0,2,26266,2,13365.0,18,13375.0,4,B
2018-04-19 13:32:19,13765.0,2,26268,2,13365.0,18,13375.0,4,B
2018-04-19 13:32:20,13765.0,2,26270,0,13365.0,18,13375.0,4,B
2018-04-19 13:32:22,13765.0,2,26272,0,13365.0,18,13375.0,4,B
2018-04-19 13:32:22,13760.0,2,26274,0,13365.0,18,13375.0,4,S
2018-04-19 13:32:23,13760.0,2,26276,-2,13365.0,18,13375.0,4,S
2018-04-19 13:32:29,13765.0,2,26278,-2,13365.0,18,13375.0,4,B
2018-04-19 13:32:30,13765.0,2,26280,0,13365.0,18,13375.0,4,B
2018-04-19 13:32:31,13765.0,4,26284,-2,13365.0,18,13375.0,4,B
2018-04-19 13:32:32,13755.0,2,26286,-2,13365.0,18,13375.0,4,S
2018-04-19 13:32:34,13760.0,2,26288,0,13365.0,18,13375.0,4,B
2018-04-19 13:32:35,13760.0,2,26290,0,13365.0,18,13375.0,4,B
2018-04-19 13:32:38,13760.0,4,26294,0,13365.0,18,13375.0,4,B
2018-04-19 13:32:39,13760.0,2,26296,2,13365.0,18,13375.0,4,B
2018-04-19 13:32:43,13765.0,2,26298,2,13365.0,18,13375.0,4,B
2018-04-19 13:32:44,13760.0,4,26302,0,13365.0,18,13375.0,4,S
2018-04-19 13:32:45,13770.0,2,26304,2,13365.0,18,13375.0,4,B
2018-04-19 13:32:45,13765.0,2,26306,-2,13365.0,18,13375.0,4,S
2018-04-19 13:32:46,13770.0,2,26308,2,13365.0,18,13375.0,4,B
2018-04-19 13:32:47,13770.0,8,26316,6,13365.0,18,13375.0,4,B
2018-04-19 13:32:48,13770.0,2,26318,0,13365.0,18,13375.0,4,B
2018-04-19 13:32:49,13770.0,2,26320,0,13365.0,18,13375.0,4,B
2018-04-19 13:32:50,13770.0,8,26328,-8,13365.0,18,13375.0,4,B
2018-04-19 13:32:50,13775.0,4,26332,2,13365.0,18,13375.0,4,B
2018-04-19 13:32:51,13775.0,2,26334,0,13365.0,18,13375.0,4,B
2018-04-19 13:32:52,13775.0,4,26338,-4,13365.0,18,13375.0,4,B
2018-04-19 13:32:54,13770.0,2,26340,-2,13365.0,18,13375.0,4,S
2018-04-19 13:32:54,13770.0,4,26344,-4,13365.0,18,13375.0,4,S
2018-04-19 13:32:55,13770.0,2,26346,0,13365.0,18,13375.0,4,S
2018-04-19 13:32:57,13775.0,4,26350,2,13365.0,18,13375.0,4,B
2018-04-19 13:32:58,13770.0,6,26356,0,13365.0,18,13375.0,4,S
2018-04-19 13:32:59,13770.0,6,26362,4,13365.0,18,13375.0,4,S
2018-04-19 13:33:01,13780.0,2,26364,0,13365.0,18,13375.0,4,B
2018-04-19 13:33:02,13780.0,4,26368,4,13365.0,18,13375.0,4,B
2018-04-19 13:33:04,13775.0,2,26370,2,13365.0,18,13375.0,4,S
2018-04-19 13:33:06,13780.0,2,26372,0,13365.0,18,13375.0,4,B
2018-04-19 13:33:07,13780.0,8,26380,-8,13365.0,18,13375.0,4,B
2018-04-19 13:33:07,13785.0,2,26382,-2,13365.0,18,13375.0,4,B
2018-04-19 13:33:08,13785.0,2,26384,2,13365.0,18,13375.0,4,B
2018-04-19 13:33:09,13785.0,6,26390,6,13365.0,18,13375.0,4,B
2018-04-19 13:33:09,13785.0,2,26392,0,13365.0,18,13375.0,4,B
2018-04-19 13:33:10,13790.0,2,26394,-2,13365.0,18,13375.0,4,B
2018-04-19 13:33:11,13790.0,2,26396,-2,13365.0,18,13375.0,4,B
2018-04-19 13:33:11,13785.0,6,26402,6,13365.0,18,13375.0,4,S
2018-04-19 13:33:12,13785.0,4,26406,2,13365.0,18,13375.0,4,S
2018-04-19 13:33:13,13785.0,4,26410,0,13365.0,18,13375.0,4,S
2018-04-19 13:33:13,13790.0,4,26414,0,13365.0,18,13375.0,4,B
2018-04-19 13:33:16,13785.0,2,26416,2,13365.0,18,13375.0,4,S
2018-04-19 13:33:16,13785.0,6,26422,2,13365.0,18,13375.0,4,S
2018-04-19 13:33:17,13780.0,8,26430,2,13365.0,18,13375.0,4,S
2018-04-19 13:33:18,13775.0,4,26434,0,13365.0,18,13375.0,4,S
2018-04-19 13:33:18,13775.0,26,26460,-16,13365.0,18,13375.0,4,S
2018-04-19 13:33:19,13775.0,14,26474,2,13365.0,18,13375.0,4,S
2018-04-19 13:33:19,13775.0,6,26480,0,13365.0,18,13375.0,4,S
2018-04-19 13:33:21,13775.0,20,26500,0,13365.0,18,13375.0,4,S
2018-04-19 13:33:21,13775.0,12,26512,-12,13365.0,18,13375.0,4,S
2018-04-19 13:33:22,13775.0,2,26514,-2,13365.0,18,13375.0,4,S
2018-04-19 13:33:23,13770.0,2,26516,2,13365.0,18,13375.0,4,S
2018-04-19 13:33:25,13780.0,20,26536,8,13365.0,18,13375.0,4,B
2018-04-19 13:33:26,13790.0,6,26542,6,13365.0,18,13375.0,4,B
2018-04-19 13:33:28,13790.0,16,26558,-2,13365.0,18,13375.0,4,B
2018-04-19 13:33:29,13790.0,58,26616,-16,13365.0,18,13375.0,4,B
2018-04-19 13:33:29,13790.0,10,26626,-10,13365.0,18,13375.0,4,B
2018-04-19 13:33:30,13795.0,26,26652,-10,13365.0,18,13375.0,4,B
2018-04-19 13:33:30,13795.0,2,26654,-2,13365.0,18,13375.0,4,B
2018-04-19 13:33:31,13795.0,2,26656,2,13365.0,18,13375.0,4,B
2018-04-19 13:33:31,13790.0,8,26664,-8,13365.0,18,13375.0,4,S
2018-04-19 13:33:33,13790.0,2,26666,-2,13365.0,18,13375.0,4,S
2018-04-19 13:33:34,13795.0,4,26670,4,13365.0,18,13375.0,4,B
2018-04-19 13:33:35,13800.0,2,26672,2,13365.0,18,13375.0,4,B
2018-04-19 13:33:36,13800.0,6,26678,2,13365.0,18,13375.0,4,B
2018-04-19 13:33:37,13800.0,2,26680,0,13365.0,18,13375.0,4,B
2018-04-19 13:33:39,13795.0,4,26684,0,13365.0,18,13375.0,4,S
2018-04-19 13:33:39,13800.0,2,26686,2,13365.0,18,13375.0,4,B
2018-04-19 13:33:41,13800.0,28,26714,8,13365.0,18,13375.0,4,B
2018-04-19 13:33:41,13810.0,4,26718,2,13365.0,18,13375.0,4,B
2018-04-19 13:33:42,13800.0,4,26722,2,13365.0,18,13375.0,4,S
2018-04-19 13:33:43,13800.0,2,26724,-2,13365.0,18,13375.0,4,S
2018-04-19 13:33:44,13800.0,4,26728,4,13365.0,18,13375.0,4,S
2018-04-19 13:33:44,13800.0,4,26732,4,13365.0,18,13375.0,4,S
2018-04-19 13:33:45,13805.0,12,26744,0,13365.0,18,13375.0,4,B
2018-04-19 13:33:45,13800.0,28,26772,0,13365.0,18,13375.0,4,S
2018-04-19 13:33:46,13800.0,2,26774,0,13365.0,18,13375.0,4,S
2018-04-19 13:33:48,13800.0,12,26786,2,13365.0,18,13375.0,4,S
2018-04-19 13:33:51,13800.0,2,26788,2,13365.0,18,13375.0,4,S
2018-04-19 13:33:52,13805.0,2,26790,0,13365.0,18,13375.0,4,B
2018-04-19 13:33:52,13805.0,2,26792,0,13365.0,18,13375.0,4,B
2018-04-19 13:33:53,13805.0,6,26798,-4,13365.0,18,13375.0,4,B
2018-04-19 13:33:54,13800.0,14,26812,-12,13365.0,18,13375.0,4,S
2018-04-19 13:33:54,13805.0,44,26856,40,13365.0,18,13375.0,4,B
2018-04-19 13:33:55,13800.0,72,26928,42,13365.0,18,13375.0,4,S
2018-04-19 13:33:56,13805.0,4,26932,0,13365.0,18,13375.0,4,B
2018-04-19 13:33:57,13800.0,10,26942,0,13365.0,18,13375.0,4,S
2018-04-19 13:33:58,13800.0,2,26944,0,13365.0,18,13375.0,4,S
2018-04-19 13:33:58,13800.0,4,26948,0,13365.0,18,13375.0,4,S
2018-04-19 13:33:59,13800.0,22,26970,0,13365.0,18,13375.0,4,S
2018-04-19 13:34:00,13800.0,20,26990,12,13365.0,18,13375.0,4,S
2018-04-19 13:34:00,13795.0,10,27000,-10,13365.0,18,13375.0,4,S
2018-04-19 13:34:02,13790.0,12,27012,4,13365.0,18,13375.0,4,S
2018-04-19 13:34:05,13790.0,2,27014,-2,13365.0,18,13375.0,4,S
2018-04-19 13:34:07,13790.0,4,27018,0,13365.0,18,13375.0,4,S
2018-04-19 13:34:08,13790.0,16,27034,-6,13365.0,18,13375.0,4,S
2018-04-19 13:34:08,13790.0,10,27044,-10,13365.0,18,13375.0,4,S
2018-04-19 13:34:09,13790.0,16,27060,-16,13365.0,18,13375.0,4,S
2018-04-19 13:34:09,13790.0,36,27096,-12,13365.0,18,13375.0,4,S
2018-04-19 13:34:11,13790.0,2,27098,0,13365.0,18,13375.0,4,S
2018-04-19 13:34:12,13790.0,2,27100,0,13365.0,18,13375.0,4,S
2018-04-19 13:34:15,13785.0,4,27104,4,13365.0,18,13375.0,4,S
2018-04-19 13:34:16,13780.0,6,27110,6,13365.0,18,13375.0,4,S
2018-04-19 13:34:17,13780.0,2,27112,-2,13365.0,18,13375.0,4,S
2018-04-19 13:34:18,13770.0,2,27114,2,13365.0,18,13375.0,4,S
2018-04-19 13:34:18,13780.0,2,27116,0,13365.0,18,13375.0,4,B
2018-04-19 13:34:19,13780.0,10,27126,8,13365.0,18,13375.0,4,B
2018-04-19 13:34:20,13775.0,2,27128,-2,13365.0,18,13375.0,4,S
2018-04-19 13:34:20,13775.0,2,27130,-2,13365.0,18,13375.0,4,S
2018-04-19 13:34:21,13770.0,6,27136,-4,13365.0,18,13375.0,4,S
2018-04-19 13:34:22,13775.0,2,27138,-2,13365.0,18,13375.0,4,B
2018-04-19 13:34:23,13775.0,16,27154,8,13365.0,18,13375.0,4,B
2018-04-19 13:34:24,13775.0,2,27156,0,13365.0,18,13375.0,4,B
2018-04-19 13:34:25,13770.0,6,27162,0,13365.0,18,13375.0,4,S
2018-04-19 13:34:26,13770.0,4,27166,0,13365.0,18,13375.0,4,S
2018-04-19 13:34:26,13775.0,4,27170,-4,13365.0,18,13375.0,4,B
2018-04-19 13:34:27,13775.0,4,27174,0,13365.0,18,13375.0,4,B
2018-04-19 13:34:31,13775.0,2,27176,2,13365.0,18,13375.0,4,B
2018-04-19 13:34:33,13775.0,10,27186,-4,13365.0,18,13375.0,4,B
2018-04-19 13:34:35,13775.0,2,27188,-2,13365.0,18,13375.0,4,B
2018-04-19 13:34:35,13775.0,4,27192,0,13365.0,18,13375.0,4,B
2018-04-19 13:34:36,13775.0,2,27194,0,13365.0,18,13375.0,4,B
2018-04-19 13:34:36,13775.0,2,27196,2,13365.0,18,13375.0,4,B
2018-04-19 13:34:38,13780.0,2,27198,0,13365.0,18,13375.0,4,B
2018-04-19 13:34:38,13785.0,10,27208,-8,13365.0,18,13375.0,4,B
2018-04-19 13:34:39,13790.0,2,27210,-2,13365.0,18,13375.0,4,B
2018-04-19 13:34:40,13775.0,2,27212,-2,13365.0,18,13375.0,4,S
2018-04-19 13:34:43,13780.0,4,27216,-4,13365.0,18,13375.0,4,B
2018-04-19 13:34:44,13780.0,2,27218,-2,13365.0,18,13375.0,4,B
2018-04-19 13:34:45,13780.0,2,27220,-2,13365.0,18,13375.0,4,B
2018-04-19 13:34:46,13780.0,2,27222,-2,13365.0,18,13375.0,4,B
2018-04-19 13:34:47,13775.0,8,27230,0,13365.0,18,13375.0,4,S
2018-04-19 13:34:51,13780.0,6,27236,4,13365.0,18,13375.0,4,B
2018-04-19 13:34:54,13775.0,6,27242,2,13365.0,18,13375.0,4,S
2018-04-19 13:34:56,13780.0,2,27244,0,13365.0,18,13375.0,4,B
2018-04-19 13:34:58,13780.0,10,27254,8,13365.0,18,13375.0,4,B
2018-04-19 13:34:59,13780.0,2,27256,0,13365.0,18,13375.0,4,B
2018-04-19 13:34:59,13775.0,8,27264,-2,13365.0,18,13375.0,4,S
2018-04-19 13:35:00,13775.0,4,27268,0,13365.0,18,13375.0,4,S
2018-04-19 13:35:01,13780.0,2,27270,2,13365.0,18,13375.0,4,B
2018-04-19 13:35:02,13785.0,12,27282,2,13365.0,18,13375.0,4,B
2018-04-19 13:35:04,13790.0,10,27292,-8,13365.0,18,13375.0,4,B
2018-04-19 13:35:04,13795.0,54,27346,-32,13365.0,18,13375.0,4,B
2018-04-19 13:35:05,13800.0,48,27394,-14,13365.0,18,13375.0,4,B
2018-04-19 13:35:05,13795.0,32,27426,-16,13365.0,18,13375.0,4,S
2018-04-19 13:35:06,13790.0,4,27430,-4,13365.0,18,13375.0,4,S
2018-04-19 13:35:07,13790.0,10,27440,-8,13365.0,18,13375.0,4,S
2018-04-19 13:35:07,13790.0,12,27452,-4,13365.0,18,13375.0,4,S
2018-04-19 13:35:08,13790.0,32,27484,-2,13365.0,18,13375.0,4,S
2018-04-19 13:35:09,13785.0,6,27490,0,13365.0,18,13375.0,4,S
2018-04-19 13:35:14,13780.0,2,27492,0,13365.0,18,13375.0,4,S
2018-04-19 13:35:16,13780.0,4,27496,-4,13365.0,18,13375.0,4,S
2018-04-19 13:35:21,13780.0,18,27514,2,13365.0,18,13375.0,4,S
2018-04-19 13:35:22,13780.0,6,27520,-4,13365.0,18,13375.0,4,S
2018-04-19 13:35:23,13775.0,10,27530,0,13365.0,18,13375.0,4,S
2018-04-19 13:35:23,13775.0,2,27532,0,13365.0,18,13375.0,4,S
2018-04-19 13:35:25,13775.0,4,27536,-2,13365.0,18,13375.0,4,S
2018-04-19 13:35:26,13775.0,2,27538,-2,13365.0,18,13375.0,4,S
2018-04-19 13:35:29,13775.0,2,27540,2,13365.0,18,13375.0,4,S
2018-04-19 13:35:30,13775.0,2,27542,0,13365.0,18,13375.0,4,S
2018-04-19 13:35:31,13775.0,4,27546,-4,13365.0,18,13375.0,4,S
2018-04-19 13:35:34,13775.0,2,27548,0,13365.0,18,13375.0,4,S
2018-04-19 13:35:36,13780.0,12,27560,4,13365.0,18,13375.0,4,B
2018-04-19 13:35:37,13780.0,12,27572,6,13365.0,18,13375.0,4,B
2018-04-19 13:35:37,13775.0,2,27574,0,13365.0,18,13375.0,4,S
2018-04-19 13:35:38,13775.0,2,27576,0,13365.0,18,13375.0,4,S
2018-04-19 13:35:42,13775.0,2,27578,0,13365.0,18,13375.0,4,S
2018-04-19 13:35:42,13780.0,2,27580,0,13365.0,18,13375.0,4,B
2018-04-19 13:35:43,13775.0,4,27584,-2,13365.0,18,13375.0,4,S
2018-04-19 13:35:44,13775.0,16,27600,-8,13365.0,18,13375.0,4,S
2018-04-19 13:35:46,13780.0,2,27602,2,13365.0,18,13375.0,4,B
2018-04-19 13:35:50,13775.0,2,27604,-2,13365.0,18,13375.0,4,S
2018-04-19 13:35:57,13775.0,2,27606,0,13365.0,18,13375.0,4,S
2018-04-19 13:36:00,13775.0,4,27610,0,13365.0,18,13375.0,4,S
2018-04-19 13:36:01,13775.0,2,27612,2,13365.0,18,13375.0,4,S
2018-04-19 13:36:02,13775.0,8,27620,4,13365.0,18,13375.0,4,S
2018-04-19 13:36:03,13770.0,4,27624,0,13365.0,18,13375.0,4,S
2018-04-19 13:36:03,13770.0,4,27628,0,13365.0,18,13375.0,4,S
2018-04-19 13:36:07,13770.0,12,27640,-8,13365.0,18,13375.0,4,S
2018-04-19 13:36:07,13770.0,58,27698,56,13365.0,18,13375.0,4,S
2018-04-19 13:36:12,13765.0,2,27700,-2,13365.0,18,13375.0,4,S
2018-04-19 13:36:15,13765.0,2,27702,0,13365.0,18,13375.0,4,S
2018-04-19 13:36:16,13765.0,12,27714,-8,13365.0,18,13375.0,4,S
2018-04-19 13:36:17,13765.0,2,27716,2,13365.0,18,13375.0,4,S
2018-04-19 13:36:19,13750.0,10,27726,-6,13365.0,18,13375.0,4,S
2018-04-19 13:36:19,13755.0,6,27732,2,13365.0,18,13375.0,4,B
2018-04-19 13:36:20,13755.0,4,27736,-4,13365.0,18,13375.0,4,B
2018-04-19 13:36:21,13755.0,2,27738,0,13365.0,18,13375.0,4,B
2018-04-19 13:36:21,13755.0,6,27744,-6,13365.0,18,13375.0,4,B
2018-04-19 13:36:22,13755.0,16,27760,-8,13365.0,18,13375.0,4,B
2018-04-19 13:36:22,13750.0,36,27796,-8,13365.0,18,13375.0,4,S
2018-04-19 13:36:23,13755.0,4,27800,2,13365.0,18,13375.0,4,B
2018-04-19 13:36:27,13755.0,6,27806,-4,13365.0,18,13375.0,4,B
2018-04-19 13:36:32,13755.0,4,27810,0,13365.0,18,13375.0,4,B
2018-04-19 13:36:32,13755.0,4,27814,4,13365.0,18,13375.0,4,B
2018-04-19 13:36:33,13755.0,2,27816,0,13365.0,18,13375.0,4,B
2018-04-19 13:36:33,13750.0,2,27818,0,13365.0,18,13375.0,4,S
2018-04-19 13:36:34,13750.0,2,27820,2,13365.0,18,13375.0,4,S
2018-04-19 13:36:35,13745.0,4,27824,-2,13365.0,18,13375.0,4,S
2018-04-19 13:36:36,13740.0,8,27832,2,13365.0,18,13375.0,4,S
2018-04-19 13:36:37,13750.0,6,27838,6,13365.0,18,13375.0,4,B
2018-04-19 13:36:38,13750.0,2,27840,0,13365.0,18,13375.0,4,B
2018-04-19 13:36:41,13745.0,2,27842,2,13365.0,18,13375.0,4,S
2018-04-19 13:36:42,13745.0,2,27844,0,13365.0,18,13375.0,4,S
2018-04-19 13:36:44,13745.0,2,27846,0,13365.0,18,13375.0,4,S
2018-04-19 13:36:45,13745.0,2,27848,0,13365.0,18,13375.0,4,S
2018-04-19 13:36:45,13745.0,6,27854,2,13365.0,18,13375.0,4,S
2018-04-19 13:36:46,13740.0,8,27862,-6,13365.0,18,13375.0,4,S
2018-04-19 13:36:47,13740.0,2,27864,2,13365.0,18,13375.0,4,S
2018-04-19 13:36:48,13735.0,4,27868,0,13365.0,18,13375.0,4,S
2018-04-19 13:36:49,13735.0,2,27870,0,13365.0,18,13375.0,4,S
2018-04-19 13:36:49,13735.0,6,27876,2,13365.0,18,13375.0,4,S
2018-04-19 13:36:50,13740.0,24,27900,-4,13365.0,18,13375.0,4,B
2018-04-19 13:36:51,13740.0,52,27952,30,13365.0,18,13375.0,4,B
2018-04-19 13:36:51,13735.0,12,27964,2,13365.0,18,13375.0,4,S
2018-04-19 13:36:53,13730.0,10,27974,8,13365.0,18,13375.0,4,S
2018-04-19 13:36:53,13730.0,8,27982,2,13365.0,18,13375.0,4,S
2018-04-19 13:36:54,13730.0,2,27984,0,13365.0,18,13375.0,4,S
2018-04-19 13:36:54,13725.0,4,27988,-2,13365.0,18,13375.0,4,S
2018-04-19 13:36:55,13730.0,8,27996,-4,13365.0,18,13375.0,4,B
2018-04-19 13:36:56,13730.0,18,28014,-14,13365.0,18,13375.0,4,B
2018-04-19 13:36:56,13725.0,2,28016,0,13365.0,18,13375.0,4,S
2018-04-19 13:36:57,13730.0,2,28018,0,13365.0,18,13375.0,4,B
2018-04-19 13:36:58,13725.0,42,28060,4,13365.0,18,13375.0,4,S
2018-04-19 13:36:58,13720.0,4,28064,-2,13365.0,18,13375.0,4,S
2018-04-19 13:36:59,13725.0,4,28068,0,13365.0,18,13375.0,4,B
2018-04-19 13:36:59,13725.0,8,28076,0,13365.0,18,13375.0,4,B
2018-04-19 13:37:00,13725.0,2,28078,-2,13365.0,18,13375.0,4,B
2018-04-19 13:37:01,13720.0,36,28114,-28,13365.0,18,13375.0,4,S
2018-04-19 13:37:02,13720.0,2,28116,-2,13365.0,18,13375.0,4,S
2018-04-19 13:37:04,13715.0,2,28118,0,13365.0,18,13375.0,4,S
2018-04-19 13:37:04,13720.0,10,28128,8,13365.0,18,13375.0,4,B
2018-04-19 13:37:05,13720.0,10,28138,10,13365.0,18,13375.0,4,B
2018-04-19 13:37:05,13715.0,2,28140,2,13365.0,18,13375.0,4,S
2018-04-19 13:37:06,13715.0,4,28144,-4,13365.0,18,13375.0,4,S
2018-04-19 13:37:07,13715.0,4,28148,0,13365.0,18,13375.0,4,S
2018-04-19 13:37:08,13715.0,12,28160,-2,13365.0,18,13375.0,4,S
2018-04-19 13:37:09,13715.0,2,28162,0,13365.0,18,13375.0,4,S
2018-04-19 13:37:10,13710.0,2,28164,2,13365.0,18,13375.0,4,S
2018-04-19 13:37:11,13710.0,8,28172,-4,13365.0,18,13375.0,4,S
2018-04-19 13:37:12,13710.0,8,28180,2,13365.0,18,13375.0,4,S
2018-04-19 13:37:13,13700.0,10,28190,-4,13365.0,18,13375.0,4,S
2018-04-19 13:37:14,13705.0,4,28194,-2,13365.0,18,13375.0,4,B
2018-04-19 13:37:14,13710.0,2,28196,0,13365.0,18,13375.0,4,B
2018-04-19 13:37:15,13705.0,26,28222,6,13365.0,18,13375.0,4,S
2018-04-19 13:37:15,13710.0,8,28230,0,13365.0,18,13375.0,4,B
2018-04-19 13:37:16,13710.0,4,28234,2,13365.0,18,13375.0,4,B
2018-04-19 13:37:17,13705.0,2,28236,0,13365.0,18,13375.0,4,S
2018-04-19 13:37:17,13710.0,2,28238,-2,13365.0,18,13375.0,4,B
2018-04-19 13:37:20,13700.0,40,28278,20,13365.0,18,13375.0,4,S
2018-04-19 13:37:21,13705.0,2,28280,0,13365.0,18,13375.0,4,B
2018-04-19 13:37:21,13705.0,2,28282,0,13365.0,18,13375.0,4,B
2018-04-19 13:37:22,13715.0,2,28284,2,13365.0,18,13375.0,4,B
2018-04-19 13:37:22,13710.0,2,28286,-2,13365.0,18,13375.0,4,S
2018-04-19 13:37:24,13710.0,2,28288,2,13365.0,18,13375.0,4,S
2018-04-19 13:37:24,13715.0,12,28300,0,13365.0,18,13375.0,4,B
2018-04-19 13:37:25,13715.0,12,28312,-12,13365.0,18,13375.0,4,B
2018-04-19 13:37:27,13715.0,2,28314,-2,13365.0,18,13375.0,4,B
2018-04-19 13:37:30,13710.0,2,28316,0,13365.0,18,13375.0,4,S
2018-04-19 13:37:30,13710.0,8,28324,-8,13365.0,18,13375.0,4,S
2018-04-19 13:37:31,13715.0,2,28326,0,13365.0,18,13375.0,4,B
2018-04-19 13:37:31,13715.0,2,28328,-2,13365.0,18,13375.0,4,B
2018-04-19 13:37:32,13715.0,4,28332,0,13365.0,18,13375.0,4,B
2018-04-19 13:37:32,13715.0,2,28334,0,13365.0,18,13375.0,4,B
2018-04-19 13:37:33,13715.0,4,28338,4,13365.0,18,13375.0,4,B
2018-04-19 13:37:34,13720.0,2,28340,2,13365.0,18,13375.0,4,B
2018-04-19 13:37:36,13720.0,4,28344,-2,13365.0,18,13375.0,4,B
2018-04-19 13:37:39,13720.0,2,28346,-2,13365.0,18,13375.0,4,B
2018-04-19 13:37:40,13715.0,2,28348,2,13365.0,18,13375.0,4,S
2018-04-19 13:37:41,13715.0,2,28350,2,13365.0,18,13375.0,4,S
2018-04-19 13:37:43,13725.0,2,28352,2,13365.0,18,13375.0,4,B
2018-04-19 13:37:44,13720.0,2,28354,0,13365.0,18,13375.0,4,S
2018-04-19 13:37:47,13720.0,2,28356,0,13365.0,18,13375.0,4,S
2018-04-19 13:37:47,13730.0,12,28368,-8,13365.0,18,13375.0,4,B
2018-04-19 13:37:48,13735.0,2,28370,0,13365.0,18,13375.0,4,B
2018-04-19 13:37:49,13725.0,14,28384,0,13365.0,18,13375.0,4,S
2018-04-19 13:37:50,13715.0,40,28424,22,13365.0,18,13375.0,4,S
2018-04-19 13:37:55,13725.0,4,28428,-4,13365.0,18,13375.0,4,B
2018-04-19 13:37:56,13725.0,20,28448,18,13365.0,18,13375.0,4,B
2018-04-19 13:37:58,13735.0,2,28450,-2,13365.0,18,13375.0,4,B
2018-04-19 13:37:59,13730.0,2,28452,-2,13365.0,18,13375.0,4,S
2018-04-19 13:38:00,13730.0,2,28454,-2,13365.0,18,13375.0,4,S
2018-04-19 13:38:02,13735.0,8,28462,-6,13365.0,18,13375.0,4,B
2018-04-19 13:38:03,13735.0,4,28466,0,13365.0,18,13375.0,4,B
2018-04-19 13:38:05,13730.0,14,28480,2,13365.0,18,13375.0,4,S
2018-04-19 13:38:05,13730.0,6,28486,6,13365.0,18,13375.0,4,S
2018-04-19 13:38:07,13740.0,2,28488,0,13365.0,18,13375.0,4,B
2018-04-19 13:38:09,13730.0,2,28490,-2,13365.0,18,13375.0,4,S
2018-04-19 13:38:10,13710.0,40,28530,22,13365.0,18,13375.0,4,S
2018-04-19 13:38:11,13740.0,16,28546,-4,13365.0,18,13375.0,4,B
2018-04-19 13:38:11,13740.0,4,28550,2,13365.0,18,13375.0,4,B
2018-04-19 13:38:12,13735.0,2,28552,0,13365.0,18,13375.0,4,S
2018-04-19 13:38:12,13740.0,2,28554,0,13365.0,18,13375.0,4,B
2018-04-19 13:38:16,13740.0,2,28556,0,13365.0,18,13375.0,4,B
2018-04-19 13:38:17,13735.0,14,28570,0,13365.0,18,13375.0,4,S
2018-04-19 13:38:18,13725.0,26,28596,16,13365.0,18,13375.0,4,S
2018-04-19 13:38:19,13725.0,14,28610,0,13365.0,18,13375.0,4,S
2018-04-19 13:38:21,13730.0,2,28612,-2,13365.0,18,13375.0,4,B
2018-04-19 13:38:25,13730.0,4,28616,4,13365.0,18,13375.0,4,B
2018-04-19 13:38:25,13730.0,2,28618,2,13365.0,18,13375.0,4,B
2018-04-19 13:38:26,13730.0,2,28620,0,13365.0,18,13375.0,4,B
2018-04-19 13:38:33,13730.0,2,28622,0,13365.0,18,13375.0,4,B
2018-04-19 13:38:34,13730.0,4,28626,-2,13365.0,18,13375.0,4,B
2018-04-19 13:38:34,13730.0,2,28628,-2,13365.0,18,13375.0,4,B
2018-04-19 13:38:35,13730.0,6,28634,-4,13365.0,18,13375.0,4,B
2018-04-19 13:38:35,13730.0,6,28640,-4,13365.0,18,13375.0,4,B
2018-04-19 13:38:36,13730.0,12,28652,-10,13365.0,18,13375.0,4,B
2018-04-19 13:38:36,13730.0,6,28658,-2,13365.0,18,13375.0,4,B
2018-04-19 13:38:37,13730.0,2,28660,-2,13365.0,18,13375.0,4,B
2018-04-19 13:38:38,13730.0,2,28662,-2,13365.0,18,13375.0,4,B
2018-04-19 13:38:43,13750.0,80,28742,-36,13365.0,18,13375.0,4,B
2018-04-19 13:38:44,13725.0,2,28744,0,13365.0,18,13375.0,4,S
2018-04-19 13:38:45,13730.0,2,28746,2,13365.0,18,13375.0,4,B
2018-04-19 13:38:47,13725.0,4,28750,2,13365.0,18,13375.0,4,S
2018-04-19 13:38:49,13735.0,22,28772,-2,13365.0,18,13375.0,4,B
2018-04-19 13:38:49,13735.0,42,28814,-34,13365.0,18,13375.0,4,B
2018-04-19 13:38:50,13735.0,38,28852,0,13365.0,18,13375.0,4,B
2018-04-19 13:38:50,13735.0,2,28854,2,13365.0,18,13375.0,4,B
2018-04-19 13:38:51,13735.0,2,28856,0,13365.0,18,13375.0,4,B
2018-04-19 13:38:55,13730.0,8,28864,2,13365.0,18,13375.0,4,S
2018-04-19 13:38:56,13730.0,2,28866,2,13365.0,18,13375.0,4,S
2018-04-19 13:38:56,13740.0,6,28872,2,13365.0,18,13375.0,4,B
2018-04-19 13:38:59,13725.0,10,28882,2,13365.0,18,13375.0,4,S
2018-04-19 13:39:02,13730.0,2,28884,0,13365.0,18,13375.0,4,B
2018-04-19 13:39:04,13730.0,6,28890,-6,13365.0,18,13375.0,4,B
2018-04-19 13:39:04,13730.0,2,28892,-2,13365.0,18,13375.0,4,B
2018-04-19 13:39:06,13735.0,6,28898,6,13365.0,18,13375.0,4,B
2018-04-19 13:39:07,13730.0,4,28902,0,13365.0,18,13375.0,4,S
2018-04-19 13:39:09,13725.0,4,28906,0,13365.0,18,13375.0,4,S
2018-04-19 13:39:13,13735.0,2,28908,0,13365.0,18,13375.0,4,B
2018-04-19 13:39:16,13735.0,2,28910,2,13365.0,18,13375.0,4,B
2018-04-19 13:39:17,13730.0,4,28914,0,13365.0,18,13375.0,4,S
2018-04-19 13:39:20,13730.0,2,28916,0,13365.0,18,13375.0,4,S
2018-04-19 13:39:22,13730.0,2,28918,0,13365.0,18,13375.0,4,S
2018-04-19 13:39:23,13725.0,14,28932,-4,13365.0,18,13375.0,4,S
2018-04-19 13:39:25,13725.0,2,28934,0,13365.0,18,13375.0,4,S
2018-04-19 13:39:26,13730.0,2,28936,0,13365.0,18,13375.0,4,B
2018-04-19 13:39:28,13725.0,2,28938,-2,13365.0,18,13375.0,4,S
2018-04-19 13:39:33,13725.0,12,28950,0,13365.0,18,13375.0,4,S
2018-04-19 13:39:34,13725.0,6,28956,4,13365.0,18,13375.0,4,S
2018-04-19 13:39:34,13725.0,2,28958,2,13365.0,18,13375.0,4,S
2018-04-19 13:39:38,13730.0,90,29048,0,13365.0,18,13375.0,4,B
2018-04-19 13:39:39,13735.0,2,29050,2,13365.0,18,13375.0,4,B
2018-04-19 13:39:41,13730.0,8,29058,8,13365.0,18,13375.0,4,S
2018-04-19 13:39:43,13735.0,4,29062,4,13365.0,18,13375.0,4,B
2018-04-19 13:39:49,13735.0,2,29064,2,13365.0,18,13375.0,4,B
2018-04-19 13:39:50,13730.0,2,29066,0,13365.0,18,13375.0,4,S
2018-04-19 13:39:56,13735.0,2,29068,2,13365.0,18,13375.0,4,B
2018-04-19 13:39:57,13730.0,2,29070,-2,13365.0,18,13375.0,4,S
2018-04-19 13:40:03,13730.0,4,29074,0,13365.0,18,13375.0,4,S
2018-04-19 13:40:05,13735.0,4,29078,0,13365.0,18,13375.0,4,B
2018-04-19 13:40:06,13725.0,8,29086,0,13365.0,18,13375.0,4,S
2018-04-19 13:40:08,13735.0,2,29088,2,13365.0,18,13375.0,4,B
2018-04-19 13:40:09,13735.0,6,29094,-2,13365.0,18,13375.0,4,B
2018-04-19 13:40:12,13730.0,2,29096,0,13365.0,18,13375.0,4,S
2018-04-19 13:40:15,13735.0,2,29098,-2,13365.0,18,13375.0,4,B
2018-04-19 13:40:23,13730.0,10,29108,6,13365.0,18,13375.0,4,S
2018-04-19 13:40:24,13730.0,10,29118,6,13365.0,18,13375.0,4,S
2018-04-19 13:40:29,13730.0,10,29128,-8,13365.0,18,13375.0,4,S
2018-04-19 13:40:30,13730.0,2,29130,0,13365.0,18,13375.0,4,S
2018-04-19 13:40:30,13735.0,2,29132,0,13365.0,18,13375.0,4,B
2018-04-19 13:40:36,13735.0,4,29136,4,13365.0,18,13375.0,4,B
2018-04-19 13:40:38,13735.0,2,29138,2,13365.0,18,13375.0,4,B
2018-04-19 13:40:39,13740.0,2,29140,2,13365.0,18,13375.0,4,B
2018-04-19 13:40:39,13740.0,2,29142,0,13365.0,18,13375.0,4,B
2018-04-19 13:40:48,13740.0,6,29148,0,13365.0,18,13375.0,4,B
2018-04-19 13:40:48,13740.0,2,29150,2,13365.0,18,13375.0,4,B
2018-04-19 13:40:51,13735.0,10,29160,-2,13365.0,18,13375.0,4,S
2018-04-19 13:40:54,13740.0,8,29168,4,13365.0,18,13375.0,4,B
2018-04-19 13:40:55,13740.0,22,29190,-6,13365.0,18,13375.0,4,B
2018-04-19 13:41:02,13745.0,4,29194,0,13365.0,18,13375.0,4,B
2018-04-19 13:41:02,13740.0,2,29196,0,13365.0,18,13375.0,4,S
2018-04-19 13:41:03,13745.0,2,29198,-2,13365.0,18,13375.0,4,B
2018-04-19 13:41:05,13745.0,4,29202,0,13365.0,18,13375.0,4,B
2018-04-19 13:41:08,13745.0,16,29218,-6,13365.0,18,13375.0,4,B
2018-04-19 13:41:09,13740.0,10,29228,4,13365.0,18,13375.0,4,S
2018-04-19 13:41:11,13745.0,2,29230,0,13365.0,18,13375.0,4,B
2018-04-19 13:41:15,13750.0,38,29268,20,13365.0,18,13375.0,4,B
2018-04-19 13:41:16,13750.0,10,29278,10,13365.0,18,13375.0,4,B
2018-04-19 13:41:18,13750.0,24,29302,16,13365.0,18,13375.0,4,B
2018-04-19 13:41:18,13755.0,2,29304,0,13365.0,18,13375.0,4,B
2018-04-19 13:41:20,13760.0,2,29306,0,13365.0,18,13375.0,4,B
2018-04-19 13:41:22,13760.0,10,29316,-4,13365.0,18,13375.0,4,B
2018-04-19 13:41:22,13760.0,4,29320,0,13365.0,18,13375.0,4,B
2018-04-19 13:41:23,13760.0,2,29322,0,13365.0,18,13375.0,4,B
2018-04-19 13:41:23,13760.0,2,29324,0,13365.0,18,13375.0,4,B
2018-04-19 13:41:24,13760.0,4,29328,4,13365.0,18,13375.0,4,B
2018-04-19 13:41:25,13760.0,4,29332,4,13365.0,18,13375.0,4,B
2018-04-19 13:41:26,13760.0,2,29334,0,13365.0,18,13375.0,4,B
2018-04-19 13:41:28,13750.0,12,29346,12,13365.0,18,13375.0,4,S
2018-04-19 13:41:29,13750.0,12,29358,12,13365.0,18,13375.0,4,S
2018-04-19 13:41:29,13750.0,8,29366,-8,13365.0,18,13375.0,4,S
2018-04-19 13:41:30,13750.0,2,29368,-2,13365.0,18,13375.0,4,S
2018-04-19 13:41:31,13750.0,2,29370,-2,13365.0,18,13375.0,4,S
2018-04-19 13:41:32,13745.0,20,29390,-8,13365.0,18,13375.0,4,S
2018-04-19 13:41:32,13745.0,22,29412,-22,13365.0,18,13375.0,4,S
2018-04-19 13:41:35,13750.0,2,29414,0,13365.0,18,13375.0,4,B
2018-04-19 13:41:38,13750.0,2,29416,2,13365.0,18,13375.0,4,B
2018-04-19 13:41:42,13750.0,6,29422,0,13365.0,18,13375.0,4,B
2018-04-19 13:41:44,13750.0,12,29434,-4,13365.0,18,13375.0,4,B
2018-04-19 13:41:45,13750.0,10,29444,0,13365.0,18,13375.0,4,B
2018-04-19 13:41:47,13750.0,16,29460,16,13365.0,18,13375.0,4,B
2018-04-19 13:41:47,13750.0,4,29464,0,13365.0,18,13375.0,4,B
2018-04-19 13:41:48,13745.0,2,29466,0,13365.0,18,13375.0,4,S
2018-04-19 13:41:49,13750.0,2,29468,0,13365.0,18,13375.0,4,B
2018-04-19 13:41:51,13745.0,10,29478,0,13365.0,18,13375.0,4,S
2018-04-19 13:41:51,13740.0,32,29510,-10,13365.0,18,13375.0,4,S
2018-04-19 13:41:52,13740.0,28,29538,-24,13365.0,18,13375.0,4,S
2018-04-19 13:41:52,13750.0,4,29542,2,13365.0,18,13375.0,4,B
2018-04-19 13:41:59,13775.0,100,29642,-40,13365.0,18,13375.0,4,B
2018-04-19 13:42:00,13775.0,2,29644,0,13365.0,18,13375.0,4,B
2018-04-19 13:42:00,13750.0,2,29646,0,13365.0,18,13375.0,4,S
2018-04-19 13:42:01,13755.0,2,29648,2,13365.0,18,13375.0,4,B
2018-04-19 13:42:02,13755.0,14,29662,4,13365.0,18,13375.0,4,B
2018-04-19 13:42:03,13780.0,60,29722,-8,13365.0,18,13375.0,4,B
2018-04-19 13:42:03,13780.0,40,29762,-40,13365.0,18,13375.0,4,B
2018-04-19 13:42:05,13760.0,8,29770,8,13365.0,18,13375.0,4,S
2018-04-19 13:42:05,13755.0,8,29778,0,13365.0,18,13375.0,4,S
2018-04-19 13:42:06,13755.0,14,29792,-10,13365.0,18,13375.0,4,S
2018-04-19 13:42:07,13755.0,10,29802,-10,13365.0,18,13375.0,4,S
2018-04-19 13:42:07,13740.0,42,29844,-20,13365.0,18,13375.0,4,S
2018-04-19 13:42:08,13740.0,18,29862,0,13365.0,18,13375.0,4,S
2018-04-19 13:42:08,13750.0,2,29864,-2,13365.0,18,13375.0,4,B
2018-04-19 13:42:10,13750.0,102,29966,-32,13365.0,18,13375.0,4,B
2018-04-19 13:42:10,13765.0,6,29972,6,13365.0,18,13375.0,4,B
2018-04-19 13:42:11,13765.0,4,29976,4,13365.0,18,13375.0,4,B
2018-04-19 13:42:12,13800.0,100,30076,-28,13365.0,18,13375.0,4,B
2018-04-19 13:42:12,13755.0,12,30088,6,13365.0,18,13375.0,4,S
2018-04-19 13:42:13,13760.0,6,30094,4,13365.0,18,13375.0,4,B
2018-04-19 13:42:14,13770.0,102,30196,-20,13365.0,18,13375.0,4,B
2018-04-19 13:42:15,13750.0,28,30224,-24,13365.0,18,13375.0,4,S
2018-04-19 13:42:15,13745.0,32,30256,-14,13365.0,18,13375.0,4,S
2018-04-19 13:42:16,13750.0,2,30258,-2,13365.0,18,13375.0,4,B
2018-04-19 13:42:16,13800.0,100,30358,-4,13365.0,18,13375.0,4,B
2018-04-19 13:42:17,13770.0,82,30440,-18,13365.0,18,13375.0,4,S
2018-04-19 13:42:17,13765.0,6,30446,0,13365.0,18,13375.0,4,S
2018-04-19 13:42:19,13765.0,4,30450,0,13365.0,18,13375.0,4,S
2018-04-19 13:42:19,13800.0,100,30550,-34,13365.0,18,13375.0,4,B
2018-04-19 13:42:20,13770.0,6,30556,0,13365.0,18,13375.0,4,S
2018-04-19 13:42:20,13775.0,22,30578,0,13365.0,18,13375.0,4,B
2018-04-19 13:42:21,13770.0,2,30580,0,13365.0,18,13375.0,4,S
2018-04-19 13:42:21,13770.0,6,30586,0,13365.0,18,13375.0,4,S
2018-04-19 13:42:22,13775.0,6,30592,0,13365.0,18,13375.0,4,B
2018-04-19 13:42:23,13775.0,4,30596,2,13365.0,18,13375.0,4,B
2018-04-19 13:42:24,13740.0,62,30658,-44,13365.0,18,13375.0,4,S
2018-04-19 13:42:24,13770.0,8,30666,-4,13365.0,18,13375.0,4,B
2018-04-19 13:42:25,13800.0,102,30768,-14,13365.0,18,13375.0,4,B
2018-04-19 13:42:25,13775.0,2,30770,2,13365.0,18,13375.0,4,S
2018-04-19 13:42:28,13800.0,82,30852,-10,13365.0,18,13375.0,4,B
2018-04-19 13:42:29,13800.0,18,30870,-2,13365.0,18,13375.0,4,B
2018-04-19 13:42:29,13785.0,2,30872,0,13365.0,18,13375.0,4,S
2018-04-19 13:42:30,13780.0,6,30878,0,13365.0,18,13375.0,4,S
2018-04-19 13:42:31,13770.0,8,30886,-6,13365.0,18,13375.0,4,S
2018-04-19 13:42:32,13800.0,64,30950,-30,13365.0,18,13375.0,4,B
2018-04-19 13:42:32,13785.0,74,31024,-32,13365.0,18,13375.0,4,S
2018-04-19 13:42:33,13785.0,2,31026,2,13365.0,18,13375.0,4,S
2018-04-19 13:42:33,13785.0,8,31034,2,13365.0,18,13375.0,4,S
2018-04-19 13:42:34,13780.0,2,31036,0,13365.0,18,13375.0,4,S
2018-04-19 13:42:35,13780.0,4,31040,0,13365.0,18,13375.0,4,S
2018-04-19 13:42:36,13780.0,2,31042,0,13365.0,18,13375.0,4,S
2018-04-19 13:42:37,13780.0,2,31044,0,13365.0,18,13375.0,4,S
2018-04-19 13:42:38,13780.0,4,31048,2,13365.0,18,13375.0,4,S
2018-04-19 13:42:41,13785.0,2,31050,2,13365.0,18,13375.0,4,B
2018-04-19 13:42:41,13785.0,2,31052,2,13365.0,18,13375.0,4,B
2018-04-19 13:42:42,13785.0,2,31054,0,13365.0,18,13375.0,4,B
2018-04-19 13:42:43,13780.0,2,31056,0,13365.0,18,13375.0,4,S
2018-04-19 13:42:43,13780.0,2,31058,0,13365.0,18,13375.0,4,S
2018-04-19 13:42:45,13780.0,6,31064,2,13365.0,18,13375.0,4,S
2018-04-19 13:42:46,13785.0,2,31066,2,13365.0,18,13375.0,4,B
2018-04-19 13:42:46,13780.0,2,31068,2,13365.0,18,13375.0,4,S
2018-04-19 13:42:47,13780.0,2,31070,2,13365.0,18,13375.0,4,S
2018-04-19 13:42:51,13775.0,2,31072,2,13365.0,18,13375.0,4,S
2018-04-19 13:42:52,13775.0,2,31074,2,13365.0,18,13375.0,4,S
2018-04-19 13:42:53,13780.0,4,31078,-2,13365.0,18,13375.0,4,B
2018-04-19 13:42:54,13780.0,2,31080,0,13365.0,18,13375.0,4,B
2018-04-19 13:42:54,13780.0,2,31082,0,13365.0,18,13375.0,4,B
2018-04-19 13:42:58,13780.0,2,31084,-2,13365.0,18,13375.0,4,B
2018-04-19 13:42:59,13780.0,62,31146,-60,13365.0,18,13375.0,4,B
2018-04-19 13:42:59,13780.0,20,31166,-20,13365.0,18,13375.0,4,B
2018-04-19 13:43:02,13780.0,20,31186,-16,13365.0,18,13375.0,4,B
2018-04-19 13:43:02,13780.0,2,31188,-2,13365.0,18,13375.0,4,B
2018-04-19 13:43:06,13780.0,44,31232,-40,13365.0,18,13375.0,4,B
2018-04-19 13:43:06,13780.0,16,31248,-16,13365.0,18,13375.0,4,B
2018-04-19 13:43:08,13780.0,40,31288,-40,13365.0,18,13375.0,4,B
2018-04-19 13:43:14,13775.0,2,31290,-2,13365.0,18,13375.0,4,S
2018-04-19 13:43:16,13770.0,4,31294,0,13365.0,18,13375.0,4,S
2018-04-19 13:43:17,13770.0,2,31296,-2,13365.0,18,13375.0,4,S
2018-04-19 13:43:17,13770.0,2,31298,-2,13365.0,18,13375.0,4,S
2018-04-19 13:43:19,13775.0,2,31300,-2,13365.0,18,13375.0,4,B
2018-04-19 13:43:21,13770.0,2,31302,0,13365.0,18,13375.0,4,S
2018-04-19 13:43:25,13780.0,2,31304,0,13365.0,18,13375.0,4,B
2018-04-19 13:43:26,13780.0,4,31308,-2,13365.0,18,13375.0,4,B
2018-04-19 13:43:28,13780.0,60,31368,-60,13365.0,18,13375.0,4,B
2018-04-19 13:43:28,13780.0,36,31404,-28,13365.0,18,13375.0,4,B
2018-04-19 13:43:29,13775.0,2,31406,0,13365.0,18,13375.0,4,S
2018-04-19 13:43:30,13780.0,14,31420,-10,13365.0,18,13375.0,4,B
2018-04-19 13:43:31,13780.0,4,31424,-4,13365.0,18,13375.0,4,B
2018-04-19 13:43:34,13780.0,6,31430,-4,13365.0,18,13375.0,4,B
2018-04-19 13:43:37,13780.0,2,31432,-2,13365.0,18,13375.0,4,B
2018-04-19 13:43:38,13780.0,22,31454,-22,13365.0,18,13375.0,4,B
2018-04-19 13:43:39,13780.0,4,31458,-4,13365.0,18,13375.0,4,B
2018-04-19 13:43:42,13780.0,2,31460,-2,13365.0,18,13375.0,4,B
2018-04-19 13:43:45,13780.0,102,31562,-42,13365.0,18,13375.0,4,B
2018-04-19 13:43:45,13785.0,2,31564,-2,13365.0,18,13375.0,4,B
2018-04-19 13:43:46,13785.0,44,31608,-6,13365.0,18,13375.0,4,B
2018-04-19 13:43:47,13785.0,6,31614,0,13365.0,18,13375.0,4,B
2018-04-19 13:43:47,13780.0,106,31720,-52,13365.0,18,13375.0,4,S
2018-04-19 13:43:48,13785.0,6,31726,2,13365.0,18,13375.0,4,B
2018-04-19 13:43:48,13790.0,2,31728,2,13365.0,18,13375.0,4,B
2018-04-19 13:43:49,13785.0,12,31740,-6,13365.0,18,13375.0,4,S
2018-04-19 13:43:49,13785.0,2,31742,-2,13365.0,18,13375.0,4,S
2018-04-19 13:43:50,13785.0,104,31846,-18,13365.0,18,13375.0,4,S
2018-04-19 13:43:51,13785.0,6,31852,0,13365.0,18,13375.0,4,S
2018-04-19 13:43:51,13785.0,28,31880,-4,13365.0,18,13375.0,4,S
2018-04-19 13:43:52,13795.0,18,31898,18,13365.0,18,13375.0,4,B
2018-04-19 13:43:53,13800.0,102,32000,-26,13365.0,18,13375.0,4,B
2018-04-19 13:43:54,13810.0,6,32006,0,13365.0,18,13375.0,4,B
2018-04-19 13:43:54,13805.0,6,32012,-2,13365.0,18,13375.0,4,S
2018-04-19 13:43:55,13795.0,16,32028,-16,13365.0,18,13375.0,4,S
2018-04-19 13:43:56,13840.0,100,32128,-34,13365.0,18,13375.0,4,B
2018-04-19 13:43:57,13815.0,50,32178,-2,13365.0,18,13375.0,4,S
2018-04-19 13:43:57,13805.0,14,32192,-8,13365.0,18,13375.0,4,S
2018-04-19 13:43:58,13795.0,8,32200,-4,13365.0,18,13375.0,4,S
2018-04-19 13:43:58,13800.0,4,32204,0,13365.0,18,13375.0,4,B
2018-04-19 13:43:59,13795.0,20,32224,-12,13365.0,18,13375.0,4,S
2018-04-19 13:43:59,13795.0,4,32228,-4,13365.0,18,13375.0,4,S
2018-04-19 13:44:00,13840.0,100,32328,-12,13365.0,18,13375.0,4,B
2018-04-19 13:44:00,13815.0,52,32380,-12,13365.0,18,13375.0,4,S
2018-04-19 13:44:01,13805.0,10,32390,4,13365.0,18,13375.0,4,S
2018-04-19 13:44:01,13810.0,12,32402,6,13365.0,18,13375.0,4,B
2018-04-19 13:44:02,13810.0,6,32408,0,13365.0,18,13375.0,4,B
2018-04-19 13:44:02,13850.0,102,32510,-12,13365.0,18,13375.0,4,B
2018-04-19 13:44:03,13805.0,6,32516,-2,13365.0,18,13375.0,4,S
2018-04-19 13:44:03,13850.0,68,32584,4,13365.0,18,13375.0,4,B
2018-04-19 13:44:04,13810.0,8,32592,2,13365.0,18,13375.0,4,S
2018-04-19 13:44:04,13805.0,68,32660,-16,13365.0,18,13375.0,4,S
2018-04-19 13:44:05,13850.0,100,32760,-28,13365.0,18,13375.0,4,B
2018-04-19 13:44:06,13810.0,14,32774,-4,13365.0,18,13375.0,4,S
2018-04-19 13:44:06,13800.0,6,32780,2,13365.0,18,13375.0,4,S
2018-04-19 13:44:07,13800.0,10,32790,-2,13365.0,18,13375.0,4,S
2018-04-19 13:44:07,13850.0,106,32896,-6,13365.0,18,13375.0,4,B
2018-04-19 13:44:08,13825.0,54,32950,-20,13365.0,18,13375.0,4,S
2018-04-19 13:44:08,13805.0,6,32956,0,13365.0,18,13375.0,4,S
2018-04-19 13:44:09,13810.0,40,32996,2,13365.0,18,13375.0,4,B
2018-04-19 13:44:09,13820.0,10,33006,8,13365.0,18,13375.0,4,B
2018-04-19 13:44:10,13815.0,2,33008,2,13365.0,18,13375.0,4,S
2018-04-19 13:44:11,13850.0,86,33094,-6,13365.0,18,13375.0,4,B
2018-04-19 13:44:12,13850.0,16,33110,-8,13365.0,18,13375.0,4,B
2018-04-19 13:44:12,13820.0,38,33148,22,13365.0,18,13375.0,4,S
2018-04-19 13:44:13,13815.0,14,33162,-12,13365.0,18,13375.0,4,S
2018-04-19 13:44:14,13810.0,10,33172,-6,13365.0,18,13375.0,4,S
2018-04-19 13:44:14,13810.0,10,33182,-4,13365.0,18,13375.0,4,S
2018-04-19 13:44:15,13810.0,4,33186,-4,13365.0,18,13375.0,4,S
2018-04-19 13:44:16,13810.0,16,33202,-12,13365.0,18,13375.0,4,S
2018-04-19 13:44:16,13810.0,16,33218,-2,13365.0,18,13375.0,4,S
2018-04-19 13:44:17,13810.0,6,33224,-4,13365.0,18,13375.0,4,S
2018-04-19 13:44:17,13805.0,4,33228,0,13365.0,18,13375.0,4,S
2018-04-19 13:44:18,13805.0,10,33238,-8,13365.0,18,13375.0,4,S
2018-04-19 13:44:18,13810.0,2,33240,-2,13365.0,18,13375.0,4,B
2018-04-19 13:44:20,13805.0,8,33248,-2,13365.0,18,13375.0,4,S
2018-04-19 13:44:21,13805.0,4,33252,-2,13365.0,18,13375.0,4,S
2018-04-19 13:44:23,13810.0,2,33254,-2,13365.0,18,13375.0,4,B
2018-04-19 13:44:24,13805.0,2,33256,-2,13365.0,18,13375.0,4,S
2018-04-19 13:44:25,13800.0,12,33268,-8,13365.0,18,13375.0,4,S
2018-04-19 13:44:26,13800.0,14,33282,-10,13365.0,18,13375.0,4,S
2018-04-19 13:44:26,13795.0,6,33288,-6,13365.0,18,13375.0,4,S
2018-04-19 13:44:27,13795.0,6,33294,-6,13365.0,18,13375.0,4,S
2018-04-19 13:44:28,13795.0,4,33298,-4,13365.0,18,13375.0,4,S
2018-04-19 13:44:28,13795.0,4,33302,0,13365.0,18,13375.0,4,S
2018-04-19 13:44:29,13795.0,4,33306,-4,13365.0,18,13375.0,4,S
2018-04-19 13:44:29,13795.0,14,33320,-10,13365.0,18,13375.0,4,S
2018-04-19 13:44:30,13800.0,28,33348,-28,13365.0,18,13375.0,4,B
2018-04-19 13:44:30,13805.0,10,33358,-2,13365.0,18,13375.0,4,B
2018-04-19 13:44:31,13800.0,12,33370,0,13365.0,18,13375.0,4,S
2018-04-19 13:44:31,13800.0,8,33378,0,13365.0,18,13375.0,4,S
2018-04-19 13:44:32,13805.0,2,33380,0,13365.0,18,13375.0,4,B
2018-04-19 13:44:33,13800.0,20,33400,-20,13365.0,18,13375.0,4,S
2018-04-19 13:44:34,13800.0,8,33408,-8,13365.0,18,13375.0,4,S
2018-04-19 13:44:37,13800.0,12,33420,2,13365.0,18,13375.0,4,S
2018-04-19 13:44:38,13800.0,2,33422,0,13365.0,18,13375.0,4,S
2018-04-19 13:44:38,13800.0,2,33424,2,13365.0,18,13375.0,4,S
2018-04-19 13:44:39,13795.0,14,33438,-2,13365.0,18,13375.0,4,S
2018-04-19 13:44:39,13795.0,20,33458,8,13365.0,18,13375.0,4,S
2018-04-19 13:44:40,13795.0,10,33468,-6,13365.0,18,13375.0,4,S
2018-04-19 13:44:40,13800.0,2,33470,-2,13365.0,18,13375.0,4,B
2018-04-19 13:44:41,13795.0,4,33474,4,13365.0,18,13375.0,4,S
2018-04-19 13:44:49,13795.0,6,33480,0,13365.0,18,13375.0,4,S
2018-04-19 13:44:50,13795.0,10,33490,-10,13365.0,18,13375.0,4,S
2018-04-19 13:44:52,13795.0,4,33494,0,13365.0,18,13375.0,4,S
2018-04-19 13:44:53,13800.0,20,33514,-16,13365.0,18,13375.0,4,B
2018-04-19 13:44:54,13795.0,4,33518,-4,13365.0,18,13375.0,4,S
2018-04-19 13:44:54,13795.0,10,33528,-2,13365.0,18,13375.0,4,S
2018-04-19 13:44:55,13800.0,2,33530,0,13365.0,18,13375.0,4,B
2018-04-19 13:44:56,13800.0,2,33532,-2,13365.0,18,13375.0,4,B
2018-04-19 13:45:00,13800.0,10,33542,2,13365.0,18,13375.0,4,B
2018-04-19 13:45:00,13800.0,2,33544,0,13365.0,18,13375.0,4,B
2018-04-19 13:45:01,13800.0,4,33548,0,13365.0,18,13375.0,4,B
2018-04-19 13:45:01,13805.0,2,33550,-2,13365.0,18,13375.0,4,B
2018-04-19 13:45:02,13805.0,4,33554,2,13365.0,18,13375.0,4,B
2018-04-19 13:45:03,13800.0,4,33558,0,13365.0,18,13375.0,4,S
2018-04-19 13:45:05,13805.0,20,33578,12,13365.0,18,13375.0,4,B
2018-04-19 13:45:05,13805.0,20,33598,12,13365.0,18,13375.0,4,B
2018-04-19 13:45:06,13810.0,2,33600,2,13365.0,18,13375.0,4,B
2018-04-19 13:45:06,13815.0,4,33604,2,13365.0,18,13375.0,4,B
2018-04-19 13:45:07,13805.0,16,33620,-6,13365.0,18,13375.0,4,S
2018-04-19 13:45:08,13805.0,8,33628,0,13365.0,18,13375.0,4,S
2018-04-19 13:45:09,13805.0,2,33630,0,13365.0,18,13375.0,4,S
2018-04-19 13:45:10,13805.0,2,33632,0,13365.0,18,13375.0,4,S
2018-04-19 13:45:10,13805.0,12,33644,-12,13365.0,18,13375.0,4,S
2018-04-19 13:45:11,13800.0,4,33648,0,13365.0,18,13375.0,4,S
2018-04-19 13:45:11,13800.0,10,33658,-4,13365.0,18,13375.0,4,S
2018-04-19 13:45:12,13800.0,12,33670,0,13365.0,18,13375.0,4,S
2018-04-19 13:45:13,13800.0,4,33674,0,13365.0,18,13375.0,4,S
2018-04-19 13:45:14,13800.0,2,33676,0,13365.0,18,13375.0,4,S
2018-04-19 13:45:21,13800.0,4,33680,0,13365.0,18,13375.0,4,S
2018-04-19 13:45:22,13800.0,4,33684,0,13365.0,18,13375.0,4,S
2018-04-19 13:45:25,13800.0,2,33686,0,13365.0,18,13375.0,4,S
2018-04-19 13:45:29,13800.0,4,33690,-4,13365.0,18,13375.0,4,S
2018-04-19 13:45:30,13805.0,2,33692,0,13365.0,18,13375.0,4,B
2018-04-19 13:45:33,13805.0,4,33696,0,13365.0,18,13375.0,4,B
2018-04-19 13:45:33,13805.0,2,33698,2,13365.0,18,13375.0,4,B
2018-04-19 13:45:36,13800.0,2,33700,0,13365.0,18,13375.0,4,S
2018-04-19 13:45:37,13800.0,16,33716,-10,13365.0,18,13375.0,4,S
2018-04-19 13:45:40,13805.0,18,33734,0,13365.0,18,13375.0,4,B
2018-04-19 13:45:43,13805.0,10,33744,-10,13365.0,18,13375.0,4,B
2018-04-19 13:45:44,13805.0,28,33772,8,13365.0,18,13375.0,4,B
2018-04-19 13:45:45,13805.0,4,33776,0,13365.0,18,13375.0,4,B
2018-04-19 13:45:47,13805.0,16,33792,14,13365.0,18,13375.0,4,B
2018-04-19 13:45:47,13800.0,18,33810,-16,13365.0,18,13375.0,4,S
2018-04-19 13:45:48,13800.0,18,33828,-6,13365.0,18,13375.0,4,S
2018-04-19 13:45:50,13805.0,10,33838,0,13365.0,18,13375.0,4,B
2018-04-19 13:45:50,13800.0,24,33862,-14,13365.0,18,13375.0,4,S
2018-04-19 13:45:51,13800.0,18,33880,-6,13365.0,18,13375.0,4,S
2018-04-19 13:45:51,13800.0,12,33892,-10,13365.0,18,13375.0,4,S
2018-04-19 13:45:52,13805.0,4,33896,-2,13365.0,18,13375.0,4,B
2018-04-19 13:45:52,13800.0,2,33898,0,13365.0,18,13375.0,4,S
2018-04-19 13:45:55,13805.0,2,33900,2,13365.0,18,13375.0,4,B
2018-04-19 13:46:00,13805.0,10,33910,10,13365.0,18,13375.0,4,B
2018-04-19 13:46:02,13800.0,2,33912,0,13365.0,18,13375.0,4,S
2018-04-19 13:46:03,13800.0,20,33932,-10,13365.0,18,13375.0,4,S
2018-04-19 13:46:03,13800.0,16,33948,-6,13365.0,18,13375.0,4,S
2018-04-19 13:46:04,13800.0,62,34010,-4,13365.0,18,13375.0,4,S
2018-04-19 13:46:04,13800.0,22,34032,-6,13365.0,18,13375.0,4,S
2018-04-19 13:46:05,13800.0,16,34048,-12,13365.0,18,13375.0,4,S
2018-04-19 13:46:05,13800.0,10,34058,-2,13365.0,18,13375.0,4,S
2018-04-19 13:46:06,13800.0,38,34096,-6,13365.0,18,13375.0,4,S
2018-04-19 13:46:06,13800.0,24,34120,-2,13365.0,18,13375.0,4,S
2018-04-19 13:46:07,13800.0,42,34162,-22,13365.0,18,13375.0,4,S
2018-04-19 13:46:07,13795.0,50,34212,-40,13365.0,18,13375.0,4,S
2018-04-19 13:46:08,13800.0,46,34258,0,13365.0,18,13375.0,4,B
2018-04-19 13:46:09,13800.0,54,34312,-38,13365.0,18,13375.0,4,B
2018-04-19 13:46:10,13790.0,2,34314,0,13365.0,18,13375.0,4,S
2018-04-19 13:46:11,13790.0,2,34316,-2,13365.0,18,13375.0,4,S
2018-04-19 13:46:13,13790.0,6,34322,-4,13365.0,18,13375.0,4,S
2018-04-19 13:46:14,13790.0,32,34354,32,13365.0,18,13375.0,4,S
2018-04-19 13:46:14,13790.0,12,34366,12,13365.0,18,13375.0,4,S
2018-04-19 13:46:15,13790.0,4,34370,4,13365.0,18,13375.0,4,S
2018-04-19 13:46:15,13790.0,4,34374,0,13365.0,18,13375.0,4,S
2018-04-19 13:46:17,13790.0,10,34384,-6,13365.0,18,13375.0,4,S
2018-04-19 13:46:20,13790.0,2,34386,0,13365.0,18,13375.0,4,S
2018-04-19 13:46:20,13785.0,4,34390,0,13365.0,18,13375.0,4,S
2018-04-19 13:46:22,13785.0,6,34396,-6,13365.0,18,13375.0,4,S
2018-04-19 13:46:22,13780.0,6,34402,-6,13365.0,18,13375.0,4,S
2018-04-19 13:46:23,13790.0,4,34406,-4,13365.0,18,13375.0,4,B
2018-04-19 13:46:23,13785.0,2,34408,0,13365.0,18,13375.0,4,S
2018-04-19 13:46:24,13780.0,4,34412,0,13365.0,18,13375.0,4,S
2018-04-19 13:46:24,13780.0,2,34414,-2,13365.0,18,13375.0,4,S
2018-04-19 13:46:25,13785.0,2,34416,0,13365.0,18,13375.0,4,B
2018-04-19 13:46:25,13780.0,8,34424,-8,13365.0,18,13375.0,4,S
2018-04-19 13:46:28,13785.0,4,34428,0,13365.0,18,13375.0,4,B
2018-04-19 13:46:31,13785.0,2,34430,0,13365.0,18,13375.0,4,B
2018-04-19 13:46:31,13785.0,10,34440,8,13365.0,18,13375.0,4,B
2018-04-19 13:46:33,13780.0,4,34444,4,13365.0,18,13375.0,4,S
2018-04-19 13:46:33,13780.0,36,34480,0,13365.0,18,13375.0,4,S
2018-04-19 13:46:34,13780.0,8,34488,0,13365.0,18,13375.0,4,S
2018-04-19 13:46:40,13785.0,4,34492,0,13365.0,18,13375.0,4,B
2018-04-19 13:46:49,13780.0,2,34494,0,13365.0,18,13375.0,4,S
2018-04-19 13:46:53,13780.0,2,34496,-2,13365.0,18,13375.0,4,S
2018-04-19 13:46:56,13785.0,2,34498,-2,13365.0,18,13375.0,4,B
2018-04-19 13:46:56,13785.0,6,34504,0,13365.0,18,13375.0,4,B
2018-04-19 13:46:57,13780.0,2,34506,2,13365.0,18,13375.0,4,S
2018-04-19 13:46:57,13780.0,18,34524,8,13365.0,18,13375.0,4,S
2018-04-19 13:46:59,13780.0,2,34526,0,13365.0,18,13375.0,4,S
2018-04-19 13:47:05,13790.0,8,34534,-8,13365.0,18,13375.0,4,B
2018-04-19 13:47:05,13790.0,2,34536,0,13365.0,18,13375.0,4,B
2018-04-19 13:47:06,13785.0,2,34538,0,13365.0,18,13375.0,4,S
2018-04-19 13:47:06,13790.0,34,34572,2,13365.0,18,13375.0,4,B
2018-04-19 13:47:09,13795.0,2,34574,0,13365.0,18,13375.0,4,B
2018-04-19 13:47:13,13790.0,2,34576,2,13365.0,18,13375.0,4,S
2018-04-19 13:47:17,13795.0,20,34596,0,13365.0,18,13375.0,4,B
2018-04-19 13:47:17,13795.0,2,34598,2,13365.0,18,13375.0,4,B
2018-04-19 13:47:18,13795.0,12,34610,-6,13365.0,18,13375.0,4,B
2018-04-19 13:47:20,13795.0,4,34614,0,13365.0,18,13375.0,4,B
2018-04-19 13:47:22,13800.0,2,34616,2,13365.0,18,13375.0,4,B
2018-04-19 13:47:23,13790.0,2,34618,2,13365.0,18,13375.0,4,S
2018-04-19 13:47:29,13800.0,4,34622,-4,13365.0,18,13375.0,4,B
2018-04-19 13:47:30,13800.0,6,34628,-6,13365.0,18,13375.0,4,B
2018-04-19 13:47:30,13805.0,6,34634,-2,13365.0,18,13375.0,4,B
2018-04-19 13:47:31,13800.0,8,34642,-8,13365.0,18,13375.0,4,S
2018-04-19 13:47:37,13810.0,4,34646,2,13365.0,18,13375.0,4,B
2018-04-19 13:47:39,13810.0,4,34650,4,13365.0,18,13375.0,4,B
2018-04-19 13:47:46,13805.0,4,34654,0,13365.0,18,13375.0,4,S
2018-04-19 13:47:50,13805.0,2,34656,0,13365.0,18,13375.0,4,S
2018-04-19 13:47:53,13800.0,6,34662,-2,13365.0,18,13375.0,4,S
2018-04-19 13:47:54,13805.0,4,34666,-2,13365.0,18,13375.0,4,B
2018-04-19 13:47:54,13805.0,16,34682,8,13365.0,18,13375.0,4,B
2018-04-19 13:47:55,13800.0,4,34686,4,13365.0,18,13375.0,4,S
2018-04-19 13:47:55,13800.0,2,34688,0,13365.0,18,13375.0,4,S
2018-04-19 13:47:58,13795.0,4,34692,0,13365.0,18,13375.0,4,S
2018-04-19 13:48:02,13800.0,8,34700,8,13365.0,18,13375.0,4,B
2018-04-19 13:48:05,13795.0,2,34702,-2,13365.0,18,13375.0,4,S
2018-04-19 13:48:15,13795.0,46,34748,6,13365.0,18,13375.0,4,S
2018-04-19 13:48:15,13795.0,8,34756,0,13365.0,18,13375.0,4,S
2018-04-19 13:48:17,13800.0,8,34764,8,13365.0,18,13375.0,4,B
2018-04-19 13:48:17,13800.0,2,34766,0,13365.0,18,13375.0,4,B
2018-04-19 13:48:18,13800.0,8,34774,4,13365.0,18,13375.0,4,B
2018-04-19 13:48:29,13800.0,10,34784,10,13365.0,18,13375.0,4,B
2018-04-19 13:48:35,13795.0,4,34788,0,13365.0,18,13375.0,4,S
2018-04-19 13:48:35,13795.0,4,34792,0,13365.0,18,13375.0,4,S
2018-04-19 13:48:39,13790.0,4,34796,4,13365.0,18,13375.0,4,S
2018-04-19 13:48:43,13790.0,20,34816,-16,13365.0,18,13375.0,4,S
2018-04-19 13:48:43,13790.0,18,34834,-4,13365.0,18,13375.0,4,S
2018-04-19 13:48:49,13790.0,4,34838,4,13365.0,18,13375.0,4,S
2018-04-19 13:48:53,13785.0,2,34840,0,13365.0,18,13375.0,4,S
2018-04-19 13:48:54,13785.0,2,34842,-2,13365.0,18,13375.0,4,S
2018-04-19 13:48:58,13785.0,20,34862,2,13365.0,18,13375.0,4,S
2018-04-19 13:48:59,13785.0,2,34864,0,13365.0,18,13375.0,4,S
2018-04-19 13:49:01,13785.0,2,34866,2,13365.0,18,13375.0,4,S
2018-04-19 13:49:02,13785.0,26,34892,-6,13365.0,18,13375.0,4,S
2018-04-19 13:49:03,13790.0,6,34898,-4,13365.0,18,13375.0,4,B
2018-04-19 13:49:04,13790.0,2,34900,0,13365.0,18,13375.0,4,B
2018-04-19 13:49:09,13790.0,6,34906,2,13365.0,18,13375.0,4,B
2018-04-19 13:49:09,13790.0,2,34908,0,13365.0,18,13375.0,4,B
2018-04-19 13:49:17,13795.0,4,34912,0,13365.0,18,13375.0,4,B
2018-04-19 13:49:25,13795.0,2,34914,0,13365.0,18,13375.0,4,B
2018-04-19 13:49:25,13795.0,2,34916,2,13365.0,18,13375.0,4,B
2018-04-19 13:49:37,13790.0,2,34918,0,13365.0,18,13375.0,4,S
2018-04-19 13:49:38,13795.0,2,34920,2,13365.0,18,13375.0,4,B
2018-04-19 13:49:43,13790.0,4,34924,0,13365.0,18,13375.0,4,S
2018-04-19 13:49:52,13795.0,2,34926,2,13365.0,18,13375.0,4,B
2018-04-19 13:49:54,13790.0,2,34928,0,13365.0,18,13375.0,4,S
2018-04-19 13:49:59,13790.0,2,34930,0,13365.0,18,13375.0,4,S
2018-04-19 13:50:13,13795.0,2,34932,2,13365.0,18,13375.0,4,B
2018-04-19 13:50:13,13795.0,10,34942,0,13365.0,18,13375.0,4,B
2018-04-19 13:50:15,13795.0,4,34946,4,13365.0,18,13375.0,4,B
2018-04-19 13:50:22,13795.0,4,34950,0,13365.0,18,13375.0,4,B
2018-04-19 13:50:23,13795.0,2,34952,0,13365.0,18,13375.0,4,B
2018-04-19 13:50:23,13795.0,2,34954,0,13365.0,18,13375.0,4,B
2018-04-19 13:50:26,13795.0,10,34964,-6,13365.0,18,13375.0,4,B
2018-04-19 13:50:29,13795.0,18,34982,-16,13365.0,18,13375.0,4,B
2018-04-19 13:50:29,13795.0,6,34988,2,13365.0,18,13375.0,4,B
2018-04-19 13:50:33,13800.0,2,34990,0,13365.0,18,13375.0,4,B
2018-04-19 13:50:34,13795.0,2,34992,2,13365.0,18,13375.0,4,S
2018-04-19 13:50:38,13795.0,2,34994,-2,13365.0,18,13375.0,4,S
2018-04-19 13:50:41,13795.0,2,34996,0,13365.0,18,13375.0,4,S
2018-04-19 13:50:46,13790.0,16,35012,4,13365.0,18,13375.0,4,S
2018-04-19 13:50:58,13790.0,2,35014,0,13365.0,18,13375.0,4,S
2018-04-19 13:51:10,13795.0,2,35016,0,13365.0,18,13375.0,4,B
2018-04-19 13:51:12,13790.0,2,35018,-2,13365.0,18,13375.0,4,S
2018-04-19 13:51:13,13790.0,4,35022,0,13365.0,18,13375.0,4,S
2018-04-19 13:51:23,13790.0,2,35024,-2,13365.0,18,13375.0,4,S
2018-04-19 13:51:29,13790.0,2,35026,-2,13365.0,18,13375.0,4,S
2018-04-19 13:51:34,13790.0,2,35028,-2,13365.0,18,13375.0,4,S
2018-04-19 13:51:40,13785.0,8,35036,0,13365.0,18,13375.0,4,S
2018-04-19 13:51:43,13790.0,2,35038,-2,13365.0,18,13375.0,4,B
2018-04-19 13:51:48,13795.0,2,35040,0,13365.0,18,13375.0,4,B
2018-04-19 13:51:48,13795.0,6,35046,4,13365.0,18,13375.0,4,B
2018-04-19 13:52:13,13790.0,2,35048,2,13365.0,18,13375.0,4,S
2018-04-19 13:52:17,13795.0,2,35050,2,13365.0,18,13375.0,4,B
2018-04-19 13:52:24,13800.0,2,35052,2,13365.0,18,13375.0,4,B
2018-04-19 13:52:28,13800.0,2,35054,-2,13365.0,18,13375.0,4,B
2018-04-19 13:52:48,13790.0,2,35056,0,13365.0,18,13375.0,4,S
2018-04-19 13:52:51,13790.0,2,35058,0,13365.0,18,13375.0,4,S
2018-04-19 13:52:52,13795.0,2,35060,2,13365.0,18,13375.0,4,B
2018-04-19 13:52:59,13795.0,2,35062,0,13365.0,18,13375.0,4,B
2018-04-19 13:53:12,13795.0,4,35066,-4,13365.0,18,13375.0,4,B
2018-04-19 13:53:16,13800.0,4,35070,4,13365.0,18,13375.0,4,B
2018-04-19 13:53:25,13800.0,2,35072,2,13365.0,18,13375.0,4,B
2018-04-19 13:53:29,13800.0,4,35076,4,13365.0,18,13375.0,4,B
2018-04-19 13:53:32,13800.0,2,35078,2,13365.0,18,13375.0,4,B
2018-04-19 13:53:33,13800.0,6,35084,0,13365.0,18,13375.0,4,B
2018-04-19 13:53:34,13800.0,20,35104,4,13365.0,18,13375.0,4,B
2018-04-19 13:53:34,13800.0,56,35160,0,13365.0,18,13375.0,4,B
2018-04-19 13:53:35,13800.0,2,35162,0,13365.0,18,13375.0,4,B
2018-04-19 13:53:35,13800.0,10,35172,0,13365.0,18,13375.0,4,B
2018-04-19 13:53:36,13800.0,22,35194,18,13365.0,18,13375.0,4,B
2018-04-19 13:53:36,13800.0,2,35196,2,13365.0,18,13375.0,4,B
2018-04-19 13:53:38,13800.0,6,35202,2,13365.0,18,13375.0,4,B
2018-04-19 13:53:39,13800.0,2,35204,2,13365.0,18,13375.0,4,B
2018-04-19 13:53:43,13800.0,2,35206,-2,13365.0,18,13375.0,4,B
2018-04-19 13:53:45,13800.0,2,35208,0,13365.0,18,13375.0,4,B
2018-04-19 13:53:45,13800.0,12,35220,4,13365.0,18,13375.0,4,B
2018-04-19 13:53:47,13805.0,2,35222,0,13365.0,18,13375.0,4,B
2018-04-19 13:53:47,13805.0,2,35224,0,13365.0,18,13375.0,4,B
2018-04-19 13:53:50,13805.0,64,35288,18,13365.0,18,13375.0,4,B
2018-04-19 13:53:51,13805.0,6,35294,0,13365.0,18,13375.0,4,B
2018-04-19 13:53:51,13805.0,30,35324,26,13365.0,18,13375.0,4,B
2018-04-19 13:53:53,13810.0,2,35326,2,13365.0,18,13375.0,4,B
2018-04-19 13:53:54,13805.0,2,35328,2,13365.0,18,13375.0,4,S
2018-04-19 13:53:55,13810.0,2,35330,0,13365.0,18,13375.0,4,B
2018-04-19 13:53:57,13810.0,2,35332,0,13365.0,18,13375.0,4,B
2018-04-19 13:53:58,13805.0,2,35334,2,13365.0,18,13375.0,4,S
2018-04-19 13:53:59,13805.0,4,35338,-2,13365.0,18,13375.0,4,S
2018-04-19 13:54:01,13810.0,4,35342,0,13365.0,18,13375.0,4,B
2018-04-19 13:54:03,13805.0,4,35346,0,13365.0,18,13375.0,4,S
2018-04-19 13:54:06,13810.0,2,35348,0,13365.0,18,13375.0,4,B
2018-04-19 13:54:07,13805.0,2,35350,0,13365.0,18,13375.0,4,S
2018-04-19 13:54:07,13805.0,2,35352,0,13365.0,18,13375.0,4,S
2018-04-19 13:54:09,13800.0,16,35368,12,13365.0,18,13375.0,4,S
2018-04-19 13:54:09,13795.0,2,35370,2,13365.0,18,13375.0,4,S
2018-04-19 13:54:16,13800.0,2,35372,0,13365.0,18,13375.0,4,B
2018-04-19 13:54:20,13795.0,4,35376,0,13365.0,18,13375.0,4,S
2018-04-19 13:54:23,13800.0,2,35378,-2,13365.0,18,13375.0,4,B
2018-04-19 13:54:24,13790.0,4,35382,0,13365.0,18,13375.0,4,S
2018-04-19 13:54:25,13790.0,4,35386,4,13365.0,18,13375.0,4,S
2018-04-19 13:54:27,13790.0,2,35388,0,13365.0,18,13375.0,4,S
2018-04-19 13:54:39,13795.0,2,35390,-2,13365.0,18,13375.0,4,B
2018-04-19 13:54:40,13795.0,4,35394,-4,13365.0,18,13375.0,4,B
2018-04-19 13:54:42,13795.0,6,35400,0,13365.0,18,13375.0,4,B
2018-04-19 13:54:46,13790.0,2,35402,0,13365.0,18,13375.0,4,S
2018-04-19 13:54:48,13790.0,22,35424,-8,13365.0,18,13375.0,4,S
2018-04-19 13:54:51,13790.0,10,35434,-10,13365.0,18,13375.0,4,S
2018-04-19 13:54:52,13790.0,4,35438,0,13365.0,18,13375.0,4,S
2018-04-19 13:55:05,13785.0,8,35446,-4,13365.0,18,13375.0,4,S
2018-04-19 13:55:11,13780.0,2,35448,-2,13365.0,18,13375.0,4,S
2018-04-19 13:55:12,13780.0,2,35450,-2,13365.0,18,13375.0,4,S
2018-04-19 13:55:12,13780.0,2,35452,0,13365.0,18,13375.0,4,S
2018-04-19 13:55:22,13785.0,2,35454,0,13365.0,18,13375.0,4,B
2018-04-19 13:55:30,13780.0,4,35458,2,13365.0,18,13375.0,4,S
2018-04-19 13:55:33,13780.0,2,35460,2,13365.0,18,13375.0,4,S
2018-04-19 13:55:42,13770.0,6,35466,4,13365.0,18,13375.0,4,S
2018-04-19 13:55:43,13775.0,6,35472,-2,13365.0,18,13375.0,4,B
2018-04-19 13:55:44,13770.0,2,35474,-2,13365.0,18,13375.0,4,S
2018-04-19 13:55:45,13765.0,6,35480,0,13365.0,18,13375.0,4,S
2018-04-19 13:55:48,13760.0,4,35484,0,13365.0,18,13375.0,4,S
2018-04-19 13:55:48,13760.0,2,35486,2,13365.0,18,13375.0,4,S
2018-04-19 13:55:49,13760.0,2,35488,2,13365.0,18,13375.0,4,S
2018-04-19 13:55:50,13760.0,8,35496,-6,13365.0,18,13375.0,4,S
2018-04-19 13:55:51,13760.0,2,35498,0,13365.0,18,13375.0,4,S
2018-04-19 13:55:52,13760.0,4,35502,-2,13365.0,18,13375.0,4,S
2018-04-19 13:55:54,13760.0,10,35512,2,13365.0,18,13375.0,4,S
2018-04-19 13:55:55,13760.0,2,35514,-2,13365.0,18,13375.0,4,S
2018-04-19 13:55:56,13760.0,4,35518,0,13365.0,18,13375.0,4,S
2018-04-19 13:55:59,13755.0,2,35520,2,13365.0,18,13375.0,4,S
2018-04-19 13:56:00,13755.0,2,35522,0,13365.0,18,13375.0,4,S
2018-04-19 13:56:01,13760.0,2,35524,-2,13365.0,18,13375.0,4,B
2018-04-19 13:56:01,13755.0,2,35526,0,13365.0,18,13375.0,4,S
2018-04-19 13:56:03,13760.0,2,35528,0,13365.0,18,13375.0,4,B
2018-04-19 13:56:03,13755.0,2,35530,0,13365.0,18,13375.0,4,S
2018-04-19 13:56:04,13755.0,4,35534,0,13365.0,18,13375.0,4,S
2018-04-19 13:56:05,13755.0,2,35536,0,13365.0,18,13375.0,4,S
2018-04-19 13:56:13,13765.0,2,35538,2,13365.0,18,13375.0,4,B
2018-04-19 13:56:14,13760.0,2,35540,0,13365.0,18,13375.0,4,S
2018-04-19 13:56:29,13765.0,2,35542,0,13365.0,18,13375.0,4,B
2018-04-19 13:56:30,13765.0,4,35546,0,13365.0,18,13375.0,4,B
2018-04-19 13:56:31,13770.0,2,35548,-2,13365.0,18,13375.0,4,B
2018-04-19 13:56:31,13770.0,2,35550,-2,13365.0,18,13375.0,4,B
2018-04-19 13:56:32,13770.0,16,35566,2,13365.0,18,13375.0,4,B
2018-04-19 13:56:33,13770.0,8,35574,-6,13365.0,18,13375.0,4,B
2018-04-19 13:56:34,13770.0,6,35580,-2,13365.0,18,13375.0,4,B
2018-04-19 13:56:44,13770.0,4,35584,2,13365.0,18,13375.0,4,B
2018-04-19 13:56:46,13770.0,2,35586,-2,13365.0,18,13375.0,4,B
2018-04-19 13:56:48,13775.0,6,35592,-6,13365.0,18,13375.0,4,B
2018-04-19 13:57:02,13775.0,32,35624,26,13365.0,18,13375.0,4,B
2018-04-19 13:57:02,13775.0,18,35642,4,13365.0,18,13375.0,4,B
2018-04-19 13:57:04,13770.0,2,35644,0,13365.0,18,13375.0,4,S
2018-04-19 13:57:08,13770.0,2,35646,0,13365.0,18,13375.0,4,S
2018-04-19 13:57:09,13770.0,12,35658,8,13365.0,18,13375.0,4,S
2018-04-19 13:57:14,13770.0,2,35660,2,13365.0,18,13375.0,4,S
2018-04-19 13:57:16,13765.0,2,35662,0,13365.0,18,13375.0,4,S
2018-04-19 13:57:23,13765.0,2,35664,2,13365.0,18,13375.0,4,S
2018-04-19 13:57:26,13765.0,2,35666,0,13365.0,18,13375.0,4,S
2018-04-19 13:57:26,13765.0,8,35674,4,13365.0,18,13375.0,4,S
2018-04-19 13:57:27,13765.0,10,35684,4,13365.0,18,13375.0,4,S
2018-04-19 13:57:29,13775.0,2,35686,0,13365.0,18,13375.0,4,B
2018-04-19 13:58:08,13770.0,2,35688,0,13365.0,18,13375.0,4,S
2018-04-19 13:58:15,13770.0,14,35702,-2,13365.0,18,13375.0,4,S
2018-04-19 13:58:26,13770.0,8,35710,-4,13365.0,18,13375.0,4,S
2018-04-19 13:58:29,13765.0,4,35714,2,13365.0,18,13375.0,4,S
2018-04-19 13:58:30,13765.0,6,35720,0,13365.0,18,13375.0,4,S
2018-04-19 13:58:38,13765.0,28,35748,16,13365.0,18,13375.0,4,S
2018-04-19 13:58:39,13760.0,2,35750,0,13365.0,18,13375.0,4,S
2018-04-19 13:58:39,13765.0,2,35752,-2,13365.0,18,13375.0,4,B
2018-04-19 13:58:41,13760.0,2,35754,0,13365.0,18,13375.0,4,S
2018-04-19 13:58:42,13765.0,2,35756,0,13365.0,18,13375.0,4,B
2018-04-19 13:58:47,13765.0,12,35768,-4,13365.0,18,13375.0,4,B
2018-04-19 13:58:54,13765.0,6,35774,6,13365.0,18,13375.0,4,B
2018-04-19 13:59:06,13765.0,4,35778,2,13365.0,18,13375.0,4,B
2018-04-19 13:59:07,13760.0,2,35780,-2,13365.0,18,13375.0,4,S
2018-04-19 13:59:12,13760.0,12,35792,-10,13365.0,18,13375.0,4,S
2018-04-19 13:59:13,13760.0,2,35794,-2,13365.0,18,13375.0,4,S
2018-04-19 13:59:14,13760.0,2,35796,-2,13365.0,18,13375.0,4,S
2018-04-19 13:59:15,13765.0,8,35804,0,13365.0,18,13375.0,4,B
2018-04-19 13:59:18,13765.0,2,35806,0,13365.0,18,13375.0,4,B
2018-04-19 13:59:21,13765.0,8,35814,6,13365.0,18,13375.0,4,B
2018-04-19 13:59:25,13765.0,2,35816,0,13365.0,18,13375.0,4,B
2018-04-19 13:59:26,13765.0,2,35818,2,13365.0,18,13375.0,4,B
2018-04-19 13:59:39,13765.0,2,35820,-2,13365.0,18,13375.0,4,B
2018-04-19 13:59:39,13765.0,2,35822,-2,13365.0,18,13375.0,4,B
2018-04-19 13:59:40,13765.0,6,35828,-4,13365.0,18,13375.0,4,B
2018-04-19 13:59:41,13760.0,36,35864,-20,13365.0,18,13375.0,4,S
2018-04-19 13:59:41,13760.0,38,35902,-24,13365.0,18,13375.0,4,S
2018-04-19 13:59:42,13760.0,2,35904,0,13365.0,18,13375.0,4,S
2018-04-19 13:59:44,13760.0,4,35908,2,13365.0,18,13375.0,4,S
2018-04-19 13:59:45,13760.0,6,35914,6,13365.0,18,13375.0,4,S
2018-04-19 13:59:47,13760.0,2,35916,2,13365.0,18,13375.0,4,S
2018-04-19 13:59:58,13755.0,12,35928,4,13365.0,18,13375.0,4,S
2018-04-19 13:59:59,13755.0,4,35932,4,13365.0,18,13375.0,4,S
2018-04-19 14:00:01,13760.0,2,35934,0,13365.0,18,13375.0,4,B
2018-04-19 14:00:01,13755.0,6,35940,0,13365.0,18,13375.0,4,S
2018-04-19 14:00:02,13765.0,14,35954,6,13365.0,18,13375.0,4,B
2018-04-19 14:00:06,13765.0,2,35956,-2,13365.0,18,13375.0,4,B
2018-04-19 14:00:13,13760.0,2,35958,0,13365.0,18,13375.0,4,S
2018-04-19 14:00:26,13760.0,2,35960,0,13365.0,18,13375.0,4,S
2018-04-19 14:00:29,13765.0,4,35964,-4,13365.0,18,13375.0,4,B
2018-04-19 14:00:39,13755.0,40,36004,-10,13365.0,18,13375.0,4,S
2018-04-19 14:00:40,13765.0,16,36020,0,13365.0,18,13375.0,4,B
2018-04-19 14:00:41,13765.0,2,36022,0,13365.0,18,13375.0,4,B
2018-04-19 14:00:48,13765.0,4,36026,0,13365.0,18,13375.0,4,B
2018-04-19 14:00:51,13760.0,2,36028,2,13365.0,18,13375.0,4,S
2018-04-19 14:00:54,13765.0,2,36030,-2,13365.0,18,13375.0,4,B
2018-04-19 14:00:56,13765.0,10,36040,6,13365.0,18,13375.0,4,B
2018-04-19 14:00:56,13770.0,2,36042,-2,13365.0,18,13375.0,4,B
2018-04-19 14:00:58,13760.0,2,36044,0,13365.0,18,13375.0,4,S
2018-04-19 14:01:01,13770.0,2,36046,-2,13365.0,18,13375.0,4,B
2018-04-19 14:01:11,13770.0,2,36048,-2,13365.0,18,13375.0,4,B
2018-04-19 14:01:14,13770.0,2,36050,0,13365.0,18,13375.0,4,B
2018-04-19 14:01:17,13770.0,2,36052,0,13365.0,18,13375.0,4,B
2018-04-19 14:01:33,13770.0,6,36058,-6,13365.0,18,13375.0,4,B
2018-04-19 14:01:47,13775.0,2,36060,-2,13365.0,18,13375.0,4,B
2018-04-19 14:01:47,13775.0,2,36062,-2,13365.0,18,13375.0,4,B
2018-04-19 14:01:55,13775.0,2,36064,-2,13365.0,18,13375.0,4,B
2018-04-19 14:01:55,13775.0,16,36080,-4,13365.0,18,13375.0,4,B
2018-04-19 14:01:58,13775.0,2,36082,2,13365.0,18,13375.0,4,B
2018-04-19 14:01:59,13770.0,2,36084,0,13365.0,18,13375.0,4,S
2018-04-19 14:02:07,13780.0,2,36086,0,13365.0,18,13375.0,4,B
2018-04-19 14:02:11,13775.0,2,36088,0,13365.0,18,13375.0,4,S
2018-04-19 14:02:12,13775.0,2,36090,0,13365.0,18,13375.0,4,S
2018-04-19 14:02:13,13770.0,2,36092,0,13365.0,18,13375.0,4,S
2018-04-19 14:02:15,13775.0,22,36114,22,13365.0,18,13375.0,4,B
2018-04-19 14:02:15,13775.0,38,36152,2,13365.0,18,13375.0,4,B
2018-04-19 14:02:19,13780.0,2,36154,2,13365.0,18,13375.0,4,B
2018-04-19 14:02:21,13775.0,2,36156,2,13365.0,18,13375.0,4,S
2018-04-19 14:02:22,13775.0,2,36158,2,13365.0,18,13375.0,4,S
2018-04-19 14:02:23,13780.0,8,36166,-6,13365.0,18,13375.0,4,B
2018-04-19 14:02:27,13780.0,8,36174,6,13365.0,18,13375.0,4,B
2018-04-19 14:02:28,13780.0,10,36184,10,13365.0,18,13375.0,4,B
2018-04-19 14:02:34,13785.0,2,36186,0,13365.0,18,13375.0,4,B
2018-04-19 14:02:34,13780.0,8,36194,8,13365.0,18,13375.0,4,S
2018-04-19 14:02:35,13780.0,2,36196,0,13365.0,18,13375.0,4,S
2018-04-19 14:02:36,13780.0,2,36198,0,13365.0,18,13375.0,4,S
2018-04-19 14:02:38,13780.0,16,36214,16,13365.0,18,13375.0,4,S
2018-04-19 14:02:39,13780.0,2,36216,2,13365.0,18,13375.0,4,S
2018-04-19 14:02:43,13775.0,4,36220,4,13365.0,18,13375.0,4,S
2018-04-19 14:02:45,13775.0,2,36222,0,13365.0,18,13375.0,4,S
2018-04-19 14:02:48,13775.0,24,36246,24,13365.0,18,13375.0,4,S
2018-04-19 14:02:49,13775.0,2,36248,0,13365.0,18,13375.0,4,S
2018-04-19 14:02:52,13775.0,2,36250,0,13365.0,18,13375.0,4,S
2018-04-19 14:02:57,13775.0,10,36260,8,13365.0,18,13375.0,4,S
2018-04-19 14:03:02,13770.0,2,36262,0,13365.0,18,13375.0,4,S
2018-04-19 14:03:03,13770.0,2,36264,-2,13365.0,18,13375.0,4,S
2018-04-19 14:03:03,13770.0,4,36268,0,13365.0,18,13375.0,4,S
2018-04-19 14:03:07,13770.0,12,36280,10,13365.0,18,13375.0,4,S
2018-04-19 14:03:13,13765.0,8,36288,4,13365.0,18,13375.0,4,S
2018-04-19 14:03:14,13765.0,2,36290,0,13365.0,18,13375.0,4,S
2018-04-19 14:03:19,13770.0,2,36292,0,13365.0,18,13375.0,4,B
2018-04-19 14:03:21,13760.0,16,36308,10,13365.0,18,13375.0,4,S
2018-04-19 14:03:29,13765.0,2,36310,2,13365.0,18,13375.0,4,B
2018-04-19 14:03:30,13765.0,10,36320,2,13365.0,18,13375.0,4,B
2018-04-19 14:03:31,13765.0,4,36324,0,13365.0,18,13375.0,4,B
2018-04-19 14:03:31,13765.0,4,36328,-2,13365.0,18,13375.0,4,B
2018-04-19 14:03:37,13760.0,12,36340,4,13365.0,18,13375.0,4,S
2018-04-19 14:03:39,13765.0,2,36342,-2,13365.0,18,13375.0,4,B
2018-04-19 14:03:42,13765.0,2,36344,0,13365.0,18,13375.0,4,B
2018-04-19 14:03:45,13765.0,2,36346,-2,13365.0,18,13375.0,4,B
2018-04-19 14:03:52,13760.0,6,36352,0,13365.0,18,13375.0,4,S
2018-04-19 14:03:56,13760.0,2,36354,0,13365.0,18,13375.0,4,S
2018-04-19 14:04:00,13760.0,2,36356,0,13365.0,18,13375.0,4,S
2018-04-19 14:04:03,13760.0,2,36358,-2,13365.0,18,13375.0,4,S
2018-04-19 14:04:05,13765.0,2,36360,-2,13365.0,18,13375.0,4,B
2018-04-19 14:04:06,13765.0,16,36376,6,13365.0,18,13375.0,4,B
2018-04-19 14:04:06,13765.0,2,36378,-2,13365.0,18,13375.0,4,B
2018-04-19 14:04:07,13765.0,6,36384,-6,13365.0,18,13375.0,4,B
2018-04-19 14:04:09,13770.0,4,36388,0,13365.0,18,13375.0,4,B
2018-04-19 14:04:15,13765.0,8,36396,6,13365.0,18,13375.0,4,S
2018-04-19 14:04:16,13765.0,8,36404,-2,13365.0,18,13375.0,4,S
2018-04-19 14:04:18,13765.0,2,36406,-2,13365.0,18,13375.0,4,S
2018-04-19 14:04:18,13760.0,2,36408,-2,13365.0,18,13375.0,4,S
2018-04-19 14:04:25,13765.0,10,36418,4,13365.0,18,13375.0,4,B
2018-04-19 14:04:27,13765.0,4,36422,0,13365.0,18,13375.0,4,B
2018-04-19 14:04:32,13760.0,2,36424,2,13365.0,18,13375.0,4,S
2018-04-19 14:04:34,13760.0,2,36426,-2,13365.0,18,13375.0,4,S
2018-04-19 14:04:35,13760.0,2,36428,0,13365.0,18,13375.0,4,S
2018-04-19 14:04:39,13765.0,2,36430,0,13365.0,18,13375.0,4,B
2018-04-19 14:04:39,13765.0,4,36434,4,13365.0,18,13375.0,4,B
2018-04-19 14:04:41,13760.0,6,36440,-6,13365.0,18,13375.0,4,S
2018-04-19 14:04:43,13765.0,6,36446,6,13365.0,18,13375.0,4,B
2018-04-19 14:04:44,13760.0,8,36454,0,13365.0,18,13375.0,4,S
2018-04-19 14:04:46,13760.0,2,36456,0,13365.0,18,13375.0,4,S
2018-04-19 14:04:52,13760.0,4,36460,0,13365.0,18,13375.0,4,S
2018-04-19 14:05:04,13760.0,2,36462,0,13365.0,18,13375.0,4,S
2018-04-19 14:05:04,13760.0,6,36468,2,13365.0,18,13375.0,4,S
2018-04-19 14:05:10,13765.0,8,36476,2,13365.0,18,13375.0,4,B
2018-04-19 14:05:11,13760.0,2,36478,0,13365.0,18,13375.0,4,S
2018-04-19 14:05:15,13760.0,4,36482,2,13365.0,18,13375.0,4,S
2018-04-19 14:05:15,13760.0,6,36488,2,13365.0,18,13375.0,4,S
2018-04-19 14:05:17,13760.0,2,36490,-2,13365.0,18,13375.0,4,S
2018-04-19 14:05:18,13760.0,10,36500,8,13365.0,18,13375.0,4,S
2018-04-19 14:05:22,13765.0,2,36502,2,13365.0,18,13375.0,4,B
2018-04-19 14:05:23,13765.0,6,36508,2,13365.0,18,13375.0,4,B
2018-04-19 14:05:30,13765.0,2,36510,0,13365.0,18,13375.0,4,B
2018-04-19 14:05:36,13770.0,8,36518,2,13365.0,18,13375.0,4,B
2018-04-19 14:05:37,13770.0,2,36520,0,13365.0,18,13375.0,4,B
2018-04-19 14:05:47,13760.0,18,36538,4,13365.0,18,13375.0,4,S
2018-04-19 14:05:47,13760.0,8,36546,4,13365.0,18,13375.0,4,S
2018-04-19 14:05:48,13760.0,14,36560,0,13365.0,18,13375.0,4,S
2018-04-19 14:05:54,13765.0,2,36562,0,13365.0,18,13375.0,4,B
2018-04-19 14:06:11,13765.0,2,36564,0,13365.0,18,13375.0,4,B
2018-04-19 14:06:11,13765.0,2,36566,0,13365.0,18,13375.0,4,B
2018-04-19 14:06:16,13770.0,14,36580,12,13365.0,18,13375.0,4,B
2018-04-19 14:06:16,13775.0,4,36584,-4,13365.0,18,13375.0,4,B
2018-04-19 14:06:33,13775.0,2,36586,0,13365.0,18,13375.0,4,B
2018-04-19 14:06:33,13780.0,8,36594,0,13365.0,18,13375.0,4,B
2018-04-19 14:06:48,13780.0,2,36596,0,13365.0,18,13375.0,4,B
2018-04-19 14:06:48,13785.0,2,36598,0,13365.0,18,13375.0,4,B
2018-04-19 14:06:52,13785.0,16,36614,0,13365.0,18,13375.0,4,B
2018-04-19 14:06:57,13775.0,8,36622,6,13365.0,18,13375.0,4,S
2018-04-19 14:06:58,13775.0,8,36630,0,13365.0,18,13375.0,4,S
2018-04-19 14:06:59,13780.0,2,36632,2,13365.0,18,13375.0,4,B
2018-04-19 14:07:02,13785.0,2,36634,-2,13365.0,18,13375.0,4,B
2018-04-19 14:07:06,13785.0,2,36636,2,13365.0,18,13375.0,4,B
2018-04-19 14:07:12,13780.0,2,36638,2,13365.0,18,13375.0,4,S
2018-04-19 14:07:13,13780.0,2,36640,0,13365.0,18,13375.0,4,S
2018-04-19 14:07:17,13785.0,4,36644,-2,13365.0,18,13375.0,4,B
2018-04-19 14:07:25,13785.0,4,36648,2,13365.0,18,13375.0,4,B
2018-04-19 14:07:26,13775.0,22,36670,-16,13365.0,18,13375.0,4,S
2018-04-19 14:07:27,13775.0,6,36676,-6,13365.0,18,13375.0,4,S
2018-04-19 14:07:27,13775.0,12,36688,0,13365.0,18,13375.0,4,S
2018-04-19 14:07:45,13775.0,4,36692,4,13365.0,18,13375.0,4,S
2018-04-19 14:08:08,13770.0,6,36698,4,13365.0,18,13375.0,4,S
2018-04-19 14:08:10,13775.0,2,36700,0,13365.0,18,13375.0,4,B
2018-04-19 14:08:19,13770.0,4,36704,0,13365.0,18,13375.0,4,S
2018-04-19 14:08:23,13780.0,2,36706,0,13365.0,18,13375.0,4,B
2018-04-19 14:08:53,13780.0,2,36708,0,13365.0,18,13375.0,4,B
2018-04-19 14:08:55,13780.0,2,36710,2,13365.0,18,13375.0,4,B
2018-04-19 14:08:59,13780.0,6,36716,-2,13365.0,18,13375.0,4,B
2018-04-19 14:09:03,13780.0,2,36718,0,13365.0,18,13375.0,4,B
2018-04-19 14:09:07,13780.0,6,36724,0,13365.0,18,13375.0,4,B
2018-04-19 14:09:09,13785.0,2,36726,0,13365.0,18,13375.0,4,B
2018-04-19 14:09:18,13780.0,20,36746,18,13365.0,18,13375.0,4,S
2018-04-19 14:09:18,13785.0,4,36750,2,13365.0,18,13375.0,4,B
2018-04-19 14:09:19,13785.0,2,36752,0,13365.0,18,13375.0,4,B
2018-04-19 14:09:23,13790.0,4,36756,0,13365.0,18,13375.0,4,B
2018-04-19 14:09:24,13790.0,2,36758,0,13365.0,18,13375.0,4,B
2018-04-19 14:09:27,13780.0,4,36762,4,13365.0,18,13375.0,4,S
2018-04-19 14:09:42,13785.0,2,36764,-2,13365.0,18,13375.0,4,B
2018-04-19 14:09:50,13785.0,2,36766,2,13365.0,18,13375.0,4,B
2018-04-19 14:09:53,13790.0,4,36770,0,13365.0,18,13375.0,4,B
2018-04-19 14:09:54,13790.0,6,36776,0,13365.0,18,13375.0,4,B
2018-04-19 14:09:55,13790.0,4,36780,0,13365.0,18,13375.0,4,B
2018-04-19 14:09:56,13790.0,2,36782,0,13365.0,18,13375.0,4,B
2018-04-19 14:09:59,13790.0,2,36784,2,13365.0,18,13375.0,4,B
2018-04-19 14:10:00,13790.0,2,36786,0,13365.0,18,13375.0,4,B
2018-04-19 14:10:01,13790.0,6,36792,-6,13365.0,18,13375.0,4,B
2018-04-19 14:10:01,13790.0,2,36794,0,13365.0,18,13375.0,4,B
2018-04-19 14:10:06,13785.0,2,36796,0,13365.0,18,13375.0,4,S
2018-04-19 14:10:07,13790.0,6,36802,2,13365.0,18,13375.0,4,B
2018-04-19 14:10:07,13790.0,2,36804,2,13365.0,18,13375.0,4,B
2018-04-19 14:10:11,13790.0,12,36816,12,13365.0,18,13375.0,4,B
2018-04-19 14:10:11,13790.0,2,36818,2,13365.0,18,13375.0,4,B
2018-04-19 14:10:12,13790.0,2,36820,2,13365.0,18,13375.0,4,B
2018-04-19 14:10:13,13790.0,2,36822,0,13365.0,18,13375.0,4,B
2018-04-19 14:10:14,13790.0,2,36824,2,13365.0,18,13375.0,4,B
2018-04-19 14:10:15,13790.0,2,36826,0,13365.0,18,13375.0,4,B
2018-04-19 14:10:19,13785.0,2,36828,2,13365.0,18,13375.0,4,S
2018-04-19 14:10:20,13780.0,2,36830,0,13365.0,18,13375.0,4,S
2018-04-19 14:10:22,13785.0,2,36832,2,13365.0,18,13375.0,4,B
2018-04-19 14:10:26,13780.0,8,36840,0,13365.0,18,13375.0,4,S
2018-04-19 14:10:40,13780.0,4,36844,-4,13365.0,18,13375.0,4,S
2018-04-19 14:10:47,13780.0,2,36846,0,13365.0,18,13375.0,4,S
2018-04-19 14:10:59,13780.0,4,36850,0,13365.0,18,13375.0,4,S
2018-04-19 14:11:00,13780.0,4,36854,0,13365.0,18,13375.0,4,S
2018-04-19 14:11:01,13780.0,2,36856,2,13365.0,18,13375.0,4,S
2018-04-19 14:11:14,13780.0,2,36858,0,13365.0,18,13375.0,4,S
2018-04-19 14:11:16,13780.0,4,36862,0,13365.0,18,13375.0,4,S
2018-04-19 14:11:32,13790.0,2,36864,2,13365.0,18,13375.0,4,B
2018-04-19 14:11:52,13790.0,2,36866,2,13365.0,18,13375.0,4,B
2018-04-19 14:11:54,13790.0,4,36870,2,13365.0,18,13375.0,4,B
2018-04-19 14:11:55,13790.0,2,36872,0,13365.0,18,13375.0,4,B
2018-04-19 14:12:03,13785.0,4,36876,-4,13365.0,18,13375.0,4,S
2018-04-19 14:12:04,13785.0,4,36880,0,13365.0,18,13375.0,4,S
2018-04-19 14:12:08,13790.0,2,36882,2,13365.0,18,13375.0,4,B
2018-04-19 14:12:21,13790.0,2,36884,0,13365.0,18,13375.0,4,B
2018-04-19 14:12:59,13785.0,2,36886,-2,13365.0,18,13375.0,4,S
2018-04-19 14:13:00,13785.0,2,36888,-2,13365.0,18,13375.0,4,S
2018-04-19 14:13:09,13785.0,2,36890,0,13365.0,18,13375.0,4,S
2018-04-19 14:13:11,13790.0,6,36896,6,13365.0,18,13375.0,4,B
2018-04-19 14:13:22,13790.0,2,36898,0,13365.0,18,13375.0,4,B
2018-04-19 14:13:29,13790.0,4,36902,4,13365.0,18,13375.0,4,B
2018-04-19 14:13:40,13790.0,2,36904,2,13365.0,18,13375.0,4,B
2018-04-19 14:13:41,13790.0,2,36906,2,13365.0,18,13375.0,4,B
2018-04-19 14:13:44,13795.0,8,36914,-4,13365.0,18,13375.0,4,B
2018-04-19 14:13:47,13795.0,2,36916,-2,13365.0,18,13375.0,4,B
2018-04-19 14:13:49,13800.0,12,36928,10,13365.0,18,13375.0,4,B
2018-04-19 14:13:49,13800.0,6,36934,-2,13365.0,18,13375.0,4,B
2018-04-19 14:13:50,13800.0,6,36940,-4,13365.0,18,13375.0,4,B
2018-04-19 14:13:51,13800.0,4,36944,4,13365.0,18,13375.0,4,B
2018-04-19 14:13:51,13800.0,4,36948,4,13365.0,18,13375.0,4,B
2018-04-19 14:13:52,13800.0,12,36960,-6,13365.0,18,13375.0,4,B
2018-04-19 14:13:54,13810.0,4,36964,4,13365.0,18,13375.0,4,B
2018-04-19 14:13:55,13810.0,2,36966,2,13365.0,18,13375.0,4,B
2018-04-19 14:13:55,13810.0,2,36968,0,13365.0,18,13375.0,4,B
2018-04-19 14:13:56,13815.0,8,36976,8,13365.0,18,13375.0,4,B
2018-04-19 14:13:57,13815.0,4,36980,4,13365.0,18,13375.0,4,B
2018-04-19 14:14:00,13820.0,2,36982,-2,13365.0,18,13375.0,4,B
2018-04-19 14:14:00,13825.0,20,37002,-4,13365.0,18,13375.0,4,B
2018-04-19 14:14:01,13825.0,2,37004,0,13365.0,18,13375.0,4,B
2018-04-19 14:14:02,13815.0,4,37008,0,13365.0,18,13375.0,4,S
2018-04-19 14:14:03,13820.0,22,37030,0,13365.0,18,13375.0,4,B
2018-04-19 14:14:03,13820.0,2,37032,2,13365.0,18,13375.0,4,B
2018-04-19 14:14:05,13830.0,40,37072,28,13365.0,18,13375.0,4,B
2018-04-19 14:14:05,13830.0,4,37076,4,13365.0,18,13375.0,4,B
2018-04-19 14:14:06,13830.0,2,37078,-2,13365.0,18,13375.0,4,B
2018-04-19 14:14:07,13820.0,20,37098,12,13365.0,18,13375.0,4,S
2018-04-19 14:14:16,13820.0,4,37102,2,13365.0,18,13375.0,4,S
2018-04-19 14:14:17,13825.0,2,37104,-2,13365.0,18,13375.0,4,B
2018-04-19 14:14:21,13825.0,4,37108,-4,13365.0,18,13375.0,4,B
2018-04-19 14:14:22,13820.0,2,37110,-2,13365.0,18,13375.0,4,S
2018-04-19 14:14:23,13820.0,4,37114,0,13365.0,18,13375.0,4,S
2018-04-19 14:14:24,13825.0,4,37118,-4,13365.0,18,13375.0,4,B
2018-04-19 14:14:28,13825.0,2,37120,-2,13365.0,18,13375.0,4,B
2018-04-19 14:14:30,13815.0,2,37122,2,13365.0,18,13375.0,4,S
2018-04-19 14:14:30,13820.0,2,37124,2,13365.0,18,13375.0,4,B
2018-04-19 14:14:32,13820.0,2,37126,-2,13365.0,18,13375.0,4,B
2018-04-19 14:14:32,13815.0,4,37130,4,13365.0,18,13375.0,4,S
2018-04-19 14:14:33,13815.0,8,37138,0,13365.0,18,13375.0,4,S
2018-04-19 14:14:35,13815.0,2,37140,-2,13365.0,18,13375.0,4,S
2018-04-19 14:14:37,13820.0,4,37144,-4,13365.0,18,13375.0,4,B
2018-04-19 14:14:38,13815.0,6,37150,4,13365.0,18,13375.0,4,S
2018-04-19 14:14:42,13810.0,4,37154,-4,13365.0,18,13375.0,4,S
2018-04-19 14:14:43,13810.0,2,37156,0,13365.0,18,13375.0,4,S
2018-04-19 14:14:47,13805.0,8,37164,-8,13365.0,18,13375.0,4,S
2018-04-19 14:14:47,13805.0,2,37166,-2,13365.0,18,13375.0,4,S
2018-04-19 14:14:48,13800.0,4,37170,0,13365.0,18,13375.0,4,S
2018-04-19 14:14:52,13800.0,2,37172,-2,13365.0,18,13375.0,4,S
2018-04-19 14:14:56,13805.0,20,37192,4,13365.0,18,13375.0,4,B
2018-04-19 14:14:56,13805.0,10,37202,-2,13365.0,18,13375.0,4,B
2018-04-19 14:14:59,13800.0,20,37222,4,13365.0,18,13375.0,4,S
2018-04-19 14:15:07,13800.0,2,37224,0,13365.0,18,13375.0,4,S
2018-04-19 14:15:14,13805.0,8,37232,2,13365.0,18,13375.0,4,B
2018-04-19 14:15:16,13800.0,2,37234,-2,13365.0,18,13375.0,4,S
2018-04-19 14:15:20,13800.0,4,37238,4,13365.0,18,13375.0,4,S
2018-04-19 14:15:21,13800.0,16,37254,6,13365.0,18,13375.0,4,S
2018-04-19 14:15:22,13810.0,2,37256,0,13365.0,18,13375.0,4,B
2018-04-19 14:15:29,13805.0,4,37260,2,13365.0,18,13375.0,4,S
2018-04-19 14:15:46,13800.0,2,37262,0,13365.0,18,13375.0,4,S
2018-04-19 14:15:49,13795.0,10,37272,-10,13365.0,18,13375.0,4,S
2018-04-19 14:15:54,13800.0,2,37274,2,13365.0,18,13375.0,4,B
2018-04-19 14:15:54,13800.0,2,37276,0,13365.0,18,13375.0,4,B
2018-04-19 14:16:00,13800.0,2,37278,2,13365.0,18,13375.0,4,B
2018-04-19 14:16:03,13810.0,4,37282,-2,13365.0,18,13375.0,4,B
2018-04-19 14:16:07,13810.0,2,37284,2,13365.0,18,13375.0,4,B
2018-04-19 14:16:10,13815.0,4,37288,0,13365.0,18,13375.0,4,B
2018-04-19 14:16:14,13810.0,4,37292,0,13365.0,18,13375.0,4,S
2018-04-19 14:16:16,13810.0,2,37294,2,13365.0,18,13375.0,4,S
2018-04-19 14:16:22,13820.0,14,37308,10,13365.0,18,13375.0,4,B
2018-04-19 14:16:23,13820.0,6,37314,0,13365.0,18,13375.0,4,B
2018-04-19 14:16:28,13820.0,2,37316,0,13365.0,18,13375.0,4,B
2018-04-19 14:16:29,13820.0,2,37318,0,13365.0,18,13375.0,4,B
2018-04-19 14:16:32,13825.0,2,37320,2,13365.0,18,13375.0,4,B
2018-04-19 14:16:33,13825.0,2,37322,2,13365.0,18,13375.0,4,B
2018-04-19 14:16:37,13820.0,6,37328,0,13365.0,18,13375.0,4,S
2018-04-19 14:16:38,13820.0,2,37330,0,13365.0,18,13375.0,4,S
2018-04-19 14:16:42,13820.0,4,37334,2,13365.0,18,13375.0,4,S
2018-04-19 14:16:54,13815.0,20,37354,4,13365.0,18,13375.0,4,S
2018-04-19 14:16:56,13815.0,2,37356,2,13365.0,18,13375.0,4,S
2018-04-19 14:17:11,13815.0,2,37358,2,13365.0,18,13375.0,4,S
2018-04-19 14:17:15,13810.0,36,37394,30,13365.0,18,13375.0,4,S
2018-04-19 14:17:15,13815.0,20,37414,16,13365.0,18,13375.0,4,B
2018-04-19 14:17:16,13810.0,10,37424,2,13365.0,18,13375.0,4,S
2018-04-19 14:17:16,13810.0,6,37430,2,13365.0,18,13375.0,4,S
2018-04-19 14:17:17,13810.0,2,37432,2,13365.0,18,13375.0,4,S
2018-04-19 14:17:17,13810.0,2,37434,2,13365.0,18,13375.0,4,S
2018-04-19 14:17:18,13810.0,2,37436,2,13365.0,18,13375.0,4,S
2018-04-19 14:17:18,13810.0,2,37438,2,13365.0,18,13375.0,4,S
2018-04-19 14:17:19,13810.0,2,37440,2,13365.0,18,13375.0,4,S
2018-04-19 14:17:19,13810.0,2,37442,2,13365.0,18,13375.0,4,S
2018-04-19 14:17:21,13810.0,4,37446,0,13365.0,18,13375.0,4,S
2018-04-19 14:17:21,13810.0,4,37450,0,13365.0,18,13375.0,4,S
2018-04-19 14:17:23,13810.0,4,37454,0,13365.0,18,13375.0,4,S
2018-04-19 14:17:24,13810.0,2,37456,0,13365.0,18,13375.0,4,S
2018-04-19 14:17:25,13805.0,38,37494,26,13365.0,18,13375.0,4,S
2018-04-19 14:17:25,13805.0,2,37496,2,13365.0,18,13375.0,4,S
2018-04-19 14:17:26,13805.0,4,37500,-4,13365.0,18,13375.0,4,S
2018-04-19 14:17:27,13810.0,2,37502,2,13365.0,18,13375.0,4,B
2018-04-19 14:17:28,13810.0,2,37504,2,13365.0,18,13375.0,4,B
2018-04-19 14:17:28,13810.0,2,37506,2,13365.0,18,13375.0,4,B
2018-04-19 14:17:29,13805.0,4,37510,4,13365.0,18,13375.0,4,S
2018-04-19 14:17:29,13810.0,2,37512,2,13365.0,18,13375.0,4,B
2018-04-19 14:17:30,13810.0,2,37514,2,13365.0,18,13375.0,4,B
2018-04-19 14:17:30,13810.0,2,37516,2,13365.0,18,13375.0,4,B
2018-04-19 14:17:31,13810.0,2,37518,2,13365.0,18,13375.0,4,B
2018-04-19 14:17:31,13810.0,2,37520,2,13365.0,18,13375.0,4,B
2018-04-19 14:17:32,13805.0,6,37526,0,13365.0,18,13375.0,4,S
2018-04-19 14:17:33,13805.0,8,37534,2,13365.0,18,13375.0,4,S
2018-04-19 14:17:33,13810.0,4,37538,0,13365.0,18,13375.0,4,B
2018-04-19 14:17:34,13810.0,8,37546,4,13365.0,18,13375.0,4,B
2018-04-19 14:17:34,13810.0,2,37548,2,13365.0,18,13375.0,4,B
2018-04-19 14:17:35,13810.0,2,37550,2,13365.0,18,13375.0,4,B
2018-04-19 14:17:35,13810.0,2,37552,2,13365.0,18,13375.0,4,B
2018-04-19 14:17:36,13810.0,2,37554,2,13365.0,18,13375.0,4,B
2018-04-19 14:17:36,13810.0,2,37556,2,13365.0,18,13375.0,4,B
2018-04-19 14:17:37,13810.0,2,37558,2,13365.0,18,13375.0,4,B
2018-04-19 14:17:37,13810.0,2,37560,2,13365.0,18,13375.0,4,B
2018-04-19 14:17:38,13810.0,2,37562,2,13365.0,18,13375.0,4,B
2018-04-19 14:17:38,13810.0,2,37564,2,13365.0,18,13375.0,4,B
2018-04-19 14:17:41,13810.0,2,37566,0,13365.0,18,13375.0,4,B
2018-04-19 14:17:48,13810.0,2,37568,0,13365.0,18,13375.0,4,B
2018-04-19 14:17:48,13810.0,68,37636,16,13365.0,18,13375.0,4,B
2018-04-19 14:17:51,13810.0,36,37672,34,13365.0,18,13375.0,4,B
2018-04-19 14:17:52,13810.0,4,37676,0,13365.0,18,13375.0,4,B
2018-04-19 14:17:52,13810.0,40,37716,20,13365.0,18,13375.0,4,B
2018-04-19 14:17:53,13810.0,24,37740,6,13365.0,18,13375.0,4,B
2018-04-19 14:17:54,13820.0,30,37770,22,13365.0,18,13375.0,4,B
2018-04-19 14:17:54,13825.0,6,37776,-4,13365.0,18,13375.0,4,B
2018-04-19 14:17:55,13825.0,10,37786,-10,13365.0,18,13375.0,4,B
2018-04-19 14:17:55,13815.0,8,37794,0,13365.0,18,13375.0,4,S
2018-04-19 14:17:56,13815.0,6,37800,-6,13365.0,18,13375.0,4,S
2018-04-19 14:17:59,13830.0,10,37810,-6,13365.0,18,13375.0,4,B
2018-04-19 14:18:00,13835.0,10,37820,-4,13365.0,18,13375.0,4,B
2018-04-19 14:18:00,13825.0,12,37832,0,13365.0,18,13375.0,4,S
2018-04-19 14:18:02,13830.0,4,37836,0,13365.0,18,13375.0,4,B
2018-04-19 14:18:03,13830.0,2,37838,-2,13365.0,18,13375.0,4,B
2018-04-19 14:18:05,13830.0,4,37842,4,13365.0,18,13375.0,4,B
2018-04-19 14:18:05,13825.0,2,37844,0,13365.0,18,13375.0,4,S
2018-04-19 14:18:08,13825.0,2,37846,-2,13365.0,18,13375.0,4,S
2018-04-19 14:18:08,13835.0,4,37850,2,13365.0,18,13375.0,4,B
2018-04-19 14:18:09,13830.0,2,37852,0,13365.0,18,13375.0,4,S
2018-04-19 14:18:11,13825.0,2,37854,0,13365.0,18,13375.0,4,S
2018-04-19 14:18:11,13835.0,4,37858,4,13365.0,18,13375.0,4,B
2018-04-19 14:18:12,13835.0,2,37860,2,13365.0,18,13375.0,4,B
2018-04-19 14:18:14,13825.0,4,37864,0,13365.0,18,13375.0,4,S
2018-04-19 14:18:15,13825.0,8,37872,4,13365.0,18,13375.0,4,S
2018-04-19 14:18:16,13820.0,2,37874,0,13365.0,18,13375.0,4,S
2018-04-19 14:18:19,13815.0,2,37876,-2,13365.0,18,13375.0,4,S
2018-04-19 14:18:20,13815.0,8,37884,-8,13365.0,18,13375.0,4,S
2018-04-19 14:18:20,13810.0,6,37890,6,13365.0,18,13375.0,4,S
2018-04-19 14:18:21,13810.0,2,37892,0,13365.0,18,13375.0,4,S
2018-04-19 14:18:22,13810.0,4,37896,-2,13365.0,18,13375.0,4,S
2018-04-19 14:18:22,13815.0,4,37900,-4,13365.0,18,13375.0,4,B
2018-04-19 14:18:23,13810.0,2,37902,2,13365.0,18,13375.0,4,S
2018-04-19 14:18:24,13810.0,2,37904,2,13365.0,18,13375.0,4,S
2018-04-19 14:18:25,13815.0,2,37906,-2,13365.0,18,13375.0,4,B
2018-04-19 14:18:26,13805.0,4,37910,0,13365.0,18,13375.0,4,S
2018-04-19 14:18:27,13805.0,2,37912,0,13365.0,18,13375.0,4,S
2018-04-19 14:18:28,13805.0,20,37932,0,13365.0,18,13375.0,4,S
2018-04-19 14:18:28,13805.0,2,37934,-2,13365.0,18,13375.0,4,S
2018-04-19 14:18:29,13805.0,2,37936,-2,13365.0,18,13375.0,4,S
2018-04-19 14:18:30,13805.0,4,37940,-4,13365.0,18,13375.0,4,S
2018-04-19 14:18:30,13810.0,4,37944,0,13365.0,18,13375.0,4,B
2018-04-19 14:18:34,13805.0,4,37948,4,13365.0,18,13375.0,4,S
2018-04-19 14:18:37,13800.0,18,37966,-12,13365.0,18,13375.0,4,S
2018-04-19 14:18:38,13800.0,6,37972,-2,13365.0,18,13375.0,4,S
2018-04-19 14:18:41,13800.0,2,37974,2,13365.0,18,13375.0,4,S
2018-04-19 14:18:44,13800.0,4,37978,4,13365.0,18,13375.0,4,S
2018-04-19 14:18:45,13800.0,10,37988,0,13365.0,18,13375.0,4,S
2018-04-19 14:18:45,13795.0,2,37990,-2,13365.0,18,13375.0,4,S
2018-04-19 14:18:46,13800.0,2,37992,0,13365.0,18,13375.0,4,B
2018-04-19 14:18:47,13795.0,8,38000,0,13365.0,18,13375.0,4,S
2018-04-19 14:18:48,13790.0,8,38008,-4,13365.0,18,13375.0,4,S
2018-04-19 14:18:49,13785.0,2,38010,0,13365.0,18,13375.0,4,S
2018-04-19 14:18:49,13785.0,8,38018,-2,13365.0,18,13375.0,4,S
2018-04-19 14:18:50,13785.0,2,38020,-2,13365.0,18,13375.0,4,S
2018-04-19 14:18:53,13785.0,2,38022,0,13365.0,18,13375.0,4,S
2018-04-19 14:18:54,13785.0,2,38024,2,13365.0,18,13375.0,4,S
2018-04-19 14:18:59,13790.0,2,38026,0,13365.0,18,13375.0,4,B
2018-04-19 14:19:05,13785.0,4,38030,0,13365.0,18,13375.0,4,S
2018-04-19 14:19:08,13785.0,6,38036,-6,13365.0,18,13375.0,4,S
2018-04-19 14:19:08,13790.0,6,38042,0,13365.0,18,13375.0,4,B
2018-04-19 14:19:13,13790.0,2,38044,-2,13365.0,18,13375.0,4,B
2018-04-19 14:19:19,13790.0,2,38046,-2,13365.0,18,13375.0,4,B
2018-04-19 14:19:21,13780.0,2,38048,-2,13365.0,18,13375.0,4,S
2018-04-19 14:19:30,13780.0,12,38060,-4,13365.0,18,13375.0,4,S
2018-04-19 14:19:31,13770.0,4,38064,2,13365.0,18,13375.0,4,S
2018-04-19 14:19:31,13780.0,2,38066,0,13365.0,18,13375.0,4,B
2018-04-19 14:19:32,13770.0,16,38082,-14,13365.0,18,13375.0,4,S
2018-04-19 14:19:32,13770.0,8,38090,-4,13365.0,18,13375.0,4,S
2018-04-19 14:19:33,13770.0,4,38094,0,13365.0,18,13375.0,4,S
2018-04-19 14:19:34,13770.0,2,38096,0,13365.0,18,13375.0,4,S
2018-04-19 14:19:36,13765.0,4,38100,-2,13365.0,18,13375.0,4,S
2018-04-19 14:19:37,13765.0,8,38108,0,13365.0,18,13375.0,4,S
2018-04-19 14:19:38,13770.0,4,38112,-4,13365.0,18,13375.0,4,B
2018-04-19 14:19:40,13765.0,14,38126,-10,13365.0,18,13375.0,4,S
2018-04-19 14:19:41,13765.0,2,38128,0,13365.0,18,13375.0,4,S
2018-04-19 14:19:41,13765.0,8,38136,-4,13365.0,18,13375.0,4,S
2018-04-19 14:19:43,13770.0,2,38138,2,13365.0,18,13375.0,4,B
2018-04-19 14:19:44,13765.0,4,38142,0,13365.0,18,13375.0,4,S
2018-04-19 14:19:44,13765.0,2,38144,-2,13365.0,18,13375.0,4,S
2018-04-19 14:19:45,13765.0,22,38166,-16,13365.0,18,13375.0,4,S
2018-04-19 14:19:45,13770.0,20,38186,-16,13365.0,18,13375.0,4,B
2018-04-19 14:19:49,13765.0,2,38188,2,13365.0,18,13375.0,4,S
2018-04-19 14:19:52,13765.0,2,38190,0,13365.0,18,13375.0,4,S
2018-04-19 14:19:53,13765.0,2,38192,0,13365.0,18,13375.0,4,S
2018-04-19 14:19:54,13770.0,2,38194,0,13365.0,18,13375.0,4,B
2018-04-19 14:19:57,13765.0,2,38196,2,13365.0,18,13375.0,4,S
2018-04-19 14:19:59,13765.0,2,38198,0,13365.0,18,13375.0,4,S
2018-04-19 14:20:00,13765.0,2,38200,0,13365.0,18,13375.0,4,S
2018-04-19 14:20:04,13765.0,6,38206,2,13365.0,18,13375.0,4,S
2018-04-19 14:20:04,13765.0,2,38208,0,13365.0,18,13375.0,4,S
2018-04-19 14:20:08,13770.0,6,38214,0,13365.0,18,13375.0,4,B
2018-04-19 14:20:09,13770.0,2,38216,0,13365.0,18,13375.0,4,B
2018-04-19 14:20:10,13765.0,4,38220,0,13365.0,18,13375.0,4,S
2018-04-19 14:20:22,13775.0,2,38222,2,13365.0,18,13375.0,4,B
2018-04-19 14:20:24,13770.0,2,38224,-2,13365.0,18,13375.0,4,S
2018-04-19 14:20:26,13775.0,2,38226,0,13365.0,18,13375.0,4,B
2018-04-19 14:20:27,13775.0,2,38228,-2,13365.0,18,13375.0,4,B
2018-04-19 14:20:36,13775.0,2,38230,2,13365.0,18,13375.0,4,B
2018-04-19 14:20:39,13770.0,4,38234,-4,13365.0,18,13375.0,4,S
2018-04-19 14:20:56,13775.0,8,38242,8,13365.0,18,13375.0,4,B
2018-04-19 14:20:57,13775.0,32,38274,30,13365.0,18,13375.0,4,B
2018-04-19 14:20:57,13770.0,2,38276,0,13365.0,18,13375.0,4,S
2018-04-19 14:21:08,13780.0,4,38280,-4,13365.0,18,13375.0,4,B
2018-04-19 14:21:08,13780.0,4,38284,0,13365.0,18,13375.0,4,B
2018-04-19 14:21:14,13780.0,2,38286,0,13365.0,18,13375.0,4,B
2018-04-19 14:21:43,13775.0,10,38296,6,13365.0,18,13375.0,4,S
2018-04-19 14:21:43,13775.0,10,38306,4,13365.0,18,13375.0,4,S
2018-04-19 14:21:44,13775.0,2,38308,2,13365.0,18,13375.0,4,S
2018-04-19 14:21:48,13780.0,2,38310,0,13365.0,18,13375.0,4,B
2018-04-19 14:21:50,13785.0,6,38316,2,13365.0,18,13375.0,4,B
2018-04-19 14:21:51,13790.0,2,38318,0,13365.0,18,13375.0,4,B
2018-04-19 14:22:00,13785.0,2,38320,2,13365.0,18,13375.0,4,S
2018-04-19 14:22:07,13790.0,2,38322,-2,13365.0,18,13375.0,4,B
2018-04-19 14:22:13,13790.0,2,38324,0,13365.0,18,13375.0,4,B
2018-04-19 14:22:16,13790.0,2,38326,-2,13365.0,18,13375.0,4,B
2018-04-19 14:22:23,13780.0,2,38328,0,13365.0,18,13375.0,4,S
2018-04-19 14:22:25,13785.0,4,38332,0,13365.0,18,13375.0,4,B
2018-04-19 14:22:28,13785.0,2,38334,0,13365.0,18,13375.0,4,B
2018-04-19 14:22:37,13790.0,2,38336,-2,13365.0,18,13375.0,4,B
2018-04-19 14:23:09,13780.0,8,38344,4,13365.0,18,13375.0,4,S
2018-04-19 14:23:10,13780.0,6,38350,4,13365.0,18,13375.0,4,S
2018-04-19 14:23:10,13780.0,2,38352,2,13365.0,18,13375.0,4,S
2018-04-19 14:23:15,13785.0,10,38362,8,13365.0,18,13375.0,4,B
2018-04-19 14:23:33,13780.0,2,38364,0,13365.0,18,13375.0,4,S
2018-04-19 14:23:37,13780.0,2,38366,-2,13365.0,18,13375.0,4,S
2018-04-19 14:23:42,13785.0,6,38372,2,13365.0,18,13375.0,4,B
2018-04-19 14:23:43,13785.0,2,38374,2,13365.0,18,13375.0,4,B
2018-04-19 14:24:00,13785.0,4,38378,2,13365.0,18,13375.0,4,B
2018-04-19 14:24:01,13785.0,2,38380,-2,13365.0,18,13375.0,4,B
2018-04-19 14:24:01,13790.0,10,38390,8,13365.0,18,13375.0,4,B
2018-04-19 14:24:11,13785.0,10,38400,10,13365.0,18,13375.0,4,S
2018-04-19 14:24:14,13785.0,2,38402,0,13365.0,18,13375.0,4,S
2018-04-19 14:24:37,13785.0,10,38412,-2,13365.0,18,13375.0,4,S
2018-04-19 14:24:48,13790.0,16,38428,2,13365.0,18,13375.0,4,B
2018-04-19 14:24:49,13795.0,2,38430,2,13365.0,18,13375.0,4,B
2018-04-19 14:24:58,13790.0,2,38432,0,13365.0,18,13375.0,4,S
2018-04-19 14:24:58,13790.0,4,38436,-2,13365.0,18,13375.0,4,S
2018-04-19 14:24:59,13790.0,4,38440,2,13365.0,18,13375.0,4,S
2018-04-19 14:25:01,13785.0,4,38444,2,13365.0,18,13375.0,4,S
2018-04-19 14:25:04,13790.0,4,38448,-4,13365.0,18,13375.0,4,B
2018-04-19 14:25:05,13790.0,36,38484,-32,13365.0,18,13375.0,4,B
2018-04-19 14:25:14,13780.0,16,38500,-16,13365.0,18,13375.0,4,S
2018-04-19 14:25:15,13775.0,2,38502,-2,13365.0,18,13375.0,4,S
2018-04-19 14:25:31,13770.0,8,38510,4,13365.0,18,13375.0,4,S
2018-04-19 14:25:32,13770.0,8,38518,4,13365.0,18,13375.0,4,S
2018-04-19 14:25:32,13770.0,4,38522,0,13365.0,18,13375.0,4,S
2018-04-19 14:25:34,13770.0,8,38530,8,13365.0,18,13375.0,4,S
2018-04-19 14:25:34,13770.0,12,38542,12,13365.0,18,13375.0,4,S
2018-04-19 14:25:39,13775.0,6,38548,-6,13365.0,18,13375.0,4,B
2018-04-19 14:25:43,13775.0,2,38550,-2,13365.0,18,13375.0,4,B
2018-04-19 14:25:43,13775.0,32,38582,0,13365.0,18,13375.0,4,B
2018-04-19 14:25:51,13770.0,2,38584,0,13365.0,18,13375.0,4,S
2018-04-19 14:25:58,13765.0,2,38586,0,13365.0,18,13375.0,4,S
2018-04-19 14:26:07,13770.0,4,38590,0,13365.0,18,13375.0,4,B
2018-04-19 14:26:18,13775.0,2,38592,0,13365.0,18,13375.0,4,B
2018-04-19 14:26:22,13770.0,2,38594,0,13365.0,18,13375.0,4,S
2018-04-19 14:26:24,13775.0,2,38596,0,13365.0,18,13375.0,4,B
2018-04-19 14:26:26,13775.0,2,38598,-2,13365.0,18,13375.0,4,B
2018-04-19 14:26:34,13775.0,2,38600,0,13365.0,18,13375.0,4,B
2018-04-19 14:26:36,13770.0,20,38620,2,13365.0,18,13375.0,4,S
2018-04-19 14:26:52,13780.0,26,38646,-8,13365.0,18,13375.0,4,B
2018-04-19 14:26:52,13780.0,14,38660,-2,13365.0,18,13375.0,4,B
2018-04-19 14:26:54,13770.0,16,38676,-2,13365.0,18,13375.0,4,S
2018-04-19 14:26:54,13770.0,44,38720,-44,13365.0,18,13375.0,4,S
2018-04-19 14:26:58,13775.0,2,38722,0,13365.0,18,13375.0,4,B
2018-04-19 14:27:22,13780.0,2,38724,0,13365.0,18,13375.0,4,B
2018-04-19 14:27:22,13780.0,4,38728,0,13365.0,18,13375.0,4,B
2018-04-19 14:27:25,13785.0,24,38752,-20,13365.0,18,13375.0,4,B
2018-04-19 14:27:26,13785.0,4,38756,0,13365.0,18,13375.0,4,B
2018-04-19 14:27:26,13785.0,8,38764,-8,13365.0,18,13375.0,4,B
2018-04-19 14:27:35,13785.0,2,38766,-2,13365.0,18,13375.0,4,B
2018-04-19 14:27:49,13790.0,2,38768,0,13365.0,18,13375.0,4,B
2018-04-19 14:27:51,13785.0,2,38770,-2,13365.0,18,13375.0,4,S
2018-04-19 14:27:59,13790.0,2,38772,0,13365.0,18,13375.0,4,B
2018-04-19 14:28:21,13785.0,2,38774,0,13365.0,18,13375.0,4,S
2018-04-19 14:28:27,13790.0,4,38778,0,13365.0,18,13375.0,4,B
2018-04-19 14:28:29,13780.0,2,38780,2,13365.0,18,13375.0,4,S
2018-04-19 14:28:34,13780.0,2,38782,0,13365.0,18,13375.0,4,S
2018-04-19 14:28:42,13790.0,2,38784,0,13365.0,18,13375.0,4,B
2018-04-19 14:28:43,13790.0,2,38786,0,13365.0,18,13375.0,4,B
2018-04-19 14:28:52,13795.0,2,38788,-2,13365.0,18,13375.0,4,B
2018-04-19 14:28:53,13795.0,2,38790,0,13365.0,18,13375.0,4,B
2018-04-19 14:28:55,13800.0,2,38792,0,13365.0,18,13375.0,4,B
2018-04-19 14:28:55,13800.0,14,38806,6,13365.0,18,13375.0,4,B
2018-04-19 14:28:56,13805.0,2,38808,-2,13365.0,18,13375.0,4,B
2018-04-19 14:28:59,13805.0,2,38810,0,13365.0,18,13375.0,4,B
2018-04-19 14:29:01,13805.0,2,38812,0,13365.0,18,13375.0,4,B
2018-04-19 14:29:01,13805.0,2,38814,-2,13365.0,18,13375.0,4,B
2018-04-19 14:29:04,13805.0,2,38816,-2,13365.0,18,13375.0,4,B
2018-04-19 14:29:04,13810.0,4,38820,-4,13365.0,18,13375.0,4,B
2018-04-19 14:29:06,13805.0,12,38832,-4,13365.0,18,13375.0,4,S
2018-04-19 14:29:09,13800.0,2,38834,-2,13365.0,18,13375.0,4,S
2018-04-19 14:29:10,13805.0,8,38842,-2,13365.0,18,13375.0,4,B
2018-04-19 14:29:14,13800.0,6,38848,4,13365.0,18,13375.0,4,S
2018-04-19 14:29:18,13800.0,2,38850,-2,13365.0,18,13375.0,4,S
2018-04-19 14:29:22,13800.0,2,38852,2,13365.0,18,13375.0,4,S
2018-04-19 14:29:28,13795.0,6,38858,0,13365.0,18,13375.0,4,S
2018-04-19 14:29:28,13795.0,2,38860,2,13365.0,18,13375.0,4,S
2018-04-19 14:29:34,13790.0,2,38862,-2,13365.0,18,13375.0,4,S
2018-04-19 14:29:59,13790.0,6,38868,-2,13365.0,18,13375.0,4,S
2018-04-19 14:30:07,13790.0,2,38870,2,13365.0,18,13375.0,4,S
2018-04-19 14:30:12,13795.0,4,38874,-4,13365.0,18,13375.0,4,B
2018-04-19 14:30:12,13795.0,6,38880,-6,13365.0,18,13375.0,4,B
2018-04-19 14:30:20,13795.0,20,38900,-20,13365.0,18,13375.0,4,B
2018-04-19 14:30:21,13795.0,10,38910,-6,13365.0,18,13375.0,4,B
2018-04-19 14:30:22,13800.0,2,38912,2,13365.0,18,13375.0,4,B
2018-04-19 14:30:35,13795.0,2,38914,0,13365.0,18,13375.0,4,S
2018-04-19 14:30:40,13800.0,2,38916,2,13365.0,18,13375.0,4,B
2018-04-19 14:30:57,13800.0,2,38918,0,13365.0,18,13375.0,4,B
2018-04-19 14:31:06,13800.0,40,38958,-8,13365.0,18,13375.0,4,B
2018-04-19 14:31:07,13800.0,8,38966,2,13365.0,18,13375.0,4,B
2018-04-19 14:31:09,13795.0,8,38974,-8,13365.0,18,13375.0,4,S
2018-04-19 14:31:25,13795.0,2,38976,-2,13365.0,18,13375.0,4,S
2018-04-19 14:31:34,13780.0,8,38984,-2,13365.0,18,13375.0,4,S
2018-04-19 14:31:34,13780.0,12,38996,-4,13365.0,18,13375.0,4,S
2018-04-19 14:31:46,13780.0,18,39014,-16,13365.0,18,13375.0,4,S
2018-04-19 14:31:47,13780.0,2,39016,-2,13365.0,18,13375.0,4,S
2018-04-19 14:31:48,13780.0,2,39018,0,13365.0,18,13375.0,4,S
2018-04-19 14:31:57,13780.0,2,39020,2,13365.0,18,13375.0,4,S
2018-04-19 14:32:01,13780.0,4,39024,0,13365.0,18,13375.0,4,S
2018-04-19 14:32:02,13780.0,4,39028,0,13365.0,18,13375.0,4,S
2018-04-19 14:32:09,13775.0,6,39034,0,13365.0,18,13375.0,4,S
2018-04-19 14:32:10,13770.0,2,39036,0,13365.0,18,13375.0,4,S
2018-04-19 14:32:12,13770.0,2,39038,2,13365.0,18,13375.0,4,S
2018-04-19 14:32:15,13770.0,4,39042,-2,13365.0,18,13375.0,4,S
2018-04-19 14:32:19,13770.0,2,39044,-2,13365.0,18,13375.0,4,S
2018-04-19 14:32:19,13775.0,4,39048,2,13365.0,18,13375.0,4,B
2018-04-19 14:32:22,13770.0,4,39052,-4,13365.0,18,13375.0,4,S
2018-04-19 14:32:22,13770.0,32,39084,-4,13365.0,18,13375.0,4,S
2018-04-19 14:32:25,13775.0,2,39086,2,13365.0,18,13375.0,4,B
2018-04-19 14:32:32,13770.0,2,39088,-2,13365.0,18,13375.0,4,S
2018-04-19 14:32:39,13775.0,2,39090,0,13365.0,18,13375.0,4,B
2018-04-19 14:32:41,13780.0,10,39100,-8,13365.0,18,13375.0,4,B
2018-04-19 14:32:41,13780.0,4,39104,0,13365.0,18,13375.0,4,B
2018-04-19 14:32:42,13780.0,2,39106,0,13365.0,18,13375.0,4,B
2018-04-19 14:32:49,13785.0,40,39146,0,13365.0,18,13375.0,4,B
2018-04-19 14:32:50,13780.0,2,39148,2,13365.0,18,13375.0,4,S
2018-04-19 14:32:58,13785.0,2,39150,0,13365.0,18,13375.0,4,B
2018-04-19 14:33:06,13785.0,4,39154,-2,13365.0,18,13375.0,4,B
2018-04-19 14:33:06,13785.0,12,39166,-4,13365.0,18,13375.0,4,B
2018-04-19 14:33:11,13785.0,24,39190,-22,13365.0,18,13375.0,4,B
2018-04-19 14:33:11,13785.0,4,39194,2,13365.0,18,13375.0,4,B
2018-04-19 14:33:14,13785.0,2,39196,-2,13365.0,18,13375.0,4,B
2018-04-19 14:33:24,13790.0,2,39198,0,13365.0,18,13375.0,4,B
2018-04-19 14:33:40,13785.0,2,39200,2,13365.0,18,13375.0,4,S
2018-04-19 14:33:47,13785.0,20,39220,-4,13365.0,18,13375.0,4,S
2018-04-19 14:33:51,13790.0,2,39222,0,13365.0,18,13375.0,4,B
2018-04-19 14:34:06,13790.0,8,39230,-2,13365.0,18,13375.0,4,B
2018-04-19 14:34:07,13795.0,4,39234,0,13365.0,18,13375.0,4,B
2018-04-19 14:34:20,13795.0,2,39236,0,13365.0,18,13375.0,4,B
2018-04-19 14:34:36,13800.0,2,39238,0,13365.0,18,13375.0,4,B
2018-04-19 14:34:44,13795.0,2,39240,-2,13365.0,18,13375.0,4,S
2018-04-19 14:34:46,13800.0,2,39242,2,13365.0,18,13375.0,4,B
2018-04-19 14:34:46,13800.0,4,39246,2,13365.0,18,13375.0,4,B
2018-04-19 14:34:52,13800.0,6,39252,-6,13365.0,18,13375.0,4,B
2018-04-19 14:34:53,13800.0,2,39254,-2,13365.0,18,13375.0,4,B
2018-04-19 14:35:03,13800.0,6,39260,2,13365.0,18,13375.0,4,B
2018-04-19 14:35:07,13800.0,2,39262,0,13365.0,18,13375.0,4,B
2018-04-19 14:35:20,13795.0,4,39266,0,13365.0,18,13375.0,4,S
2018-04-19 14:35:21,13790.0,2,39268,-2,13365.0,18,13375.0,4,S
2018-04-19 14:35:26,13790.0,2,39270,-2,13365.0,18,13375.0,4,S
2018-04-19 14:35:33,13795.0,4,39274,2,13365.0,18,13375.0,4,B
2018-04-19 14:35:35,13790.0,2,39276,0,13365.0,18,13375.0,4,S
2018-04-19 14:35:52,13790.0,2,39278,-2,13365.0,18,13375.0,4,S
2018-04-19 14:35:52,13790.0,2,39280,-2,13365.0,18,13375.0,4,S
2018-04-19 14:35:56,13795.0,2,39282,2,13365.0,18,13375.0,4,B
2018-04-19 14:36:37,13800.0,4,39286,-2,13365.0,18,13375.0,4,B
2018-04-19 14:36:53,13805.0,28,39314,-18,13365.0,18,13375.0,4,B
2018-04-19 14:36:54,13805.0,2,39316,0,13365.0,18,13375.0,4,B
2018-04-19 14:36:54,13805.0,2,39318,-2,13365.0,18,13375.0,4,B
2018-04-19 14:36:59,13805.0,6,39324,-2,13365.0,18,13375.0,4,B
2018-04-19 14:37:02,13805.0,2,39326,-2,13365.0,18,13375.0,4,B
2018-04-19 14:37:12,13810.0,2,39328,2,13365.0,18,13375.0,4,B
2018-04-19 14:37:14,13805.0,2,39330,2,13365.0,18,13375.0,4,S
2018-04-19 14:37:20,13805.0,2,39332,-2,13365.0,18,13375.0,4,S
2018-04-19 14:37:24,13800.0,4,39336,0,13365.0,18,13375.0,4,S
2018-04-19 14:37:40,13805.0,18,39354,-16,13365.0,18,13375.0,4,B
2018-04-19 14:37:40,13805.0,2,39356,0,13365.0,18,13375.0,4,B
2018-04-19 14:37:41,13805.0,2,39358,-2,13365.0,18,13375.0,4,B
2018-04-19 14:37:55,13810.0,2,39360,0,13365.0,18,13375.0,4,B
2018-04-19 14:37:57,13800.0,2,39362,0,13365.0,18,13375.0,4,S
2018-04-19 14:38:21,13805.0,2,39364,0,13365.0,18,13375.0,4,B
2018-04-19 14:38:28,13810.0,10,39374,-8,13365.0,18,13375.0,4,B
2018-04-19 14:38:29,13810.0,4,39378,-2,13365.0,18,13375.0,4,B
2018-04-19 14:38:31,13810.0,4,39382,0,13365.0,18,13375.0,4,B
2018-04-19 14:38:32,13810.0,12,39394,0,13365.0,18,13375.0,4,B
2018-04-19 14:38:39,13805.0,2,39396,0,13365.0,18,13375.0,4,S
2018-04-19 14:39:11,13800.0,2,39398,0,13365.0,18,13375.0,4,S
2018-04-19 14:39:12,13795.0,2,39400,0,13365.0,18,13375.0,4,S
2018-04-19 14:39:32,13800.0,2,39402,-2,13365.0,18,13375.0,4,B
2018-04-19 14:39:32,13800.0,2,39404,-2,13365.0,18,13375.0,4,B
2018-04-19 14:39:37,13795.0,2,39406,2,13365.0,18,13375.0,4,S
2018-04-19 14:39:37,13795.0,6,39412,2,13365.0,18,13375.0,4,S
2018-04-19 14:39:38,13795.0,2,39414,2,13365.0,18,13375.0,4,S
2018-04-19 14:39:39,13795.0,2,39416,2,13365.0,18,13375.0,4,S
2018-04-19 14:39:47,13790.0,2,39418,-2,13365.0,18,13375.0,4,S
2018-04-19 14:39:55,13795.0,4,39422,4,13365.0,18,13375.0,4,B
2018-04-19 14:39:57,13795.0,4,39426,0,13365.0,18,13375.0,4,B
2018-04-19 14:39:58,13795.0,6,39432,-2,13365.0,18,13375.0,4,B
2018-04-19 14:40:09,13800.0,4,39436,4,13365.0,18,13375.0,4,B
2018-04-19 14:40:17,13800.0,4,39440,0,13365.0,18,13375.0,4,B
2018-04-19 14:40:23,13795.0,2,39442,-2,13365.0,18,13375.0,4,S
2018-04-19 14:40:23,13795.0,2,39444,0,13365.0,18,13375.0,4,S
2018-04-19 14:40:30,13800.0,4,39448,0,13365.0,18,13375.0,4,B
2018-04-19 14:40:31,13800.0,4,39452,4,13365.0,18,13375.0,4,B
2018-04-19 14:40:32,13795.0,2,39454,0,13365.0,18,13375.0,4,S
2018-04-19 14:40:34,13800.0,2,39456,2,13365.0,18,13375.0,4,B
2018-04-19 14:40:55,13795.0,2,39458,0,13365.0,18,13375.0,4,S
2018-04-19 14:41:08,13795.0,2,39460,2,13365.0,18,13375.0,4,S
2018-04-19 14:41:24,13795.0,2,39462,-2,13365.0,18,13375.0,4,S
2018-04-19 14:41:27,13790.0,4,39466,-2,13365.0,18,13375.0,4,S
2018-04-19 14:41:41,13790.0,4,39470,4,13365.0,18,13375.0,4,S
2018-04-19 14:42:25,13790.0,2,39472,0,13365.0,18,13375.0,4,S
2018-04-19 14:42:25,13790.0,4,39476,0,13365.0,18,13375.0,4,S
2018-04-19 14:42:42,13795.0,4,39480,-2,13365.0,18,13375.0,4,B
2018-04-19 14:42:59,13790.0,2,39482,2,13365.0,18,13375.0,4,S
2018-04-19 14:43:06,13795.0,4,39486,4,13365.0,18,13375.0,4,B
2018-04-19 14:43:14,13795.0,2,39488,2,13365.0,18,13375.0,4,B
2018-04-19 14:43:15,13795.0,28,39516,0,13365.0,18,13375.0,4,B
2018-04-19 14:43:15,13795.0,2,39518,0,13365.0,18,13375.0,4,B
2018-04-19 14:43:18,13795.0,2,39520,0,13365.0,18,13375.0,4,B
2018-04-19 14:43:28,13795.0,2,39522,-2,13365.0,18,13375.0,4,B
2018-04-19 14:43:34,13795.0,2,39524,-2,13365.0,18,13375.0,4,B
2018-04-19 14:44:11,13795.0,20,39544,-18,13365.0,18,13375.0,4,B
2018-04-19 14:44:15,13790.0,2,39546,-2,13365.0,18,13375.0,4,S
2018-04-19 14:44:24,13790.0,4,39550,0,13365.0,18,13375.0,4,S
2018-04-19 14:44:25,13795.0,2,39552,-2,13365.0,18,13375.0,4,B
2018-04-19 14:44:49,13795.0,2,39554,-2,13365.0,18,13375.0,4,B
2018-04-19 14:44:51,13790.0,2,39556,2,13365.0,18,13375.0,4,S
2018-04-19 14:45:08,13790.0,4,39560,2,13365.0,18,13375.0,4,S
2018-04-19 14:45:21,13785.0,2,39562,2,13365.0,18,13375.0,4,S
2018-04-19 14:45:25,13785.0,8,39570,-4,13365.0,18,13375.0,4,S
2018-04-19 14:45:32,13790.0,2,39572,2,13365.0,18,13375.0,4,B
2018-04-19 14:45:36,13785.0,2,39574,-2,13365.0,18,13375.0,4,S
2018-04-19 14:45:43,13785.0,4,39578,0,13365.0,18,13375.0,4,S
2018-04-19 14:45:50,13785.0,16,39594,-16,13365.0,18,13375.0,4,S
2018-04-19 14:45:55,13790.0,4,39598,0,13365.0,18,13375.0,4,B
2018-04-19 14:45:57,13780.0,6,39604,2,13365.0,18,13375.0,4,S
2018-04-19 14:45:58,13780.0,14,39618,8,13365.0,18,13375.0,4,S
2018-04-19 14:46:07,13780.0,20,39638,14,13365.0,18,13375.0,4,S
2018-04-19 14:46:12,13780.0,34,39672,0,13365.0,18,13375.0,4,S
2018-04-19 14:46:13,13780.0,2,39674,0,13365.0,18,13375.0,4,S
2018-04-19 14:46:18,13780.0,20,39694,0,13365.0,18,13375.0,4,S
2018-04-19 14:46:20,13780.0,4,39698,0,13365.0,18,13375.0,4,S
2018-04-19 14:46:20,13780.0,6,39704,0,13365.0,18,13375.0,4,S
2018-04-19 14:46:25,13775.0,4,39708,2,13365.0,18,13375.0,4,S
2018-04-19 14:46:26,13775.0,6,39714,6,13365.0,18,13375.0,4,S
2018-04-19 14:46:26,13775.0,10,39724,6,13365.0,18,13375.0,4,S
2018-04-19 14:46:27,13785.0,2,39726,-2,13365.0,18,13375.0,4,B
2018-04-19 14:46:32,13775.0,8,39734,0,13365.0,18,13375.0,4,S
2018-04-19 14:46:37,13770.0,20,39754,4,13365.0,18,13375.0,4,S
2018-04-19 14:46:38,13775.0,2,39756,-2,13365.0,18,13375.0,4,B
2018-04-19 14:46:44,13770.0,22,39778,12,13365.0,18,13375.0,4,S
2018-04-19 14:46:48,13770.0,20,39798,20,13365.0,18,13375.0,4,S
2018-04-19 14:46:59,13770.0,2,39800,2,13365.0,18,13375.0,4,S
2018-04-19 14:47:06,13775.0,20,39820,0,13365.0,18,13375.0,4,B
2018-04-19 14:47:21,13775.0,2,39822,0,13365.0,18,13375.0,4,B
2018-04-19 14:47:23,13775.0,8,39830,-4,13365.0,18,13375.0,4,B
2018-04-19 14:47:26,13765.0,10,39840,-6,13365.0,18,13375.0,4,S
2018-04-19 14:47:27,13760.0,10,39850,-4,13365.0,18,13375.0,4,S
2018-04-19 14:47:28,13760.0,4,39854,4,13365.0,18,13375.0,4,S
2018-04-19 14:47:28,13755.0,12,39866,2,13365.0,18,13375.0,4,S
2018-04-19 14:47:29,13760.0,12,39878,12,13365.0,18,13375.0,4,B
2018-04-19 14:47:32,13760.0,2,39880,-2,13365.0,18,13375.0,4,B
2018-04-19 14:47:35,13760.0,2,39882,2,13365.0,18,13375.0,4,B
2018-04-19 14:47:35,13765.0,2,39884,0,13365.0,18,13375.0,4,B
2018-04-19 14:47:36,13760.0,2,39886,-2,13365.0,18,13375.0,4,S
2018-04-19 14:47:37,13760.0,2,39888,-2,13365.0,18,13375.0,4,S
2018-04-19 14:47:41,13765.0,2,39890,0,13365.0,18,13375.0,4,B
2018-04-19 14:48:00,13765.0,2,39892,0,13365.0,18,13375.0,4,B
2018-04-19 14:48:02,13765.0,2,39894,2,13365.0,18,13375.0,4,B
2018-04-19 14:48:34,13765.0,4,39898,-4,13365.0,18,13375.0,4,B
2018-04-19 14:48:50,13770.0,2,39900,-2,13365.0,18,13375.0,4,B
2018-04-19 14:48:51,13770.0,8,39908,2,13365.0,18,13375.0,4,B
2018-04-19 14:48:51,13775.0,2,39910,0,13365.0,18,13375.0,4,B
2018-04-19 14:48:52,13780.0,2,39912,-2,13365.0,18,13375.0,4,B
2018-04-19 14:48:53,13780.0,2,39914,-2,13365.0,18,13375.0,4,B
2018-04-19 14:48:53,13770.0,10,39924,0,13365.0,18,13375.0,4,S
2018-04-19 14:48:55,13780.0,2,39926,0,13365.0,18,13375.0,4,B
2018-04-19 14:49:18,13765.0,2,39928,0,13365.0,18,13375.0,4,S
2018-04-19 14:49:19,13775.0,2,39930,2,13365.0,18,13375.0,4,B
2018-04-19 14:49:20,13775.0,6,39936,-6,13365.0,18,13375.0,4,B
2018-04-19 14:49:35,13775.0,2,39938,0,13365.0,18,13375.0,4,B
2018-04-19 14:49:44,13775.0,2,39940,0,13365.0,18,13375.0,4,B
2018-04-19 14:49:45,13775.0,2,39942,0,13365.0,18,13375.0,4,B
2018-04-19 14:49:57,13780.0,2,39944,0,13365.0,18,13375.0,4,B
2018-04-19 14:49:57,13780.0,2,39946,0,13365.0,18,13375.0,4,B
2018-04-19 14:49:58,13780.0,2,39948,0,13365.0,18,13375.0,4,B
2018-04-19 14:49:59,13780.0,2,39950,0,13365.0,18,13375.0,4,B
2018-04-19 14:49:59,13780.0,2,39952,-2,13365.0,18,13375.0,4,B
2018-04-19 14:50:03,13780.0,2,39954,0,13365.0,18,13375.0,4,B
2018-04-19 14:50:04,13780.0,4,39958,0,13365.0,18,13375.0,4,B
2018-04-19 14:50:06,13785.0,2,39960,-2,13365.0,18,13375.0,4,B
2018-04-19 14:50:08,13780.0,2,39962,0,13365.0,18,13375.0,4,S
2018-04-19 14:50:14,13780.0,4,39966,0,13365.0,18,13375.0,4,S
2018-04-19 14:50:15,13780.0,4,39970,0,13365.0,18,13375.0,4,S
2018-04-19 14:50:16,13785.0,2,39972,0,13365.0,18,13375.0,4,B
2018-04-19 14:50:20,13785.0,2,39974,0,13365.0,18,13375.0,4,B
2018-04-19 14:50:51,13785.0,2,39976,2,13365.0,18,13375.0,4,B
2018-04-19 14:50:59,13785.0,22,39998,0,13365.0,18,13375.0,4,B
2018-04-19 14:51:01,13785.0,4,40002,-2,13365.0,18,13375.0,4,B
2018-04-19 14:51:16,13785.0,2,40004,0,13365.0,18,13375.0,4,B
2018-04-19 14:51:18,13780.0,2,40006,-2,13365.0,18,13375.0,4,S
2018-04-19 14:51:21,13780.0,2,40008,0,13365.0,18,13375.0,4,S
2018-04-19 14:51:27,13785.0,2,40010,-2,13365.0,18,13375.0,4,B
2018-04-19 14:51:28,13785.0,4,40014,-2,13365.0,18,13375.0,4,B
2018-04-19 14:51:29,13785.0,2,40016,-2,13365.0,18,13375.0,4,B
2018-04-19 14:51:32,13785.0,8,40024,-8,13365.0,18,13375.0,4,B
2018-04-19 14:51:34,13785.0,6,40030,0,13365.0,18,13375.0,4,B
2018-04-19 14:51:54,13785.0,2,40032,0,13365.0,18,13375.0,4,B
2018-04-19 14:52:09,13790.0,2,40034,-2,13365.0,18,13375.0,4,B
2018-04-19 14:52:10,13790.0,2,40036,0,13365.0,18,13375.0,4,B
2018-04-19 14:52:11,13780.0,2,40038,0,13365.0,18,13375.0,4,S
2018-04-19 14:52:14,13790.0,2,40040,2,13365.0,18,13375.0,4,B
2018-04-19 14:52:19,13785.0,2,40042,2,13365.0,18,13375.0,4,S
2018-04-19 14:52:25,13785.0,2,40044,-2,13365.0,18,13375.0,4,S
2018-04-19 14:52:28,13780.0,2,40046,0,13365.0,18,13375.0,4,S
2018-04-19 14:52:41,13780.0,2,40048,2,13365.0,18,13375.0,4,S
2018-04-19 14:52:42,13775.0,28,40076,10,13365.0,18,13375.0,4,S
2018-04-19 14:52:43,13780.0,2,40078,0,13365.0,18,13375.0,4,B
2018-04-19 14:52:54,13780.0,2,40080,0,13365.0,18,13375.0,4,B
2018-04-19 14:52:59,13785.0,2,40082,0,13365.0,18,13375.0,4,B
2018-04-19 14:53:01,13790.0,2,40084,2,13365.0,18,13375.0,4,B
2018-04-19 14:53:05,13790.0,2,40086,0,13365.0,18,13375.0,4,B
2018-04-19 14:53:06,13790.0,2,40088,0,13365.0,18,13375.0,4,B
2018-04-19 14:53:06,13790.0,2,40090,0,13365.0,18,13375.0,4,B
2018-04-19 14:53:07,13790.0,2,40092,0,13365.0,18,13375.0,4,B
2018-04-19 14:53:07,13790.0,2,40094,0,13365.0,18,13375.0,4,B
2018-04-19 14:53:08,13790.0,2,40096,0,13365.0,18,13375.0,4,B
2018-04-19 14:53:08,13790.0,2,40098,0,13365.0,18,13375.0,4,B
2018-04-19 14:53:09,13790.0,2,40100,0,13365.0,18,13375.0,4,B
2018-04-19 14:53:10,13790.0,2,40102,0,13365.0,18,13375.0,4,B
2018-04-19 14:53:10,13790.0,2,40104,0,13365.0,18,13375.0,4,B
2018-04-19 14:53:11,13790.0,2,40106,0,13365.0,18,13375.0,4,B
2018-04-19 14:53:14,13780.0,2,40108,2,13365.0,18,13375.0,4,S
2018-04-19 14:53:16,13785.0,2,40110,-2,13365.0,18,13375.0,4,B
2018-04-19 14:53:24,13780.0,4,40114,0,13365.0,18,13375.0,4,S
2018-04-19 14:53:26,13785.0,2,40116,0,13365.0,18,13375.0,4,B
2018-04-19 14:53:27,13785.0,2,40118,0,13365.0,18,13375.0,4,B
2018-04-19 14:53:28,13785.0,2,40120,0,13365.0,18,13375.0,4,B
2018-04-19 14:53:28,13785.0,2,40122,0,13365.0,18,13375.0,4,B
2018-04-19 14:53:29,13785.0,2,40124,0,13365.0,18,13375.0,4,B
2018-04-19 14:53:29,13790.0,2,40126,0,13365.0,18,13375.0,4,B
2018-04-19 14:53:30,13790.0,2,40128,0,13365.0,18,13375.0,4,B
2018-04-19 14:53:30,13790.0,4,40132,0,13365.0,18,13375.0,4,B
2018-04-19 14:53:31,13790.0,2,40134,0,13365.0,18,13375.0,4,B
2018-04-19 14:53:31,13790.0,2,40136,0,13365.0,18,13375.0,4,B
2018-04-19 14:53:44,13785.0,2,40138,0,13365.0,18,13375.0,4,S
2018-04-19 14:53:45,13790.0,2,40140,-2,13365.0,18,13375.0,4,B
2018-04-19 14:53:56,13780.0,2,40142,-2,13365.0,18,13375.0,4,S
2018-04-19 14:54:01,13785.0,2,40144,-2,13365.0,18,13375.0,4,B
2018-04-19 14:54:09,13780.0,2,40146,-2,13365.0,18,13375.0,4,S
2018-04-19 14:54:10,13780.0,4,40150,0,13365.0,18,13375.0,4,S
2018-04-19 14:54:10,13780.0,6,40156,-6,13365.0,18,13375.0,4,S
2018-04-19 14:54:11,13780.0,8,40164,0,13365.0,18,13375.0,4,S
2018-04-19 14:54:14,13785.0,2,40166,0,13365.0,18,13375.0,4,B
2018-04-19 14:54:15,13785.0,2,40168,0,13365.0,18,13375.0,4,B
2018-04-19 14:54:16,13785.0,2,40170,-2,13365.0,18,13375.0,4,B
2018-04-19 14:54:16,13790.0,2,40172,-2,13365.0,18,13375.0,4,B
2018-04-19 14:54:17,13790.0,2,40174,-2,13365.0,18,13375.0,4,B
2018-04-19 14:54:17,13790.0,2,40176,-2,13365.0,18,13375.0,4,B
2018-04-19 14:54:18,13790.0,2,40178,0,13365.0,18,13375.0,4,B
2018-04-19 14:54:18,13790.0,2,40180,-2,13365.0,18,13375.0,4,B
2018-04-19 14:54:19,13790.0,2,40182,-2,13365.0,18,13375.0,4,B
2018-04-19 14:54:29,13785.0,12,40194,-12,13365.0,18,13375.0,4,S
2018-04-19 14:54:29,13785.0,8,40202,-2,13365.0,18,13375.0,4,S
2018-04-19 14:54:39,13785.0,2,40204,-2,13365.0,18,13375.0,4,S
2018-04-19 14:54:42,13780.0,20,40224,0,13365.0,18,13375.0,4,S
2018-04-19 14:54:43,13790.0,2,40226,-2,13365.0,18,13375.0,4,B
2018-04-19 14:54:55,13780.0,2,40228,0,13365.0,18,13375.0,4,S
2018-04-19 14:54:57,13780.0,2,40230,2,13365.0,18,13375.0,4,S
2018-04-19 14:55:01,13780.0,8,40238,2,13365.0,18,13375.0,4,S
2018-04-19 14:55:01,13780.0,2,40240,-2,13365.0,18,13375.0,4,S
2018-04-19 14:55:03,13780.0,2,40242,0,13365.0,18,13375.0,4,S
2018-04-19 14:55:03,13790.0,4,40246,-4,13365.0,18,13375.0,4,B
2018-04-19 14:55:04,13790.0,2,40248,0,13365.0,18,13375.0,4,B
2018-04-19 14:55:05,13790.0,2,40250,0,13365.0,18,13375.0,4,B
2018-04-19 14:55:05,13790.0,2,40252,0,13365.0,18,13375.0,4,B
2018-04-19 14:55:06,13790.0,2,40254,0,13365.0,18,13375.0,4,B
2018-04-19 14:55:18,13785.0,8,40262,-4,13365.0,18,13375.0,4,S
2018-04-19 14:55:18,13785.0,2,40264,0,13365.0,18,13375.0,4,S
2018-04-19 14:55:19,13785.0,2,40266,-2,13365.0,18,13375.0,4,S
2018-04-19 14:55:19,13790.0,2,40268,-2,13365.0,18,13375.0,4,B
2018-04-19 14:55:23,13780.0,6,40274,0,13365.0,18,13375.0,4,S
2018-04-19 14:55:23,13780.0,8,40282,0,13365.0,18,13375.0,4,S
2018-04-19 14:55:25,13780.0,6,40288,4,13365.0,18,13375.0,4,S
2018-04-19 14:55:26,13780.0,14,40302,10,13365.0,18,13375.0,4,S
2018-04-19 14:55:26,13780.0,18,40320,14,13365.0,18,13375.0,4,S
2018-04-19 14:55:27,13790.0,10,40330,8,13365.0,18,13375.0,4,B
2018-04-19 14:55:27,13790.0,2,40332,0,13365.0,18,13375.0,4,B
2018-04-19 14:55:28,13790.0,2,40334,0,13365.0,18,13375.0,4,B
2018-04-19 14:55:33,13790.0,6,40340,0,13365.0,18,13375.0,4,B
2018-04-19 14:55:34,13790.0,10,40350,10,13365.0,18,13375.0,4,B
2018-04-19 14:55:36,13780.0,2,40352,-2,13365.0,18,13375.0,4,S
2018-04-19 14:55:38,13780.0,20,40372,16,13365.0,18,13375.0,4,S
2018-04-19 14:55:52,13780.0,4,40376,2,13365.0,18,13375.0,4,S
2018-04-19 14:56:21,13780.0,20,40396,0,13365.0,18,13375.0,4,S
2018-04-19 14:56:25,13780.0,6,40402,-6,13365.0,18,13375.0,4,S
2018-04-19 14:56:26,13780.0,2,40404,0,13365.0,18,13375.0,4,S
2018-04-19 14:56:27,13785.0,4,40408,-2,13365.0,18,13375.0,4,B
2018-04-19 14:56:54,13785.0,2,40410,-2,13365.0,18,13375.0,4,B
2018-04-19 14:57:01,13785.0,4,40414,-2,13365.0,18,13375.0,4,B
2018-04-19 14:57:02,13780.0,4,40418,-4,13365.0,18,13375.0,4,S
2018-04-19 14:57:04,13780.0,8,40426,-8,13365.0,18,13375.0,4,S
2018-04-19 14:57:05,13780.0,2,40428,-2,13365.0,18,13375.0,4,S
2018-04-19 14:57:06,13780.0,4,40432,-4,13365.0,18,13375.0,4,S
2018-04-19 14:57:08,13780.0,2,40434,-2,13365.0,18,13375.0,4,S
2018-04-19 14:57:08,13785.0,2,40436,2,13365.0,18,13375.0,4,B
2018-04-19 14:57:14,13785.0,2,40438,2,13365.0,18,13375.0,4,B
2018-04-19 14:57:15,13780.0,4,40442,2,13365.0,18,13375.0,4,S
2018-04-19 14:57:17,13780.0,2,40444,2,13365.0,18,13375.0,4,S
2018-04-19 14:57:18,13780.0,4,40448,4,13365.0,18,13375.0,4,S
2018-04-19 14:57:22,13780.0,2,40450,2,13365.0,18,13375.0,4,S
2018-04-19 14:57:23,13780.0,2,40452,2,13365.0,18,13375.0,4,S
2018-04-19 14:57:28,13780.0,2,40454,0,13365.0,18,13375.0,4,S
2018-04-19 14:57:31,13775.0,10,40464,0,13365.0,18,13375.0,4,S
2018-04-19 14:57:38,13775.0,4,40468,4,13365.0,18,13375.0,4,S
2018-04-19 14:57:42,13775.0,10,40478,0,13365.0,18,13375.0,4,S
2018-04-19 14:58:00,13780.0,16,40494,-2,13365.0,18,13375.0,4,B
2018-04-19 14:58:03,13775.0,2,40496,0,13365.0,18,13375.0,4,S
2018-04-19 14:58:06,13775.0,2,40498,2,13365.0,18,13375.0,4,S
2018-04-19 14:58:09,13780.0,2,40500,0,13365.0,18,13375.0,4,B
2018-04-19 14:58:14,13780.0,2,40502,0,13365.0,18,13375.0,4,B
2018-04-19 14:58:15,13780.0,10,40512,10,13365.0,18,13375.0,4,B
2018-04-19 14:58:15,13780.0,2,40514,0,13365.0,18,13375.0,4,B
2018-04-19 14:58:16,13780.0,2,40516,0,13365.0,18,13375.0,4,B
2018-04-19 14:58:16,13780.0,2,40518,0,13365.0,18,13375.0,4,B
2018-04-19 14:58:18,13775.0,42,40560,38,13365.0,18,13375.0,4,S
2018-04-19 14:58:18,13775.0,8,40568,0,13365.0,18,13375.0,4,S
2018-04-19 14:58:20,13775.0,2,40570,2,13365.0,18,13375.0,4,S
2018-04-19 14:58:22,13775.0,4,40574,4,13365.0,18,13375.0,4,S
2018-04-19 14:58:23,13775.0,2,40576,2,13365.0,18,13375.0,4,S
2018-04-19 14:58:23,13775.0,20,40596,0,13365.0,18,13375.0,4,S
2018-04-19 14:58:24,13775.0,2,40598,2,13365.0,18,13375.0,4,S
2018-04-19 14:58:25,13780.0,2,40600,0,13365.0,18,13375.0,4,B
2018-04-19 14:58:39,13785.0,2,40602,0,13365.0,18,13375.0,4,B
2018-04-19 14:58:41,13785.0,10,40612,4,13365.0,18,13375.0,4,B
2018-04-19 14:58:41,13780.0,2,40614,0,13365.0,18,13375.0,4,S
2018-04-19 14:58:46,13785.0,2,40616,2,13365.0,18,13375.0,4,B
2018-04-19 14:58:46,13785.0,2,40618,0,13365.0,18,13375.0,4,B
2018-04-19 14:58:51,13785.0,4,40622,4,13365.0,18,13375.0,4,B
2018-04-19 14:59:00,13790.0,8,40630,0,13365.0,18,13375.0,4,B
2018-04-19 14:59:04,13785.0,2,40632,0,13365.0,18,13375.0,4,S
2018-04-19 14:59:11,13785.0,4,40636,4,13365.0,18,13375.0,4,S
2018-04-19 14:59:11,13785.0,6,40642,4,13365.0,18,13375.0,4,S
2018-04-19 14:59:12,13785.0,4,40646,0,13365.0,18,13375.0,4,S
2018-04-19 14:59:12,13785.0,2,40648,0,13365.0,18,13375.0,4,S
2018-04-19 14:59:15,13785.0,2,40650,-2,13365.0,18,13375.0,4,S
2018-04-19 14:59:18,13780.0,4,40654,-4,13365.0,18,13375.0,4,S
2018-04-19 14:59:21,13790.0,2,40656,2,13365.0,18,13375.0,4,B
2018-04-19 14:59:21,13790.0,2,40658,2,13365.0,18,13375.0,4,B
2018-04-19 14:59:23,13790.0,2,40660,2,13365.0,18,13375.0,4,B
2018-04-19 14:59:23,13790.0,2,40662,0,13365.0,18,13375.0,4,B
2018-04-19 14:59:24,13790.0,44,40706,2,13365.0,18,13375.0,4,B
2018-04-19 14:59:25,13790.0,10,40716,10,13365.0,18,13375.0,4,B
2018-04-19 14:59:26,13795.0,2,40718,2,13365.0,18,13375.0,4,B
2018-04-19 14:59:27,13790.0,4,40722,0,13365.0,18,13375.0,4,S
2018-04-19 14:59:30,13795.0,4,40726,0,13365.0,18,13375.0,4,B
2018-04-19 14:59:31,13795.0,2,40728,2,13365.0,18,13375.0,4,B
2018-04-19 14:59:34,13795.0,4,40732,0,13365.0,18,13375.0,4,B
2018-04-19 14:59:35,13795.0,2,40734,2,13365.0,18,13375.0,4,B
2018-04-19 14:59:36,13795.0,10,40744,8,13365.0,18,13375.0,4,B
2018-04-19 14:59:39,13795.0,2,40746,0,13365.0,18,13375.0,4,B
2018-04-19 14:59:40,13795.0,10,40756,8,13365.0,18,13375.0,4,B
2018-04-19 14:59:41,13800.0,2,40758,0,13365.0,18,13375.0,4,B
2018-04-19 14:59:46,13795.0,2,40760,2,13365.0,18,13375.0,4,S
2018-04-19 14:59:49,13795.0,2,40762,2,13365.0,18,13375.0,4,S
2018-04-19 14:59:50,13790.0,4,40766,-2,13365.0,18,13375.0,4,S
2018-04-19 14:59:50,13800.0,2,40768,0,13365.0,18,13375.0,4,B
2018-04-19 14:59:54,13795.0,4,40772,4,13365.0,18,13375.0,4,S
2018-04-19 14:59:55,13800.0,2,40774,0,13365.0,18,13375.0,4,B
2018-04-19 14:59:55,13800.0,10,40784,0,13365.0,18,13375.0,4,B
2018-04-19 14:59:56,13800.0,26,40810,16,13365.0,18,13375.0,4,B
2018-04-19 14:59:56,13800.0,4,40814,-4,13365.0,18,13375.0,4,B
2018-04-19 20:59:00,13765.0,22,22,70376,0.0,0,0.0,0,B
2018-04-19 21:00:00,13765.0,34,56,4,13750.0,3,13760.0,7,B
2018-04-19 21:00:01,13760.0,14,70,4,13770.0,2,13780.0,1,S
2018-04-19 21:00:01,13785.0,4,74,0,13770.0,6,13785.0,39,B
2018-04-19 21:00:02,13770.0,16,90,2,13775.0,3,13785.0,41,S
2018-04-19 21:00:02,13770.0,18,108,6,13770.0,1,13785.0,39,S
2018-04-19 21:00:03,13770.0,2,110,0,13770.0,6,13785.0,39,S
2018-04-19 21:00:04,13770.0,12,122,12,13765.0,5,13785.0,39,S
2018-04-19 21:00:05,13785.0,4,126,4,13770.0,6,13785.0,34,B
2018-04-19 21:00:07,13785.0,18,144,18,13775.0,1,13785.0,26,B
2018-04-19 21:00:07,13780.0,8,152,8,13770.0,6,13780.0,5,S
2018-04-19 21:00:08,13770.0,22,174,2,13770.0,2,13780.0,4,S
2018-04-19 21:00:09,13785.0,50,224,2,13780.0,4,13785.0,5,B
2018-04-19 21:00:10,13785.0,4,228,4,13780.0,3,13785.0,4,B
2018-04-19 21:00:10,13785.0,6,234,0,13780.0,3,13785.0,1,B
2018-04-19 21:00:11,13785.0,2,236,0,13785.0,1,13790.0,41,B
2018-04-19 21:00:11,13785.0,2,238,0,13780.0,8,13790.0,41,B
2018-04-19 21:00:12,13790.0,2,240,-2,13780.0,5,13790.0,40,B
2018-04-19 21:00:12,13780.0,2,242,0,13780.0,4,13790.0,40,S
2018-04-19 21:00:13,13780.0,8,250,-8,13775.0,3,13790.0,40,S
2018-04-19 21:00:14,13785.0,2,252,0,13775.0,1,13785.0,3,B
2018-04-19 21:00:15,13780.0,2,254,0,13780.0,1,13785.0,3,S
2018-04-19 21:00:17,13780.0,6,260,2,13775.0,4,13780.0,1,S
2018-04-19 21:00:17,13780.0,8,268,-4,13785.0,2,13790.0,40,S
2018-04-19 21:00:18,13780.0,2,270,-2,13785.0,1,13790.0,40,S
2018-04-19 21:00:18,13785.0,2,272,-2,13780.0,2,13790.0,40,B
2018-04-19 21:00:20,13790.0,2,274,-2,13780.0,1,13790.0,39,B
2018-04-19 21:00:22,13785.0,2,276,0,13780.0,2,13785.0,4,S
2018-04-19 21:00:23,13785.0,2,278,0,13780.0,2,13785.0,3,S
2018-04-19 21:00:23,13785.0,6,284,0,13785.0,1,13790.0,42,S
2018-04-19 21:00:24,13785.0,4,288,2,13780.0,3,13785.0,1,S
2018-04-19 21:00:24,13785.0,2,290,2,13780.0,3,13790.0,42,S
2018-04-19 21:00:25,13780.0,6,296,2,13780.0,4,13790.0,41,S
2018-04-19 21:00:26,13790.0,2,298,0,13780.0,4,13790.0,40,B
2018-04-19 21:00:27,13780.0,12,310,-2,13775.0,7,13790.0,40,S
2018-04-19 21:00:29,13785.0,2,312,2,13775.0,11,13785.0,9,B
2018-04-19 21:00:32,13785.0,2,314,2,13780.0,9,13785.0,10,B
2018-04-19 21:00:32,13780.0,12,326,0,13775.0,9,13780.0,2,S
2018-04-19 21:00:34,13780.0,2,328,0,13775.0,5,13780.0,5,S
2018-04-19 21:00:34,13780.0,10,338,-4,13780.0,4,13785.0,14,S
2018-04-19 21:00:35,13780.0,2,340,0,13780.0,6,13785.0,14,S
2018-04-19 21:00:36,13780.0,2,342,0,13775.0,19,13780.0,2,S
2018-04-19 21:00:38,13780.0,4,346,4,13775.0,19,13785.0,14,S
2018-04-19 21:00:40,13775.0,26,372,14,13775.0,1,13780.0,2,S
2018-04-19 21:00:40,13780.0,8,380,4,13765.0,16,13780.0,1,B
2018-04-19 21:00:41,13780.0,2,382,-2,13770.0,9,13780.0,10,B
2018-04-19 21:00:42,13780.0,2,384,0,13775.0,3,13785.0,10,B
2018-04-19 21:00:43,13785.0,2,386,2,13775.0,3,13785.0,18,B
2018-04-19 21:00:48,13775.0,2,388,2,13775.0,2,13780.0,12,S
2018-04-19 21:00:50,13775.0,4,392,4,13770.0,4,13775.0,17,S
2018-04-19 21:00:51,13770.0,8,400,-4,13765.0,3,13775.0,12,S
2018-04-19 21:00:54,13765.0,6,406,0,13760.0,3,13765.0,5,S
2018-04-19 21:00:55,13760.0,6,412,0,13750.0,9,13760.0,13,S
2018-04-19 21:00:56,13755.0,36,448,4,13755.0,15,13765.0,10,S
2018-04-19 21:00:57,13765.0,2,450,2,13755.0,31,13765.0,4,B
2018-04-19 21:00:58,13755.0,12,462,-6,13755.0,1,13765.0,12,S
2018-04-19 21:00:58,13755.0,2,464,0,13755.0,11,13765.0,7,S
2018-04-19 21:01:03,13760.0,14,478,-4,13750.0,3,13760.0,12,B
2018-04-19 21:01:03,13750.0,6,484,-6,13745.0,1,13755.0,5,S
2018-04-19 21:01:04,13745.0,2,486,-2,13740.0,3,13750.0,4,S
2018-04-19 21:01:04,13740.0,8,494,2,13735.0,6,13740.0,1,S
2018-04-19 21:01:05,13735.0,4,498,-4,13735.0,4,13740.0,1,S
2018-04-19 21:01:05,13740.0,4,502,0,13740.0,3,13750.0,26,B
2018-04-19 21:01:07,13740.0,2,504,0,13735.0,5,13745.0,10,B
2018-04-19 21:01:09,13745.0,2,506,-2,13735.0,5,13745.0,4,B
2018-04-19 21:01:10,13735.0,2,508,0,13735.0,9,13745.0,2,S
2018-04-19 21:01:11,13740.0,2,510,0,13735.0,19,13745.0,3,B
2018-04-19 21:01:12,13735.0,2,512,0,13735.0,19,13745.0,3,S
2018-04-19 21:01:12,13745.0,2,514,2,13735.0,19,13745.0,1,B
2018-04-19 21:01:13,13740.0,2,516,0,13740.0,2,13745.0,1,S
2018-04-19 21:01:14,13740.0,20,536,-4,13740.0,1,13750.0,10,S
2018-04-19 21:01:15,13740.0,2,538,0,13735.0,18,13750.0,8,S
2018-04-19 21:01:16,13740.0,2,540,2,13740.0,2,13750.0,8,S
2018-04-19 21:01:16,13740.0,4,544,4,13735.0,19,13740.0,4,S
2018-04-19 21:01:17,13735.0,22,566,12,13735.0,9,13740.0,3,S
2018-04-19 21:01:17,13740.0,6,572,4,13740.0,15,13750.0,8,B
2018-04-19 21:01:21,13740.0,2,574,0,13740.0,16,13745.0,3,B
2018-04-19 21:01:21,13740.0,8,582,8,13740.0,12,13745.0,3,B
2018-04-19 21:01:22,13745.0,6,588,-6,13745.0,7,13750.0,9,B
2018-04-19 21:01:22,13750.0,14,602,4,13745.0,20,13755.0,3,B
2018-04-19 21:01:23,13750.0,2,604,0,13750.0,2,13760.0,7,B
2018-04-19 21:01:25,13750.0,2,606,2,13750.0,3,13760.0,9,B
2018-04-19 21:01:25,13750.0,12,618,2,13750.0,3,13755.0,5,B
2018-04-19 21:01:26,13755.0,2,620,0,13750.0,3,13755.0,5,B
2018-04-19 21:01:26,13750.0,6,626,2,13745.0,12,13750.0,1,S
2018-04-19 21:01:28,13750.0,2,628,2,13750.0,1,13755.0,5,S
2018-04-19 21:01:30,13755.0,8,636,-2,13755.0,36,13760.0,12,B
2018-04-19 21:01:32,13760.0,14,650,0,13755.0,36,13765.0,3,B
2018-04-19 21:01:33,13755.0,2,652,0,13755.0,35,13760.0,1,S
2018-04-19 21:01:33,13760.0,4,656,-4,13755.0,35,13760.0,3,B
2018-04-19 21:01:34,13760.0,6,662,0,13750.0,2,13760.0,1,B
2018-04-19 21:01:34,13760.0,2,664,0,13760.0,34,13765.0,9,B
2018-04-19 21:01:39,13760.0,14,678,0,13760.0,28,13765.0,10,B
2018-04-19 21:01:40,13765.0,20,698,-14,13765.0,17,13780.0,6,B
2018-04-19 21:01:41,13765.0,2,700,-2,13765.0,19,13775.0,28,B
2018-04-19 21:01:42,13765.0,4,704,-4,13765.0,14,13775.0,34,B
2018-04-19 21:01:45,13770.0,2,706,0,13765.0,17,13770.0,3,B
2018-04-19 21:01:45,13770.0,4,710,-4,13765.0,17,13770.0,1,B
2018-04-19 21:01:46,13770.0,2,712,-2,13765.0,3,13775.0,17,B
2018-04-19 21:01:47,13770.0,2,714,-2,13770.0,16,13775.0,17,B
2018-04-19 21:01:48,13770.0,32,746,-32,13765.0,3,13770.0,4,B
2018-04-19 21:01:48,13770.0,2,748,-2,13765.0,3,13770.0,3,B
2018-04-19 21:01:51,13770.0,6,754,-2,13770.0,1,13775.0,16,B
2018-04-19 21:01:52,13775.0,10,764,-8,13770.0,1,13775.0,13,B
2018-04-19 21:01:52,13775.0,26,790,-24,13770.0,1,13780.0,10,B
2018-04-19 21:01:53,13780.0,10,800,4,13775.0,4,13780.0,2,B
2018-04-19 21:01:53,13780.0,4,804,-2,13775.0,7,13785.0,3,B
2018-04-19 21:01:54,13775.0,2,806,0,13775.0,1,13780.0,2,S
2018-04-19 21:01:54,13775.0,2,808,0,13770.0,5,13780.0,11,S
2018-04-19 21:01:56,13770.0,4,812,0,13765.0,7,13775.0,2,S
2018-04-19 21:01:57,13775.0,2,814,-2,13770.0,1,13775.0,5,B
2018-04-19 21:01:57,13775.0,6,820,-2,13765.0,14,13775.0,6,B
2018-04-19 21:02:00,13775.0,2,822,2,13765.0,12,13775.0,6,B
2018-04-19 21:02:01,13775.0,2,824,2,13765.0,12,13775.0,6,B
2018-04-19 21:02:03,13765.0,2,826,0,13765.0,12,13775.0,6,S
2018-04-19 21:02:05,13770.0,8,834,-6,13765.0,10,13775.0,2,B
2018-04-19 21:02:09,13775.0,2,836,0,13770.0,10,13775.0,3,B
2018-04-19 21:02:22,13780.0,2,838,0,13775.0,15,13780.0,1,B
2018-04-19 21:02:26,13775.0,2,840,0,13775.0,14,13780.0,7,S
2018-04-19 21:02:27,13780.0,14,854,0,13780.0,9,13785.0,6,B
2018-04-19 21:02:29,13780.0,2,856,-2,13780.0,9,13785.0,7,B
2018-04-19 21:02:31,13780.0,2,858,0,13775.0,4,13780.0,2,B
2018-04-19 21:02:35,13775.0,4,862,0,13775.0,10,13780.0,2,S
2018-04-19 21:02:36,13780.0,2,864,0,13775.0,10,13780.0,1,B
2018-04-19 21:02:41,13775.0,4,868,0,13770.0,5,13780.0,8,S
2018-04-19 21:02:42,13780.0,2,870,-2,13770.0,14,13780.0,7,B
2018-04-19 21:02:42,13780.0,4,874,4,13770.0,14,13780.0,5,B
2018-04-19 21:02:45,13770.0,6,880,4,13770.0,4,13775.0,12,S
2018-04-19 21:02:46,13770.0,8,888,-6,13765.0,6,13775.0,12,S
2018-04-19 21:02:47,13775.0,8,896,-8,13770.0,9,13780.0,4,B
2018-04-19 21:02:52,13780.0,2,898,0,13770.0,11,13780.0,9,B
2018-04-19 21:02:59,13770.0,2,900,-2,13770.0,12,13775.0,1,S
2018-04-19 21:03:00,13775.0,2,902,0,13770.0,12,13780.0,11,B
2018-04-19 21:03:03,13770.0,10,912,0,13765.0,8,13775.0,11,S
2018-04-19 21:03:11,13765.0,22,934,14,13765.0,5,13770.0,3,S
2018-04-19 21:03:11,13765.0,10,944,6,13760.0,1,13765.0,4,S
2018-04-19 21:03:13,13755.0,2,946,-2,13755.0,7,13765.0,8,S
2018-04-19 21:03:14,13755.0,14,960,4,13745.0,1,13750.0,1,S
2018-04-19 21:03:15,13750.0,4,964,0,13745.0,3,13750.0,3,S
2018-04-19 21:03:15,13750.0,8,972,8,13745.0,7,13755.0,8,S
2018-04-19 21:03:16,13750.0,8,980,-6,13750.0,1,13755.0,8,S
2018-04-19 21:03:17,13750.0,2,982,0,13750.0,1,13755.0,11,S
2018-04-19 21:03:17,13755.0,12,994,-12,13750.0,1,13755.0,2,B
2018-04-19 21:03:19,13755.0,4,998,-4,13750.0,1,13760.0,4,B
2018-04-19 21:03:19,13750.0,2,1000,0,13750.0,1,13760.0,7,S
2018-04-19 21:03:22,13750.0,8,1008,2,13745.0,5,13750.0,5,S
2018-04-19 21:03:23,13745.0,8,1016,4,13740.0,3,13750.0,8,S
2018-04-19 21:03:25,13745.0,2,1018,0,13740.0,9,13750.0,11,S
2018-04-19 21:03:26,13745.0,2,1020,0,13740.0,9,13750.0,11,S
2018-04-19 21:03:29,13745.0,14,1034,14,13740.0,4,13750.0,93,S
2018-04-19 21:03:30,13745.0,2,1036,2,13740.0,4,13745.0,3,S
2018-04-19 21:03:31,13745.0,6,1042,-6,13740.0,5,13745.0,3,S
2018-04-19 21:03:31,13745.0,4,1046,0,13740.0,5,13745.0,1,S
2018-04-19 21:03:32,13745.0,2,1048,0,13745.0,5,13750.0,93,S
2018-04-19 21:03:35,13745.0,2,1050,0,13740.0,10,13750.0,108,S
2018-04-19 21:03:35,13745.0,2,1052,2,13740.0,21,13750.0,108,S
2018-04-19 21:03:36,13745.0,2,1054,0,13740.0,8,13745.0,3,S
2018-04-19 21:03:38,13745.0,6,1060,2,13745.0,4,13750.0,108,S
2018-04-19 21:03:41,13745.0,2,1062,2,13745.0,3,13750.0,108,S
2018-04-19 21:03:42,13745.0,2,1064,0,13745.0,2,13750.0,108,S
2018-04-19 21:03:45,13745.0,2,1066,0,13740.0,10,13750.0,107,S
2018-04-19 21:03:51,13750.0,40,1106,0,13740.0,40,13750.0,87,B
2018-04-19 21:03:51,13740.0,2,1108,2,13740.0,39,13750.0,87,S
2018-04-19 21:03:52,13740.0,8,1116,6,13740.0,23,13750.0,87,S
2018-04-19 21:03:53,13740.0,2,1118,0,13740.0,29,13750.0,87,S
2018-04-19 21:03:58,13740.0,2,1120,2,13740.0,27,13750.0,87,S
2018-04-19 21:04:01,13740.0,2,1122,2,13740.0,31,13750.0,88,S
2018-04-19 21:04:07,13740.0,2,1124,2,13740.0,31,13750.0,88,S
2018-04-19 21:04:09,13740.0,2,1126,0,13740.0,25,13750.0,88,S
2018-04-19 21:04:10,13750.0,4,1130,0,13740.0,30,13750.0,86,B
2018-04-19 21:04:10,13740.0,2,1132,0,13740.0,29,13750.0,86,S
2018-04-19 21:04:14,13750.0,14,1146,0,13740.0,24,13750.0,83,B
2018-04-19 21:04:17,13745.0,2,1148,0,13745.0,4,13750.0,91,S
2018-04-19 21:04:20,13750.0,10,1158,10,13745.0,5,13750.0,86,B
2018-04-19 21:04:21,13750.0,16,1174,12,13745.0,10,13750.0,66,B
2018-04-19 21:04:22,13750.0,2,1176,2,13745.0,15,13750.0,65,B
2018-04-19 21:04:24,13750.0,2,1178,0,13745.0,15,13750.0,64,B
2018-04-19 21:04:24,13750.0,26,1204,14,13745.0,16,13750.0,51,B
2018-04-19 21:04:25,13750.0,48,1252,24,13745.0,21,13750.0,27,B
2018-04-19 21:04:25,13750.0,54,1306,32,13750.0,9,13755.0,3,B
2018-04-19 21:04:26,13755.0,6,1312,-2,13755.0,2,13760.0,5,B
2018-04-19 21:04:29,13760.0,2,1314,-2,13760.0,1,13765.0,1,B
2018-04-19 21:04:32,13765.0,16,1330,-10,13760.0,3,13765.0,6,B
2018-04-19 21:04:32,13765.0,2,1332,0,13760.0,21,13770.0,2,B
2018-04-19 21:04:33,13765.0,2,1334,0,13760.0,8,13765.0,2,B
2018-04-19 21:04:35,13765.0,4,1338,-2,13760.0,5,13770.0,23,B
2018-04-19 21:04:36,13765.0,8,1346,0,13765.0,1,13770.0,23,B
2018-04-19 21:04:36,13765.0,2,1348,-2,13760.0,1,13765.0,2,B
2018-04-19 21:04:38,13760.0,2,1350,0,13755.0,1,13765.0,3,S
2018-04-19 21:04:41,13765.0,2,1352,0,13760.0,2,13770.0,7,B
2018-04-19 21:04:43,13765.0,2,1354,0,13760.0,2,13765.0,4,B
2018-04-19 21:04:50,13765.0,6,1360,4,13765.0,3,13770.0,8,B
2018-04-19 21:04:51,13765.0,4,1364,0,13765.0,1,13770.0,8,B
2018-04-19 21:04:54,13765.0,2,1366,2,13760.0,3,13770.0,8,B
2018-04-19 21:04:55,13770.0,2,1368,2,13760.0,3,13770.0,7,B
2018-04-19 21:04:56,13760.0,6,1374,6,13755.0,15,13760.0,4,S
2018-04-19 21:05:00,13760.0,2,1376,0,13755.0,31,13760.0,3,S
2018-04-19 21:05:00,13755.0,6,1382,-4,13755.0,29,13760.0,2,S
2018-04-19 21:05:02,13760.0,2,1384,2,13750.0,18,13760.0,1,B
2018-04-19 21:05:03,13760.0,2,1386,2,13750.0,31,13765.0,3,B
2018-04-19 21:05:06,13755.0,2,1388,2,13750.0,20,13760.0,7,S
2018-04-19 21:05:11,13755.0,2,1390,-2,13750.0,3,13755.0,1,S
2018-04-19 21:05:12,13750.0,2,1392,0,13750.0,2,13760.0,12,S
2018-04-19 21:05:15,13750.0,2,1394,0,13750.0,2,13760.0,12,S
2018-04-19 21:05:17,13750.0,10,1404,2,13745.0,14,13750.0,4,S
2018-04-19 21:05:18,13745.0,8,1412,-2,13740.0,23,13750.0,7,S
2018-04-19 21:05:25,13745.0,2,1414,0,13740.0,36,13750.0,4,S
2018-04-19 21:05:31,13745.0,2,1416,0,13740.0,33,13745.0,2,S
2018-04-19 21:05:32,13745.0,2,1418,0,13740.0,23,13745.0,1,S
2018-04-19 21:05:32,13740.0,4,1422,-2,13740.0,21,13745.0,1,S
2018-04-19 21:05:33,13740.0,2,1424,0,13740.0,20,13745.0,1,S
2018-04-19 21:05:40,13745.0,2,1426,0,13740.0,20,13745.0,1,B
2018-04-19 21:05:42,13740.0,22,1448,0,13740.0,9,13745.0,5,S
2018-04-19 21:05:43,13740.0,18,1466,-6,13735.0,3,13740.0,9,S
2018-04-19 21:05:43,13735.0,4,1470,-2,13730.0,7,13740.0,5,S
2018-04-19 21:05:48,13735.0,2,1472,-2,13730.0,14,13735.0,1,S
2018-04-19 21:05:48,13740.0,14,1486,-2,13730.0,17,13740.0,5,B
2018-04-19 21:05:49,13740.0,10,1496,-4,13730.0,8,13740.0,3,B
2018-04-19 21:05:51,13730.0,2,1498,0,13730.0,8,13740.0,4,S
2018-04-19 21:05:52,13730.0,2,1500,0,13730.0,7,13735.0,1,S
2018-04-19 21:05:53,13730.0,14,1514,-6,13730.0,1,13735.0,4,S
2018-04-19 21:05:53,13730.0,4,1518,2,13730.0,1,13740.0,2,S
2018-04-19 21:05:54,13735.0,4,1522,0,13735.0,2,13740.0,1,B
2018-04-19 21:05:55,13735.0,2,1524,0,13735.0,1,13740.0,2,B
2018-04-19 21:05:55,13735.0,2,1526,2,13730.0,2,13740.0,3,B
2018-04-19 21:05:59,13730.0,2,1528,-2,13730.0,5,13740.0,8,S
2018-04-19 21:06:02,13735.0,4,1532,4,13735.0,1,13740.0,3,B
2018-04-19 21:06:05,13740.0,4,1536,-2,13735.0,1,13740.0,2,B
2018-04-19 21:06:06,13740.0,4,1540,0,13740.0,3,13745.0,6,B
2018-04-19 21:06:06,13735.0,10,1550,-2,13730.0,19,13740.0,1,S
2018-04-19 21:06:07,13740.0,2,1552,2,13735.0,3,13745.0,9,B
2018-04-19 21:06:10,13735.0,4,1556,4,13735.0,2,13740.0,1,S
2018-04-19 21:06:14,13740.0,4,1560,0,13740.0,6,13745.0,3,B
2018-04-19 21:06:15,13740.0,4,1564,0,13735.0,12,13745.0,5,B
2018-04-19 21:06:28,13745.0,2,1566,2,13740.0,3,13745.0,4,B
2018-04-19 21:06:33,13735.0,20,1586,-8,13735.0,1,13745.0,6,S
2018-04-19 21:06:34,13745.0,2,1588,0,13735.0,2,13745.0,13,B
2018-04-19 21:06:36,13735.0,2,1590,0,13735.0,1,13740.0,2,S
2018-04-19 21:06:36,13735.0,2,1592,0,13730.0,10,13735.0,3,S
2018-04-19 21:06:38,13735.0,2,1594,0,13730.0,4,13735.0,2,S
2018-04-19 21:06:39,13730.0,2,1596,0,13730.0,4,13735.0,16,S
2018-04-19 21:06:39,13730.0,8,1604,4,13725.0,2,13735.0,16,S
2018-04-19 21:06:42,13725.0,4,1608,4,13720.0,1,13725.0,1,S
2018-04-19 21:06:45,13720.0,2,1610,0,13715.0,2,13725.0,2,S
2018-04-19 21:06:46,13720.0,2,1612,0,13720.0,1,13725.0,2,S
2018-04-19 21:06:47,13725.0,4,1616,0,13725.0,5,13730.0,14,B
2018-04-19 21:06:47,13720.0,20,1636,-20,13720.0,4,13730.0,8,S
2018-04-19 21:06:49,13725.0,2,1638,2,13720.0,9,13730.0,5,B
2018-04-19 21:06:50,13720.0,2,1640,-2,13720.0,6,13730.0,21,S
2018-04-19 21:06:57,13715.0,12,1652,8,13710.0,7,13720.0,10,S
2018-04-19 21:06:58,13720.0,6,1658,-4,13710.0,12,13720.0,10,B
2018-04-19 21:06:59,13710.0,4,1662,4,13710.0,3,13715.0,3,S
2018-04-19 21:06:59,13710.0,4,1666,-2,13710.0,2,13715.0,4,S
2018-04-19 21:07:00,13710.0,4,1670,2,13705.0,6,13710.0,13,S
2018-04-19 21:07:00,13700.0,14,1684,6,13700.0,3,13705.0,21,S
2018-04-19 21:07:01,13705.0,4,1688,-2,13700.0,3,13705.0,2,B
2018-04-19 21:07:01,13700.0,8,1696,-8,13695.0,2,13700.0,1,S
2018-04-19 21:07:02,13700.0,2,1698,-2,13700.0,31,13710.0,8,S
2018-04-19 21:07:03,13710.0,14,1712,-2,13710.0,2,13715.0,5,B
2018-04-19 21:07:03,13710.0,4,1716,-4,13705.0,2,13710.0,2,B
2018-04-19 21:07:04,13705.0,4,1720,2,13700.0,9,13705.0,2,S
2018-04-19 21:07:05,13710.0,2,1722,-2,13700.0,16,13710.0,5,B
2018-04-19 21:07:06,13700.0,2,1724,0,13700.0,5,13705.0,8,S
2018-04-19 21:07:06,13700.0,10,1734,2,13695.0,9,13705.0,2,S
2018-04-19 21:07:09,13705.0,2,1736,0,13695.0,15,13705.0,7,B
2018-04-19 21:07:09,13705.0,2,1738,0,13695.0,15,13705.0,6,B
2018-04-19 21:07:11,13695.0,4,1742,-4,13690.0,5,13700.0,4,S
2018-04-19 21:07:12,13690.0,14,1756,-6,13685.0,1,13695.0,8,S
2018-04-19 21:07:12,13685.0,12,1768,-2,13685.0,9,13695.0,10,S
2018-04-19 21:07:13,13690.0,18,1786,0,13680.0,5,13690.0,3,B
2018-04-19 21:07:13,13680.0,10,1796,4,13675.0,11,13680.0,23,S
2018-04-19 21:07:14,13685.0,20,1816,12,13675.0,12,13685.0,22,B
2018-04-19 21:07:15,13675.0,28,1844,-14,13680.0,1,13690.0,6,S
2018-04-19 21:07:15,13690.0,2,1846,2,13685.0,4,13690.0,2,B
2018-04-19 21:07:16,13685.0,2,1848,2,13680.0,11,13685.0,1,S
2018-04-19 21:07:18,13685.0,2,1850,0,13680.0,1,13685.0,7,S
2018-04-19 21:07:18,13680.0,4,1854,2,13675.0,15,13685.0,8,S
2018-04-19 21:07:19,13680.0,4,1858,2,13675.0,20,13685.0,8,S
2018-04-19 21:07:20,13680.0,2,1860,-2,13675.0,10,13680.0,1,S
2018-04-19 21:07:20,13680.0,2,1862,2,13680.0,2,13685.0,17,S
2018-04-19 21:07:21,13680.0,4,1866,4,13675.0,10,13680.0,1,S
2018-04-19 21:07:22,13680.0,4,1870,4,13680.0,1,13685.0,17,S
2018-04-19 21:07:22,13680.0,8,1878,-8,13675.0,21,13685.0,6,S
2018-04-19 21:07:23,13680.0,4,1882,0,13680.0,3,13685.0,7,S
2018-04-19 21:07:24,13685.0,2,1884,2,13680.0,3,13685.0,8,B
2018-04-19 21:07:25,13680.0,6,1890,4,13675.0,15,13680.0,2,S
2018-04-19 21:07:25,13685.0,6,1896,0,13680.0,2,13685.0,6,B
2018-04-19 21:07:26,13685.0,6,1902,2,13675.0,19,13685.0,5,B
2018-04-19 21:07:27,13685.0,2,1904,2,13680.0,1,13685.0,12,B
2018-04-19 21:07:27,13685.0,2,1906,0,13680.0,1,13685.0,11,B
2018-04-19 21:07:28,13685.0,4,1910,-2,13685.0,5,13690.0,8,B
2018-04-19 21:07:29,13685.0,4,1914,-2,13685.0,4,13690.0,3,B
2018-04-19 21:07:29,13685.0,8,1922,0,13680.0,6,13690.0,12,B
2018-04-19 21:07:30,13685.0,2,1924,-2,13680.0,6,13690.0,12,B
2018-04-19 21:07:32,13680.0,4,1928,4,13680.0,4,13685.0,2,S
2018-04-19 21:07:32,13680.0,2,1930,2,13680.0,3,13685.0,9,S
2018-04-19 21:07:33,13680.0,8,1938,8,13675.0,15,13685.0,10,S
2018-04-19 21:07:33,13680.0,2,1940,2,13675.0,15,13680.0,4,S
2018-04-19 21:07:34,13680.0,10,1950,2,13675.0,8,13685.0,13,S
2018-04-19 21:07:38,13685.0,2,1952,-2,13680.0,2,13685.0,9,B
2018-04-19 21:07:39,13680.0,4,1956,0,13680.0,1,13685.0,6,S
2018-04-19 21:07:40,13685.0,2,1958,-2,13685.0,2,13690.0,13,B
2018-04-19 21:07:41,13685.0,4,1962,0,13680.0,6,13685.0,2,B
2018-04-19 21:07:42,13685.0,2,1964,0,13680.0,6,13690.0,15,B
2018-04-19 21:07:43,13680.0,12,1976,8,13675.0,14,13680.0,4,S
2018-04-19 21:07:43,13680.0,8,1984,8,13680.0,20,13695.0,4,S
2018-04-19 21:07:44,13695.0,10,1994,-2,13685.0,1,13700.0,4,B
2018-04-19 21:07:46,13685.0,6,2000,-4,13680.0,42,13685.0,69,S
2018-04-19 21:07:46,13685.0,54,2054,-18,13680.0,38,13685.0,42,S
2018-04-19 21:07:47,13685.0,84,2138,0,13680.0,32,13685.0,1,S
2018-04-19 21:07:47,13685.0,2,2140,0,13685.0,2,13695.0,14,S
2018-04-19 21:07:48,13695.0,16,2156,-8,13685.0,1,13695.0,7,B
2018-04-19 21:07:53,13695.0,2,2158,-2,13690.0,2,13695.0,1,B
2018-04-19 21:07:54,13690.0,2,2160,2,13690.0,1,13695.0,8,S
2018-04-19 21:07:57,13690.0,2,2162,2,13685.0,7,13695.0,2,S
2018-04-19 21:07:58,13690.0,2,2164,2,13685.0,7,13690.0,2,S
2018-04-19 21:08:00,13690.0,2,2166,0,13690.0,2,13695.0,2,S
2018-04-19 21:08:01,13690.0,4,2170,-2,13690.0,1,13695.0,3,S
2018-04-19 21:08:02,13690.0,2,2172,2,13690.0,1,13695.0,1,S
2018-04-19 21:08:05,13690.0,6,2178,2,13685.0,1,13690.0,1,S
2018-04-19 21:08:08,13690.0,2,2180,2,13685.0,1,13690.0,1,S
2018-04-19 21:08:18,13695.0,4,2184,-4,13690.0,4,13700.0,12,B
2018-04-19 21:08:19,13700.0,2,2186,2,13695.0,5,13700.0,7,B
2018-04-19 21:08:19,13705.0,2,2188,0,13695.0,5,13710.0,2,B
2018-04-19 21:08:21,13700.0,10,2198,-10,13695.0,1,13700.0,3,S
2018-04-19 21:08:25,13690.0,2,2200,0,13685.0,4,13695.0,7,S
2018-04-19 21:08:25,13690.0,2,2202,2,13685.0,4,13695.0,7,S
2018-04-19 21:08:26,13690.0,2,2204,0,13685.0,4,13695.0,7,S
2018-04-19 21:08:27,13695.0,2,2206,0,13685.0,5,13695.0,5,B
2018-04-19 21:08:30,13695.0,2,2208,-2,13685.0,2,13695.0,8,B
2018-04-19 21:08:36,13700.0,2,2210,2,13695.0,4,13700.0,7,B
2018-04-19 21:08:37,13700.0,6,2216,2,13695.0,4,13700.0,9,B
2018-04-19 21:08:40,13695.0,2,2218,0,13695.0,7,13700.0,5,S
2018-04-19 21:08:40,13700.0,2,2220,0,13695.0,7,13700.0,5,B
2018-04-19 21:08:41,13700.0,4,2224,2,13695.0,7,13700.0,3,B
2018-04-19 21:08:42,13700.0,6,2230,4,13700.0,3,13705.0,14,B
2018-04-19 21:08:44,13700.0,12,2242,0,13695.0,15,13700.0,2,B
2018-04-19 21:08:44,13700.0,4,2246,0,13695.0,15,13700.0,1,B
2018-04-19 21:08:45,13700.0,2,2248,0,13695.0,15,13705.0,14,B
2018-04-19 21:08:46,13700.0,2,2250,-2,13695.0,15,13700.0,1,B
2018-04-19 21:08:46,13700.0,2,2252,-2,13700.0,2,13705.0,14,B
2018-04-19 21:08:47,13700.0,6,2258,-4,13700.0,2,13705.0,13,B
2018-04-19 21:08:50,13705.0,2,2260,2,13700.0,2,13705.0,10,B
2018-04-19 21:08:53,13705.0,2,2262,0,13700.0,2,13705.0,9,B
2018-04-19 21:08:59,13705.0,6,2268,4,13700.0,3,13710.0,26,B
2018-04-19 21:09:01,13705.0,2,2270,0,13705.0,1,13710.0,16,B
2018-04-19 21:09:02,13705.0,2,2272,0,13700.0,2,13710.0,19,B
2018-04-19 21:09:03,13700.0,6,2278,-4,13695.0,15,13705.0,3,S
2018-04-19 21:09:06,13700.0,2,2280,-2,13695.0,7,13705.0,18,S
2018-04-19 21:09:07,13700.0,2,2282,0,13700.0,3,13705.0,6,S
2018-04-19 21:09:10,13700.0,8,2290,2,13695.0,16,13700.0,6,S
2018-04-19 21:09:12,13700.0,2,2292,0,13695.0,16,13700.0,5,S
2018-04-19 21:09:13,13700.0,2,2294,0,13695.0,16,13700.0,5,S
2018-04-19 21:09:14,13695.0,2,2296,2,13695.0,15,13700.0,6,S
2018-04-19 21:09:18,13700.0,2,2298,0,13695.0,19,13700.0,5,B
2018-04-19 21:09:19,13700.0,10,2308,4,13700.0,12,13705.0,1,B
2018-04-19 21:09:19,13700.0,20,2328,12,13700.0,2,13705.0,1,B
2018-04-19 21:09:21,13700.0,2,2330,-2,13700.0,2,13705.0,1,B
2018-04-19 21:09:25,13705.0,2,2332,0,13705.0,1,13710.0,6,B
2018-04-19 21:09:28,13710.0,4,2336,-4,13705.0,1,13710.0,11,B
2018-04-19 21:09:28,13710.0,16,2352,-12,13705.0,1,13710.0,4,B
2018-04-19 21:09:29,13710.0,6,2358,0,13705.0,8,13715.0,2,B
2018-04-19 21:09:31,13710.0,4,2362,0,13710.0,130,13715.0,3,B
2018-04-19 21:09:32,13715.0,4,2366,-2,13710.0,130,13715.0,2,B
2018-04-19 21:09:33,13715.0,2,2368,0,13710.0,130,13715.0,2,B
2018-04-19 21:09:33,13710.0,2,2370,-2,13710.0,129,13715.0,2,S
2018-04-19 21:09:35,13715.0,2,2372,-2,13715.0,3,13720.0,14,B
2018-04-19 21:09:35,13715.0,2,2374,2,13715.0,2,13720.0,11,B
2018-04-19 21:09:36,13720.0,6,2380,0,13715.0,3,13720.0,3,B
2018-04-19 21:09:36,13720.0,6,2386,-4,13720.0,2,13725.0,11,B
2018-04-19 21:09:37,13720.0,4,2390,0,13715.0,16,13725.0,11,B
2018-04-19 21:09:50,13715.0,4,2394,0,13715.0,3,13720.0,4,S
2018-04-19 21:09:58,13710.0,6,2400,-6,13710.0,128,13715.0,15,S
2018-04-19 21:09:58,13710.0,16,2416,-10,13710.0,120,13715.0,17,S
2018-04-19 21:09:59,13710.0,8,2424,0,13710.0,116,13715.0,17,S
2018-04-19 21:10:02,13715.0,2,2426,0,13710.0,116,13715.0,16,B
2018-04-19 21:10:03,13710.0,12,2438,0,13710.0,110,13715.0,16,S
2018-04-19 21:10:05,13710.0,6,2444,-6,13710.0,107,13715.0,15,S
2018-04-19 21:10:06,13715.0,6,2450,0,13710.0,107,13715.0,12,B
2018-04-19 21:10:08,13715.0,2,2452,0,13710.0,107,13715.0,12,B
2018-04-19 21:10:10,13710.0,28,2480,-26,13710.0,93,13715.0,18,S
2018-04-19 21:10:10,13710.0,6,2486,-2,13710.0,90,13715.0,16,S
2018-04-19 21:10:11,13710.0,6,2492,-6,13710.0,87,13715.0,16,S
2018-04-19 21:10:11,13710.0,8,2500,0,13710.0,86,13715.0,23,S
2018-04-19 21:10:12,13710.0,8,2508,-8,13710.0,82,13715.0,23,S
2018-04-19 21:10:12,13710.0,8,2516,-6,13710.0,78,13715.0,23,S
2018-04-19 21:10:13,13710.0,4,2520,-4,13710.0,76,13715.0,23,S
2018-04-19 21:10:14,13710.0,8,2528,0,13710.0,72,13715.0,24,S
2018-04-19 21:10:16,13710.0,6,2534,0,13710.0,70,13715.0,28,S
2018-04-19 21:10:16,13710.0,4,2538,-4,13710.0,68,13715.0,28,S
2018-04-19 21:10:17,13710.0,4,2542,0,13710.0,66,13715.0,28,S
2018-04-19 21:10:17,13710.0,8,2550,0,13710.0,62,13715.0,28,S
2018-04-19 21:10:20,13710.0,4,2554,-4,13710.0,59,13715.0,30,S
2018-04-19 21:10:21,13710.0,20,2574,-20,13710.0,49,13715.0,20,S
2018-04-19 21:10:21,13710.0,2,2576,-2,13710.0,48,13715.0,20,S
2018-04-19 21:10:27,13710.0,4,2580,0,13710.0,46,13715.0,22,S
2018-04-19 21:10:27,13710.0,4,2584,-4,13710.0,44,13715.0,24,S
2018-04-19 21:10:28,13710.0,10,2594,-10,13710.0,39,13715.0,24,S
2018-04-19 21:10:28,13710.0,2,2596,0,13710.0,38,13715.0,24,S
2018-04-19 21:10:32,13715.0,2,2598,2,13710.0,38,13715.0,22,B
2018-04-19 21:10:35,13710.0,2,2600,0,13710.0,37,13715.0,22,S
2018-04-19 21:10:36,13710.0,4,2604,0,13710.0,36,13715.0,21,S
2018-04-19 21:10:38,13710.0,12,2616,-12,13710.0,30,13715.0,29,S
2018-04-19 21:10:43,13710.0,10,2626,0,13710.0,25,13715.0,23,S
2018-04-19 21:10:53,13710.0,12,2638,-12,13710.0,22,13715.0,25,S
2018-04-19 21:10:53,13710.0,12,2650,0,13710.0,16,13715.0,30,S
2018-04-19 21:10:54,13710.0,20,2670,-20,13710.0,6,13715.0,14,S
2018-04-19 21:10:55,13710.0,2,2672,-2,13710.0,5,13715.0,13,S
2018-04-19 21:10:56,13710.0,2,2674,-2,13710.0,4,13715.0,13,S
2018-04-19 21:10:58,13715.0,4,2678,2,13710.0,4,13715.0,4,B
2018-04-19 21:11:00,13715.0,6,2684,0,13710.0,4,13715.0,1,B
2018-04-19 21:11:05,13720.0,6,2690,0,13715.0,16,13720.0,3,B
2018-04-19 21:11:05,13720.0,6,2696,0,13715.0,7,13725.0,32,B
2018-04-19 21:11:11,13725.0,10,2706,10,13715.0,20,13725.0,11,B
2018-04-19 21:11:14,13720.0,24,2730,12,13720.0,13,13730.0,3,S
2018-04-19 21:11:17,13730.0,2,2732,2,13720.0,16,13730.0,4,B
2018-04-19 21:11:21,13725.0,4,2736,4,13725.0,2,13730.0,2,S
2018-04-19 21:11:23,13730.0,10,2746,4,13730.0,3,13735.0,2,B
2018-04-19 21:11:23,13735.0,4,2750,-2,13730.0,9,13735.0,1,B
2018-04-19 21:11:24,13735.0,2,2752,2,13730.0,6,13740.0,2,B
2018-04-19 21:11:32,13730.0,6,2758,0,13725.0,14,13730.0,1,S
2018-04-19 21:11:33,13730.0,6,2764,-6,13730.0,1,13735.0,17,S
2018-04-19 21:11:33,13725.0,6,2770,-4,13725.0,1,13730.0,3,S
2018-04-19 21:11:35,13730.0,2,2772,2,13725.0,1,13730.0,6,B
2018-04-19 21:11:38,13730.0,10,2782,10,13725.0,1,13730.0,1,B
2018-04-19 21:11:44,13725.0,8,2790,0,13725.0,13,13730.0,1,S
2018-04-19 21:11:45,13730.0,2,2792,-2,13725.0,12,13735.0,7,B
2018-04-19 21:11:49,13730.0,6,2798,-4,13725.0,14,13735.0,8,B
2018-04-19 21:11:55,13730.0,2,2800,2,13725.0,14,13735.0,4,B
2018-04-19 21:11:57,13730.0,2,2802,-2,13725.0,14,13735.0,4,B
2018-04-19 21:12:00,13735.0,2,2804,2,13725.0,14,13735.0,3,B
2018-04-19 21:12:01,13735.0,6,2810,-2,13730.0,12,13740.0,4,B
2018-04-19 21:12:05,13735.0,2,2812,2,13730.0,15,13740.0,4,B
2018-04-19 21:12:06,13740.0,10,2822,2,13740.0,5,13745.0,8,B
2018-04-19 21:12:07,13740.0,2,2824,-2,13740.0,3,13745.0,5,B
2018-04-19 21:12:08,13745.0,2,2826,2,13740.0,19,13745.0,4,B
2018-04-19 21:12:09,13745.0,10,2836,-2,13740.0,19,13750.0,23,B
2018-04-19 21:12:12,13745.0,2,2838,0,13740.0,19,13750.0,23,B
2018-04-19 21:12:14,13745.0,2,2840,0,13745.0,16,13750.0,23,B
2018-04-19 21:12:15,13745.0,10,2850,8,13740.0,17,13745.0,1,B
2018-04-19 21:12:16,13745.0,2,2852,0,13745.0,9,13750.0,24,B
2018-04-19 21:12:17,13745.0,4,2856,2,13745.0,12,13750.0,24,B
2018-04-19 21:12:19,13745.0,2,2858,2,13745.0,15,13750.0,24,B
2018-04-19 21:12:21,13750.0,2,2860,0,13745.0,15,13750.0,23,B
2018-04-19 21:12:22,13750.0,8,2868,-2,13745.0,14,13750.0,20,B
2018-04-19 21:12:24,13750.0,2,2870,2,13745.0,14,13750.0,20,B
2018-04-19 21:12:25,13745.0,2,2872,-2,13745.0,13,13750.0,20,S
2018-04-19 21:12:26,13745.0,2,2874,2,13745.0,10,13750.0,20,S
2018-04-19 21:12:26,13750.0,2,2876,2,13745.0,10,13750.0,20,B
2018-04-19 21:12:27,13750.0,20,2896,2,13745.0,10,13750.0,10,B
2018-04-19 21:12:27,13750.0,20,2916,16,13750.0,1,13755.0,2,B
2018-04-19 21:12:28,13750.0,2,2918,0,13745.0,9,13750.0,6,B
2018-04-19 21:12:29,13750.0,8,2926,-6,13745.0,2,13750.0,10,B
2018-04-19 21:12:29,13745.0,2,2928,0,13745.0,1,13750.0,11,S
2018-04-19 21:12:32,13750.0,2,2930,0,13745.0,2,13750.0,10,B
2018-04-19 21:12:33,13745.0,2,2932,0,13740.0,6,13750.0,11,S
2018-04-19 21:12:34,13750.0,2,2934,2,13740.0,7,13745.0,1,B
2018-04-19 21:12:37,13740.0,2,2936,0,13740.0,1,13745.0,10,S
2018-04-19 21:12:38,13740.0,2,2938,0,13735.0,1,13745.0,10,S
2018-04-19 21:12:39,13745.0,20,2958,12,13740.0,1,13750.0,22,B
2018-04-19 21:12:43,13740.0,4,2962,2,13735.0,14,13740.0,18,S
2018-04-19 21:12:44,13740.0,2,2964,0,13735.0,15,13740.0,17,S
2018-04-19 21:12:45,13735.0,2,2966,0,13735.0,12,13740.0,17,S
2018-04-19 21:12:48,13735.0,6,2972,-4,13735.0,10,13740.0,17,S
2018-04-19 21:12:55,13740.0,4,2976,-2,13735.0,1,13740.0,19,B
2018-04-19 21:12:56,13735.0,2,2978,2,13730.0,2,13740.0,20,S
2018-04-19 21:13:03,13735.0,2,2980,0,13735.0,1,13740.0,23,S
2018-04-19 21:13:14,13735.0,4,2984,-2,13730.0,13,13735.0,1,S
2018-04-19 21:13:21,13735.0,2,2986,0,13730.0,13,13735.0,1,S
2018-04-19 21:13:23,13730.0,26,3012,12,13725.0,2,13730.0,3,S
2018-04-19 21:13:23,13730.0,2,3014,2,13725.0,2,13730.0,2,S
2018-04-19 21:13:37,13730.0,2,3016,0,13725.0,10,13730.0,2,S
2018-04-19 21:13:48,13725.0,4,3020,-4,13725.0,7,13730.0,2,S
2018-04-19 21:13:51,13725.0,4,3024,2,13725.0,6,13730.0,2,S
2018-04-19 21:13:52,13730.0,2,3026,0,13725.0,9,13730.0,1,B
2018-04-19 21:13:52,13730.0,2,3028,2,13730.0,1,13735.0,1,B
2018-04-19 21:13:56,13730.0,2,3030,0,13725.0,8,13735.0,3,B
2018-04-19 21:14:00,13730.0,2,3032,-2,13725.0,4,13730.0,3,B
2018-04-19 21:14:07,13725.0,2,3034,-2,13725.0,3,13730.0,8,S
2018-04-19 21:14:11,13730.0,2,3036,2,13725.0,3,13730.0,6,B
2018-04-19 21:14:15,13730.0,20,3056,10,13725.0,1,13730.0,1,B
2018-04-19 21:14:20,13720.0,8,3064,-4,13720.0,11,13730.0,2,S
2018-04-19 21:14:20,13720.0,2,3066,2,13720.0,11,13730.0,3,S
2018-04-19 21:14:24,13720.0,4,3070,0,13715.0,5,13725.0,6,S
2018-04-19 21:14:24,13730.0,20,3090,14,13720.0,1,13730.0,4,B
2018-04-19 21:14:36,13725.0,6,3096,4,13725.0,7,13730.0,6,S
2018-04-19 21:14:36,13725.0,14,3110,14,13720.0,3,13730.0,6,S
2018-04-19 21:14:41,13730.0,16,3126,10,13730.0,2,13735.0,23,B
2018-04-19 21:14:41,13730.0,4,3130,4,13725.0,1,13730.0,14,B
2018-04-19 21:14:42,13725.0,2,3132,-2,13720.0,2,13725.0,1,S
2018-04-19 21:14:43,13720.0,2,3134,-2,13715.0,10,13725.0,2,S
2018-04-19 21:14:47,13730.0,20,3154,20,13720.0,5,13730.0,2,B
2018-04-19 21:14:49,13730.0,2,3156,0,13725.0,3,13730.0,1,B
2018-04-19 21:14:52,13730.0,6,3162,4,13730.0,2,13735.0,8,B
2018-04-19 21:14:53,13730.0,4,3166,2,13725.0,3,13735.0,9,B
2018-04-19 21:14:56,13730.0,10,3176,0,13725.0,3,13735.0,7,B
2018-04-19 21:14:59,13735.0,2,3178,2,13725.0,1,13735.0,14,B
2018-04-19 21:15:00,13735.0,2,3180,0,13720.0,6,13735.0,13,B
2018-04-19 21:15:08,13725.0,2,3182,2,13725.0,1,13730.0,1,S
2018-04-19 21:15:08,13725.0,2,3184,-2,13720.0,6,13730.0,2,S
2018-04-19 21:15:12,13720.0,2,3186,0,13720.0,6,13730.0,11,S
2018-04-19 21:15:14,13730.0,2,3188,-2,13720.0,6,13730.0,10,B
2018-04-19 21:15:21,13730.0,2,3190,2,13720.0,7,13730.0,10,B
2018-04-19 21:15:24,13730.0,2,3192,2,13720.0,4,13730.0,9,B
2018-04-19 21:15:27,13730.0,4,3196,4,13725.0,3,13730.0,8,B
2018-04-19 21:15:27,13730.0,12,3208,4,13725.0,9,13735.0,4,B
2018-04-19 21:15:35,13730.0,2,3210,-2,13725.0,12,13735.0,5,B
2018-04-19 21:15:37,13730.0,2,3212,0,13730.0,1,13735.0,7,B
2018-04-19 21:15:40,13730.0,2,3214,-2,13725.0,10,13735.0,4,B
2018-04-19 21:15:41,13735.0,10,3224,2,13735.0,1,13740.0,4,B
2018-04-19 21:15:42,13735.0,2,3226,0,13730.0,14,13740.0,3,B
2018-04-19 21:15:50,13730.0,2,3228,0,13730.0,14,13740.0,5,S
2018-04-19 21:15:53,13740.0,2,3230,0,13735.0,13,13745.0,8,B
2018-04-19 21:15:56,13745.0,4,3234,0,13735.0,13,13745.0,7,B
2018-04-19 21:15:57,13745.0,6,3240,2,13735.0,13,13745.0,4,B
2018-04-19 21:16:00,13740.0,4,3244,0,13740.0,1,13745.0,7,S
2018-04-19 21:16:20,13740.0,2,3246,0,13740.0,1,13745.0,7,S
2018-04-19 21:16:48,13745.0,2,3248,0,13740.0,1,13745.0,7,B
2018-04-19 21:16:49,13740.0,2,3250,0,13740.0,1,13745.0,7,S
2018-04-19 21:16:50,13735.0,2,3252,0,13740.0,1,13745.0,7,S
2018-04-19 21:17:10,13740.0,2,3254,2,13730.0,18,13740.0,7,B
2018-04-19 21:17:12,13730.0,2,3256,0,13730.0,17,13740.0,8,S
2018-04-19 21:17:23,13730.0,2,3258,0,13730.0,2,13735.0,2,S
2018-04-19 21:17:26,13735.0,2,3260,0,13730.0,13,13740.0,13,B
2018-04-19 21:17:50,13735.0,2,3262,2,13730.0,2,13735.0,1,B
2018-04-19 21:18:07,13730.0,2,3264,0,13725.0,3,13735.0,3,S
2018-04-19 21:18:12,13725.0,2,3266,-2,13725.0,3,13730.0,11,S
2018-04-19 21:18:13,13725.0,2,3268,0,13725.0,1,13730.0,11,S
2018-04-19 21:18:22,13725.0,2,3270,0,13720.0,14,13730.0,10,S
2018-04-19 21:18:34,13720.0,4,3274,-2,13720.0,12,13725.0,1,S
2018-04-19 21:18:38,13725.0,4,3278,-2,13720.0,12,13725.0,5,B
2018-04-19 21:18:38,13725.0,10,3288,-8,13725.0,20,13735.0,21,B
2018-04-19 21:18:43,13735.0,2,3290,2,13730.0,16,13740.0,6,B
2018-04-19 21:18:56,13735.0,10,3300,4,13735.0,10,13740.0,3,B
2018-04-19 21:18:58,13735.0,2,3302,0,13735.0,9,13740.0,3,B
2018-04-19 21:18:59,13735.0,10,3312,6,13735.0,4,13740.0,3,B
2018-04-19 21:19:04,13740.0,2,3314,2,13735.0,6,13740.0,2,B
2018-04-19 21:19:06,13735.0,6,3320,0,13735.0,2,13740.0,4,S
2018-04-19 21:19:10,13740.0,2,3322,2,13735.0,9,13740.0,3,B
2018-04-19 21:19:28,13740.0,6,3328,0,13740.0,2,13745.0,26,B
2018-04-19 21:19:28,13740.0,4,3332,0,13735.0,8,13745.0,33,B
2018-04-19 21:19:31,13745.0,2,3334,2,13740.0,1,13745.0,16,B
2018-04-19 21:19:31,13740.0,2,3336,2,13735.0,4,13745.0,16,S
2018-04-19 21:19:38,13735.0,6,3342,-2,13735.0,6,13745.0,16,S
2018-04-19 21:19:47,13745.0,4,3346,4,13740.0,9,13745.0,3,B
2018-04-19 21:19:49,13745.0,22,3368,-18,13735.0,8,13745.0,22,B
2018-04-19 21:19:54,13735.0,2,3370,0,13735.0,4,13745.0,11,S
2018-04-19 21:20:08,13735.0,2,3372,2,13730.0,8,13735.0,1,S
2018-04-19 21:20:13,13730.0,10,3382,-2,13730.0,1,13735.0,2,S
2018-04-19 21:20:16,13730.0,4,3386,-4,13725.0,3,13735.0,4,S
2018-04-19 21:20:35,13735.0,4,3390,-2,13730.0,9,13735.0,4,B
2018-04-19 21:20:37,13735.0,2,3392,2,13730.0,13,13740.0,6,B
2018-04-19 21:20:59,13730.0,10,3402,-10,13730.0,6,13735.0,2,S
2018-04-19 21:21:08,13730.0,2,3404,-2,13730.0,6,13735.0,2,S
2018-04-19 21:21:08,13735.0,2,3406,0,13730.0,10,13735.0,1,B
2018-04-19 21:21:22,13735.0,4,3410,2,13730.0,12,13740.0,4,B
2018-04-19 21:21:24,13735.0,2,3412,2,13735.0,3,13740.0,2,B
2018-04-19 21:21:34,13740.0,6,3418,2,13740.0,1,13745.0,9,B
2018-04-19 21:21:35,13740.0,2,3420,2,13735.0,4,13745.0,18,B
2018-04-19 21:21:37,13740.0,2,3422,0,13740.0,2,13745.0,14,B
2018-04-19 21:21:37,13740.0,2,3424,0,13740.0,8,13745.0,4,B
2018-04-19 21:21:41,13740.0,4,3428,4,13740.0,4,13745.0,3,B
2018-04-19 21:21:49,13745.0,2,3430,0,13740.0,7,13745.0,2,B
2018-04-19 21:21:50,13745.0,2,3432,0,13740.0,9,13745.0,1,B
2018-04-19 21:21:53,13745.0,2,3434,2,13740.0,9,13750.0,12,B
2018-04-19 21:22:02,13745.0,2,3436,0,13740.0,9,13750.0,10,B
2018-04-19 21:22:03,13745.0,2,3438,-2,13740.0,7,13745.0,1,B
2018-04-19 21:22:04,13745.0,2,3440,0,13740.0,7,13750.0,10,B
2018-04-19 21:22:09,13745.0,12,3452,10,13740.0,12,13750.0,7,B
2018-04-19 21:22:12,13750.0,2,3454,0,13745.0,1,13750.0,8,B
2018-04-19 21:22:13,13750.0,2,3456,0,13745.0,1,13750.0,7,B
2018-04-19 21:22:17,13750.0,2,3458,-2,13745.0,6,13750.0,5,B
2018-04-19 21:22:22,13750.0,2,3460,0,13745.0,6,13750.0,3,B
2018-04-19 21:22:24,13755.0,8,3468,2,13745.0,6,13755.0,2,B
2018-04-19 21:22:25,13755.0,2,3470,-2,13750.0,1,13755.0,10,B
2018-04-19 21:22:34,13750.0,2,3472,2,13745.0,6,13755.0,10,S
2018-04-19 21:22:37,13750.0,2,3474,2,13750.0,4,13755.0,9,S
2018-04-19 21:22:40,13750.0,4,3478,4,13750.0,6,13760.0,30,S
2018-04-19 21:22:52,13750.0,20,3498,0,13745.0,8,13750.0,5,S
2018-04-19 21:23:10,13740.0,10,3508,6,13740.0,10,13750.0,14,S
2018-04-19 21:23:33,13745.0,4,3512,0,13740.0,15,13750.0,18,B
2018-04-19 21:23:34,13750.0,10,3522,-4,13745.0,2,13750.0,4,B
2018-04-19 21:23:34,13750.0,8,3530,0,13750.0,9,13755.0,12,B
2018-04-19 21:23:35,13750.0,24,3554,-2,13750.0,2,13755.0,9,B
2018-04-19 21:23:38,13750.0,4,3558,0,13745.0,8,13755.0,18,B
2018-04-19 21:23:41,13750.0,2,3560,2,13745.0,14,13750.0,12,B
2018-04-19 21:23:49,13750.0,10,3570,2,13745.0,12,13750.0,9,B
2018-04-19 21:23:49,13750.0,4,3574,4,13745.0,12,13750.0,7,B
2018-04-19 21:23:50,13750.0,2,3576,2,13745.0,12,13750.0,6,B
2018-04-19 21:23:52,13750.0,6,3582,0,13745.0,12,13750.0,3,B
2018-04-19 21:23:57,13750.0,2,3584,0,13745.0,12,13750.0,2,B
2018-04-19 21:23:58,13750.0,2,3586,0,13745.0,11,13750.0,1,B
2018-04-19 21:24:14,13750.0,2,3588,2,13750.0,1,13755.0,9,B
2018-04-19 21:24:14,13750.0,2,3590,0,13750.0,1,13755.0,9,B
2018-04-19 21:24:22,13750.0,8,3598,0,13750.0,2,13755.0,18,B
2018-04-19 21:24:22,13750.0,4,3602,2,13745.0,5,13755.0,18,B
2018-04-19 21:24:30,13750.0,2,3604,0,13745.0,11,13755.0,19,B
2018-04-19 21:24:31,13750.0,2,3606,2,13745.0,8,13750.0,1,B
2018-04-19 21:24:36,13750.0,2,3608,2,13745.0,8,13750.0,4,B
2018-04-19 21:24:40,13750.0,2,3610,0,13745.0,10,13750.0,2,B
2018-04-19 21:24:46,13745.0,16,3626,4,13740.0,12,13750.0,8,S
2018-04-19 21:24:48,13750.0,4,3630,0,13740.0,7,13750.0,15,B
2018-04-19 21:24:50,13740.0,2,3632,0,13740.0,6,13745.0,3,S
2018-04-19 21:24:52,13745.0,4,3636,2,13740.0,6,13750.0,15,B
2018-04-19 21:24:58,13745.0,2,3638,0,13745.0,6,13750.0,2,B
2018-04-19 21:25:11,13750.0,4,3642,2,13745.0,7,13755.0,14,B
2018-04-19 21:25:12,13745.0,2,3644,0,13745.0,6,13755.0,18,S
2018-04-19 21:25:26,13755.0,6,3650,-6,13745.0,10,13755.0,4,B
2018-04-19 21:25:37,13745.0,2,3652,-2,13745.0,9,13755.0,4,S
2018-04-19 21:25:37,13755.0,2,3654,0,13745.0,9,13755.0,3,B
2018-04-19 21:25:43,13755.0,8,3662,-6,13755.0,6,13760.0,15,B
2018-04-19 21:25:44,13755.0,16,3678,0,13750.0,2,13760.0,23,B
2018-04-19 21:26:00,13760.0,2,3680,2,13755.0,9,13760.0,8,B
2018-04-19 21:26:00,13765.0,20,3700,6,13755.0,12,13765.0,8,B
2018-04-19 21:26:01,13765.0,2,3702,0,13760.0,1,13765.0,5,B
2018-04-19 21:26:29,13760.0,6,3708,0,13760.0,4,13765.0,10,S
2018-04-19 21:26:30,13765.0,10,3718,4,13755.0,8,13765.0,29,B
2018-04-19 21:26:33,13760.0,4,3722,-2,13755.0,5,13765.0,29,S
2018-04-19 21:26:51,13755.0,2,3724,0,13755.0,5,13760.0,1,S
2018-04-19 21:26:56,13760.0,2,3726,0,13755.0,6,13765.0,10,B
2018-04-19 21:26:59,13760.0,4,3730,2,13760.0,2,13765.0,10,B
2018-04-19 21:27:01,13765.0,2,3732,2,13760.0,3,13765.0,8,B
2018-04-19 21:27:05,13765.0,2,3734,2,13760.0,4,13765.0,7,B
2018-04-19 21:27:08,13765.0,4,3738,0,13760.0,4,13765.0,5,B
2018-04-19 21:27:16,13760.0,4,3742,-4,13760.0,2,13765.0,3,S
2018-04-19 21:27:17,13765.0,6,3748,2,13760.0,2,13770.0,19,B
2018-04-19 21:27:20,13765.0,2,3750,2,13760.0,3,13765.0,1,B
2018-04-19 21:27:22,13765.0,2,3752,-2,13760.0,6,13770.0,27,B
2018-04-19 21:27:35,13765.0,2,3754,0,13765.0,1,13770.0,6,B
2018-04-19 21:27:42,13770.0,4,3758,-4,13765.0,2,13770.0,2,B
2018-04-19 21:27:54,13770.0,28,3786,12,13770.0,2,13775.0,39,B
2018-04-19 21:27:54,13770.0,4,3790,0,13765.0,3,13770.0,6,B
2018-04-19 21:27:56,13770.0,2,3792,-2,13765.0,3,13770.0,4,B
2018-04-19 21:28:02,13765.0,2,3794,2,13765.0,2,13770.0,4,S
2018-04-19 21:28:06,13765.0,2,3796,2,13765.0,1,13770.0,4,S
2018-04-19 21:28:08,13765.0,2,3798,0,13760.0,6,13770.0,5,S
2018-04-19 21:28:10,13760.0,10,3808,2,13755.0,4,13760.0,1,S
2018-04-19 21:28:16,13760.0,10,3818,2,13755.0,6,13765.0,4,S
2018-04-19 21:28:18,13760.0,4,3822,2,13755.0,5,13765.0,4,S
2018-04-19 21:28:27,13760.0,2,3824,2,13755.0,1,13760.0,4,S
2018-04-19 21:28:35,13755.0,2,3826,0,13750.0,12,13760.0,5,S
2018-04-19 21:28:38,13750.0,2,3828,0,13750.0,4,13755.0,1,S
2018-04-19 21:28:40,13750.0,2,3830,2,13755.0,3,13760.0,5,S
2018-04-19 21:28:42,13760.0,2,3832,2,13755.0,3,13760.0,4,B
2018-04-19 21:28:43,13755.0,2,3834,2,13755.0,2,13760.0,4,S
2018-04-19 21:28:45,13760.0,2,3836,2,13755.0,2,13760.0,3,B
2018-04-19 21:28:59,13760.0,4,3840,-4,13760.0,5,13765.0,10,B
2018-04-19 21:29:02,13760.0,2,3842,-2,13760.0,2,13765.0,5,B
2018-04-19 21:29:03,13760.0,4,3846,0,13755.0,14,13765.0,4,B
2018-04-19 21:29:26,13765.0,4,3850,2,13760.0,10,13765.0,1,B
2018-04-19 21:29:26,13765.0,2,3852,0,13760.0,15,13770.0,6,B
2018-04-19 21:29:40,13770.0,4,3856,-2,13770.0,2,13775.0,39,B
2018-04-19 21:29:41,13770.0,4,3860,-4,13765.0,1,13770.0,2,B
2018-04-19 21:29:43,13770.0,2,3862,2,13760.0,16,13770.0,1,B
2018-04-19 21:29:47,13770.0,2,3864,2,13765.0,1,13770.0,3,B
2018-04-19 21:29:52,13770.0,2,3866,0,13765.0,4,13770.0,1,B
2018-04-19 21:29:55,13765.0,8,3874,0,13760.0,7,13770.0,18,S
2018-04-19 21:30:05,13755.0,2,3876,-2,13750.0,8,13755.0,2,S
2018-04-19 21:30:05,13755.0,4,3880,0,13750.0,16,13760.0,4,S
2018-04-19 21:30:19,13750.0,2,3882,0,13750.0,4,13760.0,25,S
2018-04-19 21:30:26,13750.0,10,3892,6,13745.0,7,13750.0,1,S
2018-04-19 21:30:30,13750.0,2,3894,2,13745.0,16,13755.0,4,S
2018-04-19 21:30:44,13750.0,2,3896,0,13745.0,16,13750.0,3,S
2018-04-19 21:30:45,13750.0,2,3898,2,13745.0,16,13750.0,2,S
2018-04-19 21:31:02,13750.0,4,3902,4,13750.0,11,13755.0,10,S
2018-04-19 21:31:17,13755.0,20,3922,0,13755.0,7,13760.0,11,B
2018-04-19 21:31:34,13760.0,2,3924,0,13755.0,12,13760.0,5,B
2018-04-19 21:31:35,13760.0,10,3934,6,13760.0,10,13765.0,6,B
2018-04-19 21:31:41,13765.0,2,3936,2,13760.0,3,13765.0,1,B
2018-04-19 21:31:46,13765.0,2,3938,0,13760.0,7,13770.0,12,B
2018-04-19 21:31:55,13775.0,8,3946,-6,13770.0,5,13775.0,27,B
2018-04-19 21:31:56,13770.0,4,3950,-2,13770.0,2,13775.0,22,S
2018-04-19 21:31:57,13770.0,2,3952,0,13770.0,3,13775.0,22,S
2018-04-19 21:31:58,13770.0,4,3956,-2,13765.0,17,13775.0,22,S
2018-04-19 21:32:02,13770.0,2,3958,-2,13770.0,1,13775.0,24,S
2018-04-19 21:32:03,13770.0,2,3960,2,13770.0,1,13775.0,24,S
2018-04-19 21:32:04,13770.0,2,3962,-2,13770.0,1,13775.0,24,S
2018-04-19 21:32:08,13775.0,2,3964,0,13770.0,9,13775.0,21,B
2018-04-19 21:32:09,13775.0,8,3972,0,13770.0,14,13775.0,17,B
2018-04-19 21:32:11,13775.0,34,4006,8,13775.0,23,13780.0,13,B
2018-04-19 21:32:12,13780.0,24,4030,4,13775.0,16,13785.0,5,B
2018-04-19 21:32:15,13785.0,4,4034,-4,13780.0,15,13785.0,2,B
2018-04-19 21:32:15,13785.0,4,4038,-2,13780.0,15,13790.0,44,B
2018-04-19 21:32:16,13790.0,2,4040,2,13785.0,3,13790.0,47,B
2018-04-19 21:32:18,13790.0,4,4044,0,13785.0,12,13790.0,41,B
2018-04-19 21:32:18,13790.0,50,4094,-18,13785.0,14,13790.0,16,B
2018-04-19 21:32:19,13790.0,30,4124,-14,13785.0,23,13790.0,1,B
2018-04-19 21:32:19,13790.0,2,4126,0,13790.0,4,13795.0,13,B
2018-04-19 21:32:20,13795.0,2,4128,0,13790.0,7,13795.0,12,B
2018-04-19 21:32:20,13795.0,2,4130,2,13790.0,4,13795.0,11,B
2018-04-19 21:32:22,13795.0,20,4150,0,13790.0,4,13795.0,1,B
2018-04-19 21:32:22,13790.0,6,4156,2,13790.0,2,13800.0,131,S
2018-04-19 21:32:23,13795.0,2,4158,-2,13790.0,2,13795.0,2,B
2018-04-19 21:32:23,13795.0,2,4160,-2,13790.0,3,13795.0,9,B
2018-04-19 21:32:24,13790.0,4,4164,0,13785.0,11,13790.0,1,S
2018-04-19 21:32:25,13785.0,2,4166,2,13785.0,7,13790.0,4,S
2018-04-19 21:32:27,13785.0,14,4180,-4,13780.0,9,13785.0,1,S
2018-04-19 21:32:28,13780.0,18,4198,6,13775.0,4,13780.0,1,S
2018-04-19 21:32:31,13780.0,4,4202,0,13775.0,9,13785.0,8,S
2018-04-19 21:32:32,13780.0,2,4204,0,13775.0,6,13785.0,19,S
2018-04-19 21:32:40,13775.0,10,4214,8,13775.0,3,13785.0,20,S
2018-04-19 21:32:42,13775.0,4,4218,2,13775.0,1,13780.0,11,S
2018-04-19 21:32:43,13775.0,2,4220,2,13770.0,3,13775.0,4,S
2018-04-19 21:32:56,13780.0,4,4224,0,13770.0,26,13780.0,15,B
2018-04-19 21:32:58,13775.0,2,4226,-2,13770.0,25,13780.0,17,S
2018-04-19 21:33:04,13770.0,2,4228,0,13770.0,19,13775.0,20,S
2018-04-19 21:33:09,13775.0,20,4248,-6,13770.0,19,13775.0,10,B
2018-04-19 21:33:11,13770.0,2,4250,-2,13770.0,18,13775.0,10,S
2018-04-19 21:33:11,13770.0,4,4254,-4,13770.0,16,13775.0,25,S
2018-04-19 21:33:12,13770.0,32,4286,0,13765.0,5,13775.0,15,S
2018-04-19 21:33:20,13765.0,8,4294,4,13760.0,2,13765.0,4,S
2018-04-19 21:33:21,13760.0,2,4296,0,13755.0,3,13765.0,6,S
2018-04-19 21:33:24,13765.0,6,4302,-6,13760.0,14,13770.0,9,B
2018-04-19 21:33:26,13770.0,2,4304,0,13760.0,18,13770.0,10,B
2018-04-19 21:33:28,13760.0,2,4306,2,13760.0,17,13770.0,10,S
2018-04-19 21:33:40,13760.0,2,4308,0,13760.0,18,13770.0,10,S
2018-04-19 21:33:50,13760.0,2,4310,-2,13760.0,17,13765.0,2,S
2018-04-19 21:33:52,13765.0,2,4312,0,13760.0,17,13765.0,1,B
2018-04-19 21:33:57,13760.0,2,4314,0,13760.0,15,13765.0,1,S
2018-04-19 21:34:02,13765.0,2,4316,2,13760.0,15,13770.0,10,B
2018-04-19 21:34:03,13760.0,20,4336,10,13760.0,5,13770.0,16,S
2018-04-19 21:34:20,13760.0,6,4342,4,13760.0,1,13765.0,6,S
2018-04-19 21:34:32,13760.0,4,4346,0,13755.0,10,13765.0,29,S
2018-04-19 21:34:50,13755.0,2,4348,-2,13755.0,10,13760.0,1,S
2018-04-19 21:34:56,13755.0,12,4360,6,13750.0,7,13760.0,30,S
2018-04-19 21:34:57,13755.0,2,4362,0,13750.0,5,13755.0,3,S
2018-04-19 21:35:05,13755.0,8,4370,8,13750.0,6,13760.0,31,S
2018-04-19 21:35:14,13760.0,16,4386,-4,13755.0,5,13765.0,18,B
2018-04-19 21:35:20,13765.0,2,4388,2,13760.0,4,13765.0,5,B
2018-04-19 21:35:25,13765.0,4,4392,0,13760.0,4,13765.0,3,B
2018-04-19 21:35:26,13765.0,2,4394,2,13760.0,4,13765.0,2,B
2018-04-19 21:35:26,13760.0,2,4396,0,13760.0,3,13765.0,2,S
2018-04-19 21:35:30,13760.0,4,4400,0,13760.0,1,13765.0,2,S
2018-04-19 21:35:30,13760.0,2,4402,-2,13755.0,14,13765.0,2,S
2018-04-19 21:35:32,13765.0,4,4406,0,13765.0,5,13770.0,6,B
2018-04-19 21:35:48,13770.0,2,4408,0,13770.0,1,13775.0,7,B
2018-04-19 21:36:01,13775.0,2,4410,0,13770.0,4,13780.0,14,B
2018-04-19 21:36:04,13775.0,2,4412,-2,13770.0,4,13775.0,1,B
2018-04-19 21:36:10,13775.0,4,4416,-4,13775.0,3,13780.0,15,B
2018-04-19 21:36:10,13775.0,6,4422,-2,13770.0,5,13780.0,15,B
2018-04-19 21:36:20,13770.0,2,4424,0,13770.0,5,13775.0,20,S
2018-04-19 21:36:27,13770.0,10,4434,2,13765.0,6,13770.0,21,S
2018-04-19 21:36:31,13770.0,2,4436,-2,13765.0,3,13770.0,13,S
2018-04-19 21:36:37,13760.0,2,4438,0,13755.0,2,13765.0,11,S
2018-04-19 21:36:37,13755.0,2,4440,0,13755.0,2,13765.0,13,S
2018-04-19 21:36:43,13755.0,4,4444,0,13755.0,2,13765.0,13,S
2018-04-19 21:36:46,13755.0,4,4448,-2,13755.0,1,13765.0,12,S
2018-04-19 21:36:48,13755.0,4,4452,2,13750.0,16,13765.0,13,S
2018-04-19 21:37:07,13765.0,2,4454,-2,13760.0,2,13770.0,12,B
2018-04-19 21:37:25,13760.0,2,4456,0,13755.0,14,13765.0,3,S
2018-04-19 21:37:33,13760.0,2,4458,2,13755.0,6,13760.0,3,S
2018-04-19 21:37:34,13760.0,2,4460,0,13755.0,10,13765.0,9,S
2018-04-19 21:37:37,13765.0,6,4466,0,13760.0,1,13765.0,7,B
2018-04-19 21:37:54,13765.0,4,4470,4,13760.0,1,13765.0,2,B
2018-04-19 21:38:08,13765.0,2,4472,0,13760.0,3,13765.0,1,B
2018-04-19 21:38:11,13760.0,6,4478,0,13755.0,12,13765.0,2,S
2018-04-19 21:38:17,13765.0,2,4480,2,13755.0,22,13765.0,6,B
2018-04-19 21:38:55,13760.0,8,4488,-6,13760.0,1,13765.0,28,S
2018-04-19 21:38:55,13760.0,2,4490,-2,13755.0,13,13760.0,2,S
2018-04-19 21:39:13,13760.0,2,4492,2,13760.0,11,13765.0,7,S
2018-04-19 21:39:13,13760.0,2,4494,-2,13760.0,1,13765.0,2,S
2018-04-19 21:39:29,13765.0,16,4510,-6,13760.0,1,13770.0,28,B
2018-04-19 21:39:30,13765.0,4,4514,-2,13760.0,2,13765.0,1,B
2018-04-19 21:39:30,13765.0,4,4518,0,13760.0,4,13770.0,38,B
2018-04-19 21:39:31,13765.0,2,4520,0,13760.0,6,13770.0,38,B
2018-04-19 21:39:36,13760.0,12,4532,-2,13755.0,8,13760.0,1,S
2018-04-19 21:39:37,13755.0,6,4538,2,13755.0,3,13760.0,4,S
2018-04-19 21:39:39,13755.0,2,4540,-2,13755.0,1,13760.0,4,S
2018-04-19 21:39:40,13755.0,4,4544,-4,13750.0,16,13760.0,4,S
2018-04-19 21:39:54,13750.0,10,4554,-8,13745.0,9,13755.0,18,S
2018-04-19 21:40:03,13750.0,2,4556,0,13745.0,6,13750.0,5,S
2018-04-19 21:40:04,13745.0,2,4558,-2,13745.0,5,13750.0,5,S
2018-04-19 21:40:06,13745.0,2,4560,-2,13745.0,4,13750.0,17,S
2018-04-19 21:40:07,13745.0,8,4568,-2,13740.0,27,13750.0,17,S
2018-04-19 21:40:08,13750.0,2,4570,2,13745.0,13,13755.0,15,B
2018-04-19 21:40:13,13750.0,2,4572,0,13745.0,11,13750.0,1,B
2018-04-19 21:40:29,13750.0,2,4574,-2,13745.0,9,13750.0,2,B
2018-04-19 21:40:30,13750.0,4,4578,-4,13745.0,14,13755.0,19,B
2018-04-19 21:40:36,13760.0,8,4586,0,13755.0,5,13765.0,17,B
2018-04-19 21:40:42,13755.0,2,4588,0,13755.0,5,13760.0,1,S
2018-04-19 21:40:49,13760.0,6,4594,-2,13755.0,4,13765.0,18,B
2018-04-19 21:40:50,13760.0,4,4598,-4,13755.0,7,13760.0,2,B
2018-04-19 21:41:00,13755.0,6,4604,-2,13750.0,9,13755.0,3,S
2018-04-19 21:41:01,13755.0,2,4606,2,13750.0,10,13755.0,2,S
2018-04-19 21:41:03,13755.0,4,4610,0,13755.0,1,13760.0,8,S
2018-04-19 21:41:08,13755.0,2,4612,0,13750.0,24,13760.0,4,S
2018-04-19 21:41:36,13755.0,2,4614,0,13755.0,3,13760.0,4,S
2018-04-19 21:41:37,13760.0,8,4622,4,13760.0,14,13765.0,8,B
2018-04-19 21:41:38,13765.0,4,4626,-2,13760.0,12,13765.0,2,B
2018-04-19 21:41:39,13770.0,14,4640,4,13770.0,7,13775.0,11,B
2018-04-19 21:41:40,13770.0,28,4668,-8,13765.0,21,13770.0,2,B
2018-04-19 21:41:40,13765.0,6,4674,0,13765.0,6,13770.0,4,S
2018-04-19 21:41:41,13765.0,2,4676,0,13765.0,5,13770.0,10,S
2018-04-19 21:41:41,13765.0,8,4684,8,13760.0,13,13770.0,9,S
2018-04-19 21:41:45,13770.0,2,4686,0,13765.0,9,13775.0,12,B
2018-04-19 21:41:58,13775.0,6,4692,0,13770.0,23,13775.0,5,B
2018-04-19 21:41:58,13775.0,10,4702,-2,13770.0,15,13780.0,6,B
2018-04-19 21:42:01,13775.0,10,4712,-4,13770.0,8,13780.0,22,B
2018-04-19 21:42:01,13780.0,24,4736,6,13780.0,4,13785.0,3,B
2018-04-19 21:42:02,13780.0,2,4738,-2,13780.0,4,13785.0,3,B
2018-04-19 21:42:02,13785.0,4,4742,2,13780.0,4,13785.0,1,B
2018-04-19 21:42:03,13785.0,2,4744,0,13780.0,4,13790.0,18,B
2018-04-19 21:42:05,13785.0,4,4748,0,13780.0,5,13785.0,4,B
2018-04-19 21:42:05,13785.0,8,4756,8,13785.0,9,13790.0,29,B
2018-04-19 21:42:06,13785.0,16,4772,4,13785.0,14,13790.0,11,B
2018-04-19 21:42:07,13790.0,22,4794,20,13785.0,15,13795.0,25,B
2018-04-19 21:42:08,13790.0,4,4798,-2,13785.0,19,13795.0,25,B
2018-04-19 21:42:08,13790.0,4,4802,2,13785.0,19,13795.0,24,B
2018-04-19 21:42:10,13795.0,8,4810,0,13790.0,14,13795.0,20,B
2018-04-19 21:42:11,13795.0,40,4850,30,13795.0,6,13800.0,135,B
2018-04-19 21:42:12,13795.0,10,4860,-2,13795.0,18,13800.0,131,B
2018-04-19 21:42:12,13800.0,52,4912,-10,13795.0,27,13800.0,105,B
2018-04-19 21:42:13,13800.0,18,4930,-4,13795.0,13,13800.0,97,B
2018-04-19 21:42:14,13795.0,4,4934,0,13795.0,11,13800.0,99,S
2018-04-19 21:42:14,13795.0,22,4956,0,13790.0,23,13800.0,99,S
2018-04-19 21:42:15,13795.0,2,4958,0,13790.0,23,13800.0,101,S
2018-04-19 21:42:16,13800.0,2,4960,0,13795.0,6,13800.0,96,B
2018-04-19 21:42:18,13795.0,2,4962,2,13795.0,8,13800.0,96,S
2018-04-19 21:42:19,13795.0,4,4966,-4,13795.0,6,13800.0,97,S
2018-04-19 21:42:20,13800.0,4,4970,0,13795.0,33,13800.0,95,B
2018-04-19 21:42:20,13800.0,18,4988,-6,13795.0,3,13800.0,90,B
2018-04-19 21:42:21,13795.0,2,4990,2,13795.0,5,13800.0,91,S
2018-04-19 21:42:22,13790.0,94,5084,82,13790.0,2,13795.0,1,S
2018-04-19 21:42:22,13790.0,4,5088,2,13780.0,6,13790.0,10,S
2018-04-19 21:42:24,13780.0,32,5120,-6,13780.0,3,13785.0,1,S
2018-04-19 21:42:24,13785.0,2,5122,-2,13780.0,3,13790.0,10,B
2018-04-19 21:42:25,13780.0,2,5124,0,13780.0,2,13785.0,3,S
2018-04-19 21:42:26,13780.0,4,5128,0,13775.0,6,13785.0,9,S
2018-04-19 21:42:33,13775.0,8,5136,6,13770.0,5,13775.0,1,S
2018-04-19 21:42:33,13775.0,4,5140,0,13770.0,5,13780.0,10,S
2018-04-19 21:42:36,13780.0,2,5142,0,13775.0,12,13780.0,4,B
2018-04-19 21:42:37,13785.0,8,5150,-4,13775.0,13,13785.0,3,B
2018-04-19 21:42:38,13780.0,2,5152,-2,13780.0,4,13785.0,1,S
2018-04-19 21:42:41,13785.0,2,5154,2,13780.0,3,13785.0,8,B
2018-04-19 21:42:45,13785.0,2,5156,2,13780.0,12,13785.0,1,B
2018-04-19 21:42:46,13785.0,2,5158,-2,13785.0,5,13790.0,8,B
2018-04-19 21:42:47,13790.0,2,5160,2,13790.0,1,13795.0,14,B
2018-04-19 21:42:47,13790.0,4,5164,0,13790.0,4,13795.0,15,B
2018-04-19 21:42:48,13790.0,2,5166,0,13790.0,3,13795.0,17,B
2018-04-19 21:42:51,13790.0,8,5174,0,13785.0,13,13790.0,6,B
2018-04-19 21:42:55,13785.0,2,5176,0,13780.0,11,13790.0,22,S
2018-04-19 21:42:56,13785.0,2,5178,0,13785.0,1,13790.0,22,S
2018-04-19 21:42:56,13785.0,2,5180,2,13780.0,9,13790.0,22,S
2018-04-19 21:42:58,13780.0,2,5182,0,13780.0,12,13790.0,20,S
2018-04-19 21:43:02,13780.0,6,5188,-4,13780.0,6,13785.0,17,S
2018-04-19 21:43:03,13780.0,2,5190,-2,13780.0,5,13785.0,17,S
2018-04-19 21:43:06,13780.0,12,5202,10,13775.0,14,13780.0,4,S
2018-04-19 21:43:07,13780.0,2,5204,2,13775.0,14,13780.0,8,S
2018-04-19 21:43:15,13785.0,8,5212,-8,13780.0,3,13785.0,15,B
2018-04-19 21:43:17,13785.0,2,5214,0,13780.0,3,13790.0,16,B
2018-04-19 21:43:19,13790.0,10,5224,0,13780.0,5,13790.0,17,B
2018-04-19 21:43:20,13790.0,4,5228,2,13780.0,3,13790.0,17,B
2018-04-19 21:43:25,13780.0,2,5230,0,13780.0,1,13785.0,18,S
2018-04-19 21:43:36,13780.0,2,5232,2,13780.0,1,13785.0,15,S
2018-04-19 21:43:54,13785.0,2,5234,-2,13780.0,7,13785.0,2,B
2018-04-19 21:43:57,13790.0,8,5242,-8,13780.0,8,13790.0,17,B
2018-04-19 21:44:01,13790.0,10,5252,-10,13780.0,12,13790.0,16,B
2018-04-19 21:44:02,13790.0,8,5260,-4,13790.0,4,13795.0,21,B
2018-04-19 21:44:04,13795.0,4,5264,2,13790.0,3,13795.0,22,B
2018-04-19 21:44:05,13795.0,6,5270,2,13790.0,4,13795.0,10,B
2018-04-19 21:44:08,13795.0,10,5280,0,13790.0,4,13795.0,5,B
2018-04-19 21:44:12,13790.0,14,5294,-2,13785.0,7,13790.0,3,S
2018-04-19 21:44:12,13790.0,6,5300,-2,13790.0,2,13795.0,8,S
2018-04-19 21:44:13,13795.0,6,5306,0,13790.0,5,13795.0,2,B
2018-04-19 21:44:14,13795.0,4,5310,0,13795.0,9,13800.0,97,B
2018-04-19 21:44:15,13795.0,14,5324,0,13790.0,21,13800.0,90,B
2018-04-19 21:44:18,13790.0,4,5328,2,13785.0,8,13790.0,1,S
2018-04-19 21:44:19,13790.0,4,5332,-2,13785.0,13,13795.0,6,S
2018-04-19 21:44:22,13790.0,2,5334,2,13785.0,2,13790.0,1,S
2018-04-19 21:44:22,13785.0,4,5338,-2,13780.0,11,13790.0,15,S
2018-04-19 21:44:23,13790.0,4,5342,2,13780.0,6,13790.0,14,B
2018-04-19 21:44:25,13785.0,2,5344,0,13780.0,9,13790.0,14,S
2018-04-19 21:44:31,13785.0,2,5346,0,13780.0,10,13785.0,3,S
2018-04-19 21:44:34,13780.0,4,5350,4,13780.0,5,13785.0,14,S
2018-04-19 21:44:49,13780.0,4,5354,-2,13780.0,5,13785.0,18,S
2018-04-19 21:44:50,13780.0,10,5364,8,13775.0,9,13780.0,9,S
2018-04-19 21:44:51,13780.0,18,5382,-10,13780.0,11,13785.0,13,S
2018-04-19 21:44:51,13780.0,16,5398,-4,13780.0,3,13785.0,13,S
2018-04-19 21:44:52,13780.0,6,5404,-6,13775.0,7,13780.0,4,S
2018-04-19 21:45:01,13780.0,4,5408,-4,13775.0,8,13785.0,8,S
2018-04-19 21:45:04,13780.0,2,5410,0,13780.0,3,13785.0,5,S
2018-04-19 21:45:07,13780.0,4,5414,0,13780.0,2,13785.0,5,S
2018-04-19 21:45:11,13785.0,10,5424,-6,13785.0,3,13790.0,23,B
2018-04-19 21:45:15,13790.0,4,5428,-2,13785.0,4,13790.0,1,B
2018-04-19 21:45:28,13790.0,2,5430,0,13790.0,3,13795.0,10,B
2018-04-19 21:45:30,13795.0,8,5438,-2,13790.0,4,13800.0,116,B
2018-04-19 21:45:32,13795.0,32,5470,16,13795.0,15,13800.0,93,B
2018-04-19 21:45:32,13800.0,2,5472,-2,13795.0,15,13800.0,92,B
2018-04-19 21:45:33,13800.0,10,5482,-10,13795.0,15,13800.0,87,B
2018-04-19 21:45:33,13800.0,28,5510,-18,13795.0,15,13800.0,73,B
2018-04-19 21:45:34,13795.0,20,5530,-8,13790.0,8,13795.0,2,S
2018-04-19 21:45:34,13795.0,18,5548,4,13790.0,4,13795.0,2,S
2018-04-19 21:45:38,13795.0,2,5550,0,13790.0,6,13795.0,1,S
2018-04-19 21:45:38,13795.0,2,5552,0,13790.0,6,13795.0,1,S
2018-04-19 21:45:41,13795.0,2,5554,0,13790.0,1,13795.0,6,S
2018-04-19 21:45:44,13790.0,4,5558,-2,13785.0,9,13795.0,10,S
2018-04-19 21:45:45,13795.0,2,5560,-2,13785.0,10,13795.0,9,B
2018-04-19 21:45:47,13795.0,2,5562,0,13785.0,3,13790.0,6,B
2018-04-19 21:45:56,13790.0,8,5570,-2,13790.0,6,13795.0,8,S
2018-04-19 21:46:01,13795.0,8,5578,0,13790.0,6,13795.0,5,B
2018-04-19 21:46:05,13790.0,12,5590,-10,13785.0,10,13790.0,5,S
2018-04-19 21:46:06,13790.0,2,5592,0,13785.0,6,13790.0,2,S
2018-04-19 21:46:12,13790.0,2,5594,0,13785.0,6,13790.0,4,S
2018-04-19 21:46:13,13785.0,2,5596,2,13785.0,8,13790.0,3,S
2018-04-19 21:46:13,13790.0,2,5598,-2,13785.0,10,13790.0,1,B
2018-04-19 21:46:14,13790.0,2,5600,2,13785.0,10,13795.0,6,B
2018-04-19 21:46:19,13785.0,4,5604,2,13785.0,8,13790.0,1,S
2018-04-19 21:46:20,13790.0,2,5606,-2,13785.0,8,13795.0,5,B
2018-04-19 21:46:20,13795.0,8,5614,0,13790.0,3,13800.0,93,B
2018-04-19 21:46:21,13795.0,2,5616,2,13790.0,11,13795.0,3,B
2018-04-19 21:46:22,13795.0,2,5618,2,13790.0,11,13795.0,2,B
2018-04-19 21:46:25,13795.0,2,5620,2,13790.0,11,13795.0,1,B
2018-04-19 21:46:26,13795.0,4,5624,4,13795.0,3,13800.0,89,B
2018-04-19 21:46:27,13795.0,6,5630,6,13795.0,1,13800.0,99,B
2018-04-19 21:46:28,13795.0,2,5632,2,13790.0,9,13795.0,2,B
2018-04-19 21:46:29,13790.0,8,5640,0,13785.0,6,13795.0,16,S
2018-04-19 21:46:30,13795.0,4,5644,4,13795.0,2,13800.0,94,B
2018-04-19 21:46:31,13800.0,4,5648,0,13795.0,12,13800.0,82,B
2018-04-19 21:46:31,13800.0,4,5652,0,13795.0,12,13800.0,80,B
2018-04-19 21:46:32,13800.0,24,5676,-2,13795.0,45,13800.0,68,B
2018-04-19 21:46:32,13800.0,74,5750,24,13795.0,44,13800.0,31,B
2018-04-19 21:46:33,13800.0,62,5812,0,13800.0,2,13805.0,20,B
2018-04-19 21:46:33,13800.0,28,5840,6,13800.0,3,13805.0,8,B
2018-04-19 21:46:34,13805.0,10,5850,0,13805.0,8,13810.0,20,B
2018-04-19 21:46:35,13805.0,8,5858,4,13805.0,16,13810.0,16,B
2018-04-19 21:46:37,13800.0,36,5894,36,13795.0,24,13805.0,9,S
2018-04-19 21:46:37,13795.0,14,5908,-4,13790.0,1,13800.0,4,S
2018-04-19 21:46:38,13800.0,2,5910,2,13790.0,1,13800.0,3,B
2018-04-19 21:46:42,13795.0,6,5916,0,13790.0,4,13795.0,5,S
2018-04-19 21:46:45,13790.0,4,5920,-2,13790.0,2,13795.0,5,S
2018-04-19 21:46:45,13790.0,4,5924,0,13785.0,6,13795.0,5,S
2018-04-19 21:46:47,13795.0,4,5928,0,13785.0,41,13800.0,22,B
2018-04-19 21:46:51,13795.0,6,5934,4,13790.0,1,13795.0,2,B
2018-04-19 21:46:52,13795.0,4,5938,0,13790.0,1,13800.0,22,B
2018-04-19 21:46:58,13795.0,2,5940,0,13790.0,1,13795.0,19,B
2018-04-19 21:46:59,13790.0,2,5942,0,13785.0,29,13795.0,19,S
2018-04-19 21:47:00,13785.0,2,5944,0,13780.0,20,13790.0,18,S
2018-04-19 21:47:00,13790.0,2,5946,-2,13780.0,16,13790.0,17,B
2018-04-19 21:47:01,13780.0,2,5948,-2,13780.0,15,13790.0,17,S
2018-04-19 21:47:04,13785.0,2,5950,-2,13780.0,11,13785.0,9,B
2018-04-19 21:47:05,13780.0,6,5956,-6,13780.0,8,13785.0,15,S
2018-04-19 21:47:05,13780.0,16,5972,-4,13775.0,10,13785.0,17,S
2018-04-19 21:47:06,13775.0,20,5992,-10,13770.0,21,13775.0,2,S
2018-04-19 21:47:06,13775.0,20,6012,-6,13770.0,10,13775.0,8,S
2018-04-19 21:47:07,13770.0,14,6026,0,13770.0,3,13775.0,9,S
2018-04-19 21:47:07,13770.0,6,6032,0,13765.0,6,13775.0,9,S
2018-04-19 21:47:11,13775.0,8,6040,6,13765.0,10,13775.0,5,B
2018-04-19 21:47:15,13775.0,4,6044,4,13770.0,11,13775.0,1,B
2018-04-19 21:47:18,13780.0,8,6052,2,13775.0,1,13780.0,7,B
2018-04-19 21:47:18,13780.0,12,6064,6,13780.0,1,13785.0,13,B
2018-04-19 21:47:19,13785.0,12,6076,4,13780.0,2,13790.0,11,B
2018-04-19 21:47:21,13785.0,2,6078,0,13785.0,4,13790.0,15,B
2018-04-19 21:47:22,13790.0,2,6080,-2,13785.0,12,13790.0,1,B
2018-04-19 21:47:24,13790.0,4,6084,2,13790.0,2,13795.0,18,B
2018-04-19 21:47:24,13790.0,4,6088,0,13785.0,8,13790.0,1,B
2018-04-19 21:47:27,13785.0,4,6092,0,13780.0,8,13790.0,13,S
2018-04-19 21:47:35,13785.0,6,6098,-4,13780.0,2,13790.0,15,S
2018-04-19 21:47:42,13785.0,2,6100,2,13780.0,17,13790.0,7,S
2018-04-19 21:47:45,13790.0,2,6102,2,13780.0,7,13790.0,11,B
2018-04-19 21:47:46,13790.0,2,6104,0,13780.0,7,13790.0,9,B
2018-04-19 21:48:05,13785.0,2,6106,0,13785.0,4,13790.0,5,S
2018-04-19 21:48:07,13785.0,8,6114,-8,13780.0,10,13790.0,7,S
2018-04-19 21:48:18,13780.0,2,6116,0,13780.0,3,13785.0,8,S
2018-04-19 21:48:19,13780.0,6,6122,4,13775.0,10,13785.0,13,S
2018-04-19 21:48:44,13775.0,2,6124,-2,13775.0,10,13780.0,1,S
2018-04-19 21:48:51,13780.0,6,6130,2,13780.0,1,13785.0,11,B
2018-04-19 21:48:52,13780.0,2,6132,2,13780.0,1,13785.0,6,B
2018-04-19 21:49:02,13780.0,2,6134,0,13775.0,18,13785.0,4,B
2018-04-19 21:49:09,13780.0,6,6140,-2,13775.0,8,13785.0,28,B
2018-04-19 21:49:10,13780.0,2,6142,0,13775.0,18,13785.0,7,B
2018-04-19 21:49:10,13780.0,2,6144,0,13780.0,1,13785.0,3,B
2018-04-19 21:49:11,13785.0,6,6150,4,13785.0,1,13790.0,21,B
2018-04-19 21:49:25,13785.0,2,6152,0,13780.0,12,13790.0,22,B
2018-04-19 21:50:03,13780.0,2,6154,0,13780.0,4,13785.0,5,S
2018-04-19 21:50:03,13780.0,8,6162,8,13775.0,13,13780.0,6,S
2018-04-19 21:50:06,13775.0,4,6166,-4,13775.0,2,13780.0,27,S
2018-04-19 21:50:06,13775.0,4,6170,-4,13770.0,22,13775.0,1,S
2018-04-19 21:50:09,13770.0,2,6172,-2,13770.0,18,13775.0,1,S
2018-04-19 21:50:13,13775.0,2,6174,0,13775.0,1,13780.0,27,B
2018-04-19 21:50:15,13780.0,2,6176,0,13775.0,7,13785.0,32,B
2018-04-19 21:50:18,13785.0,6,6182,-2,13780.0,8,13790.0,23,B
2018-04-19 21:50:19,13785.0,2,6184,-2,13785.0,3,13790.0,28,B
2018-04-19 21:50:20,13785.0,4,6188,-4,13785.0,1,13790.0,28,B
2018-04-19 21:50:22,13785.0,2,6190,0,13780.0,8,13790.0,13,B
2018-04-19 21:50:23,13785.0,2,6192,0,13780.0,8,13790.0,16,B
2018-04-19 21:50:25,13780.0,2,6194,-2,13780.0,7,13785.0,1,S
2018-04-19 21:50:32,13780.0,2,6196,2,13780.0,1,13785.0,4,S
2018-04-19 21:50:36,13780.0,8,6204,0,13775.0,7,13785.0,10,S
2018-04-19 21:50:45,13780.0,2,6206,0,13775.0,3,13780.0,3,S
2018-04-19 21:50:46,13780.0,2,6208,2,13775.0,3,13780.0,2,S
2018-04-19 21:50:48,13780.0,2,6210,2,13775.0,3,13780.0,1,S
2018-04-19 21:50:57,13775.0,4,6214,-2,13775.0,2,13780.0,2,S
2018-04-19 21:51:19,13780.0,2,6216,2,13775.0,4,13780.0,2,B
2018-04-19 21:51:19,13775.0,2,6218,-2,13775.0,3,13780.0,2,S
2018-04-19 21:51:24,13780.0,4,6222,2,13775.0,4,13780.0,1,B
2018-04-19 21:51:26,13780.0,2,6224,0,13780.0,1,13785.0,15,B
2018-04-19 21:51:27,13780.0,2,6226,0,13775.0,5,13785.0,15,B
2018-04-19 21:51:43,13780.0,8,6234,-6,13775.0,10,13785.0,7,B
2018-04-19 21:51:55,13770.0,2,6236,0,13770.0,17,13780.0,26,S
2018-04-19 21:51:57,13775.0,2,6238,0,13770.0,17,13780.0,26,B
2018-04-19 21:51:58,13770.0,2,6240,-2,13770.0,16,13780.0,26,S
2018-04-19 21:52:06,13770.0,2,6242,-2,13770.0,11,13775.0,4,S
2018-04-19 21:52:19,13775.0,6,6248,0,13775.0,5,13780.0,9,B
2018-04-19 21:52:33,13780.0,2,6250,-2,13775.0,4,13780.0,7,B
2018-04-19 21:52:37,13775.0,2,6252,-2,13775.0,3,13780.0,7,S
2018-04-19 21:52:51,13780.0,4,6256,4,13775.0,4,13780.0,3,B
2018-04-19 21:52:51,13780.0,4,6260,4,13775.0,5,13780.0,1,B
2018-04-19 21:52:52,13780.0,2,6262,-2,13775.0,8,13785.0,25,B
2018-04-19 21:53:13,13785.0,2,6264,0,13780.0,4,13785.0,8,B
2018-04-19 21:53:14,13785.0,8,6272,-6,13785.0,2,13790.0,7,B
2018-04-19 21:53:24,13790.0,2,6274,-2,13785.0,4,13790.0,2,B
2018-04-19 21:53:30,13790.0,2,6276,-2,13785.0,4,13790.0,1,B
2018-04-19 21:53:31,13790.0,2,6278,0,13785.0,4,13795.0,20,B
2018-04-19 21:53:36,13790.0,8,6286,0,13785.0,7,13790.0,3,B
2018-04-19 21:53:37,13790.0,6,6292,-6,13785.0,7,13795.0,10,B
2018-04-19 21:53:45,13790.0,4,6296,0,13790.0,38,13795.0,8,B
2018-04-19 21:53:48,13795.0,4,6300,0,13790.0,38,13795.0,6,B
2018-04-19 21:53:48,13795.0,16,6316,2,13790.0,38,13795.0,2,B
2018-04-19 21:53:49,13795.0,4,6320,-4,13790.0,38,13795.0,2,B
2018-04-19 21:53:49,13795.0,4,6324,-4,13790.0,38,13795.0,2,B
2018-04-19 21:53:50,13795.0,4,6328,-4,13790.0,38,13795.0,2,B
2018-04-19 21:53:50,13795.0,4,6332,-4,13795.0,4,13800.0,40,B
2018-04-19 21:53:51,13800.0,4,6336,2,13795.0,15,13800.0,18,B
2018-04-19 21:53:53,13800.0,8,6344,2,13795.0,12,13800.0,14,B
2018-04-19 21:54:04,13800.0,10,6354,6,13795.0,10,13800.0,14,B
2018-04-19 21:54:05,13795.0,10,6364,0,13790.0,15,13795.0,10,S
2018-04-19 21:54:05,13790.0,6,6370,6,13790.0,5,13795.0,8,S
2018-04-19 21:54:06,13790.0,10,6380,-2,13785.0,8,13790.0,10,S
2018-04-19 21:54:13,13785.0,4,6384,0,13780.0,6,13790.0,12,S
2018-04-19 21:54:13,13790.0,4,6388,0,13780.0,10,13790.0,11,B
2018-04-19 21:54:27,13785.0,6,6394,6,13780.0,4,13785.0,2,S
2018-04-19 21:54:36,13780.0,4,6398,-2,13780.0,9,13785.0,7,S
2018-04-19 21:55:15,13785.0,18,6416,10,13780.0,6,13790.0,14,B
2018-04-19 21:55:21,13790.0,2,6418,0,13785.0,2,13790.0,6,B
2018-04-19 21:55:30,13785.0,4,6422,-2,13780.0,7,13790.0,6,S
2018-04-19 21:55:37,13780.0,2,6424,-2,13780.0,10,13790.0,8,S
2018-04-19 21:55:47,13780.0,2,6426,0,13780.0,9,13790.0,8,S
2018-04-19 21:56:19,13785.0,6,6432,6,13780.0,6,13790.0,10,B
2018-04-19 21:56:21,13775.0,4,6436,0,13775.0,13,13785.0,6,S
2018-04-19 21:56:42,13775.0,4,6440,-4,13775.0,4,13780.0,5,S
2018-04-19 21:56:43,13775.0,8,6448,0,13770.0,13,13780.0,8,S
2018-04-19 21:56:57,13780.0,2,6450,2,13770.0,18,13780.0,7,B
2018-04-19 21:57:25,13775.0,2,6452,2,13770.0,19,13775.0,14,S
2018-04-19 21:57:38,13770.0,14,6466,0,13770.0,13,13775.0,14,S
2018-04-19 21:57:39,13770.0,2,6468,-2,13770.0,9,13775.0,14,S
2018-04-19 21:57:42,13775.0,2,6470,2,13770.0,7,13775.0,13,B
2018-04-19 21:57:49,13775.0,2,6472,2,13770.0,7,13775.0,12,B
2018-04-19 21:57:51,13770.0,12,6484,4,13765.0,7,13770.0,8,S
2018-04-19 21:57:53,13770.0,10,6494,6,13760.0,9,13770.0,6,S
2018-04-19 21:58:03,13775.0,14,6508,4,13770.0,2,13775.0,14,B
2018-04-19 21:58:05,13770.0,4,6512,4,13770.0,8,13775.0,16,S
2018-04-19 21:58:08,13770.0,2,6514,2,13770.0,7,13775.0,16,S
2018-04-19 21:58:08,13770.0,14,6528,10,13765.0,7,13770.0,3,S
2018-04-19 21:58:16,13765.0,4,6532,0,13760.0,10,13765.0,19,S
2018-04-19 21:58:17,13760.0,10,6542,-10,13755.0,6,13765.0,13,S
2018-04-19 21:58:20,13755.0,2,6544,-2,13755.0,7,13765.0,13,S
2018-04-19 21:58:32,13755.0,2,6546,-2,13755.0,3,13760.0,8,S
2018-04-19 21:58:37,13755.0,2,6548,2,13755.0,2,13760.0,8,S
2018-04-19 21:58:38,13760.0,2,6550,-2,13755.0,11,13760.0,1,B
2018-04-19 21:58:38,13760.0,2,6552,2,13760.0,1,13765.0,11,B
2018-04-19 21:58:49,13760.0,2,6554,-2,13760.0,10,13770.0,11,B
2018-04-19 21:58:53,13760.0,2,6556,0,13760.0,9,13770.0,11,B
2018-04-19 21:59:54,13765.0,2,6558,0,13760.0,10,13770.0,17,B
2018-04-19 22:00:05,13760.0,2,6560,0,13760.0,3,13765.0,9,S
2018-04-19 22:00:11,13765.0,4,6564,-4,13760.0,21,13770.0,12,B
2018-04-19 22:00:24,13770.0,2,6566,0,13765.0,11,13775.0,11,B
2018-04-19 22:00:39,13770.0,2,6568,-2,13765.0,9,13775.0,15,B
2018-04-19 22:00:52,13765.0,6,6574,-6,13760.0,15,13770.0,10,S
2018-04-19 22:01:02,13770.0,2,6576,0,13760.0,15,13770.0,13,B
2018-04-19 22:01:09,13765.0,2,6578,0,13760.0,15,13770.0,12,S
2018-04-19 22:01:33,13760.0,2,6580,0,13760.0,6,13765.0,6,S
2018-04-19 22:01:36,13760.0,12,6592,4,13755.0,6,13760.0,7,S
2018-04-19 22:01:36,13755.0,12,6604,2,13750.0,15,13755.0,8,S
2018-04-19 22:01:37,13750.0,4,6608,4,13750.0,9,13755.0,9,S
2018-04-19 22:01:37,13750.0,20,6628,4,13745.0,5,13755.0,16,S
2018-04-19 22:01:38,13750.0,2,6630,0,13740.0,19,13745.0,1,S
2018-04-19 22:01:39,13745.0,8,6638,-6,13745.0,5,13750.0,30,S
2018-04-19 22:01:42,13750.0,2,6640,0,13750.0,8,13755.0,12,B
2018-04-19 22:01:54,13745.0,2,6642,-2,13740.0,26,13745.0,1,S
2018-04-19 22:01:56,13745.0,2,6644,0,13740.0,19,13745.0,3,S
2018-04-19 22:01:56,13740.0,2,6646,0,13740.0,19,13745.0,3,S
2018-04-19 22:01:58,13740.0,38,6684,6,13735.0,10,13740.0,6,S
2018-04-19 22:01:59,13740.0,12,6696,0,13735.0,11,13745.0,32,S
2018-04-19 22:02:00,13740.0,4,6700,-4,13735.0,15,13745.0,6,S
2018-04-19 22:02:02,13740.0,4,6704,2,13740.0,4,13745.0,2,S
2018-04-19 22:02:08,13745.0,6,6710,-2,13740.0,6,13745.0,2,B
2018-04-19 22:02:11,13745.0,4,6714,2,13740.0,2,13745.0,3,B
2018-04-19 22:02:13,13745.0,2,6716,2,13740.0,4,13745.0,1,B
2018-04-19 22:02:13,13745.0,2,6718,0,13740.0,4,13750.0,29,B
2018-04-19 22:02:27,13745.0,2,6720,0,13740.0,9,13745.0,2,B
2018-04-19 22:02:28,13740.0,4,6724,-2,13740.0,7,13745.0,2,S
2018-04-19 22:02:42,13740.0,4,6728,-2,13735.0,13,13745.0,12,S
2018-04-19 22:02:43,13745.0,2,6730,-2,13735.0,11,13740.0,1,B
2018-04-19 22:02:44,13735.0,4,6734,-4,13735.0,9,13740.0,1,S
2018-04-19 22:02:48,13735.0,6,6740,0,13735.0,11,13745.0,11,S
2018-04-19 22:02:48,13735.0,4,6744,-4,13735.0,9,13745.0,9,S
2018-04-19 22:02:50,13740.0,2,6746,-2,13740.0,1,13745.0,3,B
2018-04-19 22:02:53,13740.0,4,6750,0,13735.0,9,13745.0,33,B
2018-04-19 22:02:55,13740.0,2,6752,0,13735.0,5,13740.0,2,B
2018-04-19 22:02:58,13740.0,2,6754,0,13735.0,6,13740.0,1,B
2018-04-19 22:03:04,13740.0,2,6756,0,13740.0,2,13745.0,8,B
2018-04-19 22:03:07,13745.0,4,6760,0,13740.0,3,13745.0,3,B
2018-04-19 22:03:13,13740.0,2,6762,-2,13740.0,2,13745.0,4,S
2018-04-19 22:03:22,13750.0,2,6764,0,13745.0,4,13750.0,2,B
2018-04-19 22:03:24,13745.0,2,6766,2,13740.0,11,13750.0,6,S
2018-04-19 22:03:25,13745.0,2,6768,2,13740.0,3,13745.0,1,S
2018-04-19 22:03:27,13740.0,2,6770,-2,13740.0,2,13745.0,1,S
2018-04-19 22:03:28,13740.0,2,6772,-2,13740.0,6,13750.0,28,S
2018-04-19 22:03:29,13745.0,2,6774,0,13740.0,9,13750.0,37,B
2018-04-19 22:03:33,13745.0,2,6776,2,13740.0,9,13745.0,2,B
2018-04-19 22:03:34,13745.0,10,6786,-4,13740.0,9,13750.0,23,B
2018-04-19 22:03:37,13740.0,2,6788,-2,13740.0,8,13745.0,1,S
2018-04-19 22:03:39,13745.0,2,6790,0,13740.0,7,13745.0,2,B
2018-04-19 22:03:42,13745.0,4,6794,-2,13745.0,1,13750.0,20,B
2018-04-19 22:03:42,13740.0,8,6802,-2,13740.0,4,13750.0,25,S
2018-04-19 22:03:44,13740.0,4,6806,-2,13735.0,9,13745.0,4,S
2018-04-19 22:03:46,13745.0,2,6808,2,13735.0,11,13745.0,11,B
2018-04-19 22:03:50,13740.0,2,6810,0,13735.0,9,13745.0,25,S
2018-04-19 22:03:51,13735.0,2,6812,-2,13735.0,8,13745.0,25,S
2018-04-19 22:04:02,13745.0,4,6816,-2,13740.0,12,13750.0,11,B
2018-04-19 22:04:24,13740.0,4,6820,0,13735.0,5,13740.0,1,S
2018-04-19 22:04:43,13735.0,2,6822,-2,13735.0,3,13740.0,1,S
2018-04-19 22:04:48,13735.0,6,6828,6,13730.0,14,13735.0,1,S
2018-04-19 22:04:48,13730.0,8,6836,-6,13730.0,5,13735.0,9,S
2018-04-19 22:04:49,13735.0,2,6838,-2,13730.0,5,13735.0,8,B
2018-04-19 22:04:50,13735.0,2,6840,0,13730.0,5,13735.0,8,B
2018-04-19 22:04:51,13730.0,6,6846,-2,13730.0,2,13735.0,9,S
2018-04-19 22:04:51,13730.0,4,6850,-2,13725.0,4,13730.0,5,S
2018-04-19 22:04:54,13730.0,6,6856,-2,13725.0,2,13730.0,1,S
2018-04-19 22:04:56,13725.0,6,6862,-6,13720.0,5,13725.0,2,S
2018-04-19 22:04:57,13725.0,4,6866,-4,13725.0,2,13730.0,5,S
2018-04-19 22:04:59,13725.0,2,6868,-2,13725.0,1,13730.0,2,S
2018-04-19 22:05:05,13730.0,2,6870,0,13725.0,11,13730.0,2,B
2018-04-19 22:05:05,13730.0,4,6874,0,13730.0,1,13735.0,9,B
2018-04-19 22:05:09,13730.0,2,6876,0,13730.0,6,13735.0,1,B
2018-04-19 22:05:20,13730.0,4,6880,-4,13725.0,8,13735.0,4,B
2018-04-19 22:05:22,13725.0,2,6882,0,13725.0,10,13735.0,6,S
2018-04-19 22:05:38,13740.0,14,6896,10,13735.0,13,13745.0,3,B
2018-04-19 22:05:48,13745.0,2,6898,0,13740.0,1,13745.0,2,B
2018-04-19 22:05:57,13745.0,2,6900,-2,13740.0,3,13745.0,2,B
2018-04-19 22:06:05,13740.0,2,6902,2,13735.0,17,13745.0,2,S
2018-04-19 22:06:36,13735.0,4,6906,-4,13735.0,1,13740.0,4,S
2018-04-19 22:06:37,13735.0,4,6910,-4,13730.0,14,13740.0,4,S
2018-04-19 22:06:41,13730.0,8,6918,0,13725.0,12,13735.0,6,S
2018-04-19 22:06:47,13730.0,2,6920,2,13730.0,1,13735.0,5,S
2018-04-19 22:06:51,13730.0,2,6922,0,13725.0,15,13735.0,6,S
2018-04-19 22:07:17,13730.0,2,6924,0,13725.0,15,13735.0,5,S
2018-04-19 22:07:22,13730.0,2,6926,0,13730.0,1,13735.0,3,S
2018-04-19 22:07:55,13735.0,6,6932,0,13730.0,3,13735.0,2,B
2018-04-19 22:08:05,13730.0,2,6934,-2,13730.0,2,13735.0,3,S
2018-04-19 22:08:06,13730.0,4,6938,-4,13725.0,13,13735.0,3,S
2018-04-19 22:08:07,13735.0,2,6940,0,13725.0,13,13735.0,2,B
2018-04-19 22:08:14,13735.0,2,6942,2,13735.0,1,13740.0,21,B
2018-04-19 22:08:30,13740.0,2,6944,2,13730.0,9,13740.0,10,B
2018-04-19 22:08:32,13740.0,6,6950,-4,13730.0,9,13740.0,2,B
2018-04-19 22:08:50,13740.0,2,6952,0,13735.0,1,13745.0,32,B
2018-04-19 22:08:53,13745.0,2,6954,2,13740.0,3,13745.0,4,B
2018-04-19 22:08:56,13745.0,2,6956,0,13740.0,3,13745.0,3,B
2018-04-19 22:09:29,13745.0,2,6958,0,13735.0,10,13745.0,5,B
2018-04-19 22:09:48,13740.0,4,6962,0,13735.0,10,13740.0,1,S
2018-04-19 22:09:48,13740.0,2,6964,0,13735.0,10,13745.0,5,S
2018-04-19 22:10:19,13745.0,20,6984,4,13740.0,5,13750.0,30,B
2018-04-19 22:10:28,13745.0,2,6986,0,13740.0,7,13745.0,4,B
2018-04-19 22:10:36,13745.0,2,6988,-2,13740.0,7,13745.0,3,B
2018-04-19 22:10:37,13745.0,6,6994,-6,13740.0,5,13750.0,31,B
2018-04-19 22:10:38,13750.0,10,7004,4,13745.0,7,13755.0,5,B
2018-04-19 22:10:39,13750.0,4,7008,0,13745.0,11,13755.0,13,B
2018-04-19 22:10:42,13755.0,4,7012,2,13750.0,4,13755.0,1,B
2018-04-19 22:10:42,13755.0,2,7014,0,13755.0,1,13760.0,1,B
2018-04-19 22:10:44,13760.0,6,7020,-6,13755.0,7,13760.0,2,B
2018-04-19 22:10:45,13765.0,6,7026,-4,13755.0,7,13760.0,1,B
2018-04-19 22:10:45,13760.0,2,7028,0,13755.0,7,13765.0,3,S
2018-04-19 22:10:50,13755.0,2,7030,2,13755.0,6,13765.0,7,S
2018-04-19 22:11:00,13760.0,2,7032,-2,13750.0,7,13760.0,8,B
2018-04-19 22:11:05,13750.0,8,7040,0,13745.0,5,13755.0,9,S
2018-04-19 22:11:05,13755.0,2,7042,0,13745.0,3,13755.0,16,B
2018-04-19 22:11:40,13760.0,2,7044,2,13750.0,9,13760.0,23,B
2018-04-19 22:11:49,13765.0,2,7046,0,13755.0,7,13765.0,34,B
2018-04-19 22:11:52,13765.0,2,7048,-2,13755.0,7,13765.0,30,B
2018-04-19 22:11:54,13755.0,2,7050,-2,13755.0,6,13760.0,1,S
2018-04-19 22:12:05,13760.0,2,7052,2,13755.0,7,13760.0,2,B
2018-04-19 22:12:07,13760.0,2,7054,0,13755.0,7,13760.0,2,B
2018-04-19 22:12:45,13755.0,4,7058,0,13755.0,7,13760.0,2,S
2018-04-19 22:12:54,13755.0,8,7066,2,13755.0,7,13760.0,2,S
2018-04-19 22:13:10,13760.0,4,7070,-4,13755.0,7,13760.0,2,B
2018-04-19 22:13:21,13760.0,2,7072,2,13755.0,7,13760.0,2,B
2018-04-19 22:13:25,13765.0,14,7086,12,13755.0,7,13760.0,2,B
2018-04-19 22:13:28,13765.0,2,7088,2,13760.0,3,13770.0,35,B
2018-04-19 22:13:40,13765.0,2,7090,2,13760.0,4,13765.0,1,B
2018-04-19 22:13:49,13770.0,4,7094,4,13760.0,3,13770.0,23,B
2018-04-19 22:13:49,13770.0,2,7096,0,13760.0,3,13770.0,22,B
2018-04-19 22:13:50,13770.0,6,7102,-6,13760.0,3,13770.0,9,B
2018-04-19 22:13:58,13765.0,4,7106,0,13765.0,2,13770.0,10,S
2018-04-19 22:14:05,13765.0,2,7108,2,13760.0,7,13770.0,5,S
2018-04-19 22:14:28,13765.0,6,7114,-2,13760.0,3,13770.0,9,S
2018-04-19 22:14:41,13765.0,2,7116,0,13760.0,3,13765.0,2,S
2018-04-19 22:15:17,13760.0,6,7122,4,13755.0,5,13765.0,10,S
2018-04-19 22:15:21,13760.0,2,7124,2,13755.0,4,13760.0,2,S
2018-04-19 22:15:29,13755.0,2,7126,-2,13755.0,4,13760.0,2,S
2018-04-19 22:15:34,13760.0,4,7130,0,13755.0,4,13760.0,2,B
2018-04-19 22:15:34,13760.0,2,7132,0,13755.0,4,13760.0,2,B
2018-04-19 22:15:35,13760.0,20,7152,-6,13755.0,4,13760.0,2,B
2018-04-19 22:15:36,13760.0,4,7156,4,13755.0,4,13760.0,2,B
2018-04-19 22:15:36,13760.0,2,7158,0,13755.0,4,13760.0,2,B
2018-04-19 22:15:54,13755.0,8,7166,0,13755.0,4,13760.0,2,S
2018-04-19 22:15:55,13755.0,2,7168,0,13755.0,4,13760.0,2,S
2018-04-19 22:16:00,13755.0,2,7170,-2,13755.0,4,13760.0,2,S
2018-04-19 22:16:01,13755.0,6,7176,2,13755.0,4,13760.0,2,S
2018-04-19 22:16:01,13755.0,4,7180,0,13755.0,4,13760.0,2,S
2018-04-19 22:16:14,13760.0,2,7182,2,13755.0,4,13760.0,2,B
2018-04-19 22:16:21,13760.0,4,7186,-4,13755.0,4,13760.0,2,B
2018-04-19 22:16:31,13760.0,6,7192,4,13755.0,10,13765.0,4,B
2018-04-19 22:17:01,13760.0,2,7194,2,13760.0,2,13765.0,4,B
2018-04-19 22:17:09,13765.0,4,7198,-4,13760.0,4,13770.0,26,B
2018-04-19 22:17:27,13770.0,2,7200,0,13765.0,4,13770.0,9,B
2018-04-19 22:17:32,13765.0,6,7206,6,13765.0,1,13770.0,8,S
2018-04-19 22:17:34,13770.0,8,7214,-4,13765.0,2,13770.0,2,B
2018-04-19 22:17:34,13770.0,4,7218,0,13765.0,2,13775.0,23,B
2018-04-19 22:17:35,13775.0,6,7224,6,13770.0,4,13775.0,5,B
2018-04-19 22:17:36,13775.0,2,7226,2,13770.0,3,13775.0,6,B
2018-04-19 22:17:39,13770.0,2,7228,0,13770.0,3,13775.0,6,S
2018-04-19 22:17:45,13775.0,10,7238,4,13775.0,2,13780.0,22,B
2018-04-19 22:17:52,13780.0,2,7240,2,13775.0,3,13780.0,5,B
2018-04-19 22:17:54,13780.0,2,7242,2,13775.0,3,13780.0,4,B
2018-04-19 22:17:58,13780.0,2,7244,0,13775.0,3,13780.0,3,B
2018-04-19 22:17:59,13780.0,2,7246,2,13775.0,3,13780.0,2,B
2018-04-19 22:18:07,13780.0,2,7248,0,13775.0,3,13780.0,1,B
2018-04-19 22:18:15,13780.0,6,7254,-2,13780.0,2,13785.0,14,B
2018-04-19 22:18:16,13780.0,4,7258,-4,13775.0,3,13780.0,1,B
2018-04-19 22:18:22,13775.0,4,7262,-4,13770.0,4,13775.0,2,S
2018-04-19 22:18:23,13775.0,2,7264,0,13770.0,8,13775.0,1,S
2018-04-19 22:18:23,13775.0,2,7266,-2,13770.0,8,13780.0,11,S
2018-04-19 22:18:26,13775.0,2,7268,-2,13770.0,9,13780.0,13,S
2018-04-19 22:18:32,13775.0,4,7272,0,13770.0,7,13775.0,12,S
2018-04-19 22:18:37,13770.0,6,7278,4,13770.0,4,13775.0,6,S
2018-04-19 22:18:38,13770.0,8,7286,0,13765.0,2,13770.0,7,S
2018-04-19 22:19:12,13770.0,2,7288,2,13760.0,9,13770.0,10,S
2018-04-19 22:19:53,13760.0,6,7294,0,13755.0,6,13765.0,6,S
2018-04-19 22:20:09,13765.0,12,7306,4,13760.0,8,13770.0,11,B
2018-04-19 22:20:14,13770.0,2,7308,0,13765.0,4,13770.0,4,B
2018-04-19 22:20:40,13770.0,2,7310,2,13765.0,3,13770.0,4,B
2018-04-19 22:20:52,13765.0,2,7312,0,13765.0,2,13770.0,4,S
2018-04-19 22:20:57,13770.0,8,7320,2,13770.0,1,13775.0,23,B
2018-04-19 22:20:57,13770.0,2,7322,2,13765.0,3,13775.0,24,B
2018-04-19 22:21:09,13765.0,2,7324,0,13765.0,3,13775.0,34,S
2018-04-19 22:21:29,13765.0,4,7328,0,13760.0,4,13765.0,1,S
2018-04-19 22:21:51,13760.0,2,7330,0,13760.0,3,13765.0,4,S
2018-04-19 22:22:14,13760.0,2,7332,-2,13760.0,2,13765.0,3,S
2018-04-19 22:22:21,13760.0,2,7334,0,13755.0,8,13765.0,3,S
2018-04-19 22:22:58,13765.0,6,7340,-6,13765.0,3,13770.0,17,B
2018-04-19 22:22:58,13765.0,6,7346,0,13760.0,1,13765.0,2,B
2018-04-19 22:23:13,13765.0,2,7348,-2,13760.0,4,13765.0,1,B
2018-04-19 22:23:15,13765.0,2,7350,2,13760.0,4,13770.0,26,B
2018-04-19 22:23:44,13765.0,2,7352,0,13765.0,14,13770.0,2,B
2018-04-19 22:24:04,13770.0,4,7356,0,13770.0,2,13775.0,8,B
2018-04-19 22:24:11,13770.0,2,7358,2,13765.0,4,13775.0,32,B
2018-04-19 22:24:17,13765.0,2,7360,0,13765.0,3,13770.0,2,S
2018-04-19 22:24:26,13770.0,2,7362,2,13765.0,3,13770.0,1,B
2018-04-19 22:24:41,13770.0,2,7364,2,13765.0,5,13775.0,32,B
2018-04-19 22:24:48,13770.0,2,7366,0,13765.0,3,13775.0,33,B
2018-04-19 22:24:54,13765.0,4,7370,4,13760.0,8,13765.0,1,S
2018-04-19 22:25:10,13770.0,2,7372,2,13765.0,1,13770.0,2,B
2018-04-19 22:25:15,13765.0,4,7376,0,13760.0,12,13770.0,3,S
2018-04-19 22:25:20,13770.0,2,7378,2,13765.0,1,13770.0,2,B
2018-04-19 22:25:20,13770.0,2,7380,0,13765.0,1,13770.0,2,B
2018-04-19 22:25:22,13765.0,2,7382,2,13765.0,1,13770.0,2,S
2018-04-19 22:25:51,13770.0,2,7384,0,13765.0,2,13770.0,1,B
2018-04-19 22:25:55,13770.0,2,7386,0,13765.0,2,13775.0,39,B
2018-04-19 22:25:59,13775.0,2,7388,2,13770.0,6,13775.0,8,B
2018-04-19 22:26:07,13770.0,2,7390,2,13770.0,5,13775.0,8,S
2018-04-19 22:26:09,13770.0,2,7392,0,13770.0,4,13775.0,8,S
2018-04-19 22:26:15,13770.0,2,7394,0,13770.0,3,13775.0,9,S
2018-04-19 22:26:21,13775.0,2,7396,2,13770.0,3,13775.0,8,B
2018-04-19 22:26:34,13775.0,2,7398,2,13770.0,3,13775.0,6,B
2018-04-19 22:26:43,13770.0,4,7402,-2,13770.0,1,13775.0,6,S
2018-04-19 22:26:48,13775.0,2,7404,0,13770.0,1,13775.0,5,B
2018-04-19 22:26:55,13775.0,2,7406,0,13770.0,3,13775.0,4,B
2018-04-19 22:27:14,13770.0,6,7412,-6,13770.0,2,13775.0,4,S
2018-04-19 22:27:21,13775.0,8,7420,0,13770.0,7,13780.0,9,B
2018-04-19 22:27:29,13780.0,4,7424,-2,13775.0,20,13785.0,6,B
2018-04-19 22:27:41,13785.0,2,7426,-2,13780.0,6,13785.0,3,B
2018-04-19 22:27:41,13785.0,6,7432,-2,13780.0,11,13790.0,9,B
2018-04-19 22:28:13,13785.0,4,7436,4,13775.0,12,13785.0,7,B
2018-04-19 22:28:34,13775.0,2,7438,0,13770.0,5,13775.0,1,S
2018-04-19 22:28:34,13775.0,2,7440,0,13770.0,9,13775.0,3,S
2018-04-19 22:28:44,13775.0,2,7442,2,13770.0,7,13775.0,2,S
2018-04-19 22:28:58,13770.0,2,7444,0,13770.0,4,13775.0,4,S
2018-04-19 22:29:10,13775.0,2,7446,2,13770.0,4,13775.0,3,B
2018-04-19 22:29:24,13775.0,2,7448,0,13770.0,4,13775.0,1,B
2018-04-19 22:29:27,13775.0,2,7450,0,13770.0,4,13780.0,7,B
2018-04-19 22:29:48,13770.0,2,7452,2,13770.0,1,13775.0,1,S
2018-04-19 22:29:48,13770.0,2,7454,0,13765.0,36,13770.0,1,S
2018-04-19 22:29:49,13770.0,2,7456,0,13770.0,2,13775.0,2,S
2018-04-19 22:29:54,13775.0,2,7458,2,13770.0,1,13775.0,1,B
2018-04-19 22:30:13,13780.0,4,7462,4,13770.0,7,13780.0,6,B
2018-04-19 22:30:22,13780.0,2,7464,2,13775.0,6,13780.0,2,B
2018-04-19 22:30:29,13780.0,2,7466,0,13775.0,3,13780.0,1,B
2018-04-19 22:30:40,13780.0,2,7468,2,13775.0,3,13780.0,1,B
2018-04-19 22:30:47,13780.0,2,7470,0,13780.0,1,13785.0,6,B
2018-04-19 22:30:48,13785.0,4,7474,-2,13780.0,9,13785.0,3,B
2018-04-19 22:30:48,13785.0,6,7480,6,13785.0,1,13790.0,12,B
2018-04-19 22:30:49,13785.0,2,7482,0,13785.0,2,13790.0,9,B
2018-04-19 22:30:49,13785.0,4,7486,0,13780.0,9,13790.0,9,B
2018-04-19 22:31:10,13785.0,2,7488,2,13780.0,1,13785.0,4,B
2018-04-19 22:31:20,13780.0,2,7490,0,13775.0,5,13785.0,3,S
2018-04-19 22:31:28,13780.0,2,7492,2,13770.0,13,13780.0,6,S
2018-04-19 22:31:35,13775.0,16,7508,-4,13770.0,9,13780.0,6,S
2018-04-19 22:32:05,13780.0,2,7510,0,13775.0,10,13780.0,5,B
2018-04-19 22:32:14,13780.0,2,7512,0,13775.0,10,13780.0,4,B
2018-04-19 22:32:17,13775.0,20,7532,20,13770.0,6,13775.0,30,S
2018-04-19 22:32:18,13775.0,12,7544,8,13770.0,5,13775.0,24,S
2018-04-19 22:32:19,13775.0,42,7586,36,13770.0,29,13775.0,3,S
2018-04-19 22:32:19,13775.0,6,7592,0,13775.0,5,13780.0,1,S
2018-04-19 22:32:27,13780.0,2,7594,0,13775.0,5,13785.0,10,B
2018-04-19 22:32:37,13780.0,2,7596,-2,13775.0,2,13785.0,12,B
2018-04-19 22:32:48,13780.0,6,7602,6,13780.0,7,13785.0,9,B
2018-04-19 22:33:45,13775.0,6,7608,0,13770.0,3,13780.0,8,S
2018-04-19 22:34:11,13770.0,2,7610,2,13770.0,5,13775.0,16,S
2018-04-19 22:34:11,13770.0,2,7612,0,13770.0,4,13775.0,16,S
2018-04-19 22:34:12,13770.0,2,7614,0,13770.0,3,13775.0,16,S
2018-04-19 22:34:12,13770.0,2,7616,0,13770.0,2,13775.0,16,S
2018-04-19 22:34:23,13770.0,2,7618,0,13765.0,27,13775.0,10,S
2018-04-19 22:34:35,13770.0,4,7622,4,13770.0,9,13775.0,12,S
2018-04-19 22:34:42,13770.0,10,7632,10,13770.0,4,13775.0,12,S
2018-04-19 22:34:54,13770.0,2,7634,2,13770.0,3,13775.0,8,S
2018-04-19 22:34:55,13770.0,6,7640,-2,13765.0,16,13775.0,8,S
2018-04-19 22:35:07,13765.0,8,7648,6,13765.0,13,13775.0,7,S
2018-04-19 22:35:17,13775.0,4,7652,2,13770.0,5,13780.0,17,B
2018-04-19 22:35:33,13775.0,2,7654,0,13765.0,17,13775.0,6,B
2018-04-19 22:35:39,13775.0,2,7656,0,13770.0,6,13775.0,6,B
2018-04-19 22:35:40,13770.0,4,7660,4,13770.0,4,13775.0,6,S
2018-04-19 22:35:52,13775.0,2,7662,2,13770.0,4,13775.0,6,B
2018-04-19 22:35:56,13775.0,2,7664,0,13770.0,9,13780.0,15,B
2018-04-19 22:36:06,13775.0,2,7666,0,13770.0,4,13775.0,2,B
2018-04-19 22:36:12,13775.0,2,7668,2,13770.0,4,13775.0,2,B
2018-04-19 22:36:18,13775.0,2,7670,2,13770.0,4,13775.0,2,B
2018-04-19 22:36:46,13770.0,4,7674,0,13770.0,2,13775.0,12,S
2018-04-19 22:36:46,13770.0,4,7678,4,13765.0,24,13775.0,15,S
2018-04-19 22:36:57,13770.0,2,7680,0,13765.0,12,13770.0,1,S
2018-04-19 22:37:02,13770.0,2,7682,0,13765.0,28,13775.0,15,S
2018-04-19 22:37:30,13775.0,10,7692,-4,13770.0,7,13775.0,6,B
2018-04-19 22:37:31,13775.0,4,7696,-4,13770.0,7,13775.0,4,B
2018-04-19 22:37:43,13770.0,4,7700,-4,13770.0,11,13780.0,16,S
2018-04-19 22:38:29,13775.0,2,7702,2,13775.0,3,13780.0,13,B
2018-04-19 22:38:31,13775.0,2,7704,2,13775.0,3,13780.0,13,B
2018-04-19 22:38:32,13775.0,2,7706,2,13775.0,2,13780.0,13,B
2018-04-19 22:39:28,13780.0,2,7708,0,13775.0,1,13780.0,12,B
2018-04-19 22:39:33,13775.0,2,7710,2,13770.0,7,13775.0,9,S
2018-04-19 22:39:34,13770.0,2,7712,-2,13770.0,3,13775.0,5,S
2018-04-19 22:39:34,13770.0,2,7714,2,13770.0,3,13775.0,5,S
2018-04-19 22:39:35,13775.0,2,7716,0,13770.0,3,13775.0,4,B
2018-04-19 22:39:41,13775.0,2,7718,2,13770.0,2,13775.0,6,B
2018-04-19 22:39:42,13770.0,4,7722,-2,13765.0,13,13770.0,4,S
2018-04-19 22:39:51,13770.0,10,7732,0,13765.0,11,13775.0,18,S
2018-04-19 22:40:09,13765.0,22,7754,8,13760.0,89,13770.0,5,S
2018-04-19 22:40:10,13765.0,2,7756,-2,13760.0,105,13765.0,1,S
2018-04-19 22:40:10,13765.0,2,7758,-2,13765.0,1,13770.0,7,S
2018-04-19 22:40:24,13765.0,2,7760,2,13760.0,89,13770.0,40,S
2018-04-19 22:40:30,13760.0,2,7762,0,13760.0,88,13765.0,1,S
2018-04-19 22:40:32,13760.0,2,7764,0,13760.0,84,13765.0,10,S
2018-04-19 22:40:40,13760.0,6,7770,-2,13760.0,83,13765.0,4,S
2018-04-19 22:41:01,13765.0,10,7780,-10,13765.0,1,13770.0,28,B
2018-04-19 22:41:02,13770.0,18,7798,0,13765.0,14,13775.0,19,B
2018-04-19 22:41:10,13775.0,6,7804,-6,13770.0,4,13780.0,40,B
2018-04-19 22:41:11,13775.0,4,7808,-4,13770.0,3,13775.0,6,B
2018-04-19 22:41:17,13770.0,2,7810,-2,13770.0,2,13775.0,5,S
2018-04-19 22:42:17,13780.0,18,7828,18,13775.0,7,13780.0,3,B
2018-04-19 22:42:21,13780.0,2,7830,2,13775.0,8,13780.0,2,B
2018-04-19 22:42:32,13780.0,6,7836,6,13775.0,12,13780.0,1,B
2018-04-19 22:42:33,13780.0,2,7838,-2,13780.0,1,13785.0,17,B
2018-04-19 22:42:37,13780.0,2,7840,-2,13775.0,8,13780.0,1,B
2018-04-19 22:42:37,13780.0,2,7842,2,13775.0,8,13785.0,42,B
2018-04-19 22:42:53,13780.0,2,7844,-2,13770.0,4,13775.0,2,B
2018-04-19 22:43:00,13780.0,2,7846,-2,13770.0,5,13775.0,1,B
2018-04-19 22:43:00,13780.0,2,7848,-2,13770.0,5,13780.0,21,B
2018-04-19 22:43:01,13780.0,2,7850,0,13770.0,5,13780.0,23,B
2018-04-19 22:43:01,13780.0,4,7854,-4,13770.0,5,13780.0,21,B
2018-04-19 22:43:02,13780.0,2,7856,-2,13770.0,6,13780.0,20,B
2018-04-19 22:43:02,13780.0,2,7858,0,13770.0,6,13780.0,20,B
2018-04-19 22:43:03,13780.0,4,7862,0,13770.0,6,13780.0,18,B
2018-04-19 22:43:10,13770.0,8,7870,2,13765.0,8,13775.0,30,S
2018-04-19 22:43:11,13775.0,2,7872,-2,13765.0,7,13775.0,29,B
2018-04-19 22:43:27,13775.0,2,7874,-2,13765.0,8,13775.0,28,B
2018-04-19 22:43:28,13775.0,4,7878,-4,13765.0,8,13775.0,26,B
2018-04-19 22:43:28,13775.0,4,7882,-4,13765.0,8,13775.0,24,B
2018-04-19 22:43:29,13775.0,4,7886,-4,13765.0,8,13775.0,22,B
2018-04-19 22:43:29,13775.0,4,7890,-2,13765.0,7,13775.0,20,B
2018-04-19 22:43:30,13775.0,2,7892,-2,13765.0,7,13775.0,19,B
2018-04-19 22:43:38,13770.0,2,7894,-2,13765.0,6,13775.0,25,S
2018-04-19 22:43:51,13775.0,2,7896,-2,13765.0,7,13775.0,26,B
2018-04-19 22:43:52,13775.0,4,7900,-4,13765.0,7,13775.0,24,B
2018-04-19 22:43:52,13775.0,4,7904,-2,13765.0,7,13775.0,22,B
2018-04-19 22:43:53,13775.0,4,7908,-4,13765.0,7,13775.0,9,B
2018-04-19 22:43:53,13775.0,4,7912,-4,13765.0,7,13775.0,7,B
2018-04-19 22:43:54,13775.0,2,7914,-2,13765.0,7,13775.0,6,B
2018-04-19 22:44:02,13775.0,4,7918,0,13765.0,7,13775.0,4,B
2018-04-19 22:44:07,13775.0,2,7920,-2,13765.0,11,13775.0,3,B
2018-04-19 22:44:08,13775.0,4,7924,-4,13765.0,11,13775.0,2,B
2018-04-19 22:44:08,13775.0,4,7928,-4,13765.0,11,13775.0,1,B
2018-04-19 22:44:09,13780.0,4,7932,-4,13765.0,11,13775.0,1,B
2018-04-19 22:44:09,13780.0,4,7936,-4,13765.0,11,13775.0,2,B
2018-04-19 22:44:10,13780.0,2,7938,-2,13770.0,1,13775.0,2,B
2018-04-19 22:44:12,13775.0,2,7940,-2,13770.0,11,13780.0,4,S
2018-04-19 22:44:22,13780.0,2,7942,0,13770.0,12,13780.0,5,B
2018-04-19 22:44:25,13780.0,2,7944,0,13770.0,12,13780.0,4,B
2018-04-19 22:44:26,13780.0,4,7948,-2,13770.0,12,13780.0,3,B
2018-04-19 22:44:26,13780.0,4,7952,-4,13770.0,12,13780.0,1,B
2018-04-19 22:44:27,13785.0,4,7956,-2,13770.0,12,13780.0,1,B
2018-04-19 22:44:27,13785.0,4,7960,-4,13770.0,12,13780.0,1,B
2018-04-19 22:44:28,13780.0,8,7968,-8,13770.0,12,13785.0,20,S
2018-04-19 22:44:37,13780.0,6,7974,-4,13780.0,1,13785.0,41,S
2018-04-19 22:44:42,13780.0,2,7976,-2,13780.0,5,13785.0,19,S
2018-04-19 22:44:43,13780.0,2,7978,-2,13780.0,1,13785.0,18,S
2018-04-19 22:44:51,13780.0,2,7980,0,13780.0,1,13785.0,18,S
2018-04-19 22:45:03,13775.0,2,7982,0,13770.0,8,13775.0,2,S
2018-04-19 22:45:04,13780.0,8,7990,-2,13770.0,7,13780.0,15,B
2018-04-19 22:45:21,13775.0,10,8000,-2,13775.0,6,13780.0,5,S
2018-04-19 22:45:23,13775.0,4,8004,-2,13770.0,11,13780.0,6,S
2018-04-19 22:45:57,13780.0,2,8006,-2,13770.0,15,13780.0,10,B
2018-04-19 22:46:19,13780.0,4,8010,0,13775.0,13,13780.0,8,B
2018-04-19 22:46:31,13780.0,4,8014,-4,13775.0,13,13780.0,6,B
2018-04-19 22:46:34,13775.0,2,8016,2,13775.0,12,13780.0,6,S
2018-04-19 22:48:04,13780.0,2,8018,2,13775.0,9,13780.0,8,B
2018-04-19 22:48:38,13780.0,12,8030,-8,13780.0,4,13785.0,32,B
2018-04-19 22:49:00,13785.0,4,8034,2,13780.0,13,13785.0,29,B
2018-04-19 22:49:02,13785.0,2,8036,0,13780.0,13,13785.0,23,B
2018-04-19 22:49:09,13785.0,30,8066,-10,13780.0,13,13785.0,8,B
2018-04-19 22:49:09,13785.0,16,8082,0,13780.0,13,13790.0,12,B
2018-04-19 22:49:17,13790.0,12,8094,-6,13780.0,12,13790.0,7,B
2018-04-19 22:49:17,13790.0,2,8096,-2,13780.0,11,13790.0,6,B
2018-04-19 22:49:24,13785.0,2,8098,0,13780.0,5,13790.0,21,S
2018-04-19 22:49:25,13785.0,4,8102,-4,13785.0,2,13790.0,28,S
2018-04-19 22:49:25,13785.0,4,8106,0,13780.0,2,13785.0,3,S
2018-04-19 22:49:28,13785.0,8,8114,-8,13785.0,18,13790.0,21,S
2018-04-19 22:49:28,13785.0,8,8122,-4,13785.0,14,13790.0,28,S
2018-04-19 22:49:29,13785.0,20,8142,0,13785.0,4,13790.0,28,S
2018-04-19 22:49:29,13785.0,8,8150,-6,13780.0,2,13785.0,1,S
2018-04-19 22:49:52,13780.0,2,8152,0,13780.0,8,13785.0,2,S
2018-04-19 22:50:01,13780.0,4,8156,-2,13780.0,4,13785.0,6,S
2018-04-19 22:50:02,13780.0,8,8164,-6,13775.0,27,13780.0,2,S
2018-04-19 22:50:13,13785.0,4,8168,-4,13775.0,26,13785.0,24,B
2018-04-19 22:50:50,13780.0,4,8172,2,13780.0,4,13785.0,6,S
2018-04-19 22:50:53,13780.0,2,8174,2,13780.0,3,13785.0,6,S
2018-04-19 22:50:56,13780.0,2,8176,2,13780.0,2,13785.0,6,S
2018-04-19 22:51:03,13780.0,2,8178,2,13780.0,1,13785.0,10,S
2018-04-19 22:51:04,13780.0,2,8180,2,13775.0,28,13780.0,1,S
2018-04-19 22:51:18,13780.0,4,8184,0,13775.0,27,13780.0,2,S
2018-04-19 22:51:27,13780.0,2,8186,-2,13775.0,27,13780.0,1,S
2018-04-19 22:51:27,13780.0,2,8188,0,13780.0,2,13785.0,13,S
2018-04-19 22:51:33,13780.0,4,8192,0,13775.0,43,13780.0,1,S
2018-04-19 22:51:35,13775.0,2,8194,0,13775.0,42,13780.0,1,S
2018-04-19 22:51:48,13780.0,2,8196,0,13775.0,33,13785.0,9,B
2018-04-19 22:51:56,13785.0,18,8214,-8,13780.0,4,13790.0,23,B
2018-04-19 22:52:11,13790.0,2,8216,2,13785.0,4,13790.0,9,B
2018-04-19 22:52:27,13790.0,2,8218,2,13785.0,4,13790.0,6,B
2018-04-19 22:52:28,13790.0,2,8220,0,13785.0,4,13790.0,5,B
2018-04-19 22:53:09,13790.0,2,8222,0,13785.0,3,13790.0,5,B
2018-04-19 22:53:12,13790.0,2,8224,0,13785.0,4,13790.0,4,B
2018-04-19 22:53:17,13790.0,2,8226,2,13785.0,4,13790.0,4,B
2018-04-19 22:53:18,13785.0,6,8232,0,13780.0,7,13790.0,27,S
2018-04-19 22:53:20,13785.0,2,8234,0,13780.0,7,13785.0,3,S
2018-04-19 22:53:25,13785.0,2,8236,0,13780.0,9,13785.0,2,S
2018-04-19 22:53:27,13785.0,2,8238,0,13780.0,9,13785.0,1,S
2018-04-19 22:53:34,13780.0,10,8248,-8,13780.0,2,13785.0,3,S
2018-04-19 22:53:36,13780.0,4,8252,2,13775.0,24,13780.0,1,S
2018-04-19 22:53:44,13780.0,2,8254,0,13775.0,20,13780.0,4,S
2018-04-19 22:53:48,13780.0,2,8256,0,13775.0,20,13780.0,3,S
2018-04-19 22:53:54,13780.0,2,8258,0,13775.0,20,13780.0,3,S
2018-04-19 22:54:00,13780.0,6,8264,-2,13775.0,20,13785.0,7,S
2018-04-19 22:54:01,13780.0,2,8266,-2,13775.0,20,13785.0,8,S
2018-04-19 22:54:05,13780.0,2,8268,0,13775.0,20,13785.0,8,S
2018-04-19 22:54:30,13780.0,4,8272,0,13775.0,26,13780.0,2,S
2018-04-19 22:54:30,13785.0,16,8288,-10,13775.0,24,13790.0,8,B
2018-04-19 22:54:31,13785.0,6,8294,-4,13775.0,26,13785.0,7,B
2018-04-19 22:54:32,13785.0,14,8308,0,13775.0,26,13790.0,12,B
2018-04-19 22:54:33,13785.0,2,8310,0,13775.0,26,13790.0,12,B
2018-04-19 22:54:34,13790.0,10,8320,-8,13780.0,7,13785.0,1,B
2018-04-19 22:54:35,13785.0,2,8322,0,13785.0,2,13790.0,1,S
2018-04-19 22:54:35,13790.0,2,8324,0,13785.0,1,13790.0,1,B
2018-04-19 22:54:52,13785.0,2,8326,-2,13780.0,6,13785.0,1,S
2018-04-19 22:54:57,13785.0,2,8328,-2,13780.0,5,13790.0,2,S
2018-04-19 22:55:13,13795.0,6,8334,2,13785.0,6,13795.0,7,B
2018-04-19 22:55:22,13790.0,2,8336,0,13785.0,8,13795.0,5,S
2018-04-19 22:55:34,13790.0,2,8338,-2,13785.0,3,13795.0,18,S
2018-04-19 22:56:18,13785.0,2,8340,0,13780.0,3,13785.0,1,S
2018-04-19 22:56:24,13785.0,2,8342,0,13780.0,9,13790.0,7,S
2018-04-19 22:56:38,13780.0,2,8344,0,13775.0,23,13780.0,1,S
2018-04-19 22:56:54,13780.0,8,8352,-8,13775.0,21,13785.0,8,S
2018-04-19 22:57:01,13780.0,2,8354,0,13775.0,25,13785.0,2,S
2018-04-19 22:57:14,13780.0,2,8356,-2,13780.0,2,13785.0,6,S
2018-04-19 22:57:20,13780.0,2,8358,2,13780.0,1,13785.0,6,S
2018-04-19 22:57:38,13780.0,2,8360,-2,13775.0,23,13785.0,2,S
2018-04-19 22:58:00,13780.0,2,8362,0,13775.0,28,13780.0,6,S
2018-04-19 22:58:02,13775.0,4,8366,0,13775.0,25,13780.0,6,S
2018-04-19 22:58:02,13780.0,2,8368,0,13775.0,25,13780.0,5,B
2018-04-19 22:58:17,13775.0,2,8370,0,13775.0,24,13780.0,6,S
2018-04-19 22:58:20,13780.0,2,8372,-2,13775.0,26,13780.0,2,B
2018-04-19 22:58:23,13775.0,2,8374,2,13775.0,25,13780.0,3,S
2018-04-19 22:58:28,13780.0,6,8380,-2,13775.0,25,13785.0,4,B
2018-04-19 22:58:28,13775.0,6,8386,0,13775.0,22,13785.0,4,S
2018-04-19 22:58:41,13780.0,2,8388,-2,13775.0,23,13785.0,4,B
2018-04-19 22:58:52,13780.0,2,8390,0,13775.0,23,13785.0,3,B
2018-04-19 22:58:53,13775.0,2,8392,0,13775.0,20,13785.0,3,S
2018-04-19 22:59:00,13785.0,4,8396,0,13775.0,22,13785.0,2,B
2018-04-19 22:59:02,13785.0,6,8402,-6,13775.0,20,13790.0,7,B
2018-04-19 22:59:10,13785.0,2,8404,-2,13780.0,4,13785.0,4,B
2018-04-19 22:59:15,13780.0,2,8406,-2,13780.0,1,13785.0,4,S
2018-04-19 22:59:20,13780.0,2,8408,-2,13775.0,17,13785.0,10,S
2018-04-19 22:59:21,13775.0,2,8410,-2,13775.0,16,13785.0,10,S
2018-04-19 22:59:31,13780.0,4,8414,-2,13775.0,18,13785.0,6,B
2018-04-19 22:59:38,13780.0,2,8416,-2,13775.0,13,13785.0,9,B
2018-04-19 22:59:40,13780.0,2,8418,-2,13775.0,13,13780.0,2,B
2018-04-19 22:59:42,13780.0,4,8422,-4,13775.0,13,13785.0,9,B
2018-04-19 22:59:43,13785.0,2,8424,-2,13775.0,13,13785.0,8,B
2018-04-19 22:59:45,13780.0,2,8426,-2,13775.0,13,13785.0,3,S
2018-04-19 22:59:46,13780.0,2,8428,-2,13775.0,16,13785.0,3,S
2018-04-19 22:59:56,13775.0,6,8434,-6,13775.0,14,13785.0,1,S
2018-04-19 22:59:59,13785.0,2,8436,-2,13775.0,11,13785.0,1,B
2018-04-20 09:00:00,13785.0,24,8460,-2,13775.0,1,13790.0,1,B
2018-04-20 09:00:01,13775.0,2,8462,-2,13775.0,3,13790.0,6,S
2018-04-20 09:00:04,13780.0,4,8466,-4,13770.0,10,13780.0,14,B
2018-04-20 09:00:05,13770.0,2,8468,-2,13770.0,6,13780.0,34,S
2018-04-20 09:00:06,13770.0,14,8482,4,13760.0,3,13770.0,2,S
2018-04-20 09:00:07,13770.0,2,8484,0,13760.0,5,13770.0,1,S
2018-04-20 09:00:08,13760.0,4,8488,-2,13760.0,3,13765.0,1,S
2018-04-20 09:00:09,13760.0,6,8494,0,13755.0,4,13760.0,16,S
2018-04-20 09:00:10,13755.0,4,8498,-2,13755.0,1,13760.0,21,S
2018-04-20 09:00:11,13750.0,8,8506,-2,13740.0,4,13755.0,6,S
2018-04-20 09:00:12,13740.0,4,8510,2,13740.0,3,13750.0,18,S
2018-04-20 09:00:13,13750.0,12,8522,-2,13745.0,1,13755.0,20,B
2018-04-20 09:00:14,13740.0,22,8544,8,13735.0,2,13740.0,1,S
2018-04-20 09:00:14,13740.0,8,8552,4,13740.0,21,13750.0,1,S
2018-04-20 09:00:15,13750.0,4,8556,-2,13740.0,5,13750.0,16,B
2018-04-20 09:00:16,13750.0,4,8560,0,13740.0,4,13750.0,15,B
2018-04-20 09:00:17,13740.0,18,8578,-6,13735.0,3,13740.0,1,S
2018-04-20 09:00:17,13740.0,4,8582,0,13740.0,3,13745.0,1,S
2018-04-20 09:00:18,13750.0,4,8586,0,13740.0,3,13755.0,24,B
2018-04-20 09:00:18,13750.0,4,8590,0,13740.0,3,13750.0,13,B
2018-04-20 09:00:19,13740.0,2,8592,0,13740.0,3,13750.0,13,S
2018-04-20 09:00:38,13755.0,10,8602,4,13750.0,6,13760.0,1,B
2018-04-20 09:00:39,13755.0,14,8616,8,13755.0,18,13765.0,4,B
2018-04-20 09:00:42,13755.0,2,8618,0,13755.0,1,13765.0,4,B
2018-04-20 09:00:46,13760.0,2,8620,2,13760.0,6,13765.0,3,B
2018-04-20 09:00:47,13760.0,2,8622,0,13755.0,1,13765.0,6,B
2018-04-20 09:01:02,13750.0,2,8624,0,13750.0,5,13760.0,5,S
2018-04-20 09:01:08,13755.0,6,8630,0,13750.0,4,13755.0,6,B
2018-04-20 09:01:12,13755.0,4,8634,0,13750.0,4,13755.0,6,B
2018-04-20 09:01:15,13750.0,6,8640,4,13750.0,2,13755.0,7,S
2018-04-20 09:01:16,13750.0,4,8644,4,13745.0,2,13750.0,3,S
2018-04-20 09:01:18,13755.0,2,8646,2,13745.0,6,13755.0,5,B
2018-04-20 09:01:25,13745.0,4,8650,0,13745.0,1,13750.0,9,S
2018-04-20 09:01:25,13745.0,2,8652,0,13740.0,82,13750.0,9,S
2018-04-20 09:01:27,13750.0,2,8654,-2,13745.0,4,13750.0,9,B
2018-04-20 09:01:30,13745.0,4,8658,-4,13745.0,2,13750.0,7,S
2018-04-20 09:01:31,13740.0,10,8668,-2,13740.0,79,13750.0,5,S
2018-04-20 09:01:34,13750.0,2,8670,0,13745.0,4,13750.0,5,B
2018-04-20 09:01:36,13745.0,2,8672,-2,13740.0,83,13750.0,5,S
2018-04-20 09:01:38,13750.0,2,8674,0,13745.0,2,13750.0,4,B
2018-04-20 09:01:40,13745.0,2,8676,2,13745.0,4,13750.0,4,S
2018-04-20 09:01:46,13750.0,16,8692,16,13750.0,49,13755.0,31,B
2018-04-20 09:01:46,13750.0,8,8700,6,13750.0,45,13755.0,41,B
2018-04-20 09:01:47,13750.0,8,8708,0,13750.0,41,13755.0,41,B
2018-04-20 09:01:49,13755.0,6,8714,2,13750.0,43,13760.0,24,B
2018-04-20 09:01:51,13755.0,6,8720,2,13750.0,41,13755.0,2,B
2018-04-20 09:01:51,13755.0,6,8726,6,13750.0,43,13760.0,26,B
2018-04-20 09:01:52,13755.0,2,8728,2,13750.0,43,13760.0,29,B
2018-04-20 09:01:57,13755.0,2,8730,-2,13750.0,43,13755.0,2,B
2018-04-20 09:02:00,13750.0,6,8736,0,13750.0,42,13755.0,3,S
2018-04-20 09:02:01,13755.0,6,8742,-4,13755.0,3,13760.0,12,B
2018-04-20 09:02:01,13755.0,6,8748,-6,13750.0,43,13760.0,29,B
2018-04-20 09:02:02,13750.0,54,8802,54,13750.0,16,13760.0,29,S
2018-04-20 09:02:03,13755.0,2,8804,2,13750.0,18,13760.0,29,B
2018-04-20 09:02:06,13755.0,2,8806,0,13755.0,4,13760.0,9,B
2018-04-20 09:02:12,13760.0,2,8808,2,13755.0,5,13760.0,9,B
2018-04-20 09:02:13,13755.0,4,8812,-4,13755.0,3,13760.0,9,S
2018-04-20 09:02:14,13755.0,14,8826,6,13750.0,15,13755.0,3,S
2018-04-20 09:02:20,13750.0,10,8836,10,13750.0,9,13755.0,3,S
2018-04-20 09:02:24,13750.0,2,8838,2,13750.0,8,13755.0,4,S
2018-04-20 09:02:29,13750.0,4,8842,4,13750.0,6,13755.0,4,S
2018-04-20 09:02:30,13750.0,4,8846,4,13750.0,4,13755.0,4,S
2018-04-20 09:02:31,13750.0,8,8854,6,13745.0,5,13755.0,6,S
2018-04-20 09:02:34,13750.0,2,8856,-2,13745.0,7,13750.0,3,S
2018-04-20 09:02:43,13745.0,10,8866,0,13740.0,83,13745.0,3,S
2018-04-20 09:02:45,13740.0,20,8886,14,13740.0,71,13745.0,12,S
2018-04-20 09:02:46,13740.0,10,8896,6,13740.0,66,13745.0,30,S
2018-04-20 09:02:46,13740.0,78,8974,44,13740.0,27,13745.0,35,S
2018-04-20 09:02:47,13740.0,56,9030,50,13735.0,7,13740.0,5,S
2018-04-20 09:02:47,13735.0,10,9040,0,13735.0,2,13740.0,13,S
2018-04-20 09:02:48,13735.0,4,9044,-4,13735.0,1,13740.0,32,S
2018-04-20 09:02:48,13735.0,2,9046,-2,13730.0,3,13735.0,1,S
2018-04-20 09:02:49,13730.0,10,9056,-6,13725.0,4,13730.0,3,S
2018-04-20 09:02:50,13730.0,6,9062,4,13725.0,7,13730.0,3,S
2018-04-20 09:02:50,13725.0,8,9070,4,13725.0,3,13730.0,3,S
2018-04-20 09:02:51,13725.0,6,9076,0,13725.0,3,13730.0,5,S
2018-04-20 09:02:52,13725.0,6,9082,0,13720.0,7,13725.0,2,S
2018-04-20 09:02:52,13725.0,4,9086,4,13720.0,6,13730.0,7,S
2018-04-20 09:02:56,13730.0,2,9088,0,13725.0,12,13730.0,5,B
2018-04-20 09:02:57,13725.0,10,9098,-6,13725.0,11,13730.0,1,S
2018-04-20 09:02:58,13730.0,2,9100,-2,13725.0,7,13735.0,3,B
2018-04-20 09:03:02,13730.0,2,9102,0,13730.0,1,13735.0,16,B
2018-04-20 09:03:03,13730.0,2,9104,-2,13725.0,4,13735.0,31,B
2018-04-20 09:03:04,13735.0,6,9110,-6,13730.0,5,13740.0,20,B
2018-04-20 09:03:09,13735.0,2,9112,-2,13730.0,7,13735.0,1,B
2018-04-20 09:03:11,13735.0,2,9114,0,13730.0,7,13740.0,25,B
2018-04-20 09:03:13,13735.0,6,9120,-6,13730.0,11,13735.0,3,B
2018-04-20 09:03:14,13735.0,2,9122,0,13730.0,11,13735.0,2,B
2018-04-20 09:03:15,13735.0,2,9124,0,13730.0,11,13735.0,1,B
2018-04-20 09:03:16,13735.0,2,9126,0,13735.0,3,13740.0,10,B
2018-04-20 09:03:19,13740.0,2,9128,0,13735.0,7,13740.0,4,B
2018-04-20 09:03:20,13740.0,6,9134,-6,13735.0,7,13740.0,1,B
2018-04-20 09:03:21,13740.0,2,9136,0,13740.0,5,13745.0,26,B
2018-04-20 09:03:21,13745.0,2,9138,2,13745.0,3,13750.0,24,B
2018-04-20 09:03:22,13745.0,6,9144,-6,13745.0,7,13750.0,30,B
2018-04-20 09:03:26,13750.0,2,9146,2,13745.0,6,13750.0,15,B
2018-04-20 09:03:33,13745.0,4,9150,0,13745.0,1,13750.0,21,S
2018-04-20 09:03:34,13745.0,2,9152,0,13740.0,8,13750.0,24,S
2018-04-20 09:03:39,13745.0,4,9156,0,13740.0,7,13745.0,18,S
2018-04-20 09:03:43,13740.0,8,9164,2,13740.0,12,13750.0,28,S
2018-04-20 09:03:44,13745.0,2,9166,0,13740.0,12,13750.0,28,B
2018-04-20 09:03:45,13740.0,2,9168,0,13740.0,13,13750.0,27,S
2018-04-20 09:03:50,13745.0,2,9170,-2,13740.0,11,13745.0,2,B
2018-04-20 09:03:50,13745.0,4,9174,0,13740.0,10,13745.0,1,B
2018-04-20 09:03:54,13745.0,2,9176,0,13740.0,11,13745.0,5,B
2018-04-20 09:04:07,13740.0,2,9178,-2,13740.0,5,13750.0,27,S
2018-04-20 09:04:16,13740.0,4,9182,0,13735.0,15,13740.0,18,S
2018-04-20 09:04:17,13735.0,8,9190,-2,13735.0,2,13740.0,19,S
2018-04-20 09:04:17,13735.0,4,9194,4,13730.0,7,13735.0,1,S
2018-04-20 09:04:20,13735.0,2,9196,2,13730.0,11,13740.0,30,S
2018-04-20 09:04:27,13730.0,4,9200,-4,13730.0,3,13735.0,21,S
2018-04-20 09:04:27,13730.0,2,9202,0,13730.0,1,13735.0,21,S
2018-04-20 09:04:28,13730.0,2,9204,0,13725.0,4,13730.0,1,S
2018-04-20 09:04:35,13730.0,2,9206,0,13730.0,2,13735.0,2,S
2018-04-20 09:04:35,13730.0,2,9208,0,13730.0,1,13735.0,3,S
2018-04-20 09:04:36,13730.0,2,9210,0,13725.0,11,13730.0,2,S
2018-04-20 09:04:45,13725.0,4,9214,2,13720.0,5,13730.0,13,S
2018-04-20 09:05:03,13730.0,4,9218,0,13725.0,12,13735.0,9,B
2018-04-20 09:05:08,13735.0,4,9222,4,13730.0,13,13740.0,27,B
2018-04-20 09:05:11,13740.0,8,9230,-8,13735.0,7,13740.0,14,B
2018-04-20 09:05:15,13740.0,28,9258,0,13735.0,16,13745.0,4,B
2018-04-20 09:05:17,13745.0,8,9266,4,13735.0,8,13745.0,12,B
2018-04-20 09:05:25,13745.0,2,9268,0,13735.0,10,13745.0,10,B
2018-04-20 09:05:27,13740.0,2,9270,0,13740.0,2,13745.0,10,S
2018-04-20 09:05:49,13745.0,4,9274,4,13740.0,14,13750.0,11,B
2018-04-20 09:05:58,13745.0,38,9312,2,13740.0,11,13745.0,46,B
2018-04-20 09:05:58,13745.0,18,9330,0,13740.0,12,13745.0,37,B
2018-04-20 09:06:02,13740.0,10,9340,6,13740.0,4,13745.0,39,S
2018-04-20 09:06:05,13740.0,6,9346,0,13735.0,11,13745.0,42,S
2018-04-20 09:06:07,13740.0,2,9348,0,13740.0,1,13745.0,42,S
2018-04-20 09:06:07,13740.0,2,9350,0,13735.0,15,13745.0,42,S
2018-04-20 09:06:10,13740.0,2,9352,2,13740.0,3,13745.0,39,S
2018-04-20 09:06:27,13745.0,2,9354,0,13740.0,2,13745.0,44,B
2018-04-20 09:06:36,13740.0,2,9356,0,13735.0,16,13745.0,43,S
2018-04-20 09:06:41,13740.0,2,9358,2,13735.0,16,13745.0,43,S
2018-04-20 09:06:44,13740.0,2,9360,0,13735.0,16,13745.0,46,S
2018-04-20 09:06:48,13735.0,2,9362,-2,13735.0,12,13745.0,46,S
2018-04-20 09:06:50,13745.0,2,9364,0,13735.0,12,13745.0,45,B
2018-04-20 09:06:58,13740.0,2,9366,0,13735.0,13,13745.0,44,S
2018-04-20 09:07:04,13740.0,2,9368,0,13735.0,13,13740.0,3,S
2018-04-20 09:07:05,13745.0,8,9376,6,13740.0,1,13745.0,43,B
2018-04-20 09:07:25,13740.0,2,9378,2,13735.0,9,13740.0,7,S
2018-04-20 09:07:59,13740.0,6,9384,4,13735.0,12,13745.0,48,S
2018-04-20 09:08:07,13740.0,2,9386,0,13740.0,1,13745.0,46,S
2018-04-20 09:08:07,13740.0,2,9388,0,13735.0,13,13740.0,1,S
2018-04-20 09:08:08,13740.0,2,9390,0,13735.0,13,13745.0,43,S
2018-04-20 09:08:15,13745.0,2,9392,0,13735.0,12,13745.0,45,B
2018-04-20 09:08:23,13745.0,6,9398,-6,13740.0,3,13745.0,37,B
2018-04-20 09:08:23,13745.0,8,9406,-8,13740.0,11,13745.0,31,B
2018-04-20 09:08:32,13740.0,10,9416,10,13740.0,5,13745.0,31,S
2018-04-20 09:08:33,13740.0,10,9426,-4,13735.0,9,13740.0,1,S
2018-04-20 09:08:33,13740.0,2,9428,-2,13740.0,3,13745.0,31,S
2018-04-20 09:08:37,13745.0,2,9430,0,13740.0,27,13745.0,30,B
2018-04-20 09:08:38,13740.0,4,9434,2,13740.0,28,13745.0,30,S
2018-04-20 09:08:39,13740.0,48,9482,-24,13735.0,9,13745.0,44,S
2018-04-20 09:08:42,13740.0,6,9488,-6,13740.0,2,13745.0,38,S
2018-04-20 09:08:44,13740.0,2,9490,0,13735.0,9,13740.0,3,S
2018-04-20 09:08:52,13740.0,6,9496,0,13735.0,10,13745.0,42,S
2018-04-20 09:08:57,13745.0,8,9504,-8,13740.0,4,13745.0,30,B
2018-04-20 09:09:06,13745.0,2,9506,0,13740.0,4,13745.0,33,B
2018-04-20 09:09:14,13740.0,8,9514,-8,13735.0,12,13745.0,33,S
2018-04-20 09:09:14,13745.0,2,9516,0,13735.0,11,13745.0,50,B
2018-04-20 09:09:18,13740.0,2,9518,2,13735.0,12,13740.0,2,S
2018-04-20 09:09:19,13740.0,2,9520,0,13735.0,9,13740.0,3,S
2018-04-20 09:09:27,13740.0,2,9522,0,13735.0,11,13740.0,2,S
2018-04-20 09:09:31,13735.0,16,9538,-14,13735.0,3,13740.0,8,S
2018-04-20 09:09:32,13735.0,4,9542,2,13730.0,8,13740.0,21,S
2018-04-20 09:09:41,13740.0,2,9544,0,13730.0,13,13740.0,12,B
2018-04-20 09:10:09,13740.0,2,9546,0,13735.0,3,13740.0,13,B
2018-04-20 09:10:18,13735.0,2,9548,2,13735.0,2,13740.0,14,S
2018-04-20 09:10:29,13735.0,4,9552,4,13730.0,14,13735.0,3,S
2018-04-20 09:10:31,13730.0,2,9554,0,13730.0,9,13735.0,1,S
2018-04-20 09:10:41,13730.0,12,9566,4,13730.0,1,13735.0,7,S
2018-04-20 09:10:56,13730.0,2,9568,-2,13725.0,3,13735.0,5,S
2018-04-20 09:10:59,13730.0,2,9570,0,13730.0,1,13735.0,6,S
2018-04-20 09:11:03,13730.0,2,9572,0,13725.0,5,13735.0,7,S
2018-04-20 09:11:27,13725.0,2,9574,-2,13725.0,3,13730.0,9,S
2018-04-20 09:11:41,13725.0,2,9576,2,13725.0,15,13730.0,9,S
2018-04-20 09:11:43,13725.0,2,9578,0,13725.0,14,13730.0,13,S
2018-04-20 09:11:43,13725.0,6,9584,0,13725.0,11,13730.0,15,S
2018-04-20 09:11:51,13730.0,2,9586,0,13725.0,11,13730.0,18,B
2018-04-20 09:12:00,13725.0,10,9596,-6,13725.0,6,13730.0,20,S
2018-04-20 09:12:01,13725.0,8,9604,-4,13725.0,2,13730.0,16,S
2018-04-20 09:12:01,13725.0,2,9606,0,13725.0,1,13730.0,16,S
2018-04-20 09:12:03,13725.0,2,9608,-2,13720.0,7,13730.0,15,S
2018-04-20 09:12:10,13725.0,2,9610,0,13720.0,9,13725.0,3,S
2018-04-20 09:12:13,13720.0,2,9612,-2,13720.0,2,13725.0,4,S
2018-04-20 09:12:14,13720.0,4,9616,0,13715.0,2,13720.0,2,S
2018-04-20 09:12:14,13715.0,8,9624,-6,13715.0,3,13720.0,2,S
2018-04-20 09:12:19,13720.0,2,9626,2,13715.0,8,13720.0,4,B
2018-04-20 09:12:20,13720.0,6,9632,-6,13710.0,4,13720.0,8,B
2018-04-20 09:12:20,13720.0,4,9636,0,13710.0,7,13715.0,12,B
2018-04-20 09:12:21,13715.0,4,9640,0,13710.0,4,13715.0,14,S
2018-04-20 09:12:23,13715.0,2,9642,2,13710.0,4,13715.0,15,S
2018-04-20 09:12:24,13710.0,2,9644,2,13710.0,3,13715.0,15,S
2018-04-20 09:12:25,13715.0,2,9646,2,13710.0,5,13715.0,2,B
2018-04-20 09:12:25,13715.0,2,9648,-2,13710.0,6,13720.0,8,B
2018-04-20 09:12:26,13710.0,2,9650,0,13710.0,2,13715.0,11,S
2018-04-20 09:12:27,13710.0,2,9652,0,13710.0,1,13715.0,3,S
2018-04-20 09:12:27,13710.0,2,9654,-2,13710.0,2,13720.0,10,S
2018-04-20 09:12:34,13710.0,2,9656,-2,13710.0,2,13715.0,13,S
2018-04-20 09:12:38,13710.0,4,9660,-4,13705.0,7,13710.0,17,S
2018-04-20 09:12:39,13710.0,2,9662,-2,13705.0,9,13710.0,16,S
2018-04-20 09:12:43,13710.0,12,9674,-12,13705.0,13,13710.0,11,S
2018-04-20 09:12:44,13705.0,2,9676,-2,13705.0,12,13710.0,13,S
2018-04-20 09:12:47,13705.0,2,9678,0,13705.0,4,13710.0,13,S
2018-04-20 09:12:48,13705.0,6,9684,2,13700.0,15,13705.0,49,S
2018-04-20 09:12:49,13705.0,4,9688,0,13700.0,17,13705.0,47,S
2018-04-20 09:12:52,13700.0,36,9724,24,13695.0,8,13700.0,14,S
2018-04-20 09:12:53,13700.0,28,9752,10,13695.0,9,13700.0,2,S
2018-04-20 09:12:53,13700.0,10,9762,4,13700.0,6,13705.0,48,S
2018-04-20 09:12:54,13700.0,2,9764,-2,13700.0,2,13705.0,50,S
2018-04-20 09:12:54,13700.0,6,9770,0,13695.0,13,13705.0,50,S
2018-04-20 09:12:56,13695.0,12,9782,-10,13695.0,8,13700.0,1,S
2018-04-20 09:12:57,13700.0,2,9784,0,13695.0,8,13705.0,50,B
2018-04-20 09:12:59,13705.0,62,9846,36,13700.0,17,13705.0,18,B
2018-04-20 09:13:00,13705.0,36,9882,16,13705.0,18,13710.0,19,B
2018-04-20 09:13:01,13705.0,12,9894,-4,13705.0,47,13710.0,21,B
2018-04-20 09:13:05,13705.0,2,9896,0,13705.0,44,13710.0,22,B
2018-04-20 09:13:08,13710.0,2,9898,-2,13705.0,44,13710.0,21,B
2018-04-20 09:13:14,13705.0,2,9900,-2,13705.0,43,13710.0,28,S
2018-04-20 09:13:15,13705.0,2,9902,-2,13705.0,42,13710.0,29,S
2018-04-20 09:13:16,13705.0,4,9906,0,13705.0,40,13710.0,30,S
2018-04-20 09:13:21,13710.0,10,9916,-10,13705.0,48,13710.0,13,B
2018-04-20 09:13:24,13705.0,6,9922,6,13705.0,37,13710.0,23,S
2018-04-20 09:13:26,13705.0,2,9924,2,13705.0,36,13710.0,23,S
2018-04-20 09:13:27,13705.0,2,9926,2,13705.0,35,13710.0,25,S
2018-04-20 09:13:29,13705.0,6,9932,6,13705.0,32,13710.0,25,S
2018-04-20 09:13:30,13705.0,2,9934,2,13705.0,31,13710.0,25,S
2018-04-20 09:13:32,13705.0,2,9936,2,13705.0,30,13710.0,25,S
2018-04-20 09:13:35,13705.0,2,9938,2,13705.0,29,13710.0,25,S
2018-04-20 09:13:46,13710.0,2,9940,-2,13705.0,35,13710.0,20,B
2018-04-20 09:13:46,13710.0,14,9954,-6,13705.0,35,13710.0,13,B
2018-04-20 09:13:47,13710.0,16,9970,0,13710.0,3,13715.0,5,B
2018-04-20 09:13:51,13710.0,6,9976,0,13705.0,38,13710.0,2,B
2018-04-20 09:13:52,13710.0,6,9982,0,13705.0,32,13710.0,2,B
2018-04-20 09:13:55,13710.0,2,9984,2,13705.0,29,13710.0,10,B
2018-04-20 09:13:57,13705.0,12,9996,8,13705.0,23,13710.0,31,S
2018-04-20 09:13:57,13705.0,4,10000,4,13705.0,21,13710.0,32,S
2018-04-20 09:14:00,13705.0,10,10010,10,13705.0,16,13710.0,32,S
2018-04-20 09:14:00,13705.0,22,10032,10,13705.0,5,13710.0,20,S
2018-04-20 09:14:01,13705.0,4,10036,0,13705.0,3,13710.0,20,S
2018-04-20 09:14:06,13710.0,2,10038,2,13705.0,9,13710.0,18,B
2018-04-20 09:14:06,13710.0,14,10052,0,13705.0,6,13710.0,3,B
2018-04-20 09:14:07,13705.0,2,10054,0,13705.0,5,13710.0,3,S
2018-04-20 09:14:09,13705.0,2,10056,0,13705.0,4,13710.0,2,S
2018-04-20 09:14:10,13705.0,2,10058,0,13705.0,3,13710.0,3,S
2018-04-20 09:14:14,13710.0,6,10064,0,13705.0,12,13715.0,6,B
2018-04-20 09:14:15,13715.0,2,10066,0,13705.0,12,13715.0,6,B
2018-04-20 09:14:16,13705.0,6,10072,4,13705.0,9,13715.0,8,S
2018-04-20 09:14:36,13705.0,18,10090,10,13700.0,9,13715.0,13,S
2018-04-20 09:14:42,13700.0,16,10106,8,13695.0,2,13700.0,2,S
2018-04-20 09:14:42,13695.0,8,10114,0,13695.0,2,13705.0,1,S
2018-04-20 09:14:45,13700.0,10,10124,6,13695.0,4,13700.0,5,B
2018-04-20 09:14:46,13695.0,4,10128,2,13695.0,5,13700.0,6,S
2018-04-20 09:14:49,13700.0,2,10130,0,13695.0,5,13700.0,5,B
2018-04-20 09:14:49,13700.0,10,10140,-2,13700.0,1,13705.0,1,B
2018-04-20 09:14:52,13700.0,2,10142,2,13700.0,8,13705.0,2,B
2018-04-20 09:14:55,13700.0,2,10144,2,13700.0,4,13705.0,7,B
2018-04-20 09:14:57,13705.0,2,10146,0,13700.0,4,13705.0,5,B
2018-04-20 09:14:58,13705.0,2,10148,2,13700.0,6,13705.0,4,B
2018-04-20 09:15:02,13705.0,2,10150,2,13700.0,4,13705.0,4,B
2018-04-20 09:15:13,13700.0,20,10170,10,13700.0,1,13710.0,10,S
2018-04-20 09:15:15,13700.0,4,10174,2,13695.0,7,13700.0,8,S
2018-04-20 09:15:15,13700.0,16,10190,0,13700.0,6,13705.0,1,S
2018-04-20 09:15:17,13700.0,18,10208,14,13695.0,10,13700.0,1,S
2018-04-20 09:15:17,13705.0,4,10212,4,13700.0,25,13710.0,15,B
2018-04-20 09:15:18,13700.0,28,10240,20,13700.0,14,13710.0,15,S
2018-04-20 09:15:21,13705.0,2,10242,-2,13705.0,1,13710.0,15,B
2018-04-20 09:15:22,13705.0,2,10244,0,13700.0,10,13705.0,2,B
2018-04-20 09:15:23,13705.0,4,10248,0,13700.0,11,13705.0,1,B
2018-04-20 09:15:26,13705.0,2,10250,0,13700.0,13,13705.0,2,B
2018-04-20 09:15:30,13700.0,2,10252,0,13700.0,12,13705.0,1,S
2018-04-20 09:15:32,13705.0,2,10254,0,13700.0,17,13710.0,22,B
2018-04-20 09:15:37,13705.0,2,10256,2,13700.0,11,13705.0,4,B
2018-04-20 09:15:41,13705.0,2,10258,2,13700.0,11,13705.0,3,B
2018-04-20 09:15:44,13705.0,6,10264,0,13705.0,1,13710.0,23,B
2018-04-20 09:15:44,13705.0,2,10266,-2,13700.0,10,13710.0,23,B
2018-04-20 09:15:53,13705.0,2,10268,0,13700.0,14,13705.0,3,B
2018-04-20 09:15:57,13705.0,22,10290,16,13700.0,4,13705.0,2,B
2018-04-20 09:15:59,13700.0,8,10298,8,13695.0,7,13700.0,6,S
2018-04-20 09:16:00,13705.0,14,10312,10,13700.0,9,13705.0,1,B
2018-04-20 09:16:02,13705.0,20,10332,18,13700.0,1,13705.0,11,B
2018-04-20 09:16:07,13700.0,4,10336,0,13695.0,2,13700.0,8,S
2018-04-20 09:16:10,13700.0,6,10342,6,13695.0,2,13700.0,7,S
2018-04-20 09:16:12,13695.0,4,10346,-4,13690.0,26,13700.0,7,S
2018-04-20 09:16:19,13695.0,2,10348,2,13690.0,17,13695.0,2,S
2018-04-20 09:16:20,13695.0,10,10358,-4,13690.0,9,13695.0,5,S
2018-04-20 09:16:21,13695.0,10,10368,10,13695.0,3,13700.0,15,S
2018-04-20 09:16:23,13695.0,14,10382,14,13690.0,22,13695.0,3,S
2018-04-20 09:16:24,13695.0,6,10388,0,13690.0,35,13700.0,15,S
2018-04-20 09:16:25,13695.0,2,10390,-2,13690.0,22,13700.0,15,S
2018-04-20 09:16:27,13695.0,2,10392,0,13695.0,1,13700.0,15,S
2018-04-20 09:16:28,13695.0,2,10394,0,13690.0,18,13695.0,10,S
2018-04-20 09:16:31,13690.0,2,10396,2,13690.0,10,13695.0,13,S
2018-04-20 09:16:32,13690.0,4,10400,-4,13690.0,13,13695.0,13,S
2018-04-20 09:16:33,13690.0,2,10402,0,13690.0,11,13695.0,13,S
2018-04-20 09:16:34,13695.0,2,10404,0,13690.0,21,13695.0,10,B
2018-04-20 09:16:35,13695.0,6,10410,-6,13690.0,32,13695.0,7,B
2018-04-20 09:16:36,13695.0,6,10416,-4,13690.0,32,13695.0,2,B
2018-04-20 09:16:36,13690.0,6,10422,-6,13690.0,31,13700.0,15,S
2018-04-20 09:16:37,13690.0,6,10428,6,13690.0,8,13700.0,21,S
2018-04-20 09:16:38,13690.0,8,10436,0,13690.0,4,13700.0,21,S
2018-04-20 09:16:45,13695.0,4,10440,4,13690.0,4,13695.0,5,B
2018-04-20 09:16:45,13690.0,2,10442,-2,13690.0,3,13695.0,2,S
2018-04-20 09:16:56,13695.0,2,10444,0,13690.0,17,13695.0,3,B
2018-04-20 09:17:01,13690.0,22,10466,10,13690.0,6,13695.0,3,S
2018-04-20 09:17:02,13690.0,6,10472,-4,13685.0,9,13690.0,22,S
2018-04-20 09:17:03,13685.0,20,10492,18,13685.0,16,13690.0,22,S
2018-04-20 09:17:03,13685.0,4,10496,0,13685.0,14,13690.0,23,S
2018-04-20 09:17:04,13690.0,6,10502,-2,13685.0,13,13690.0,21,B
2018-04-20 09:17:05,13685.0,20,10522,16,13685.0,4,13690.0,21,S
2018-04-20 09:17:08,13685.0,12,10534,4,13680.0,30,13690.0,24,S
2018-04-20 09:17:09,13680.0,2,10536,0,13680.0,30,13685.0,26,S
2018-04-20 09:17:10,13680.0,6,10542,-6,13680.0,28,13685.0,22,S
2018-04-20 09:17:10,13680.0,2,10544,-2,13680.0,27,13685.0,22,S
2018-04-20 09:17:12,13680.0,20,10564,0,13680.0,17,13685.0,7,S
2018-04-20 09:17:13,13680.0,20,10584,6,13680.0,9,13685.0,7,S
2018-04-20 09:17:13,13685.0,2,10586,0,13680.0,9,13685.0,2,B
2018-04-20 09:17:14,13685.0,2,10588,0,13680.0,9,13685.0,1,B
2018-04-20 09:17:14,13680.0,22,10610,6,13680.0,1,13685.0,1,S
2018-04-20 09:17:18,13685.0,10,10620,2,13680.0,3,13685.0,4,B
2018-04-20 09:17:20,13685.0,2,10622,0,13680.0,3,13685.0,5,B
2018-04-20 09:17:24,13685.0,2,10624,2,13680.0,4,13685.0,4,B
2018-04-20 09:17:25,13680.0,10,10634,6,13680.0,2,13685.0,4,S
2018-04-20 09:17:28,13685.0,2,10636,0,13680.0,4,13685.0,3,B
2018-04-20 09:17:29,13680.0,10,10646,6,13680.0,2,13685.0,3,S
2018-04-20 09:17:32,13685.0,2,10648,0,13680.0,4,13685.0,3,B
2018-04-20 09:17:34,13680.0,10,10658,8,13680.0,2,13685.0,3,S
2018-04-20 09:17:35,13680.0,10,10668,10,13680.0,1,13685.0,3,S
2018-04-20 09:17:41,13685.0,2,10670,-2,13685.0,19,13690.0,25,B
2018-04-20 09:17:43,13685.0,2,10672,2,13680.0,11,13690.0,23,B
2018-04-20 09:17:47,13690.0,8,10680,0,13685.0,2,13690.0,19,B
2018-04-20 09:17:50,13685.0,4,10684,4,13680.0,11,13685.0,3,S
2018-04-20 09:17:51,13680.0,2,10686,-2,13675.0,3,13685.0,16,S
2018-04-20 09:17:54,13675.0,10,10696,6,13675.0,2,13680.0,3,S
2018-04-20 09:17:54,13675.0,4,10700,2,13670.0,11,13675.0,3,S
2018-04-20 09:17:55,13675.0,6,10706,4,13675.0,1,13680.0,3,S
2018-04-20 09:17:56,13680.0,2,10708,0,13675.0,1,13680.0,2,B
2018-04-20 09:17:57,13680.0,2,10710,-2,13670.0,33,13685.0,34,B
2018-04-20 09:17:58,13685.0,8,10718,6,13670.0,46,13685.0,32,B
2018-04-20 09:17:59,13675.0,4,10722,2,13675.0,13,13685.0,32,S
2018-04-20 09:17:59,13675.0,10,10732,8,13675.0,38,13685.0,13,S
2018-04-20 09:18:00,13675.0,10,10742,10,13675.0,41,13685.0,6,S
2018-04-20 09:18:01,13675.0,10,10752,4,13680.0,1,13685.0,6,S
2018-04-20 09:18:02,13675.0,12,10764,0,13675.0,25,13685.0,6,S
2018-04-20 09:18:04,13675.0,10,10774,0,13675.0,31,13685.0,8,S
2018-04-20 09:18:05,13675.0,10,10784,0,13675.0,26,13685.0,8,S
2018-04-20 09:18:06,13675.0,10,10794,0,13675.0,21,13680.0,3,S
2018-04-20 09:18:07,13675.0,4,10798,0,13670.0,18,13675.0,3,S
2018-04-20 09:18:07,13675.0,2,10800,0,13670.0,29,13675.0,2,S
2018-04-20 09:18:08,13675.0,4,10804,0,13675.0,1,13680.0,7,S
2018-04-20 09:18:08,13675.0,2,10806,0,13675.0,4,13680.0,7,S
2018-04-20 09:18:11,13675.0,10,10816,10,13670.0,20,13680.0,8,S
2018-04-20 09:18:11,13670.0,10,10826,8,13670.0,27,13675.0,9,S
2018-04-20 09:18:12,13670.0,24,10850,-6,13670.0,25,13680.0,8,S
2018-04-20 09:18:12,13670.0,10,10860,0,13670.0,20,13680.0,9,S
2018-04-20 09:18:13,13670.0,10,10870,8,13670.0,15,13680.0,10,S
2018-04-20 09:18:13,13680.0,2,10872,2,13670.0,15,13680.0,9,B
2018-04-20 09:18:15,13670.0,2,10874,2,13670.0,14,13680.0,9,S
2018-04-20 09:18:22,13670.0,4,10878,2,13670.0,5,13675.0,11,S
2018-04-20 09:18:23,13670.0,2,10880,0,13670.0,4,13675.0,9,S
2018-04-20 09:18:24,13670.0,8,10888,-2,13665.0,2,13675.0,10,S
2018-04-20 09:18:27,13675.0,4,10892,4,13665.0,12,13675.0,9,B
2018-04-20 09:18:29,13675.0,6,10898,2,13665.0,12,13675.0,9,B
2018-04-20 09:18:33,13675.0,8,10906,4,13665.0,15,13675.0,4,B
2018-04-20 09:18:35,13675.0,2,10908,0,13670.0,30,13680.0,15,B
2018-04-20 09:18:36,13675.0,4,10912,-4,13670.0,29,13680.0,27,B
2018-04-20 09:18:46,13670.0,4,10916,0,13670.0,25,13675.0,31,S
2018-04-20 09:18:46,13670.0,26,10942,26,13670.0,12,13675.0,31,S
2018-04-20 09:18:47,13670.0,10,10952,0,13670.0,7,13675.0,19,S
2018-04-20 09:18:47,13665.0,24,10976,18,13665.0,4,13670.0,1,S
2018-04-20 09:18:48,13665.0,8,10984,-8,13660.0,18,13665.0,17,S
2018-04-20 09:18:48,13665.0,48,11032,38,13655.0,5,13660.0,3,S
2018-04-20 09:18:49,13660.0,10,11042,-6,13655.0,5,13665.0,17,S
2018-04-20 09:18:49,13655.0,16,11058,-8,13655.0,1,13660.0,1,S
2018-04-20 09:18:50,13655.0,2,11060,0,13655.0,17,13665.0,17,S
2018-04-20 09:18:52,13655.0,4,11064,0,13655.0,18,13660.0,1,S
2018-04-20 09:18:53,13655.0,6,11070,0,13655.0,15,13665.0,9,S
2018-04-20 09:18:53,13655.0,6,11076,-6,13655.0,2,13660.0,1,S
2018-04-20 09:18:55,13655.0,2,11078,0,13655.0,1,13660.0,1,S
2018-04-20 09:18:57,13655.0,6,11084,0,13655.0,1,13660.0,3,S
2018-04-20 09:18:57,13655.0,8,11092,-4,13650.0,43,13655.0,4,S
2018-04-20 09:18:58,13655.0,2,11094,0,13650.0,46,13655.0,5,S
2018-04-20 09:18:58,13650.0,80,11174,0,13650.0,3,13655.0,13,S
2018-04-20 09:18:59,13650.0,10,11184,-2,13640.0,2,13650.0,34,S
2018-04-20 09:18:59,13650.0,2,11186,0,13640.0,9,13645.0,4,S
2018-04-20 09:19:00,13645.0,8,11194,-4,13640.0,10,13650.0,28,S
2018-04-20 09:19:00,13640.0,22,11216,-12,13640.0,4,13645.0,6,S
2018-04-20 09:19:01,13645.0,4,11220,0,13640.0,14,13645.0,10,B
2018-04-20 09:19:03,13640.0,14,11234,-2,13635.0,4,13640.0,1,S
2018-04-20 09:19:03,13640.0,6,11240,4,13635.0,19,13640.0,2,S
2018-04-20 09:19:04,13645.0,6,11246,2,13640.0,14,13650.0,11,B
2018-04-20 09:19:06,13640.0,2,11248,2,13640.0,1,13645.0,7,S
2018-04-20 09:19:09,13645.0,4,11252,0,13640.0,1,13645.0,12,B
2018-04-20 09:19:11,13640.0,2,11254,2,13635.0,6,13640.0,1,S
2018-04-20 09:19:11,13640.0,2,11256,0,13640.0,7,13645.0,4,S
2018-04-20 09:19:12,13645.0,8,11264,-6,13645.0,1,13650.0,9,B
2018-04-20 09:19:12,13645.0,2,11266,0,13640.0,33,13650.0,10,B
2018-04-20 09:19:13,13640.0,20,11286,-6,13640.0,28,13650.0,12,S
2018-04-20 09:19:15,13650.0,2,11288,0,13640.0,41,13650.0,9,B
2018-04-20 09:19:15,13650.0,2,11290,2,13640.0,42,13650.0,8,B
2018-04-20 09:19:16,13650.0,10,11300,6,13645.0,5,13650.0,3,B
2018-04-20 09:19:17,13650.0,6,11306,0,13650.0,2,13655.0,6,B
2018-04-20 09:19:17,13650.0,2,11308,2,13645.0,21,13655.0,6,B
2018-04-20 09:19:20,13650.0,2,11310,0,13645.0,10,13655.0,14,B
2018-04-20 09:19:21,13650.0,4,11314,4,13645.0,7,13650.0,2,B
2018-04-20 09:19:23,13650.0,4,11318,4,13645.0,6,13655.0,15,B
2018-04-20 09:19:25,13650.0,2,11320,0,13645.0,9,13650.0,4,B
2018-04-20 09:19:25,13650.0,4,11324,4,13645.0,9,13650.0,2,B
2018-04-20 09:19:26,13650.0,2,11326,2,13645.0,7,13650.0,4,B
2018-04-20 09:19:27,13650.0,2,11328,2,13645.0,7,13650.0,4,B
2018-04-20 09:19:30,13650.0,2,11330,-2,13645.0,7,13650.0,2,B
2018-04-20 09:19:35,13650.0,2,11332,2,13650.0,1,13655.0,1,B
2018-04-20 09:19:38,13655.0,2,11334,0,13655.0,2,13660.0,8,B
2018-04-20 09:19:41,13660.0,4,11338,4,13655.0,10,13660.0,7,B
2018-04-20 09:19:47,13655.0,2,11340,-2,13655.0,9,13660.0,10,S
2018-04-20 09:19:49,13660.0,2,11342,2,13655.0,9,13660.0,9,B
2018-04-20 09:19:51,13660.0,6,11348,2,13655.0,10,13660.0,6,B
2018-04-20 09:19:51,13655.0,2,11350,-2,13655.0,9,13660.0,7,S
2018-04-20 09:19:52,13655.0,6,11356,-2,13655.0,6,13660.0,12,S
2018-04-20 09:19:54,13660.0,2,11358,-2,13655.0,6,13660.0,11,B
2018-04-20 09:19:54,13660.0,6,11364,-2,13655.0,5,13660.0,9,B
2018-04-20 09:20:02,13655.0,2,11366,0,13655.0,8,13660.0,14,S
2018-04-20 09:20:03,13655.0,18,11384,6,13650.0,10,13660.0,20,S
2018-04-20 09:20:03,13655.0,2,11386,0,13650.0,10,13660.0,20,S
2018-04-20 09:20:05,13660.0,2,11388,0,13650.0,14,13660.0,19,B
2018-04-20 09:20:08,13660.0,6,11394,-6,13655.0,14,13660.0,6,B
2018-04-20 09:20:08,13660.0,14,11408,-2,13655.0,14,13665.0,4,B
2018-04-20 09:20:11,13665.0,4,11412,2,13660.0,17,13670.0,2,B
2018-04-20 09:20:12,13665.0,6,11418,-6,13665.0,2,13670.0,5,B
2018-04-20 09:20:14,13670.0,2,11420,2,13665.0,2,13670.0,6,B
2018-04-20 09:20:20,13670.0,6,11426,-2,13665.0,1,13670.0,10,B
2018-04-20 09:20:21,13670.0,14,11440,0,13665.0,8,13675.0,1,B
2018-04-20 09:20:23,13675.0,4,11444,-4,13670.0,10,13675.0,2,B
2018-04-20 09:20:23,13675.0,4,11448,0,13670.0,10,13675.0,1,B
2018-04-20 09:20:24,13675.0,2,11450,-2,13670.0,10,13675.0,2,B
2018-04-20 09:20:24,13675.0,4,11454,-4,13670.0,10,13675.0,1,B
2018-04-20 09:20:34,13675.0,4,11458,0,13670.0,10,13675.0,7,B
2018-04-20 09:20:36,13675.0,2,11460,0,13670.0,10,13675.0,3,B
2018-04-20 09:20:37,13675.0,2,11462,-2,13670.0,10,13675.0,2,B
2018-04-20 09:20:40,13670.0,2,11464,-2,13670.0,9,13675.0,2,S
2018-04-20 09:20:41,13675.0,2,11466,0,13670.0,9,13675.0,1,B
2018-04-20 09:20:52,13675.0,4,11470,-4,13670.0,14,13675.0,3,B
2018-04-20 09:21:00,13670.0,2,11472,0,13670.0,6,13675.0,13,S
2018-04-20 09:21:00,13670.0,2,11474,0,13670.0,5,13675.0,12,S
2018-04-20 09:21:01,13670.0,4,11478,0,13670.0,1,13675.0,12,S
2018-04-20 09:21:01,13670.0,2,11480,2,13670.0,1,13675.0,12,S
2018-04-20 09:21:10,13675.0,2,11482,0,13665.0,12,13675.0,8,B
2018-04-20 09:21:37,13670.0,4,11486,2,13670.0,7,13675.0,6,S
2018-04-20 09:21:38,13670.0,2,11488,0,13670.0,6,13675.0,5,S
2018-04-20 09:21:42,13675.0,2,11490,-2,13670.0,6,13675.0,5,B
2018-04-20 09:21:54,13670.0,2,11492,0,13670.0,3,13675.0,5,S
2018-04-20 09:21:55,13675.0,2,11494,-2,13670.0,3,13675.0,4,B
2018-04-20 09:22:06,13670.0,6,11500,0,13665.0,12,13670.0,1,S
2018-04-20 09:22:08,13665.0,2,11502,0,13665.0,2,13670.0,12,S
2018-04-20 09:22:13,13665.0,2,11504,2,13665.0,3,13670.0,9,S
2018-04-20 09:22:24,13670.0,2,11506,0,13665.0,7,13670.0,7,B
2018-04-20 09:22:26,13670.0,2,11508,0,13665.0,9,13670.0,3,B
2018-04-20 09:22:35,13670.0,6,11514,-4,13670.0,1,13675.0,13,B
2018-04-20 09:22:36,13670.0,2,11516,-2,13665.0,5,13675.0,13,B
2018-04-20 09:22:38,13675.0,2,11518,0,13665.0,9,13675.0,10,B
2018-04-20 09:22:41,13670.0,2,11520,0,13665.0,9,13675.0,10,S
2018-04-20 09:22:47,13670.0,2,11522,-2,13670.0,11,13675.0,4,S
2018-04-20 09:22:51,13675.0,8,11530,0,13670.0,13,13680.0,8,B
2018-04-20 09:22:52,13680.0,12,11542,-6,13675.0,21,13685.0,3,B
2018-04-20 09:22:56,13675.0,4,11546,0,13675.0,25,13685.0,6,S
2018-04-20 09:23:00,13685.0,4,11550,4,13680.0,11,13690.0,20,B
2018-04-20 09:23:09,13685.0,2,11552,2,13685.0,1,13690.0,27,B
2018-04-20 09:23:18,13685.0,2,11554,0,13685.0,3,13690.0,28,B
2018-04-20 09:23:19,13685.0,2,11556,2,13685.0,2,13690.0,28,B
2018-04-20 09:23:19,13690.0,2,11558,0,13685.0,3,13690.0,27,B
2018-04-20 09:23:22,13685.0,2,11560,0,13685.0,2,13690.0,27,S
2018-04-20 09:23:27,13690.0,2,11562,0,13685.0,2,13690.0,25,B
2018-04-20 09:23:30,13685.0,6,11568,2,13680.0,4,13685.0,2,S
2018-04-20 09:23:36,13690.0,2,11570,-2,13685.0,1,13690.0,38,B
2018-04-20 09:23:37,13690.0,6,11576,0,13680.0,2,13690.0,37,B
2018-04-20 09:23:46,13685.0,2,11578,0,13680.0,3,13685.0,8,S
2018-04-20 09:23:49,13680.0,2,11580,0,13680.0,2,13685.0,10,S
2018-04-20 09:23:56,13680.0,10,11590,10,13675.0,10,13680.0,2,S
2018-04-20 09:24:03,13680.0,4,11594,0,13675.0,9,13680.0,6,S
2018-04-20 09:24:26,13680.0,2,11596,-2,13675.0,8,13680.0,5,S
2018-04-20 09:24:30,13680.0,2,11598,-2,13675.0,13,13685.0,11,S
2018-04-20 09:24:32,13680.0,4,11602,-4,13680.0,2,13685.0,13,S
2018-04-20 09:24:42,13685.0,2,11604,2,13680.0,3,13685.0,12,B
2018-04-20 09:24:48,13680.0,6,11610,-4,13675.0,8,13685.0,31,S
2018-04-20 09:25:03,13680.0,4,11614,0,13680.0,1,13685.0,11,S
2018-04-20 09:25:05,13680.0,2,11616,2,13675.0,6,13680.0,3,S
2018-04-20 09:25:18,13680.0,2,11618,2,13675.0,4,13680.0,5,S
2018-04-20 09:25:29,13680.0,2,11620,2,13675.0,4,13680.0,8,S
2018-04-20 09:25:43,13675.0,8,11628,-2,13670.0,9,13675.0,1,S
2018-04-20 09:25:43,13675.0,2,11630,-2,13675.0,2,13680.0,4,S
2018-04-20 09:25:45,13680.0,8,11638,8,13680.0,1,13685.0,33,B
2018-04-20 09:25:45,13680.0,2,11640,2,13675.0,2,13680.0,2,B
2018-04-20 09:26:06,13670.0,2,11642,0,13670.0,1,13675.0,9,S
2018-04-20 09:26:13,13675.0,4,11646,0,13665.0,6,13675.0,8,B
2018-04-20 09:26:14,13675.0,10,11656,-4,13675.0,1,13680.0,12,B
2018-04-20 09:26:18,13675.0,4,11660,0,13675.0,1,13680.0,8,B
2018-04-20 09:26:21,13675.0,2,11662,2,13675.0,3,13680.0,3,B
2018-04-20 09:26:21,13680.0,4,11666,0,13675.0,8,13680.0,1,B
2018-04-20 09:26:22,13680.0,2,11668,0,13680.0,3,13685.0,7,B
2018-04-20 09:26:28,13680.0,2,11670,0,13670.0,12,13680.0,5,B
2018-04-20 09:26:33,13670.0,20,11690,2,13670.0,2,13680.0,6,S
2018-04-20 09:26:35,13670.0,20,11710,16,13675.0,1,13680.0,2,S
2018-04-20 09:26:38,13670.0,8,11718,2,13665.0,11,13670.0,6,S
2018-04-20 09:26:38,13670.0,12,11730,4,13670.0,7,13675.0,1,S
2018-04-20 09:26:40,13670.0,14,11744,10,13665.0,27,13670.0,3,S
2018-04-20 09:26:40,13670.0,14,11758,0,13665.0,45,13670.0,2,S
2018-04-20 09:26:41,13670.0,4,11762,0,13670.0,3,13680.0,5,S
2018-04-20 09:26:42,13670.0,2,11764,0,13665.0,11,13670.0,9,S
2018-04-20 09:26:43,13680.0,52,11816,-20,13680.0,26,13685.0,7,B
2018-04-20 09:26:44,13680.0,52,11868,-28,13675.0,1,13680.0,8,B
2018-04-20 09:26:51,13680.0,2,11870,0,13670.0,8,13680.0,11,B
2018-04-20 09:26:55,13670.0,2,11872,0,13670.0,12,13680.0,18,S
2018-04-20 09:27:01,13670.0,2,11874,0,13670.0,11,13680.0,19,S
2018-04-20 09:27:02,13670.0,2,11876,2,13670.0,10,13680.0,20,S
2018-04-20 09:27:02,13670.0,2,11878,2,13670.0,9,13680.0,21,S
2018-04-20 09:27:03,13670.0,2,11880,0,13670.0,8,13680.0,21,S
2018-04-20 09:27:11,13670.0,18,11898,10,13665.0,14,13670.0,1,S
2018-04-20 09:27:12,13670.0,2,11900,0,13670.0,10,13675.0,4,S
2018-04-20 09:27:12,13675.0,2,11902,0,13670.0,10,13675.0,3,B
2018-04-20 09:27:14,13670.0,20,11922,0,13665.0,17,13675.0,3,S
2018-04-20 09:27:15,13670.0,6,11928,2,13665.0,17,13670.0,7,S
2018-04-20 09:27:15,13670.0,4,11932,4,13665.0,17,13670.0,5,S
2018-04-20 09:27:16,13670.0,6,11938,0,13665.0,17,13670.0,2,S
2018-04-20 09:27:20,13670.0,4,11942,0,13670.0,1,13675.0,5,S
2018-04-20 09:27:20,13675.0,2,11944,0,13670.0,5,13675.0,4,B
2018-04-20 09:27:23,13670.0,10,11954,10,13670.0,5,13675.0,2,S
2018-04-20 09:27:26,13670.0,8,11962,8,13665.0,24,13675.0,8,S
2018-04-20 09:27:33,13670.0,2,11964,2,13665.0,21,13670.0,1,S
2018-04-20 09:27:35,13670.0,2,11966,2,13670.0,5,13675.0,5,S
2018-04-20 09:27:53,13675.0,2,11968,-2,13670.0,19,13680.0,6,B
2018-04-20 09:28:16,13675.0,10,11978,8,13675.0,6,13680.0,4,B
2018-04-20 09:28:25,13675.0,4,11982,4,13675.0,4,13680.0,4,B
2018-04-20 09:28:33,13680.0,10,11992,2,13675.0,5,13680.0,2,B
2018-04-20 09:28:37,13680.0,2,11994,0,13675.0,8,13680.0,2,B
2018-04-20 09:28:41,13680.0,2,11996,2,13680.0,1,13685.0,10,B
2018-04-20 09:28:41,13680.0,2,11998,2,13675.0,5,13685.0,10,B
2018-04-20 09:28:45,13675.0,2,12000,-2,13670.0,26,13680.0,12,S
2018-04-20 09:28:53,13675.0,8,12008,8,13670.0,30,13680.0,12,S
2018-04-20 09:29:01,13675.0,8,12016,2,13670.0,27,13675.0,6,S
2018-04-20 09:29:12,13675.0,12,12028,12,13670.0,28,13680.0,8,S
2018-04-20 09:29:17,13675.0,2,12030,0,13675.0,3,13680.0,4,S
2018-04-20 09:29:22,13680.0,2,12032,0,13675.0,10,13680.0,1,B
2018-04-20 09:29:25,13680.0,2,12034,0,13675.0,13,13685.0,8,B
2018-04-20 09:29:40,13680.0,4,12038,-2,13670.0,25,13680.0,8,B
2018-04-20 09:29:46,13670.0,2,12040,-2,13670.0,24,13680.0,10,S
2018-04-20 09:29:54,13670.0,2,12042,0,13670.0,23,13680.0,10,S
2018-04-20 09:30:27,13685.0,2,12044,2,13680.0,17,13690.0,19,B
2018-04-20 09:30:28,13680.0,4,12048,4,13680.0,19,13690.0,24,S
2018-04-20 09:30:42,13685.0,2,12050,2,13680.0,19,13690.0,15,B
2018-04-20 09:30:45,13685.0,4,12054,4,13680.0,17,13685.0,2,B
2018-04-20 09:30:52,13685.0,2,12056,2,13680.0,17,13685.0,2,B
2018-04-20 09:30:58,13685.0,4,12060,2,13685.0,2,13690.0,17,B
2018-04-20 09:30:59,13690.0,2,12062,0,13685.0,12,13690.0,16,B
2018-04-20 09:31:03,13685.0,4,12066,0,13685.0,1,13690.0,22,S
2018-04-20 09:31:08,13690.0,2,12068,0,13685.0,5,13690.0,17,B
2018-04-20 09:31:22,13690.0,2,12070,-2,13685.0,7,13690.0,14,B
2018-04-20 09:31:28,13685.0,2,12072,0,13680.0,20,13690.0,21,S
2018-04-20 09:31:34,13685.0,2,12074,-2,13680.0,16,13690.0,19,S
2018-04-20 09:31:38,13685.0,2,12076,0,13680.0,19,13690.0,20,S
2018-04-20 09:31:49,13685.0,2,12078,0,13680.0,12,13690.0,22,S
2018-04-20 09:32:11,13690.0,2,12080,0,13685.0,9,13690.0,14,B
2018-04-20 09:32:16,13690.0,2,12082,-2,13685.0,9,13690.0,13,B
2018-04-20 09:32:32,13690.0,2,12084,-2,13685.0,9,13690.0,11,B
2018-04-20 09:32:45,13685.0,6,12090,0,13685.0,6,13690.0,9,S
2018-04-20 09:33:02,13685.0,2,12092,-2,13685.0,4,13690.0,9,S
2018-04-20 09:33:04,13685.0,6,12098,2,13680.0,20,13685.0,4,S
2018-04-20 09:33:05,13680.0,16,12114,2,13675.0,5,13685.0,18,S
2018-04-20 09:33:30,13680.0,2,12116,0,13680.0,1,13685.0,7,S
2018-04-20 09:33:34,13685.0,2,12118,2,13685.0,3,13690.0,14,B
2018-04-20 09:33:36,13685.0,4,12122,0,13680.0,19,13690.0,15,B
2018-04-20 09:33:46,13680.0,6,12128,0,13680.0,3,13685.0,9,S
2018-04-20 09:33:54,13680.0,2,12130,0,13680.0,4,13685.0,9,S
2018-04-20 09:34:04,13680.0,2,12132,2,13680.0,3,13685.0,9,S
2018-04-20 09:34:09,13680.0,6,12138,0,13675.0,23,13680.0,2,S
2018-04-20 09:34:10,13680.0,4,12142,4,13680.0,1,13685.0,12,S
2018-04-20 09:34:11,13680.0,8,12150,-2,13680.0,1,13685.0,11,S
2018-04-20 09:34:13,13680.0,2,12152,-2,13680.0,5,13685.0,11,S
2018-04-20 09:34:13,13680.0,10,12162,0,13675.0,18,13685.0,13,S
2018-04-20 09:34:14,13675.0,10,12172,4,13675.0,17,13685.0,13,S
2018-04-20 09:34:24,13680.0,2,12174,0,13680.0,2,13685.0,14,B
2018-04-20 09:34:25,13680.0,4,12178,4,13675.0,11,13680.0,6,B
2018-04-20 09:34:37,13680.0,2,12180,2,13675.0,1,13680.0,5,B
2018-04-20 09:34:37,13675.0,2,12182,0,13670.0,23,13680.0,5,S
2018-04-20 09:34:53,13675.0,2,12184,0,13670.0,20,13680.0,8,S
2018-04-20 09:34:59,13670.0,2,12186,-2,13670.0,16,13675.0,2,S
2018-04-20 09:35:12,13675.0,2,12188,0,13675.0,2,13680.0,6,B
2018-04-20 09:35:43,13680.0,2,12190,-2,13675.0,3,13680.0,3,B
2018-04-20 09:35:49,13680.0,2,12192,0,13675.0,3,13680.0,3,B
2018-04-20 09:35:49,13675.0,2,12194,2,13675.0,2,13680.0,3,S
2018-04-20 09:35:59,13680.0,12,12206,4,13675.0,5,13685.0,27,B
2018-04-20 09:36:01,13685.0,2,12208,2,13680.0,6,13685.0,4,B
2018-04-20 09:36:02,13685.0,2,12210,0,13680.0,7,13685.0,3,B
2018-04-20 09:36:09,13680.0,2,12212,0,13680.0,4,13685.0,6,S
2018-04-20 09:36:15,13685.0,8,12220,2,13680.0,5,13690.0,25,B
2018-04-20 09:36:29,13690.0,2,12222,-2,13685.0,1,13690.0,8,B
2018-04-20 09:36:31,13690.0,2,12224,0,13685.0,3,13690.0,7,B
2018-04-20 09:36:31,13685.0,2,12226,2,13685.0,2,13690.0,7,S
2018-04-20 09:36:52,13685.0,4,12230,4,13685.0,3,13690.0,7,S
2018-04-20 09:36:58,13685.0,2,12232,0,13685.0,1,13690.0,8,S
2018-04-20 09:36:59,13685.0,2,12234,2,13680.0,17,13690.0,9,S
2018-04-20 09:37:16,13680.0,6,12240,-6,13675.0,7,13685.0,12,S
2018-04-20 09:37:28,13680.0,6,12246,4,13675.0,21,13680.0,7,S
2018-04-20 09:37:59,13680.0,26,12272,18,13675.0,37,13680.0,6,S
2018-04-20 09:37:59,13680.0,6,12278,4,13675.0,37,13680.0,2,S
2018-04-20 09:38:00,13680.0,2,12280,0,13675.0,24,13680.0,3,S
2018-04-20 09:38:05,13680.0,4,12284,4,13675.0,24,13685.0,13,S
2018-04-20 09:38:17,13685.0,4,12288,4,13680.0,16,13685.0,8,B
2018-04-20 09:38:21,13685.0,4,12292,2,13680.0,19,13685.0,6,B
2018-04-20 09:38:22,13685.0,12,12304,6,13685.0,1,13690.0,25,B
2018-04-20 09:38:25,13690.0,2,12306,-2,13685.0,17,13690.0,6,B
2018-04-20 09:38:32,13690.0,2,12308,0,13685.0,3,13690.0,12,B
2018-04-20 09:38:35,13690.0,2,12310,0,13685.0,16,13690.0,6,B
2018-04-20 09:38:51,13690.0,2,12312,0,13685.0,22,13690.0,3,B
2018-04-20 09:39:10,13690.0,2,12314,0,13685.0,23,13690.0,3,B
2018-04-20 09:39:11,13690.0,2,12316,2,13685.0,23,13690.0,2,B
2018-04-20 09:39:11,13690.0,4,12320,2,13685.0,23,13695.0,16,B
2018-04-20 09:39:48,13695.0,2,12322,2,13690.0,9,13695.0,23,B
2018-04-20 09:39:59,13690.0,2,12324,0,13690.0,9,13695.0,22,S
2018-04-20 09:40:00,13690.0,12,12336,6,13690.0,3,13695.0,34,S
2018-04-20 09:40:01,13690.0,2,12338,2,13690.0,1,13695.0,23,S
2018-04-20 09:40:01,13690.0,2,12340,-2,13685.0,27,13695.0,23,S
2018-04-20 09:40:04,13695.0,8,12348,-4,13685.0,17,13690.0,1,B
2018-04-20 09:40:12,13690.0,4,12352,4,13690.0,28,13695.0,21,S
2018-04-20 09:40:12,13690.0,16,12368,14,13690.0,20,13695.0,21,S
2018-04-20 09:40:20,13690.0,2,12370,0,13690.0,20,13695.0,20,S
2018-04-20 09:40:23,13695.0,40,12410,28,13690.0,19,13695.0,6,B
2018-04-20 09:40:24,13690.0,4,12414,0,13690.0,18,13695.0,5,S
2018-04-20 09:40:27,13690.0,2,12416,0,13690.0,17,13695.0,10,S
2018-04-20 09:40:47,13690.0,2,12418,2,13690.0,15,13695.0,30,S
2018-04-20 09:41:10,13690.0,30,12448,16,13685.0,7,13695.0,63,S
2018-04-20 09:41:13,13690.0,10,12458,-6,13685.0,14,13695.0,37,S
2018-04-20 09:41:27,13690.0,4,12462,0,13685.0,13,13690.0,21,S
2018-04-20 09:41:27,13690.0,30,12492,-10,13685.0,22,13690.0,6,S
2018-04-20 09:41:38,13685.0,2,12494,2,13685.0,5,13690.0,6,S
2018-04-20 09:42:04,13690.0,4,12498,0,13685.0,6,13690.0,4,B
2018-04-20 09:42:58,13690.0,2,12500,0,13685.0,5,13690.0,5,B
2018-04-20 09:43:02,13690.0,6,12506,-6,13690.0,3,13695.0,12,B
2018-04-20 09:43:37,13695.0,8,12514,-4,13690.0,22,13695.0,4,B
2018-04-20 09:43:38,13695.0,8,12522,8,13695.0,2,13700.0,24,B
2018-04-20 09:43:42,13695.0,2,12524,-2,13695.0,2,13700.0,23,B
2018-04-20 09:43:48,13700.0,2,12526,0,13695.0,1,13700.0,22,B
2018-04-20 09:43:49,13700.0,2,12528,2,13695.0,1,13700.0,21,B
2018-04-20 09:43:52,13695.0,2,12530,0,13690.0,15,13695.0,2,S
2018-04-20 09:43:59,13695.0,4,12534,-2,13690.0,5,13700.0,48,S
2018-04-20 09:44:09,13700.0,12,12546,10,13690.0,6,13700.0,46,B
2018-04-20 09:44:24,13695.0,2,12548,0,13695.0,6,13700.0,30,S
2018-04-20 09:44:30,13695.0,8,12556,-2,13690.0,21,13700.0,42,S
2018-04-20 09:44:42,13690.0,2,12558,0,13690.0,11,13700.0,42,S
2018-04-20 09:44:52,13695.0,4,12562,0,13690.0,9,13695.0,2,B
2018-04-20 09:45:18,13695.0,8,12570,4,13690.0,5,13695.0,1,B
2018-04-20 09:45:43,13695.0,4,12574,0,13695.0,3,13700.0,45,B
2018-04-20 09:45:43,13690.0,8,12582,-2,13690.0,8,13700.0,45,S
2018-04-20 09:45:52,13690.0,4,12586,4,13690.0,6,13695.0,2,S
2018-04-20 09:46:12,13695.0,4,12590,-2,13695.0,2,13700.0,42,B
2018-04-20 09:46:13,13700.0,8,12598,0,13695.0,6,13700.0,29,B
2018-04-20 09:46:18,13695.0,2,12600,-2,13695.0,7,13700.0,29,S
2018-04-20 09:46:23,13695.0,2,12602,2,13695.0,3,13700.0,29,S
2018-04-20 09:46:26,13700.0,2,12604,0,13695.0,3,13700.0,25,B
2018-04-20 09:46:28,13700.0,50,12654,-18,13700.0,1,13705.0,16,B
2018-04-20 09:46:29,13705.0,4,12658,-2,13700.0,16,13705.0,1,B
2018-04-20 09:46:30,13705.0,2,12660,0,13700.0,16,13710.0,17,B
2018-04-20 09:46:30,13710.0,2,12662,0,13700.0,13,13710.0,20,B
2018-04-20 09:46:31,13710.0,8,12670,-6,13700.0,12,13710.0,21,B
2018-04-20 09:46:36,13710.0,6,12676,-6,13710.0,1,13715.0,13,B
2018-04-20 09:46:37,13715.0,2,12678,2,13710.0,11,13720.0,15,B
2018-04-20 09:46:39,13710.0,2,12680,2,13705.0,7,13715.0,19,S
2018-04-20 09:46:50,13705.0,2,12682,-2,13700.0,22,13705.0,1,S
2018-04-20 09:47:16,13705.0,8,12690,2,13705.0,1,13710.0,16,S
2018-04-20 09:47:19,13705.0,2,12692,0,13705.0,1,13710.0,10,S
2018-04-20 09:47:28,13710.0,4,12696,2,13705.0,7,13715.0,14,B
2018-04-20 09:47:32,13715.0,28,12724,12,13715.0,11,13720.0,44,B
2018-04-20 09:47:32,13715.0,22,12746,20,13710.0,1,13720.0,54,B
2018-04-20 09:47:43,13710.0,4,12750,-2,13705.0,26,13715.0,7,S
2018-04-20 09:47:45,13715.0,2,12752,0,13705.0,13,13715.0,6,B
2018-04-20 09:47:52,13715.0,2,12754,2,13715.0,1,13720.0,13,B
2018-04-20 09:47:57,13720.0,4,12758,0,13710.0,12,13720.0,6,B
2018-04-20 09:47:57,13720.0,2,12760,0,13710.0,12,13720.0,5,B
2018-04-20 09:48:02,13715.0,2,12762,0,13710.0,14,13720.0,6,S
2018-04-20 09:48:06,13710.0,16,12778,6,13705.0,28,13715.0,5,S
2018-04-20 09:48:17,13715.0,2,12780,-2,13710.0,4,13715.0,10,B
2018-04-20 09:48:18,13715.0,10,12790,-6,13710.0,4,13715.0,5,B
2018-04-20 09:48:20,13715.0,2,12792,0,13715.0,4,13720.0,16,B
2018-04-20 09:48:22,13720.0,10,12802,-2,13715.0,4,13720.0,13,B
2018-04-20 09:48:22,13720.0,10,12812,-8,13715.0,4,13720.0,26,B
2018-04-20 09:48:23,13715.0,2,12814,0,13715.0,3,13720.0,45,S
2018-04-20 09:48:23,13715.0,6,12820,-6,13710.0,6,13720.0,45,S
2018-04-20 09:48:33,13710.0,4,12824,0,13710.0,5,13720.0,37,S
2018-04-20 09:48:42,13710.0,2,12826,2,13710.0,3,13715.0,3,S
2018-04-20 09:49:09,13710.0,2,12828,2,13710.0,1,13715.0,5,S
2018-04-20 09:49:17,13715.0,10,12838,0,13710.0,12,13720.0,14,B
2018-04-20 09:49:24,13715.0,2,12840,0,13715.0,8,13720.0,12,B
2018-04-20 09:49:32,13715.0,8,12848,0,13715.0,3,13720.0,43,B
2018-04-20 09:49:32,13715.0,6,12854,-6,13710.0,5,13720.0,43,B
2018-04-20 09:49:40,13715.0,4,12858,-2,13715.0,3,13720.0,53,B
2018-04-20 09:49:40,13715.0,6,12864,0,13710.0,4,13720.0,53,B
2018-04-20 09:49:45,13715.0,2,12866,0,13710.0,13,13720.0,18,B
2018-04-20 09:50:33,13715.0,8,12874,0,13715.0,1,13720.0,48,B
2018-04-20 09:50:33,13715.0,2,12876,-2,13710.0,8,13720.0,57,B
2018-04-20 09:50:55,13720.0,20,12896,6,13715.0,5,13720.0,16,B
2018-04-20 09:50:57,13720.0,2,12898,2,13715.0,5,13720.0,15,B
2018-04-20 09:51:06,13720.0,6,12904,0,13715.0,9,13720.0,11,B
2018-04-20 09:51:06,13720.0,20,12924,-4,13715.0,10,13725.0,17,B
2018-04-20 09:51:14,13720.0,4,12928,-4,13720.0,3,13725.0,22,B
2018-04-20 09:51:16,13725.0,10,12938,0,13720.0,4,13725.0,12,B
2018-04-20 09:51:17,13725.0,10,12948,0,13720.0,4,13725.0,7,B
2018-04-20 09:51:20,13725.0,10,12958,-4,13715.0,11,13725.0,15,B
2018-04-20 09:51:20,13725.0,14,12972,-4,13715.0,15,13725.0,8,B
2018-04-20 09:51:21,13725.0,8,12980,-8,13715.0,15,13725.0,5,B
2018-04-20 09:51:24,13725.0,10,12990,-10,13715.0,15,13725.0,2,B
2018-04-20 09:51:24,13725.0,8,12998,-8,13725.0,1,13730.0,36,B
2018-04-20 09:51:25,13725.0,2,13000,0,13720.0,4,13725.0,10,B
2018-04-20 09:51:25,13720.0,2,13002,0,13720.0,3,13725.0,10,S
2018-04-20 09:51:26,13725.0,10,13012,-4,13720.0,3,13725.0,20,B
2018-04-20 09:51:27,13725.0,10,13022,-8,13720.0,3,13725.0,14,B
2018-04-20 09:51:28,13725.0,10,13032,-10,13720.0,10,13725.0,9,B
2018-04-20 09:51:29,13725.0,10,13042,-10,13720.0,10,13725.0,4,B
2018-04-20 09:51:30,13725.0,10,13052,-10,13720.0,10,13725.0,2,B
2018-04-20 09:51:31,13725.0,2,13054,-2,13720.0,12,13725.0,1,B
2018-04-20 09:51:31,13725.0,2,13056,0,13725.0,2,13730.0,7,B
2018-04-20 09:51:32,13730.0,10,13066,-6,13725.0,6,13730.0,6,B
2018-04-20 09:51:37,13730.0,10,13076,-10,13725.0,6,13730.0,2,B
2018-04-20 09:51:47,13730.0,22,13098,-10,13725.0,12,13730.0,1,B
2018-04-20 09:51:48,13730.0,2,13100,0,13730.0,1,13735.0,8,B
2018-04-20 09:51:50,13730.0,2,13102,0,13730.0,6,13735.0,7,B
2018-04-20 09:51:50,13735.0,12,13114,-10,13735.0,1,13740.0,35,B
2018-04-20 09:51:51,13735.0,4,13118,2,13735.0,9,13740.0,4,B
2018-04-20 09:51:51,13740.0,2,13120,-2,13735.0,6,13740.0,3,B
2018-04-20 09:51:52,13735.0,4,13124,0,13735.0,3,13740.0,3,S
2018-04-20 09:51:52,13735.0,6,13130,6,13730.0,11,13740.0,8,S
2018-04-20 09:51:57,13735.0,2,13132,0,13730.0,8,13735.0,13,S
2018-04-20 09:52:15,13730.0,4,13136,-2,13725.0,7,13735.0,22,S
2018-04-20 09:52:21,13725.0,2,13138,0,13725.0,11,13735.0,28,S
2018-04-20 09:52:24,13725.0,14,13152,-8,13720.0,12,13725.0,4,S
2018-04-20 09:52:26,13720.0,18,13170,18,13715.0,1,13720.0,4,S
2018-04-20 09:52:28,13715.0,4,13174,-2,13715.0,1,13720.0,2,S
2018-04-20 09:52:28,13720.0,4,13178,4,13715.0,2,13725.0,10,B
2018-04-20 09:52:30,13720.0,4,13182,0,13715.0,4,13725.0,10,B
2018-04-20 09:52:33,13720.0,2,13184,0,13720.0,2,13725.0,8,B
2018-04-20 09:52:36,13720.0,2,13186,0,13715.0,7,13720.0,3,B
2018-04-20 09:52:36,13715.0,2,13188,0,13715.0,6,13725.0,15,S
2018-04-20 09:52:40,13715.0,2,13190,-2,13715.0,2,13720.0,2,S
2018-04-20 09:52:40,13720.0,2,13192,2,13715.0,2,13720.0,1,B
2018-04-20 09:52:44,13715.0,6,13198,0,13710.0,4,13715.0,1,S
2018-04-20 09:52:45,13715.0,2,13200,0,13710.0,10,13720.0,15,S
2018-04-20 09:53:00,13715.0,2,13202,2,13715.0,3,13720.0,7,S
2018-04-20 09:53:02,13715.0,2,13204,0,13715.0,3,13720.0,6,S
2018-04-20 09:53:09,13715.0,2,13206,0,13715.0,2,13720.0,8,S
2018-04-20 09:53:18,13715.0,2,13208,0,13715.0,6,13720.0,5,S
2018-04-20 09:54:02,13715.0,2,13210,2,13715.0,2,13720.0,6,S
2018-04-20 09:54:07,13715.0,2,13212,0,13710.0,11,13720.0,7,S
2018-04-20 09:54:25,13720.0,2,13214,0,13715.0,7,13720.0,6,B
2018-04-20 09:54:44,13720.0,18,13232,12,13720.0,21,13725.0,10,B
2018-04-20 09:54:44,13720.0,2,13234,2,13720.0,20,13725.0,15,B
2018-04-20 09:54:46,13720.0,2,13236,0,13720.0,19,13725.0,25,B
2018-04-20 09:54:50,13720.0,4,13240,4,13720.0,17,13725.0,15,B
2018-04-20 09:54:53,13720.0,2,13242,2,13720.0,16,13725.0,15,B
2018-04-20 09:54:54,13720.0,2,13244,0,13720.0,15,13725.0,15,B
2018-04-20 09:55:09,13720.0,2,13246,0,13720.0,15,13725.0,21,B
2018-04-20 09:55:30,13725.0,36,13282,-2,13720.0,18,13725.0,3,B
2018-04-20 09:55:33,13725.0,2,13284,0,13720.0,18,13725.0,4,B
2018-04-20 09:55:44,13725.0,6,13290,2,13725.0,11,13730.0,11,B
2018-04-20 09:55:46,13730.0,2,13292,0,13725.0,10,13730.0,3,B
2018-04-20 09:55:51,13725.0,4,13296,-4,13725.0,8,13730.0,4,S
2018-04-20 09:55:52,13730.0,2,13298,2,13725.0,8,13730.0,3,B
2018-04-20 09:55:55,13725.0,6,13304,-6,13725.0,6,13730.0,5,S
2018-04-20 09:56:05,13725.0,2,13306,0,13725.0,5,13730.0,11,S
2018-04-20 09:56:37,13725.0,4,13310,-4,13720.0,23,13725.0,2,S
2018-04-20 09:56:56,13720.0,2,13312,0,13720.0,14,13725.0,10,S
2018-04-20 09:57:12,13725.0,4,13316,0,13720.0,14,13725.0,16,B
2018-04-20 09:57:29,13725.0,30,13346,30,13715.0,2,13725.0,26,B
2018-04-20 09:57:47,13720.0,2,13348,2,13710.0,12,13720.0,17,S
2018-04-20 09:57:53,13715.0,2,13350,-2,13710.0,12,13720.0,14,S
2018-04-20 09:58:00,13715.0,2,13352,-2,13710.0,14,13720.0,11,S
2018-04-20 09:58:16,13715.0,2,13354,2,13710.0,14,13720.0,10,S
2018-04-20 09:58:41,13710.0,2,13356,-2,13710.0,14,13720.0,10,S
2018-04-20 09:59:04,13710.0,30,13386,-8,13710.0,1,13715.0,5,S
2018-04-20 09:59:05,13710.0,2,13388,2,13705.0,4,13710.0,4,S
2018-04-20 09:59:07,13705.0,4,13392,-4,13705.0,3,13710.0,9,S
2018-04-20 09:59:11,13705.0,2,13394,0,13705.0,2,13710.0,9,S
2018-04-20 09:59:12,13705.0,2,13396,-2,13705.0,1,13710.0,9,S
2018-04-20 09:59:13,13705.0,4,13400,-4,13700.0,12,13710.0,9,S
2018-04-20 09:59:19,13700.0,20,13420,14,13700.0,1,13705.0,21,S
2018-04-20 09:59:21,13700.0,2,13422,0,13695.0,2,13705.0,14,S
2018-04-20 09:59:33,13700.0,2,13424,2,13695.0,5,13705.0,14,S
2018-04-20 09:59:46,13695.0,2,13426,-2,13695.0,4,13700.0,7,S
2018-04-20 09:59:46,13695.0,8,13434,-6,13690.0,7,13700.0,7,S
2018-04-20 09:59:50,13695.0,6,13440,2,13690.0,10,13700.0,17,S
2018-04-20 09:59:53,13690.0,8,13448,2,13690.0,6,13695.0,14,S
2018-04-20 10:00:03,13690.0,4,13452,0,13690.0,1,13695.0,16,S
2018-04-20 10:00:04,13690.0,2,13454,0,13685.0,8,13690.0,2,S
2018-04-20 10:00:05,13690.0,6,13460,0,13685.0,13,13695.0,16,S
2018-04-20 10:00:07,13695.0,8,13468,0,13690.0,11,13700.0,16,B
2018-04-20 10:00:11,13695.0,8,13476,0,13690.0,9,13700.0,20,B
2018-04-20 10:00:17,13700.0,4,13480,0,13690.0,8,13700.0,14,B
2018-04-20 10:00:32,13695.0,4,13484,4,13690.0,5,13700.0,13,S
2018-04-20 10:00:52,13695.0,2,13486,-2,13690.0,9,13700.0,17,S
2018-04-20 10:00:53,13695.0,2,13488,0,13695.0,1,13700.0,17,S
2018-04-20 10:01:00,13700.0,2,13490,0,13695.0,4,13700.0,15,B
2018-04-20 10:01:19,13700.0,6,13496,2,13695.0,6,13700.0,12,B
2018-04-20 10:01:21,13695.0,2,13498,0,13695.0,6,13700.0,12,S
2018-04-20 10:01:35,13700.0,2,13500,2,13695.0,6,13700.0,11,B
2018-04-20 10:01:35,13695.0,6,13506,-2,13695.0,3,13700.0,11,S
2018-04-20 10:01:38,13695.0,2,13508,2,13695.0,2,13700.0,11,S
2018-04-20 10:01:46,13695.0,8,13516,4,13690.0,10,13695.0,5,S
2018-04-20 10:01:49,13695.0,4,13520,0,13690.0,12,13695.0,2,S
2018-04-20 10:01:49,13695.0,4,13524,0,13695.0,1,13700.0,9,S
2018-04-20 10:02:40,13695.0,6,13530,0,13690.0,9,13700.0,5,S
2018-04-20 10:02:51,13700.0,8,13538,-8,13695.0,9,13705.0,7,B
2018-04-20 10:03:28,13705.0,4,13542,2,13705.0,1,13710.0,6,B
2018-04-20 10:03:28,13705.0,2,13544,0,13700.0,8,13710.0,7,B
2018-04-20 10:03:30,13710.0,2,13546,2,13700.0,8,13710.0,6,B
2018-04-20 10:04:04,13710.0,2,13548,-2,13700.0,12,13710.0,19,B
2018-04-20 10:05:16,13705.0,8,13556,-4,13700.0,4,13705.0,5,S
2018-04-20 10:05:17,13700.0,2,13558,0,13700.0,3,13705.0,5,S
2018-04-20 10:05:30,13700.0,2,13560,0,13700.0,2,13705.0,4,S
2018-04-20 10:05:31,13705.0,2,13562,0,13700.0,2,13705.0,5,B
2018-04-20 10:05:35,13705.0,2,13564,2,13700.0,2,13705.0,4,B
2018-04-20 10:05:47,13705.0,2,13566,0,13700.0,2,13705.0,5,B
2018-04-20 10:05:51,13700.0,4,13570,-4,13700.0,1,13705.0,4,S
2018-04-20 10:06:01,13700.0,2,13572,-2,13695.0,2,13705.0,4,S
2018-04-20 10:06:02,13705.0,6,13578,2,13695.0,8,13705.0,1,B
2018-04-20 10:06:15,13705.0,2,13580,0,13700.0,1,13705.0,2,B
2018-04-20 10:06:23,13700.0,2,13582,2,13700.0,1,13705.0,2,S
2018-04-20 10:06:26,13705.0,4,13586,-2,13700.0,1,13710.0,51,B
2018-04-20 10:07:01,13705.0,2,13588,0,13705.0,4,13710.0,16,B
2018-04-20 10:07:08,13710.0,2,13590,2,13705.0,5,13710.0,3,B
2018-04-20 10:07:09,13705.0,10,13600,0,13700.0,8,13705.0,5,S
2018-04-20 10:07:10,13705.0,10,13610,-6,13705.0,5,13710.0,2,S
2018-04-20 10:07:27,13705.0,2,13612,0,13705.0,1,13710.0,9,S
2018-04-20 10:08:05,13705.0,2,13614,-2,13700.0,14,13705.0,1,S
2018-04-20 10:08:06,13705.0,2,13616,-2,13700.0,14,13710.0,9,S
2018-04-20 10:08:17,13710.0,4,13620,2,13705.0,13,13715.0,17,B
2018-04-20 10:08:29,13715.0,4,13624,4,13705.0,12,13715.0,17,B
2018-04-20 10:08:50,13715.0,6,13630,-2,13705.0,12,13715.0,4,B
2018-04-20 10:09:04,13715.0,8,13638,-8,13710.0,13,13720.0,4,B
2018-04-20 10:09:12,13720.0,2,13640,0,13715.0,3,13720.0,1,B
2018-04-20 10:09:19,13720.0,4,13644,0,13715.0,8,13725.0,11,B
2018-04-20 10:09:24,13720.0,2,13646,-2,13720.0,1,13725.0,7,B
2018-04-20 10:09:43,13720.0,2,13648,-2,13720.0,1,13725.0,8,B
2018-04-20 10:10:04,13725.0,12,13660,2,13720.0,11,13725.0,3,B
2018-04-20 10:10:05,13725.0,6,13666,4,13720.0,12,13730.0,11,B
2018-04-20 10:10:11,13725.0,2,13668,-2,13725.0,1,13730.0,13,B
2018-04-20 10:10:20,13720.0,20,13688,8,13720.0,1,13725.0,8,S
2018-04-20 10:10:21,13720.0,2,13690,0,13715.0,7,13725.0,10,S
2018-04-20 10:10:41,13725.0,2,13692,0,13715.0,9,13725.0,12,B
2018-04-20 10:10:43,13715.0,4,13696,4,13715.0,4,13720.0,29,S
2018-04-20 10:10:44,13715.0,8,13704,-4,13710.0,5,13720.0,33,S
2018-04-20 10:11:16,13710.0,2,13706,0,13710.0,6,13715.0,9,S
2018-04-20 10:11:22,13710.0,12,13718,0,13705.0,14,13715.0,4,S
2018-04-20 10:11:24,13715.0,2,13720,-2,13710.0,18,13715.0,7,B
2018-04-20 10:11:24,13715.0,8,13728,2,13710.0,19,13715.0,3,B
2018-04-20 10:11:28,13715.0,2,13730,0,13710.0,6,13715.0,2,B
2018-04-20 10:11:31,13715.0,2,13732,0,13710.0,9,13715.0,1,B
2018-04-20 10:11:32,13715.0,18,13750,2,13705.0,4,13715.0,3,B
2018-04-20 10:11:34,13710.0,2,13752,0,13705.0,3,13710.0,17,S
2018-04-20 10:11:36,13710.0,2,13754,2,13705.0,2,13710.0,7,S
2018-04-20 10:11:52,13705.0,2,13756,-2,13700.0,6,13710.0,10,S
2018-04-20 10:11:54,13710.0,2,13758,0,13700.0,6,13710.0,9,B
2018-04-20 10:11:55,13700.0,2,13760,0,13700.0,5,13710.0,9,S
2018-04-20 10:12:02,13710.0,4,13764,-4,13705.0,3,13715.0,10,B
2018-04-20 10:12:05,13705.0,10,13774,4,13700.0,7,13705.0,21,S
2018-04-20 10:12:06,13705.0,42,13816,36,13705.0,1,13710.0,1,S
2018-04-20 10:12:07,13710.0,4,13820,0,13705.0,5,13715.0,18,B
2018-04-20 10:12:25,13715.0,2,13822,0,13710.0,8,13715.0,3,B
2018-04-20 10:12:37,13715.0,2,13824,0,13710.0,6,13715.0,2,B
2018-04-20 10:13:10,13715.0,2,13826,0,13710.0,8,13715.0,2,B
2018-04-20 10:13:22,13710.0,14,13840,0,13705.0,5,13715.0,17,S
2018-04-20 10:13:30,13710.0,8,13848,8,13705.0,7,13715.0,17,S
2018-04-20 10:13:37,13705.0,6,13854,4,13700.0,7,13710.0,28,S
2018-04-20 10:14:10,13700.0,4,13858,0,13700.0,6,13705.0,4,S
2018-04-20 10:14:14,13705.0,8,13866,8,13705.0,1,13710.0,19,B
2018-04-20 10:14:14,13705.0,2,13868,2,13700.0,7,13705.0,4,B
2018-04-20 10:14:19,13705.0,2,13870,2,13700.0,8,13710.0,19,B
2018-04-20 10:14:21,13705.0,2,13872,0,13705.0,1,13710.0,19,B
2018-04-20 10:14:22,13705.0,2,13874,-2,13700.0,8,13705.0,2,B
2018-04-20 10:14:55,13700.0,2,13876,2,13700.0,8,13710.0,15,S
2018-04-20 10:14:57,13710.0,2,13878,0,13700.0,7,13710.0,14,B
2018-04-20 10:30:01,13700.0,4,13882,-2,13700.0,6,13705.0,3,S
2018-04-20 10:30:01,13700.0,12,13894,6,13695.0,3,13705.0,18,S
2018-04-20 10:30:03,13705.0,2,13896,2,13695.0,4,13705.0,17,B
2018-04-20 10:30:05,13705.0,2,13898,-2,13700.0,8,13710.0,7,B
2018-04-20 10:30:06,13705.0,2,13900,0,13700.0,8,13710.0,16,B
2018-04-20 10:30:14,13700.0,2,13902,0,13700.0,5,13710.0,15,S
2018-04-20 10:30:18,13700.0,4,13906,-4,13700.0,5,13705.0,1,S
2018-04-20 10:30:28,13700.0,2,13908,0,13700.0,5,13705.0,2,S
2018-04-20 10:30:46,13705.0,4,13912,-2,13700.0,6,13710.0,13,B
2018-04-20 10:30:59,13700.0,2,13914,-2,13695.0,5,13705.0,8,S
2018-04-20 10:31:22,13695.0,4,13918,-2,13695.0,2,13700.0,12,S
2018-04-20 10:31:22,13695.0,4,13922,0,13690.0,26,13695.0,2,S
2018-04-20 10:31:45,13695.0,2,13924,-2,13695.0,2,13700.0,19,S
2018-04-20 10:31:46,13695.0,4,13928,-2,13695.0,1,13700.0,19,S
2018-04-20 10:31:47,13695.0,2,13930,-2,13690.0,29,13700.0,19,S
2018-04-20 10:32:09,13695.0,2,13932,-2,13690.0,34,13700.0,18,S
2018-04-20 10:32:15,13695.0,2,13934,-2,13695.0,2,13700.0,20,S
2018-04-20 10:32:16,13695.0,2,13936,0,13695.0,1,13700.0,20,S
2018-04-20 10:32:28,13695.0,2,13938,-2,13690.0,35,13695.0,5,S
2018-04-20 10:32:43,13690.0,2,13940,0,13690.0,33,13695.0,17,S
2018-04-20 10:32:44,13690.0,64,14004,-18,13690.0,1,13695.0,17,S
2018-04-20 10:32:44,13685.0,4,14008,0,13685.0,3,13690.0,2,S
2018-04-20 10:32:52,13685.0,2,14010,-2,13685.0,2,13690.0,9,S
2018-04-20 10:32:54,13685.0,4,14014,-2,13680.0,10,13685.0,4,S
2018-04-20 10:32:55,13685.0,4,14018,2,13680.0,19,13685.0,2,S
2018-04-20 10:32:55,13685.0,4,14022,0,13680.0,20,13690.0,23,S
2018-04-20 10:33:21,13685.0,2,14024,0,13685.0,3,13690.0,28,S
2018-04-20 10:33:25,13685.0,2,14026,2,13685.0,2,13690.0,15,S
2018-04-20 10:33:32,13690.0,14,14040,4,13690.0,1,13695.0,4,B
2018-04-20 10:33:49,13695.0,2,14042,0,13690.0,12,13700.0,13,B
2018-04-20 10:34:05,13695.0,2,14044,0,13695.0,4,13700.0,7,B
2018-04-20 10:34:32,13695.0,4,14048,4,13695.0,1,13700.0,26,B
2018-04-20 10:34:33,13695.0,2,14050,0,13690.0,11,13700.0,31,B
2018-04-20 10:34:36,13695.0,6,14056,0,13690.0,11,13700.0,24,B
2018-04-20 10:34:51,13695.0,2,14058,0,13690.0,5,13695.0,3,B
2018-04-20 10:35:12,13690.0,2,14060,0,13690.0,4,13695.0,4,S
2018-04-20 10:35:25,13695.0,8,14068,-6,13690.0,17,13700.0,7,B
2018-04-20 10:35:48,13695.0,2,14070,0,13690.0,13,13700.0,18,B
2018-04-20 10:36:14,13695.0,4,14074,-4,13695.0,5,13700.0,1,B
2018-04-20 10:36:21,13700.0,2,14076,0,13695.0,5,13705.0,22,B
2018-04-20 10:36:41,13700.0,2,14078,0,13700.0,1,13705.0,22,B
2018-04-20 10:36:42,13700.0,2,14080,0,13695.0,6,13705.0,26,B
2018-04-20 10:36:55,13695.0,12,14092,-4,13690.0,14,13700.0,20,S
2018-04-20 10:38:04,13690.0,14,14106,-8,13685.0,11,13695.0,8,S
2018-04-20 10:38:26,13690.0,4,14110,-4,13685.0,11,13695.0,27,S
2018-04-20 10:38:37,13690.0,2,14112,0,13685.0,5,13690.0,5,S
2018-04-20 10:38:44,13685.0,6,14118,-2,13680.0,10,13685.0,4,S
2018-04-20 10:38:46,13680.0,2,14120,2,13680.0,8,13685.0,4,S
2018-04-20 10:38:46,13685.0,10,14130,0,13680.0,5,13685.0,3,B
2018-04-20 10:38:47,13680.0,2,14132,0,13680.0,4,13685.0,3,S
2018-04-20 10:38:53,13685.0,6,14138,6,13680.0,11,13690.0,9,B
2018-04-20 10:38:59,13690.0,8,14146,2,13685.0,6,13695.0,43,B
2018-04-20 10:39:18,13690.0,2,14148,2,13685.0,8,13695.0,34,B
2018-04-20 10:39:26,13690.0,2,14150,0,13685.0,8,13690.0,4,B
2018-04-20 10:39:37,13690.0,6,14156,0,13685.0,3,13690.0,1,B
2018-04-20 10:39:43,13685.0,8,14164,-2,13680.0,12,13690.0,8,S
2018-04-20 10:39:46,13685.0,2,14166,0,13680.0,12,13690.0,9,S
2018-04-20 10:39:58,13680.0,4,14170,-4,13680.0,5,13685.0,8,S
2018-04-20 10:39:59,13680.0,10,14180,-2,13675.0,2,13685.0,8,S
2018-04-20 10:40:09,13675.0,2,14182,-2,13675.0,5,13680.0,1,S
2018-04-20 10:40:13,13680.0,2,14184,-2,13680.0,15,13685.0,6,B
2018-04-20 10:40:14,13685.0,12,14196,8,13685.0,2,13690.0,8,B
2018-04-20 10:40:14,13690.0,2,14198,2,13680.0,14,13690.0,11,B
2018-04-20 10:40:20,13685.0,4,14202,0,13680.0,17,13690.0,12,S
2018-04-20 10:40:59,13680.0,2,14204,0,13680.0,15,13690.0,11,S
2018-04-20 10:41:23,13690.0,2,14206,0,13685.0,1,13690.0,29,B
2018-04-20 10:41:51,13690.0,24,14230,-10,13685.0,17,13690.0,15,B
2018-04-20 10:41:52,13690.0,2,14232,0,13685.0,17,13690.0,14,B
2018-04-20 10:42:32,13690.0,2,14234,0,13685.0,2,13690.0,17,B
2018-04-20 10:42:36,13690.0,8,14242,0,13685.0,7,13690.0,11,B
2018-04-20 10:42:51,13685.0,2,14244,0,13685.0,5,13690.0,11,S
2018-04-20 10:42:57,13685.0,12,14256,-10,13680.0,17,13690.0,11,S
2018-04-20 10:43:01,13690.0,2,14258,0,13685.0,1,13690.0,10,B
2018-04-20 10:43:02,13685.0,4,14262,4,13680.0,17,13690.0,10,S
2018-04-20 10:43:33,13685.0,2,14264,0,13685.0,7,13690.0,8,S
2018-04-20 10:43:33,13685.0,2,14266,2,13685.0,6,13690.0,8,S
2018-04-20 10:43:36,13690.0,2,14268,0,13685.0,6,13690.0,7,B
2018-04-20 10:43:43,13690.0,14,14282,-12,13685.0,14,13695.0,10,B
2018-04-20 10:43:53,13695.0,6,14288,-4,13690.0,1,13695.0,2,B
2018-04-20 10:43:53,13695.0,4,14292,-4,13690.0,14,13700.0,7,B
2018-04-20 10:44:03,13690.0,2,14294,-2,13685.0,3,13695.0,11,S
2018-04-20 10:45:05,13690.0,4,14298,0,13685.0,15,13695.0,10,S
2018-04-20 10:45:27,13695.0,2,14300,2,13690.0,15,13700.0,10,B
2018-04-20 10:45:49,13695.0,6,14306,-6,13690.0,1,13695.0,3,B
2018-04-20 10:46:11,13695.0,2,14308,0,13690.0,4,13700.0,22,B
2018-04-20 10:46:47,13690.0,2,14310,2,13690.0,6,13695.0,1,S
2018-04-20 10:47:02,13690.0,2,14312,0,13690.0,3,13695.0,10,S
2018-04-20 10:47:17,13695.0,2,14314,0,13690.0,5,13700.0,11,B
2018-04-20 10:47:27,13690.0,10,14324,10,13685.0,7,13695.0,19,S
2018-04-20 10:47:50,13685.0,10,14334,6,13680.0,6,13690.0,11,S
2018-04-20 10:47:54,13680.0,4,14338,2,13675.0,3,13685.0,11,S
2018-04-20 10:48:08,13685.0,4,14342,-2,13685.0,3,13690.0,10,B
2018-04-20 10:48:08,13690.0,10,14352,-6,13685.0,3,13690.0,2,B
2018-04-20 10:48:12,13685.0,2,14354,-2,13680.0,5,13690.0,13,S
2018-04-20 10:48:35,13685.0,2,14356,-2,13685.0,1,13690.0,12,S
2018-04-20 10:49:34,13685.0,4,14360,0,13680.0,5,13685.0,1,S
2018-04-20 10:49:35,13680.0,6,14366,-2,13675.0,3,13680.0,1,S
2018-04-20 10:49:36,13680.0,2,14368,0,13675.0,7,13680.0,2,S
2018-04-20 10:49:37,13680.0,4,14372,0,13675.0,9,13685.0,20,S
2018-04-20 10:49:51,13675.0,2,14374,0,13675.0,2,13680.0,10,S
2018-04-20 10:49:51,13675.0,4,14378,-4,13670.0,9,13675.0,1,S
2018-04-20 10:49:54,13670.0,8,14386,0,13670.0,5,13675.0,15,S
2018-04-20 10:49:54,13670.0,10,14396,-6,13665.0,2,13670.0,1,S
2018-04-20 10:49:55,13665.0,2,14398,0,13665.0,3,13670.0,4,S
2018-04-20 10:49:57,13665.0,4,14402,2,13660.0,2,13665.0,2,S
2018-04-20 10:50:00,13665.0,4,14406,0,13660.0,2,13665.0,1,S
2018-04-20 10:50:02,13665.0,2,14408,0,13660.0,6,13670.0,17,S
2018-04-20 10:50:05,13665.0,8,14416,0,13665.0,1,13670.0,6,S
2018-04-20 10:50:11,13670.0,8,14424,8,13665.0,14,13675.0,6,B
2018-04-20 10:50:18,13670.0,2,14426,0,13670.0,2,13675.0,6,B
2018-04-20 10:50:35,13675.0,4,14430,4,13670.0,4,13675.0,4,B
2018-04-20 10:50:41,13675.0,2,14432,-2,13670.0,8,13680.0,4,B
2018-04-20 10:51:01,13680.0,2,14434,2,13675.0,3,13680.0,1,B
2018-04-20 10:51:17,13685.0,2,14436,2,13675.0,6,13685.0,10,B
2018-04-20 10:51:18,13675.0,2,14438,0,13675.0,2,13680.0,8,S
2018-04-20 10:51:22,13675.0,4,14442,4,13670.0,11,13675.0,1,S
2018-04-20 10:51:23,13670.0,2,14444,0,13670.0,5,13675.0,12,S
2018-04-20 10:51:27,13675.0,4,14448,4,13670.0,9,13680.0,13,B
2018-04-20 10:51:38,13675.0,10,14458,4,13675.0,5,13685.0,9,B
2018-04-20 10:51:45,13675.0,10,14468,4,13670.0,20,13685.0,11,B
2018-04-20 10:52:07,13680.0,2,14470,2,13670.0,19,13680.0,10,B
2018-04-20 10:52:12,13680.0,2,14472,0,13670.0,21,13680.0,9,B
2018-04-20 10:52:19,13680.0,2,14474,0,13670.0,14,13680.0,9,B
2018-04-20 10:52:24,13670.0,28,14502,14,13665.0,4,13675.0,9,S
2018-04-20 10:52:24,13675.0,2,14504,2,13665.0,3,13675.0,13,B
2018-04-20 10:52:38,13670.0,4,14508,0,13665.0,10,13675.0,8,S
2018-04-20 10:53:00,13660.0,2,14510,0,13660.0,16,13670.0,13,S
2018-04-20 10:53:04,13670.0,2,14512,2,13660.0,3,13670.0,17,B
2018-04-20 10:53:11,13665.0,2,14514,-2,13660.0,3,13665.0,1,S
2018-04-20 10:53:24,13665.0,2,14516,2,13660.0,8,13665.0,5,S
2018-04-20 10:53:24,13665.0,4,14520,4,13665.0,1,13670.0,12,S
2018-04-20 10:53:26,13665.0,2,14522,0,13660.0,13,13670.0,12,S
2018-04-20 10:53:41,13665.0,2,14524,-2,13660.0,15,13670.0,9,S
2018-04-20 10:53:48,13665.0,2,14526,0,13660.0,15,13665.0,3,S
2018-04-20 10:53:59,13665.0,4,14530,0,13660.0,14,13665.0,1,S
2018-04-20 10:54:05,13665.0,2,14532,-2,13665.0,2,13670.0,11,S
2018-04-20 10:54:13,13670.0,2,14534,0,13665.0,15,13670.0,6,B
2018-04-20 10:54:16,13665.0,2,14536,0,13665.0,14,13670.0,6,S
2018-04-20 10:54:25,13670.0,2,14538,0,13665.0,15,13670.0,5,B
2018-04-20 10:54:31,13670.0,2,14540,2,13665.0,24,13670.0,4,B
2018-04-20 10:54:37,13665.0,14,14554,-8,13665.0,10,13670.0,22,S
2018-04-20 10:54:37,13665.0,20,14574,12,13665.0,2,13670.0,22,S
2018-04-20 10:54:38,13665.0,4,14578,0,13660.0,8,13670.0,22,S
2018-04-20 10:54:45,13665.0,2,14580,2,13660.0,3,13665.0,13,S
2018-04-20 10:54:59,13660.0,2,14582,2,13660.0,4,13665.0,10,S
2018-04-20 10:55:01,13660.0,6,14588,2,13660.0,1,13665.0,10,S
2018-04-20 10:55:02,13660.0,2,14590,0,13655.0,5,13665.0,10,S
2018-04-20 10:55:07,13665.0,10,14600,-4,13660.0,16,13670.0,9,B
2018-04-20 10:55:15,13665.0,2,14602,2,13660.0,15,13665.0,4,B
2018-04-20 10:55:15,13665.0,2,14604,0,13660.0,8,13665.0,2,B
2018-04-20 10:55:42,13670.0,8,14612,-2,13670.0,2,13675.0,4,B
2018-04-20 10:55:46,13675.0,2,14614,2,13670.0,15,13680.0,4,B
2018-04-20 10:55:50,13670.0,8,14622,2,13665.0,10,13675.0,5,S
2018-04-20 10:55:51,13670.0,6,14628,0,13665.0,4,13670.0,2,S
2018-04-20 10:55:53,13670.0,2,14630,2,13665.0,4,13670.0,1,S
2018-04-20 10:55:55,13670.0,2,14632,0,13665.0,9,13675.0,12,S
2018-04-20 10:56:09,13665.0,2,14634,0,13665.0,8,13675.0,14,S
2018-04-20 10:56:34,13675.0,2,14636,2,13665.0,16,13675.0,13,B
2018-04-20 10:57:10,13675.0,2,14638,-2,13670.0,10,13680.0,18,B
2018-04-20 10:57:15,13680.0,8,14646,-8,13670.0,11,13680.0,14,B
2018-04-20 10:57:24,13675.0,12,14658,8,13675.0,2,13680.0,10,S
2018-04-20 10:57:26,13675.0,2,14660,0,13675.0,3,13680.0,10,S
2018-04-20 10:57:29,13680.0,10,14670,4,13675.0,3,13680.0,5,B
2018-04-20 10:57:34,13675.0,2,14672,0,13675.0,2,13680.0,6,S
2018-04-20 10:57:34,13675.0,4,14676,0,13670.0,9,13680.0,39,S
2018-04-20 10:57:38,13680.0,6,14682,2,13670.0,9,13680.0,17,B
2018-04-20 10:57:40,13680.0,4,14686,-4,13670.0,10,13680.0,3,B
2018-04-20 10:57:45,13675.0,6,14692,-6,13670.0,10,13680.0,3,S
2018-04-20 10:57:52,13675.0,2,14694,2,13675.0,1,13680.0,3,S
2018-04-20 10:58:18,13675.0,4,14698,2,13670.0,6,13680.0,33,S
2018-04-20 10:58:22,13675.0,4,14702,2,13670.0,10,13675.0,1,S
2018-04-20 10:58:28,13670.0,4,14706,4,13665.0,10,13675.0,35,S
2018-04-20 10:58:42,13665.0,2,14708,0,13665.0,11,13670.0,5,S
2018-04-20 10:59:00,13670.0,2,14710,0,13665.0,10,13670.0,14,B
2018-04-20 10:59:01,13665.0,10,14720,-8,13665.0,5,13670.0,15,S
2018-04-20 10:59:01,13665.0,10,14730,-6,13660.0,4,13665.0,5,S
2018-04-20 10:59:06,13665.0,10,14740,-2,13660.0,2,13665.0,5,S
2018-04-20 10:59:10,13660.0,2,14742,0,13660.0,1,13665.0,7,S
2018-04-20 10:59:12,13660.0,2,14744,2,13655.0,7,13660.0,2,S
2018-04-20 10:59:13,13660.0,2,14746,0,13655.0,3,13665.0,39,S
2018-04-20 10:59:23,13655.0,6,14752,-2,13655.0,1,13660.0,7,S
2018-04-20 10:59:23,13655.0,2,14754,0,13650.0,14,13660.0,7,S
2018-04-20 10:59:24,13650.0,2,14756,-2,13650.0,12,13655.0,7,S
2018-04-20 10:59:25,13650.0,4,14760,0,13650.0,10,13655.0,7,S
2018-04-20 10:59:26,13650.0,20,14780,8,13645.0,4,13650.0,3,S
2018-04-20 10:59:27,13645.0,8,14788,4,13640.0,18,13645.0,46,S
2018-04-20 10:59:27,13635.0,40,14828,32,13635.0,2,13640.0,23,S
2018-04-20 10:59:28,13640.0,68,14896,2,13640.0,6,13645.0,5,B
2018-04-20 10:59:28,13645.0,10,14906,10,13645.0,17,13650.0,17,B
2018-04-20 10:59:29,13650.0,8,14914,4,13650.0,17,13655.0,15,B
2018-04-20 10:59:29,13655.0,4,14918,0,13655.0,12,13660.0,20,B
2018-04-20 10:59:30,13650.0,36,14954,-14,13645.0,3,13650.0,3,S
2018-04-20 10:59:31,13645.0,2,14956,0,13640.0,8,13650.0,23,S
2018-04-20 10:59:34,13645.0,2,14958,0,13640.0,5,13650.0,17,S
2018-04-20 10:59:40,13635.0,4,14962,-2,13630.0,10,13635.0,1,S
2018-04-20 10:59:40,13625.0,26,14988,-8,13625.0,3,13635.0,13,S
2018-04-20 10:59:41,13635.0,18,15006,-6,13620.0,11,13635.0,10,B
2018-04-20 10:59:41,13625.0,2,15008,0,13625.0,10,13635.0,8,S
2018-04-20 10:59:42,13625.0,10,15018,2,13625.0,7,13635.0,8,S
2018-04-20 10:59:43,13635.0,6,15024,0,13635.0,3,13640.0,9,B
2018-04-20 10:59:44,13635.0,10,15034,6,13635.0,3,13640.0,5,B
2018-04-20 10:59:45,13630.0,10,15044,0,13630.0,8,13640.0,12,S
2018-04-20 10:59:46,13640.0,14,15058,-4,13630.0,1,13640.0,16,B
2018-04-20 10:59:46,13630.0,2,15060,-2,13630.0,1,13635.0,2,S
2018-04-20 10:59:48,13630.0,10,15070,6,13625.0,6,13630.0,1,S
2018-04-20 10:59:48,13635.0,6,15076,-4,13630.0,9,13640.0,22,B
2018-04-20 10:59:50,13630.0,2,15078,2,13630.0,13,13640.0,14,S
2018-04-20 10:59:53,13630.0,2,15080,2,13630.0,8,13635.0,3,S
2018-04-20 10:59:54,13630.0,8,15088,-8,13630.0,2,13635.0,6,S
2018-04-20 10:59:54,13635.0,4,15092,2,13625.0,8,13635.0,4,B
2018-04-20 10:59:56,13635.0,2,15094,0,13625.0,8,13635.0,11,B
2018-04-20 10:59:57,13630.0,10,15104,0,13625.0,4,13635.0,14,S
2018-04-20 10:59:58,13625.0,2,15106,0,13625.0,6,13635.0,9,S
2018-04-20 11:00:01,13635.0,2,15108,0,13630.0,1,13635.0,5,B
2018-04-20 11:00:01,13630.0,2,15110,0,13625.0,12,13630.0,1,S
2018-04-20 11:00:02,13630.0,8,15118,0,13630.0,3,13635.0,1,S
2018-04-20 11:00:06,13630.0,2,15120,-2,13630.0,28,13640.0,19,S
2018-04-20 11:00:07,13640.0,2,15122,0,13635.0,2,13640.0,13,B
2018-04-20 11:00:07,13640.0,18,15140,6,13635.0,7,13645.0,5,B
2018-04-20 11:00:10,13640.0,10,15150,0,13635.0,7,13645.0,4,B
2018-04-20 11:00:14,13645.0,2,15152,-2,13640.0,4,13650.0,8,B
2018-04-20 11:00:15,13650.0,6,15158,4,13645.0,1,13650.0,2,B
2018-04-20 11:00:16,13650.0,4,15162,-4,13645.0,2,13650.0,1,B
2018-04-20 11:00:17,13650.0,2,15164,0,13645.0,5,13655.0,4,B
2018-04-20 11:00:24,13650.0,2,15166,0,13645.0,5,13650.0,3,B
2018-04-20 11:00:32,13650.0,4,15170,2,13645.0,2,13655.0,15,B
2018-04-20 11:00:38,13655.0,2,15172,2,13650.0,8,13655.0,1,B
2018-04-20 11:00:41,13655.0,2,15174,-2,13650.0,8,13660.0,11,B
2018-04-20 11:00:42,13650.0,2,15176,0,13650.0,7,13660.0,11,S
2018-04-20 11:00:44,13655.0,2,15178,2,13655.0,15,13665.0,14,B
2018-04-20 11:00:46,13665.0,2,15180,0,13655.0,12,13665.0,15,B
2018-04-20 11:00:49,13660.0,4,15184,0,13655.0,12,13665.0,16,S
2018-04-20 11:00:51,13660.0,4,15188,0,13660.0,2,13665.0,16,S
2018-04-20 11:00:53,13660.0,4,15192,0,13660.0,4,13665.0,15,S
2018-04-20 11:00:55,13660.0,4,15196,-4,13660.0,2,13665.0,9,S
2018-04-20 11:00:56,13660.0,4,15200,2,13655.0,4,13665.0,11,S
2018-04-20 11:01:08,13655.0,10,15210,4,13650.0,8,13660.0,9,S
2018-04-20 11:01:10,13655.0,4,15214,2,13650.0,1,13655.0,16,S
2018-04-20 11:01:12,13650.0,2,15216,2,13645.0,5,13655.0,16,S
2018-04-20 11:01:14,13655.0,2,15218,2,13645.0,6,13655.0,16,B
2018-04-20 11:01:22,13650.0,4,15222,0,13645.0,7,13655.0,19,S
2018-04-20 11:01:29,13645.0,8,15230,6,13640.0,2,13645.0,1,S
2018-04-20 11:01:30,13640.0,2,15232,-2,13635.0,20,13645.0,19,S
2018-04-20 11:01:34,13640.0,6,15238,-6,13635.0,22,13645.0,19,S
2018-04-20 11:01:36,13640.0,2,15240,0,13635.0,22,13645.0,20,S
2018-04-20 11:01:38,13640.0,2,15242,0,13635.0,20,13645.0,20,S
2018-04-20 11:01:46,13640.0,2,15244,2,13635.0,20,13640.0,6,S
2018-04-20 11:01:47,13640.0,26,15270,-8,13635.0,20,13645.0,13,S
2018-04-20 11:01:54,13645.0,18,15288,0,13640.0,5,13650.0,9,B
2018-04-20 11:01:57,13640.0,16,15304,10,13635.0,24,13640.0,12,S
2018-04-20 11:01:58,13640.0,24,15328,18,13640.0,16,13645.0,1,S
2018-04-20 11:02:03,13645.0,2,15330,-2,13640.0,15,13650.0,11,B
2018-04-20 11:02:03,13650.0,14,15344,10,13640.0,8,13650.0,5,B
2018-04-20 11:02:20,13650.0,10,15354,0,13645.0,8,13655.0,6,B
2018-04-20 11:02:29,13650.0,2,15356,0,13650.0,1,13655.0,10,B
2018-04-20 11:02:39,13645.0,4,15360,-2,13640.0,13,13650.0,11,S
2018-04-20 11:02:48,13650.0,4,15364,-2,13640.0,15,13650.0,5,B
2018-04-20 11:02:56,13645.0,6,15370,-2,13640.0,12,13650.0,3,S
2018-04-20 11:03:14,13645.0,2,15372,-2,13645.0,1,13650.0,7,S
2018-04-20 11:03:14,13645.0,2,15374,-2,13640.0,12,13650.0,7,S
2018-04-20 11:03:19,13650.0,2,15376,0,13640.0,12,13650.0,7,B
2018-04-20 11:03:22,13650.0,12,15388,-6,13645.0,5,13655.0,20,B
2018-04-20 11:03:23,13655.0,8,15396,2,13655.0,1,13660.0,19,B
2018-04-20 11:03:28,13660.0,2,15398,0,13655.0,2,13660.0,5,B
2018-04-20 11:03:29,13660.0,14,15412,-2,13655.0,2,13660.0,1,B
2018-04-20 11:03:29,13660.0,2,15414,-2,13655.0,2,13660.0,1,B
2018-04-20 11:03:30,13660.0,2,15416,0,13655.0,3,13660.0,1,B
2018-04-20 11:03:34,13660.0,2,15418,-2,13655.0,5,13660.0,4,B
2018-04-20 11:03:34,13660.0,8,15426,4,13655.0,5,13665.0,4,B
2018-04-20 11:03:40,13665.0,2,15428,0,13655.0,5,13665.0,2,B
2018-04-20 11:03:52,13665.0,2,15430,0,13660.0,1,13665.0,7,B
2018-04-20 11:03:52,13665.0,2,15432,0,13660.0,1,13665.0,6,B
2018-04-20 11:03:54,13660.0,2,15434,2,13655.0,6,13660.0,3,S
2018-04-20 11:03:57,13655.0,4,15438,2,13655.0,4,13660.0,6,S
2018-04-20 11:03:57,13660.0,6,15444,4,13655.0,4,13660.0,3,B
2018-04-20 11:04:15,13660.0,4,15448,-4,13660.0,3,13665.0,5,B
2018-04-20 11:04:21,13660.0,2,15450,0,13660.0,4,13665.0,4,B
2018-04-20 11:04:23,13660.0,4,15454,4,13660.0,2,13665.0,4,B
2018-04-20 11:04:23,13660.0,4,15458,0,13655.0,5,13660.0,4,B
2018-04-20 11:04:39,13660.0,4,15462,0,13655.0,3,13660.0,6,B
2018-04-20 11:04:52,13660.0,2,15464,2,13655.0,3,13660.0,5,B
2018-04-20 11:05:04,13660.0,2,15466,0,13655.0,2,13660.0,3,B
2018-04-20 11:05:10,13665.0,10,15476,-6,13655.0,9,13665.0,2,B
2018-04-20 11:05:14,13665.0,2,15478,2,13660.0,1,13665.0,4,B
2018-04-20 11:05:14,13665.0,8,15486,-4,13660.0,5,13670.0,16,B
2018-04-20 11:05:22,13665.0,2,15488,0,13665.0,12,13670.0,3,B
2018-04-20 11:05:22,13670.0,6,15494,4,13665.0,12,13675.0,6,B
2018-04-20 11:05:24,13665.0,2,15496,2,13665.0,12,13675.0,7,S
2018-04-20 11:05:31,13670.0,2,15498,-2,13670.0,1,13675.0,8,B
2018-04-20 11:05:34,13675.0,2,15500,2,13665.0,4,13675.0,7,B
2018-04-20 11:05:36,13675.0,4,15504,0,13665.0,4,13675.0,5,B
2018-04-20 11:05:42,13675.0,2,15506,0,13670.0,3,13675.0,4,B
2018-04-20 11:05:44,13670.0,6,15512,-4,13665.0,2,13670.0,6,S
2018-04-20 11:05:45,13670.0,2,15514,2,13660.0,13,13675.0,22,S
2018-04-20 11:05:46,13670.0,2,15516,2,13660.0,13,13670.0,6,S
2018-04-20 11:05:55,13670.0,2,15518,2,13660.0,13,13670.0,7,S
2018-04-20 11:06:00,13670.0,2,15520,2,13660.0,13,13670.0,6,S
2018-04-20 11:06:19,13670.0,2,15522,0,13670.0,1,13675.0,6,S
2018-04-20 11:06:26,13675.0,6,15528,2,13670.0,6,13675.0,1,B
2018-04-20 11:06:26,13675.0,2,15530,-2,13670.0,7,13680.0,5,B
2018-04-20 11:06:29,13680.0,8,15538,4,13675.0,5,13685.0,3,B
2018-04-20 11:06:31,13685.0,6,15544,-4,13685.0,1,13690.0,5,B
2018-04-20 11:06:32,13685.0,2,15546,0,13680.0,6,13690.0,23,B
2018-04-20 11:06:37,13690.0,4,15550,0,13685.0,5,13690.0,5,B
2018-04-20 11:06:39,13690.0,2,15552,2,13685.0,7,13690.0,4,B
2018-04-20 11:06:42,13690.0,2,15554,0,13685.0,5,13690.0,3,B
2018-04-20 11:06:43,13690.0,2,15556,0,13685.0,5,13690.0,2,B
2018-04-20 11:06:45,13685.0,4,15560,0,13680.0,3,13685.0,2,S
2018-04-20 11:06:53,13680.0,8,15568,2,13675.0,9,13685.0,5,S
2018-04-20 11:07:00,13685.0,2,15570,2,13680.0,3,13685.0,1,B
2018-04-20 11:07:09,13680.0,2,15572,0,13675.0,11,13680.0,3,S
2018-04-20 11:07:26,13670.0,8,15580,-2,13670.0,8,13680.0,8,S
2018-04-20 11:07:45,13670.0,18,15598,6,13665.0,1,13675.0,8,S
2018-04-20 11:08:11,13670.0,2,15600,0,13665.0,4,13670.0,4,S
2018-04-20 11:08:11,13670.0,8,15608,2,13665.0,13,13675.0,8,S
2018-04-20 11:08:16,13670.0,4,15612,0,13670.0,1,13675.0,5,S
2018-04-20 11:08:16,13670.0,2,15614,-2,13665.0,12,13675.0,10,S
2018-04-20 11:08:31,13670.0,2,15616,0,13665.0,14,13675.0,6,S
2018-04-20 11:08:38,13670.0,2,15618,0,13665.0,13,13675.0,12,S
2018-04-20 11:08:46,13670.0,2,15620,-2,13670.0,2,13675.0,5,S
2018-04-20 11:08:50,13670.0,2,15622,-2,13670.0,1,13675.0,4,S
2018-04-20 11:09:22,13680.0,6,15628,-6,13675.0,3,13685.0,7,B
2018-04-20 11:10:20,13675.0,4,15632,2,13670.0,6,13675.0,1,S
2018-04-20 11:10:29,13670.0,2,15634,0,13665.0,5,13675.0,11,S
2018-04-20 11:10:33,13675.0,2,15636,2,13665.0,8,13675.0,10,B
2018-04-20 11:10:37,13675.0,2,15638,2,13665.0,7,13675.0,9,B
2018-04-20 11:10:50,13675.0,2,15640,0,13675.0,5,13680.0,4,B
2018-04-20 11:11:15,13680.0,2,15642,0,13675.0,5,13680.0,4,B
2018-04-20 11:11:25,13675.0,6,15648,4,13670.0,1,13680.0,30,S
2018-04-20 11:12:42,13675.0,2,15650,-2,13670.0,4,13675.0,3,S
2018-04-20 11:12:50,13675.0,2,15652,0,13670.0,4,13675.0,2,S
2018-04-20 11:12:52,13670.0,6,15658,4,13665.0,13,13675.0,7,S
2018-04-20 11:13:28,13665.0,12,15670,-10,13660.0,23,13665.0,3,S
2018-04-20 11:13:28,13660.0,14,15684,6,13660.0,20,13665.0,2,S
2018-04-20 11:13:31,13660.0,4,15688,-4,13660.0,7,13665.0,2,S
2018-04-20 11:13:52,13665.0,4,15692,-4,13665.0,3,13670.0,5,B
2018-04-20 11:13:56,13670.0,2,15694,-2,13670.0,2,13675.0,7,B
2018-04-20 11:13:57,13675.0,2,15696,-2,13670.0,12,13675.0,1,B
2018-04-20 11:14:09,13675.0,2,15698,2,13670.0,13,13680.0,7,B
2018-04-20 11:14:25,13670.0,8,15706,0,13665.0,8,13675.0,11,S
2018-04-20 11:15:02,13665.0,2,15708,-2,13665.0,2,13670.0,7,S
2018-04-20 11:15:17,13665.0,2,15710,-2,13665.0,1,13670.0,8,S
2018-04-20 11:15:19,13665.0,2,15712,-2,13660.0,7,13670.0,11,S
2018-04-20 11:15:38,13655.0,2,15714,-2,13655.0,4,13665.0,13,S
2018-04-20 11:15:50,13655.0,2,15716,0,13655.0,5,13665.0,11,S
2018-04-20 11:16:14,13655.0,2,15718,0,13655.0,8,13660.0,1,S
2018-04-20 11:16:17,13655.0,2,15720,0,13655.0,3,13660.0,3,S
2018-04-20 11:16:21,13660.0,2,15722,-2,13655.0,7,13665.0,13,B
2018-04-20 11:16:26,13660.0,6,15728,0,13655.0,13,13660.0,1,B
2018-04-20 11:16:38,13655.0,6,15734,4,13650.0,13,13660.0,24,S
2018-04-20 11:16:45,13655.0,8,15742,0,13655.0,6,13660.0,4,S
2018-04-20 11:16:47,13655.0,4,15746,0,13650.0,20,13660.0,7,S
2018-04-20 11:17:10,13650.0,2,15748,0,13650.0,6,13655.0,7,S
2018-04-20 11:17:12,13650.0,12,15760,4,13645.0,4,13655.0,8,S
2018-04-20 11:17:20,13645.0,4,15764,-2,13640.0,7,13650.0,6,S
2018-04-20 11:17:27,13650.0,8,15772,-8,13650.0,11,13655.0,13,B
2018-04-20 11:17:28,13650.0,8,15780,-4,13650.0,7,13655.0,13,B
2018-04-20 11:18:09,13660.0,10,15790,4,13655.0,4,13665.0,21,B
2018-04-20 11:18:45,13665.0,2,15792,0,13660.0,8,13670.0,7,B
2018-04-20 11:19:16,13670.0,2,15794,2,13660.0,9,13670.0,4,B
2018-04-20 11:19:22,13660.0,10,15804,6,13655.0,5,13660.0,1,S
2018-04-20 11:19:29,13655.0,6,15810,4,13650.0,13,13660.0,9,S
2018-04-20 11:19:48,13655.0,4,15814,-4,13650.0,13,13655.0,2,S
2018-04-20 11:19:48,13655.0,4,15818,-4,13650.0,13,13660.0,11,S
2018-04-20 11:20:00,13660.0,2,15820,0,13655.0,8,13660.0,2,B
2018-04-20 11:20:04,13660.0,4,15824,4,13655.0,8,13665.0,4,B
2018-04-20 11:20:19,13655.0,4,15828,0,13650.0,14,13655.0,3,S
2018-04-20 11:20:19,13655.0,6,15834,4,13655.0,1,13660.0,2,S
2018-04-20 11:20:26,13655.0,2,15836,0,13650.0,11,13660.0,8,S
2018-04-20 11:20:53,13660.0,2,15838,2,13655.0,9,13660.0,2,B
2018-04-20 11:20:59,13660.0,2,15840,2,13655.0,3,13665.0,9,B
2018-04-20 11:21:00,13665.0,2,15842,2,13655.0,2,13665.0,8,B
2018-04-20 11:22:26,13650.0,8,15850,-8,13650.0,25,13655.0,4,S
2018-04-20 11:22:30,13650.0,26,15876,-14,13650.0,12,13655.0,23,S
2018-04-20 11:22:31,13650.0,24,15900,-2,13640.0,16,13650.0,3,S
2018-04-20 11:22:58,13640.0,2,15902,-2,13640.0,10,13645.0,4,S
2018-04-20 11:23:06,13645.0,4,15906,-2,13640.0,10,13650.0,5,B
2018-04-20 11:23:07,13640.0,2,15908,-2,13640.0,9,13650.0,11,S
2018-04-20 11:23:18,13645.0,2,15910,2,13640.0,13,13650.0,11,B
2018-04-20 11:23:29,13640.0,4,15914,-4,13640.0,15,13650.0,20,S
2018-04-20 11:23:53,13640.0,2,15916,2,13640.0,7,13645.0,13,S
2018-04-20 11:23:53,13640.0,4,15920,0,13640.0,5,13645.0,13,S
2018-04-20 11:23:54,13640.0,10,15930,0,13635.0,1,13640.0,4,S
2018-04-20 11:23:55,13635.0,2,15932,0,13630.0,22,13640.0,8,S
2018-04-20 11:23:57,13640.0,2,15934,-2,13630.0,17,13640.0,7,B
2018-04-20 11:24:01,13630.0,6,15940,-4,13630.0,24,13635.0,5,S
2018-04-20 11:24:01,13630.0,12,15952,0,13630.0,22,13635.0,8,S
2018-04-20 11:24:02,13630.0,16,15968,-4,13630.0,14,13635.0,24,S
2018-04-20 11:24:06,13630.0,2,15970,-2,13630.0,14,13635.0,9,S
2018-04-20 11:24:14,13635.0,14,15984,-12,13630.0,22,13640.0,12,B
2018-04-20 11:24:16,13635.0,2,15986,0,13630.0,12,13640.0,31,B
2018-04-20 11:24:19,13640.0,8,15994,-4,13630.0,12,13640.0,26,B
2018-04-20 11:24:24,13640.0,2,15996,2,13635.0,15,13640.0,2,B
2018-04-20 11:24:31,13640.0,2,15998,2,13635.0,11,13640.0,7,B
2018-04-20 11:24:32,13640.0,2,16000,0,13635.0,9,13640.0,6,B
2018-04-20 11:24:33,13640.0,6,16006,0,13640.0,2,13645.0,19,B
2018-04-20 11:24:38,13645.0,14,16020,2,13640.0,14,13650.0,16,B
2018-04-20 11:24:47,13645.0,2,16022,-2,13640.0,18,13650.0,19,B
2018-04-20 11:24:51,13640.0,2,16024,-2,13640.0,16,13645.0,1,S
2018-04-20 11:24:51,13650.0,6,16030,2,13640.0,15,13650.0,16,B
2018-04-20 11:25:07,13650.0,2,16032,2,13640.0,4,13645.0,4,B
2018-04-20 11:25:34,13645.0,2,16034,2,13640.0,12,13650.0,20,S
2018-04-20 11:25:55,13645.0,2,16036,0,13645.0,5,13650.0,11,S
2018-04-20 11:25:59,13645.0,2,16038,0,13640.0,11,13650.0,22,S
2018-04-20 11:26:01,13645.0,2,16040,0,13640.0,11,13650.0,22,S
2018-04-20 11:26:10,13645.0,2,16042,0,13640.0,5,13645.0,1,S
2018-04-20 11:26:12,13640.0,8,16050,-6,13635.0,5,13640.0,2,S
2018-04-20 11:26:15,13635.0,10,16060,8,13635.0,1,13640.0,2,S
2018-04-20 11:26:38,13635.0,2,16062,0,13630.0,18,13640.0,7,S
2018-04-20 11:27:00,13630.0,4,16066,0,13630.0,8,13635.0,9,S
2018-04-20 11:27:00,13630.0,12,16078,0,13630.0,2,13635.0,37,S
2018-04-20 11:27:01,13630.0,4,16082,-4,13625.0,10,13635.0,25,S
2018-04-20 11:27:03,13625.0,4,16086,2,13625.0,5,13630.0,25,S
2018-04-20 11:27:03,13620.0,16,16102,8,13620.0,6,13625.0,42,S
2018-04-20 11:27:04,13620.0,14,16116,12,13615.0,3,13620.0,22,S
2018-04-20 11:27:04,13615.0,40,16156,-2,13610.0,6,13615.0,1,S
2018-04-20 11:27:05,13620.0,8,16164,2,13615.0,6,13620.0,6,B
2018-04-20 11:27:05,13615.0,12,16176,-4,13610.0,10,13615.0,10,S
2018-04-20 11:27:06,13615.0,14,16190,0,13610.0,6,13615.0,6,S
2018-04-20 11:27:06,13615.0,12,16202,0,13610.0,13,13620.0,31,S
2018-04-20 11:27:07,13625.0,4,16206,2,13615.0,8,13625.0,32,B
2018-04-20 11:27:10,13615.0,4,16210,0,13610.0,8,13620.0,4,S
2018-04-20 11:27:12,13610.0,4,16214,2,13610.0,4,13615.0,7,S
2018-04-20 11:27:13,13610.0,12,16226,12,13605.0,33,13610.0,3,S
2018-04-20 11:27:13,13610.0,14,16240,0,13605.0,33,13610.0,3,S
2018-04-20 11:27:14,13610.0,10,16250,0,13605.0,27,13610.0,15,S
2018-04-20 11:27:14,13600.0,128,16378,-12,13595.0,9,13605.0,13,S
2018-04-20 11:27:15,13595.0,36,16414,-18,13595.0,5,13600.0,2,S
2018-04-20 11:27:15,13600.0,10,16424,-4,13600.0,8,13605.0,2,B
2018-04-20 11:27:16,13600.0,20,16444,-16,13595.0,10,13605.0,2,B
2018-04-20 11:27:18,13600.0,8,16452,6,13595.0,10,13600.0,1,B
2018-04-20 11:27:18,13600.0,2,16454,0,13595.0,10,13605.0,2,B
2018-04-20 11:27:21,13600.0,2,16456,0,13600.0,6,13605.0,2,B
2018-04-20 11:27:23,13600.0,2,16458,0,13600.0,4,13605.0,2,B
2018-04-20 11:27:26,13600.0,2,16460,2,13600.0,1,13605.0,3,B
2018-04-20 11:27:26,13600.0,2,16462,-2,13595.0,12,13605.0,5,B
2018-04-20 11:27:29,13600.0,2,16464,2,13595.0,14,13605.0,4,B
2018-04-20 11:27:31,13605.0,2,16466,2,13600.0,3,13605.0,2,B
2018-04-20 11:27:32,13600.0,2,16468,0,13595.0,14,13605.0,2,S
2018-04-20 11:27:33,13600.0,2,16470,2,13595.0,5,13605.0,11,S
2018-04-20 11:27:35,13595.0,2,16472,0,13595.0,7,13605.0,12,S
2018-04-20 11:27:39,13595.0,8,16480,2,13590.0,13,13600.0,13,S
2018-04-20 11:27:42,13595.0,4,16484,-4,13590.0,25,13600.0,3,S
2018-04-20 11:27:43,13600.0,4,16488,2,13590.0,21,13600.0,7,B
2018-04-20 11:27:43,13600.0,4,16492,-2,13590.0,25,13600.0,1,B
2018-04-20 11:27:44,13600.0,2,16494,0,13600.0,1,13605.0,8,B
2018-04-20 11:27:53,13600.0,2,16496,2,13590.0,15,13595.0,2,B
2018-04-20 11:27:53,13595.0,2,16498,2,13590.0,15,13595.0,1,S
2018-04-20 11:27:54,13595.0,2,16500,0,13590.0,15,13600.0,10,S
2018-04-20 11:27:56,13600.0,4,16504,-2,13595.0,4,13600.0,8,B
2018-04-20 11:27:58,13600.0,6,16510,6,13595.0,7,13605.0,4,B
2018-04-20 11:28:02,13605.0,4,16514,-2,13600.0,2,13605.0,5,B
2018-04-20 11:28:07,13605.0,4,16518,0,13600.0,4,13605.0,3,B
2018-04-20 11:28:07,13605.0,10,16528,0,13605.0,2,13610.0,14,B
2018-04-20 11:28:11,13605.0,2,16530,0,13605.0,1,13610.0,10,B
2018-04-20 11:28:19,13605.0,4,16534,-2,13600.0,10,13610.0,10,B
2018-04-20 11:28:20,13605.0,2,16536,2,13600.0,10,13610.0,11,B
2018-04-20 11:28:24,13610.0,2,16538,0,13600.0,10,13610.0,15,B
2018-04-20 11:28:25,13610.0,2,16540,0,13600.0,10,13610.0,14,B
2018-04-20 11:28:25,13610.0,4,16544,-4,13600.0,10,13610.0,12,B
2018-04-20 11:28:29,13600.0,6,16550,6,13600.0,7,13610.0,12,S
2018-04-20 11:28:35,13600.0,2,16552,0,13600.0,8,13610.0,14,S
2018-04-20 11:28:39,13605.0,4,16556,2,13595.0,8,13605.0,3,B
2018-04-20 11:28:51,13595.0,10,16566,-2,13590.0,17,13600.0,4,S
2018-04-20 11:28:52,13595.0,2,16568,-2,13595.0,3,13600.0,4,S
2018-04-20 11:28:54,13595.0,4,16572,2,13590.0,20,13600.0,7,S
2018-04-20 11:28:56,13595.0,2,16574,2,13590.0,21,13600.0,10,S
2018-04-20 11:29:00,13600.0,10,16584,2,13595.0,1,13605.0,9,B
2018-04-20 11:29:01,13605.0,6,16590,-2,13595.0,2,13605.0,8,B
2018-04-20 11:29:01,13590.0,6,16596,-6,13590.0,33,13605.0,8,S
2018-04-20 11:29:02,13590.0,6,16602,-2,13590.0,32,13605.0,8,S
2018-04-20 11:29:05,13600.0,2,16604,2,13590.0,32,13605.0,9,B
2018-04-20 11:29:11,13595.0,4,16608,2,13590.0,19,13595.0,1,S
2018-04-20 11:29:12,13595.0,2,16610,2,13595.0,2,13600.0,10,S
2018-04-20 11:29:13,13600.0,2,16612,0,13595.0,2,13600.0,4,B
2018-04-20 11:29:14,13595.0,4,16616,0,13590.0,31,13595.0,1,S
2018-04-20 11:29:15,13595.0,2,16618,-2,13590.0,21,13600.0,4,S
2018-04-20 11:29:16,13590.0,2,16620,-2,13590.0,11,13595.0,4,S
2018-04-20 11:29:17,13590.0,6,16626,-2,13590.0,8,13595.0,10,S
2018-04-20 11:29:17,13590.0,2,16628,0,13590.0,7,13595.0,9,S
2018-04-20 11:29:18,13590.0,14,16642,-2,13585.0,22,13590.0,2,S
2018-04-20 11:29:18,13590.0,2,16644,-2,13585.0,22,13590.0,3,S
2018-04-20 11:29:24,13590.0,2,16646,-2,13585.0,22,13590.0,4,S
2018-04-20 11:29:25,13585.0,46,16692,36,13580.0,9,13585.0,18,S
2018-04-20 11:29:25,13580.0,10,16702,0,13580.0,7,13585.0,17,S
2018-04-20 11:29:26,13585.0,8,16710,0,13580.0,6,13585.0,15,B
2018-04-20 11:29:27,13585.0,2,16712,0,13580.0,5,13585.0,14,B
2018-04-20 11:29:28,13585.0,4,16716,0,13580.0,6,13585.0,12,B
2018-04-20 11:29:29,13580.0,12,16728,6,13575.0,12,13580.0,14,S
2018-04-20 11:29:29,13580.0,14,16742,2,13575.0,14,13580.0,7,S
2018-04-20 11:29:30,13585.0,16,16758,2,13580.0,5,13585.0,12,B
2018-04-20 11:29:30,13580.0,10,16768,0,13575.0,16,13580.0,15,S
2018-04-20 11:29:31,13580.0,2,16770,2,13575.0,15,13580.0,15,S
2018-04-20 11:29:32,13580.0,4,16774,2,13575.0,15,13580.0,13,S
2018-04-20 11:29:32,13580.0,6,16780,0,13575.0,15,13580.0,10,S
2018-04-20 11:29:33,13580.0,4,16784,4,13575.0,15,13580.0,8,S
2018-04-20 11:29:34,13580.0,2,16786,0,13575.0,15,13580.0,7,S
2018-04-20 11:29:34,13580.0,2,16788,2,13575.0,15,13580.0,7,S
2018-04-20 11:29:35,13580.0,2,16790,0,13575.0,15,13580.0,5,S
2018-04-20 11:29:36,13575.0,2,16792,2,13575.0,13,13580.0,5,S
2018-04-20 11:29:37,13575.0,2,16794,0,13575.0,10,13580.0,6,S
2018-04-20 11:29:38,13575.0,20,16814,8,13570.0,38,13575.0,90,S
2018-04-20 11:29:39,13570.0,34,16848,8,13570.0,22,13575.0,90,S
2018-04-20 11:29:40,13570.0,2,16850,-2,13570.0,20,13575.0,93,S
2018-04-20 11:29:40,13570.0,2,16852,-2,13570.0,20,13575.0,93,S
2018-04-20 11:29:41,13575.0,2,16854,0,13570.0,20,13575.0,92,B
2018-04-20 11:29:41,13570.0,42,16896,22,13570.0,2,13575.0,89,S
2018-04-20 11:29:42,13570.0,4,16900,-4,13565.0,14,13575.0,89,S
2018-04-20 11:29:44,13570.0,2,16902,2,13565.0,16,13570.0,5,S
2018-04-20 11:29:45,13570.0,10,16912,6,13570.0,1,13575.0,89,S
2018-04-20 11:29:47,13575.0,8,16920,2,13565.0,16,13575.0,86,B
2018-04-20 11:29:47,13565.0,2,16922,0,13565.0,15,13575.0,86,S
2018-04-20 11:29:48,13575.0,2,16924,2,13565.0,15,13575.0,85,B
2018-04-20 11:29:51,13570.0,4,16928,-2,13565.0,16,13570.0,1,S
2018-04-20 11:29:51,13570.0,2,16930,-2,13570.0,1,13575.0,86,S
2018-04-20 11:29:56,13570.0,4,16934,0,13570.0,1,13575.0,90,S
2018-04-20 11:29:58,13570.0,2,16936,2,13570.0,3,13575.0,5,S
2018-04-20 11:29:58,13565.0,56,16992,38,13560.0,13,13565.0,61,S
2018-04-20 11:29:59,13565.0,108,17100,44,13560.0,18,13565.0,7,S
2018-04-20 11:29:59,13565.0,14,17114,2,13565.0,4,13575.0,1,S
2018-04-20 13:30:00,13565.0,26,17140,22,13560.0,15,13565.0,17,S
2018-04-20 13:30:01,13560.0,26,17166,10,13555.0,8,13560.0,51,S
2018-04-20 13:30:02,13555.0,16,17182,10,13555.0,2,13560.0,52,S
2018-04-20 13:30:02,13555.0,16,17198,0,13555.0,3,13560.0,52,S
2018-04-20 13:30:03,13560.0,2,17200,0,13555.0,3,13560.0,51,B
2018-04-20 13:30:03,13560.0,2,17202,0,13555.0,3,13560.0,50,B
2018-04-20 13:30:04,13560.0,10,17212,4,13555.0,4,13560.0,45,B
2018-04-20 13:30:05,13550.0,10,17222,-4,13555.0,3,13560.0,48,S
2018-04-20 13:30:05,13555.0,6,17228,0,13550.0,39,13560.0,48,B
2018-04-20 13:30:07,13560.0,2,17230,0,13555.0,27,13560.0,47,B
2018-04-20 13:30:07,13560.0,4,17234,0,13555.0,39,13560.0,45,B
2018-04-20 13:30:08,13560.0,4,17238,4,13555.0,7,13560.0,43,B
2018-04-20 13:30:09,13560.0,2,17240,0,13555.0,6,13560.0,42,B
2018-04-20 13:30:10,13560.0,4,17244,4,13555.0,7,13560.0,41,B
2018-04-20 13:30:10,13560.0,4,17248,4,13555.0,4,13560.0,38,B
2018-04-20 13:30:11,13555.0,8,17256,-8,13555.0,1,13560.0,38,S
2018-04-20 13:30:12,13555.0,2,17258,0,13550.0,61,13560.0,38,S
2018-04-20 13:30:13,13555.0,2,17260,-2,13555.0,2,13560.0,38,S
2018-04-20 13:30:13,13555.0,2,17262,0,13555.0,1,13560.0,38,S
2018-04-20 13:30:17,13555.0,6,17268,4,13555.0,4,13560.0,38,S
2018-04-20 13:30:20,13560.0,4,17272,4,13555.0,39,13560.0,36,B
2018-04-20 13:30:20,13560.0,114,17386,48,13560.0,16,13570.0,3,B
2018-04-20 13:30:24,13565.0,14,17400,10,13560.0,23,13565.0,43,B
2018-04-20 13:30:24,13565.0,86,17486,82,13565.0,14,13570.0,1,B
2018-04-20 13:30:25,13575.0,2,17488,2,13570.0,2,13575.0,2,B
2018-04-20 13:30:25,13565.0,8,17496,0,13560.0,17,13565.0,1,S
2018-04-20 13:30:26,13565.0,8,17504,4,13565.0,4,13570.0,1,S
2018-04-20 13:30:27,13570.0,2,17506,0,13570.0,1,13575.0,3,B
2018-04-20 13:30:29,13565.0,2,17508,-2,13565.0,1,13570.0,10,S
2018-04-20 13:30:30,13565.0,2,17510,-2,13560.0,5,13565.0,1,S
2018-04-20 13:30:30,13565.0,2,17512,0,13565.0,4,13570.0,8,S
2018-04-20 13:30:31,13565.0,8,17520,4,13560.0,5,13570.0,8,S
2018-04-20 13:30:31,13565.0,2,17522,0,13560.0,5,13570.0,8,S
2018-04-20 13:30:32,13560.0,10,17532,6,13555.0,11,13560.0,45,S
2018-04-20 13:30:32,13560.0,62,17594,52,13555.0,21,13560.0,16,S
2018-04-20 13:30:33,13555.0,14,17608,10,13550.0,20,13560.0,18,S
2018-04-20 13:30:35,13560.0,10,17618,0,13555.0,1,13560.0,14,B
2018-04-20 13:30:35,13555.0,2,17620,2,13555.0,4,13560.0,12,S
2018-04-20 13:30:36,13555.0,8,17628,-8,13550.0,26,13560.0,17,S
2018-04-20 13:30:39,13555.0,32,17660,30,13550.0,32,13555.0,6,S
2018-04-20 13:30:40,13555.0,12,17672,12,13555.0,2,13560.0,11,S
2018-04-20 13:30:42,13555.0,8,17680,6,13555.0,19,13560.0,9,S
2018-04-20 13:30:42,13560.0,2,17682,0,13555.0,7,13560.0,9,B
2018-04-20 13:30:43,13555.0,2,17684,2,13555.0,6,13560.0,9,S
2018-04-20 13:30:44,13560.0,18,17702,0,13560.0,1,13565.0,4,B
2018-04-20 13:30:46,13560.0,20,17722,18,13555.0,19,13560.0,40,B
2018-04-20 13:30:47,13560.0,2,17724,2,13555.0,28,13560.0,39,B
2018-04-20 13:30:47,13560.0,30,17754,0,13555.0,29,13560.0,24,B
2018-04-20 13:30:48,13560.0,48,17802,0,13560.0,2,13565.0,3,B
2018-04-20 13:30:48,13565.0,2,17804,0,13560.0,2,13565.0,6,B
2018-04-20 13:30:50,13560.0,4,17808,2,13555.0,18,13560.0,18,S
2018-04-20 13:30:52,13560.0,36,17844,36,13560.0,3,13565.0,5,S
2018-04-20 13:30:52,13565.0,10,17854,4,13565.0,2,13570.0,4,B
2018-04-20 13:30:53,13565.0,4,17858,2,13560.0,16,13565.0,18,B
2018-04-20 13:30:54,13560.0,6,17864,-2,13560.0,24,13565.0,16,S
2018-04-20 13:30:54,13565.0,2,17866,2,13560.0,24,13565.0,15,B
2018-04-20 13:30:56,13560.0,4,17870,4,13555.0,19,13560.0,1,S
2018-04-20 13:30:56,13555.0,30,17900,6,13555.0,3,13560.0,8,S
2018-04-20 13:30:59,13555.0,2,17902,2,13555.0,3,13560.0,6,S
2018-04-20 13:31:00,13565.0,26,17928,-6,13555.0,3,13565.0,8,B
2018-04-20 13:31:01,13555.0,8,17936,-2,13550.0,20,13555.0,1,S
2018-04-20 13:31:01,13555.0,6,17942,0,13550.0,31,13555.0,1,S
2018-04-20 13:31:02,13550.0,42,17984,26,13550.0,11,13560.0,4,S
2018-04-20 13:31:03,13555.0,2,17986,0,13550.0,6,13560.0,12,B
2018-04-20 13:31:04,13550.0,4,17990,-4,13545.0,4,13555.0,16,S
2018-04-20 13:31:04,13555.0,8,17998,6,13545.0,15,13555.0,15,B
2018-04-20 13:31:05,13550.0,6,18004,4,13545.0,33,13550.0,11,S
2018-04-20 13:31:05,13550.0,22,18026,14,13550.0,12,13560.0,12,S
2018-04-20 13:31:06,13550.0,4,18030,2,13550.0,26,13560.0,11,S
2018-04-20 13:31:06,13560.0,6,18036,-2,13555.0,4,13565.0,10,B
2018-04-20 13:31:07,13555.0,18,18054,6,13550.0,37,13555.0,11,S
2018-04-20 13:31:07,13555.0,22,18076,16,13555.0,7,13560.0,1,S
2018-04-20 13:31:09,13555.0,2,18078,2,13555.0,6,13565.0,17,S
2018-04-20 13:31:13,13560.0,4,18082,4,13555.0,3,13560.0,18,B
2018-04-20 13:31:13,13560.0,2,18084,0,13555.0,4,13560.0,17,B
2018-04-20 13:31:14,13560.0,2,18086,2,13555.0,4,13560.0,17,B
2018-04-20 13:31:18,13560.0,2,18088,2,13555.0,4,13560.0,20,B
2018-04-20 13:31:20,13560.0,16,18104,0,13555.0,5,13560.0,12,B
2018-04-20 13:31:21,13560.0,2,18106,2,13555.0,7,13560.0,8,B
2018-04-20 13:31:22,13560.0,20,18126,14,13560.0,7,13565.0,13,B
2018-04-20 13:31:26,13565.0,2,18128,2,13560.0,16,13565.0,6,B
2018-04-20 13:31:27,13565.0,2,18130,2,13560.0,15,13565.0,5,B
2018-04-20 13:31:27,13560.0,4,18134,0,13560.0,13,13565.0,4,S
2018-04-20 13:31:28,13565.0,4,18138,0,13560.0,13,13565.0,1,B
2018-04-20 13:31:29,13565.0,4,18142,-2,13565.0,1,13570.0,6,B
2018-04-20 13:31:30,13565.0,6,18148,2,13560.0,12,13565.0,17,B
2018-04-20 13:31:30,13565.0,26,18174,14,13560.0,38,13565.0,5,B
2018-04-20 13:31:31,13565.0,10,18184,4,13560.0,37,13570.0,6,B
2018-04-20 13:31:33,13560.0,30,18214,16,13555.0,19,13560.0,5,S
2018-04-20 13:31:34,13560.0,16,18230,16,13560.0,11,13565.0,4,S
2018-04-20 13:31:36,13560.0,40,18270,36,13555.0,20,13560.0,1,S
2018-04-20 13:31:36,13560.0,2,18272,0,13565.0,11,13570.0,6,S
2018-04-20 13:31:37,13570.0,6,18278,0,13565.0,14,13570.0,3,B
2018-04-20 13:31:37,13570.0,2,18280,2,13565.0,14,13570.0,2,B
2018-04-20 13:31:38,13570.0,4,18284,0,13570.0,5,13575.0,5,B
2018-04-20 13:31:38,13570.0,12,18296,8,13565.0,16,13570.0,14,B
2018-04-20 13:31:39,13570.0,10,18306,6,13565.0,29,13570.0,9,B
2018-04-20 13:31:39,13570.0,14,18320,12,13565.0,28,13570.0,2,B
2018-04-20 13:31:40,13565.0,16,18336,10,13565.0,1,13570.0,6,S
2018-04-20 13:31:40,13565.0,4,18340,-4,13560.0,12,13570.0,10,S
2018-04-20 13:31:42,13570.0,6,18346,-2,13565.0,3,13570.0,3,B
2018-04-20 13:31:43,13570.0,2,18348,0,13565.0,6,13575.0,5,B
2018-04-20 13:31:44,13570.0,2,18350,0,13565.0,19,13570.0,19,B
2018-04-20 13:31:45,13570.0,2,18352,0,13565.0,20,13570.0,18,B
2018-04-20 13:31:45,13570.0,2,18354,0,13565.0,27,13570.0,17,B
2018-04-20 13:31:46,13575.0,36,18390,16,13565.0,27,13575.0,4,B
2018-04-20 13:31:46,13570.0,2,18392,0,13570.0,1,13575.0,4,S
2018-04-20 13:31:48,13575.0,10,18402,-10,13570.0,5,13580.0,9,B
2018-04-20 13:31:50,13575.0,2,18404,0,13570.0,7,13575.0,10,B
2018-04-20 13:31:52,13570.0,40,18444,38,13570.0,15,13580.0,6,S
2018-04-20 13:31:55,13580.0,8,18452,8,13575.0,9,13580.0,1,B
2018-04-20 13:31:56,13575.0,2,18454,-2,13575.0,4,13580.0,1,S
2018-04-20 13:31:57,13580.0,2,18456,0,13575.0,16,13585.0,14,B
2018-04-20 13:31:57,13585.0,2,18458,2,13575.0,20,13585.0,13,B
2018-04-20 13:31:58,13585.0,2,18460,0,13575.0,21,13585.0,12,B
2018-04-20 13:31:59,13575.0,8,18468,-2,13575.0,5,13585.0,12,S
2018-04-20 13:32:00,13585.0,2,18470,2,13575.0,16,13585.0,13,B
2018-04-20 13:32:03,13580.0,12,18482,0,13575.0,2,13580.0,3,S
2018-04-20 13:32:04,13575.0,4,18486,2,13570.0,17,13575.0,18,S
2018-04-20 13:32:04,13575.0,4,18490,4,13570.0,25,13575.0,18,S
2018-04-20 13:32:05,13575.0,2,18492,0,13570.0,24,13575.0,17,S
2018-04-20 13:32:09,13570.0,8,18500,0,13570.0,9,13575.0,21,S
2018-04-20 13:32:10,13575.0,10,18510,10,13570.0,1,13575.0,15,B
2018-04-20 13:32:19,13575.0,4,18514,4,13570.0,18,13575.0,11,B
2018-04-20 13:32:21,13570.0,4,18518,4,13570.0,16,13575.0,11,S
2018-04-20 13:32:22,13570.0,2,18520,2,13570.0,15,13575.0,11,S
2018-04-20 13:32:23,13575.0,2,18522,0,13570.0,15,13575.0,10,B
2018-04-20 13:32:24,13570.0,4,18526,4,13570.0,13,13575.0,10,S
2018-04-20 13:32:24,13575.0,2,18528,0,13570.0,13,13575.0,9,B
2018-04-20 13:32:27,13570.0,4,18532,4,13570.0,8,13575.0,9,S
2018-04-20 13:32:30,13575.0,2,18534,2,13570.0,8,13575.0,8,B
2018-04-20 13:32:30,13570.0,2,18536,0,13570.0,7,13575.0,8,S
2018-04-20 13:32:31,13570.0,2,18538,2,13570.0,3,13575.0,15,S
2018-04-20 13:32:32,13570.0,20,18558,18,13565.0,22,13570.0,10,S
2018-04-20 13:32:33,13570.0,20,18578,8,13570.0,8,13575.0,9,S
2018-04-20 13:32:35,13570.0,16,18594,16,13565.0,24,13570.0,12,S
2018-04-20 13:32:35,13570.0,4,18598,4,13565.0,31,13570.0,10,S
2018-04-20 13:32:36,13570.0,10,18608,0,13565.0,31,13570.0,5,S
2018-04-20 13:32:37,13575.0,12,18620,12,13565.0,30,13575.0,10,B
2018-04-20 13:32:44,13570.0,6,18626,6,13565.0,26,13570.0,27,S
2018-04-20 13:32:45,13565.0,40,18666,24,13565.0,11,13570.0,27,S
2018-04-20 13:32:46,13570.0,2,18668,2,13565.0,11,13570.0,26,B
2018-04-20 13:32:48,13565.0,24,18692,24,13560.0,25,13565.0,8,S
2018-04-20 13:32:49,13570.0,64,18756,64,13565.0,9,13570.0,4,B
2018-04-20 13:32:49,13570.0,2,18758,2,13565.0,8,13570.0,3,B
2018-04-20 13:32:50,13565.0,2,18760,0,13560.0,27,13570.0,3,S
2018-04-20 13:32:51,13570.0,2,18762,2,13560.0,22,13570.0,6,B
2018-04-20 13:32:52,13570.0,10,18772,2,13570.0,4,13575.0,21,B
2018-04-20 13:32:52,13570.0,14,18786,12,13565.0,1,13570.0,4,B
2018-04-20 13:32:55,13570.0,2,18788,0,13565.0,1,13570.0,3,B
2018-04-20 13:32:56,13570.0,2,18790,0,13565.0,1,13570.0,2,B
2018-04-20 13:32:57,13565.0,2,18792,2,13560.0,15,13565.0,19,S
2018-04-20 13:32:57,13565.0,22,18814,18,13560.0,20,13565.0,8,S
2018-04-20 13:33:00,13565.0,4,18818,4,13560.0,18,13565.0,6,S
2018-04-20 13:33:01,13565.0,12,18830,12,13560.0,19,13570.0,5,S
2018-04-20 13:33:02,13570.0,2,18832,-2,13560.0,22,13570.0,4,B
2018-04-20 13:33:03,13570.0,4,18836,0,13560.0,24,13570.0,6,B
2018-04-20 13:33:04,13570.0,2,18838,2,13560.0,26,13570.0,6,B
2018-04-20 13:33:04,13570.0,2,18840,2,13560.0,26,13570.0,5,B
2018-04-20 13:33:11,13565.0,2,18842,0,13560.0,12,13565.0,22,S
2018-04-20 13:33:16,13565.0,6,18848,2,13560.0,12,13565.0,23,S
2018-04-20 13:33:16,13565.0,22,18870,16,13560.0,14,13565.0,22,S
2018-04-20 13:33:19,13565.0,2,18872,2,13560.0,16,13565.0,21,S
2018-04-20 13:33:23,13565.0,2,18874,0,13560.0,19,13565.0,20,S
2018-04-20 13:33:29,13565.0,10,18884,8,13560.0,20,13565.0,16,S
2018-04-20 13:33:30,13565.0,2,18886,0,13560.0,20,13565.0,15,S
2018-04-20 13:33:32,13565.0,2,18888,0,13560.0,17,13565.0,16,S
2018-04-20 13:33:36,13560.0,6,18894,4,13560.0,5,13565.0,21,S
2018-04-20 13:33:37,13565.0,4,18898,0,13560.0,6,13565.0,17,B
2018-04-20 13:33:44,13565.0,20,18918,0,13560.0,25,13565.0,2,B
2018-04-20 13:33:45,13565.0,4,18922,0,13560.0,25,13570.0,14,B
2018-04-20 13:33:46,13565.0,10,18932,10,13560.0,28,13565.0,15,B
2018-04-20 13:33:47,13565.0,10,18942,6,13560.0,26,13565.0,10,B
2018-04-20 13:33:48,13565.0,14,18956,14,13560.0,19,13565.0,3,B
2018-04-20 13:33:49,13565.0,6,18962,6,13560.0,19,13570.0,18,B
2018-04-20 13:33:54,13565.0,2,18964,2,13560.0,19,13565.0,24,B
2018-04-20 13:33:55,13565.0,4,18968,0,13560.0,19,13565.0,22,B
2018-04-20 13:33:56,13565.0,4,18972,4,13560.0,19,13565.0,20,B
2018-04-20 13:33:56,13565.0,8,18980,6,13560.0,14,13565.0,18,B
2018-04-20 13:33:57,13565.0,14,18994,10,13560.0,13,13565.0,9,B
2018-04-20 13:33:58,13570.0,34,19028,34,13565.0,4,13570.0,6,B
2018-04-20 13:34:03,13565.0,26,19054,12,13565.0,3,13570.0,7,S
2018-04-20 13:34:04,13565.0,12,19066,-4,13560.0,9,13565.0,1,S
2018-04-20 13:34:06,13565.0,2,19068,0,13560.0,10,13570.0,19,S
2018-04-20 13:34:10,13565.0,2,19070,0,13560.0,11,13565.0,4,S
2018-04-20 13:34:11,13565.0,8,19078,-4,13560.0,11,13565.0,1,S
2018-04-20 13:34:12,13565.0,2,19080,2,13565.0,2,13570.0,19,S
2018-04-20 13:34:15,13570.0,4,19084,4,13565.0,1,13570.0,13,B
2018-04-20 13:34:17,13570.0,4,19088,0,13565.0,1,13570.0,12,B
2018-04-20 13:34:17,13570.0,4,19092,2,13565.0,1,13570.0,10,B
2018-04-20 13:34:19,13570.0,2,19094,0,13565.0,3,13570.0,6,B
2018-04-20 13:34:25,13565.0,8,19102,-4,13560.0,12,13570.0,13,S
2018-04-20 13:34:26,13560.0,2,19104,-2,13560.0,5,13565.0,20,S
2018-04-20 13:34:26,13560.0,10,19114,-2,13555.0,8,13560.0,7,S
2018-04-20 13:34:27,13560.0,8,19122,6,13560.0,3,13565.0,9,S
2018-04-20 13:34:29,13560.0,2,19124,0,13555.0,10,13560.0,9,S
2018-04-20 13:34:33,13560.0,2,19126,2,13555.0,11,13560.0,8,S
2018-04-20 13:34:34,13560.0,16,19142,10,13560.0,3,13565.0,19,S
2018-04-20 13:34:34,13565.0,10,19152,2,13560.0,13,13565.0,10,B
2018-04-20 13:34:36,13560.0,2,19154,-2,13560.0,10,13565.0,13,S
2018-04-20 13:34:37,13565.0,4,19158,4,13560.0,8,13565.0,13,B
2018-04-20 13:34:44,13560.0,6,19164,0,13560.0,2,13565.0,15,S
2018-04-20 13:34:44,13560.0,6,19170,6,13555.0,20,13565.0,15,S
2018-04-20 13:34:54,13560.0,2,19172,-2,13555.0,18,13560.0,12,S
2018-04-20 13:34:55,13560.0,22,19194,12,13555.0,9,13560.0,11,S
2018-04-20 13:34:56,13560.0,6,19200,6,13555.0,10,13560.0,8,S
2018-04-20 13:34:57,13560.0,4,19204,4,13555.0,10,13560.0,6,S
2018-04-20 13:34:58,13560.0,6,19210,6,13555.0,10,13560.0,3,S
2018-04-20 13:34:59,13560.0,2,19212,0,13555.0,12,13560.0,2,S
2018-04-20 13:35:00,13560.0,4,19216,2,13555.0,12,13565.0,16,S
2018-04-20 13:35:00,13565.0,14,19230,14,13555.0,13,13565.0,9,B
2018-04-20 13:35:01,13565.0,2,19232,2,13560.0,8,13570.0,19,B
2018-04-20 13:35:06,13555.0,10,19242,8,13555.0,11,13565.0,22,S
2018-04-20 13:35:09,13565.0,8,19250,0,13560.0,7,13565.0,1,B
2018-04-20 13:35:13,13560.0,8,19258,0,13555.0,23,13565.0,3,S
2018-04-20 13:35:13,13555.0,42,19300,-12,13555.0,2,13560.0,5,S
2018-04-20 13:35:14,13555.0,4,19304,0,13550.0,21,13560.0,8,S
2018-04-20 13:35:19,13560.0,2,19306,0,13555.0,4,13560.0,7,B
2018-04-20 13:35:20,13560.0,4,19310,0,13555.0,4,13560.0,5,B
2018-04-20 13:35:21,13560.0,6,19316,0,13555.0,4,13560.0,2,B
2018-04-20 13:35:22,13560.0,4,19320,0,13560.0,5,13565.0,13,B
2018-04-20 13:35:23,13560.0,4,19324,0,13560.0,23,13565.0,8,B
2018-04-20 13:35:25,13565.0,4,19328,2,13560.0,21,13570.0,24,B
2018-04-20 13:35:30,13565.0,2,19330,-2,13560.0,21,13565.0,6,B
2018-04-20 13:35:44,13565.0,18,19348,8,13565.0,1,13570.0,27,B
2018-04-20 13:35:45,13565.0,2,19350,2,13560.0,22,13565.0,5,B
2018-04-20 13:35:47,13560.0,20,19370,20,13560.0,12,13565.0,13,S
2018-04-20 13:35:48,13560.0,6,19376,6,13560.0,9,13565.0,11,S
2018-04-20 13:35:50,13560.0,4,19380,4,13560.0,7,13565.0,12,S
2018-04-20 13:35:51,13560.0,14,19394,0,13555.0,4,13560.0,1,S
2018-04-20 13:35:58,13555.0,2,19396,0,13555.0,6,13560.0,11,S
2018-04-20 13:35:58,13560.0,8,19404,-2,13555.0,7,13560.0,7,B
2018-04-20 13:36:03,13555.0,6,19410,-2,13550.0,22,13560.0,13,S
2018-04-20 13:36:07,13550.0,2,19412,-2,13550.0,19,13555.0,2,S
2018-04-20 13:36:08,13550.0,2,19414,0,13550.0,17,13555.0,2,S
2018-04-20 13:36:09,13550.0,20,19434,20,13550.0,7,13555.0,2,S
2018-04-20 13:36:10,13550.0,14,19448,4,13545.0,2,13550.0,10,S
2018-04-20 13:36:10,13550.0,2,19450,2,13545.0,6,13550.0,10,S
2018-04-20 13:36:11,13550.0,20,19470,0,13545.0,7,13555.0,5,S
2018-04-20 13:36:13,13545.0,4,19474,2,13545.0,4,13550.0,4,S
2018-04-20 13:36:14,13545.0,4,19478,-2,13545.0,2,13550.0,4,S
2018-04-20 13:36:15,13545.0,6,19484,2,13540.0,4,13545.0,5,S
2018-04-20 13:36:16,13540.0,6,19490,4,13540.0,1,13545.0,38,S
2018-04-20 13:36:17,13535.0,4,19494,0,13535.0,19,13545.0,38,S
2018-04-20 13:36:17,13535.0,2,19496,-2,13535.0,20,13545.0,38,S
2018-04-20 13:36:19,13535.0,4,19500,2,13535.0,9,13540.0,2,S
2018-04-20 13:36:20,13535.0,8,19508,2,13530.0,17,13540.0,5,S
2018-04-20 13:36:21,13530.0,2,19510,-2,13530.0,18,13535.0,1,S
2018-04-20 13:36:22,13530.0,4,19514,-2,13530.0,16,13535.0,1,S
2018-04-20 13:36:22,13530.0,4,19518,4,13530.0,17,13540.0,8,S
2018-04-20 13:36:23,13535.0,2,19520,0,13530.0,19,13540.0,8,B
2018-04-20 13:36:25,13530.0,60,19580,54,13530.0,2,13535.0,1,S
2018-04-20 13:36:26,13535.0,6,19586,0,13525.0,11,13535.0,11,B
2018-04-20 13:36:29,13525.0,6,19592,-6,13525.0,8,13530.0,14,S
2018-04-20 13:36:29,13525.0,6,19598,0,13525.0,8,13535.0,14,S
2018-04-20 13:36:33,13525.0,22,19620,10,13520.0,6,13525.0,9,S
2018-04-20 13:36:34,13525.0,18,19638,16,13525.0,4,13530.0,1,S
2018-04-20 13:36:34,13525.0,2,19640,0,13525.0,3,13530.0,2,S
2018-04-20 13:36:36,13530.0,6,19646,6,13525.0,1,13530.0,2,B
2018-04-20 13:36:36,13530.0,2,19648,2,13525.0,4,13535.0,9,B
2018-04-20 13:36:37,13535.0,20,19668,8,13525.0,4,13535.0,1,B
2018-04-20 13:36:37,13535.0,4,19672,2,13535.0,5,13540.0,8,B
2018-04-20 13:36:38,13535.0,4,19676,2,13535.0,3,13540.0,5,B
2018-04-20 13:36:38,13535.0,6,19682,0,13530.0,5,13540.0,7,B
2018-04-20 13:36:41,13530.0,6,19688,-4,13525.0,6,13535.0,11,S
2018-04-20 13:36:41,13525.0,2,19690,-2,13525.0,3,13535.0,12,S
2018-04-20 13:36:42,13530.0,10,19700,10,13525.0,3,13530.0,1,B
2018-04-20 13:36:43,13525.0,4,19704,-2,13520.0,10,13530.0,4,S
2018-04-20 13:36:46,13515.0,30,19734,8,13510.0,8,13520.0,1,S
2018-04-20 13:36:46,13520.0,18,19752,6,13510.0,6,13520.0,1,B
2018-04-20 13:36:47,13515.0,12,19764,4,13510.0,2,13515.0,15,S
2018-04-20 13:36:47,13510.0,4,19768,2,13505.0,11,13515.0,16,S
2018-04-20 13:36:48,13510.0,8,19776,2,13510.0,2,13515.0,9,S
2018-04-20 13:36:48,13510.0,4,19780,-4,13505.0,18,13510.0,2,S
2018-04-20 13:36:49,13505.0,2,19782,-2,13505.0,10,13510.0,6,S
2018-04-20 13:36:49,13505.0,36,19818,-6,13500.0,45,13505.0,27,S
2018-04-20 13:36:50,13505.0,54,19872,-28,13505.0,6,13510.0,6,S
2018-04-20 13:36:50,13510.0,12,19884,0,13505.0,8,13515.0,9,B
2018-04-20 13:36:51,13505.0,8,19892,0,13500.0,52,13510.0,9,S
2018-04-20 13:36:52,13500.0,12,19904,0,13500.0,39,13505.0,2,S
2018-04-20 13:36:53,13500.0,38,19942,6,13500.0,20,13505.0,8,S
2018-04-20 13:36:53,13495.0,42,19984,22,13495.0,2,13500.0,10,S
2018-04-20 13:36:54,13495.0,4,19988,2,13495.0,1,13500.0,8,S
2018-04-20 13:36:55,13505.0,16,20004,4,13500.0,4,13505.0,3,B
2018-04-20 13:36:56,13500.0,6,20010,0,13495.0,12,13505.0,3,S
2018-04-20 13:36:57,13505.0,2,20012,2,13495.0,12,13505.0,8,B
2018-04-20 13:36:58,13505.0,10,20022,4,13495.0,9,13505.0,4,B
2018-04-20 13:36:59,13500.0,2,20024,2,13495.0,5,13500.0,1,S
2018-04-20 13:37:00,13505.0,12,20036,12,13495.0,3,13505.0,3,B
2018-04-20 13:37:01,13505.0,4,20040,2,13500.0,1,13505.0,1,B
2018-04-20 13:37:01,13505.0,4,20044,2,13505.0,1,13510.0,3,B
2018-04-20 13:37:02,13505.0,12,20056,2,13500.0,3,13510.0,15,B
2018-04-20 13:37:02,13500.0,8,20064,-6,13495.0,5,13500.0,4,S
2018-04-20 13:37:03,13500.0,2,20066,0,13500.0,16,13505.0,11,S
2018-04-20 13:37:04,13505.0,8,20074,8,13500.0,26,13505.0,6,B
2018-04-20 13:37:05,13500.0,22,20096,12,13500.0,20,13510.0,6,S
2018-04-20 13:37:05,13500.0,4,20100,-4,13500.0,19,13510.0,8,S
2018-04-20 13:37:06,13500.0,4,20104,4,13505.0,2,13510.0,8,S
2018-04-20 13:37:07,13510.0,12,20116,0,13510.0,2,13515.0,11,B
2018-04-20 13:37:11,13515.0,6,20122,0,13515.0,2,13520.0,14,B
2018-04-20 13:37:11,13515.0,4,20126,0,13510.0,16,13520.0,15,B
2018-04-20 13:37:14,13515.0,10,20136,0,13510.0,10,13515.0,2,B
2018-04-20 13:37:16,13510.0,8,20144,-4,13505.0,11,13515.0,19,S
2018-04-20 13:37:17,13515.0,4,20148,0,13510.0,13,13515.0,3,B
2018-04-20 13:37:17,13515.0,6,20154,-6,13510.0,13,13520.0,13,B
2018-04-20 13:37:19,13520.0,4,20158,0,13510.0,14,13520.0,15,B
2018-04-20 13:37:21,13520.0,4,20162,0,13515.0,9,13520.0,2,B
2018-04-20 13:37:21,13520.0,4,20166,4,13515.0,9,13525.0,5,B
2018-04-20 13:37:22,13525.0,4,20170,0,13515.0,17,13525.0,9,B
2018-04-20 13:37:24,13525.0,2,20172,0,13525.0,6,13530.0,10,B
2018-04-20 13:37:25,13525.0,2,20174,0,13525.0,5,13530.0,7,B
2018-04-20 13:37:25,13525.0,2,20176,0,13525.0,4,13530.0,7,B
2018-04-20 13:37:26,13530.0,2,20178,0,13525.0,3,13530.0,6,B
2018-04-20 13:37:26,13530.0,4,20182,2,13525.0,3,13530.0,4,B
2018-04-20 13:37:29,13525.0,6,20188,-6,13520.0,22,13530.0,9,S
2018-04-20 13:37:30,13530.0,16,20204,10,13525.0,17,13535.0,8,B
2018-04-20 13:37:32,13525.0,4,20208,-4,13525.0,8,13530.0,5,S
2018-04-20 13:37:33,13525.0,2,20210,-2,13525.0,14,13530.0,5,S
2018-04-20 13:37:34,13530.0,2,20212,-2,13525.0,7,13530.0,8,B
2018-04-20 13:37:35,13525.0,2,20214,-2,13525.0,8,13530.0,8,S
2018-04-20 13:37:36,13530.0,4,20218,-4,13525.0,8,13530.0,6,B
2018-04-20 13:37:37,13530.0,4,20222,0,13525.0,8,13530.0,3,B
2018-04-20 13:37:39,13530.0,2,20224,-2,13525.0,6,13530.0,2,B
2018-04-20 13:37:41,13530.0,14,20238,6,13525.0,6,13530.0,2,B
2018-04-20 13:37:46,13530.0,2,20240,0,13525.0,6,13530.0,3,B
2018-04-20 13:37:48,13520.0,32,20272,0,13515.0,2,13520.0,2,S
2018-04-20 13:37:48,13530.0,74,20346,34,13515.0,1,13525.0,1,B
2018-04-20 13:37:49,13515.0,2,20348,-2,13515.0,2,13520.0,1,S
2018-04-20 13:37:49,13520.0,4,20352,-2,13515.0,11,13520.0,1,B
2018-04-20 13:37:50,13520.0,4,20356,2,13515.0,11,13520.0,1,B
2018-04-20 13:37:52,13515.0,4,20360,2,13510.0,3,13515.0,22,S
2018-04-20 13:37:52,13510.0,2,20362,-2,13510.0,1,13515.0,15,S
2018-04-20 13:37:53,13515.0,12,20374,6,13510.0,14,13515.0,1,B
2018-04-20 13:37:54,13515.0,4,20378,2,13510.0,4,13515.0,2,B
2018-04-20 13:37:54,13510.0,2,20380,0,13510.0,1,13515.0,9,S
2018-04-20 13:37:55,13510.0,2,20382,-2,13510.0,6,13515.0,9,S
2018-04-20 13:37:56,13515.0,2,20384,0,13510.0,1,13515.0,8,B
2018-04-20 13:37:57,13510.0,2,20386,0,13505.0,4,13515.0,14,S
2018-04-20 13:37:59,13515.0,2,20388,0,13510.0,15,13515.0,2,B
2018-04-20 13:37:59,13515.0,6,20394,2,13510.0,19,13520.0,6,B
2018-04-20 13:38:00,13515.0,4,20398,0,13515.0,21,13520.0,3,B
2018-04-20 13:38:06,13520.0,2,20400,-2,13515.0,7,13525.0,16,B
2018-04-20 13:38:10,13525.0,6,20406,-6,13515.0,12,13525.0,17,B
2018-04-20 13:38:12,13515.0,2,20408,-2,13510.0,7,13520.0,3,S
2018-04-20 13:38:13,13520.0,4,20412,-4,13515.0,11,13525.0,16,B
2018-04-20 13:38:14,13520.0,4,20416,-4,13515.0,11,13525.0,18,B
2018-04-20 13:38:15,13520.0,2,20418,0,13515.0,3,13520.0,2,B
2018-04-20 13:38:16,13525.0,2,20420,2,13515.0,9,13525.0,28,B
2018-04-20 13:38:17,13520.0,2,20422,0,13515.0,13,13525.0,13,S
2018-04-20 13:38:18,13520.0,2,20424,0,13515.0,7,13525.0,13,S
2018-04-20 13:38:21,13520.0,2,20426,-2,13520.0,15,13525.0,8,S
2018-04-20 13:38:21,13525.0,16,20442,10,13525.0,6,13530.0,6,B
2018-04-20 13:38:24,13525.0,2,20444,2,13525.0,5,13530.0,6,B
2018-04-20 13:38:26,13525.0,2,20446,0,13520.0,4,13525.0,3,B
2018-04-20 13:38:37,13525.0,6,20452,4,13525.0,12,13530.0,14,B
2018-04-20 13:38:38,13530.0,28,20480,-4,13530.0,2,13535.0,7,B
2018-04-20 13:38:38,13530.0,2,20482,0,13530.0,4,13535.0,7,B
2018-04-20 13:38:40,13530.0,2,20484,-2,13530.0,3,13535.0,5,B
2018-04-20 13:38:46,13535.0,2,20486,0,13530.0,3,13535.0,14,B
2018-04-20 13:38:47,13535.0,28,20514,4,13535.0,16,13540.0,7,B
2018-04-20 13:38:48,13535.0,6,20520,6,13535.0,13,13540.0,17,B
2018-04-20 13:38:48,13535.0,6,20526,0,13535.0,10,13540.0,16,B
2018-04-20 13:38:56,13535.0,20,20546,20,13530.0,4,13535.0,40,B
2018-04-20 13:38:57,13535.0,2,20548,2,13530.0,4,13535.0,39,B
2018-04-20 13:38:58,13530.0,2,20550,0,13530.0,3,13535.0,39,S
2018-04-20 13:38:58,13530.0,6,20556,-2,13525.0,11,13535.0,39,S
2018-04-20 13:39:02,13530.0,2,20558,0,13525.0,4,13530.0,4,S
2018-04-20 13:39:04,13530.0,2,20560,0,13525.0,4,13530.0,3,S
2018-04-20 13:39:07,13525.0,2,20562,0,13525.0,3,13530.0,3,S
2018-04-20 13:39:08,13530.0,2,20564,0,13525.0,4,13530.0,4,B
2018-04-20 13:39:13,13530.0,4,20568,0,13525.0,5,13530.0,3,B
2018-04-20 13:39:14,13530.0,2,20570,2,13525.0,5,13530.0,2,B
2018-04-20 13:39:16,13530.0,2,20572,0,13525.0,9,13530.0,1,B
2018-04-20 13:39:17,13530.0,2,20574,-2,13530.0,2,13535.0,42,B
2018-04-20 13:39:26,13530.0,6,20580,6,13530.0,1,13535.0,42,B
2018-04-20 13:39:26,13530.0,2,20582,2,13525.0,9,13535.0,53,B
2018-04-20 13:39:28,13535.0,2,20584,2,13525.0,9,13535.0,52,B
2018-04-20 13:39:30,13530.0,4,20588,-2,13525.0,8,13535.0,50,S
2018-04-20 13:39:38,13535.0,12,20600,12,13530.0,15,13535.0,32,B
2018-04-20 13:39:38,13535.0,16,20616,16,13530.0,16,13535.0,24,B
2018-04-20 13:39:43,13535.0,2,20618,0,13530.0,2,13535.0,26,B
2018-04-20 13:39:45,13530.0,4,20622,4,13525.0,9,13530.0,2,S
2018-04-20 13:39:46,13530.0,4,20626,4,13525.0,13,13535.0,28,S
2018-04-20 13:39:55,13525.0,6,20632,2,13525.0,13,13535.0,27,S
2018-04-20 13:40:02,13525.0,2,20634,0,13525.0,3,13530.0,6,S
2018-04-20 13:40:03,13525.0,2,20636,0,13525.0,2,13530.0,7,S
2018-04-20 13:40:05,13525.0,6,20642,-4,13525.0,11,13530.0,8,S
2018-04-20 13:40:05,13525.0,2,20644,2,13525.0,10,13530.0,7,S
2018-04-20 13:40:11,13530.0,2,20646,-2,13525.0,7,13530.0,6,B
2018-04-20 13:40:21,13530.0,2,20648,0,13525.0,4,13530.0,8,B
2018-04-20 13:40:25,13530.0,2,20650,2,13525.0,7,13530.0,4,B
2018-04-20 13:40:26,13530.0,8,20658,0,13525.0,14,13535.0,28,B
2018-04-20 13:40:30,13530.0,2,20660,-2,13525.0,9,13535.0,42,B
2018-04-20 13:40:32,13535.0,10,20670,10,13525.0,6,13535.0,37,B
2018-04-20 13:40:38,13535.0,2,20672,2,13525.0,6,13535.0,39,B
2018-04-20 13:40:41,13525.0,2,20674,0,13525.0,5,13535.0,41,S
2018-04-20 13:40:43,13525.0,4,20678,-4,13525.0,3,13535.0,41,S
2018-04-20 13:40:47,13535.0,2,20680,0,13525.0,4,13535.0,38,B
2018-04-20 13:40:48,13525.0,10,20690,0,13525.0,1,13535.0,38,S
2018-04-20 13:41:02,13535.0,10,20700,10,13530.0,3,13535.0,13,B
2018-04-20 13:41:02,13535.0,8,20708,8,13530.0,9,13535.0,9,B
2018-04-20 13:41:04,13530.0,2,20710,0,13530.0,8,13535.0,9,S
2018-04-20 13:41:08,13535.0,4,20714,4,13530.0,8,13535.0,7,B
2018-04-20 13:41:10,13535.0,8,20722,0,13530.0,8,13535.0,3,B
2018-04-20 13:41:10,13535.0,6,20728,0,13530.0,8,13540.0,6,B
2018-04-20 13:41:13,13540.0,10,20738,-6,13535.0,11,13540.0,2,B
2018-04-20 13:41:13,13540.0,4,20742,0,13540.0,2,13545.0,4,B
2018-04-20 13:41:15,13545.0,6,20748,-2,13540.0,2,13545.0,1,B
2018-04-20 13:41:27,13540.0,2,20750,-2,13540.0,1,13545.0,4,S
2018-04-20 13:41:32,13540.0,2,20752,0,13535.0,8,13545.0,3,S
2018-04-20 13:41:35,13545.0,4,20756,-2,13535.0,12,13545.0,3,B
2018-04-20 13:41:37,13540.0,2,20758,0,13540.0,2,13545.0,3,S
2018-04-20 13:41:40,13540.0,6,20764,4,13535.0,6,13540.0,14,S
2018-04-20 13:41:45,13540.0,8,20772,0,13540.0,1,13545.0,20,S
2018-04-20 13:41:45,13540.0,2,20774,0,13535.0,4,13540.0,2,S
2018-04-20 13:41:48,13545.0,50,20824,20,13535.0,2,13545.0,3,B
2018-04-20 13:41:49,13540.0,2,20826,0,13535.0,5,13545.0,8,S
2018-04-20 13:41:50,13540.0,2,20828,2,13540.0,1,13545.0,7,S
2018-04-20 13:41:51,13540.0,2,20830,2,13535.0,5,13545.0,7,S
2018-04-20 13:41:52,13540.0,2,20832,2,13535.0,5,13545.0,7,S
2018-04-20 13:41:53,13545.0,8,20840,-4,13540.0,5,13545.0,2,B
2018-04-20 13:42:11,13550.0,20,20860,10,13540.0,13,13550.0,5,B
2018-04-20 13:42:11,13540.0,2,20862,0,13540.0,12,13550.0,5,S
2018-04-20 13:42:12,13545.0,2,20864,2,13545.0,3,13550.0,5,B
2018-04-20 13:42:13,13545.0,2,20866,2,13545.0,2,13550.0,7,B
2018-04-20 13:42:13,13545.0,4,20870,4,13540.0,11,13550.0,7,B
2018-04-20 13:42:16,13545.0,12,20882,0,13540.0,9,13550.0,8,B
2018-04-20 13:42:19,13545.0,2,20884,0,13545.0,2,13550.0,5,B
2018-04-20 13:42:22,13550.0,2,20886,2,13545.0,8,13550.0,4,B
2018-04-20 13:42:25,13550.0,2,20888,2,13545.0,8,13550.0,3,B
2018-04-20 13:42:28,13550.0,8,20896,-4,13545.0,9,13555.0,15,B
2018-04-20 13:42:30,13550.0,4,20900,4,13550.0,4,13555.0,13,B
2018-04-20 13:42:34,13555.0,22,20922,18,13550.0,3,13555.0,5,B
2018-04-20 13:42:34,13550.0,6,20928,4,13545.0,6,13550.0,4,S
2018-04-20 13:42:39,13550.0,2,20930,2,13545.0,6,13550.0,2,S
2018-04-20 13:42:40,13545.0,2,20932,0,13545.0,5,13550.0,2,S
2018-04-20 13:42:45,13550.0,6,20938,-2,13550.0,4,13555.0,19,B
2018-04-20 13:42:45,13550.0,8,20946,-8,13545.0,3,13550.0,1,B
2018-04-20 13:42:48,13550.0,4,20950,2,13545.0,4,13550.0,1,B
2018-04-20 13:42:51,13550.0,2,20952,0,13545.0,4,13550.0,1,B
2018-04-20 13:42:53,13550.0,2,20954,0,13550.0,5,13555.0,18,B
2018-04-20 13:42:54,13555.0,8,20962,-6,13550.0,4,13555.0,1,B
2018-04-20 13:42:55,13555.0,4,20966,-2,13555.0,1,13560.0,11,B
2018-04-20 13:42:55,13550.0,10,20976,0,13550.0,1,13555.0,1,S
2018-04-20 13:42:56,13555.0,6,20982,4,13550.0,1,13555.0,4,B
2018-04-20 13:42:56,13550.0,2,20984,0,13545.0,8,13555.0,5,S
2018-04-20 13:43:03,13545.0,2,20986,0,13545.0,3,13555.0,17,S
2018-04-20 13:43:14,13555.0,18,21004,8,13545.0,8,13560.0,19,B
2018-04-20 13:43:20,13550.0,6,21010,0,13545.0,4,13550.0,7,S
2018-04-20 13:43:23,13545.0,8,21018,-6,13545.0,2,13555.0,11,S
2018-04-20 13:43:28,13545.0,2,21020,0,13545.0,5,13550.0,4,S
2018-04-20 13:43:39,13545.0,4,21024,4,13540.0,8,13550.0,9,S
2018-04-20 13:43:46,13540.0,2,21026,0,13540.0,8,13550.0,9,S
2018-04-20 13:43:52,13540.0,2,21028,0,13540.0,1,13545.0,14,S
2018-04-20 13:43:53,13540.0,2,21030,0,13535.0,7,13545.0,14,S
2018-04-20 13:44:05,13540.0,6,21036,6,13535.0,9,13545.0,6,S
2018-04-20 13:44:18,13540.0,10,21046,8,13535.0,10,13545.0,10,S
2018-04-20 13:44:27,13540.0,2,21048,0,13540.0,8,13545.0,11,S
2018-04-20 13:44:32,13545.0,20,21068,4,13540.0,5,13545.0,1,B
2018-04-20 13:44:33,13540.0,10,21078,-2,13535.0,10,13540.0,1,S
2018-04-20 13:44:35,13540.0,6,21084,-4,13540.0,1,13545.0,7,S
2018-04-20 13:44:56,13540.0,2,21086,2,13535.0,7,13545.0,12,S
2018-04-20 13:44:57,13535.0,4,21090,-2,13535.0,5,13545.0,12,S
2018-04-20 13:45:02,13535.0,8,21098,-4,13530.0,4,13540.0,1,S
2018-04-20 13:45:07,13535.0,6,21104,4,13530.0,1,13535.0,19,S
2018-04-20 13:45:07,13530.0,4,21108,-4,13525.0,2,13530.0,8,S
2018-04-20 13:45:08,13530.0,16,21124,-4,13530.0,7,13535.0,7,S
2018-04-20 13:45:08,13535.0,14,21138,-8,13530.0,14,13540.0,28,B
2018-04-20 13:45:12,13535.0,2,21140,0,13530.0,16,13540.0,26,B
2018-04-20 13:45:22,13535.0,2,21142,2,13535.0,8,13540.0,22,B
2018-04-20 13:45:25,13535.0,2,21144,0,13530.0,9,13540.0,26,B
2018-04-20 13:45:28,13535.0,6,21150,4,13530.0,20,13540.0,24,B
2018-04-20 13:45:30,13535.0,2,21152,-2,13535.0,2,13540.0,24,B
2018-04-20 13:45:35,13535.0,4,21156,-4,13535.0,3,13540.0,25,B
2018-04-20 13:45:36,13535.0,2,21158,-2,13535.0,4,13540.0,24,B
2018-04-20 13:45:39,13540.0,26,21184,0,13535.0,5,13540.0,8,B
2018-04-20 13:45:39,13540.0,16,21200,0,13535.0,15,13545.0,8,B
2018-04-20 13:45:42,13545.0,10,21210,4,13540.0,5,13545.0,1,B
2018-04-20 13:45:42,13545.0,2,21212,0,13545.0,5,13550.0,14,B
2018-04-20 13:45:43,13545.0,12,21224,0,13540.0,18,13550.0,13,B
2018-04-20 13:45:43,13545.0,2,21226,0,13540.0,9,13550.0,18,B
2018-04-20 13:45:46,13540.0,2,21228,0,13535.0,11,13540.0,9,S
2018-04-20 13:45:46,13540.0,6,21234,4,13535.0,13,13540.0,6,S
2018-04-20 13:45:47,13540.0,8,21242,4,13535.0,13,13540.0,2,S
2018-04-20 13:45:49,13540.0,4,21246,0,13540.0,2,13545.0,2,S
2018-04-20 13:45:58,13540.0,2,21248,0,13535.0,12,13545.0,8,S
2018-04-20 13:46:13,13540.0,4,21252,4,13540.0,4,13545.0,12,S
2018-04-20 13:46:13,13540.0,8,21260,-6,13535.0,10,13545.0,12,S
2018-04-20 13:46:22,13540.0,2,21262,0,13540.0,4,13545.0,5,S
2018-04-20 13:46:43,13540.0,6,21268,-6,13535.0,16,13540.0,1,S
2018-04-20 13:46:44,13540.0,2,21270,0,13535.0,20,13545.0,11,S
2018-04-20 13:46:58,13545.0,2,21272,0,13540.0,4,13545.0,9,B
2018-04-20 13:47:06,13540.0,10,21282,-8,13535.0,15,13545.0,10,S
2018-04-20 13:47:07,13540.0,2,21284,2,13535.0,6,13540.0,1,S
2018-04-20 13:47:13,13540.0,6,21290,0,13540.0,1,13545.0,9,S
2018-04-20 13:47:38,13540.0,2,21292,2,13535.0,31,13540.0,3,S
2018-04-20 13:47:38,13540.0,6,21298,4,13535.0,29,13545.0,8,S
2018-04-20 13:47:45,13540.0,2,21300,0,13535.0,37,13540.0,19,S
2018-04-20 13:47:47,13540.0,8,21308,8,13535.0,36,13540.0,15,S
2018-04-20 13:47:48,13535.0,6,21314,0,13535.0,38,13540.0,13,S
2018-04-20 13:47:57,13535.0,2,21316,2,13535.0,38,13540.0,13,S
2018-04-20 13:48:04,13540.0,10,21326,10,13535.0,38,13540.0,8,B
2018-04-20 13:48:05,13540.0,4,21330,4,13535.0,38,13540.0,6,B
2018-04-20 13:48:06,13540.0,2,21332,0,13535.0,38,13540.0,5,B
2018-04-20 13:48:16,13540.0,2,21334,2,13535.0,63,13540.0,7,B
2018-04-20 13:48:27,13540.0,14,21348,12,13540.0,1,13545.0,8,B
2018-04-20 13:48:32,13540.0,14,21362,0,13535.0,63,13545.0,9,B
2018-04-20 13:48:37,13540.0,2,21364,-2,13535.0,71,13545.0,7,B
2018-04-20 13:48:41,13540.0,8,21372,4,13535.0,69,13545.0,9,B
2018-04-20 13:48:54,13540.0,4,21376,0,13535.0,68,13545.0,13,B
2018-04-20 13:48:55,13540.0,2,21378,2,13535.0,88,13540.0,1,B
2018-04-20 13:49:05,13540.0,2,21380,-2,13535.0,83,13540.0,2,B
2018-04-20 13:49:12,13540.0,2,21382,0,13535.0,83,13540.0,7,B
2018-04-20 13:49:14,13540.0,12,21394,-8,13540.0,4,13545.0,9,B
2018-04-20 13:49:27,13545.0,10,21404,-6,13540.0,2,13545.0,24,B
2018-04-20 13:49:28,13540.0,2,21406,2,13540.0,1,13545.0,24,S
2018-04-20 13:49:30,13545.0,16,21422,10,13540.0,2,13545.0,16,B
2018-04-20 13:49:43,13545.0,2,21424,2,13540.0,6,13545.0,16,B
2018-04-20 13:49:51,13545.0,2,21426,2,13540.0,24,13545.0,17,B
2018-04-20 13:50:08,13545.0,2,21428,2,13540.0,24,13545.0,15,B
2018-04-20 13:50:11,13545.0,32,21460,26,13545.0,1,13550.0,14,B
2018-04-20 13:50:19,13545.0,2,21462,0,13540.0,37,13550.0,12,B
2018-04-20 13:50:35,13550.0,2,21464,-2,13545.0,16,13550.0,13,B
2018-04-20 13:50:37,13550.0,2,21466,0,13545.0,16,13550.0,11,B
2018-04-20 13:50:59,13550.0,10,21476,6,13545.0,64,13550.0,3,B
2018-04-20 13:51:00,13550.0,6,21482,2,13550.0,1,13555.0,4,B
2018-04-20 13:51:05,13550.0,2,21484,0,13550.0,4,13555.0,10,B
2018-04-20 13:51:05,13550.0,4,21488,2,13550.0,3,13555.0,13,B
2018-04-20 13:51:13,13550.0,28,21516,6,13545.0,64,13550.0,86,B
2018-04-20 13:51:13,13550.0,2,21518,0,13545.0,68,13550.0,85,B
2018-04-20 13:51:15,13550.0,2,21520,2,13545.0,67,13550.0,85,B
2018-04-20 13:51:15,13550.0,6,21526,6,13545.0,67,13550.0,82,B
2018-04-20 13:51:30,13550.0,12,21538,0,13545.0,64,13550.0,77,B
2018-04-20 13:51:45,13550.0,6,21544,0,13545.0,64,13550.0,75,B
2018-04-20 13:51:54,13550.0,2,21546,2,13545.0,78,13550.0,74,B
2018-04-20 13:52:04,13550.0,4,21550,4,13545.0,87,13550.0,72,B
2018-04-20 13:52:05,13550.0,14,21564,8,13545.0,87,13550.0,65,B
2018-04-20 13:52:06,13550.0,8,21572,4,13545.0,83,13550.0,61,B
2018-04-20 13:52:06,13550.0,4,21576,4,13545.0,83,13550.0,59,B
2018-04-20 13:52:07,13550.0,2,21578,0,13545.0,82,13550.0,58,B
2018-04-20 13:52:09,13550.0,2,21580,0,13545.0,85,13550.0,57,B
2018-04-20 13:52:10,13550.0,2,21582,0,13545.0,85,13550.0,56,B
2018-04-20 13:52:13,13550.0,2,21584,2,13545.0,85,13550.0,55,B
2018-04-20 13:52:15,13550.0,34,21618,34,13545.0,90,13550.0,38,B
2018-04-20 13:52:15,13550.0,60,21678,38,13545.0,95,13550.0,6,B
2018-04-20 13:52:16,13550.0,12,21690,10,13550.0,2,13555.0,4,B
2018-04-20 13:52:22,13555.0,2,21692,2,13550.0,4,13555.0,2,B
2018-04-20 13:52:31,13555.0,6,21698,-2,13555.0,1,13560.0,12,B
2018-04-20 13:52:34,13560.0,4,21702,4,13555.0,10,13560.0,9,B
2018-04-20 13:52:36,13555.0,2,21704,0,13555.0,9,13560.0,9,S
2018-04-20 13:52:40,13560.0,2,21706,2,13555.0,3,13560.0,8,B
2018-04-20 13:52:43,13555.0,2,21708,0,13555.0,1,13560.0,15,S
2018-04-20 13:52:43,13555.0,2,21710,0,13555.0,1,13560.0,15,S
2018-04-20 13:52:45,13560.0,4,21714,0,13555.0,1,13560.0,13,B
2018-04-20 13:52:48,13555.0,2,21716,2,13550.0,36,13555.0,2,S
2018-04-20 13:52:49,13555.0,4,21720,4,13550.0,36,13560.0,7,S
2018-04-20 13:52:52,13555.0,6,21726,-4,13555.0,6,13560.0,6,S
2018-04-20 13:53:04,13560.0,32,21758,10,13555.0,10,13560.0,97,B
2018-04-20 13:53:05,13555.0,20,21778,8,13550.0,30,13560.0,97,S
2018-04-20 13:53:05,13550.0,2,21780,0,13550.0,27,13555.0,8,S
2018-04-20 13:53:39,13550.0,40,21820,-4,13550.0,5,13555.0,16,S
2018-04-20 13:53:39,13550.0,10,21830,6,13545.0,65,13555.0,18,S
2018-04-20 13:53:40,13555.0,2,21832,0,13545.0,67,13555.0,16,B
2018-04-20 13:54:02,13550.0,2,21834,0,13545.0,63,13550.0,98,S
2018-04-20 13:54:05,13545.0,2,21836,0,13545.0,62,13550.0,98,S
2018-04-20 13:54:12,13550.0,36,21872,24,13545.0,66,13550.0,78,B
2018-04-20 13:54:12,13550.0,12,21884,0,13545.0,66,13550.0,72,B
2018-04-20 13:54:34,13545.0,40,21924,18,13545.0,46,13550.0,73,S
2018-04-20 13:54:40,13550.0,2,21926,0,13545.0,46,13550.0,72,B
2018-04-20 13:54:42,13550.0,4,21930,0,13545.0,60,13550.0,70,B
2018-04-20 13:54:49,13550.0,2,21932,0,13545.0,70,13550.0,69,B
2018-04-20 13:55:04,13550.0,2,21934,0,13545.0,63,13550.0,67,B
2018-04-20 13:55:10,13550.0,20,21954,0,13545.0,63,13550.0,57,B
2018-04-20 13:55:12,13550.0,20,21974,0,13545.0,63,13550.0,47,B
2018-04-20 13:55:15,13550.0,8,21982,0,13545.0,65,13550.0,45,B
2018-04-20 13:55:25,13550.0,4,21986,4,13545.0,65,13550.0,43,B
2018-04-20 13:55:28,13550.0,2,21988,2,13545.0,65,13550.0,42,B
2018-04-20 13:55:30,13550.0,2,21990,2,13545.0,65,13550.0,41,B
2018-04-20 13:55:34,13550.0,6,21996,6,13545.0,65,13550.0,38,B
2018-04-20 13:55:38,13550.0,2,21998,2,13545.0,59,13550.0,41,B
2018-04-20 13:55:50,13550.0,4,22002,4,13545.0,57,13550.0,34,B
2018-04-20 13:55:59,13550.0,2,22004,2,13545.0,57,13550.0,38,B
2018-04-20 13:56:11,13550.0,2,22006,2,13545.0,57,13550.0,38,B
2018-04-20 13:56:17,13550.0,4,22010,4,13545.0,57,13550.0,36,B
2018-04-20 13:56:19,13550.0,4,22014,4,13545.0,61,13550.0,34,B
2018-04-20 13:56:20,13550.0,68,22082,48,13550.0,7,13555.0,17,B
2018-04-20 13:56:20,13555.0,2,22084,-2,13550.0,42,13555.0,15,B
2018-04-20 13:56:23,13555.0,4,22088,2,13550.0,44,13555.0,9,B
2018-04-20 13:56:28,13555.0,2,22090,2,13550.0,44,13555.0,8,B
2018-04-20 13:56:29,13555.0,2,22092,2,13550.0,44,13555.0,7,B
2018-04-20 13:56:31,13555.0,2,22094,0,13550.0,44,13555.0,6,B
2018-04-20 13:56:33,13555.0,12,22106,0,13555.0,4,13560.0,14,B
2018-04-20 13:56:35,13560.0,20,22126,-6,13555.0,6,13560.0,9,B
2018-04-20 13:56:36,13560.0,20,22146,-6,13555.0,6,13565.0,16,B
2018-04-20 13:56:38,13565.0,20,22166,-4,13555.0,9,13565.0,7,B
2018-04-20 13:56:39,13565.0,4,22170,-2,13555.0,8,13565.0,11,B
2018-04-20 13:56:41,13560.0,2,22172,-2,13555.0,9,13565.0,11,S
2018-04-20 13:56:45,13565.0,2,22174,0,13555.0,9,13565.0,12,B
2018-04-20 13:56:50,13555.0,18,22192,-12,13555.0,1,13560.0,100,S
2018-04-20 13:56:51,13555.0,2,22194,2,13550.0,22,13555.0,8,S
2018-04-20 13:56:53,13555.0,14,22208,-14,13555.0,1,13560.0,107,S
2018-04-20 13:56:54,13555.0,2,22210,0,13550.0,11,13555.0,3,S
2018-04-20 13:56:55,13555.0,2,22212,0,13550.0,11,13555.0,5,S
2018-04-20 13:56:55,13555.0,2,22214,0,13550.0,11,13555.0,4,S
2018-04-20 13:56:56,13555.0,2,22216,-2,13550.0,11,13555.0,3,S
2018-04-20 13:57:03,13555.0,2,22218,0,13550.0,8,13555.0,2,S
2018-04-20 13:57:09,13560.0,12,22230,2,13550.0,10,13555.0,1,B
2018-04-20 13:57:13,13555.0,2,22232,0,13550.0,10,13555.0,1,S
2018-04-20 13:57:16,13550.0,20,22252,-10,13545.0,50,13555.0,11,S
2018-04-20 13:57:29,13550.0,2,22254,0,13545.0,46,13555.0,31,S
2018-04-20 13:57:33,13545.0,14,22268,0,13545.0,45,13555.0,29,S
2018-04-20 13:57:42,13550.0,8,22276,-8,13545.0,63,13550.0,1,B
2018-04-20 13:57:44,13550.0,4,22280,-2,13550.0,8,13555.0,25,B
2018-04-20 13:57:46,13555.0,20,22300,-2,13550.0,10,13555.0,14,B
2018-04-20 13:57:47,13555.0,20,22320,0,13550.0,10,13555.0,4,B
2018-04-20 13:57:52,13555.0,6,22326,0,13555.0,5,13560.0,104,B
2018-04-20 13:57:53,13555.0,10,22336,-4,13550.0,10,13560.0,104,B
2018-04-20 13:58:06,13555.0,4,22340,-4,13550.0,11,13555.0,1,B
2018-04-20 13:58:09,13550.0,20,22360,-10,13545.0,42,13555.0,10,S
2018-04-20 13:58:47,13550.0,40,22400,20,13545.0,41,13550.0,78,S
2018-04-20 13:58:49,13550.0,20,22420,0,13545.0,41,13550.0,68,S
2018-04-20 13:58:54,13550.0,10,22430,0,13545.0,41,13550.0,67,S
2018-04-20 13:58:54,13550.0,16,22446,0,13545.0,41,13550.0,59,S
2018-04-20 13:59:01,13545.0,2,22448,0,13545.0,35,13550.0,64,S
2018-04-20 13:59:03,13545.0,2,22450,-2,13545.0,34,13550.0,64,S
2018-04-20 13:59:04,13545.0,4,22454,0,13545.0,32,13550.0,64,S
2018-04-20 13:59:12,13545.0,2,22456,-2,13545.0,31,13550.0,65,S
2018-04-20 13:59:22,13545.0,6,22462,-6,13545.0,28,13550.0,65,S
2018-04-20 13:59:22,13545.0,24,22486,-10,13545.0,16,13550.0,65,S
2018-04-20 13:59:23,13545.0,32,22518,4,13540.0,25,13550.0,65,S
2018-04-20 13:59:24,13545.0,4,22522,-4,13540.0,32,13550.0,63,S
2018-04-20 13:59:48,13545.0,4,22526,4,13540.0,27,13545.0,3,S
2018-04-20 14:00:04,13540.0,2,22528,0,13540.0,37,13545.0,45,S
2018-04-20 14:00:08,13540.0,20,22548,10,13540.0,27,13545.0,45,S
2018-04-20 14:00:09,13540.0,2,22550,2,13540.0,26,13545.0,45,S
2018-04-20 14:00:10,13540.0,2,22552,2,13540.0,25,13545.0,45,S
2018-04-20 14:00:17,13545.0,90,22642,54,13545.0,1,13550.0,60,B
2018-04-20 14:00:26,13545.0,4,22646,4,13540.0,27,13550.0,65,B
2018-04-20 14:00:31,13550.0,22,22668,22,13540.0,34,13550.0,54,B
2018-04-20 14:00:35,13550.0,22,22690,22,13540.0,34,13550.0,43,B
2018-04-20 14:01:08,13550.0,14,22704,0,13540.0,17,13550.0,45,B
2018-04-20 14:01:14,13540.0,32,22736,0,13535.0,18,13545.0,17,S
2018-04-20 14:01:23,13540.0,2,22738,0,13535.0,14,13540.0,6,S
2018-04-20 14:01:36,13540.0,2,22740,-2,13535.0,15,13545.0,29,S
2018-04-20 14:01:54,13535.0,2,22742,2,13535.0,15,13540.0,1,S
2018-04-20 14:02:04,13535.0,12,22754,12,13535.0,9,13540.0,10,S
2018-04-20 14:02:05,13535.0,18,22772,6,13530.0,49,13535.0,2,S
2018-04-20 14:02:06,13535.0,4,22776,-4,13530.0,48,13540.0,19,S
2018-04-20 14:02:11,13535.0,6,22782,0,13530.0,55,13540.0,10,S
2018-04-20 14:02:15,13540.0,4,22786,-4,13540.0,1,13545.0,23,B
2018-04-20 14:02:15,13535.0,12,22798,0,13530.0,58,13535.0,15,S
2018-04-20 14:02:16,13535.0,30,22828,-4,13535.0,3,13540.0,1,S
2018-04-20 14:02:23,13530.0,48,22876,4,13530.0,23,13535.0,5,S
2018-04-20 14:02:23,13530.0,4,22880,-4,13530.0,21,13535.0,5,S
2018-04-20 14:02:37,13530.0,46,22926,26,13525.0,12,13530.0,7,S
2018-04-20 14:02:38,13530.0,14,22940,0,13530.0,6,13535.0,12,S
2018-04-20 14:02:38,13530.0,12,22952,0,13525.0,14,13530.0,94,S
2018-04-20 14:02:39,13525.0,2,22954,2,13525.0,16,13530.0,94,S
2018-04-20 14:02:43,13530.0,2,22956,2,13525.0,15,13530.0,100,B
2018-04-20 14:02:44,13525.0,4,22960,0,13525.0,13,13530.0,100,S
2018-04-20 14:02:45,13525.0,4,22964,0,13525.0,7,13530.0,100,S
2018-04-20 14:02:46,13525.0,16,22980,2,13525.0,5,13530.0,100,S
2018-04-20 14:02:47,13525.0,10,22990,0,13520.0,4,13525.0,2,S
2018-04-20 14:02:47,13525.0,12,23002,-4,13525.0,12,13530.0,100,S
2018-04-20 14:02:49,13525.0,2,23004,-2,13525.0,11,13530.0,96,S
2018-04-20 14:02:57,13525.0,2,23006,0,13525.0,32,13530.0,96,S
2018-04-20 14:02:58,13525.0,2,23008,0,13525.0,31,13530.0,96,S
2018-04-20 14:03:04,13525.0,2,23010,0,13525.0,30,13530.0,96,S
2018-04-20 14:03:04,13525.0,4,23014,-4,13525.0,28,13530.0,96,S
2018-04-20 14:03:06,13530.0,4,23018,0,13525.0,32,13530.0,91,B
2018-04-20 14:03:08,13525.0,8,23026,0,13525.0,28,13530.0,91,S
2018-04-20 14:03:10,13525.0,2,23028,0,13525.0,24,13530.0,98,S
2018-04-20 14:03:11,13525.0,20,23048,-20,13525.0,14,13530.0,94,S
2018-04-20 14:03:15,13525.0,42,23090,-16,13520.0,7,13530.0,92,S
2018-04-20 14:03:20,13525.0,50,23140,48,13520.0,16,13525.0,25,S
2018-04-20 14:03:21,13525.0,50,23190,46,13525.0,2,13530.0,91,S
2018-04-20 14:03:21,13525.0,8,23198,8,13520.0,16,13530.0,92,S
2018-04-20 14:03:22,13525.0,2,23200,-2,13520.0,17,13530.0,99,S
2018-04-20 14:03:29,13525.0,24,23224,4,13525.0,5,13530.0,99,S
2018-04-20 14:03:29,13530.0,24,23248,24,13525.0,28,13530.0,79,B
2018-04-20 14:03:39,13525.0,28,23276,14,13520.0,18,13525.0,1,S
2018-04-20 14:03:45,13525.0,6,23282,2,13520.0,10,13525.0,5,S
2018-04-20 14:03:46,13525.0,10,23292,-10,13520.0,10,13530.0,81,S
2018-04-20 14:03:48,13525.0,2,23294,-2,13525.0,1,13530.0,80,S
2018-04-20 14:03:49,13525.0,2,23296,0,13520.0,22,13530.0,80,S
2018-04-20 14:03:50,13525.0,2,23298,0,13525.0,3,13530.0,83,S
2018-04-20 14:03:55,13525.0,2,23300,2,13520.0,22,13525.0,2,S
2018-04-20 14:03:55,13525.0,4,23304,0,13520.0,28,13530.0,83,S
2018-04-20 14:04:10,13525.0,2,23306,0,13520.0,24,13525.0,2,S
2018-04-20 14:04:10,13525.0,4,23310,0,13520.0,27,13530.0,82,S
2018-04-20 14:04:14,13530.0,4,23314,4,13520.0,30,13530.0,80,B
2018-04-20 14:04:16,13525.0,2,23316,0,13520.0,29,13530.0,81,S
2018-04-20 14:04:31,13525.0,14,23330,6,13520.0,23,13530.0,84,S
2018-04-20 14:04:34,13525.0,2,23332,2,13520.0,10,13525.0,5,S
2018-04-20 14:04:39,13525.0,2,23334,0,13520.0,10,13525.0,14,S
2018-04-20 14:04:49,13520.0,2,23336,-2,13520.0,8,13525.0,12,S
2018-04-20 14:04:50,13525.0,2,23338,0,13520.0,8,13525.0,11,B
2018-04-20 14:04:59,13525.0,22,23360,8,13520.0,22,13530.0,95,B
2018-04-20 14:05:06,13525.0,2,23362,2,13520.0,23,13530.0,96,B
2018-04-20 14:05:10,13525.0,14,23376,-10,13520.0,11,13525.0,3,B
2018-04-20 14:05:21,13520.0,12,23388,8,13520.0,3,13525.0,16,S
2018-04-20 14:05:29,13525.0,20,23408,0,13520.0,18,13530.0,95,B
2018-04-20 14:05:39,13530.0,2,23410,2,13520.0,32,13530.0,86,B
2018-04-20 14:05:49,13530.0,2,23412,2,13525.0,15,13530.0,85,B
2018-04-20 14:05:53,13530.0,2,23414,2,13525.0,16,13530.0,84,B
2018-04-20 14:05:53,13530.0,2,23416,2,13525.0,16,13530.0,83,B
2018-04-20 14:05:56,13530.0,2,23418,0,13525.0,16,13530.0,82,B
2018-04-20 14:06:11,13530.0,2,23420,2,13525.0,18,13530.0,82,B
2018-04-20 14:06:15,13525.0,20,23440,-8,13525.0,8,13530.0,82,S
2018-04-20 14:06:20,13530.0,2,23442,2,13525.0,8,13530.0,81,B
2018-04-20 14:06:23,13530.0,2,23444,2,13525.0,8,13530.0,80,B
2018-04-20 14:06:23,13530.0,2,23446,2,13525.0,8,13530.0,79,B
2018-04-20 14:06:24,13530.0,22,23468,18,13525.0,9,13530.0,68,B
2018-04-20 14:06:25,13525.0,8,23476,-2,13525.0,2,13530.0,73,S
2018-04-20 14:06:25,13525.0,2,23478,0,13525.0,1,13530.0,73,S
2018-04-20 14:06:30,13525.0,2,23480,0,13520.0,26,13530.0,73,S
2018-04-20 14:06:41,13530.0,2,23482,2,13525.0,6,13530.0,69,B
2018-04-20 14:06:42,13530.0,4,23486,4,13525.0,8,13530.0,65,B
2018-04-20 14:06:42,13530.0,10,23496,10,13525.0,16,13530.0,59,B
2018-04-20 14:06:43,13530.0,8,23504,8,13525.0,16,13530.0,55,B
2018-04-20 14:06:43,13530.0,16,23520,14,13525.0,17,13530.0,47,B
2018-04-20 14:06:47,13530.0,2,23522,0,13525.0,17,13530.0,46,B
2018-04-20 14:06:53,13525.0,4,23526,2,13525.0,9,13530.0,52,S
2018-04-20 14:06:53,13525.0,2,23528,0,13525.0,1,13530.0,52,S
2018-04-20 14:06:54,13525.0,2,23530,2,13520.0,22,13530.0,52,S
2018-04-20 14:06:58,13525.0,4,23534,0,13520.0,29,13525.0,1,S
2018-04-20 14:06:58,13525.0,2,23536,0,13525.0,1,13530.0,54,S
2018-04-20 14:06:59,13525.0,2,23538,2,13520.0,26,13530.0,54,S
2018-04-20 14:07:04,13525.0,2,23540,2,13525.0,1,13530.0,54,S
2018-04-20 14:07:05,13520.0,6,23546,2,13520.0,26,13525.0,1,S
2018-04-20 14:07:06,13525.0,4,23550,4,13525.0,10,13530.0,58,B
2018-04-20 14:07:06,13525.0,20,23570,0,13520.0,26,13525.0,1,B
2018-04-20 14:07:07,13525.0,4,23574,4,13520.0,25,13525.0,4,B
2018-04-20 14:07:09,13525.0,4,23578,2,13520.0,28,13525.0,2,B
2018-04-20 14:07:10,13525.0,2,23580,0,13520.0,28,13525.0,2,B
2018-04-20 14:07:14,13525.0,4,23584,4,13520.0,28,13530.0,59,B
2018-04-20 14:07:21,13530.0,2,23586,2,13520.0,30,13530.0,58,B
2018-04-20 14:07:24,13530.0,4,23590,4,13520.0,31,13530.0,56,B
2018-04-20 14:07:28,13530.0,4,23594,4,13520.0,37,13530.0,56,B
2018-04-20 14:07:29,13530.0,4,23598,4,13520.0,37,13530.0,54,B
2018-04-20 14:07:31,13530.0,6,23604,6,13525.0,11,13530.0,39,B
2018-04-20 14:07:32,13530.0,2,23606,2,13525.0,15,13530.0,37,B
2018-04-20 14:07:33,13525.0,4,23610,4,13520.0,36,13530.0,47,S
2018-04-20 14:07:35,13525.0,2,23612,2,13525.0,1,13530.0,50,S
2018-04-20 14:07:35,13525.0,2,23614,2,13525.0,17,13530.0,50,S
2018-04-20 14:07:36,13525.0,2,23616,0,13525.0,16,13530.0,50,S
2018-04-20 14:07:36,13525.0,2,23618,0,13525.0,15,13530.0,49,S
2018-04-20 14:07:37,13525.0,2,23620,0,13525.0,14,13530.0,49,S
2018-04-20 14:07:37,13525.0,2,23622,0,13525.0,13,13530.0,49,S
2018-04-20 14:07:38,13525.0,2,23624,0,13525.0,12,13530.0,49,S
2018-04-20 14:07:38,13525.0,4,23628,0,13525.0,10,13530.0,49,S
2018-04-20 14:07:39,13525.0,4,23632,0,13525.0,8,13530.0,49,S
2018-04-20 14:07:39,13525.0,2,23634,0,13525.0,7,13530.0,49,S
2018-04-20 14:07:40,13525.0,2,23636,0,13525.0,6,13530.0,50,S
2018-04-20 14:07:40,13525.0,2,23638,0,13525.0,5,13530.0,50,S
2018-04-20 14:07:41,13525.0,2,23640,0,13525.0,4,13530.0,50,S
2018-04-20 14:07:41,13525.0,2,23642,0,13525.0,3,13530.0,50,S
2018-04-20 14:07:42,13525.0,4,23646,0,13525.0,1,13530.0,50,S
2018-04-20 14:07:42,13525.0,2,23648,0,13520.0,47,13525.0,1,S
2018-04-20 14:07:43,13525.0,4,23652,0,13520.0,48,13530.0,44,S
2018-04-20 14:07:44,13525.0,2,23654,0,13525.0,2,13530.0,43,S
2018-04-20 14:07:44,13525.0,2,23656,0,13525.0,1,13530.0,43,S
2018-04-20 14:07:45,13525.0,2,23658,0,13520.0,47,13530.0,43,S
2018-04-20 14:07:54,13530.0,4,23662,0,13525.0,1,13530.0,45,B
2018-04-20 14:07:55,13525.0,2,23664,2,13525.0,1,13530.0,45,S
2018-04-20 14:07:55,13525.0,2,23666,2,13520.0,50,13530.0,45,S
2018-04-20 14:08:00,13530.0,8,23674,8,13520.0,56,13530.0,56,B
2018-04-20 14:08:07,13520.0,2,23676,2,13520.0,43,13525.0,16,S
2018-04-20 14:08:07,13520.0,2,23678,2,13520.0,40,13525.0,16,S
2018-04-20 14:08:08,13530.0,46,23724,-10,13520.0,39,13530.0,41,B
2018-04-20 14:08:08,13520.0,2,23726,2,13520.0,40,13530.0,42,S
2018-04-20 14:08:18,13520.0,2,23728,2,13520.0,40,13525.0,2,S
2018-04-20 14:08:18,13520.0,2,23730,2,13520.0,37,13525.0,2,S
2018-04-20 14:08:19,13520.0,4,23734,4,13520.0,35,13525.0,2,S
2018-04-20 14:08:19,13520.0,2,23736,0,13520.0,34,13525.0,2,S
2018-04-20 14:08:20,13520.0,2,23738,0,13520.0,33,13525.0,1,S
2018-04-20 14:08:20,13520.0,2,23740,2,13520.0,32,13525.0,1,S
2018-04-20 14:08:21,13520.0,2,23742,2,13520.0,31,13525.0,1,S
2018-04-20 14:08:21,13520.0,2,23744,2,13520.0,30,13525.0,1,S
2018-04-20 14:08:22,13520.0,2,23746,2,13520.0,29,13525.0,1,S
2018-04-20 14:08:22,13520.0,2,23748,0,13520.0,28,13525.0,1,S
2018-04-20 14:08:23,13520.0,2,23750,0,13520.0,28,13525.0,3,S
2018-04-20 14:08:24,13520.0,2,23752,2,13520.0,28,13525.0,3,S
2018-04-20 14:08:25,13520.0,2,23754,0,13520.0,37,13525.0,3,S
2018-04-20 14:08:25,13520.0,2,23756,0,13520.0,36,13525.0,3,S
2018-04-20 14:08:26,13520.0,4,23760,-2,13520.0,34,13525.0,3,S
2018-04-20 14:08:26,13520.0,2,23762,0,13520.0,33,13525.0,13,S
2018-04-20 14:08:27,13520.0,2,23764,0,13520.0,31,13525.0,13,S
2018-04-20 14:08:27,13520.0,2,23766,2,13520.0,30,13525.0,13,S
2018-04-20 14:08:28,13520.0,2,23768,2,13520.0,29,13525.0,13,S
2018-04-20 14:08:29,13520.0,50,23818,24,13520.0,19,13525.0,12,S
2018-04-20 14:08:29,13515.0,46,23864,-4,13510.0,4,13520.0,33,S
2018-04-20 14:08:30,13515.0,2,23866,0,13510.0,11,13520.0,15,S
2018-04-20 14:08:32,13510.0,2,23868,0,13510.0,10,13515.0,6,S
2018-04-20 14:08:32,13510.0,2,23870,0,13510.0,8,13515.0,6,S
2018-04-20 14:08:34,13510.0,2,23872,2,13505.0,5,13515.0,2,S
2018-04-20 14:08:37,13510.0,2,23874,-2,13510.0,8,13515.0,1,S
2018-04-20 14:08:38,13510.0,2,23876,2,13505.0,20,13515.0,10,S
2018-04-20 14:08:40,13515.0,2,23878,-2,13510.0,12,13520.0,12,B
2018-04-20 14:08:48,13515.0,2,23880,2,13515.0,2,13520.0,16,B
2018-04-20 14:08:48,13515.0,2,23882,0,13515.0,1,13520.0,16,B
2018-04-20 14:08:49,13515.0,2,23884,0,13510.0,14,13520.0,16,B
2018-04-20 14:08:51,13520.0,20,23904,-4,13510.0,15,13520.0,6,B
2018-04-20 14:08:58,13510.0,4,23908,0,13510.0,8,13515.0,1,S
2018-04-20 14:09:00,13515.0,2,23910,2,13510.0,17,13520.0,20,B
2018-04-20 14:09:03,13515.0,4,23914,0,13515.0,1,13520.0,20,B
2018-04-20 14:09:04,13515.0,2,23916,2,13510.0,23,13515.0,1,B
2018-04-20 14:09:05,13515.0,2,23918,0,13510.0,23,13520.0,20,B
2018-04-20 14:09:07,13515.0,4,23922,0,13510.0,25,13520.0,20,B
2018-04-20 14:09:12,13510.0,10,23932,-2,13510.0,18,13515.0,12,S
2018-04-20 14:09:13,13515.0,2,23934,0,13510.0,18,13515.0,11,B
2018-04-20 14:09:17,13510.0,20,23954,0,13510.0,8,13515.0,11,S
2018-04-20 14:09:18,13515.0,2,23956,0,13510.0,9,13515.0,10,B
2018-04-20 14:09:21,13510.0,18,23974,-4,13505.0,31,13510.0,1,S
2018-04-20 14:09:21,13510.0,2,23976,-2,13510.0,8,13515.0,11,S
2018-04-20 14:09:23,13515.0,8,23984,8,13510.0,7,13515.0,7,B
2018-04-20 14:09:24,13515.0,12,23996,0,13515.0,5,13520.0,41,B
2018-04-20 14:09:24,13520.0,2,23998,2,13515.0,17,13520.0,33,B
2018-04-20 14:09:26,13515.0,12,24010,10,13515.0,10,13520.0,32,S
2018-04-20 14:09:28,13520.0,4,24014,4,13515.0,8,13520.0,30,B
2018-04-20 14:09:34,13520.0,20,24034,0,13515.0,12,13520.0,24,B
2018-04-20 14:09:35,13515.0,14,24048,2,13515.0,5,13520.0,30,S
2018-04-20 14:09:35,13515.0,10,24058,2,13510.0,7,13515.0,2,S
2018-04-20 14:09:37,13520.0,2,24060,0,13510.0,10,13520.0,29,B
2018-04-20 14:09:40,13520.0,8,24068,8,13510.0,14,13520.0,25,B
2018-04-20 14:09:41,13520.0,38,24106,16,13515.0,9,13525.0,7,B
2018-04-20 14:09:47,13525.0,10,24116,6,13520.0,1,13525.0,9,B
2018-04-20 14:09:48,13525.0,4,24120,0,13525.0,1,13530.0,27,B
2018-04-20 14:09:48,13525.0,2,24122,-2,13520.0,11,13525.0,2,B
2018-04-20 14:09:49,13525.0,2,24124,0,13520.0,11,13525.0,1,B
2018-04-20 14:09:51,13520.0,2,24126,2,13515.0,10,13525.0,6,S
2018-04-20 14:09:51,13520.0,2,24128,2,13515.0,13,13525.0,7,S
2018-04-20 14:09:56,13515.0,6,24134,0,13515.0,15,13525.0,9,S
2018-04-20 14:10:05,13525.0,2,24136,0,13515.0,16,13525.0,9,B
2018-04-20 14:10:06,13515.0,2,24138,0,13515.0,2,13520.0,17,S
2018-04-20 14:10:06,13515.0,4,24142,-4,13510.0,13,13515.0,1,S
2018-04-20 14:10:14,13510.0,22,24164,8,13505.0,28,13510.0,2,S
2018-04-20 14:10:15,13510.0,4,24168,0,13510.0,9,13515.0,2,S
2018-04-20 14:10:16,13515.0,4,24172,0,13515.0,38,13520.0,13,B
2018-04-20 14:10:17,13515.0,2,24174,0,13515.0,40,13520.0,14,B
2018-04-20 14:10:17,13515.0,2,24176,0,13515.0,39,13520.0,14,B
2018-04-20 14:10:18,13515.0,2,24178,0,13515.0,48,13520.0,14,B
2018-04-20 14:10:18,13515.0,2,24180,0,13515.0,47,13520.0,14,B
2018-04-20 14:10:19,13515.0,2,24182,0,13515.0,46,13520.0,14,B
2018-04-20 14:10:19,13515.0,2,24184,0,13515.0,45,13520.0,14,B
2018-04-20 14:10:20,13515.0,2,24186,0,13515.0,44,13520.0,14,B
2018-04-20 14:10:20,13515.0,2,24188,0,13515.0,43,13520.0,14,B
2018-04-20 14:10:21,13515.0,2,24190,2,13515.0,42,13520.0,14,B
2018-04-20 14:10:21,13515.0,2,24192,2,13515.0,41,13520.0,13,B
2018-04-20 14:10:22,13520.0,22,24214,-4,13515.0,41,13520.0,3,B
2018-04-20 14:10:22,13515.0,2,24216,2,13515.0,40,13520.0,3,S
2018-04-20 14:10:23,13515.0,2,24218,2,13515.0,39,13520.0,3,S
2018-04-20 14:10:23,13515.0,2,24220,2,13515.0,38,13520.0,3,S
2018-04-20 14:10:24,13515.0,2,24222,2,13515.0,37,13520.0,3,S
2018-04-20 14:10:24,13515.0,2,24224,2,13515.0,36,13520.0,3,S
2018-04-20 14:10:25,13515.0,2,24226,2,13515.0,35,13520.0,3,S
2018-04-20 14:10:25,13515.0,2,24228,2,13515.0,34,13520.0,4,S
2018-04-20 14:10:28,13520.0,2,24230,0,13515.0,36,13520.0,3,B
2018-04-20 14:10:29,13520.0,2,24232,0,13515.0,36,13520.0,1,B
2018-04-20 14:10:30,13520.0,2,24234,-2,13515.0,37,13525.0,6,B
2018-04-20 14:10:37,13520.0,4,24238,4,13520.0,2,13525.0,11,B
2018-04-20 14:10:38,13520.0,4,24242,0,13515.0,39,13525.0,8,B
2018-04-20 14:10:39,13525.0,2,24244,0,13515.0,39,13525.0,7,B
2018-04-20 14:10:43,13520.0,4,24248,4,13515.0,39,13520.0,98,S
2018-04-20 14:10:44,13520.0,2,24250,2,13515.0,39,13520.0,97,S
2018-04-20 14:10:47,13520.0,2,24252,2,13515.0,38,13520.0,98,S
2018-04-20 14:11:00,13520.0,8,24260,8,13515.0,38,13520.0,95,S
2018-04-20 14:11:04,13515.0,12,24272,2,13515.0,33,13520.0,94,S
2018-04-20 14:11:08,13515.0,2,24274,0,13515.0,34,13520.0,94,S
2018-04-20 14:11:15,13520.0,24,24298,0,13515.0,34,13520.0,82,B
2018-04-20 14:11:38,13520.0,20,24318,20,13515.0,24,13520.0,74,B
2018-04-20 14:11:45,13515.0,16,24334,8,13515.0,13,13520.0,73,S
2018-04-20 14:11:47,13515.0,16,24350,0,13515.0,5,13520.0,76,S
2018-04-20 14:11:48,13515.0,10,24360,-8,13510.0,10,13520.0,76,S
2018-04-20 14:12:05,13510.0,2,24362,-2,13510.0,15,13515.0,6,S
2018-04-20 14:12:06,13515.0,12,24374,-10,13515.0,6,13520.0,78,B
2018-04-20 14:12:11,13515.0,2,24376,-2,13515.0,5,13520.0,78,B
2018-04-20 14:12:17,13515.0,2,24378,-2,13515.0,4,13520.0,77,B
2018-04-20 14:12:18,13515.0,2,24380,0,13515.0,3,13520.0,77,B
2018-04-20 14:12:29,13515.0,10,24390,-8,13510.0,17,13515.0,5,B
2018-04-20 14:12:29,13515.0,10,24400,-6,13510.0,17,13520.0,77,B
2018-04-20 14:12:35,13515.0,2,24402,2,13510.0,17,13515.0,1,B
2018-04-20 14:12:37,13510.0,2,24404,-2,13510.0,16,13515.0,2,S
2018-04-20 14:12:39,13515.0,2,24406,0,13510.0,16,13515.0,1,B
2018-04-20 14:12:40,13510.0,30,24436,10,13505.0,23,13510.0,1,S
2018-04-20 14:12:41,13510.0,4,24440,-2,13505.0,14,13510.0,2,S
2018-04-20 14:12:42,13510.0,4,24444,4,13510.0,2,13515.0,17,S
2018-04-20 14:12:43,13510.0,2,24446,0,13505.0,21,13515.0,24,S
2018-04-20 14:12:47,13500.0,82,24528,48,13495.0,33,13500.0,59,S
2018-04-20 14:12:48,13505.0,124,24652,54,13500.0,35,13510.0,3,B
2018-04-20 14:12:50,13500.0,30,24682,18,13495.0,43,13500.0,54,S
2018-04-20 14:12:51,13500.0,100,24782,80,13495.0,49,13500.0,4,S
2018-04-20 14:12:51,13500.0,8,24790,8,13500.0,2,13505.0,3,S
2018-04-20 14:12:52,13505.0,6,24796,0,13505.0,3,13510.0,7,B
2018-04-20 14:12:52,13505.0,2,24798,2,13505.0,3,13510.0,6,B
2018-04-20 14:12:55,13510.0,4,24802,2,13505.0,1,13510.0,4,B
2018-04-20 14:12:55,13500.0,46,24848,40,13495.0,43,13500.0,77,S
2018-04-20 14:12:56,13500.0,12,24860,12,13495.0,47,13500.0,71,S
2018-04-20 14:12:58,13500.0,8,24868,8,13495.0,48,13500.0,67,S
2018-04-20 14:12:58,13500.0,4,24872,4,13495.0,49,13500.0,65,S
2018-04-20 14:12:59,13500.0,2,24874,2,13495.0,49,13500.0,64,S
2018-04-20 14:13:00,13500.0,20,24894,0,13495.0,49,13500.0,154,S
2018-04-20 14:13:01,13495.0,2,24896,0,13495.0,47,13500.0,154,S
2018-04-20 14:13:02,13495.0,68,24964,-34,13495.0,14,13500.0,154,S
2018-04-20 14:13:02,13495.0,24,24988,-4,13495.0,2,13500.0,153,S
2018-04-20 14:13:03,13495.0,4,24992,-2,13490.0,8,13495.0,1,S
2018-04-20 14:13:03,13495.0,10,25002,2,13495.0,4,13500.0,156,S
2018-04-20 14:13:04,13495.0,10,25012,2,13490.0,8,13495.0,3,S
2018-04-20 14:13:04,13495.0,6,25018,0,13490.0,9,13495.0,7,S
2018-04-20 14:13:09,13495.0,8,25026,0,13490.0,5,13495.0,12,S
2018-04-20 14:13:11,13495.0,2,25028,2,13490.0,5,13495.0,10,S
2018-04-20 14:13:12,13495.0,2,25030,2,13490.0,4,13495.0,9,S
2018-04-20 14:13:13,13495.0,2,25032,0,13490.0,4,13495.0,7,S
2018-04-20 14:13:16,13490.0,2,25034,0,13490.0,21,13495.0,6,S
2018-04-20 14:13:16,13490.0,6,25040,-2,13490.0,18,13495.0,6,S
2018-04-20 14:13:17,13490.0,2,25042,-2,13490.0,17,13495.0,6,S
2018-04-20 14:13:18,13495.0,4,25046,4,13490.0,17,13495.0,5,B
2018-04-20 14:13:18,13490.0,4,25050,-4,13490.0,15,13495.0,5,S
2018-04-20 14:13:19,13495.0,4,25054,4,13490.0,15,13495.0,3,B
2018-04-20 14:13:21,13495.0,2,25056,0,13490.0,15,13495.0,9,B
2018-04-20 14:13:21,13495.0,12,25068,0,13490.0,10,13495.0,13,B
2018-04-20 14:13:24,13490.0,22,25090,-6,13485.0,2,13490.0,7,S
2018-04-20 14:13:24,13490.0,6,25096,-6,13480.0,24,13490.0,16,S
2018-04-20 14:13:25,13490.0,4,25100,0,13480.0,24,13490.0,16,S
2018-04-20 14:13:26,13490.0,2,25102,2,13485.0,1,13490.0,12,S
2018-04-20 14:13:26,13490.0,4,25106,-2,13480.0,24,13490.0,11,S
2018-04-20 14:13:27,13490.0,2,25108,0,13480.0,24,13490.0,10,S
2018-04-20 14:13:27,13490.0,2,25110,0,13480.0,24,13490.0,10,S
2018-04-20 14:13:28,13480.0,2,25112,2,13480.0,23,13485.0,10,S
2018-04-20 14:13:28,13480.0,40,25152,-18,13480.0,21,13490.0,8,S
2018-04-20 14:13:29,13485.0,2,25154,0,13480.0,25,13490.0,7,B
2018-04-20 14:13:29,13485.0,2,25156,0,13480.0,25,13490.0,7,B
2018-04-20 14:13:30,13485.0,2,25158,0,13480.0,21,13490.0,7,B
2018-04-20 14:13:31,13485.0,2,25160,0,13480.0,21,13490.0,7,B
2018-04-20 14:13:35,13485.0,2,25162,2,13480.0,22,13485.0,2,B
2018-04-20 14:13:36,13485.0,2,25164,0,13480.0,26,13485.0,1,B
2018-04-20 14:13:36,13485.0,4,25168,0,13485.0,2,13490.0,8,B
2018-04-20 14:13:37,13485.0,4,25172,-4,13480.0,26,13490.0,8,B
2018-04-20 14:13:38,13485.0,2,25174,0,13480.0,26,13490.0,8,B
2018-04-20 14:13:40,13485.0,2,25176,0,13485.0,9,13490.0,8,B
2018-04-20 14:13:40,13485.0,16,25192,0,13485.0,1,13490.0,8,B
2018-04-20 14:13:41,13485.0,2,25194,-2,13480.0,22,13490.0,8,B
2018-04-20 14:13:46,13485.0,2,25196,0,13485.0,9,13490.0,8,B
2018-04-20 14:13:55,13490.0,10,25206,4,13485.0,11,13490.0,2,B
2018-04-20 14:13:56,13490.0,4,25210,-2,13490.0,1,13495.0,21,B
2018-04-20 14:13:57,13490.0,4,25214,-4,13485.0,19,13495.0,17,B
2018-04-20 14:13:58,13490.0,2,25216,2,13485.0,16,13495.0,18,B
2018-04-20 14:14:00,13490.0,2,25218,0,13490.0,18,13495.0,24,B
2018-04-20 14:14:01,13490.0,36,25254,-24,13485.0,12,13490.0,2,B
2018-04-20 14:14:03,13490.0,2,25256,0,13485.0,12,13490.0,7,B
2018-04-20 14:14:04,13490.0,2,25258,0,13485.0,12,13490.0,6,B
2018-04-20 14:14:08,13485.0,2,25260,0,13485.0,14,13490.0,6,S
2018-04-20 14:14:11,13490.0,10,25270,8,13485.0,13,13490.0,1,B
2018-04-20 14:14:11,13490.0,2,25272,2,13485.0,13,13490.0,1,B
2018-04-20 14:14:12,13490.0,2,25274,2,13485.0,13,13495.0,23,B
2018-04-20 14:14:14,13490.0,2,25276,0,13490.0,5,13495.0,23,B
2018-04-20 14:14:15,13490.0,2,25278,2,13485.0,17,13495.0,22,B
2018-04-20 14:14:17,13490.0,4,25282,0,13485.0,17,13495.0,32,B
2018-04-20 14:14:19,13490.0,2,25284,2,13485.0,18,13495.0,33,B
2018-04-20 14:14:22,13490.0,2,25286,2,13490.0,2,13495.0,29,B
2018-04-20 14:14:24,13490.0,2,25288,0,13485.0,24,13495.0,19,B
2018-04-20 14:14:25,13490.0,2,25290,0,13485.0,23,13495.0,19,B
2018-04-20 14:14:27,13490.0,4,25294,0,13485.0,15,13490.0,1,B
2018-04-20 14:14:28,13490.0,2,25296,0,13485.0,15,13490.0,1,B
2018-04-20 14:14:32,13485.0,12,25308,-12,13485.0,9,13490.0,1,S
2018-04-20 14:14:37,13490.0,2,25310,2,13485.0,9,13495.0,19,B
2018-04-20 14:14:37,13490.0,2,25312,2,13485.0,11,13495.0,27,B
2018-04-20 14:14:38,13490.0,2,25314,0,13485.0,13,13495.0,37,B
2018-04-20 14:14:39,13490.0,2,25316,0,13485.0,19,13495.0,24,B
2018-04-20 14:14:48,13490.0,2,25318,2,13490.0,2,13495.0,19,B
2018-04-20 14:14:49,13490.0,2,25320,0,13485.0,20,13495.0,21,B
2018-04-20 14:14:50,13490.0,2,25322,2,13485.0,20,13495.0,19,B
2018-04-20 14:14:51,13490.0,2,25324,2,13485.0,19,13495.0,19,B
2018-04-20 14:14:51,13485.0,2,25326,0,13485.0,18,13490.0,1,S
2018-04-20 14:14:52,13490.0,2,25328,2,13485.0,18,13495.0,19,B
2018-04-20 14:14:53,13490.0,2,25330,0,13485.0,18,13495.0,19,B
2018-04-20 14:14:54,13490.0,2,25332,0,13485.0,18,13495.0,19,B
2018-04-20 14:14:55,13490.0,2,25334,2,13485.0,18,13495.0,19,B
2018-04-20 14:14:56,13490.0,2,25336,2,13490.0,1,13495.0,19,B
2018-04-20 14:14:56,13495.0,8,25344,0,13485.0,18,13495.0,19,B
2018-04-20 14:14:57,13485.0,2,25346,2,13485.0,17,13490.0,1,S
2018-04-20 14:15:01,13490.0,8,25354,2,13485.0,14,13495.0,19,B
2018-04-20 14:15:05,13490.0,2,25356,0,13485.0,14,13495.0,19,B
2018-04-20 14:15:07,13490.0,2,25358,0,13485.0,14,13495.0,19,B
2018-04-20 14:15:09,13490.0,2,25360,2,13485.0,15,13495.0,19,B
2018-04-20 14:15:13,13490.0,2,25362,2,13490.0,1,13495.0,19,B
2018-04-20 14:15:17,13495.0,26,25388,20,13490.0,13,13495.0,1,B
2018-04-20 14:15:18,13495.0,2,25390,2,13490.0,10,13495.0,1,B
2018-04-20 14:15:20,13490.0,8,25398,0,13485.0,14,13495.0,10,S
2018-04-20 14:15:25,13490.0,2,25400,2,13485.0,18,13495.0,10,S
2018-04-20 14:15:27,13490.0,4,25404,4,13485.0,15,13495.0,6,S
2018-04-20 14:15:28,13495.0,4,25408,2,13490.0,4,13495.0,5,B
2018-04-20 14:15:29,13490.0,6,25414,0,13490.0,11,13495.0,7,S
2018-04-20 14:15:29,13495.0,10,25424,4,13490.0,7,13495.0,7,B
2018-04-20 14:15:30,13490.0,14,25438,10,13485.0,10,13490.0,7,S
2018-04-20 14:15:31,13490.0,2,25440,0,13485.0,10,13490.0,11,S
2018-04-20 14:15:31,13490.0,4,25444,0,13485.0,9,13490.0,13,S
2018-04-20 14:15:35,13485.0,16,25460,0,13480.0,31,13490.0,17,S
2018-04-20 14:15:36,13485.0,2,25462,0,13480.0,28,13485.0,2,S
2018-04-20 14:15:36,13485.0,2,25464,0,13480.0,27,13485.0,6,S
2018-04-20 14:15:37,13485.0,12,25476,0,13480.0,21,13485.0,19,S
2018-04-20 14:15:37,13485.0,2,25478,0,13480.0,21,13485.0,16,S
2018-04-20 14:15:38,13485.0,2,25480,-2,13480.0,21,13485.0,5,S
2018-04-20 14:15:39,13485.0,6,25486,-4,13480.0,20,13485.0,2,S
2018-04-20 14:15:43,13480.0,2,25488,0,13480.0,23,13485.0,2,S
2018-04-20 14:15:43,13485.0,4,25492,-4,13480.0,24,13490.0,12,B
2018-04-20 14:15:46,13480.0,42,25534,6,13475.0,7,13480.0,18,S
2018-04-20 14:15:47,13475.0,18,25552,2,13470.0,4,13475.0,21,S
2018-04-20 14:15:47,13470.0,12,25564,-4,13465.0,8,13475.0,6,S
2018-04-20 14:15:48,13460.0,38,25602,4,13460.0,2,13465.0,12,S
2018-04-20 14:15:48,13460.0,12,25614,4,13455.0,8,13465.0,10,S
2018-04-20 14:15:49,13465.0,28,25642,4,13455.0,7,13460.0,3,B
2018-04-20 14:15:49,13465.0,26,25668,-22,13460.0,6,13465.0,2,B
2018-04-20 14:15:50,13465.0,2,25670,0,13460.0,9,13465.0,1,B
2018-04-20 14:15:51,13465.0,2,25672,0,13460.0,9,13465.0,1,B
2018-04-20 14:15:51,13460.0,14,25686,-10,13455.0,19,13460.0,23,S
2018-04-20 14:15:52,13460.0,20,25706,-16,13455.0,19,13460.0,13,S
2018-04-20 14:15:53,13455.0,2,25708,0,13455.0,10,13460.0,19,S
2018-04-20 14:15:53,13455.0,20,25728,-4,13450.0,16,13460.0,25,S
2018-04-20 14:15:54,13450.0,4,25732,2,13450.0,14,13455.0,8,S
2018-04-20 14:15:54,13450.0,12,25744,-4,13450.0,10,13460.0,22,S
2018-04-20 14:15:56,13450.0,4,25748,0,13450.0,8,13460.0,13,S
2018-04-20 14:15:57,13450.0,26,25774,-16,13450.0,9,13460.0,4,S
2018-04-20 14:15:58,13455.0,10,25784,-2,13455.0,4,13460.0,13,B
2018-04-20 14:15:58,13460.0,4,25788,0,13455.0,2,13460.0,13,B
2018-04-20 14:15:59,13460.0,6,25794,6,13450.0,8,13460.0,12,B
2018-04-20 14:16:00,13450.0,10,25804,0,13450.0,7,13460.0,11,S
2018-04-20 14:16:00,13450.0,2,25806,-2,13450.0,10,13460.0,11,S
2018-04-20 14:16:01,13450.0,6,25812,0,13450.0,7,13460.0,11,S
2018-04-20 14:16:02,13460.0,16,25828,16,13455.0,7,13465.0,3,B
2018-04-20 14:16:02,13460.0,2,25830,-2,13455.0,8,13465.0,5,B
2018-04-20 14:16:03,13455.0,2,25832,0,13455.0,8,13465.0,7,S
2018-04-20 14:16:04,13460.0,2,25834,-2,13455.0,9,13460.0,9,B
2018-04-20 14:16:05,13460.0,4,25838,-4,13455.0,9,13460.0,10,B
2018-04-20 14:16:06,13460.0,16,25854,-6,13455.0,9,13460.0,2,B
2018-04-20 14:16:06,13460.0,4,25858,0,13460.0,2,13465.0,6,B
2018-04-20 14:16:07,13460.0,2,25860,-2,13460.0,1,13465.0,5,B
2018-04-20 14:16:08,13460.0,2,25862,0,13460.0,1,13465.0,6,B
2018-04-20 14:16:09,13460.0,2,25864,0,13460.0,3,13465.0,2,B
2018-04-20 14:16:11,13465.0,2,25866,0,13460.0,4,13465.0,1,B
2018-04-20 14:16:12,13465.0,2,25868,2,13460.0,5,13470.0,3,B
2018-04-20 14:16:18,13470.0,4,25872,2,13465.0,18,13475.0,2,B
2018-04-20 14:16:22,13475.0,2,25874,2,13470.0,4,13475.0,5,B
2018-04-20 14:16:26,13475.0,10,25884,4,13470.0,6,13475.0,4,B
2018-04-20 14:16:27,13470.0,2,25886,0,13470.0,5,13475.0,4,S
2018-04-20 14:16:28,13470.0,6,25892,0,13465.0,19,13470.0,1,S
2018-04-20 14:16:29,13465.0,34,25926,0,13460.0,5,13465.0,1,S
2018-04-20 14:16:29,13460.0,2,25928,2,13460.0,4,13465.0,10,S
2018-04-20 14:16:30,13465.0,20,25948,-6,13460.0,2,13465.0,1,B
2018-04-20 14:16:34,13465.0,2,25950,0,13460.0,2,13465.0,16,B
2018-04-20 14:16:35,13460.0,10,25960,-6,13460.0,6,13465.0,4,S
2018-04-20 14:16:35,13465.0,8,25968,2,13465.0,1,13470.0,6,B
2018-04-20 14:16:37,13465.0,2,25970,-2,13460.0,8,13465.0,20,B
2018-04-20 14:16:38,13465.0,4,25974,-4,13460.0,1,13465.0,11,B
2018-04-20 14:16:38,13470.0,20,25994,-8,13465.0,10,13470.0,11,B
2018-04-20 14:16:41,13470.0,10,26004,-2,13465.0,16,13470.0,2,B
2018-04-20 14:16:42,13470.0,4,26008,0,13470.0,1,13475.0,3,B
2018-04-20 14:16:43,13465.0,24,26032,0,13465.0,4,13470.0,4,S
2018-04-20 14:16:43,13470.0,2,26034,2,13465.0,4,13470.0,5,B
2018-04-20 14:16:45,13470.0,2,26036,2,13465.0,4,13470.0,4,B
2018-04-20 14:16:46,13465.0,8,26044,-4,13460.0,11,13470.0,13,S
2018-04-20 14:16:51,13460.0,16,26060,-2,13455.0,20,13460.0,3,S
2018-04-20 14:16:52,13460.0,6,26066,-4,13460.0,2,13465.0,10,S
2018-04-20 14:16:56,13460.0,8,26074,-8,13455.0,21,13465.0,10,S
2018-04-20 14:16:59,13455.0,2,26076,0,13455.0,20,13465.0,21,S
2018-04-20 14:17:02,13455.0,8,26084,6,13455.0,14,13465.0,22,S
2018-04-20 14:17:02,13455.0,2,26086,0,13455.0,13,13465.0,22,S
2018-04-20 14:17:04,13460.0,2,26088,0,13455.0,13,13465.0,22,B
2018-04-20 14:17:05,13465.0,2,26090,2,13460.0,7,13465.0,13,B
2018-04-20 14:17:08,13460.0,2,26092,0,13460.0,7,13465.0,5,S
2018-04-20 14:17:09,13465.0,4,26096,0,13460.0,7,13465.0,3,B
2018-04-20 14:17:09,13460.0,4,26100,-2,13460.0,7,13465.0,8,S
2018-04-20 14:17:11,13460.0,4,26104,-2,13455.0,14,13460.0,8,S
2018-04-20 14:17:13,13460.0,2,26106,0,13455.0,14,13460.0,7,S
2018-04-20 14:17:14,13460.0,14,26120,-14,13460.0,3,13465.0,11,S
2018-04-20 14:17:14,13465.0,10,26130,-6,13465.0,1,13470.0,16,B
2018-04-20 14:17:15,13465.0,2,26132,2,13465.0,4,13470.0,12,B
2018-04-20 14:17:16,13465.0,6,26138,2,13465.0,2,13470.0,4,B
2018-04-20 14:17:18,13460.0,14,26152,2,13460.0,2,13465.0,17,S
2018-04-20 14:17:20,13465.0,2,26154,2,13460.0,2,13465.0,16,B
2018-04-20 14:17:26,13465.0,2,26156,2,13460.0,4,13465.0,15,B
2018-04-20 14:17:27,13460.0,2,26158,2,13460.0,1,13465.0,16,S
2018-04-20 14:17:28,13460.0,2,26160,-2,13455.0,12,13465.0,18,S
2018-04-20 14:17:28,13455.0,10,26170,10,13455.0,7,13465.0,18,S
2018-04-20 14:17:34,13465.0,10,26180,0,13455.0,12,13465.0,12,B
2018-04-20 14:17:34,13455.0,2,26182,2,13455.0,11,13465.0,12,S
2018-04-20 14:17:38,13455.0,20,26202,12,13455.0,1,13465.0,15,S
2018-04-20 14:17:45,13465.0,2,26204,0,13460.0,11,13465.0,16,B
2018-04-20 14:17:53,13465.0,4,26208,0,13460.0,14,13465.0,15,B
2018-04-20 14:17:54,13465.0,10,26218,10,13460.0,14,13465.0,10,B
2018-04-20 14:17:55,13465.0,2,26220,0,13460.0,13,13465.0,12,B
2018-04-20 14:17:56,13465.0,16,26236,0,13465.0,1,13470.0,17,B
2018-04-20 14:17:56,13465.0,2,26238,0,13460.0,12,13465.0,9,B
2018-04-20 14:17:57,13465.0,2,26240,0,13460.0,14,13465.0,8,B
2018-04-20 14:17:58,13465.0,16,26256,16,13460.0,16,13470.0,17,B
2018-04-20 14:17:58,13465.0,2,26258,0,13465.0,10,13470.0,16,B
2018-04-20 14:18:00,13470.0,2,26260,0,13465.0,1,13470.0,17,B
2018-04-20 14:18:00,13465.0,2,26262,2,13460.0,18,13465.0,1,S
2018-04-20 14:18:01,13465.0,2,26264,0,13460.0,16,13465.0,10,S
2018-04-20 14:18:01,13465.0,2,26266,-2,13460.0,17,13465.0,5,S
2018-04-20 14:18:02,13465.0,2,26268,-2,13460.0,16,13465.0,3,S
2018-04-20 14:18:02,13465.0,6,26274,0,13460.0,16,13470.0,18,S
2018-04-20 14:18:04,13465.0,4,26278,-2,13460.0,16,13470.0,18,S
2018-04-20 14:18:05,13465.0,2,26280,2,13460.0,16,13465.0,1,S
2018-04-20 14:18:06,13465.0,8,26288,2,13465.0,2,13470.0,18,S
2018-04-20 14:18:06,13465.0,4,26292,4,13460.0,16,13470.0,19,S
2018-04-20 14:18:13,13465.0,2,26294,-2,13460.0,19,13465.0,1,S
2018-04-20 14:18:14,13465.0,2,26296,2,13460.0,20,13470.0,20,S
2018-04-20 14:18:17,13465.0,2,26298,0,13460.0,20,13470.0,19,S
2018-04-20 14:18:21,13465.0,2,26300,0,13460.0,20,13465.0,2,S
2018-04-20 14:18:23,13465.0,2,26302,0,13460.0,18,13465.0,1,S
2018-04-20 14:18:24,13465.0,4,26306,2,13465.0,3,13470.0,32,S
2018-04-20 14:18:29,13465.0,6,26312,6,13460.0,18,13465.0,7,S
2018-04-20 14:18:33,13460.0,34,26346,14,13455.0,5,13460.0,5,S
2018-04-20 14:18:35,13455.0,6,26352,6,13450.0,13,13460.0,9,S
2018-04-20 14:18:37,13455.0,4,26356,0,13455.0,3,13460.0,7,S
2018-04-20 14:18:46,13460.0,18,26374,14,13455.0,3,13465.0,6,B
2018-04-20 14:18:54,13460.0,6,26380,6,13455.0,4,13465.0,6,B
2018-04-20 14:19:15,13465.0,6,26386,2,13460.0,9,13465.0,6,B
2018-04-20 14:19:15,13465.0,12,26398,-2,13460.0,9,13470.0,26,B
2018-04-20 14:19:20,13465.0,2,26400,0,13460.0,9,13470.0,31,B
2018-04-20 14:19:33,13465.0,6,26406,6,13465.0,2,13470.0,26,B
2018-04-20 14:19:36,13470.0,6,26412,4,13465.0,8,13470.0,27,B
2018-04-20 14:19:37,13470.0,14,26426,-4,13465.0,8,13470.0,20,B
2018-04-20 14:19:37,13470.0,2,26428,-2,13465.0,10,13470.0,19,B
2018-04-20 14:19:38,13470.0,2,26430,-2,13465.0,7,13470.0,18,B
2018-04-20 14:19:38,13470.0,2,26432,-2,13465.0,7,13470.0,17,B
2018-04-20 14:19:39,13470.0,12,26444,12,13465.0,7,13470.0,11,B
2018-04-20 14:19:39,13470.0,2,26446,2,13465.0,7,13470.0,10,B
2018-04-20 14:19:40,13470.0,2,26448,2,13465.0,4,13470.0,9,B
2018-04-20 14:19:44,13470.0,2,26450,0,13465.0,9,13470.0,9,B
2018-04-20 14:19:49,13470.0,12,26462,12,13465.0,12,13470.0,5,B
2018-04-20 14:19:50,13470.0,4,26466,2,13465.0,12,13470.0,3,B
2018-04-20 14:19:51,13470.0,2,26468,2,13465.0,12,13470.0,2,B
2018-04-20 14:19:53,13470.0,2,26470,0,13465.0,14,13470.0,1,B
2018-04-20 14:19:53,13470.0,2,26472,0,13465.0,14,13475.0,4,B
2018-04-20 14:19:56,13470.0,4,26476,2,13470.0,3,13475.0,3,B
2018-04-20 14:19:57,13475.0,2,26478,0,13470.0,6,13480.0,8,B
2018-04-20 14:19:59,13475.0,6,26484,-4,13475.0,5,13480.0,6,B
2018-04-20 14:20:02,13480.0,2,26486,-2,13475.0,3,13480.0,5,B
2018-04-20 14:20:02,13480.0,2,26488,-2,13475.0,3,13480.0,4,B
2018-04-20 14:20:03,13480.0,8,26496,-8,13475.0,3,13485.0,5,B
2018-04-20 14:20:04,13480.0,4,26500,0,13480.0,12,13485.0,1,B
2018-04-20 14:20:05,13485.0,2,26502,-2,13480.0,11,13485.0,1,B
2018-04-20 14:20:06,13480.0,2,26504,0,13480.0,10,13485.0,2,S
2018-04-20 14:20:07,13480.0,2,26506,0,13475.0,7,13485.0,5,S
2018-04-20 14:20:07,13485.0,2,26508,2,13475.0,7,13485.0,4,B
2018-04-20 14:20:14,13485.0,8,26516,2,13475.0,10,13485.0,3,B
2018-04-20 14:20:15,13485.0,2,26518,2,13475.0,10,13485.0,2,B
2018-04-20 14:20:19,13475.0,2,26520,0,13475.0,10,13485.0,7,S
2018-04-20 14:20:20,13480.0,2,26522,-2,13480.0,2,13485.0,2,B
2018-04-20 14:20:34,13485.0,2,26524,0,13480.0,10,13485.0,2,B
2018-04-20 14:20:38,13485.0,2,26526,0,13480.0,11,13485.0,1,B
2018-04-20 14:20:42,13485.0,2,26528,0,13485.0,1,13490.0,3,B
2018-04-20 14:20:43,13490.0,2,26530,-2,13490.0,8,13495.0,3,B
2018-04-20 14:20:43,13495.0,20,26550,-12,13485.0,6,13495.0,2,B
2018-04-20 14:20:44,13490.0,2,26552,2,13490.0,10,13495.0,5,S
2018-04-20 14:20:45,13490.0,20,26572,-16,13485.0,2,13490.0,5,S
2018-04-20 14:20:47,13490.0,2,26574,2,13485.0,2,13490.0,6,S
2018-04-20 14:20:49,13490.0,2,26576,2,13485.0,7,13490.0,5,S
2018-04-20 14:20:50,13485.0,14,26590,0,13485.0,7,13495.0,9,S
2018-04-20 14:20:51,13490.0,2,26592,0,13485.0,7,13495.0,1,B
2018-04-20 14:20:55,13495.0,4,26596,0,13490.0,11,13500.0,262,B
2018-04-20 14:21:00,13495.0,2,26598,2,13490.0,12,13495.0,4,B
2018-04-20 14:21:03,13490.0,12,26610,6,13485.0,7,13495.0,4,S
2018-04-20 14:21:04,13490.0,2,26612,0,13485.0,7,13495.0,5,S
2018-04-20 14:21:06,13490.0,2,26614,2,13490.0,15,13495.0,7,S
2018-04-20 14:21:36,13495.0,2,26616,0,13490.0,25,13495.0,5,B
2018-04-20 14:21:45,13495.0,8,26624,-6,13490.0,25,13495.0,1,B
2018-04-20 14:21:45,13495.0,4,26628,0,13495.0,1,13500.0,260,B
2018-04-20 14:21:46,13495.0,4,26632,0,13495.0,4,13500.0,260,B
2018-04-20 14:21:47,13495.0,8,26640,-2,13490.0,25,13500.0,259,B
2018-04-20 14:21:48,13495.0,2,26642,0,13490.0,25,13500.0,259,B
2018-04-20 14:21:51,13495.0,2,26644,2,13490.0,25,13500.0,260,B
2018-04-20 14:21:57,13495.0,4,26648,2,13490.0,24,13495.0,4,B
2018-04-20 14:22:01,13490.0,2,26650,2,13490.0,21,13495.0,4,S
2018-04-20 14:22:09,13495.0,48,26698,20,13485.0,11,13495.0,5,B
2018-04-20 14:22:11,13490.0,2,26700,2,13485.0,11,13490.0,1,S
2018-04-20 14:22:20,13490.0,4,26704,-2,13485.0,18,13495.0,7,S
2018-04-20 14:22:24,13485.0,2,26706,0,13490.0,3,13495.0,8,S
2018-04-20 14:22:25,13490.0,6,26712,4,13485.0,20,13495.0,7,B
2018-04-20 14:22:37,13490.0,2,26714,0,13485.0,14,13490.0,2,B
2018-04-20 14:22:58,13490.0,2,26716,-2,13485.0,15,13490.0,1,B
2018-04-20 14:22:59,13490.0,2,26718,0,13490.0,2,13495.0,13,B
2018-04-20 14:22:59,13490.0,4,26722,0,13485.0,15,13495.0,13,B
2018-04-20 14:23:08,13485.0,2,26724,2,13485.0,18,13495.0,10,S
2018-04-20 14:23:36,13485.0,2,26726,-2,13485.0,20,13495.0,7,S
2018-04-20 14:24:17,13495.0,4,26730,4,13490.0,12,13495.0,3,B
2018-04-20 14:24:18,13495.0,2,26732,0,13490.0,12,13495.0,2,B
2018-04-20 14:24:19,13495.0,4,26736,2,13495.0,1,13500.0,258,B
2018-04-20 14:24:20,13495.0,2,26738,0,13490.0,17,13495.0,1,B
2018-04-20 14:24:20,13495.0,2,26740,-2,13490.0,18,13500.0,258,B
2018-04-20 14:24:23,13495.0,2,26742,-2,13495.0,1,13500.0,260,B
2018-04-20 14:24:24,13495.0,2,26744,-2,13490.0,23,13500.0,260,B
2018-04-20 14:24:29,13495.0,2,26746,0,13490.0,27,13495.0,10,B
2018-04-20 14:24:30,13495.0,12,26758,0,13490.0,27,13495.0,4,B
2018-04-20 14:24:30,13495.0,8,26766,0,13490.0,27,13500.0,260,B
2018-04-20 14:24:31,13500.0,10,26776,10,13490.0,28,13500.0,255,B
2018-04-20 14:24:33,13500.0,22,26798,12,13495.0,24,13500.0,239,B
2018-04-20 14:24:34,13500.0,6,26804,4,13495.0,31,13500.0,236,B
2018-04-20 14:24:35,13495.0,22,26826,22,13495.0,20,13500.0,235,S
2018-04-20 14:24:35,13500.0,28,26854,22,13495.0,19,13500.0,221,B
2018-04-20 14:24:36,13500.0,6,26860,2,13495.0,21,13500.0,218,B
2018-04-20 14:24:36,13500.0,6,26866,6,13495.0,18,13500.0,215,B
2018-04-20 14:24:37,13500.0,18,26884,14,13495.0,19,13500.0,206,B
2018-04-20 14:24:37,13500.0,4,26888,0,13495.0,19,13500.0,204,B
2018-04-20 14:24:38,13500.0,2,26890,2,13495.0,19,13500.0,203,B
2018-04-20 14:24:45,13500.0,40,26930,20,13495.0,13,13500.0,184,B
2018-04-20 14:24:45,13500.0,12,26942,12,13495.0,13,13500.0,178,B
2018-04-20 14:24:47,13500.0,8,26950,8,13495.0,14,13500.0,174,B
2018-04-20 14:24:48,13500.0,2,26952,2,13495.0,14,13500.0,173,B
2018-04-20 14:24:52,13500.0,2,26954,0,13495.0,13,13500.0,173,B
2018-04-20 14:24:53,13495.0,12,26966,8,13490.0,23,13500.0,177,S
2018-04-20 14:24:55,13490.0,18,26984,-2,13490.0,7,13495.0,18,S
2018-04-20 14:24:56,13490.0,10,26994,-4,13490.0,2,13495.0,18,S
2018-04-20 14:24:56,13490.0,4,26998,-2,13485.0,13,13495.0,18,S
2018-04-20 14:25:03,13495.0,10,27008,2,13490.0,11,13495.0,5,B
2018-04-20 14:25:04,13495.0,2,27010,2,13490.0,11,13500.0,177,B
2018-04-20 14:25:06,13495.0,42,27052,36,13495.0,3,13500.0,177,B
2018-04-20 14:25:06,13495.0,6,27058,0,13490.0,11,13500.0,177,B
2018-04-20 14:25:07,13495.0,2,27060,0,13490.0,9,13500.0,177,B
2018-04-20 14:25:13,13495.0,2,27062,-2,13490.0,10,13495.0,4,B
2018-04-20 14:25:13,13495.0,8,27070,8,13495.0,1,13500.0,177,B
2018-04-20 14:25:19,13500.0,2,27072,0,13495.0,13,13500.0,172,B
2018-04-20 14:25:26,13500.0,2,27074,2,13495.0,11,13500.0,171,B
2018-04-20 14:25:32,13495.0,26,27100,12,13490.0,10,13500.0,171,S
2018-04-20 14:25:33,13500.0,2,27102,2,13490.0,21,13495.0,4,B
2018-04-20 14:25:35,13495.0,2,27104,2,13490.0,6,13495.0,6,S
2018-04-20 14:25:38,13495.0,10,27114,-4,13490.0,6,13500.0,174,S
2018-04-20 14:25:39,13495.0,2,27116,0,13490.0,7,13500.0,174,S
2018-04-20 14:25:55,13490.0,10,27126,6,13490.0,5,13500.0,174,S
2018-04-20 14:25:57,13500.0,4,27130,4,13490.0,5,13500.0,172,B
2018-04-20 14:26:04,13495.0,2,27132,2,13490.0,5,13495.0,1,S
2018-04-20 14:26:07,13490.0,2,27134,0,13490.0,4,13495.0,1,S
2018-04-20 14:26:12,13490.0,2,27136,-2,13485.0,16,13495.0,5,S
2018-04-20 14:26:17,13485.0,2,27138,-2,13485.0,14,13495.0,13,S
2018-04-20 14:26:19,13485.0,16,27154,-12,13485.0,8,13495.0,13,S
2018-04-20 14:26:19,13485.0,2,27156,0,13485.0,7,13495.0,13,S
2018-04-20 14:26:22,13485.0,2,27158,0,13485.0,6,13495.0,13,S
2018-04-20 14:26:25,13495.0,2,27160,0,13485.0,6,13495.0,12,B
2018-04-20 14:26:27,13485.0,10,27170,-4,13485.0,1,13495.0,13,S
2018-04-20 14:26:35,13490.0,2,27172,2,13485.0,1,13495.0,12,B
2018-04-20 14:26:38,13495.0,4,27176,0,13485.0,6,13495.0,10,B
2018-04-20 14:26:48,13495.0,14,27190,8,13485.0,9,13495.0,7,B
2018-04-20 14:26:48,13485.0,14,27204,-12,13485.0,3,13495.0,7,S
2018-04-20 14:27:03,13485.0,2,27206,0,13485.0,7,13495.0,6,S
2018-04-20 14:27:08,13485.0,2,27208,2,13485.0,6,13495.0,7,S
2018-04-20 14:27:12,13495.0,8,27216,-2,13485.0,6,13495.0,5,B
2018-04-20 14:27:21,13495.0,2,27218,0,13490.0,1,13495.0,2,B
2018-04-20 14:27:21,13490.0,2,27220,0,13485.0,6,13495.0,2,S
2018-04-20 14:27:29,13485.0,2,27222,0,13485.0,6,13495.0,6,S
2018-04-20 14:27:30,13485.0,12,27234,8,13485.0,6,13495.0,6,S
2018-04-20 14:27:31,13495.0,2,27236,-2,13485.0,6,13495.0,6,B
2018-04-20 14:27:39,13485.0,4,27240,2,13485.0,2,13490.0,1,S
2018-04-20 14:27:51,13485.0,2,27242,0,13480.0,8,13490.0,1,S
2018-04-20 14:28:09,13480.0,2,27244,0,13480.0,10,13490.0,6,S
2018-04-20 14:28:47,13495.0,8,27252,4,13490.0,13,13495.0,2,B
2018-04-20 14:28:48,13495.0,2,27254,-2,13495.0,1,13500.0,183,B
2018-04-20 14:28:48,13495.0,2,27256,-2,13495.0,2,13500.0,181,B
2018-04-20 14:28:49,13495.0,4,27260,0,13490.0,12,13500.0,183,B
2018-04-20 14:28:59,13490.0,2,27262,0,13490.0,9,13500.0,184,S
2018-04-20 14:29:06,13500.0,2,27264,2,13490.0,9,13500.0,181,B
2018-04-20 14:29:15,13490.0,2,27266,0,13490.0,2,13495.0,11,S
2018-04-20 14:29:19,13495.0,2,27268,0,13490.0,2,13495.0,14,B
2018-04-20 14:29:24,13490.0,2,27270,2,13485.0,17,13495.0,13,S
2018-04-20 14:30:04,13495.0,4,27274,-4,13490.0,6,13500.0,183,B
2018-04-20 14:30:08,13490.0,2,27276,2,13485.0,21,13490.0,4,S
2018-04-20 14:30:09,13490.0,8,27284,8,13485.0,21,13500.0,183,S
2018-04-20 14:30:14,13490.0,2,27286,-2,13485.0,21,13495.0,5,S
2018-04-20 14:30:22,13485.0,2,27288,0,13485.0,15,13490.0,4,S
2018-04-20 14:30:24,13490.0,4,27292,4,13485.0,15,13490.0,2,B
2018-04-20 14:30:25,13485.0,20,27312,-20,13485.0,5,13490.0,2,S
2018-04-20 14:30:25,13485.0,10,27322,0,13480.0,8,13490.0,2,S
2018-04-20 14:30:26,13485.0,2,27324,-2,13480.0,5,13490.0,4,S
2018-04-20 14:30:35,13485.0,4,27328,-2,13485.0,2,13490.0,2,S
2018-04-20 14:30:35,13490.0,2,27330,0,13485.0,3,13495.0,10,B
2018-04-20 14:30:46,13490.0,8,27338,0,13480.0,8,13490.0,13,B
2018-04-20 14:30:50,13490.0,24,27362,0,13480.0,9,13490.0,2,B
2018-04-20 14:30:51,13490.0,4,27366,2,13480.0,10,13495.0,11,B
2018-04-20 14:30:55,13485.0,2,27368,0,13485.0,1,13490.0,4,S
2018-04-20 14:31:13,13490.0,2,27370,-2,13490.0,1,13495.0,10,B
2018-04-20 14:31:14,13485.0,2,27372,0,13485.0,9,13495.0,10,S
2018-04-20 14:31:21,13490.0,2,27374,2,13485.0,6,13495.0,11,B
2018-04-20 14:31:28,13495.0,2,27376,2,13485.0,6,13495.0,8,B
2018-04-20 14:31:36,13490.0,6,27382,0,13485.0,7,13490.0,5,S
2018-04-20 14:31:38,13490.0,2,27384,2,13485.0,7,13490.0,4,S
2018-04-20 14:31:52,13490.0,2,27386,2,13485.0,5,13490.0,3,S
2018-04-20 14:31:56,13485.0,2,27388,0,13485.0,2,13490.0,5,S
2018-04-20 14:31:59,13485.0,2,27390,0,13480.0,8,13490.0,5,S
2018-04-20 14:32:29,13490.0,8,27398,8,13485.0,9,13490.0,4,B
2018-04-20 14:32:34,13485.0,4,27402,0,13485.0,7,13490.0,4,S
2018-04-20 14:32:58,13485.0,18,27420,-14,13480.0,12,13485.0,1,S
2018-04-20 14:32:59,13485.0,2,27422,-2,13485.0,6,13490.0,5,S
2018-04-20 14:33:08,13490.0,6,27428,0,13490.0,3,13495.0,10,B
2018-04-20 14:33:16,13495.0,4,27432,0,13490.0,7,13495.0,7,B
2018-04-20 14:33:21,13495.0,10,27442,4,13490.0,7,13495.0,2,B
2018-04-20 14:33:24,13495.0,4,27446,0,13495.0,1,13500.0,188,B
2018-04-20 14:33:24,13495.0,2,27448,0,13490.0,5,13495.0,2,B
2018-04-20 14:33:28,13495.0,2,27450,-2,13490.0,5,13495.0,2,B
2018-04-20 14:33:31,13490.0,2,27452,0,13490.0,4,13495.0,2,S
2018-04-20 14:33:37,13490.0,4,27456,0,13490.0,1,13495.0,3,S
2018-04-20 14:33:37,13490.0,2,27458,0,13485.0,7,13495.0,3,S
2018-04-20 14:33:46,13490.0,2,27460,2,13490.0,4,13495.0,11,S
2018-04-20 14:33:50,13490.0,2,27462,0,13490.0,3,13495.0,11,S
2018-04-20 14:33:50,13490.0,6,27468,0,13485.0,8,13490.0,1,S
2018-04-20 14:33:51,13485.0,4,27472,0,13485.0,3,13495.0,13,S
2018-04-20 14:34:00,13485.0,16,27488,6,13480.0,8,13485.0,12,S
2018-04-20 14:34:00,13485.0,24,27512,6,13485.0,5,13495.0,10,S
2018-04-20 14:34:02,13485.0,4,27516,-4,13485.0,3,13495.0,10,S
2018-04-20 14:34:32,13495.0,2,27518,-2,13485.0,3,13495.0,11,B
2018-04-20 14:34:39,13495.0,2,27520,0,13485.0,3,13495.0,10,B
2018-04-20 14:34:47,13490.0,2,27522,2,13485.0,3,13490.0,3,S
2018-04-20 14:34:50,13480.0,26,27548,-12,13475.0,2,13480.0,7,S
2018-04-20 14:34:50,13480.0,14,27562,-2,13480.0,14,13490.0,2,S
2018-04-20 14:35:05,13490.0,4,27566,-4,13480.0,13,13490.0,3,B
2018-04-20 14:35:12,13490.0,2,27568,0,13480.0,13,13490.0,7,B
2018-04-20 14:35:31,13490.0,12,27580,0,13485.0,3,13490.0,4,B
2018-04-20 14:35:34,13490.0,2,27582,0,13485.0,3,13490.0,3,B
2018-04-20 14:35:43,13490.0,10,27592,0,13485.0,6,13495.0,10,B
2018-04-20 14:35:48,13490.0,2,27594,2,13485.0,9,13490.0,4,B
2018-04-20 14:35:49,13490.0,14,27608,-6,13490.0,1,13495.0,4,B
2018-04-20 14:35:54,13495.0,4,27612,0,13490.0,6,13500.0,183,B
2018-04-20 14:35:59,13500.0,2,27614,2,13490.0,7,13500.0,182,B
2018-04-20 14:36:03,13500.0,2,27616,2,13490.0,8,13500.0,181,B
2018-04-20 14:36:03,13500.0,2,27618,0,13490.0,5,13500.0,180,B
2018-04-20 14:36:04,13495.0,4,27622,0,13495.0,2,13500.0,180,S
2018-04-20 14:36:05,13495.0,4,27626,-4,13490.0,7,13500.0,180,S
2018-04-20 14:36:06,13495.0,2,27628,0,13495.0,1,13500.0,180,S
2018-04-20 14:36:06,13500.0,4,27632,0,13495.0,1,13500.0,174,B
2018-04-20 14:36:07,13500.0,4,27636,0,13495.0,1,13500.0,172,B
2018-04-20 14:36:11,13500.0,2,27638,0,13495.0,1,13500.0,170,B
2018-04-20 14:36:22,13500.0,2,27640,2,13490.0,18,13500.0,173,B
2018-04-20 14:36:26,13495.0,2,27642,2,13490.0,18,13495.0,2,S
2018-04-20 14:36:26,13495.0,4,27646,0,13495.0,2,13500.0,173,S
2018-04-20 14:36:36,13500.0,2,27648,0,13490.0,20,13500.0,174,B
2018-04-20 14:36:46,13500.0,2,27650,2,13490.0,22,13500.0,170,B
2018-04-20 14:36:51,13500.0,12,27662,6,13495.0,7,13500.0,162,B
2018-04-20 14:36:57,13500.0,2,27664,2,13495.0,17,13500.0,160,B
2018-04-20 14:36:58,13500.0,4,27668,0,13495.0,17,13500.0,158,B
2018-04-20 14:37:00,13500.0,2,27670,0,13495.0,17,13500.0,157,B
2018-04-20 14:37:13,13495.0,26,27696,16,13490.0,17,13495.0,1,S
2018-04-20 14:37:27,13490.0,4,27700,-2,13490.0,9,13495.0,4,S
2018-04-20 14:37:28,13495.0,8,27708,-6,13495.0,1,13500.0,163,B
2018-04-20 14:37:29,13495.0,2,27710,-2,13490.0,9,13500.0,163,B
2018-04-20 14:37:35,13500.0,48,27758,0,13490.0,11,13500.0,139,B
2018-04-20 14:37:48,13495.0,2,27760,0,13490.0,10,13500.0,139,S
2018-04-20 14:37:51,13495.0,2,27762,0,13495.0,2,13500.0,139,S
2018-04-20 14:37:52,13500.0,2,27764,0,13495.0,11,13500.0,133,B
2018-04-20 14:37:53,13500.0,2,27766,0,13495.0,3,13500.0,132,B
2018-04-20 14:38:00,13500.0,2,27768,0,13495.0,3,13500.0,131,B
2018-04-20 14:38:12,13495.0,4,27772,4,13495.0,2,13500.0,131,S
2018-04-20 14:38:12,13495.0,4,27776,0,13495.0,3,13500.0,131,S
2018-04-20 14:38:18,13500.0,56,27832,36,13495.0,4,13500.0,101,B
2018-04-20 14:38:18,13500.0,4,27836,4,13495.0,7,13500.0,99,B
2018-04-20 14:38:19,13500.0,4,27840,0,13495.0,4,13500.0,97,B
2018-04-20 14:38:19,13500.0,36,27876,26,13495.0,5,13500.0,79,B
2018-04-20 14:38:20,13495.0,42,27918,42,13495.0,7,13500.0,59,S
2018-04-20 14:38:20,13500.0,4,27922,0,13495.0,7,13500.0,57,B
2018-04-20 14:38:21,13500.0,6,27928,0,13495.0,7,13500.0,54,B
2018-04-20 14:38:21,13500.0,4,27932,0,13495.0,7,13500.0,52,B
2018-04-20 14:38:22,13500.0,10,27942,4,13495.0,7,13500.0,47,B
2018-04-20 14:38:22,13500.0,6,27948,0,13495.0,7,13500.0,44,B
2018-04-20 14:38:23,13500.0,4,27952,0,13495.0,7,13500.0,42,B
2018-04-20 14:38:23,13495.0,6,27958,2,13495.0,6,13500.0,40,S
2018-04-20 14:38:24,13500.0,6,27964,0,13495.0,6,13500.0,37,B
2018-04-20 14:38:24,13500.0,4,27968,0,13495.0,6,13500.0,35,B
2018-04-20 14:38:25,13500.0,6,27974,0,13495.0,6,13500.0,32,B
2018-04-20 14:38:25,13500.0,6,27980,0,13495.0,6,13500.0,29,B
2018-04-20 14:38:26,13500.0,4,27984,0,13495.0,6,13500.0,27,B
2018-04-20 14:38:26,13500.0,8,27992,0,13495.0,6,13500.0,23,B
2018-04-20 14:38:27,13500.0,4,27996,0,13495.0,6,13500.0,21,B
2018-04-20 14:38:27,13500.0,2,27998,0,13495.0,6,13500.0,20,B
2018-04-20 14:38:28,13500.0,2,28000,0,13495.0,6,13500.0,19,B
2018-04-20 14:38:29,13500.0,2,28002,2,13495.0,6,13500.0,18,B
2018-04-20 14:38:29,13500.0,20,28022,-4,13495.0,6,13500.0,8,B
2018-04-20 14:38:31,13500.0,2,28024,2,13495.0,7,13500.0,7,B
2018-04-20 14:38:32,13500.0,6,28030,4,13495.0,7,13500.0,4,B
2018-04-20 14:38:34,13500.0,4,28034,4,13495.0,7,13500.0,2,B
2018-04-20 14:38:34,13500.0,4,28038,0,13500.0,15,13505.0,5,B
2018-04-20 14:38:40,13505.0,2,28040,2,13500.0,20,13505.0,3,B
2018-04-20 14:38:40,13505.0,6,28046,0,13500.0,20,13510.0,8,B
2018-04-20 14:38:42,13510.0,2,28048,0,13505.0,30,13510.0,8,B
2018-04-20 14:38:44,13510.0,2,28050,0,13505.0,30,13510.0,6,B
2018-04-20 14:38:49,13510.0,2,28052,0,13505.0,30,13510.0,6,B
2018-04-20 14:38:50,13510.0,10,28062,0,13505.0,30,13515.0,7,B
2018-04-20 14:38:53,13510.0,8,28070,0,13510.0,11,13515.0,13,B
2018-04-20 14:38:57,13515.0,2,28072,2,13510.0,12,13515.0,7,B
2018-04-20 14:38:58,13515.0,2,28074,-2,13510.0,12,13515.0,6,B
2018-04-20 14:39:00,13515.0,6,28080,-4,13510.0,12,13515.0,4,B
2018-04-20 14:39:00,13515.0,6,28086,4,13510.0,14,13520.0,8,B
2018-04-20 14:39:03,13515.0,2,28088,-2,13515.0,1,13520.0,10,B
2018-04-20 14:39:13,13515.0,2,28090,0,13515.0,6,13520.0,9,B
2018-04-20 14:39:14,13515.0,8,28098,-4,13515.0,2,13520.0,9,B
2018-04-20 14:39:14,13515.0,4,28102,2,13510.0,7,13515.0,1,B
2018-04-20 14:39:15,13510.0,6,28108,4,13505.0,34,13510.0,2,S
2018-04-20 14:39:16,13510.0,4,28112,0,13505.0,34,13515.0,9,S
2018-04-20 14:39:22,13510.0,2,28114,2,13505.0,35,13515.0,9,S
2018-04-20 14:39:23,13515.0,2,28116,2,13505.0,35,13515.0,9,B
2018-04-20 14:39:24,13510.0,2,28118,-2,13505.0,34,13510.0,3,S
2018-04-20 14:39:36,13505.0,2,28120,0,13505.0,30,13510.0,10,S
2018-04-20 14:39:37,13505.0,2,28122,0,13505.0,29,13510.0,11,S
2018-04-20 14:39:37,13505.0,2,28124,0,13505.0,28,13510.0,11,S
2018-04-20 14:39:38,13505.0,4,28128,-2,13505.0,26,13510.0,11,S
2018-04-20 14:39:38,13505.0,2,28130,0,13505.0,25,13510.0,11,S
2018-04-20 14:39:39,13505.0,2,28132,0,13505.0,24,13510.0,12,S
2018-04-20 14:39:39,13505.0,2,28134,0,13505.0,23,13510.0,12,S
2018-04-20 14:39:40,13505.0,2,28136,0,13505.0,22,13510.0,12,S
2018-04-20 14:39:40,13505.0,2,28138,0,13505.0,21,13510.0,12,S
2018-04-20 14:39:41,13505.0,2,28140,0,13505.0,20,13510.0,12,S
2018-04-20 14:39:41,13510.0,22,28162,0,13505.0,19,13510.0,2,B
2018-04-20 14:39:42,13505.0,2,28164,0,13505.0,18,13510.0,2,S
2018-04-20 14:39:42,13505.0,2,28166,0,13505.0,17,13510.0,4,S
2018-04-20 14:39:43,13505.0,2,28168,0,13505.0,16,13510.0,5,S
2018-04-20 14:39:43,13505.0,2,28170,0,13505.0,15,13510.0,5,S
2018-04-20 14:39:44,13505.0,2,28172,0,13505.0,14,13510.0,5,S
2018-04-20 14:39:44,13505.0,2,28174,0,13505.0,13,13510.0,5,S
2018-04-20 14:39:45,13505.0,2,28176,0,13505.0,12,13510.0,5,S
2018-04-20 14:39:45,13505.0,2,28178,0,13505.0,11,13510.0,6,S
2018-04-20 14:39:46,13505.0,2,28180,0,13505.0,10,13510.0,11,S
2018-04-20 14:39:46,13500.0,58,28238,40,13495.0,3,13500.0,472,S
2018-04-20 14:39:47,13490.0,42,28280,26,13490.0,12,13500.0,458,S
2018-04-20 14:39:47,13500.0,2,28282,0,13495.0,12,13500.0,458,B
2018-04-20 14:39:48,13495.0,2,28284,0,13495.0,14,13500.0,458,S
2018-04-20 14:39:55,13495.0,12,28296,4,13490.0,15,13500.0,458,S
2018-04-20 14:39:58,13495.0,2,28298,-2,13495.0,1,13500.0,460,S
2018-04-20 14:39:59,13495.0,2,28300,0,13490.0,15,13500.0,460,S
2018-04-20 14:40:03,13495.0,2,28302,0,13490.0,14,13495.0,3,S
2018-04-20 14:40:08,13490.0,20,28322,12,13485.0,10,13490.0,1,S
2018-04-20 14:40:11,13490.0,6,28328,0,13490.0,12,13495.0,10,S
2018-04-20 14:40:13,13490.0,10,28338,-4,13485.0,14,13490.0,9,S
2018-04-20 14:40:13,13490.0,18,28356,-18,13490.0,3,13495.0,10,S
2018-04-20 14:40:14,13490.0,6,28362,-6,13485.0,14,13495.0,10,S
2018-04-20 14:40:18,13490.0,2,28364,-2,13490.0,51,13495.0,10,S
2018-04-20 14:40:30,13495.0,6,28370,0,13490.0,51,13495.0,6,B
2018-04-20 14:40:31,13490.0,4,28374,0,13490.0,49,13495.0,6,S
2018-04-20 14:40:32,13490.0,2,28376,0,13490.0,48,13495.0,6,S
2018-04-20 14:40:33,13490.0,2,28378,0,13490.0,47,13495.0,6,S
2018-04-20 14:40:33,13490.0,2,28380,0,13490.0,46,13495.0,6,S
2018-04-20 14:40:34,13490.0,2,28382,0,13490.0,45,13495.0,6,S
2018-04-20 14:40:34,13490.0,2,28384,0,13490.0,44,13495.0,6,S
2018-04-20 14:40:35,13490.0,2,28386,0,13490.0,43,13495.0,6,S
2018-04-20 14:40:35,13490.0,2,28388,0,13490.0,42,13495.0,6,S
2018-04-20 14:40:36,13490.0,2,28390,0,13490.0,41,13495.0,6,S
2018-04-20 14:40:36,13490.0,4,28394,0,13490.0,39,13495.0,6,S
2018-04-20 14:40:37,13490.0,2,28396,0,13490.0,40,13495.0,3,S
2018-04-20 14:40:37,13495.0,6,28402,0,13495.0,12,13500.0,462,B
2018-04-20 14:40:38,13495.0,10,28412,0,13495.0,3,13500.0,461,B
2018-04-20 14:40:39,13495.0,2,28414,2,13495.0,1,13500.0,462,B
2018-04-20 14:40:39,13495.0,2,28416,-2,13490.0,39,13495.0,1,B
2018-04-20 14:40:40,13495.0,2,28418,0,13490.0,39,13500.0,462,B
2018-04-20 14:40:41,13495.0,2,28420,2,13495.0,2,13500.0,462,B
2018-04-20 14:40:41,13495.0,4,28424,0,13490.0,46,13495.0,1,B
2018-04-20 14:40:42,13495.0,2,28426,0,13495.0,1,13500.0,462,B
2018-04-20 14:40:42,13495.0,2,28428,-2,13490.0,40,13495.0,1,B
2018-04-20 14:40:43,13495.0,4,28432,0,13495.0,1,13500.0,462,B
2018-04-20 14:40:43,13495.0,2,28434,0,13490.0,40,13495.0,1,B
2018-04-20 14:40:44,13495.0,4,28438,2,13490.0,40,13500.0,462,B
2018-04-20 14:40:47,13495.0,4,28442,0,13490.0,45,13495.0,1,B
2018-04-20 14:40:48,13490.0,2,28444,0,13490.0,38,13495.0,1,S
2018-04-20 14:40:48,13490.0,2,28446,0,13490.0,37,13495.0,1,S
2018-04-20 14:40:49,13495.0,2,28448,-2,13495.0,1,13500.0,462,B
2018-04-20 14:40:49,13495.0,2,28450,0,13490.0,39,13495.0,1,B
2018-04-20 14:40:50,13495.0,2,28452,0,13490.0,39,13500.0,462,B
2018-04-20 14:40:55,13490.0,2,28454,0,13490.0,43,13500.0,466,S
2018-04-20 14:41:28,13490.0,2,28456,0,13490.0,49,13500.0,466,S
2018-04-20 14:41:29,13500.0,4,28460,2,13490.0,48,13500.0,465,B
2018-04-20 14:41:29,13490.0,2,28462,0,13490.0,47,13500.0,465,S
2018-04-20 14:41:30,13490.0,2,28464,0,13490.0,46,13500.0,465,S
2018-04-20 14:41:30,13490.0,2,28466,0,13490.0,45,13500.0,465,S
2018-04-20 14:41:31,13490.0,2,28468,0,13490.0,44,13500.0,465,S
2018-04-20 14:41:31,13490.0,2,28470,0,13490.0,43,13500.0,466,S
2018-04-20 14:41:32,13490.0,2,28472,0,13490.0,42,13495.0,1,S
2018-04-20 14:41:32,13495.0,4,28476,-2,13490.0,36,13500.0,466,B
2018-04-20 14:41:33,13490.0,2,28478,0,13490.0,40,13500.0,466,S
2018-04-20 14:41:33,13490.0,2,28480,0,13490.0,39,13500.0,466,S
2018-04-20 14:41:34,13490.0,2,28482,0,13490.0,38,13495.0,1,S
2018-04-20 14:41:34,13490.0,4,28486,0,13490.0,32,13500.0,466,S
2018-04-20 14:41:35,13495.0,4,28490,0,13490.0,36,13500.0,466,B
2018-04-20 14:41:35,13490.0,2,28492,0,13490.0,36,13500.0,466,S
2018-04-20 14:41:36,13490.0,2,28494,0,13490.0,36,13500.0,466,S
2018-04-20 14:41:36,13490.0,2,28496,0,13490.0,35,13500.0,466,S
2018-04-20 14:41:37,13490.0,2,28498,0,13490.0,34,13500.0,466,S
2018-04-20 14:41:37,13490.0,2,28500,0,13490.0,33,13500.0,466,S
2018-04-20 14:41:38,13490.0,2,28502,0,13490.0,33,13500.0,466,S
2018-04-20 14:41:38,13490.0,2,28504,0,13490.0,32,13500.0,466,S
2018-04-20 14:41:39,13490.0,2,28506,0,13490.0,32,13500.0,466,S
2018-04-20 14:41:39,13490.0,2,28508,0,13490.0,31,13500.0,466,S
2018-04-20 14:41:40,13490.0,2,28510,0,13490.0,30,13500.0,466,S
2018-04-20 14:41:40,13490.0,2,28512,0,13490.0,30,13500.0,466,S
2018-04-20 14:41:41,13490.0,2,28514,0,13490.0,29,13500.0,466,S
2018-04-20 14:41:41,13490.0,2,28516,0,13490.0,28,13500.0,466,S
2018-04-20 14:41:42,13500.0,4,28520,0,13490.0,27,13500.0,465,B
2018-04-20 14:41:42,13490.0,2,28522,0,13490.0,26,13500.0,465,S
2018-04-20 14:41:43,13490.0,2,28524,0,13490.0,25,13500.0,465,S
2018-04-20 14:41:43,13490.0,2,28526,0,13490.0,24,13500.0,465,S
2018-04-20 14:41:44,13490.0,2,28528,0,13490.0,23,13500.0,465,S
2018-04-20 14:41:44,13490.0,2,28530,0,13490.0,22,13500.0,465,S
2018-04-20 14:41:45,13490.0,2,28532,0,13490.0,21,13500.0,465,S
2018-04-20 14:41:45,13490.0,2,28534,2,13490.0,20,13500.0,465,S
2018-04-20 14:41:46,13490.0,2,28536,0,13490.0,19,13500.0,465,S
2018-04-20 14:41:46,13490.0,2,28538,2,13490.0,18,13500.0,465,S
2018-04-20 14:41:47,13490.0,2,28540,2,13490.0,17,13500.0,465,S
2018-04-20 14:41:47,13490.0,2,28542,2,13490.0,17,13500.0,465,S
2018-04-20 14:41:48,13490.0,2,28544,2,13490.0,17,13500.0,465,S
2018-04-20 14:41:48,13490.0,2,28546,0,13490.0,16,13500.0,465,S
2018-04-20 14:41:49,13490.0,2,28548,0,13490.0,15,13500.0,465,S
2018-04-20 14:41:49,13490.0,2,28550,0,13490.0,14,13500.0,465,S
2018-04-20 14:41:50,13490.0,2,28552,0,13490.0,8,13500.0,465,S
2018-04-20 14:41:50,13490.0,2,28554,0,13490.0,12,13500.0,465,S
2018-04-20 14:41:51,13490.0,2,28556,0,13490.0,11,13500.0,466,S
2018-04-20 14:41:51,13490.0,2,28558,0,13490.0,10,13500.0,462,S
2018-04-20 14:41:52,13490.0,2,28560,0,13490.0,9,13500.0,462,S
2018-04-20 14:41:52,13490.0,2,28562,2,13490.0,8,13500.0,462,S
2018-04-20 14:41:53,13495.0,4,28566,2,13490.0,7,13495.0,1,B
2018-04-20 14:41:53,13495.0,2,28568,-2,13490.0,2,13500.0,462,B
2018-04-20 14:41:54,13490.0,10,28578,-2,13490.0,6,13500.0,463,S
2018-04-20 14:41:55,13490.0,2,28580,0,13490.0,4,13495.0,7,S
2018-04-20 14:41:55,13490.0,4,28584,0,13490.0,2,13495.0,7,S
2018-04-20 14:41:56,13490.0,4,28588,-4,13485.0,7,13495.0,7,S
2018-04-20 14:42:01,13495.0,2,28590,2,13490.0,4,13495.0,17,B
2018-04-20 14:42:14,13490.0,2,28592,0,13490.0,2,13495.0,22,S
2018-04-20 14:42:14,13490.0,4,28596,0,13485.0,7,13495.0,22,S
2018-04-20 14:42:17,13495.0,2,28598,2,13485.0,8,13495.0,21,B
2018-04-20 14:42:17,13495.0,4,28602,4,13485.0,8,13495.0,19,B
2018-04-20 14:42:18,13495.0,40,28642,-6,13495.0,30,13500.0,463,B
2018-04-20 14:42:18,13500.0,60,28702,-16,13495.0,2,13500.0,461,B
2018-04-20 14:42:19,13495.0,4,28706,0,13490.0,1,13495.0,1,S
2018-04-20 14:42:21,13490.0,2,28708,0,13490.0,2,13500.0,462,S
2018-04-20 14:42:25,13490.0,4,28712,0,13490.0,1,13495.0,2,S
2018-04-20 14:42:27,13490.0,2,28714,0,13485.0,7,13495.0,6,S
2018-04-20 14:42:31,13495.0,2,28716,2,13485.0,7,13495.0,9,B
2018-04-20 14:42:39,13495.0,12,28728,0,13490.0,10,13500.0,459,B
2018-04-20 14:42:40,13490.0,2,28730,-2,13490.0,17,13500.0,459,S
2018-04-20 14:42:44,13495.0,2,28732,2,13490.0,18,13495.0,9,B
2018-04-20 14:42:56,13495.0,24,28756,-4,13495.0,38,13500.0,459,B
2018-04-20 14:43:07,13495.0,2,28758,-2,13495.0,39,13500.0,456,B
2018-04-20 14:43:12,13495.0,2,28760,0,13495.0,36,13500.0,456,B
2018-04-20 14:43:21,13495.0,2,28762,-2,13495.0,35,13500.0,456,B
2018-04-20 14:43:33,13500.0,2,28764,2,13495.0,38,13500.0,460,B
2018-04-20 14:43:41,13500.0,2,28766,0,13495.0,35,13500.0,459,B
2018-04-20 14:43:52,13500.0,2,28768,2,13495.0,46,13500.0,458,B
2018-04-20 14:44:14,13500.0,2,28770,0,13495.0,47,13500.0,457,B
2018-04-20 14:44:28,13500.0,20,28790,0,13495.0,37,13500.0,447,B
2018-04-20 14:44:49,13495.0,2,28792,0,13495.0,38,13500.0,447,S
2018-04-20 14:45:01,13495.0,2,28794,0,13495.0,35,13500.0,446,S
2018-04-20 14:45:04,13495.0,2,28796,-2,13495.0,34,13500.0,446,S
2018-04-20 14:45:13,13495.0,2,28798,0,13495.0,35,13500.0,446,S
2018-04-20 14:45:16,13495.0,2,28800,-2,13495.0,35,13500.0,446,S
2018-04-20 14:45:23,13495.0,30,28830,16,13495.0,36,13500.0,432,S
2018-04-20 14:45:24,13500.0,16,28846,4,13495.0,31,13500.0,430,B
2018-04-20 14:45:24,13500.0,4,28850,4,13495.0,31,13500.0,428,B
2018-04-20 14:45:26,13495.0,2,28852,0,13495.0,26,13500.0,434,S
2018-04-20 14:45:31,13500.0,2,28854,2,13495.0,27,13500.0,433,B
2018-04-20 14:45:34,13495.0,2,28856,0,13495.0,24,13500.0,433,S
2018-04-20 14:45:36,13500.0,2,28858,2,13495.0,27,13500.0,426,B
2018-04-20 14:45:37,13500.0,8,28866,0,13495.0,27,13500.0,422,B
2018-04-20 14:45:41,13500.0,2,28868,0,13495.0,27,13500.0,422,B
2018-04-20 14:45:48,13500.0,4,28872,4,13495.0,27,13500.0,420,B
2018-04-20 14:45:51,13500.0,2,28874,0,13495.0,28,13500.0,419,B
2018-04-20 14:45:54,13495.0,2,28876,0,13495.0,27,13500.0,419,S
2018-04-20 14:45:57,13500.0,2,28878,2,13495.0,27,13500.0,418,B
2018-04-20 14:46:00,13500.0,2,28880,0,13495.0,34,13500.0,417,B
2018-04-20 14:46:03,13500.0,22,28902,6,13495.0,34,13505.0,7,B
2018-04-20 14:46:08,13505.0,2,28904,-2,13500.0,3,13505.0,6,B
2018-04-20 14:46:09,13505.0,2,28906,-2,13500.0,2,13505.0,3,B
2018-04-20 14:46:10,13500.0,4,28910,0,13495.0,36,13500.0,198,S
2018-04-20 14:46:14,13500.0,2,28912,2,13495.0,32,13500.0,197,S
2018-04-20 14:46:16,13495.0,8,28920,-8,13495.0,25,13500.0,204,S
2018-04-20 14:46:20,13500.0,2,28922,0,13495.0,25,13500.0,203,B
2018-04-20 14:46:21,13495.0,2,28924,-2,13495.0,24,13500.0,203,S
2018-04-20 14:46:28,13500.0,4,28928,4,13495.0,27,13500.0,195,B
2018-04-20 14:46:28,13500.0,8,28936,8,13495.0,27,13500.0,191,B
2018-04-20 14:46:29,13500.0,6,28942,6,13495.0,27,13500.0,188,B
2018-04-20 14:46:29,13500.0,8,28950,8,13495.0,27,13500.0,184,B
2018-04-20 14:46:30,13500.0,4,28954,4,13495.0,27,13500.0,183,B
2018-04-20 14:46:30,13500.0,10,28964,10,13495.0,27,13500.0,178,B
2018-04-20 14:46:31,13500.0,4,28968,4,13495.0,27,13500.0,176,B
2018-04-20 14:46:31,13500.0,10,28978,10,13495.0,27,13500.0,171,B
2018-04-20 14:46:32,13500.0,4,28982,4,13495.0,27,13500.0,169,B
2018-04-20 14:46:32,13500.0,4,28986,4,13495.0,27,13500.0,167,B
2018-04-20 14:46:33,13500.0,8,28994,8,13495.0,27,13500.0,369,B
2018-04-20 14:46:34,13500.0,16,29010,0,13495.0,18,13500.0,373,B
2018-04-20 14:46:34,13495.0,6,29016,0,13495.0,15,13500.0,373,S
2018-04-20 14:46:35,13500.0,6,29022,6,13495.0,15,13500.0,370,B
2018-04-20 14:46:36,13495.0,2,29024,0,13495.0,14,13500.0,370,S
2018-04-20 14:46:37,13495.0,2,29026,0,13495.0,13,13500.0,370,S
2018-04-20 14:46:39,13495.0,2,29028,-2,13495.0,12,13500.0,370,S
2018-04-20 14:46:45,13495.0,2,29030,-2,13495.0,11,13500.0,366,S
2018-04-20 14:46:52,13495.0,2,29032,-2,13495.0,13,13500.0,364,S
2018-04-20 14:46:55,13500.0,6,29038,6,13495.0,13,13500.0,361,B
2018-04-20 14:47:05,13500.0,4,29042,4,13495.0,11,13500.0,359,B
2018-04-20 14:47:13,13500.0,2,29044,2,13495.0,13,13500.0,358,B
2018-04-20 14:47:15,13500.0,2,29046,2,13495.0,14,13500.0,357,B
2018-04-20 14:47:15,13500.0,4,29050,4,13495.0,14,13500.0,355,B
2018-04-20 14:47:17,13500.0,6,29056,6,13495.0,11,13500.0,358,B
2018-04-20 14:47:47,13500.0,2,29058,0,13495.0,4,13500.0,358,B
2018-04-20 14:48:08,13495.0,2,29060,-2,13495.0,4,13500.0,356,S
2018-04-20 14:48:14,13495.0,4,29064,0,13495.0,2,13500.0,356,S
2018-04-20 14:48:15,13495.0,2,29066,2,13495.0,1,13500.0,356,S
2018-04-20 14:48:16,13495.0,2,29068,2,13490.0,18,13500.0,356,S
2018-04-20 14:48:30,13495.0,2,29070,0,13490.0,16,13495.0,1,S
2018-04-20 14:48:30,13500.0,4,29074,2,13490.0,16,13500.0,363,B
2018-04-20 14:48:31,13500.0,2,29076,2,13490.0,16,13500.0,362,B
2018-04-20 14:48:35,13500.0,4,29080,4,13490.0,15,13500.0,360,B
2018-04-20 14:48:56,13495.0,2,29082,0,13490.0,15,13495.0,1,S
2018-04-20 14:49:06,13495.0,4,29086,0,13490.0,29,13500.0,363,S
2018-04-20 14:49:07,13495.0,2,29088,0,13490.0,19,13500.0,362,S
2018-04-20 14:49:11,13500.0,2,29090,2,13495.0,13,13500.0,363,B
2018-04-20 14:49:21,13500.0,26,29116,0,13495.0,1,13500.0,344,B
2018-04-20 14:49:23,13495.0,4,29120,-2,13490.0,17,13495.0,2,S
2018-04-20 14:49:24,13500.0,6,29126,-2,13495.0,8,13500.0,342,B
2018-04-20 14:49:24,13500.0,4,29130,2,13495.0,7,13500.0,341,B
2018-04-20 14:49:39,13495.0,4,29134,-4,13495.0,7,13500.0,341,S
2018-04-20 14:49:44,13495.0,2,29136,-2,13495.0,4,13500.0,341,S
2018-04-20 14:49:45,13495.0,2,29138,0,13495.0,3,13500.0,341,S
2018-04-20 14:49:51,13495.0,6,29144,-6,13490.0,17,13495.0,7,S
2018-04-20 14:49:51,13495.0,6,29150,-2,13490.0,17,13495.0,4,S
2018-04-20 14:49:52,13495.0,2,29152,0,13490.0,17,13495.0,3,S
2018-04-20 14:49:52,13495.0,6,29158,0,13495.0,2,13500.0,341,S
2018-04-20 14:49:53,13500.0,6,29164,6,13495.0,2,13500.0,338,B
2018-04-20 14:49:54,13500.0,2,29166,2,13495.0,77,13500.0,337,B
2018-04-20 14:50:09,13495.0,8,29174,4,13495.0,73,13500.0,343,S
2018-04-20 14:50:10,13495.0,2,29176,0,13495.0,72,13500.0,343,S
2018-04-20 14:50:14,13495.0,2,29178,0,13495.0,72,13500.0,342,S
2018-04-20 14:50:31,13500.0,20,29198,20,13495.0,73,13500.0,326,B
2018-04-20 14:50:34,13495.0,10,29208,0,13495.0,68,13500.0,332,S
2018-04-20 14:50:51,13495.0,2,29210,-2,13495.0,67,13500.0,326,S
2018-04-20 14:50:55,13495.0,2,29212,0,13495.0,66,13500.0,326,S
2018-04-20 14:51:06,13500.0,20,29232,20,13495.0,66,13500.0,313,B
2018-04-20 14:51:11,13495.0,4,29236,-4,13495.0,64,13500.0,312,S
2018-04-20 14:51:25,13500.0,2,29238,2,13495.0,64,13500.0,312,B
2018-04-20 14:51:35,13500.0,20,29258,20,13495.0,64,13500.0,308,B
2018-04-20 14:51:41,13500.0,20,29278,20,13495.0,65,13500.0,294,B
2018-04-20 14:51:41,13500.0,2,29280,2,13495.0,65,13500.0,293,B
2018-04-20 14:51:45,13500.0,2,29282,2,13495.0,65,13500.0,295,B
2018-04-20 14:51:45,13495.0,2,29284,-2,13495.0,64,13500.0,295,S
2018-04-20 14:51:46,13500.0,2,29286,2,13495.0,64,13500.0,294,B
2018-04-20 14:51:47,13500.0,2,29288,2,13495.0,64,13500.0,293,B
2018-04-20 14:51:48,13500.0,2,29290,2,13495.0,64,13500.0,292,B
2018-04-20 14:51:52,13500.0,2,29292,2,13495.0,64,13500.0,295,B
2018-04-20 14:51:54,13500.0,2,29294,2,13495.0,64,13500.0,294,B
2018-04-20 14:51:56,13500.0,2,29296,2,13495.0,64,13500.0,293,B
2018-04-20 14:52:04,13500.0,40,29336,-2,13495.0,45,13500.0,295,B
2018-04-20 14:52:06,13495.0,4,29340,0,13495.0,44,13500.0,299,S
2018-04-20 14:52:07,13500.0,2,29342,2,13495.0,44,13500.0,298,B
2018-04-20 14:52:11,13500.0,4,29346,4,13495.0,44,13500.0,296,B
2018-04-20 14:52:24,13495.0,6,29352,0,13490.0,13,13500.0,292,S
2018-04-20 14:52:26,13495.0,6,29358,-4,13490.0,11,13500.0,287,S
2018-04-20 14:52:27,13500.0,2,29360,2,13490.0,11,13500.0,289,B
2018-04-20 14:52:41,13500.0,20,29380,2,13490.0,7,13495.0,2,B
2018-04-20 14:52:52,13490.0,6,29386,-6,13490.0,4,13495.0,16,S
2018-04-20 14:52:57,13490.0,12,29398,-8,13485.0,4,13490.0,2,S
2018-04-20 14:52:58,13485.0,4,29402,-4,13485.0,1,13490.0,2,S
2018-04-20 14:53:01,13485.0,2,29404,-2,13485.0,5,13490.0,4,S
2018-04-20 14:53:01,13490.0,2,29406,0,13485.0,5,13490.0,4,B
2018-04-20 14:53:04,13490.0,6,29412,0,13490.0,1,13495.0,12,B
2018-04-20 14:53:06,13490.0,4,29416,2,13490.0,2,13495.0,11,B
2018-04-20 14:53:20,13490.0,6,29422,-4,13485.0,11,13490.0,17,B
2018-04-20 14:53:21,13490.0,34,29456,0,13485.0,9,13495.0,10,B
2018-04-20 14:53:34,13490.0,12,29468,-12,13490.0,4,13495.0,7,B
2018-04-20 14:53:48,13490.0,2,29470,0,13490.0,2,13495.0,11,B
2018-04-20 14:53:50,13490.0,2,29472,-2,13485.0,8,13495.0,11,B
2018-04-20 14:53:54,13490.0,2,29474,-2,13490.0,1,13495.0,11,B
2018-04-20 14:53:57,13490.0,2,29476,0,13485.0,22,13490.0,1,B
2018-04-20 14:53:58,13490.0,6,29482,2,13485.0,22,13495.0,11,B
2018-04-20 14:54:03,13495.0,8,29490,-6,13490.0,11,13495.0,4,B
2018-04-20 14:54:04,13495.0,8,29498,2,13490.0,22,13500.0,291,B
2018-04-20 14:54:18,13495.0,2,29500,-2,13490.0,2,13495.0,10,B
2018-04-20 14:54:30,13490.0,2,29502,2,13490.0,11,13495.0,6,S
2018-04-20 14:54:32,13490.0,2,29504,2,13490.0,10,13495.0,6,S
2018-04-20 14:54:44,13490.0,4,29508,0,13490.0,17,13495.0,4,S
2018-04-20 14:54:45,13495.0,2,29510,-2,13490.0,22,13495.0,3,B
2018-04-20 14:54:49,13495.0,2,29512,0,13490.0,21,13495.0,2,B
2018-04-20 14:55:10,13490.0,2,29514,2,13490.0,13,13495.0,8,S
2018-04-20 14:55:11,13490.0,2,29516,0,13490.0,12,13495.0,24,S
2018-04-20 14:55:19,13490.0,2,29518,0,13490.0,11,13495.0,6,S
2018-04-20 14:55:20,13495.0,2,29520,2,13490.0,11,13495.0,4,B
2018-04-20 14:55:21,13495.0,4,29524,0,13490.0,11,13500.0,291,B
2018-04-20 14:55:48,13495.0,2,29526,0,13490.0,23,13500.0,288,B
2018-04-20 14:56:01,13500.0,2,29528,0,13490.0,19,13500.0,313,B
2018-04-20 14:56:19,13495.0,4,29532,0,13490.0,19,13495.0,4,S
2018-04-20 14:56:23,13490.0,2,29534,0,13490.0,14,13495.0,4,S
2018-04-20 14:56:29,13495.0,2,29536,2,13490.0,14,13495.0,3,B
2018-04-20 14:56:30,13490.0,2,29538,2,13490.0,13,13495.0,3,S
2018-04-20 14:56:31,13495.0,2,29540,2,13490.0,13,13495.0,2,B
2018-04-20 14:56:35,13495.0,4,29544,4,13490.0,16,13500.0,314,B
2018-04-20 14:56:48,13490.0,4,29548,0,13490.0,14,13495.0,1,S
2018-04-20 14:56:49,13490.0,16,29564,14,13490.0,6,13495.0,1,S
2018-04-20 14:56:55,13495.0,4,29568,2,13490.0,3,13500.0,316,B
2018-04-20 14:56:58,13500.0,4,29572,4,13490.0,18,13500.0,319,B
2018-04-20 14:57:00,13495.0,10,29582,0,13495.0,14,13500.0,318,S
2018-04-20 14:57:01,13500.0,4,29586,0,13495.0,20,13500.0,308,B
2018-04-20 14:57:07,13500.0,2,29588,2,13495.0,13,13500.0,298,B
2018-04-20 14:57:13,13495.0,2,29590,2,13495.0,16,13500.0,293,S
2018-04-20 14:57:15,13495.0,2,29592,0,13495.0,15,13500.0,293,S
2018-04-20 14:57:17,13495.0,2,29594,2,13495.0,15,13500.0,294,S
2018-04-20 14:57:18,13495.0,4,29598,0,13495.0,13,13500.0,294,S
2018-04-20 14:57:18,13500.0,4,29602,2,13495.0,13,13500.0,292,B
2018-04-20 14:57:23,13500.0,14,29616,12,13495.0,14,13500.0,285,B
2018-04-20 14:57:31,13500.0,12,29628,12,13495.0,16,13500.0,279,B
2018-04-20 14:57:33,13500.0,4,29632,2,13495.0,12,13500.0,277,B
2018-04-20 14:57:33,13500.0,4,29636,2,13495.0,15,13500.0,275,B
2018-04-20 14:57:34,13500.0,2,29638,2,13495.0,14,13500.0,274,B
2018-04-20 14:57:39,13495.0,2,29640,2,13495.0,9,13500.0,274,S
2018-04-20 14:57:40,13495.0,8,29648,0,13495.0,5,13500.0,274,S
2018-04-20 14:57:47,13500.0,2,29650,0,13495.0,9,13500.0,276,B
2018-04-20 14:57:50,13495.0,2,29652,0,13495.0,8,13500.0,276,S
2018-04-20 14:57:50,13500.0,2,29654,2,13495.0,8,13500.0,275,B
2018-04-20 14:57:51,13495.0,4,29658,-4,13495.0,6,13500.0,275,S
2018-04-20 14:58:00,13495.0,52,29710,-2,13495.0,5,13500.0,252,S
2018-04-20 14:58:01,13495.0,4,29714,0,13495.0,3,13500.0,252,S
2018-04-20 14:58:04,13495.0,2,29716,2,13495.0,2,13500.0,250,S
2018-04-20 14:58:05,13500.0,34,29750,14,13495.0,3,13500.0,233,B
2018-04-20 14:58:05,13500.0,10,29760,10,13495.0,6,13500.0,228,B
2018-04-20 14:58:06,13500.0,30,29790,30,13495.0,6,13500.0,213,B
2018-04-20 14:58:07,13500.0,6,29796,6,13495.0,6,13500.0,210,B
2018-04-20 14:58:08,13500.0,6,29802,6,13495.0,6,13500.0,207,B
2018-04-20 14:58:09,13500.0,4,29806,4,13495.0,2,13500.0,207,B
2018-04-20 14:58:09,13495.0,4,29810,-2,13490.0,19,13500.0,207,S
2018-04-20 14:58:13,13495.0,4,29814,-4,13490.0,19,13495.0,4,S
2018-04-20 14:58:15,13495.0,20,29834,12,13490.0,19,13495.0,1,S
2018-04-20 14:58:16,13495.0,4,29838,0,13490.0,19,13500.0,211,S
2018-04-20 14:58:19,13495.0,6,29844,0,13490.0,19,13500.0,211,S
2018-04-20 14:58:26,13500.0,40,29884,40,13495.0,1,13500.0,174,B
2018-04-20 14:58:26,13500.0,10,29894,10,13495.0,4,13500.0,168,B
2018-04-20 14:58:27,13500.0,2,29896,2,13495.0,4,13500.0,167,B
2018-04-20 14:58:29,13495.0,30,29926,24,13495.0,7,13500.0,167,S
2018-04-20 14:58:30,13495.0,12,29938,0,13495.0,16,13500.0,167,S
2018-04-20 14:58:31,13500.0,4,29942,0,13495.0,16,13500.0,166,B
2018-04-20 14:58:32,13495.0,12,29954,10,13495.0,15,13500.0,161,S
2018-04-20 14:58:38,13500.0,2,29956,0,13495.0,15,13500.0,158,B
2018-04-20 14:58:41,13495.0,14,29970,14,13495.0,13,13500.0,158,S
2018-04-20 14:58:42,13500.0,60,30030,60,13495.0,13,13500.0,128,B
2018-04-20 14:58:50,13495.0,2,30032,0,13495.0,12,13500.0,138,S
2018-04-20 14:58:51,13495.0,12,30044,0,13495.0,6,13500.0,138,S
2018-04-20 14:58:51,13495.0,12,30056,-10,13495.0,4,13500.0,138,S
2018-04-20 14:58:52,13495.0,10,30066,0,13490.0,12,13500.0,140,S
2018-04-20 14:58:58,13495.0,2,30068,0,13490.0,13,13500.0,141,S
2018-04-20 14:59:00,13500.0,6,30074,0,13490.0,24,13500.0,138,B
2018-04-20 14:59:01,13495.0,4,30078,0,13490.0,24,13500.0,136,S
2018-04-20 14:59:01,13490.0,12,30090,-2,13490.0,21,13500.0,133,S
2018-04-20 14:59:03,13495.0,2,30092,0,13495.0,2,13500.0,133,B
2018-04-20 14:59:04,13495.0,4,30096,-2,13495.0,1,13500.0,133,B
2018-04-20 14:59:08,13500.0,20,30116,20,13495.0,2,13500.0,123,B
2018-04-20 14:59:12,13500.0,26,30142,26,13495.0,6,13500.0,108,B
2018-04-20 14:59:12,13500.0,10,30152,10,13495.0,6,13500.0,103,B
2018-04-20 14:59:13,13500.0,2,30154,2,13495.0,6,13500.0,102,B
2018-04-20 14:59:14,13500.0,8,30162,0,13495.0,6,13500.0,98,B
2018-04-20 14:59:15,13500.0,4,30166,0,13495.0,6,13500.0,96,B
2018-04-20 14:59:17,13495.0,2,30168,0,13495.0,5,13500.0,96,S
2018-04-20 14:59:18,13500.0,20,30188,20,13495.0,5,13500.0,86,B
2018-04-20 14:59:20,13500.0,20,30208,20,13495.0,5,13500.0,77,B
2018-04-20 14:59:22,13500.0,2,30210,0,13495.0,6,13500.0,76,B
2018-04-20 14:59:24,13495.0,2,30212,0,13495.0,5,13500.0,76,S
2018-04-20 14:59:27,13500.0,2,30214,2,13495.0,5,13500.0,75,B
2018-04-20 14:59:27,13500.0,2,30216,2,13495.0,5,13500.0,74,B
2018-04-20 14:59:28,13500.0,10,30226,0,13495.0,5,13500.0,69,B
2018-04-20 14:59:29,13500.0,2,30228,2,13495.0,5,13500.0,68,B
2018-04-20 14:59:30,13495.0,4,30232,4,13495.0,3,13500.0,68,S
2018-04-20 14:59:30,13500.0,136,30368,-26,13495.0,3,13505.0,9,B
2018-04-20 14:59:31,13510.0,30,30398,-12,13495.0,3,13510.0,1,B
2018-04-20 14:59:31,13495.0,4,30402,-2,13495.0,1,13510.0,1,S
2018-04-20 14:59:32,13510.0,2,30404,-2,13495.0,2,13505.0,2,B
2018-04-20 14:59:32,13505.0,4,30408,0,13495.0,2,13510.0,1,S
2018-04-20 14:59:33,13495.0,2,30410,0,13495.0,1,13510.0,1,S
2018-04-20 14:59:41,13500.0,2,30412,0,13500.0,1,13515.0,5,B
2018-04-20 14:59:44,13510.0,2,30414,-2,13500.0,1,13515.0,5,B
2018-04-20 14:59:47,13515.0,10,30424,-8,13500.0,1,13515.0,1,B
2018-04-20 14:59:47,13515.0,2,30426,-2,13500.0,1,13515.0,1,B
2018-04-20 14:59:48,13515.0,2,30428,-2,13500.0,1,13515.0,1,B
2018-04-20 14:59:48,13515.0,2,30430,-2,13500.0,2,13515.0,1,B
2018-04-20 14:59:49,13515.0,4,30434,-4,13500.0,2,13505.0,2,B
2018-04-20 14:59:49,13510.0,8,30442,0,13500.0,2,13515.0,1,S
2018-04-20 14:59:59,13515.0,2,30444,0,13505.0,1,13515.0,4,B
2018-04-20 21:00:01,13485.0,28,28,74840,0.0,0,0.0,0,B
2018-04-20 21:00:01,13490.0,20,48,4,13470.0,4,13490.0,5,B
2018-04-20 21:00:02,13470.0,4,52,4,13470.0,3,13490.0,7,S
2018-04-20 21:00:09,13495.0,16,68,-14,13475.0,1,13490.0,4,B
2018-04-20 21:00:10,13475.0,2,70,0,13470.0,6,13485.0,1,S
2018-04-20 21:00:11,13485.0,2,72,0,13470.0,6,13485.0,3,B
2018-04-20 21:00:11,13485.0,4,76,4,13470.0,5,13485.0,2,B
2018-04-20 21:00:14,13470.0,6,82,2,13460.0,2,13470.0,1,S
2018-04-20 21:00:15,13470.0,6,88,4,13470.0,2,13480.0,10,S
2018-04-20 21:00:15,13470.0,4,92,4,13465.0,4,13480.0,8,S
2018-04-20 21:00:17,13470.0,14,106,2,13465.0,2,13470.0,3,S
2018-04-20 21:00:18,13465.0,4,110,4,13455.0,4,13470.0,6,S
2018-04-20 21:00:19,13460.0,6,116,0,13455.0,5,13460.0,1,S
2018-04-20 21:00:20,13460.0,4,120,0,13460.0,1,13465.0,1,S
2018-04-20 21:00:21,13465.0,2,122,0,13460.0,3,13470.0,3,B
2018-04-20 21:00:26,13460.0,2,124,2,13455.0,3,13460.0,1,S
2018-04-20 21:00:26,13460.0,2,126,2,13455.0,3,13470.0,11,S
2018-04-20 21:00:30,13460.0,2,128,0,13455.0,6,13460.0,1,S
2018-04-20 21:00:31,13460.0,2,130,0,13455.0,6,13470.0,16,S
2018-04-20 21:00:31,13460.0,2,132,0,13455.0,4,13460.0,1,S
2018-04-20 21:00:32,13455.0,16,148,0,13450.0,4,13465.0,5,S
2018-04-20 21:00:33,13455.0,8,156,4,13450.0,1,13455.0,5,S
2018-04-20 21:00:34,13460.0,2,158,0,13455.0,1,13460.0,7,B
2018-04-20 21:00:35,13460.0,6,164,2,13455.0,1,13460.0,25,B
2018-04-20 21:00:35,13460.0,2,166,2,13455.0,7,13460.0,29,B
2018-04-20 21:00:36,13460.0,42,208,20,13455.0,7,13460.0,8,B
2018-04-20 21:00:36,13460.0,2,210,2,13455.0,10,13460.0,7,B
2018-04-20 21:00:39,13460.0,14,224,8,13460.0,4,13470.0,16,B
2018-04-20 21:00:41,13470.0,2,226,2,13465.0,2,13470.0,4,B
2018-04-20 21:00:41,13480.0,10,236,-6,13465.0,2,13480.0,4,B
2018-04-20 21:00:45,13485.0,4,240,0,13475.0,2,13485.0,8,B
2018-04-20 21:00:47,13485.0,4,244,0,13475.0,4,13485.0,6,B
2018-04-20 21:00:49,13485.0,12,256,6,13480.0,2,13490.0,5,B
2018-04-20 21:00:49,13490.0,4,260,0,13480.0,8,13495.0,2,B
2018-04-20 21:00:51,13490.0,2,262,0,13485.0,5,13495.0,6,B
2018-04-20 21:00:52,13490.0,2,264,2,13485.0,10,13495.0,7,B
2018-04-20 21:00:53,13490.0,2,266,0,13485.0,10,13495.0,6,B
2018-04-20 21:00:54,13485.0,4,270,0,13485.0,4,13495.0,8,S
2018-04-20 21:00:56,13495.0,4,274,0,13485.0,8,13495.0,3,B
2018-04-20 21:00:57,13485.0,4,278,0,13485.0,9,13495.0,2,S
2018-04-20 21:00:58,13495.0,2,280,0,13485.0,9,13495.0,1,B
2018-04-20 21:01:02,13495.0,10,290,0,13485.0,6,13495.0,1,B
2018-04-20 21:01:04,13490.0,2,292,0,13485.0,4,13490.0,3,S
2018-04-20 21:01:09,13485.0,4,296,-4,13480.0,5,13490.0,6,S
2018-04-20 21:01:11,13485.0,2,298,-2,13480.0,2,13485.0,13,S
2018-04-20 21:01:12,13480.0,4,302,0,13475.0,3,13485.0,13,S
2018-04-20 21:01:21,13485.0,4,306,-2,13480.0,4,13485.0,9,B
2018-04-20 21:01:25,13480.0,8,314,-6,13475.0,10,13485.0,9,S
2018-04-20 21:01:34,13480.0,2,316,0,13475.0,10,13485.0,6,S
2018-04-20 21:01:39,13480.0,10,326,8,13480.0,5,13490.0,2,S
2018-04-20 21:01:45,13485.0,2,328,0,13485.0,2,13490.0,3,B
2018-04-20 21:01:49,13480.0,4,332,2,13480.0,10,13490.0,4,S
2018-04-20 21:01:52,13480.0,2,334,2,13475.0,7,13485.0,4,S
2018-04-20 21:01:55,13480.0,2,336,0,13480.0,2,13485.0,2,S
2018-04-20 21:02:05,13485.0,6,342,0,13480.0,3,13485.0,1,B
2018-04-20 21:02:05,13485.0,4,346,-4,13480.0,4,13490.0,18,B
2018-04-20 21:02:08,13485.0,2,348,0,13485.0,2,13490.0,1,B
2018-04-20 21:02:08,13490.0,2,350,0,13485.0,1,13490.0,2,B
2018-04-20 21:02:09,13485.0,4,354,-2,13480.0,10,13490.0,2,S
2018-04-20 21:02:10,13485.0,2,356,0,13480.0,5,13490.0,22,S
2018-04-20 21:02:12,13485.0,2,358,2,13480.0,9,13490.0,2,S
2018-04-20 21:02:14,13490.0,2,360,-2,13490.0,1,13495.0,4,B
2018-04-20 21:02:15,13490.0,10,370,8,13485.0,14,13495.0,3,B
2018-04-20 21:02:16,13495.0,4,374,0,13495.0,2,13500.0,9,B
2018-04-20 21:02:20,13495.0,4,378,-2,13495.0,2,13500.0,10,B
2018-04-20 21:02:22,13495.0,4,382,0,13495.0,1,13500.0,10,B
2018-04-20 21:02:23,13495.0,2,384,-2,13490.0,2,13495.0,12,B
2018-04-20 21:02:25,13490.0,2,386,0,13485.0,9,13495.0,2,S
2018-04-20 21:02:26,13490.0,4,390,0,13490.0,8,13495.0,6,S
2018-04-20 21:02:28,13495.0,24,414,-24,13495.0,13,13500.0,25,B
2018-04-20 21:02:29,13495.0,2,416,-2,13495.0,12,13500.0,25,B
2018-04-20 21:02:29,13500.0,4,420,4,13495.0,14,13500.0,7,B
2018-04-20 21:02:30,13500.0,14,434,4,13495.0,14,13505.0,14,B
2018-04-20 21:02:34,13500.0,4,438,-2,13495.0,15,13500.0,2,B
2018-04-20 21:02:35,13500.0,4,442,0,13495.0,15,13505.0,13,B
2018-04-20 21:02:36,13495.0,4,446,-4,13500.0,8,13505.0,4,S
2018-04-20 21:02:39,13500.0,12,458,2,13495.0,15,13505.0,19,B
2018-04-20 21:02:41,13500.0,2,460,0,13500.0,1,13505.0,11,B
2018-04-20 21:02:41,13500.0,2,462,-2,13495.0,11,13505.0,11,B
2018-04-20 21:02:42,13500.0,2,464,-2,13495.0,4,13500.0,2,B
2018-04-20 21:02:45,13500.0,12,476,-8,13500.0,5,13505.0,17,B
2018-04-20 21:02:45,13500.0,10,486,-6,13495.0,3,13505.0,17,B
2018-04-20 21:02:50,13500.0,4,490,4,13495.0,5,13505.0,20,B
2018-04-20 21:02:54,13500.0,4,494,-2,13500.0,1,13505.0,13,B
2018-04-20 21:02:59,13500.0,2,496,2,13495.0,6,13500.0,1,B
2018-04-20 21:03:03,13500.0,2,498,0,13495.0,5,13500.0,1,B
2018-04-20 21:03:06,13505.0,2,500,0,13500.0,4,13505.0,9,B
2018-04-20 21:03:06,13505.0,4,504,0,13500.0,4,13505.0,7,B
2018-04-20 21:03:08,13505.0,6,510,-4,13500.0,6,13505.0,2,B
2018-04-20 21:03:08,13505.0,4,514,-2,13505.0,3,13510.0,4,B
2018-04-20 21:03:11,13510.0,2,516,2,13500.0,8,13510.0,6,B
2018-04-20 21:03:13,13510.0,2,518,2,13505.0,6,13515.0,1,B
2018-04-20 21:03:14,13505.0,12,530,12,13500.0,21,13510.0,2,S
2018-04-20 21:03:15,13500.0,14,544,-6,13500.0,1,13505.0,35,S
2018-04-20 21:03:15,13500.0,4,548,0,13495.0,7,13505.0,31,S
2018-04-20 21:03:18,13500.0,2,550,0,13500.0,3,13505.0,10,S
2018-04-20 21:03:20,13500.0,8,558,-4,13495.0,19,13505.0,12,S
2018-04-20 21:03:23,13500.0,2,560,-2,13495.0,11,13505.0,20,S
2018-04-20 21:03:35,13505.0,2,562,0,13500.0,3,13510.0,18,B
2018-04-20 21:03:37,13505.0,2,564,0,13500.0,2,13505.0,1,B
2018-04-20 21:03:37,13510.0,4,568,0,13500.0,9,13510.0,16,B
2018-04-20 21:03:41,13505.0,2,570,-2,13505.0,1,13510.0,7,S
2018-04-20 21:03:43,13505.0,8,578,8,13500.0,17,13505.0,8,S
2018-04-20 21:03:43,13505.0,16,594,14,13500.0,17,13510.0,5,S
2018-04-20 21:03:47,13510.0,2,596,2,13505.0,5,13510.0,4,B
2018-04-20 21:03:48,13510.0,6,602,6,13505.0,5,13510.0,1,B
2018-04-20 21:03:57,13505.0,10,612,-6,13505.0,3,13510.0,1,S
2018-04-20 21:03:58,13505.0,6,618,6,13500.0,16,13505.0,7,S
2018-04-20 21:03:59,13500.0,22,640,18,13500.0,6,13505.0,6,S
2018-04-20 21:03:59,13500.0,16,656,6,13495.0,5,13500.0,22,S
2018-04-20 21:04:00,13500.0,44,700,44,13500.0,4,13505.0,6,S
2018-04-20 21:04:03,13505.0,16,716,4,13500.0,5,13510.0,1,B
2018-04-20 21:04:04,13515.0,4,720,2,13505.0,1,13515.0,12,B
2018-04-20 21:04:06,13515.0,10,730,-6,13510.0,1,13515.0,11,B
2018-04-20 21:04:07,13510.0,2,732,-2,13505.0,2,13515.0,14,S
2018-04-20 21:04:09,13505.0,2,734,0,13500.0,3,13505.0,4,S
2018-04-20 21:04:11,13505.0,2,736,0,13500.0,1,13505.0,2,S
2018-04-20 21:04:13,13500.0,4,740,-2,13495.0,10,13500.0,9,S
2018-04-20 21:04:15,13495.0,8,748,8,13490.0,6,13495.0,6,S
2018-04-20 21:04:17,13495.0,2,750,2,13490.0,11,13495.0,5,S
2018-04-20 21:04:17,13495.0,10,760,8,13490.0,10,13500.0,20,S
2018-04-20 21:04:19,13495.0,24,784,14,13495.0,2,13500.0,11,S
2018-04-20 21:04:20,13495.0,6,790,4,13490.0,8,13495.0,7,S
2018-04-20 21:04:21,13495.0,14,804,14,13495.0,2,13500.0,12,S
2018-04-20 21:04:22,13495.0,16,820,16,13490.0,7,13495.0,2,S
2018-04-20 21:04:25,13495.0,4,824,4,13490.0,7,13500.0,12,S
2018-04-20 21:04:26,13490.0,20,844,8,13485.0,6,13500.0,11,S
2018-04-20 21:04:27,13500.0,8,852,8,13495.0,2,13500.0,6,B
2018-04-20 21:04:28,13495.0,16,868,8,13490.0,4,13495.0,8,S
2018-04-20 21:04:28,13505.0,26,894,14,13500.0,5,13505.0,5,B
2018-04-20 21:04:29,13505.0,2,896,-2,13505.0,1,13510.0,9,B
2018-04-20 21:04:31,13505.0,2,898,0,13500.0,12,13505.0,9,B
2018-04-20 21:04:31,13500.0,20,918,0,13500.0,2,13505.0,9,S
2018-04-20 21:04:36,13505.0,2,920,2,13500.0,4,13505.0,8,B
2018-04-20 21:04:37,13500.0,8,928,6,13495.0,3,13500.0,6,S
2018-04-20 21:04:37,13500.0,10,938,10,13495.0,9,13500.0,1,S
2018-04-20 21:04:40,13500.0,14,952,-4,13490.0,8,13500.0,3,S
2018-04-20 21:04:40,13505.0,10,962,-2,13490.0,15,13505.0,8,B
2018-04-20 21:04:41,13500.0,2,964,0,13490.0,20,13500.0,1,S
2018-04-20 21:04:45,13500.0,2,966,0,13495.0,1,13505.0,9,S
2018-04-20 21:04:50,13500.0,2,968,0,13495.0,5,13505.0,17,S
2018-04-20 21:04:56,13505.0,4,972,0,13500.0,2,13505.0,7,B
2018-04-20 21:05:00,13500.0,8,980,-2,13495.0,12,13505.0,16,S
2018-04-20 21:05:03,13500.0,2,982,2,13495.0,9,13505.0,18,S
2018-04-20 21:05:04,13495.0,10,992,4,13495.0,3,13505.0,13,S
2018-04-20 21:05:09,13500.0,4,996,-4,13495.0,7,13500.0,5,B
2018-04-20 21:05:09,13495.0,10,1006,2,13490.0,9,13500.0,21,S
2018-04-20 21:05:24,13495.0,2,1008,0,13490.0,11,13495.0,7,S
2018-04-20 21:05:32,13495.0,2,1010,0,13490.0,20,13495.0,13,S
2018-04-20 21:05:40,13495.0,2,1012,0,13490.0,22,13495.0,3,S
2018-04-20 21:05:41,13495.0,8,1020,4,13495.0,6,13500.0,19,S
2018-04-20 21:05:52,13495.0,12,1032,10,13490.0,23,13500.0,20,S
2018-04-20 21:06:02,13500.0,2,1034,2,13490.0,23,13500.0,67,B
2018-04-20 21:06:03,13495.0,2,1036,2,13490.0,23,13495.0,3,S
2018-04-20 21:06:05,13495.0,2,1038,2,13490.0,23,13500.0,69,S
2018-04-20 21:06:07,13500.0,2,1040,2,13495.0,1,13500.0,68,B
2018-04-20 21:06:08,13495.0,2,1042,2,13490.0,23,13500.0,69,S
2018-04-20 21:06:10,13500.0,4,1046,-2,13490.0,23,13500.0,67,B
2018-04-20 21:06:17,13495.0,2,1048,0,13490.0,26,13500.0,72,S
2018-04-20 21:06:18,13500.0,2,1050,2,13490.0,27,13500.0,69,B
2018-04-20 21:06:23,13490.0,22,1072,-10,13490.0,11,13495.0,11,S
2018-04-20 21:06:24,13490.0,22,1094,4,13485.0,5,13495.0,18,S
2018-04-20 21:06:25,13485.0,12,1106,4,13480.0,4,13485.0,1,S
2018-04-20 21:06:27,13485.0,2,1108,2,13480.0,8,13485.0,1,S
2018-04-20 21:06:28,13485.0,2,1110,0,13480.0,10,13490.0,17,S
2018-04-20 21:06:31,13485.0,4,1114,0,13485.0,3,13490.0,4,S
2018-04-20 21:06:31,13485.0,2,1116,0,13485.0,2,13490.0,4,S
2018-04-20 21:06:32,13490.0,2,1118,0,13485.0,2,13490.0,3,B
2018-04-20 21:06:34,13490.0,6,1124,4,13490.0,3,13495.0,5,B
2018-04-20 21:06:51,13495.0,2,1126,2,13490.0,5,13495.0,5,B
2018-04-20 21:06:55,13495.0,2,1128,2,13490.0,1,13495.0,8,B
2018-04-20 21:07:00,13495.0,8,1136,8,13495.0,6,13500.0,66,B
2018-04-20 21:07:06,13495.0,6,1142,0,13495.0,4,13500.0,76,B
2018-04-20 21:07:14,13500.0,6,1148,6,13495.0,1,13500.0,73,B
2018-04-20 21:07:36,13500.0,10,1158,10,13495.0,7,13500.0,67,B
2018-04-20 21:07:39,13495.0,2,1160,0,13495.0,6,13500.0,67,S
2018-04-20 21:07:50,13500.0,40,1200,-2,13495.0,10,13500.0,54,B
2018-04-20 21:07:53,13495.0,2,1202,0,13495.0,9,13500.0,54,S
2018-04-20 21:07:56,13495.0,16,1218,8,13495.0,1,13500.0,62,S
2018-04-20 21:07:57,13495.0,2,1220,0,13490.0,8,13500.0,62,S
2018-04-20 21:07:59,13495.0,2,1222,-2,13495.0,1,13500.0,64,S
2018-04-20 21:08:00,13495.0,4,1226,0,13490.0,18,13500.0,45,S
2018-04-20 21:08:08,13490.0,2,1228,0,13490.0,9,13495.0,2,S
2018-04-20 21:08:13,13500.0,20,1248,18,13490.0,4,13495.0,1,B
2018-04-20 21:08:25,13495.0,2,1250,2,13490.0,2,13495.0,6,S
2018-04-20 21:08:26,13495.0,2,1252,2,13495.0,1,13500.0,55,S
2018-04-20 21:08:27,13495.0,2,1254,0,13490.0,12,13500.0,36,S
2018-04-20 21:08:47,13495.0,4,1258,0,13490.0,3,13500.0,57,S
2018-04-20 21:09:00,13500.0,4,1262,0,13495.0,21,13500.0,38,B
2018-04-20 21:09:00,13500.0,2,1264,2,13495.0,21,13500.0,37,B
2018-04-20 21:09:04,13500.0,30,1294,16,13495.0,17,13500.0,23,B
2018-04-20 21:09:05,13500.0,46,1340,16,13500.0,5,13505.0,19,B
2018-04-20 21:09:09,13500.0,2,1342,0,13500.0,1,13505.0,16,B
2018-04-20 21:09:17,13505.0,2,1344,-2,13500.0,5,13505.0,15,B
2018-04-20 21:09:26,13500.0,6,1350,2,13495.0,13,13500.0,2,S
2018-04-20 21:09:30,13500.0,2,1352,-2,13495.0,9,13500.0,1,S
2018-04-20 21:09:33,13500.0,4,1356,-2,13495.0,7,13500.0,3,S
2018-04-20 21:09:45,13500.0,2,1358,0,13495.0,9,13500.0,1,S
2018-04-20 21:09:45,13500.0,2,1360,0,13495.0,9,13505.0,34,S
2018-04-20 21:10:01,13495.0,2,1362,0,13495.0,7,13500.0,4,S
2018-04-20 21:10:07,13495.0,4,1366,0,13490.0,8,13495.0,1,S
2018-04-20 21:10:14,13500.0,2,1368,0,13490.0,9,13500.0,23,B
2018-04-20 21:10:19,13500.0,2,1370,0,13490.0,9,13495.0,6,B
2018-04-20 21:10:19,13490.0,18,1388,6,13485.0,5,13495.0,6,S
2018-04-20 21:10:23,13490.0,2,1390,0,13485.0,4,13490.0,4,S
2018-04-20 21:10:27,13490.0,2,1392,-2,13485.0,5,13495.0,27,S
2018-04-20 21:10:47,13485.0,8,1400,2,13480.0,11,13485.0,1,S
2018-04-20 21:11:00,13480.0,2,1402,2,13485.0,1,13490.0,23,S
2018-04-20 21:11:01,13480.0,4,1406,0,13480.0,10,13490.0,23,S
2018-04-20 21:11:08,13485.0,2,1408,-2,13480.0,10,13490.0,14,B
2018-04-20 21:11:11,13485.0,2,1410,-2,13480.0,10,13485.0,1,B
2018-04-20 21:11:18,13480.0,2,1412,2,13480.0,7,13485.0,7,S
2018-04-20 21:11:23,13480.0,14,1426,-2,13475.0,1,13480.0,1,S
2018-04-20 21:11:25,13475.0,2,1428,0,13470.0,2,13480.0,45,S
2018-04-20 21:11:34,13470.0,2,1430,-2,13470.0,3,13475.0,1,S
2018-04-20 21:11:35,13475.0,2,1432,-2,13470.0,6,13480.0,45,B
2018-04-20 21:11:36,13475.0,2,1434,-2,13470.0,7,13480.0,44,B
2018-04-20 21:11:46,13475.0,2,1436,0,13475.0,5,13480.0,40,B
2018-04-20 21:12:02,13475.0,4,1440,-4,13475.0,5,13480.0,38,B
2018-04-20 21:12:15,13475.0,2,1442,-2,13475.0,3,13480.0,44,B
2018-04-20 21:12:38,13475.0,4,1446,0,13475.0,2,13480.0,44,B
2018-04-20 21:12:46,13480.0,2,1448,2,13475.0,3,13480.0,39,B
2018-04-20 21:12:50,13480.0,18,1466,-10,13475.0,14,13480.0,26,B
2018-04-20 21:12:51,13480.0,42,1508,-6,13475.0,15,13480.0,5,B
2018-04-20 21:12:51,13480.0,10,1518,0,13480.0,7,13485.0,15,B
2018-04-20 21:13:04,13485.0,4,1522,2,13485.0,1,13490.0,13,B
2018-04-20 21:13:13,13485.0,12,1534,-10,13480.0,10,13485.0,2,B
2018-04-20 21:13:14,13485.0,4,1538,0,13480.0,13,13485.0,2,B
2018-04-20 21:13:14,13485.0,4,1542,-4,13480.0,20,13485.0,1,B
2018-04-20 21:13:15,13485.0,2,1544,0,13480.0,20,13485.0,1,B
2018-04-20 21:13:15,13485.0,4,1548,-2,13480.0,20,13490.0,11,B
2018-04-20 21:13:16,13485.0,2,1550,-2,13480.0,20,13490.0,11,B
2018-04-20 21:13:18,13490.0,2,1552,2,13485.0,5,13490.0,11,B
2018-04-20 21:13:19,13485.0,2,1554,0,13485.0,4,13490.0,11,S
2018-04-20 21:13:22,13490.0,10,1564,-2,13485.0,4,13490.0,6,B
2018-04-20 21:13:24,13490.0,2,1566,0,13485.0,4,13490.0,10,B
2018-04-20 21:13:47,13485.0,14,1580,6,13480.0,12,13485.0,1,S
2018-04-20 21:13:47,13485.0,2,1582,0,13480.0,12,13490.0,5,S
2018-04-20 21:13:56,13490.0,6,1588,2,13485.0,12,13490.0,1,B
2018-04-20 21:13:57,13490.0,2,1590,-2,13490.0,6,13495.0,6,B
2018-04-20 21:14:01,13490.0,4,1594,0,13490.0,1,13495.0,4,B
2018-04-20 21:14:03,13495.0,4,1598,2,13485.0,11,13495.0,5,B
2018-04-20 21:14:09,13495.0,2,1600,2,13485.0,22,13495.0,7,B
2018-04-20 21:14:16,13495.0,20,1620,-18,13485.0,21,13495.0,2,B
2018-04-20 21:14:21,13495.0,2,1622,0,13485.0,14,13495.0,30,B
2018-04-20 21:14:21,13495.0,2,1624,0,13485.0,10,13495.0,29,B
2018-04-20 21:14:23,13490.0,2,1626,0,13485.0,8,13495.0,29,S
2018-04-20 21:14:35,13490.0,6,1632,-6,13490.0,2,13495.0,18,S
2018-04-20 21:14:38,13490.0,2,1634,-2,13485.0,15,13490.0,2,S
2018-04-20 21:14:58,13485.0,2,1636,2,13485.0,10,13490.0,5,S
2018-04-20 21:15:04,13485.0,4,1640,0,13485.0,8,13490.0,5,S
2018-04-20 21:15:05,13490.0,2,1642,0,13485.0,8,13490.0,4,B
2018-04-20 21:15:08,13490.0,8,1650,-8,13490.0,6,13495.0,19,B
2018-04-20 21:15:09,13490.0,12,1662,-12,13485.0,8,13495.0,21,B
2018-04-20 21:15:37,13485.0,16,1678,-6,13480.0,10,13485.0,7,S
2018-04-20 21:15:38,13485.0,4,1682,-4,13480.0,16,13485.0,5,S
2018-04-20 21:15:44,13485.0,2,1684,-2,13480.0,14,13485.0,6,S
2018-04-20 21:16:03,13480.0,38,1722,8,13475.0,10,13485.0,7,S
2018-04-20 21:16:03,13475.0,12,1734,-6,13475.0,5,13480.0,2,S
2018-04-20 21:16:04,13475.0,2,1736,0,13475.0,2,13480.0,8,S
2018-04-20 21:16:04,13475.0,4,1740,0,13475.0,1,13480.0,10,S
2018-04-20 21:16:05,13475.0,4,1744,-2,13470.0,8,13480.0,10,S
2018-04-20 21:16:06,13475.0,2,1746,0,13475.0,1,13480.0,10,S
2018-04-20 21:16:06,13475.0,2,1748,2,13470.0,11,13480.0,10,S
2018-04-20 21:16:11,13475.0,8,1756,-4,13475.0,4,13480.0,3,S
2018-04-20 21:16:14,13475.0,2,1758,2,13475.0,5,13480.0,3,S
2018-04-20 21:16:16,13480.0,2,1760,-2,13475.0,4,13480.0,2,B
2018-04-20 21:16:19,13475.0,2,1762,0,13475.0,4,13480.0,3,S
2018-04-20 21:16:32,13475.0,12,1774,0,13475.0,15,13480.0,3,S
2018-04-20 21:16:34,13480.0,2,1776,0,13475.0,15,13480.0,2,B
2018-04-20 21:16:46,13480.0,2,1778,2,13475.0,15,13480.0,1,B
2018-04-20 21:17:02,13480.0,2,1780,-2,13475.0,19,13485.0,20,B
2018-04-20 21:17:19,13485.0,10,1790,-4,13480.0,33,13490.0,4,B
2018-04-20 21:17:20,13490.0,6,1796,4,13490.0,1,13495.0,11,B
2018-04-20 21:17:20,13485.0,6,1802,0,13485.0,2,13490.0,15,S
2018-04-20 21:17:21,13485.0,2,1804,0,13480.0,8,13490.0,19,S
2018-04-20 21:17:36,13480.0,4,1808,4,13480.0,4,13485.0,18,S
2018-04-20 21:17:36,13480.0,8,1816,2,13475.0,5,13485.0,18,S
2018-04-20 21:17:50,13480.0,2,1818,0,13480.0,29,13485.0,22,S
2018-04-20 21:17:50,13480.0,28,1846,16,13480.0,15,13485.0,25,S
2018-04-20 21:17:59,13485.0,2,1848,0,13480.0,18,13485.0,5,B
2018-04-20 21:18:02,13485.0,6,1854,6,13480.0,33,13490.0,10,B
2018-04-20 21:18:08,13490.0,18,1872,2,13480.0,36,13490.0,1,B
2018-04-20 21:18:18,13490.0,2,1874,-2,13485.0,5,13490.0,1,B
2018-04-20 21:18:19,13490.0,2,1876,0,13485.0,8,13490.0,1,B
2018-04-20 21:18:19,13490.0,2,1878,0,13485.0,32,13495.0,13,B
2018-04-20 21:18:22,13495.0,8,1886,6,13495.0,4,13500.0,11,B
2018-04-20 21:18:25,13495.0,2,1888,0,13495.0,6,13500.0,11,B
2018-04-20 21:18:30,13500.0,2,1890,2,13495.0,15,13500.0,7,B
2018-04-20 21:18:32,13500.0,2,1892,2,13495.0,18,13500.0,6,B
2018-04-20 21:18:32,13500.0,12,1904,8,13500.0,1,13505.0,30,B
2018-04-20 21:18:33,13500.0,2,1906,0,13495.0,15,13500.0,2,B
2018-04-20 21:18:33,13500.0,4,1910,-4,13495.0,15,13500.0,2,B
2018-04-20 21:18:34,13505.0,30,1940,6,13495.0,15,13500.0,1,B
2018-04-20 21:18:34,13500.0,2,1942,0,13495.0,15,13505.0,20,S
2018-04-20 21:18:39,13505.0,4,1946,0,13495.0,17,13505.0,8,B
2018-04-20 21:18:51,13505.0,8,1954,0,13495.0,10,13505.0,8,B
2018-04-20 21:18:52,13505.0,8,1962,6,13495.0,6,13505.0,4,B
2018-04-20 21:18:55,13505.0,8,1970,0,13495.0,9,13505.0,2,B
2018-04-20 21:18:57,13505.0,2,1972,2,13495.0,2,13500.0,2,B
2018-04-20 21:19:02,13495.0,2,1974,0,13495.0,3,13500.0,5,S
2018-04-20 21:19:06,13500.0,2,1976,-2,13495.0,9,13500.0,2,B
2018-04-20 21:19:07,13500.0,4,1980,-4,13495.0,9,13505.0,11,B
2018-04-20 21:19:16,13505.0,2,1982,-2,13500.0,3,13505.0,4,B
2018-04-20 21:19:16,13505.0,8,1990,-8,13500.0,16,13510.0,6,B
2018-04-20 21:19:18,13510.0,8,1998,8,13505.0,10,13515.0,10,B
2018-04-20 21:19:19,13515.0,2,2000,0,13505.0,13,13515.0,9,B
2018-04-20 21:19:40,13510.0,2,2002,0,13510.0,1,13515.0,31,S
2018-04-20 21:19:42,13510.0,4,2006,-2,13510.0,4,13515.0,29,S
2018-04-20 21:19:43,13510.0,6,2012,0,13505.0,5,13515.0,29,S
2018-04-20 21:19:48,13515.0,2,2014,0,13510.0,2,13515.0,31,B
2018-04-20 21:19:52,13515.0,2,2016,0,13510.0,16,13515.0,28,B
2018-04-20 21:19:55,13515.0,2,2018,0,13510.0,14,13515.0,24,B
2018-04-20 21:19:57,13510.0,4,2022,-4,13505.0,5,13515.0,29,S
2018-04-20 21:19:58,13510.0,2,2024,0,13505.0,12,13515.0,31,S
2018-04-20 21:20:00,13510.0,2,2026,0,13505.0,2,13510.0,2,S
2018-04-20 21:20:01,13505.0,2,2028,2,13500.0,5,13510.0,10,S
2018-04-20 21:20:05,13500.0,2,2030,0,13500.0,15,13510.0,9,S
2018-04-20 21:20:06,13510.0,6,2036,-6,13510.0,8,13515.0,30,B
2018-04-20 21:20:10,13510.0,2,2038,-2,13510.0,7,13515.0,29,B
2018-04-20 21:20:12,13510.0,2,2040,-2,13510.0,6,13515.0,29,B
2018-04-20 21:20:14,13510.0,12,2052,-12,13505.0,17,13510.0,5,B
2018-04-20 21:20:19,13510.0,12,2064,-10,13510.0,4,13515.0,31,B
2018-04-20 21:20:19,13510.0,2,2066,-2,13510.0,3,13515.0,31,B
2018-04-20 21:20:20,13510.0,2,2068,0,13510.0,2,13515.0,31,B
2018-04-20 21:20:43,13515.0,18,2086,14,13510.0,18,13515.0,22,B
2018-04-20 21:20:43,13515.0,2,2088,0,13510.0,18,13515.0,21,B
2018-04-20 21:20:46,13510.0,2,2090,-2,13510.0,18,13515.0,19,S
2018-04-20 21:21:05,13515.0,26,2116,-8,13510.0,14,13515.0,3,B
2018-04-20 21:21:05,13515.0,6,2122,4,13515.0,3,13520.0,14,B
2018-04-20 21:21:08,13520.0,2,2124,0,13515.0,10,13520.0,11,B
2018-04-20 21:21:14,13515.0,2,2126,0,13515.0,4,13520.0,18,S
2018-04-20 21:21:16,13515.0,6,2132,-6,13515.0,3,13520.0,12,S
2018-04-20 21:21:18,13515.0,6,2138,6,13510.0,10,13515.0,5,S
2018-04-20 21:21:21,13515.0,6,2144,-6,13510.0,16,13520.0,24,S
2018-04-20 21:21:22,13515.0,2,2146,0,13510.0,15,13520.0,24,S
2018-04-20 21:21:26,13515.0,4,2150,-4,13510.0,14,13520.0,33,S
2018-04-20 21:21:28,13520.0,2,2152,0,13510.0,13,13520.0,32,B
2018-04-20 21:21:32,13520.0,4,2156,4,13510.0,14,13520.0,30,B
2018-04-20 21:21:36,13515.0,2,2158,-2,13510.0,13,13515.0,1,S
2018-04-20 21:21:36,13515.0,2,2160,0,13510.0,13,13520.0,30,S
2018-04-20 21:21:43,13515.0,2,2162,0,13515.0,1,13520.0,19,S
2018-04-20 21:21:47,13520.0,20,2182,18,13515.0,5,13520.0,7,B
2018-04-20 21:21:52,13520.0,2,2184,0,13515.0,5,13520.0,6,B
2018-04-20 21:21:56,13520.0,2,2186,0,13515.0,5,13520.0,6,B
2018-04-20 21:22:04,13515.0,8,2194,2,13510.0,12,13515.0,1,S
2018-04-20 21:22:06,13520.0,4,2198,4,13515.0,10,13520.0,2,B
2018-04-20 21:22:10,13520.0,2,2200,0,13515.0,10,13520.0,1,B
2018-04-20 21:22:28,13515.0,2,2202,2,13515.0,7,13520.0,8,S
2018-04-20 21:22:29,13515.0,14,2216,10,13510.0,12,13515.0,6,S
2018-04-20 21:22:34,13515.0,2,2218,-2,13510.0,13,13515.0,1,S
2018-04-20 21:22:44,13515.0,8,2226,0,13510.0,11,13515.0,1,S
2018-04-20 21:22:45,13520.0,6,2232,2,13510.0,12,13520.0,34,B
2018-04-20 21:22:59,13510.0,4,2236,2,13510.0,5,13515.0,4,S
2018-04-20 21:23:09,13520.0,20,2256,6,13510.0,5,13520.0,34,B
2018-04-20 21:23:14,13510.0,2,2258,2,13510.0,6,13515.0,2,S
2018-04-20 21:23:22,13515.0,2,2260,0,13510.0,5,13520.0,39,B
2018-04-20 21:23:34,13515.0,2,2262,0,13515.0,4,13520.0,35,B
2018-04-20 21:23:34,13520.0,18,2280,10,13520.0,11,13525.0,21,B
2018-04-20 21:23:36,13520.0,22,2302,10,13515.0,9,13525.0,20,B
2018-04-20 21:23:52,13520.0,2,2304,2,13515.0,9,13525.0,22,B
2018-04-20 21:24:03,13525.0,12,2316,4,13520.0,12,13530.0,6,B
2018-04-20 21:24:09,13530.0,2,2318,0,13525.0,8,13530.0,3,B
2018-04-20 21:24:11,13530.0,2,2320,-2,13525.0,8,13530.0,2,B
2018-04-20 21:24:12,13530.0,2,2322,0,13525.0,7,13530.0,2,B
2018-04-20 21:24:15,13530.0,2,2324,0,13525.0,5,13530.0,4,B
2018-04-20 21:24:19,13525.0,2,2326,2,13525.0,9,13535.0,16,S
2018-04-20 21:24:20,13530.0,34,2360,24,13530.0,4,13535.0,20,B
2018-04-20 21:24:21,13530.0,8,2368,6,13525.0,15,13535.0,18,B
2018-04-20 21:24:22,13530.0,2,2370,0,13525.0,14,13535.0,18,B
2018-04-20 21:24:34,13535.0,2,2372,2,13530.0,7,13535.0,7,B
2018-04-20 21:24:34,13530.0,22,2394,-8,13530.0,3,13540.0,5,S
2018-04-20 21:24:35,13535.0,2,2396,-2,13535.0,4,13540.0,15,B
2018-04-20 21:24:36,13540.0,12,2408,0,13535.0,15,13545.0,3,B
2018-04-20 21:24:37,13535.0,64,2472,-6,13535.0,15,13550.0,16,S
2018-04-20 21:24:40,13550.0,8,2480,0,13550.0,7,13555.0,28,B
2018-04-20 21:24:40,13550.0,14,2494,-6,13545.0,5,13550.0,3,B
2018-04-20 21:24:44,13550.0,2,2496,-2,13545.0,6,13550.0,5,B
2018-04-20 21:24:46,13550.0,2,2498,-2,13545.0,6,13550.0,5,B
2018-04-20 21:24:46,13545.0,12,2510,4,13540.0,4,13545.0,3,S
2018-04-20 21:24:48,13540.0,2,2512,0,13535.0,21,13545.0,8,S
2018-04-20 21:24:54,13540.0,2,2514,2,13535.0,8,13540.0,9,S
2018-04-20 21:24:59,13540.0,10,2524,8,13535.0,8,13540.0,6,S
2018-04-20 21:25:02,13540.0,2,2526,0,13535.0,8,13540.0,5,S
2018-04-20 21:25:06,13540.0,12,2538,-12,13535.0,9,13545.0,27,S
2018-04-20 21:25:11,13535.0,2,2540,2,13535.0,5,13545.0,35,S
2018-04-20 21:25:12,13535.0,4,2544,-2,13535.0,4,13545.0,36,S
2018-04-20 21:25:13,13535.0,2,2546,0,13535.0,4,13545.0,36,S
2018-04-20 21:25:13,13535.0,2,2548,0,13535.0,3,13545.0,36,S
2018-04-20 21:25:23,13535.0,2,2550,2,13530.0,5,13540.0,14,S
2018-04-20 21:25:23,13530.0,2,2552,0,13530.0,14,13540.0,19,S
2018-04-20 21:25:43,13525.0,2,2554,-2,13525.0,18,13535.0,11,S
2018-04-20 21:25:45,13525.0,12,2566,-8,13525.0,14,13535.0,11,S
2018-04-20 21:25:47,13535.0,6,2572,-4,13525.0,14,13535.0,7,B
2018-04-20 21:26:00,13530.0,2,2574,0,13525.0,3,13530.0,2,S
2018-04-20 21:26:08,13530.0,2,2576,0,13525.0,3,13530.0,5,S
2018-04-20 21:26:09,13525.0,6,2582,2,13520.0,2,13525.0,1,S
2018-04-20 21:26:10,13525.0,2,2584,2,13520.0,16,13530.0,6,S
2018-04-20 21:26:14,13520.0,8,2592,0,13520.0,13,13530.0,12,S
2018-04-20 21:26:17,13520.0,8,2600,4,13520.0,9,13530.0,12,S
2018-04-20 21:26:30,13520.0,2,2602,-2,13515.0,3,13525.0,11,S
2018-04-20 21:26:48,13520.0,2,2604,-2,13520.0,2,13525.0,18,S
2018-04-20 21:26:48,13525.0,12,2616,10,13520.0,13,13525.0,3,B
2018-04-20 21:26:49,13525.0,2,2618,-2,13520.0,14,13525.0,2,B
2018-04-20 21:26:50,13520.0,2,2620,-2,13520.0,13,13525.0,2,S
2018-04-20 21:26:55,13525.0,4,2624,-2,13525.0,1,13530.0,14,B
2018-04-20 21:26:57,13525.0,2,2626,0,13520.0,15,13530.0,21,B
2018-04-20 21:27:11,13520.0,2,2628,0,13520.0,12,13525.0,1,S
2018-04-20 21:27:17,13520.0,16,2644,6,13520.0,3,13525.0,4,S
2018-04-20 21:27:18,13520.0,6,2650,0,13515.0,11,13525.0,13,S
2018-04-20 21:27:21,13520.0,2,2652,0,13515.0,13,13525.0,5,S
2018-04-20 21:27:45,13520.0,4,2656,0,13515.0,12,13525.0,21,S
2018-04-20 21:27:52,13520.0,2,2658,0,13515.0,12,13525.0,21,S
2018-04-20 21:27:59,13520.0,4,2662,0,13515.0,12,13525.0,22,S
2018-04-20 21:28:03,13515.0,2,2664,2,13515.0,11,13525.0,22,S
2018-04-20 21:28:05,13515.0,2,2666,0,13515.0,10,13525.0,27,S
2018-04-20 21:28:14,13515.0,6,2672,-2,13515.0,9,13525.0,38,S
2018-04-20 21:28:33,13520.0,2,2674,-2,13515.0,13,13520.0,3,B
2018-04-20 21:28:34,13520.0,2,2676,2,13515.0,13,13525.0,38,B
2018-04-20 21:28:49,13515.0,14,2690,-8,13515.0,4,13520.0,1,S
2018-04-20 21:28:56,13520.0,2,2692,0,13515.0,7,13520.0,1,B
2018-04-20 21:29:01,13515.0,4,2696,2,13515.0,1,13520.0,29,S
2018-04-20 21:29:02,13515.0,2,2698,2,13510.0,22,13520.0,18,S
2018-04-20 21:29:11,13520.0,10,2708,4,13510.0,25,13520.0,17,B
2018-04-20 21:29:23,13510.0,6,2714,6,13510.0,19,13515.0,15,S
2018-04-20 21:29:23,13510.0,12,2726,-2,13510.0,13,13515.0,15,S
2018-04-20 21:29:28,13515.0,12,2738,0,13510.0,8,13515.0,14,B
2018-04-20 21:29:39,13510.0,2,2740,0,13510.0,7,13515.0,16,S
2018-04-20 21:29:40,13510.0,14,2754,-2,13505.0,5,13515.0,16,S
2018-04-20 21:29:53,13505.0,16,2770,6,13500.0,4,13510.0,16,S
2018-04-20 21:30:00,13505.0,2,2772,0,13500.0,13,13505.0,1,S
2018-04-20 21:30:01,13500.0,2,2774,0,13500.0,12,13505.0,1,S
2018-04-20 21:30:05,13505.0,2,2776,0,13500.0,12,13505.0,1,B
2018-04-20 21:30:06,13505.0,2,2778,-2,13500.0,12,13510.0,20,B
2018-04-20 21:30:07,13510.0,4,2782,0,13505.0,7,13510.0,4,B
2018-04-20 21:30:08,13510.0,4,2786,-2,13505.0,16,13515.0,6,B
2018-04-20 21:30:19,13510.0,6,2792,0,13510.0,7,13515.0,17,B
2018-04-20 21:30:20,13510.0,2,2794,-2,13510.0,6,13515.0,17,B
2018-04-20 21:30:21,13510.0,4,2798,-2,13510.0,4,13515.0,17,B
2018-04-20 21:30:28,13515.0,4,2802,4,13510.0,10,13520.0,6,B
2018-04-20 21:30:43,13515.0,6,2808,-2,13510.0,9,13520.0,15,B
2018-04-20 21:30:50,13515.0,2,2810,0,13515.0,4,13520.0,16,B
2018-04-20 21:30:56,13520.0,4,2814,2,13515.0,5,13520.0,14,B
2018-04-20 21:30:58,13520.0,2,2816,0,13515.0,5,13520.0,14,B
2018-04-20 21:30:59,13520.0,4,2820,2,13515.0,10,13520.0,12,B
2018-04-20 21:31:05,13490.0,234,3054,172,13485.0,3,13490.0,83,S
2018-04-20 21:31:06,13515.0,180,3234,158,13515.0,75,13520.0,21,B
2018-04-20 21:31:06,13515.0,150,3384,94,13510.0,1,13515.0,19,B
2018-04-20 21:31:07,13505.0,6,3390,-4,13500.0,3,13505.0,2,S
2018-04-20 21:31:07,13505.0,16,3406,-4,13505.0,7,13510.0,1,S
2018-04-20 21:31:18,13515.0,4,3410,-4,13510.0,10,13515.0,1,B
2018-04-20 21:31:19,13515.0,2,3412,-2,13510.0,10,13520.0,11,B
2018-04-20 21:31:39,13520.0,2,3414,0,13510.0,10,13520.0,21,B
2018-04-20 21:31:58,13520.0,2,3416,0,13515.0,9,13520.0,9,B
2018-04-20 21:32:20,13515.0,10,3426,-4,13510.0,16,13520.0,17,S
2018-04-20 21:32:21,13515.0,6,3432,-2,13510.0,16,13520.0,17,S
2018-04-20 21:32:21,13510.0,20,3452,18,13510.0,6,13520.0,22,S
2018-04-20 21:32:31,13515.0,2,3454,0,13510.0,6,13515.0,4,B
2018-04-20 21:33:13,13515.0,2,3456,0,13510.0,7,13515.0,3,B
2018-04-20 21:33:19,13515.0,6,3462,-6,13510.0,6,13515.0,2,B
2018-04-20 21:33:47,13515.0,2,3464,0,13510.0,5,13515.0,1,B
2018-04-20 21:34:01,13515.0,4,3468,0,13515.0,1,13520.0,20,B
2018-04-20 21:34:02,13515.0,2,3470,0,13510.0,10,13520.0,26,B
2018-04-20 21:34:11,13510.0,4,3474,4,13510.0,7,13515.0,6,S
2018-04-20 21:34:11,13515.0,2,3476,0,13510.0,7,13515.0,32,B
2018-04-20 21:34:18,13515.0,2,3478,0,13505.0,13,13515.0,18,B
2018-04-20 21:34:35,13510.0,2,3480,-2,13510.0,3,13515.0,5,S
2018-04-20 21:34:35,13510.0,4,3484,-4,13510.0,1,13515.0,25,S
2018-04-20 21:34:36,13510.0,2,3486,-2,13505.0,8,13515.0,25,S
2018-04-20 21:34:41,13510.0,2,3488,0,13510.0,6,13515.0,11,S
2018-04-20 21:35:10,13510.0,2,3490,0,13510.0,7,13515.0,5,S
2018-04-20 21:35:30,13515.0,2,3492,0,13510.0,7,13515.0,2,B
2018-04-20 21:36:17,13515.0,2,3494,0,13515.0,4,13520.0,10,B
2018-04-20 21:36:35,13515.0,2,3496,0,13510.0,5,13520.0,49,B
2018-04-20 21:36:51,13515.0,2,3498,2,13515.0,7,13520.0,11,B
2018-04-20 21:36:58,13515.0,2,3500,-2,13515.0,4,13520.0,11,B
2018-04-20 21:36:58,13515.0,8,3508,0,13510.0,5,13520.0,27,B
2018-04-20 21:37:16,13515.0,4,3512,0,13510.0,13,13515.0,1,B
2018-04-20 21:37:17,13515.0,2,3514,-2,13510.0,14,13520.0,14,B
2018-04-20 21:37:57,13520.0,2,3516,-2,13515.0,4,13520.0,6,B
2018-04-20 21:38:00,13520.0,12,3528,-8,13520.0,9,13525.0,9,B
2018-04-20 21:38:24,13520.0,4,3532,2,13520.0,1,13525.0,30,B
2018-04-20 21:38:25,13520.0,2,3534,0,13515.0,7,13520.0,1,B
2018-04-20 21:38:27,13520.0,2,3536,-2,13515.0,7,13520.0,3,B
2018-04-20 21:38:41,13520.0,2,3538,2,13515.0,4,13520.0,2,B
2018-04-20 21:38:45,13520.0,6,3544,0,13520.0,3,13525.0,14,B
2018-04-20 21:38:45,13520.0,2,3546,0,13515.0,14,13525.0,20,B
2018-04-20 21:39:04,13525.0,12,3558,0,13525.0,9,13530.0,7,B
2018-04-20 21:39:13,13530.0,6,3564,2,13525.0,15,13530.0,2,B
2018-04-20 21:39:14,13530.0,4,3568,4,13530.0,3,13535.0,9,B
2018-04-20 21:39:22,13530.0,6,3574,2,13525.0,12,13535.0,53,B
2018-04-20 21:39:34,13530.0,2,3576,0,13525.0,4,13530.0,4,B
2018-04-20 21:39:55,13530.0,4,3580,0,13530.0,6,13535.0,18,B
2018-04-20 21:40:03,13535.0,2,3582,2,13530.0,15,13535.0,7,B
2018-04-20 21:40:06,13535.0,16,3598,8,13535.0,4,13540.0,26,B
2018-04-20 21:40:09,13540.0,6,3604,6,13535.0,10,13540.0,15,B
2018-04-20 21:40:11,13535.0,2,3606,-2,13535.0,9,13540.0,15,S
2018-04-20 21:40:15,13540.0,2,3608,0,13535.0,10,13540.0,14,B
2018-04-20 21:40:17,13540.0,12,3620,6,13535.0,14,13540.0,7,B
2018-04-20 21:40:17,13540.0,14,3634,-2,13540.0,5,13545.0,15,B
2018-04-20 21:40:22,13540.0,10,3644,-2,13540.0,2,13545.0,13,B
2018-04-20 21:40:22,13540.0,2,3646,0,13540.0,2,13545.0,14,B
2018-04-20 21:40:23,13545.0,2,3648,0,13540.0,13,13545.0,12,B
2018-04-20 21:40:24,13545.0,4,3652,2,13540.0,13,13545.0,10,B
2018-04-20 21:40:24,13545.0,20,3672,10,13540.0,13,13550.0,22,B
2018-04-20 21:40:25,13545.0,2,3674,2,13540.0,13,13550.0,23,B
2018-04-20 21:40:28,13540.0,12,3686,12,13535.0,6,13545.0,16,S
2018-04-20 21:40:29,13545.0,18,3704,6,13540.0,1,13545.0,9,B
2018-04-20 21:40:29,13540.0,4,3708,0,13535.0,13,13545.0,9,S
2018-04-20 21:40:31,13540.0,2,3710,0,13540.0,2,13545.0,5,S
2018-04-20 21:40:37,13545.0,4,3714,0,13540.0,4,13545.0,2,B
2018-04-20 21:40:38,13540.0,2,3716,-2,13540.0,1,13545.0,2,S
2018-04-20 21:40:47,13540.0,2,3718,0,13535.0,10,13545.0,9,S
2018-04-20 21:40:47,13535.0,6,3724,2,13530.0,3,13535.0,2,S
2018-04-20 21:40:48,13535.0,4,3728,0,13530.0,10,13540.0,2,S
2018-04-20 21:40:51,13535.0,10,3738,2,13535.0,7,13545.0,16,S
2018-04-20 21:40:56,13535.0,8,3746,4,13535.0,3,13545.0,16,S
2018-04-20 21:41:00,13535.0,2,3748,2,13535.0,2,13545.0,16,S
2018-04-20 21:41:07,13535.0,2,3750,0,13535.0,2,13545.0,26,S
2018-04-20 21:41:12,13545.0,2,3752,0,13540.0,9,13545.0,9,B
2018-04-20 21:41:19,13545.0,2,3754,-2,13540.0,8,13545.0,9,B
2018-04-20 21:41:24,13545.0,2,3756,0,13540.0,6,13545.0,8,B
2018-04-20 21:41:33,13540.0,2,3758,0,13535.0,4,13545.0,25,S
2018-04-20 21:41:36,13545.0,2,3760,-2,13535.0,8,13545.0,24,B
2018-04-20 21:41:39,13540.0,2,3762,0,13540.0,1,13545.0,21,S
2018-04-20 21:41:41,13545.0,4,3766,2,13535.0,7,13545.0,21,B
2018-04-20 21:41:42,13540.0,2,3768,-2,13535.0,7,13540.0,3,S
2018-04-20 21:41:44,13535.0,2,3770,0,13535.0,1,13540.0,22,S
2018-04-20 21:41:45,13535.0,2,3772,-2,13530.0,5,13535.0,1,S
2018-04-20 21:41:53,13535.0,2,3774,-2,13530.0,6,13535.0,3,S
2018-04-20 21:42:00,13535.0,2,3776,0,13530.0,5,13535.0,6,S
2018-04-20 21:42:05,13535.0,2,3778,0,13530.0,5,13535.0,5,S
2018-04-20 21:42:09,13530.0,8,3786,6,13525.0,2,13535.0,23,S
2018-04-20 21:42:17,13525.0,4,3790,0,13525.0,2,13530.0,4,S
2018-04-20 21:42:18,13525.0,2,3792,2,13525.0,2,13530.0,5,S
2018-04-20 21:42:19,13530.0,2,3794,0,13525.0,2,13530.0,4,B
2018-04-20 21:42:21,13525.0,2,3796,2,13520.0,8,13530.0,11,S
2018-04-20 21:42:43,13520.0,22,3818,0,13515.0,1,13525.0,45,S
2018-04-20 21:43:12,13520.0,6,3824,6,13520.0,2,13525.0,11,S
2018-04-20 21:43:38,13525.0,12,3836,10,13525.0,1,13530.0,6,B
2018-04-20 21:43:39,13525.0,2,3838,2,13525.0,1,13530.0,6,B
2018-04-20 21:43:42,13530.0,4,3842,4,13525.0,5,13535.0,11,B
2018-04-20 21:44:06,13530.0,10,3852,0,13525.0,1,13530.0,4,B
2018-04-20 21:44:15,13530.0,8,3860,0,13530.0,1,13535.0,41,B
2018-04-20 21:44:15,13530.0,2,3862,0,13525.0,3,13535.0,43,B
2018-04-20 21:44:25,13525.0,2,3864,0,13520.0,10,13530.0,8,S
2018-04-20 21:44:45,13525.0,2,3866,0,13520.0,5,13525.0,2,S
2018-04-20 21:45:11,13525.0,2,3868,0,13520.0,5,13525.0,4,S
2018-04-20 21:45:12,13525.0,2,3870,-2,13520.0,5,13525.0,3,S
2018-04-20 21:45:14,13525.0,2,3872,0,13520.0,5,13525.0,3,S
2018-04-20 21:45:15,13525.0,2,3874,0,13520.0,5,13525.0,2,S
2018-04-20 21:45:17,13525.0,2,3876,0,13520.0,5,13525.0,1,S
2018-04-20 21:45:18,13525.0,2,3878,0,13520.0,5,13525.0,1,S
2018-04-20 21:45:20,13525.0,2,3880,0,13520.0,5,13530.0,19,S
2018-04-20 21:45:27,13525.0,2,3882,-2,13520.0,5,13525.0,1,S
2018-04-20 21:45:29,13525.0,2,3884,0,13520.0,5,13530.0,40,S
2018-04-20 21:45:42,13525.0,2,3886,0,13520.0,5,13530.0,39,S
2018-04-20 21:46:18,13525.0,6,3892,0,13525.0,10,13530.0,3,S
2018-04-20 21:46:29,13530.0,2,3894,-2,13525.0,8,13530.0,1,B
2018-04-20 21:46:34,13530.0,2,3896,2,13530.0,4,13535.0,18,B
2018-04-20 21:46:36,13535.0,2,3898,2,13530.0,5,13535.0,27,B
2018-04-20 21:46:53,13535.0,48,3946,-4,13535.0,1,13540.0,9,B
2018-04-20 21:47:01,13535.0,6,3952,0,13535.0,1,13540.0,17,B
2018-04-20 21:47:03,13535.0,2,3954,0,13530.0,12,13535.0,1,B
2018-04-20 21:47:04,13535.0,2,3956,2,13530.0,12,13540.0,16,B
2018-04-20 21:47:08,13540.0,2,3958,0,13535.0,7,13540.0,16,B
2018-04-20 21:47:15,13540.0,2,3960,2,13535.0,8,13540.0,16,B
2018-04-20 21:47:26,13540.0,2,3962,2,13535.0,8,13540.0,17,B
2018-04-20 21:47:29,13540.0,2,3964,0,13535.0,8,13540.0,16,B
2018-04-20 21:47:32,13535.0,16,3980,6,13530.0,7,13535.0,1,S
2018-04-20 21:47:38,13535.0,10,3990,-4,13530.0,19,13540.0,17,S
2018-04-20 21:47:46,13530.0,2,3992,0,13530.0,4,13535.0,2,S
2018-04-20 21:47:47,13530.0,2,3994,2,13530.0,2,13535.0,2,S
2018-04-20 21:47:49,13535.0,4,3998,2,13530.0,2,13540.0,63,B
2018-04-20 21:48:01,13530.0,2,4000,0,13530.0,2,13540.0,26,S
2018-04-20 21:48:04,13535.0,2,4002,-2,13530.0,2,13535.0,3,B
2018-04-20 21:48:05,13535.0,4,4006,2,13535.0,3,13540.0,20,B
2018-04-20 21:48:06,13535.0,6,4012,0,13530.0,2,13535.0,2,B
2018-04-20 21:48:08,13535.0,4,4016,-4,13530.0,18,13540.0,16,B
2018-04-20 21:48:45,13535.0,12,4028,8,13530.0,18,13540.0,17,B
2018-04-20 21:48:59,13535.0,2,4030,-2,13530.0,17,13535.0,3,B
2018-04-20 21:49:00,13535.0,6,4036,-6,13530.0,17,13540.0,16,B
2018-04-20 21:49:11,13540.0,2,4038,2,13530.0,3,13540.0,50,B
2018-04-20 21:49:21,13535.0,2,4040,-2,13530.0,3,13535.0,1,S
2018-04-20 21:49:27,13530.0,4,4044,-2,13525.0,5,13530.0,2,S
2018-04-20 21:49:38,13530.0,4,4048,0,13520.0,24,13530.0,6,S
2018-04-20 21:49:40,13525.0,2,4050,0,13525.0,1,13530.0,10,S
2018-04-20 21:49:40,13525.0,2,4052,-2,13520.0,24,13530.0,10,S
2018-04-20 21:50:21,13530.0,10,4062,0,13530.0,3,13535.0,7,B
2018-04-20 21:50:22,13535.0,2,4064,0,13530.0,2,13535.0,4,B
2018-04-20 21:50:24,13535.0,2,4066,0,13530.0,15,13540.0,13,B
2018-04-20 21:50:51,13540.0,2,4068,2,13535.0,3,13540.0,11,B
2018-04-20 21:51:01,13540.0,24,4092,10,13535.0,5,13545.0,28,B
2018-04-20 21:51:02,13545.0,2,4094,0,13540.0,14,13545.0,2,B
2018-04-20 21:51:05,13545.0,2,4096,2,13540.0,15,13545.0,2,B
2018-04-20 21:51:12,13545.0,4,4100,-2,13545.0,3,13550.0,20,B
2018-04-20 21:51:12,13545.0,2,4102,-2,13545.0,7,13550.0,17,B
2018-04-20 21:51:18,13550.0,4,4106,4,13545.0,4,13550.0,19,B
2018-04-20 21:51:22,13545.0,10,4116,0,13540.0,18,13550.0,17,S
2018-04-20 21:51:29,13540.0,26,4142,12,13535.0,7,13540.0,1,S
2018-04-20 21:51:48,13540.0,2,4144,-2,13535.0,6,13540.0,4,S
2018-04-20 21:51:58,13535.0,2,4146,-2,13535.0,4,13540.0,7,S
2018-04-20 21:51:58,13535.0,4,4150,-2,13530.0,6,13535.0,1,S
2018-04-20 21:52:07,13530.0,2,4152,-2,13530.0,3,13535.0,5,S
2018-04-20 21:52:08,13530.0,2,4154,-2,13530.0,2,13535.0,5,S
2018-04-20 21:52:11,13535.0,8,4162,0,13530.0,19,13540.0,8,B
2018-04-20 21:52:31,13540.0,8,4170,6,13540.0,6,13545.0,10,B
2018-04-20 21:52:32,13540.0,2,4172,0,13540.0,5,13545.0,40,B
2018-04-20 21:52:32,13540.0,2,4174,2,13540.0,4,13545.0,37,B
2018-04-20 21:52:33,13540.0,2,4176,0,13540.0,3,13545.0,37,B
2018-04-20 21:52:34,13540.0,6,4182,0,13535.0,6,13545.0,37,B
2018-04-20 21:52:35,13540.0,2,4184,0,13535.0,3,13540.0,3,B
2018-04-20 21:52:50,13540.0,2,4186,0,13535.0,1,13540.0,5,B
2018-04-20 21:52:56,13535.0,2,4188,0,13530.0,11,13540.0,31,S
2018-04-20 21:52:59,13535.0,2,4190,2,13530.0,3,13535.0,3,S
2018-04-20 21:53:02,13535.0,6,4196,-6,13530.0,20,13540.0,9,S
2018-04-20 21:53:16,13530.0,2,4198,-2,13530.0,6,13535.0,1,S
2018-04-20 21:53:25,13530.0,2,4200,-2,13525.0,7,13535.0,1,S
2018-04-20 21:53:31,13530.0,2,4202,-2,13525.0,4,13535.0,34,S
2018-04-20 21:54:03,13530.0,2,4204,0,13525.0,7,13530.0,6,S
2018-04-20 21:54:03,13525.0,2,4206,0,13525.0,6,13530.0,6,S
2018-04-20 21:54:09,13520.0,6,4212,-4,13520.0,9,13525.0,1,S
2018-04-20 21:54:10,13525.0,2,4214,0,13520.0,18,13530.0,7,B
2018-04-20 21:54:10,13525.0,2,4216,0,13520.0,20,13530.0,7,B
2018-04-20 21:54:18,13525.0,2,4218,0,13520.0,20,13530.0,7,B
2018-04-20 21:54:25,13530.0,14,4232,-12,13530.0,3,13535.0,5,B
2018-04-20 21:54:27,13530.0,2,4234,0,13530.0,2,13535.0,1,B
2018-04-20 21:54:29,13530.0,2,4236,-2,13525.0,13,13530.0,1,B
2018-04-20 21:54:31,13530.0,2,4238,0,13525.0,1,13530.0,2,B
2018-04-20 21:55:18,13525.0,2,4240,2,13525.0,6,13530.0,1,S
2018-04-20 21:55:30,13525.0,8,4248,8,13525.0,2,13530.0,3,S
2018-04-20 21:55:32,13525.0,2,4250,-2,13525.0,1,13530.0,6,S
2018-04-20 21:55:33,13525.0,2,4252,0,13520.0,15,13530.0,38,S
2018-04-20 21:55:34,13525.0,2,4254,2,13520.0,13,13530.0,37,S
2018-04-20 21:55:35,13525.0,2,4256,2,13520.0,14,13530.0,37,S
2018-04-20 21:55:51,13525.0,4,4260,-2,13520.0,11,13525.0,2,S
2018-04-20 21:56:20,13525.0,2,4262,2,13520.0,14,13530.0,56,S
2018-04-20 21:56:31,13525.0,2,4264,0,13520.0,13,13525.0,5,S
2018-04-20 21:57:02,13525.0,2,4266,0,13520.0,10,13525.0,1,S
2018-04-20 21:57:39,13520.0,24,4290,-2,13515.0,5,13525.0,36,S
2018-04-20 21:57:50,13515.0,4,4294,2,13515.0,3,13520.0,1,S
2018-04-20 21:57:53,13515.0,8,4302,-6,13510.0,11,13515.0,5,S
2018-04-20 21:58:02,13510.0,2,4304,0,13510.0,10,13515.0,4,S
2018-04-20 21:58:03,13510.0,20,4324,-6,13505.0,3,13510.0,1,S
2018-04-20 21:58:17,13510.0,2,4326,0,13505.0,4,13510.0,3,S
2018-04-20 21:58:21,13505.0,4,4330,-4,13505.0,1,13510.0,32,S
2018-04-20 21:58:21,13505.0,2,4332,-2,13505.0,1,13510.0,60,S
2018-04-20 21:58:24,13510.0,4,4336,0,13505.0,18,13515.0,15,B
2018-04-20 21:58:31,13510.0,2,4338,0,13505.0,20,13515.0,9,B
2018-04-20 21:58:41,13510.0,2,4340,0,13510.0,3,13515.0,5,B
2018-04-20 21:58:43,13510.0,2,4342,-2,13510.0,3,13515.0,5,B
2018-04-20 21:58:43,13515.0,2,4344,2,13510.0,3,13515.0,4,B
2018-04-20 21:59:11,13515.0,6,4350,0,13515.0,2,13520.0,40,B
2018-04-20 21:59:12,13515.0,4,4354,0,13510.0,13,13520.0,62,B
2018-04-20 21:59:21,13515.0,2,4356,-2,13510.0,8,13515.0,3,B
2018-04-20 21:59:29,13510.0,2,4358,-2,13510.0,7,13515.0,4,S
2018-04-20 21:59:37,13510.0,2,4360,0,13510.0,6,13515.0,3,S
2018-04-20 21:59:49,13510.0,2,4362,-2,13505.0,21,13515.0,11,S
2018-04-20 22:00:25,13505.0,8,4370,6,13500.0,9,13510.0,5,S
2018-04-20 22:00:29,13510.0,8,4378,0,13505.0,9,13515.0,10,B
2018-04-20 22:00:36,13505.0,4,4382,-4,13505.0,5,13510.0,6,S
2018-04-20 22:00:52,13505.0,6,4388,2,13505.0,1,13510.0,2,S
2018-04-20 22:00:56,13505.0,2,4390,2,13500.0,24,13510.0,4,S
2018-04-20 22:00:59,13505.0,2,4392,0,13500.0,24,13510.0,11,S
2018-04-20 22:01:03,13510.0,4,4396,0,13510.0,4,13515.0,7,B
2018-04-20 22:01:21,13515.0,14,4410,-4,13515.0,13,13520.0,52,B
2018-04-20 22:01:21,13515.0,10,4420,-8,13515.0,8,13520.0,60,B
2018-04-20 22:01:22,13515.0,16,4436,0,13510.0,8,13515.0,1,B
2018-04-20 22:01:22,13510.0,2,4438,0,13510.0,6,13515.0,2,S
2018-04-20 22:01:25,13510.0,2,4440,-2,13510.0,5,13515.0,2,S
2018-04-20 22:01:36,13515.0,2,4442,0,13510.0,5,13515.0,2,B
2018-04-20 22:01:37,13515.0,6,4448,-4,13515.0,17,13520.0,54,B
2018-04-20 22:01:37,13515.0,12,4460,-10,13515.0,11,13520.0,59,B
2018-04-20 22:01:51,13515.0,2,4462,0,13515.0,10,13520.0,34,B
2018-04-20 22:01:52,13520.0,8,4470,4,13515.0,13,13525.0,28,B
2018-04-20 22:01:59,13520.0,2,4472,0,13515.0,13,13525.0,31,B
2018-04-20 22:02:02,13515.0,2,4474,0,13515.0,9,13520.0,5,S
2018-04-20 22:02:03,13515.0,8,4482,-8,13515.0,5,13520.0,36,S
2018-04-20 22:02:04,13515.0,10,4492,-10,13510.0,5,13520.0,36,S
2018-04-20 22:02:21,13515.0,6,4498,-4,13515.0,17,13520.0,32,S
2018-04-20 22:02:30,13515.0,34,4532,-12,13510.0,4,13515.0,4,S
2018-04-20 22:02:31,13510.0,4,4536,0,13505.0,7,13515.0,33,S
2018-04-20 22:02:44,13510.0,2,4538,-2,13510.0,4,13515.0,3,S
2018-04-20 22:03:00,13515.0,40,4578,-38,13505.0,16,13515.0,9,B
2018-04-20 22:03:05,13510.0,4,4582,-4,13510.0,1,13515.0,17,S
2018-04-20 22:03:07,13515.0,38,4620,16,13510.0,20,13520.0,10,B
2018-04-20 22:03:08,13515.0,2,4622,0,13515.0,8,13520.0,3,B
2018-04-20 22:03:08,13515.0,18,4640,-14,13515.0,2,13520.0,3,B
2018-04-20 22:03:13,13515.0,2,4642,2,13515.0,1,13520.0,5,B
2018-04-20 22:03:14,13515.0,2,4644,-2,13510.0,36,13520.0,5,B
2018-04-20 22:03:22,13510.0,20,4664,-16,13510.0,12,13515.0,10,S
2018-04-20 22:03:26,13510.0,14,4678,-14,13510.0,5,13515.0,16,S
2018-04-20 22:03:27,13510.0,8,4686,0,13510.0,1,13515.0,17,S
2018-04-20 22:03:28,13510.0,2,4688,2,13505.0,9,13515.0,19,S
2018-04-20 22:03:32,13505.0,2,4690,0,13505.0,1,13510.0,18,S
2018-04-20 22:03:33,13505.0,2,4692,0,13500.0,14,13510.0,18,S
2018-04-20 22:03:37,13500.0,2,4694,2,13500.0,8,13505.0,5,S
2018-04-20 22:03:37,13505.0,8,4702,-4,13500.0,11,13510.0,14,B
2018-04-20 22:03:45,13500.0,16,4718,-2,13500.0,2,13505.0,14,S
2018-04-20 22:03:45,13500.0,4,4722,2,13495.0,9,13505.0,24,S
2018-04-20 22:03:47,13490.0,36,4758,-24,13485.0,4,13495.0,13,S
2018-04-20 22:03:48,13480.0,8,4766,-2,13480.0,12,13490.0,11,S
2018-04-20 22:03:49,13495.0,8,4774,4,13490.0,14,13495.0,3,B
2018-04-20 22:03:49,13495.0,6,4780,-6,13495.0,6,13500.0,8,B
2018-04-20 22:03:50,13490.0,20,4800,-6,13490.0,8,13495.0,1,S
2018-04-20 22:03:53,13490.0,4,4804,0,13485.0,14,13495.0,20,S
2018-04-20 22:03:55,13485.0,6,4810,-6,13485.0,13,13495.0,13,S
2018-04-20 22:03:56,13490.0,8,4818,-2,13485.0,13,13495.0,13,B
2018-04-20 22:04:01,13495.0,2,4820,-2,13485.0,14,13495.0,9,B
2018-04-20 22:04:04,13490.0,4,4824,0,13490.0,3,13495.0,6,S
2018-04-20 22:04:05,13485.0,2,4826,0,13485.0,21,13495.0,7,S
2018-04-20 22:04:07,13495.0,2,4828,0,13490.0,10,13495.0,1,B
2018-04-20 22:04:08,13495.0,2,4830,-2,13495.0,1,13500.0,19,B
2018-04-20 22:04:13,13500.0,2,4832,2,13495.0,2,13500.0,15,B
2018-04-20 22:04:15,13495.0,4,4836,0,13490.0,16,13500.0,16,S
2018-04-20 22:04:17,13490.0,2,4838,2,13485.0,16,13495.0,11,S
2018-04-20 22:04:36,13495.0,2,4840,0,13490.0,13,13495.0,2,B
2018-04-20 22:04:36,13495.0,4,4844,0,13490.0,8,13495.0,2,B
2018-04-20 22:04:37,13495.0,2,4846,0,13490.0,7,13500.0,26,B
2018-04-20 22:04:48,13495.0,8,4854,2,13490.0,2,13495.0,9,B
2018-04-20 22:04:51,13490.0,2,4856,-2,13490.0,1,13495.0,4,S
2018-04-20 22:04:56,13490.0,2,4858,2,13490.0,1,13495.0,8,S
2018-04-20 22:05:05,13495.0,6,4864,0,13495.0,3,13500.0,20,B
2018-04-20 22:05:13,13500.0,12,4876,8,13495.0,18,13500.0,2,B
2018-04-20 22:05:14,13500.0,4,4880,4,13495.0,20,13505.0,6,B
2018-04-20 22:05:19,13505.0,2,4882,2,13495.0,20,13505.0,13,B
2018-04-20 22:05:43,13505.0,14,4896,-12,13505.0,13,13510.0,32,B
2018-04-20 22:05:44,13505.0,6,4902,0,13505.0,10,13510.0,45,B
2018-04-20 22:05:56,13505.0,16,4918,0,13505.0,2,13510.0,38,B
2018-04-20 22:05:56,13495.0,26,4944,-18,13495.0,8,13505.0,27,S
2018-04-20 22:05:59,13495.0,4,4948,-4,13490.0,13,13500.0,4,S
2018-04-20 22:06:02,13495.0,4,4952,-4,13490.0,22,13500.0,6,S
2018-04-20 22:06:05,13495.0,2,4954,0,13490.0,22,13500.0,7,S
2018-04-20 22:06:30,13500.0,2,4956,0,13495.0,1,13500.0,2,B
2018-04-20 22:06:38,13500.0,6,4962,0,13500.0,18,13505.0,17,B
2018-04-20 22:06:45,13500.0,4,4966,-4,13500.0,16,13505.0,18,B
2018-04-20 22:06:46,13500.0,32,4998,-28,13495.0,6,13500.0,1,B
2018-04-20 22:07:06,13500.0,2,5000,0,13495.0,3,13500.0,2,B
2018-04-20 22:07:31,13495.0,2,5002,-2,13495.0,1,13500.0,5,S
2018-04-20 22:07:47,13490.0,8,5010,6,13485.0,11,13495.0,13,S
2018-04-20 22:07:49,13490.0,6,5016,-2,13485.0,3,13490.0,5,S
2018-04-20 22:07:50,13485.0,6,5022,0,13480.0,16,13490.0,8,S
2018-04-20 22:07:52,13480.0,2,5024,0,13480.0,18,13490.0,19,S
2018-04-20 22:07:54,13480.0,4,5028,0,13480.0,8,13485.0,4,S
2018-04-20 22:07:55,13480.0,4,5032,0,13480.0,6,13485.0,4,S
2018-04-20 22:07:56,13485.0,4,5036,-4,13480.0,22,13490.0,17,B
2018-04-20 22:08:02,13485.0,4,5040,0,13485.0,2,13490.0,3,B
2018-04-20 22:08:06,13490.0,2,5042,-2,13485.0,22,13495.0,12,B
2018-04-20 22:08:08,13490.0,2,5044,0,13490.0,19,13495.0,12,B
2018-04-20 22:08:12,13490.0,22,5066,0,13490.0,8,13495.0,7,B
2018-04-20 22:08:12,13490.0,16,5082,-8,13485.0,12,13490.0,7,B
2018-04-20 22:08:29,13495.0,6,5088,2,13490.0,4,13500.0,30,B
2018-04-20 22:08:35,13495.0,2,5090,2,13490.0,2,13495.0,14,B
2018-04-20 22:08:36,13490.0,4,5094,2,13485.0,11,13490.0,3,S
2018-04-20 22:08:39,13490.0,2,5096,2,13485.0,7,13490.0,1,S
2018-04-20 22:08:40,13490.0,2,5098,0,13485.0,7,13495.0,31,S
2018-04-20 22:08:41,13490.0,2,5100,2,13485.0,7,13490.0,2,S
2018-04-20 22:08:44,13485.0,6,5106,2,13485.0,1,13490.0,14,S
2018-04-20 22:08:45,13485.0,2,5108,0,13480.0,12,13485.0,1,S
2018-04-20 22:08:46,13485.0,2,5110,0,13480.0,7,13485.0,3,S
2018-04-20 22:08:51,13485.0,10,5120,-4,13485.0,4,13490.0,13,S
2018-04-20 22:08:54,13485.0,10,5130,-10,13485.0,3,13490.0,1,S
2018-04-20 22:08:56,13490.0,2,5132,2,13485.0,4,13490.0,1,B
2018-04-20 22:08:59,13485.0,2,5134,0,13485.0,3,13490.0,2,S
2018-04-20 22:09:09,13490.0,6,5140,0,13485.0,3,13495.0,24,B
2018-04-20 22:09:24,13485.0,16,5156,6,13480.0,21,13485.0,17,S
2018-04-20 22:09:24,13485.0,16,5172,6,13480.0,21,13485.0,9,S
2018-04-20 22:09:32,13480.0,2,5174,0,13480.0,20,13485.0,9,S
2018-04-20 22:09:38,13480.0,40,5214,-26,13475.0,2,13480.0,20,S
2018-04-20 22:09:38,13480.0,12,5226,-4,13475.0,9,13480.0,14,S
2018-04-20 22:09:45,13480.0,4,5230,0,13475.0,12,13480.0,13,S
2018-04-20 22:09:46,13480.0,10,5240,0,13475.0,12,13480.0,8,S
2018-04-20 22:09:49,13480.0,16,5256,-14,13480.0,12,13485.0,13,S
2018-04-20 22:09:55,13485.0,2,5258,2,13480.0,13,13485.0,12,B
2018-04-20 22:10:01,13485.0,16,5274,12,13480.0,19,13490.0,8,B
2018-04-20 22:10:04,13490.0,2,5276,0,13485.0,6,13490.0,6,B
2018-04-20 22:10:05,13490.0,2,5278,0,13485.0,6,13490.0,5,B
2018-04-20 22:10:05,13490.0,4,5282,0,13485.0,6,13490.0,3,B
2018-04-20 22:10:11,13490.0,2,5284,0,13485.0,6,13490.0,2,B
2018-04-20 22:10:12,13490.0,2,5286,0,13485.0,6,13490.0,1,B
2018-04-20 22:10:49,13490.0,2,5288,0,13490.0,10,13495.0,2,B
2018-04-20 22:10:51,13495.0,4,5292,0,13490.0,13,13500.0,11,B
2018-04-20 22:10:57,13495.0,6,5298,0,13490.0,13,13500.0,23,B
2018-04-20 22:11:01,13500.0,40,5338,-28,13490.0,10,13500.0,16,B
2018-04-20 22:11:02,13495.0,2,5340,-2,13490.0,10,13500.0,15,S
2018-04-20 22:11:03,13490.0,2,5342,0,13490.0,9,13500.0,16,S
2018-04-20 22:11:21,13500.0,24,5366,-14,13495.0,42,13500.0,4,B
2018-04-20 22:11:24,13495.0,2,5368,2,13495.0,41,13500.0,9,S
2018-04-20 22:11:39,13495.0,2,5370,2,13495.0,40,13500.0,8,S
2018-04-20 22:11:44,13500.0,12,5382,-4,13500.0,19,13505.0,12,B
2018-04-20 22:11:45,13500.0,2,5384,0,13500.0,18,13505.0,21,B
2018-04-20 22:11:45,13500.0,16,5400,-10,13500.0,10,13505.0,24,B
2018-04-20 22:11:46,13500.0,2,5402,0,13500.0,9,13505.0,29,B
2018-04-20 22:11:58,13500.0,2,5404,0,13500.0,8,13505.0,29,B
2018-04-20 22:11:59,13500.0,2,5406,0,13500.0,7,13505.0,29,B
2018-04-20 22:11:59,13500.0,14,5420,-14,13495.0,40,13500.0,20,B
2018-04-20 22:12:27,13495.0,2,5422,0,13495.0,39,13500.0,21,S
2018-04-20 22:12:40,13500.0,4,5426,0,13495.0,39,13500.0,20,B
2018-04-20 22:12:41,13500.0,40,5466,12,13495.0,39,13500.0,2,B
2018-04-20 22:12:41,13500.0,4,5470,0,13500.0,1,13505.0,30,B
2018-04-20 22:13:04,13505.0,10,5480,6,13500.0,4,13505.0,3,B
2018-04-20 22:13:13,13505.0,4,5484,0,13500.0,11,13505.0,2,B
2018-04-20 22:13:14,13505.0,4,5488,2,13505.0,3,13510.0,11,B
2018-04-20 22:13:20,13510.0,4,5492,0,13500.0,19,13510.0,7,B
2018-04-20 22:13:27,13510.0,2,5494,-2,13500.0,34,13510.0,9,B
2018-04-20 22:13:57,13505.0,2,5496,2,13500.0,23,13505.0,14,S
2018-04-20 22:14:11,13500.0,10,5506,0,13495.0,5,13500.0,4,S
2018-04-20 22:14:12,13505.0,60,5566,46,13495.0,9,13505.0,28,B
2018-04-20 22:14:13,13500.0,2,5568,-2,13495.0,9,13500.0,2,S
2018-04-20 22:14:22,13500.0,4,5572,-4,13495.0,11,13505.0,14,S
2018-04-20 22:14:34,13505.0,2,5574,0,13500.0,7,13505.0,2,B
2018-04-20 22:14:51,13505.0,6,5580,0,13505.0,1,13510.0,12,B
2018-04-20 22:15:21,13500.0,8,5588,4,13500.0,1,13505.0,24,S
2018-04-20 22:15:22,13500.0,2,5590,2,13495.0,11,13500.0,1,S
2018-04-20 22:15:25,13500.0,2,5592,0,13495.0,35,13505.0,9,S
2018-04-20 22:16:57,13505.0,2,5594,0,13500.0,37,13505.0,1,B
2018-04-20 22:16:57,13505.0,2,5596,-2,13505.0,2,13510.0,5,B
2018-04-20 22:17:23,13510.0,4,5600,0,13505.0,5,13510.0,3,B
2018-04-20 22:18:54,13505.0,2,5602,0,13500.0,15,13505.0,1,S
2018-04-20 22:20:07,13510.0,2,5604,-2,13500.0,16,13510.0,20,B
2018-04-20 22:20:36,13510.0,2,5606,0,13505.0,10,13510.0,5,B
2018-04-20 22:20:48,13510.0,2,5608,2,13505.0,11,13510.0,1,B
2018-04-20 22:20:52,13510.0,2,5610,-2,13505.0,11,13515.0,13,B
2018-04-20 22:21:14,13510.0,4,5614,0,13510.0,2,13515.0,96,B
2018-04-20 22:21:15,13510.0,4,5618,-2,13505.0,14,13515.0,96,B
2018-04-20 22:21:17,13515.0,2,5620,0,13505.0,18,13515.0,96,B
2018-04-20 22:22:03,13510.0,4,5624,-4,13505.0,18,13510.0,2,S
2018-04-20 22:22:03,13510.0,4,5628,0,13510.0,18,13515.0,86,S
2018-04-20 22:22:08,13510.0,2,5630,2,13510.0,12,13515.0,81,S
2018-04-20 22:22:46,13515.0,32,5662,16,13510.0,56,13515.0,64,B
2018-04-20 22:22:46,13515.0,76,5738,46,13510.0,54,13515.0,26,B
2018-04-20 22:22:47,13515.0,54,5792,34,13510.0,54,13520.0,10,B
2018-04-20 22:22:48,13515.0,4,5796,2,13515.0,3,13520.0,14,B
2018-04-20 22:23:02,13520.0,2,5798,2,13515.0,6,13520.0,5,B
2018-04-20 22:23:05,13520.0,8,5806,4,13515.0,12,13520.0,1,B
2018-04-20 22:23:05,13520.0,2,5808,-2,13515.0,35,13525.0,7,B
2018-04-20 22:23:10,13525.0,4,5812,-4,13525.0,1,13530.0,4,B
2018-04-20 22:23:11,13525.0,2,5814,2,13525.0,3,13530.0,1,B
2018-04-20 22:23:20,13530.0,4,5818,-2,13530.0,1,13535.0,10,B
2018-04-20 22:23:21,13530.0,2,5820,-2,13525.0,24,13535.0,10,B
2018-04-20 22:23:28,13530.0,2,5822,0,13525.0,7,13535.0,13,B
2018-04-20 22:23:35,13530.0,2,5824,0,13530.0,2,13535.0,13,B
2018-04-20 22:23:36,13530.0,4,5828,0,13525.0,7,13535.0,17,B
2018-04-20 22:23:46,13530.0,2,5830,-2,13525.0,8,13535.0,15,B
2018-04-20 22:24:03,13525.0,2,5832,0,13525.0,4,13530.0,14,S
2018-04-20 22:24:04,13525.0,4,5836,0,13525.0,2,13530.0,14,S
2018-04-20 22:24:04,13525.0,2,5838,0,13525.0,1,13530.0,14,S
2018-04-20 22:24:09,13530.0,28,5866,8,13530.0,86,13535.0,18,B
2018-04-20 22:24:30,13535.0,2,5868,-2,13530.0,86,13535.0,19,B
2018-04-20 22:24:31,13535.0,32,5900,-26,13530.0,86,13535.0,4,B
2018-04-20 22:24:31,13535.0,10,5910,-4,13530.0,89,13535.0,2,B
2018-04-20 22:24:32,13535.0,4,5914,-4,13535.0,4,13540.0,13,B
2018-04-20 22:24:36,13535.0,16,5930,-2,13530.0,97,13535.0,2,B
2018-04-20 22:24:40,13530.0,2,5932,0,13530.0,97,13535.0,2,S
2018-04-20 22:24:44,13535.0,4,5936,0,13535.0,48,13540.0,17,B
2018-04-20 22:25:02,13540.0,40,5976,28,13540.0,30,13545.0,25,B
2018-04-20 22:25:03,13540.0,18,5994,12,13540.0,21,13545.0,31,B
2018-04-20 22:25:03,13540.0,6,6000,6,13540.0,18,13545.0,38,B
2018-04-20 22:25:11,13540.0,4,6004,2,13540.0,16,13545.0,40,B
2018-04-20 22:25:12,13540.0,12,6016,12,13540.0,10,13545.0,40,B
2018-04-20 22:25:13,13540.0,12,6028,0,13540.0,7,13545.0,36,B
2018-04-20 22:25:15,13540.0,6,6034,0,13540.0,4,13545.0,37,B
2018-04-20 22:25:16,13540.0,8,6042,2,13535.0,6,13540.0,11,B
2018-04-20 22:25:22,13540.0,2,6044,0,13535.0,6,13540.0,13,B
2018-04-20 22:25:24,13535.0,6,6050,0,13535.0,3,13540.0,13,S
2018-04-20 22:25:24,13535.0,6,6056,6,13530.0,2,13535.0,11,S
2018-04-20 22:25:25,13530.0,4,6060,-4,13525.0,2,13530.0,1,S
2018-04-20 22:25:32,13525.0,2,6062,2,13525.0,2,13530.0,4,S
2018-04-20 22:25:38,13530.0,2,6064,-2,13530.0,1,13535.0,16,B
2018-04-20 22:25:47,13530.0,8,6072,0,13520.0,17,13530.0,14,B
2018-04-20 22:26:01,13520.0,2,6074,0,13520.0,7,13525.0,14,S
2018-04-20 22:26:04,13525.0,14,6088,-2,13520.0,16,13530.0,4,B
2018-04-20 22:26:04,13520.0,14,6102,-10,13520.0,13,13530.0,4,S
2018-04-20 22:26:11,13525.0,2,6104,0,13525.0,13,13535.0,11,B
2018-04-20 22:26:13,13525.0,2,6106,-2,13520.0,6,13530.0,7,B
2018-04-20 22:26:18,13530.0,6,6112,-6,13525.0,16,13535.0,10,B
2018-04-20 22:26:21,13530.0,2,6114,-2,13525.0,16,13535.0,10,B
2018-04-20 22:26:24,13530.0,2,6116,-2,13525.0,17,13535.0,11,B
2018-04-20 22:26:33,13530.0,2,6118,0,13530.0,15,13535.0,17,B
2018-04-20 22:26:39,13535.0,4,6122,0,13530.0,27,13535.0,1,B
2018-04-20 22:26:39,13535.0,2,6124,0,13530.0,29,13540.0,8,B
2018-04-20 22:26:41,13535.0,10,6134,4,13530.0,20,13535.0,7,B
2018-04-20 22:27:19,13535.0,2,6136,2,13525.0,18,13535.0,12,B
2018-04-20 22:27:33,13535.0,20,6156,16,13525.0,18,13535.0,22,B
2018-04-20 22:27:35,13535.0,2,6158,0,13525.0,18,13535.0,21,B
2018-04-20 22:27:43,13535.0,2,6160,-2,13525.0,18,13535.0,20,B
2018-04-20 22:27:52,13525.0,2,6162,0,13525.0,17,13535.0,25,S
2018-04-20 22:27:53,13525.0,2,6164,0,13525.0,17,13535.0,26,S
2018-04-20 22:27:56,13530.0,4,6168,-4,13525.0,17,13535.0,37,B
2018-04-20 22:28:11,13525.0,10,6178,-10,13520.0,6,13525.0,3,S
2018-04-20 22:28:43,13520.0,2,6180,-2,13515.0,19,13525.0,38,S
2018-04-20 22:29:00,13520.0,2,6182,0,13520.0,12,13525.0,5,S
2018-04-20 22:29:09,13520.0,8,6190,-4,13520.0,8,13525.0,4,S
2018-04-20 22:29:15,13525.0,8,6198,-8,13520.0,14,13530.0,3,B
2018-04-20 22:29:20,13525.0,4,6202,-4,13520.0,11,13530.0,38,B
2018-04-20 22:29:42,13525.0,8,6210,0,13520.0,23,13530.0,3,B
2018-04-20 22:29:55,13525.0,2,6212,2,13520.0,11,13525.0,1,B
2018-04-20 22:30:43,13530.0,10,6222,-10,13525.0,12,13530.0,1,B
2018-04-20 22:30:52,13525.0,2,6224,0,13525.0,11,13530.0,2,S
2018-04-20 22:31:19,13530.0,2,6226,0,13525.0,12,13535.0,8,B
2018-04-20 22:31:53,13530.0,2,6228,0,13530.0,8,13535.0,42,B
2018-04-20 22:32:37,13530.0,2,6230,0,13530.0,12,13535.0,42,B
2018-04-20 22:32:38,13530.0,6,6236,4,13530.0,9,13535.0,27,B
2018-04-20 22:32:38,13530.0,18,6254,-16,13525.0,8,13530.0,25,B
2018-04-20 22:33:03,13530.0,6,6260,-4,13530.0,1,13535.0,15,B
2018-04-20 22:33:08,13530.0,2,6262,2,13525.0,27,13535.0,16,B
2018-04-20 22:33:20,13525.0,4,6266,-4,13525.0,3,13530.0,26,S
2018-04-20 22:34:09,13525.0,2,6268,2,13525.0,4,13530.0,26,S
2018-04-20 22:34:26,13530.0,2,6270,0,13525.0,15,13535.0,16,B
2018-04-20 22:35:17,13530.0,6,6276,6,13525.0,8,13530.0,6,B
2018-04-20 22:35:20,13525.0,2,6278,-2,13525.0,4,13530.0,25,S
2018-04-20 22:35:25,13525.0,2,6280,-2,13520.0,12,13530.0,25,S
2018-04-20 22:36:34,13530.0,2,6282,0,13520.0,16,13530.0,30,B
2018-04-20 22:36:58,13525.0,4,6286,4,13520.0,14,13525.0,2,S
2018-04-20 22:37:06,13520.0,2,6288,-2,13515.0,10,13525.0,29,S
2018-04-20 22:37:42,13525.0,2,6290,-2,13520.0,8,13525.0,2,B
2018-04-20 22:38:22,13525.0,2,6292,-2,13520.0,8,13525.0,1,B
2018-04-20 22:38:46,13520.0,6,6298,-6,13515.0,14,13525.0,31,S
2018-04-20 22:38:51,13525.0,8,6306,-6,13515.0,18,13525.0,29,B
2018-04-20 22:39:55,13525.0,2,6308,-2,13520.0,6,13525.0,19,B
2018-04-20 22:39:59,13525.0,2,6310,-2,13520.0,6,13525.0,19,B
2018-04-20 22:40:04,13525.0,2,6312,0,13525.0,1,13530.0,7,B
2018-04-20 22:40:08,13530.0,2,6314,0,13525.0,1,13530.0,5,B
2018-04-20 22:40:16,13530.0,4,6318,-2,13525.0,2,13535.0,14,B
2018-04-20 22:40:21,13535.0,2,6320,-2,13525.0,6,13535.0,17,B
2018-04-20 22:40:42,13535.0,2,6322,-2,13530.0,10,13535.0,1,B
2018-04-20 22:40:42,13535.0,2,6324,-2,13530.0,11,13540.0,8,B
2018-04-20 22:40:59,13535.0,2,6326,-2,13530.0,15,13540.0,36,B
2018-04-20 22:41:03,13540.0,2,6328,2,13535.0,5,13540.0,28,B
2018-04-20 22:41:03,13540.0,8,6336,-8,13535.0,8,13540.0,24,B
2018-04-20 22:41:04,13540.0,16,6352,-2,13535.0,27,13545.0,15,B
2018-04-20 22:41:07,13540.0,4,6356,-2,13535.0,11,13545.0,19,B
2018-04-20 22:41:09,13540.0,2,6358,2,13540.0,2,13545.0,9,B
2018-04-20 22:41:13,13540.0,2,6360,0,13540.0,1,13545.0,9,B
2018-04-20 22:41:24,13540.0,8,6368,-8,13535.0,10,13545.0,25,B
2018-04-20 22:41:28,13545.0,2,6370,0,13535.0,13,13545.0,25,B
2018-04-20 22:41:52,13540.0,2,6372,2,13535.0,16,13540.0,7,S
2018-04-20 22:43:09,13540.0,2,6374,0,13535.0,12,13540.0,13,S
2018-04-20 22:43:10,13535.0,2,6376,0,13535.0,11,13540.0,13,S
2018-04-20 22:43:13,13535.0,2,6378,0,13535.0,10,13540.0,13,S
2018-04-20 22:43:17,13535.0,2,6380,0,13535.0,9,13540.0,13,S
2018-04-20 22:43:19,13535.0,2,6382,0,13535.0,8,13540.0,13,S
2018-04-20 22:43:22,13535.0,2,6384,0,13535.0,7,13540.0,13,S
2018-04-20 22:43:23,13535.0,10,6394,-4,13535.0,2,13540.0,13,S
2018-04-20 22:43:23,13535.0,4,6398,4,13530.0,14,13540.0,13,S
2018-04-20 22:43:25,13530.0,6,6404,4,13530.0,2,13535.0,26,S
2018-04-20 22:43:25,13530.0,4,6408,-4,13525.0,6,13530.0,2,S
2018-04-20 22:44:25,13525.0,2,6410,0,13525.0,11,13535.0,26,S
2018-04-20 22:44:50,13525.0,10,6420,-6,13520.0,10,13530.0,14,S
2018-04-20 22:44:52,13530.0,6,6426,-2,13520.0,14,13530.0,13,B
2018-04-20 22:44:56,13525.0,4,6430,-2,13525.0,10,13535.0,26,S
2018-04-20 22:45:08,13530.0,2,6432,0,13525.0,7,13530.0,1,B
2018-04-20 22:45:10,13530.0,2,6434,-2,13525.0,7,13530.0,1,B
2018-04-20 22:45:21,13530.0,4,6438,-2,13520.0,10,13530.0,4,B
2018-04-20 22:45:43,13525.0,2,6440,0,13520.0,11,13530.0,16,S
2018-04-20 22:46:05,13530.0,32,6472,16,13530.0,14,13535.0,46,B
2018-04-20 22:46:06,13530.0,14,6486,2,13530.0,7,13535.0,57,B
2018-04-20 22:46:07,13530.0,8,6494,0,13530.0,3,13535.0,47,B
2018-04-20 22:46:35,13530.0,12,6506,4,13525.0,5,13530.0,8,B
2018-04-20 22:46:36,13525.0,8,6514,-6,13520.0,9,13525.0,12,S
2018-04-20 22:46:42,13525.0,4,6518,-4,13520.0,8,13525.0,10,S
2018-04-20 22:46:46,13525.0,6,6524,-6,13520.0,8,13525.0,7,S
2018-04-20 22:46:49,13525.0,8,6532,-8,13520.0,8,13525.0,3,S
2018-04-20 22:46:57,13525.0,6,6538,-6,13525.0,3,13530.0,8,S
2018-04-20 22:47:01,13530.0,4,6542,0,13530.0,1,13535.0,26,B
2018-04-20 22:47:02,13530.0,2,6544,-2,13525.0,9,13530.0,1,B
2018-04-20 22:47:16,13530.0,4,6548,-4,13525.0,6,13530.0,1,B
2018-04-20 22:47:43,13530.0,2,6550,-2,13525.0,6,13530.0,1,B
2018-04-20 22:48:24,13530.0,2,6552,-2,13525.0,6,13535.0,28,B
2018-04-20 22:48:34,13530.0,2,6554,0,13525.0,8,13535.0,34,B
2018-04-20 22:49:33,13530.0,2,6556,0,13530.0,2,13535.0,19,B
2018-04-20 22:49:42,13530.0,2,6558,-2,13530.0,2,13535.0,19,B
2018-04-20 22:49:56,13535.0,2,6560,0,13530.0,2,13535.0,18,B
2018-04-20 22:49:58,13530.0,4,6564,2,13525.0,8,13530.0,1,S
2018-04-20 22:49:59,13525.0,10,6574,6,13520.0,15,13530.0,38,S
2018-04-20 22:50:15,13520.0,10,6584,-10,13520.0,10,13525.0,5,S
2018-04-20 22:50:17,13520.0,2,6586,0,13520.0,9,13525.0,5,S
2018-04-20 22:50:22,13520.0,2,6588,0,13520.0,8,13525.0,5,S
2018-04-20 22:50:25,13525.0,2,6590,0,13520.0,8,13525.0,4,B
2018-04-20 22:50:40,13520.0,2,6592,0,13520.0,6,13525.0,5,S
2018-04-20 22:50:46,13520.0,2,6594,0,13520.0,3,13525.0,5,S
2018-04-20 22:50:50,13520.0,4,6598,-2,13515.0,8,13525.0,25,S
2018-04-20 22:51:01,13515.0,4,6602,-2,13515.0,7,13525.0,26,S
2018-04-20 22:51:02,13515.0,2,6604,-2,13515.0,6,13520.0,2,S
2018-04-20 22:51:04,13515.0,4,6608,-4,13510.0,8,13515.0,1,S
2018-04-20 22:51:07,13510.0,6,6614,4,13510.0,2,13515.0,4,S
2018-04-20 22:51:07,13510.0,2,6616,-2,13510.0,1,13515.0,4,S
2018-04-20 22:51:15,13510.0,2,6618,-2,13510.0,2,13515.0,7,S
2018-04-20 22:51:26,13510.0,4,6622,-4,13505.0,5,13515.0,29,S
2018-04-20 22:51:45,13510.0,2,6624,-2,13510.0,4,13515.0,9,S
2018-04-20 22:51:46,13510.0,6,6630,-4,13510.0,1,13515.0,9,S
2018-04-20 22:51:53,13510.0,2,6632,0,13505.0,8,13515.0,6,S
2018-04-20 22:51:54,13510.0,2,6634,0,13510.0,1,13515.0,6,S
2018-04-20 22:51:56,13515.0,4,6638,-4,13510.0,6,13515.0,4,B
2018-04-20 22:51:57,13515.0,4,6642,-4,13510.0,6,13515.0,2,B
2018-04-20 22:52:00,13515.0,4,6646,-4,13510.0,6,13520.0,36,B
2018-04-20 22:52:02,13510.0,2,6648,0,13510.0,5,13520.0,36,S
2018-04-20 22:52:13,13510.0,10,6658,4,13505.0,7,13515.0,10,S
2018-04-20 22:52:21,13510.0,2,6660,0,13505.0,6,13510.0,1,S
2018-04-20 22:52:23,13510.0,2,6662,-2,13505.0,6,13515.0,9,S
2018-04-20 22:52:44,13510.0,2,6664,2,13505.0,13,13515.0,12,S
2018-04-20 22:52:59,13515.0,2,6666,2,13505.0,13,13515.0,11,B
2018-04-20 22:53:20,13510.0,2,6668,0,13505.0,14,13515.0,11,S
2018-04-20 22:54:05,13510.0,10,6678,0,13510.0,5,13520.0,54,S
2018-04-20 22:54:25,13515.0,2,6680,-2,13515.0,1,13520.0,38,B
2018-04-20 22:54:25,13515.0,2,6682,-2,13510.0,5,13515.0,1,B
2018-04-20 22:54:30,13515.0,8,6690,-4,13510.0,5,13515.0,2,B
2018-04-20 22:54:43,13510.0,12,6702,0,13505.0,8,13510.0,2,S
2018-04-20 22:54:46,13505.0,10,6712,-6,13500.0,5,13505.0,1,S
2018-04-20 22:54:50,13500.0,2,6714,0,13500.0,4,13505.0,5,S
2018-04-20 22:54:53,13505.0,6,6720,0,13500.0,10,13510.0,36,B
2018-04-20 22:54:59,13500.0,14,6734,-8,13500.0,3,13510.0,36,S
2018-04-20 22:55:03,13500.0,10,6744,8,13500.0,4,13505.0,1,S
2018-04-20 22:55:03,13505.0,2,6746,0,13500.0,4,13510.0,3,B
2018-04-20 22:55:15,13500.0,2,6748,0,13495.0,8,13500.0,19,S
2018-04-20 22:55:22,13495.0,4,6752,-2,13495.0,8,13500.0,19,S
2018-04-20 22:55:22,13495.0,16,6768,-6,13490.0,14,13495.0,16,S
2018-04-20 22:55:23,13495.0,4,6772,-4,13490.0,14,13495.0,14,S
2018-04-20 22:55:29,13490.0,10,6782,2,13490.0,10,13495.0,14,S
2018-04-20 22:55:37,13495.0,4,6786,-4,13490.0,27,13495.0,12,B
2018-04-20 22:55:37,13495.0,24,6810,-18,13490.0,40,13500.0,22,B
2018-04-20 22:55:39,13490.0,4,6814,-4,13490.0,38,13500.0,22,S
2018-04-20 22:55:42,13490.0,10,6824,4,13490.0,21,13500.0,23,S
2018-04-20 22:56:03,13490.0,4,6828,0,13490.0,2,13495.0,1,S
2018-04-20 22:56:04,13495.0,2,6830,2,13490.0,3,13500.0,24,B
2018-04-20 22:56:19,13500.0,2,6832,0,13495.0,1,13500.0,23,B
2018-04-20 22:56:28,13500.0,8,6840,-8,13495.0,6,13500.0,19,B
2018-04-20 22:56:29,13500.0,32,6872,-2,13495.0,7,13500.0,3,B
2018-04-20 22:56:29,13500.0,6,6878,2,13500.0,1,13505.0,4,B
2018-04-20 22:56:41,13500.0,2,6880,0,13500.0,1,13505.0,6,B
2018-04-20 22:56:41,13500.0,2,6882,-2,13495.0,1,13505.0,6,B
2018-04-20 22:56:47,13495.0,2,6884,0,13490.0,10,13500.0,6,S
2018-04-20 22:56:57,13500.0,4,6888,0,13490.0,12,13500.0,7,B
2018-04-20 22:57:00,13505.0,40,6928,28,13490.0,13,13510.0,17,B
2018-04-20 22:57:14,13500.0,2,6930,0,13500.0,1,13505.0,4,S
2018-04-20 22:57:15,13500.0,2,6932,-2,13490.0,21,13505.0,4,S
2018-04-20 22:57:20,13500.0,2,6934,-2,13490.0,24,13505.0,4,S
2018-04-20 22:57:35,13495.0,4,6938,0,13490.0,15,13500.0,18,S
2018-04-20 22:57:39,13495.0,6,6944,6,13490.0,14,13500.0,4,S
2018-04-20 22:57:58,13495.0,2,6946,0,13490.0,18,13500.0,31,S
2018-04-20 22:58:00,13490.0,12,6958,-4,13490.0,19,13500.0,31,S
2018-04-20 22:58:01,13500.0,2,6960,0,13490.0,19,13500.0,30,B
2018-04-20 22:58:19,13500.0,2,6962,-2,13500.0,4,13505.0,2,B
2018-04-20 22:58:26,13500.0,2,6964,0,13500.0,3,13505.0,2,B
2018-04-20 22:58:29,13500.0,4,6968,-4,13500.0,1,13505.0,43,B
2018-04-20 22:58:29,13500.0,2,6970,-2,13495.0,5,13500.0,2,B
2018-04-20 22:58:45,13505.0,2,6972,-2,13500.0,1,13505.0,29,B
2018-04-20 22:58:48,13500.0,2,6974,2,13495.0,10,13505.0,29,S
2018-04-20 22:58:49,13500.0,4,6978,0,13495.0,1,13505.0,42,S
2018-04-20 22:59:00,13500.0,2,6980,-2,13495.0,5,13505.0,30,S
2018-04-20 22:59:01,13495.0,2,6982,-2,13490.0,8,13505.0,30,S
2018-04-20 22:59:01,13505.0,8,6990,-8,13495.0,2,13505.0,25,B
2018-04-20 22:59:10,13495.0,2,6992,-2,13495.0,6,13500.0,1,S
2018-04-20 22:59:11,13500.0,2,6994,2,13495.0,6,13505.0,1,B
2018-04-20 22:59:20,13500.0,2,6996,-2,13500.0,14,13505.0,1,B
2018-04-20 22:59:31,13500.0,2,6998,-2,13500.0,13,13505.0,1,B
2018-04-20 22:59:37,13505.0,2,7000,2,13510.0,1,13520.0,10,B
2018-04-20 22:59:38,13510.0,2,7002,0,13500.0,13,13515.0,26,B
2018-04-20 22:59:40,13515.0,2,7004,-2,13500.0,14,13515.0,27,B
2018-04-20 22:59:57,13505.0,4,7008,-4,13500.0,13,13510.0,1,S
2018-04-23 09:00:00,13520.0,6,7014,2,13510.0,3,13520.0,2,B
2018-04-23 09:00:01,13530.0,6,7020,0,13510.0,5,13530.0,1,B
2018-04-23 09:00:03,13530.0,2,7022,0,13530.0,1,13540.0,1,B
2018-04-23 09:00:07,13535.0,2,7024,0,13535.0,5,13540.0,6,B
2018-04-23 09:00:10,13540.0,10,7034,-2,13535.0,2,13540.0,1,B
2018-04-23 09:00:12,13540.0,2,7036,0,13535.0,5,13545.0,7,B
2018-04-23 09:00:13,13545.0,2,7038,0,13540.0,16,13545.0,6,B
2018-04-23 09:00:14,13545.0,4,7042,0,13540.0,16,13545.0,9,B
2018-04-23 09:00:14,13545.0,6,7048,0,13540.0,17,13545.0,1,B
2018-04-23 09:00:16,13550.0,38,7086,30,13545.0,6,13550.0,2,B
2018-04-23 09:00:17,13550.0,4,7090,-2,13550.0,6,13555.0,14,B
2018-04-23 09:00:17,13555.0,4,7094,2,13550.0,6,13555.0,12,B
2018-04-23 09:00:18,13555.0,2,7096,0,13550.0,5,13555.0,11,B
2018-04-23 09:00:18,13550.0,6,7102,0,13550.0,2,13555.0,11,S
2018-04-23 09:00:19,13555.0,8,7110,8,13550.0,2,13555.0,7,B
2018-04-23 09:00:19,13555.0,4,7114,0,13550.0,2,13555.0,5,B
2018-04-23 09:00:20,13550.0,8,7122,4,13545.0,1,13555.0,3,S
2018-04-23 09:00:21,13555.0,6,7128,-4,13555.0,2,13560.0,15,B
2018-04-23 09:00:21,13560.0,2,7130,2,13555.0,5,13560.0,14,B
2018-04-23 09:00:22,13555.0,8,7138,2,13555.0,2,13560.0,14,S
2018-04-23 09:00:23,13560.0,2,7140,2,13555.0,2,13560.0,13,B
2018-04-23 09:00:25,13555.0,4,7144,4,13550.0,8,13560.0,13,S
2018-04-23 09:00:25,13560.0,22,7166,20,13550.0,5,13560.0,7,B
2018-04-23 09:00:27,13550.0,40,7206,12,13550.0,2,13560.0,14,S
2018-04-23 09:00:30,13560.0,2,7208,-2,13555.0,9,13560.0,1,B
2018-04-23 09:00:32,13560.0,8,7216,0,13560.0,17,13565.0,13,B
2018-04-23 09:00:33,13560.0,12,7228,-12,13560.0,11,13565.0,13,B
2018-04-23 09:00:33,13560.0,2,7230,-2,13560.0,20,13565.0,13,B
2018-04-23 09:00:34,13565.0,30,7260,-12,13560.0,6,13565.0,11,B
2018-04-23 09:00:34,13560.0,12,7272,0,13555.0,1,13560.0,1,S
2018-04-23 09:00:35,13560.0,4,7276,0,13560.0,1,13565.0,11,S
2018-04-23 09:00:36,13560.0,2,7278,0,13555.0,7,13560.0,2,S
2018-04-23 09:00:37,13555.0,2,7280,2,13555.0,6,13560.0,3,S
2018-04-23 09:00:37,13555.0,4,7284,4,13555.0,3,13565.0,11,S
2018-04-23 09:00:38,13550.0,16,7300,-4,13545.0,1,13550.0,1,S
2018-04-23 09:00:40,13550.0,10,7310,-2,13540.0,16,13550.0,6,S
2018-04-23 09:00:41,13550.0,12,7322,8,13550.0,1,13555.0,9,S
2018-04-23 09:00:42,13550.0,2,7324,2,13540.0,16,13550.0,3,S
2018-04-23 09:00:46,13545.0,4,7328,-4,13545.0,2,13555.0,4,S
2018-04-23 09:00:48,13545.0,2,7330,-2,13545.0,1,13555.0,8,S
2018-04-23 09:00:50,13550.0,18,7348,-18,13550.0,7,13555.0,3,B
2018-04-23 09:00:51,13555.0,8,7356,-2,13555.0,12,13560.0,3,B
2018-04-23 09:00:52,13555.0,8,7364,4,13555.0,11,13560.0,8,B
2018-04-23 09:00:52,13555.0,22,7386,4,13555.0,8,13560.0,1,B
2018-04-23 09:00:53,13555.0,2,7388,-2,13555.0,7,13560.0,2,B
2018-04-23 09:00:53,13555.0,14,7402,0,13550.0,1,13555.0,4,B
2018-04-23 09:00:54,13550.0,2,7404,0,13545.0,3,13555.0,26,S
2018-04-23 09:00:57,13555.0,2,7406,0,13550.0,6,13555.0,7,B
2018-04-23 09:00:57,13555.0,8,7414,8,13550.0,5,13555.0,4,B
2018-04-23 09:00:59,13550.0,2,7416,0,13550.0,3,13555.0,4,S
2018-04-23 09:00:59,13555.0,2,7418,2,13550.0,1,13555.0,3,B
2018-04-23 09:01:00,13550.0,2,7420,0,13545.0,18,13550.0,1,S
2018-04-23 09:01:01,13550.0,2,7422,2,13550.0,2,13555.0,5,S
2018-04-23 09:01:01,13550.0,4,7426,0,13545.0,20,13555.0,5,S
2018-04-23 09:01:03,13555.0,8,7434,-2,13545.0,12,13555.0,10,B
2018-04-23 09:01:04,13550.0,2,7436,0,13545.0,11,13555.0,9,S
2018-04-23 09:01:08,13550.0,4,7440,-4,13545.0,13,13550.0,3,S
2018-04-23 09:01:09,13550.0,4,7444,2,13545.0,13,13550.0,2,S
2018-04-23 09:01:10,13550.0,26,7470,-16,13550.0,11,13555.0,4,S
2018-04-23 09:01:11,13545.0,28,7498,-18,13545.0,8,13550.0,22,S
2018-04-23 09:01:11,13545.0,16,7514,-2,13540.0,10,13550.0,24,S
2018-04-23 09:01:12,13540.0,2,7516,2,13540.0,8,13545.0,1,S
2018-04-23 09:01:16,13540.0,16,7532,16,13535.0,1,13545.0,6,S
2018-04-23 09:01:17,13540.0,2,7534,-2,13540.0,2,13545.0,1,S
2018-04-23 09:01:17,13540.0,4,7538,-4,13535.0,12,13545.0,2,S
2018-04-23 09:01:21,13545.0,4,7542,4,13545.0,2,13550.0,2,B
2018-04-23 09:01:21,13545.0,4,7546,0,13545.0,1,13550.0,2,B
2018-04-23 09:01:22,13545.0,2,7548,-2,13540.0,3,13550.0,9,B
2018-04-23 09:01:23,13545.0,2,7550,-2,13540.0,4,13550.0,7,B
2018-04-23 09:01:25,13545.0,2,7552,-2,13545.0,1,13550.0,4,B
2018-04-23 09:01:27,13545.0,2,7554,2,13545.0,10,13550.0,3,B
2018-04-23 09:01:27,13545.0,2,7556,2,13545.0,9,13550.0,3,B
2018-04-23 09:01:28,13550.0,4,7560,4,13545.0,9,13550.0,1,B
2018-04-23 09:01:30,13550.0,2,7562,2,13545.0,9,13550.0,1,B
2018-04-23 09:01:31,13550.0,2,7564,-2,13550.0,1,13555.0,4,B
2018-04-23 09:01:32,13555.0,6,7570,2,13555.0,3,13560.0,4,B
2018-04-23 09:01:33,13560.0,2,7572,-2,13560.0,3,13565.0,12,B
2018-04-23 09:01:37,13560.0,4,7576,0,13555.0,16,13560.0,1,B
2018-04-23 09:01:41,13565.0,2,7578,-2,13560.0,3,13565.0,20,B
2018-04-23 09:01:41,13560.0,2,7580,0,13560.0,2,13565.0,20,S
2018-04-23 09:01:44,13565.0,8,7588,4,13560.0,14,13565.0,7,B
2018-04-23 09:01:47,13565.0,2,7590,0,13560.0,2,13565.0,16,B
2018-04-23 09:01:50,13565.0,2,7592,2,13560.0,2,13565.0,15,B
2018-04-23 09:01:53,13560.0,4,7596,2,13555.0,16,13565.0,16,S
2018-04-23 09:01:54,13555.0,2,7598,2,13555.0,11,13560.0,13,S
2018-04-23 09:01:54,13555.0,2,7600,0,13555.0,11,13560.0,15,S
2018-04-23 09:01:56,13560.0,2,7602,0,13555.0,11,13560.0,14,B
2018-04-23 09:02:00,13565.0,4,7606,0,13560.0,4,13565.0,15,B
2018-04-23 09:02:01,13565.0,20,7626,6,13560.0,4,13565.0,3,B
2018-04-23 09:02:01,13565.0,6,7632,-4,13565.0,1,13570.0,18,B
2018-04-23 09:02:03,13570.0,10,7642,-2,13565.0,12,13570.0,12,B
2018-04-23 09:02:04,13565.0,2,7644,-2,13565.0,11,13570.0,12,S
2018-04-23 09:02:06,13570.0,24,7668,22,13565.0,10,13575.0,2,B
2018-04-23 09:02:06,13570.0,2,7670,-2,13565.0,10,13570.0,4,B
2018-04-23 09:02:07,13570.0,8,7678,-8,13570.0,13,13575.0,2,B
2018-04-23 09:02:07,13575.0,4,7682,-4,13570.0,11,13580.0,4,B
2018-04-23 09:02:08,13580.0,34,7716,6,13580.0,9,13585.0,19,B
2018-04-23 09:02:09,13580.0,24,7740,16,13575.0,1,13580.0,4,B
2018-04-23 09:02:09,13575.0,2,7742,0,13570.0,9,13580.0,5,S
2018-04-23 09:02:10,13580.0,4,7746,0,13575.0,12,13580.0,5,B
2018-04-23 09:02:11,13575.0,6,7752,2,13570.0,9,13580.0,11,S
2018-04-23 09:02:12,13570.0,2,7754,0,13570.0,5,13575.0,2,S
2018-04-23 09:02:15,13570.0,2,7756,0,13570.0,10,13575.0,4,S
2018-04-23 09:02:18,13570.0,16,7772,-8,13565.0,2,13570.0,5,S
2018-04-23 09:02:19,13570.0,14,7786,10,13570.0,3,13575.0,8,S
2018-04-23 09:02:22,13570.0,2,7788,0,13570.0,5,13575.0,3,S
2018-04-23 09:02:26,13570.0,2,7790,0,13570.0,2,13575.0,3,S
2018-04-23 09:02:27,13575.0,6,7796,2,13570.0,3,13580.0,15,B
2018-04-23 09:02:29,13575.0,2,7798,0,13575.0,2,13580.0,11,B
2018-04-23 09:02:31,13580.0,2,7800,0,13575.0,2,13580.0,10,B
2018-04-23 09:02:31,13580.0,2,7802,0,13575.0,2,13580.0,9,B
2018-04-23 09:02:35,13575.0,2,7804,2,13575.0,1,13580.0,8,S
2018-04-23 09:02:37,13580.0,2,7806,0,13575.0,3,13580.0,7,B
2018-04-23 09:02:41,13580.0,2,7808,-2,13575.0,2,13580.0,10,B
2018-04-23 09:02:42,13575.0,4,7812,0,13570.0,15,13580.0,10,S
2018-04-23 09:02:44,13575.0,4,7816,0,13570.0,14,13575.0,16,S
2018-04-23 09:02:44,13575.0,32,7848,28,13575.0,1,13580.0,10,S
2018-04-23 09:02:46,13580.0,2,7850,0,13575.0,1,13580.0,9,B
2018-04-23 09:02:47,13580.0,8,7858,-2,13575.0,1,13580.0,5,B
2018-04-23 09:02:48,13580.0,2,7860,0,13575.0,1,13580.0,4,B
2018-04-23 09:02:49,13580.0,6,7866,0,13575.0,1,13580.0,2,B
2018-04-23 09:02:50,13580.0,12,7878,-12,13575.0,1,13580.0,3,B
2018-04-23 09:02:55,13580.0,12,7890,0,13580.0,2,13585.0,4,B
2018-04-23 09:02:55,13580.0,4,7894,-4,13575.0,2,13580.0,2,B
2018-04-23 09:02:57,13580.0,10,7904,-8,13575.0,2,13580.0,1,B
2018-04-23 09:03:00,13580.0,10,7914,-6,13575.0,2,13580.0,4,B
2018-04-23 09:03:05,13575.0,2,7916,0,13575.0,1,13580.0,14,S
2018-04-23 09:03:08,13575.0,2,7918,0,13575.0,1,13580.0,18,S
2018-04-23 09:03:12,13575.0,2,7920,-2,13575.0,1,13580.0,18,S
2018-04-23 09:03:12,13575.0,4,7924,-2,13570.0,19,13580.0,18,S
2018-04-23 09:03:14,13575.0,2,7926,0,13570.0,17,13580.0,20,S
2018-04-23 09:03:15,13580.0,4,7930,0,13570.0,17,13580.0,18,B
2018-04-23 09:03:16,13570.0,6,7936,0,13570.0,14,13580.0,18,S
2018-04-23 09:03:25,13575.0,2,7938,0,13575.0,11,13580.0,15,B
2018-04-23 09:03:26,13580.0,10,7948,0,13575.0,11,13580.0,10,B
2018-04-23 09:03:32,13580.0,6,7954,0,13575.0,14,13580.0,9,B
2018-04-23 09:03:33,13575.0,10,7964,4,13575.0,9,13580.0,9,S
2018-04-23 09:03:35,13580.0,2,7966,-2,13575.0,17,13580.0,8,B
2018-04-23 09:03:36,13575.0,2,7968,-2,13575.0,16,13580.0,8,S
2018-04-23 09:03:45,13575.0,10,7978,10,13575.0,7,13580.0,35,S
2018-04-23 09:03:46,13575.0,2,7980,2,13575.0,6,13580.0,35,S
2018-04-23 09:03:48,13580.0,4,7984,-4,13575.0,7,13580.0,28,B
2018-04-23 09:03:50,13575.0,2,7986,0,13575.0,10,13580.0,28,S
2018-04-23 09:03:50,13575.0,2,7988,0,13575.0,9,13580.0,28,S
2018-04-23 09:03:58,13580.0,2,7990,0,13575.0,11,13580.0,27,B
2018-04-23 09:04:00,13575.0,2,7992,0,13575.0,10,13580.0,27,S
2018-04-23 09:04:03,13575.0,6,7998,0,13575.0,9,13580.0,26,S
2018-04-23 09:04:04,13575.0,2,8000,0,13575.0,8,13580.0,26,S
2018-04-23 09:04:07,13575.0,2,8002,0,13575.0,7,13580.0,26,S
2018-04-23 09:04:10,13575.0,2,8004,-2,13575.0,6,13580.0,26,S
2018-04-23 09:04:11,13575.0,16,8020,12,13570.0,11,13580.0,26,S
2018-04-23 09:04:11,13580.0,2,8022,0,13570.0,9,13580.0,29,B
2018-04-23 09:04:15,13575.0,6,8028,0,13570.0,7,13580.0,31,S
2018-04-23 09:04:21,13570.0,14,8042,0,13565.0,3,13570.0,1,S
2018-04-23 09:04:21,13570.0,2,8044,0,13565.0,2,13570.0,3,S
2018-04-23 09:04:29,13565.0,2,8046,2,13565.0,1,13575.0,17,S
2018-04-23 09:04:33,13565.0,4,8050,-2,13560.0,7,13570.0,12,S
2018-04-23 09:04:35,13565.0,8,8058,-2,13560.0,8,13565.0,4,S
2018-04-23 09:04:36,13560.0,12,8070,-4,13560.0,2,13565.0,4,S
2018-04-23 09:04:39,13560.0,4,8074,-4,13560.0,3,13565.0,4,S
2018-04-23 09:04:48,13560.0,8,8082,-4,13555.0,11,13560.0,16,S
2018-04-23 09:04:49,13555.0,40,8122,-26,13555.0,3,13560.0,6,S
2018-04-23 09:04:49,13560.0,4,8126,-4,13555.0,6,13560.0,4,B
2018-04-23 09:04:53,13560.0,10,8136,-10,13555.0,10,13560.0,4,B
2018-04-23 09:04:54,13560.0,8,8144,-4,13560.0,1,13565.0,7,B
2018-04-23 09:04:54,13560.0,4,8148,-2,13555.0,8,13565.0,7,B
2018-04-23 09:04:58,13560.0,2,8150,0,13555.0,5,13565.0,10,B
2018-04-23 09:05:04,13560.0,26,8176,14,13555.0,16,13560.0,4,B
2018-04-23 09:05:08,13555.0,20,8196,14,13550.0,54,13560.0,16,S
2018-04-23 09:05:11,13555.0,2,8198,0,13550.0,54,13555.0,1,S
2018-04-23 09:05:15,13555.0,2,8200,0,13550.0,54,13560.0,16,S
2018-04-23 09:05:26,13560.0,4,8204,0,13550.0,56,13560.0,19,B
2018-04-23 09:05:35,13555.0,2,8206,-2,13550.0,44,13555.0,4,S
2018-04-23 09:05:36,13555.0,8,8214,-2,13555.0,1,13560.0,11,S
2018-04-23 09:05:38,13555.0,6,8220,-6,13555.0,3,13560.0,9,S
2018-04-23 09:05:41,13560.0,2,8222,-2,13555.0,3,13560.0,5,B
2018-04-23 09:05:42,13560.0,6,8228,-6,13555.0,3,13560.0,2,B
2018-04-23 09:05:43,13555.0,2,8230,-2,13555.0,2,13560.0,2,S
2018-04-23 09:05:44,13560.0,4,8234,2,13560.0,5,13565.0,10,B
2018-04-23 09:05:50,13565.0,2,8236,0,13560.0,5,13565.0,11,B
2018-04-23 09:05:51,13560.0,10,8246,10,13555.0,2,13560.0,1,S
2018-04-23 09:05:51,13555.0,4,8250,-2,13550.0,50,13560.0,12,S
2018-04-23 09:05:56,13560.0,2,8252,2,13555.0,14,13560.0,4,B
2018-04-23 09:06:07,13565.0,4,8256,0,13560.0,17,13570.0,6,B
2018-04-23 09:06:16,13570.0,2,8258,0,13570.0,1,13575.0,6,B
2018-04-23 09:06:17,13575.0,2,8260,0,13570.0,3,13575.0,9,B
2018-04-23 09:06:25,13575.0,6,8266,-2,13570.0,5,13580.0,8,B
2018-04-23 09:06:27,13575.0,8,8274,-2,13575.0,1,13580.0,17,B
2018-04-23 09:06:28,13580.0,22,8296,-8,13570.0,3,13580.0,9,B
2018-04-23 09:06:33,13585.0,10,8306,4,13585.0,2,13590.0,7,B
2018-04-23 09:06:34,13585.0,4,8310,2,13585.0,10,13590.0,6,B
2018-04-23 09:06:34,13590.0,2,8312,2,13585.0,10,13590.0,5,B
2018-04-23 09:06:36,13590.0,2,8314,2,13585.0,7,13590.0,4,B
2018-04-23 09:06:37,13590.0,8,8322,4,13590.0,6,13595.0,5,B
2018-04-23 09:06:39,13590.0,12,8334,0,13585.0,5,13595.0,10,B
2018-04-23 09:06:44,13595.0,20,8354,8,13585.0,8,13595.0,2,B
2018-04-23 09:06:45,13595.0,2,8356,0,13590.0,19,13595.0,1,B
2018-04-23 09:06:45,13595.0,2,8358,-2,13590.0,19,13600.0,32,B
2018-04-23 09:06:48,13600.0,8,8366,8,13590.0,19,13600.0,37,B
2018-04-23 09:06:48,13600.0,4,8370,0,13595.0,8,13600.0,29,B
2018-04-23 09:06:49,13600.0,12,8382,2,13595.0,7,13600.0,23,B
2018-04-23 09:06:50,13600.0,8,8390,-8,13595.0,7,13600.0,19,B
2018-04-23 09:06:51,13595.0,2,8392,-2,13590.0,10,13595.0,1,S
2018-04-23 09:06:56,13595.0,2,8394,0,13590.0,13,13595.0,2,S
2018-04-23 09:06:58,13595.0,16,8410,-6,13590.0,3,13595.0,2,S
2018-04-23 09:06:58,13585.0,14,8424,12,13580.0,21,13590.0,13,S
2018-04-23 09:07:00,13590.0,20,8444,10,13585.0,1,13590.0,2,B
2018-04-23 09:07:00,13595.0,6,8450,2,13590.0,1,13595.0,8,B
2018-04-23 09:07:03,13595.0,4,8454,0,13590.0,5,13595.0,2,B
2018-04-23 09:07:03,13590.0,2,8456,0,13590.0,2,13595.0,5,S
2018-04-23 09:07:04,13590.0,4,8460,0,13585.0,11,13590.0,3,S
2018-04-23 09:07:06,13585.0,4,8464,0,13580.0,10,13590.0,17,S
2018-04-23 09:07:06,13590.0,2,8466,2,13580.0,10,13590.0,16,B
2018-04-23 09:07:07,13580.0,2,8468,-2,13580.0,9,13590.0,16,S
2018-04-23 09:07:09,13580.0,2,8470,2,13580.0,1,13585.0,20,S
2018-04-23 09:07:09,13580.0,4,8474,2,13575.0,2,13585.0,25,S
2018-04-23 09:07:10,13580.0,2,8476,0,13575.0,1,13580.0,6,S
2018-04-23 09:07:11,13580.0,4,8480,4,13575.0,2,13580.0,4,S
2018-04-23 09:07:11,13580.0,8,8488,2,13570.0,4,13580.0,1,S
2018-04-23 09:07:16,13580.0,2,8490,2,13575.0,6,13585.0,21,S
2018-04-23 09:07:18,13580.0,2,8492,-2,13575.0,6,13580.0,2,S
2018-04-23 09:07:19,13585.0,4,8496,0,13575.0,6,13585.0,19,B
2018-04-23 09:07:26,13575.0,2,8498,0,13575.0,3,13580.0,5,S
2018-04-23 09:07:26,13580.0,2,8500,0,13575.0,4,13580.0,3,B
2018-04-23 09:07:30,13585.0,4,8504,4,13575.0,7,13585.0,13,B
2018-04-23 09:07:32,13575.0,4,8508,0,13575.0,5,13585.0,17,S
2018-04-23 09:07:33,13585.0,20,8528,-4,13575.0,5,13585.0,9,B
2018-04-23 09:07:35,13575.0,2,8530,-2,13575.0,7,13585.0,11,S
2018-04-23 09:07:39,13585.0,12,8542,-4,13585.0,5,13590.0,6,B
2018-04-23 09:07:52,13590.0,4,8546,-2,13590.0,1,13595.0,6,B
2018-04-23 09:08:03,13590.0,2,8548,-2,13590.0,3,13595.0,6,B
2018-04-23 09:08:09,13590.0,6,8554,-6,13585.0,24,13595.0,5,B
2018-04-23 09:08:10,13590.0,4,8558,-2,13585.0,24,13595.0,8,B
2018-04-23 09:08:13,13590.0,6,8564,0,13585.0,18,13595.0,26,B
2018-04-23 09:08:15,13595.0,8,8572,2,13590.0,4,13595.0,3,B
2018-04-23 09:08:16,13590.0,4,8576,-2,13590.0,2,13595.0,3,S
2018-04-23 09:08:17,13590.0,2,8578,0,13590.0,1,13595.0,3,S
2018-04-23 09:08:18,13595.0,6,8584,-6,13590.0,1,13600.0,38,B
2018-04-23 09:08:21,13590.0,10,8594,4,13590.0,9,13595.0,1,S
2018-04-23 09:08:23,13595.0,2,8596,0,13595.0,4,13600.0,43,B
2018-04-23 09:08:23,13595.0,10,8606,6,13590.0,4,13600.0,43,B
2018-04-23 09:08:26,13595.0,10,8616,4,13585.0,15,13595.0,19,B
2018-04-23 09:08:27,13585.0,10,8626,0,13585.0,10,13595.0,19,S
2018-04-23 09:08:41,13590.0,2,8628,0,13585.0,7,13590.0,9,B
2018-04-23 09:08:42,13585.0,12,8640,10,13585.0,1,13590.0,6,S
2018-04-23 09:08:43,13585.0,2,8642,2,13580.0,11,13585.0,6,S
2018-04-23 09:08:49,13580.0,2,8644,0,13580.0,2,13585.0,6,S
2018-04-23 09:08:50,13585.0,4,8648,0,13580.0,2,13585.0,4,B
2018-04-23 09:08:54,13585.0,2,8650,2,13580.0,18,13585.0,2,B
2018-04-23 09:09:02,13585.0,2,8652,2,13580.0,19,13590.0,10,B
2018-04-23 09:09:04,13590.0,4,8656,0,13585.0,26,13590.0,2,B
2018-04-23 09:09:05,13590.0,2,8658,0,13585.0,26,13595.0,32,B
2018-04-23 09:09:09,13590.0,6,8664,0,13585.0,24,13590.0,1,B
2018-04-23 09:09:10,13585.0,34,8698,8,13585.0,2,13590.0,9,S
2018-04-23 09:09:11,13585.0,4,8702,4,13580.0,10,13590.0,16,S
2018-04-23 09:09:12,13580.0,4,8706,4,13575.0,11,13585.0,7,S
2018-04-23 09:09:19,13585.0,10,8716,-6,13580.0,8,13590.0,8,B
2018-04-23 09:09:21,13585.0,4,8720,-2,13585.0,8,13590.0,3,B
2018-04-23 09:09:22,13585.0,6,8726,-4,13585.0,9,13590.0,3,B
2018-04-23 09:09:26,13585.0,4,8730,0,13580.0,11,13585.0,23,B
2018-04-23 09:10:00,13585.0,40,8770,0,13580.0,9,13585.0,6,B
2018-04-23 09:10:01,13585.0,8,8778,-8,13580.0,9,13585.0,2,B
2018-04-23 09:10:01,13585.0,4,8782,4,13580.0,11,13590.0,9,B
2018-04-23 09:10:05,13585.0,2,8784,2,13580.0,14,13585.0,3,B
2018-04-23 09:10:08,13580.0,4,8788,-4,13580.0,2,13585.0,26,S
2018-04-23 09:10:09,13580.0,4,8792,2,13575.0,13,13585.0,14,S
2018-04-23 09:10:10,13585.0,10,8802,-8,13575.0,13,13585.0,9,B
2018-04-23 09:10:32,13580.0,2,8804,0,13580.0,19,13585.0,1,S
2018-04-23 09:10:38,13580.0,18,8822,18,13580.0,2,13585.0,12,S
2018-04-23 09:10:40,13580.0,4,8826,4,13575.0,19,13580.0,4,S
2018-04-23 09:10:42,13585.0,20,8846,-8,13575.0,13,13585.0,7,B
2018-04-23 09:10:47,13575.0,2,8848,-2,13575.0,14,13585.0,10,S
2018-04-23 09:11:03,13575.0,18,8866,12,13570.0,3,13580.0,10,S
2018-04-23 09:11:09,13575.0,2,8868,0,13570.0,6,13575.0,1,S
2018-04-23 09:11:17,13570.0,6,8874,-4,13570.0,1,13575.0,8,S
2018-04-23 09:11:18,13575.0,4,8878,-2,13565.0,15,13575.0,7,B
2018-04-23 09:11:24,13570.0,4,8882,-2,13565.0,18,13575.0,10,S
2018-04-23 09:11:33,13570.0,2,8884,-2,13570.0,15,13580.0,12,S
2018-04-23 09:11:36,13570.0,4,8888,-2,13570.0,15,13580.0,14,S
2018-04-23 09:11:43,13570.0,4,8892,-4,13570.0,8,13575.0,1,S
2018-04-23 09:11:57,13575.0,4,8896,-2,13575.0,38,13580.0,14,B
2018-04-23 09:11:58,13575.0,10,8906,-4,13575.0,33,13580.0,13,B
2018-04-23 09:12:01,13575.0,2,8908,-2,13575.0,32,13580.0,11,B
2018-04-23 09:12:09,13580.0,10,8918,4,13575.0,32,13580.0,5,B
2018-04-23 09:12:17,13575.0,2,8920,-2,13575.0,31,13580.0,5,S
2018-04-23 09:12:18,13575.0,2,8922,-2,13575.0,30,13580.0,5,S
2018-04-23 09:12:20,13575.0,2,8924,-2,13575.0,30,13580.0,5,S
2018-04-23 09:12:21,13580.0,8,8932,4,13580.0,6,13585.0,6,B
2018-04-23 09:12:22,13580.0,6,8938,0,13580.0,3,13585.0,7,B
2018-04-23 09:12:26,13580.0,2,8940,2,13580.0,2,13585.0,10,B
2018-04-23 09:12:32,13580.0,2,8942,2,13580.0,1,13585.0,9,B
2018-04-23 09:12:47,13580.0,2,8944,2,13580.0,4,13585.0,25,B
2018-04-23 09:12:54,13580.0,4,8948,0,13575.0,31,13580.0,8,B
2018-04-23 09:12:54,13580.0,8,8956,-4,13575.0,33,13580.0,4,B
2018-04-23 09:12:55,13580.0,8,8964,0,13575.0,33,13585.0,26,B
2018-04-23 09:12:58,13575.0,24,8988,0,13575.0,21,13585.0,27,S
2018-04-23 09:13:02,13575.0,2,8990,2,13570.0,7,13575.0,2,S
2018-04-23 09:13:03,13575.0,4,8994,0,13570.0,12,13580.0,7,S
2018-04-23 09:13:06,13580.0,8,9002,-4,13570.0,11,13580.0,6,B
2018-04-23 09:13:08,13580.0,2,9004,0,13570.0,11,13580.0,5,B
2018-04-23 09:13:10,13570.0,2,9006,0,13570.0,10,13580.0,5,S
2018-04-23 09:13:11,13575.0,2,9008,0,13570.0,10,13580.0,5,B
2018-04-23 09:13:15,13580.0,10,9018,10,13580.0,30,13585.0,53,B
2018-04-23 09:13:16,13580.0,38,9056,10,13580.0,11,13585.0,56,B
2018-04-23 09:13:16,13580.0,22,9078,16,13575.0,11,13580.0,1,B
2018-04-23 09:13:17,13580.0,2,9080,0,13575.0,11,13585.0,57,B
2018-04-23 09:13:29,13580.0,2,9082,2,13580.0,9,13585.0,52,B
2018-04-23 09:13:35,13580.0,2,9084,0,13580.0,8,13585.0,41,B
2018-04-23 09:13:35,13580.0,4,9088,4,13580.0,6,13585.0,41,B
2018-04-23 09:13:50,13585.0,82,9170,34,13580.0,14,13590.0,39,B
2018-04-23 09:13:54,13590.0,10,9180,-2,13590.0,2,13595.0,27,B
2018-04-23 09:13:55,13590.0,8,9188,4,13585.0,11,13590.0,3,B
2018-04-23 09:13:57,13590.0,16,9204,16,13590.0,2,13595.0,33,B
2018-04-23 09:14:02,13590.0,4,9208,4,13590.0,10,13595.0,33,B
2018-04-23 09:14:06,13590.0,10,9218,0,13590.0,5,13595.0,33,B
2018-04-23 09:14:15,13595.0,30,9248,-30,13590.0,7,13595.0,17,B
2018-04-23 09:14:15,13595.0,6,9254,0,13590.0,7,13595.0,14,B
2018-04-23 09:14:18,13590.0,2,9256,2,13590.0,6,13595.0,14,S
2018-04-23 09:14:18,13590.0,8,9264,0,13590.0,2,13595.0,14,S
2018-04-23 09:14:23,13595.0,10,9274,4,13590.0,1,13595.0,10,B
2018-04-23 09:14:26,13595.0,2,9276,2,13590.0,1,13595.0,9,B
2018-04-23 09:14:30,13595.0,18,9294,-10,13590.0,2,13600.0,35,B
2018-04-23 09:14:34,13600.0,4,9298,0,13590.0,16,13600.0,29,B
2018-04-23 09:14:37,13600.0,4,9302,0,13590.0,24,13600.0,29,B
2018-04-23 09:14:39,13600.0,8,9310,0,13595.0,13,13600.0,22,B
2018-04-23 09:14:40,13600.0,44,9354,-22,13595.0,15,13605.0,3,B
2018-04-23 09:14:41,13605.0,4,9358,0,13600.0,4,13605.0,4,B
2018-04-23 09:14:43,13605.0,2,9360,0,13600.0,5,13605.0,2,B
2018-04-23 09:14:44,13600.0,2,9362,-2,13600.0,1,13605.0,2,S
2018-04-23 09:14:44,13605.0,4,9366,0,13605.0,8,13610.0,26,B
2018-04-23 09:14:45,13605.0,22,9388,12,13600.0,8,13605.0,2,B
2018-04-23 09:14:45,13605.0,4,9392,-4,13600.0,8,13605.0,1,B
2018-04-23 09:14:46,13605.0,2,9394,-2,13600.0,8,13610.0,27,B
2018-04-23 09:14:48,13600.0,2,9396,2,13600.0,6,13605.0,2,S
2018-04-23 09:14:51,13605.0,2,9398,2,13600.0,6,13605.0,2,B
2018-04-23 09:14:52,13600.0,2,9400,0,13600.0,13,13605.0,2,S
2018-04-23 09:14:54,13605.0,6,9406,4,13605.0,2,13610.0,28,B
2018-04-23 09:14:54,13605.0,4,9410,2,13600.0,13,13605.0,3,B
2018-04-23 09:14:55,13605.0,6,9416,-2,13600.0,13,13610.0,28,B
2018-04-23 09:15:00,13605.0,4,9420,2,13605.0,4,13610.0,30,B
2018-04-23 09:15:01,13605.0,4,9424,4,13605.0,2,13610.0,34,B
2018-04-23 09:15:01,13605.0,4,9428,4,13600.0,11,13610.0,21,B
2018-04-23 09:15:02,13605.0,2,9430,2,13605.0,1,13610.0,21,B
2018-04-23 09:15:04,13610.0,2,9432,2,13605.0,1,13610.0,20,B
2018-04-23 09:15:04,13605.0,2,9434,0,13600.0,11,13610.0,20,S
2018-04-23 09:15:05,13600.0,2,9436,0,13600.0,10,13605.0,1,S
2018-04-23 09:15:08,13600.0,2,9438,-2,13600.0,9,13605.0,4,S
2018-04-23 09:15:17,13605.0,2,9440,0,13600.0,9,13605.0,13,B
2018-04-23 09:15:17,13605.0,4,9444,-4,13600.0,9,13605.0,11,B
2018-04-23 09:15:21,13600.0,18,9462,10,13595.0,9,13600.0,2,S
2018-04-23 09:15:26,13600.0,8,9470,8,13595.0,7,13605.0,20,S
2018-04-23 09:15:33,13605.0,4,9474,-2,13595.0,7,13605.0,23,B
2018-04-23 09:15:35,13605.0,8,9482,-8,13595.0,7,13605.0,19,B
2018-04-23 09:15:36,13600.0,2,9484,-2,13595.0,7,13605.0,15,S
2018-04-23 09:15:38,13595.0,2,9486,0,13595.0,5,13605.0,19,S
2018-04-23 09:15:41,13600.0,2,9488,0,13595.0,3,13600.0,23,B
2018-04-23 09:15:45,13595.0,4,9492,0,13590.0,11,13600.0,28,S
2018-04-23 09:15:50,13600.0,12,9504,0,13600.0,7,13605.0,41,B
2018-04-23 09:15:53,13600.0,2,9506,0,13600.0,6,13605.0,44,B
2018-04-23 09:15:53,13600.0,12,9518,2,13595.0,10,13600.0,5,B
2018-04-23 09:15:56,13595.0,2,9520,0,13595.0,13,13600.0,4,S
2018-04-23 09:15:58,13600.0,2,9522,2,13595.0,12,13600.0,3,B
2018-04-23 09:15:59,13600.0,6,9528,6,13600.0,7,13605.0,41,B
2018-04-23 09:16:00,13600.0,4,9532,4,13600.0,5,13605.0,47,B
2018-04-23 09:16:01,13600.0,10,9542,10,13595.0,9,13600.0,3,B
2018-04-23 09:16:04,13600.0,2,9544,-2,13595.0,10,13600.0,1,B
2018-04-23 09:16:04,13600.0,2,9546,0,13595.0,10,13605.0,47,B
2018-04-23 09:16:07,13605.0,10,9556,0,13595.0,10,13605.0,47,B
2018-04-23 09:16:08,13605.0,10,9566,2,13595.0,11,13605.0,42,B
2018-04-23 09:16:09,13605.0,10,9576,8,13595.0,8,13605.0,39,B
2018-04-23 09:16:10,13605.0,10,9586,4,13595.0,3,13600.0,14,B
2018-04-23 09:16:11,13595.0,6,9592,-6,13590.0,11,13600.0,22,S
2018-04-23 09:16:21,13600.0,20,9612,0,13595.0,20,13600.0,15,B
2018-04-23 09:16:21,13600.0,8,9620,-2,13595.0,20,13600.0,11,B
2018-04-23 09:16:24,13600.0,12,9632,4,13595.0,27,13605.0,14,B
2018-04-23 09:16:26,13600.0,2,9634,2,13600.0,1,13605.0,10,B
2018-04-23 09:16:28,13605.0,6,9640,-6,13600.0,5,13605.0,4,B
2018-04-23 09:16:32,13600.0,6,9646,0,13600.0,2,13605.0,4,S
2018-04-23 09:16:41,13600.0,2,9648,0,13595.0,24,13605.0,4,S
2018-04-23 09:16:44,13600.0,2,9650,0,13600.0,5,13605.0,4,S
2018-04-23 09:16:50,13605.0,14,9664,-6,13605.0,1,13610.0,29,B
2018-04-23 09:16:50,13605.0,22,9686,0,13605.0,14,13615.0,8,B
2018-04-23 09:16:51,13615.0,2,9688,-2,13610.0,5,13615.0,9,B
2018-04-23 09:16:55,13610.0,2,9690,0,13610.0,3,13615.0,8,S
2018-04-23 09:16:56,13610.0,2,9692,0,13610.0,2,13615.0,7,S
2018-04-23 09:16:58,13615.0,6,9698,-6,13610.0,7,13615.0,3,B
2018-04-23 09:16:59,13615.0,6,9704,2,13610.0,11,13620.0,8,B
2018-04-23 09:16:59,13620.0,18,9722,-10,13615.0,2,13625.0,2,B
2018-04-23 09:17:00,13625.0,4,9726,2,13620.0,8,13630.0,22,B
2018-04-23 09:17:01,13625.0,2,9728,0,13625.0,2,13630.0,26,B
2018-04-23 09:17:01,13630.0,10,9738,0,13625.0,7,13630.0,5,B
2018-04-23 09:17:02,13635.0,16,9754,-2,13625.0,9,13635.0,13,B
2018-04-23 09:17:02,13625.0,22,9776,-20,13620.0,11,13625.0,10,S
2018-04-23 09:17:03,13625.0,24,9800,-10,13620.0,11,13625.0,3,S
2018-04-23 09:17:03,13625.0,6,9806,4,13625.0,2,13630.0,6,S
2018-04-23 09:17:04,13625.0,2,9808,0,13620.0,15,13630.0,5,S
2018-04-23 09:17:05,13625.0,2,9810,2,13625.0,2,13630.0,5,S
2018-04-23 09:17:06,13630.0,8,9818,0,13620.0,15,13630.0,3,B
2018-04-23 09:17:06,13625.0,6,9824,2,13625.0,8,13630.0,1,S
2018-04-23 09:17:07,13630.0,2,9826,0,13630.0,1,13635.0,3,B
2018-04-23 09:17:07,13630.0,2,9828,0,13630.0,2,13635.0,2,B
2018-04-23 09:17:08,13635.0,2,9830,0,13635.0,12,13640.0,19,B
2018-04-23 09:17:08,13635.0,10,9840,10,13635.0,7,13640.0,7,B
2018-04-23 09:17:09,13635.0,14,9854,14,13630.0,13,13640.0,7,B
2018-04-23 09:17:10,13635.0,20,9874,18,13630.0,11,13640.0,15,B
2018-04-23 09:17:11,13635.0,2,9876,0,13630.0,11,13640.0,14,B
2018-04-23 09:17:12,13635.0,2,9878,-2,13630.0,12,13640.0,14,B
2018-04-23 09:17:13,13635.0,2,9880,2,13635.0,5,13640.0,14,B
2018-04-23 09:17:13,13625.0,16,9896,-2,13625.0,3,13635.0,7,S
2018-04-23 09:17:14,13635.0,20,9916,6,13625.0,7,13635.0,11,B
2018-04-23 09:17:14,13635.0,4,9920,2,13625.0,6,13635.0,10,B
2018-04-23 09:17:16,13635.0,2,9922,-2,13630.0,1,13635.0,3,B
2018-04-23 09:17:18,13640.0,4,9926,0,13635.0,15,13640.0,4,B
2018-04-23 09:17:19,13635.0,4,9930,-4,13635.0,14,13640.0,3,S
2018-04-23 09:17:19,13640.0,6,9936,2,13640.0,5,13645.0,4,B
2018-04-23 09:17:20,13645.0,6,9942,4,13645.0,7,13650.0,30,B
2018-04-23 09:17:21,13645.0,16,9958,10,13640.0,3,13645.0,3,B
2018-04-23 09:17:21,13640.0,6,9964,4,13635.0,11,13640.0,11,S
2018-04-23 09:17:22,13640.0,2,9966,-2,13635.0,11,13640.0,11,S
2018-04-23 09:17:23,13640.0,2,9968,-2,13630.0,6,13640.0,10,S
2018-04-23 09:17:24,13635.0,4,9972,0,13630.0,12,13640.0,8,S
2018-04-23 09:17:25,13630.0,10,9982,4,13625.0,3,13635.0,6,S
2018-04-23 09:17:26,13635.0,2,9984,-2,13625.0,2,13630.0,2,B
2018-04-23 09:17:26,13625.0,2,9986,0,13620.0,14,13630.0,2,S
2018-04-23 09:17:27,13635.0,34,10020,-10,13625.0,7,13635.0,3,B
2018-04-23 09:17:30,13630.0,4,10024,-4,13630.0,2,13635.0,13,S
2018-04-23 09:17:32,13635.0,4,10028,-2,13630.0,9,13635.0,11,B
2018-04-23 09:17:32,13630.0,18,10046,4,13630.0,7,13635.0,6,S
2018-04-23 09:17:35,13635.0,2,10048,-2,13630.0,5,13635.0,5,B
2018-04-23 09:17:36,13630.0,2,10050,0,13630.0,4,13635.0,5,S
2018-04-23 09:17:38,13635.0,2,10052,-2,13630.0,4,13635.0,4,B
2018-04-23 09:17:38,13630.0,2,10054,0,13630.0,3,13635.0,4,S
2018-04-23 09:17:39,13635.0,2,10056,-2,13630.0,3,13635.0,3,B
2018-04-23 09:17:40,13635.0,2,10058,0,13630.0,3,13635.0,4,B
2018-04-23 09:17:41,13630.0,6,10064,6,13625.0,14,13635.0,5,S
2018-04-23 09:17:41,13630.0,4,10068,4,13630.0,1,13635.0,11,S
2018-04-23 09:17:42,13630.0,2,10070,2,13625.0,5,13630.0,12,S
2018-04-23 09:17:42,13620.0,14,10084,8,13620.0,6,13625.0,1,S
2018-04-23 09:17:43,13625.0,2,10086,-2,13620.0,6,13625.0,3,B
2018-04-23 09:17:46,13620.0,6,10092,2,13620.0,2,13625.0,9,S
2018-04-23 09:17:47,13620.0,4,10096,0,13615.0,4,13620.0,2,S
2018-04-23 09:17:47,13620.0,4,10100,0,13620.0,4,13625.0,4,S
2018-04-23 09:17:48,13625.0,2,10102,0,13620.0,6,13625.0,2,B
2018-04-23 09:17:50,13625.0,6,10108,0,13620.0,10,13625.0,1,B
2018-04-23 09:17:50,13625.0,2,10110,-2,13620.0,14,13630.0,12,B
2018-04-23 09:17:52,13630.0,10,10120,-2,13625.0,16,13635.0,14,B
2018-04-23 09:17:53,13635.0,14,10134,6,13630.0,17,13640.0,13,B
2018-04-23 09:17:53,13630.0,10,10144,6,13630.0,5,13640.0,15,S
2018-04-23 09:17:57,13635.0,2,10146,-2,13630.0,5,13635.0,4,B
2018-04-23 09:17:58,13635.0,2,10148,-2,13630.0,8,13635.0,3,B
2018-04-23 09:18:00,13635.0,2,10150,0,13630.0,2,13635.0,3,B
2018-04-23 09:18:00,13635.0,6,10156,-6,13630.0,2,13640.0,12,B
2018-04-23 09:18:01,13635.0,2,10158,0,13630.0,11,13640.0,9,B
2018-04-23 09:18:02,13630.0,20,10178,4,13630.0,1,13640.0,9,S
2018-04-23 09:18:06,13635.0,2,10180,-2,13630.0,6,13640.0,15,B
2018-04-23 09:18:06,13630.0,2,10182,2,13630.0,6,13640.0,13,S
2018-04-23 09:18:07,13635.0,2,10184,0,13630.0,7,13640.0,13,B
2018-04-23 09:18:08,13640.0,4,10188,0,13635.0,1,13640.0,9,B
2018-04-23 09:18:09,13640.0,16,10204,-14,13635.0,8,13645.0,5,B
2018-04-23 09:18:10,13640.0,2,10206,0,13635.0,3,13640.0,4,B
2018-04-23 09:18:11,13635.0,2,10208,0,13635.0,2,13640.0,4,S
2018-04-23 09:18:12,13640.0,8,10216,2,13640.0,6,13645.0,38,B
2018-04-23 09:18:13,13640.0,12,10228,12,13635.0,1,13645.0,37,B
2018-04-23 09:18:13,13630.0,2,10230,0,13630.0,6,13640.0,2,S
2018-04-23 09:18:14,13635.0,8,10238,0,13630.0,6,13640.0,1,B
2018-04-23 09:18:20,13635.0,2,10240,-2,13635.0,1,13640.0,30,B
2018-04-23 09:18:20,13635.0,4,10244,-2,13635.0,2,13640.0,30,B
2018-04-23 09:18:22,13640.0,22,10266,-20,13630.0,9,13640.0,18,B
2018-04-23 09:18:23,13640.0,6,10272,2,13640.0,7,13645.0,10,B
2018-04-23 09:18:24,13640.0,12,10284,6,13640.0,1,13645.0,16,B
2018-04-23 09:18:29,13645.0,20,10304,14,13640.0,1,13645.0,3,B
2018-04-23 09:18:34,13645.0,2,10306,-2,13640.0,7,13645.0,3,B
2018-04-23 09:18:37,13645.0,6,10312,-4,13640.0,23,13645.0,2,B
2018-04-23 09:18:37,13640.0,2,10314,0,13640.0,22,13645.0,2,S
2018-04-23 09:18:39,13640.0,40,10354,4,13635.0,2,13640.0,2,S
2018-04-23 09:18:41,13640.0,2,10356,-2,13635.0,1,13640.0,5,S
2018-04-23 09:18:43,13640.0,2,10358,2,13635.0,5,13640.0,4,S
2018-04-23 09:18:48,13640.0,4,10362,0,13635.0,11,13645.0,12,S
2018-04-23 09:18:52,13645.0,6,10368,2,13640.0,13,13645.0,3,B
2018-04-23 09:18:53,13645.0,12,10380,-10,13640.0,17,13650.0,20,B
2018-04-23 09:18:54,13645.0,4,10384,0,13645.0,4,13650.0,17,B
2018-04-23 09:18:55,13650.0,2,10386,-2,13645.0,19,13650.0,15,B
2018-04-23 09:18:55,13650.0,8,10394,0,13645.0,19,13650.0,11,B
2018-04-23 09:18:56,13645.0,2,10396,2,13645.0,18,13650.0,11,S
2018-04-23 09:18:56,13645.0,2,10398,0,13645.0,17,13650.0,11,S
2018-04-23 09:18:59,13650.0,22,10420,14,13650.0,1,13655.0,14,B
2018-04-23 09:19:00,13655.0,10,10430,-6,13650.0,5,13655.0,5,B
2018-04-23 09:19:01,13660.0,14,10444,-10,13650.0,14,13655.0,1,B
2018-04-23 09:19:01,13655.0,2,10446,0,13655.0,1,13660.0,14,S
2018-04-23 09:19:05,13660.0,10,10456,10,13655.0,14,13660.0,5,B
2018-04-23 09:19:06,13655.0,2,10458,2,13655.0,13,13660.0,5,S
2018-04-23 09:19:08,13660.0,2,10460,2,13655.0,15,13660.0,4,B
2018-04-23 09:19:09,13660.0,12,10472,4,13655.0,11,13665.0,3,B
2018-04-23 09:19:10,13655.0,2,10474,0,13655.0,8,13660.0,2,S
2018-04-23 09:19:11,13660.0,4,10478,-2,13655.0,12,13665.0,13,B
2018-04-23 09:19:13,13665.0,14,10492,-10,13660.0,2,13665.0,5,B
2018-04-23 09:19:13,13660.0,2,10494,-2,13660.0,5,13665.0,3,S
2018-04-23 09:19:14,13665.0,2,10496,0,13660.0,9,13670.0,7,B
2018-04-23 09:19:16,13660.0,2,10498,0,13660.0,8,13670.0,10,S
2018-04-23 09:19:17,13665.0,12,10510,-6,13660.0,8,13670.0,8,B
2018-04-23 09:19:19,13665.0,2,10512,0,13660.0,1,13665.0,3,B
2018-04-23 09:19:19,13665.0,2,10514,-2,13660.0,13,13670.0,8,B
2018-04-23 09:19:21,13665.0,10,10524,6,13665.0,4,13670.0,5,B
2018-04-23 09:19:22,13665.0,8,10532,-8,13660.0,10,13670.0,6,B
2018-04-23 09:19:25,13660.0,6,10538,-4,13655.0,13,13660.0,1,S
2018-04-23 09:19:29,13655.0,2,10540,-2,13655.0,7,13660.0,1,S
2018-04-23 09:19:30,13655.0,10,10550,-8,13650.0,4,13655.0,3,S
2018-04-23 09:19:30,13650.0,2,10552,2,13650.0,4,13660.0,13,S
2018-04-23 09:19:34,13650.0,2,10554,2,13650.0,9,13660.0,14,S
2018-04-23 09:19:35,13660.0,2,10556,2,13650.0,9,13660.0,13,B
2018-04-23 09:19:36,13655.0,2,10558,-2,13655.0,4,13660.0,7,S
2018-04-23 09:19:37,13660.0,14,10572,0,13655.0,9,13665.0,14,B
2018-04-23 09:19:39,13655.0,4,10576,-2,13655.0,8,13660.0,1,S
2018-04-23 09:19:39,13660.0,4,10580,4,13655.0,8,13660.0,2,B
2018-04-23 09:19:40,13655.0,16,10596,-8,13650.0,8,13655.0,2,S
2018-04-23 09:19:40,13655.0,10,10606,2,13655.0,1,13660.0,4,S
2018-04-23 09:19:46,13655.0,12,10618,-4,13655.0,4,13665.0,7,S
2018-04-23 09:19:49,13660.0,2,10620,-2,13660.0,5,13665.0,6,B
2018-04-23 09:19:53,13665.0,10,10630,6,13665.0,1,13670.0,10,B
2018-04-23 09:19:53,13660.0,12,10642,-4,13660.0,1,13670.0,15,S
2018-04-23 09:19:54,13660.0,2,10644,0,13660.0,1,13665.0,8,S
2018-04-23 09:19:56,13660.0,2,10646,-2,13660.0,1,13665.0,11,S
2018-04-23 09:19:58,13660.0,2,10648,0,13660.0,1,13665.0,9,S
2018-04-23 09:19:59,13665.0,4,10652,2,13660.0,1,13665.0,7,B
2018-04-23 09:19:59,13660.0,2,10654,0,13655.0,5,13665.0,7,S
2018-04-23 09:20:01,13660.0,2,10656,-2,13655.0,7,13665.0,3,S
2018-04-23 09:20:02,13665.0,22,10678,10,13655.0,2,13665.0,2,B
2018-04-23 09:20:04,13665.0,2,10680,2,13660.0,12,13665.0,4,B
2018-04-23 09:20:07,13665.0,18,10698,-10,13665.0,1,13670.0,13,B
2018-04-23 09:20:08,13660.0,4,10702,-2,13655.0,6,13665.0,9,S
2018-04-23 09:20:16,13655.0,2,10704,0,13650.0,1,13655.0,6,S
2018-04-23 09:20:19,13650.0,2,10706,0,13645.0,4,13650.0,3,S
2018-04-23 09:20:20,13650.0,8,10714,2,13645.0,4,13655.0,9,S
2018-04-23 09:20:22,13650.0,4,10718,-4,13650.0,1,13655.0,1,S
2018-04-23 09:20:24,13650.0,2,10720,0,13650.0,1,13655.0,2,S
2018-04-23 09:20:25,13655.0,2,10722,0,13655.0,1,13660.0,8,B
2018-04-23 09:20:25,13650.0,8,10730,0,13650.0,5,13660.0,8,S
2018-04-23 09:20:28,13655.0,4,10734,0,13655.0,8,13660.0,7,B
2018-04-23 09:20:29,13655.0,16,10750,4,13650.0,4,13655.0,1,B
2018-04-23 09:20:30,13650.0,6,10756,4,13645.0,5,13655.0,5,S
2018-04-23 09:20:34,13655.0,2,10758,0,13650.0,6,13660.0,12,B
2018-04-23 09:20:36,13650.0,2,10760,2,13650.0,3,13660.0,16,S
2018-04-23 09:20:47,13650.0,8,10768,8,13650.0,10,13660.0,13,S
2018-04-23 09:20:50,13650.0,8,10776,8,13650.0,3,13655.0,6,S
2018-04-23 09:20:50,13650.0,6,10782,6,13645.0,8,13655.0,10,S
2018-04-23 09:20:52,13650.0,4,10786,4,13645.0,8,13650.0,1,S
2018-04-23 09:20:54,13650.0,2,10788,-2,13645.0,5,13650.0,82,S
2018-04-23 09:20:54,13645.0,14,10802,-14,13640.0,5,13650.0,82,S
2018-04-23 09:20:55,13650.0,8,10810,-4,13640.0,5,13650.0,82,B
2018-04-23 09:20:56,13645.0,4,10814,4,13640.0,6,13650.0,82,S
2018-04-23 09:20:57,13645.0,2,10816,0,13645.0,6,13650.0,85,S
2018-04-23 09:20:58,13645.0,2,10818,2,13645.0,5,13650.0,83,S
2018-04-23 09:21:01,13645.0,2,10820,0,13645.0,4,13650.0,84,S
2018-04-23 09:21:03,13645.0,10,10830,2,13640.0,6,13650.0,82,S
2018-04-23 09:21:06,13640.0,2,10832,0,13640.0,1,13645.0,1,S
2018-04-23 09:21:08,13640.0,2,10834,-2,13635.0,2,13645.0,6,S
2018-04-23 09:21:15,13645.0,2,10836,-2,13635.0,2,13645.0,6,B
2018-04-23 09:21:23,13635.0,6,10842,-6,13630.0,9,13640.0,6,S
2018-04-23 09:21:23,13640.0,2,10844,0,13630.0,9,13640.0,5,B
2018-04-23 09:21:25,13635.0,2,10846,0,13630.0,12,13635.0,3,S
2018-04-23 09:21:27,13635.0,4,10850,2,13630.0,9,13640.0,10,S
2018-04-23 09:21:29,13635.0,2,10852,-2,13630.0,14,13640.0,6,S
2018-04-23 09:21:31,13630.0,2,10854,0,13630.0,8,13635.0,8,S
2018-04-23 09:21:31,13635.0,2,10856,-2,13630.0,9,13635.0,6,B
2018-04-23 09:21:33,13630.0,2,10858,-2,13630.0,6,13635.0,2,S
2018-04-23 09:21:33,13635.0,4,10862,-4,13635.0,5,13640.0,7,B
2018-04-23 09:21:34,13630.0,14,10876,6,13630.0,10,13640.0,6,S
2018-04-23 09:21:36,13640.0,2,10878,0,13630.0,10,13640.0,9,B
2018-04-23 09:21:40,13635.0,2,10880,-2,13630.0,11,13640.0,6,S
2018-04-23 09:22:00,13630.0,4,10884,0,13630.0,11,13635.0,1,S
2018-04-23 09:22:03,13635.0,4,10888,2,13635.0,3,13640.0,3,B
2018-04-23 09:22:11,13635.0,8,10896,-8,13635.0,6,13640.0,1,B
2018-04-23 09:22:12,13635.0,6,10902,0,13635.0,5,13640.0,2,B
2018-04-23 09:22:12,13640.0,4,10906,2,13640.0,1,13645.0,9,B
2018-04-23 09:22:18,13640.0,8,10914,-4,13635.0,11,13640.0,6,B
2018-04-23 09:22:18,13640.0,12,10926,0,13640.0,1,13645.0,6,B
2018-04-23 09:22:23,13645.0,4,10930,-2,13640.0,7,13650.0,86,B
2018-04-23 09:22:24,13640.0,2,10932,0,13640.0,3,13645.0,3,S
2018-04-23 09:22:30,13645.0,2,10934,-2,13640.0,3,13645.0,5,B
2018-04-23 09:22:32,13645.0,4,10938,0,13640.0,4,13645.0,3,B
2018-04-23 09:22:35,13645.0,2,10940,2,13640.0,10,13645.0,2,B
2018-04-23 09:22:35,13645.0,4,10944,4,13645.0,2,13650.0,86,B
2018-04-23 09:22:36,13645.0,4,10948,0,13640.0,11,13650.0,86,B
2018-04-23 09:22:42,13645.0,2,10950,-2,13640.0,13,13650.0,86,B
2018-04-23 09:22:43,13645.0,2,10952,-2,13640.0,13,13650.0,86,B
2018-04-23 09:22:45,13645.0,2,10954,-2,13640.0,13,13645.0,1,B
2018-04-23 09:22:47,13640.0,20,10974,-8,13640.0,3,13645.0,1,S
2018-04-23 09:22:49,13640.0,2,10976,-2,13640.0,2,13645.0,1,S
2018-04-23 09:22:50,13640.0,4,10980,-4,13635.0,11,13640.0,1,S
2018-04-23 09:22:51,13640.0,2,10982,-2,13635.0,10,13645.0,9,S
2018-04-23 09:22:53,13635.0,2,10984,-2,13635.0,10,13645.0,9,S
2018-04-23 09:22:55,13645.0,14,10998,0,13635.0,10,13645.0,8,B
2018-04-23 09:22:57,13640.0,2,11000,0,13635.0,11,13645.0,7,S
2018-04-23 09:23:02,13645.0,2,11002,0,13645.0,11,13650.0,88,B
2018-04-23 09:23:05,13645.0,2,11004,2,13640.0,10,13645.0,1,B
2018-04-23 09:23:08,13640.0,12,11016,-10,13635.0,11,13640.0,1,S
2018-04-23 09:23:19,13645.0,10,11026,6,13635.0,9,13645.0,11,B
2018-04-23 09:23:22,13640.0,2,11028,0,13640.0,6,13645.0,2,S
2018-04-23 09:23:23,13645.0,2,11030,2,13640.0,9,13645.0,1,B
2018-04-23 09:23:24,13645.0,2,11032,0,13640.0,9,13645.0,2,B
2018-04-23 09:23:27,13640.0,16,11048,0,13640.0,1,13645.0,2,S
2018-04-23 09:23:30,13635.0,20,11068,-8,13635.0,8,13645.0,1,S
2018-04-23 09:23:31,13635.0,8,11076,0,13630.0,2,13635.0,6,S
2018-04-23 09:23:32,13635.0,12,11088,0,13635.0,2,13640.0,4,S
2018-04-23 09:23:32,13635.0,4,11092,0,13630.0,2,13640.0,7,S
2018-04-23 09:23:33,13630.0,6,11098,0,13625.0,9,13635.0,7,S
2018-04-23 09:23:39,13635.0,8,11106,4,13630.0,14,13640.0,7,B
2018-04-23 09:23:41,13630.0,2,11108,0,13630.0,18,13640.0,5,S
2018-04-23 09:23:42,13640.0,2,11110,0,13635.0,1,13640.0,2,B
2018-04-23 09:23:50,13640.0,2,11112,0,13630.0,18,13640.0,6,B
2018-04-23 09:23:57,13635.0,2,11114,2,13630.0,16,13640.0,8,S
2018-04-23 09:24:04,13635.0,2,11116,2,13630.0,24,13640.0,3,S
2018-04-23 09:24:16,13635.0,10,11126,0,13630.0,20,13635.0,5,S
2018-04-23 09:24:20,13635.0,10,11136,0,13635.0,2,13640.0,9,S
2018-04-23 09:24:21,13640.0,2,11138,0,13635.0,4,13640.0,7,B
2018-04-23 09:24:24,13635.0,6,11144,6,13630.0,22,13640.0,12,S
2018-04-23 09:24:31,13630.0,2,11146,0,13630.0,15,13640.0,14,S
2018-04-23 09:24:34,13630.0,12,11158,2,13630.0,3,13635.0,10,S
2018-04-23 09:24:35,13630.0,6,11164,0,13625.0,14,13630.0,4,S
2018-04-23 09:24:37,13625.0,20,11184,-8,13625.0,4,13630.0,3,S
2018-04-23 09:24:38,13625.0,2,11186,-2,13625.0,3,13630.0,3,S
2018-04-23 09:24:41,13625.0,20,11206,-8,13625.0,1,13630.0,8,S
2018-04-23 09:24:41,13625.0,2,11208,0,13625.0,1,13630.0,8,S
2018-04-23 09:24:42,13630.0,2,11210,-2,13625.0,1,13630.0,8,B
2018-04-23 09:24:44,13630.0,10,11220,4,13625.0,8,13630.0,1,B
2018-04-23 09:24:45,13630.0,2,11222,-2,13625.0,9,13635.0,8,B
2018-04-23 09:24:48,13625.0,2,11224,-2,13625.0,6,13635.0,10,S
2018-04-23 09:24:51,13625.0,2,11226,2,13630.0,10,13635.0,4,S
2018-04-23 09:24:54,13635.0,6,11232,6,13635.0,1,13640.0,8,B
2018-04-23 09:24:54,13640.0,16,11248,-10,13635.0,23,13645.0,6,B
2018-04-23 09:24:55,13645.0,2,11250,0,13640.0,6,13645.0,2,B
2018-04-23 09:24:55,13645.0,4,11254,0,13640.0,15,13650.0,88,B
2018-04-23 09:24:56,13645.0,2,11256,2,13640.0,10,13650.0,88,B
2018-04-23 09:24:58,13645.0,12,11268,12,13640.0,11,13645.0,2,B
2018-04-23 09:25:00,13640.0,2,11270,2,13640.0,1,13645.0,7,S
2018-04-23 09:25:00,13645.0,4,11274,-2,13635.0,12,13645.0,7,B
2018-04-23 09:25:04,13635.0,8,11282,8,13635.0,8,13640.0,5,S
2018-04-23 09:25:04,13635.0,4,11286,-2,13630.0,1,13635.0,1,S
2018-04-23 09:25:08,13630.0,2,11288,0,13625.0,1,13635.0,14,S
2018-04-23 09:25:09,13630.0,2,11290,0,13625.0,2,13630.0,5,S
2018-04-23 09:25:11,13625.0,2,11292,-2,13620.0,5,13625.0,3,S
2018-04-23 09:25:12,13625.0,2,11294,-2,13625.0,2,13630.0,4,S
2018-04-23 09:25:17,13630.0,2,11296,0,13625.0,2,13630.0,6,B
2018-04-23 09:25:18,13630.0,2,11298,0,13625.0,2,13630.0,5,B
2018-04-23 09:25:20,13630.0,10,11308,-4,13630.0,7,13635.0,9,B
2018-04-23 09:25:22,13635.0,10,11318,8,13635.0,1,13640.0,11,B
2018-04-23 09:25:22,13640.0,10,11328,0,13640.0,5,13645.0,5,B
2018-04-23 09:25:23,13640.0,10,11338,2,13635.0,9,13645.0,5,B
2018-04-23 09:25:24,13635.0,4,11342,0,13630.0,12,13635.0,1,S
2018-04-23 09:25:25,13635.0,8,11350,-2,13630.0,6,13640.0,22,S
2018-04-23 09:25:28,13640.0,2,11352,0,13630.0,8,13640.0,18,B
2018-04-23 09:25:30,13635.0,4,11356,0,13630.0,9,13635.0,2,S
2018-04-23 09:25:31,13635.0,800,12156,0,13630.0,6,13640.0,9,S
2018-04-23 09:25:31,13640.0,4,12160,-4,13635.0,1,13640.0,11,B
2018-04-23 09:25:32,13640.0,22,12182,10,13640.0,9,13645.0,22,B
2018-04-23 09:25:32,13640.0,22,12204,-4,13635.0,3,13645.0,22,B
2018-04-23 09:25:33,13640.0,4,12208,-4,13635.0,6,13645.0,4,B
2018-04-23 09:25:34,13640.0,2,12210,0,13635.0,2,13640.0,3,B
2018-04-23 09:25:37,13635.0,2,12212,-2,13630.0,10,13635.0,3,S
2018-04-23 09:25:39,13630.0,32,12244,-16,13625.0,4,13630.0,5,S
2018-04-23 09:25:40,13630.0,10,12254,-2,13630.0,2,13635.0,2,S
2018-04-23 09:25:40,13630.0,4,12258,0,13630.0,1,13635.0,3,S
2018-04-23 09:25:41,13630.0,4,12262,0,13630.0,1,13635.0,3,S
2018-04-23 09:25:41,13630.0,12,12274,0,13625.0,6,13635.0,3,S
2018-04-23 09:25:42,13630.0,2,12276,-2,13625.0,10,13635.0,6,S
2018-04-23 09:25:43,13625.0,14,12290,-8,13620.0,7,13625.0,63,S
2018-04-23 09:25:44,13620.0,14,12304,-8,13620.0,1,13625.0,63,S
2018-04-23 09:25:44,13620.0,8,12312,2,13620.0,4,13625.0,66,S
2018-04-23 09:25:45,13620.0,8,12320,0,13615.0,7,13625.0,66,S
2018-04-23 09:25:45,13620.0,2,12322,0,13620.0,2,13625.0,68,S
2018-04-23 09:25:46,13620.0,10,12332,-6,13615.0,12,13620.0,5,S
2018-04-23 09:25:47,13620.0,10,12342,-4,13620.0,1,13625.0,66,S
2018-04-23 09:25:47,13620.0,2,12344,0,13615.0,11,13620.0,3,S
2018-04-23 09:25:49,13615.0,2,12346,-2,13615.0,13,13620.0,5,S
2018-04-23 09:25:50,13615.0,2,12348,-2,13610.0,3,13615.0,3,S
2018-04-23 09:25:52,13615.0,10,12358,0,13615.0,2,13620.0,7,S
2018-04-23 09:25:52,13620.0,8,12366,6,13615.0,9,13625.0,67,B
2018-04-23 09:25:54,13625.0,2,12368,-2,13615.0,13,13625.0,66,B
2018-04-23 09:25:56,13620.0,100,12468,-40,13615.0,9,13620.0,20,S
2018-04-23 09:25:59,13620.0,6,12474,6,13615.0,8,13620.0,17,S
2018-04-23 09:26:00,13620.0,2,12476,2,13615.0,8,13620.0,16,S
2018-04-23 09:26:02,13615.0,2,12478,-2,13615.0,6,13620.0,16,S
2018-04-23 09:26:02,13615.0,14,12492,2,13610.0,15,13615.0,1,S
2018-04-23 09:26:03,13620.0,8,12500,4,13615.0,6,13620.0,16,B
2018-04-23 09:26:03,13615.0,2,12502,0,13615.0,5,13620.0,16,S
2018-04-23 09:26:04,13615.0,8,12510,-2,13610.0,14,13615.0,4,S
2018-04-23 09:26:07,13615.0,2,12512,0,13610.0,13,13615.0,6,S
2018-04-23 09:26:10,13610.0,14,12526,0,13610.0,5,13615.0,12,S
2018-04-23 09:26:10,13610.0,10,12536,10,13605.0,2,13615.0,14,S
2018-04-23 09:26:12,13610.0,2,12538,2,13605.0,9,13610.0,4,S
2018-04-23 09:26:13,13610.0,10,12548,2,13605.0,3,13610.0,4,S
2018-04-23 09:26:20,13605.0,4,12552,0,13605.0,2,13610.0,2,S
2018-04-23 09:26:27,13610.0,2,12554,0,13605.0,2,13610.0,3,B
2018-04-23 09:26:28,13605.0,2,12556,2,13600.0,12,13610.0,3,S
2018-04-23 09:26:30,13605.0,4,12560,0,13600.0,15,13610.0,12,S
2018-04-23 09:26:34,13605.0,4,12564,-4,13605.0,16,13610.0,6,S
2018-04-23 09:26:34,13610.0,2,12566,0,13605.0,16,13610.0,1,B
2018-04-23 09:26:36,13610.0,4,12570,0,13605.0,16,13615.0,18,B
2018-04-23 09:26:39,13615.0,4,12574,4,13605.0,24,13615.0,17,B
2018-04-23 09:26:40,13605.0,4,12578,-4,13605.0,22,13615.0,17,S
2018-04-23 09:26:51,13610.0,2,12580,-2,13605.0,21,13615.0,13,B
2018-04-23 09:27:02,13615.0,10,12590,-8,13610.0,9,13620.0,22,B
2018-04-23 09:27:09,13615.0,2,12592,0,13610.0,4,13615.0,19,B
2018-04-23 09:27:13,13615.0,8,12600,0,13610.0,121,13615.0,23,B
2018-04-23 09:27:17,13615.0,8,12608,-8,13610.0,121,13615.0,17,B
2018-04-23 09:27:23,13615.0,2,12610,0,13610.0,121,13615.0,18,B
2018-04-23 09:27:24,13615.0,42,12652,36,13610.0,101,13615.0,17,B
2018-04-23 09:27:32,13615.0,4,12656,0,13610.0,101,13615.0,11,B
2018-04-23 09:27:38,13615.0,20,12676,4,13610.0,101,13615.0,1,B
2018-04-23 09:27:38,13615.0,2,12678,-2,13610.0,101,13620.0,37,B
2018-04-23 09:27:45,13615.0,2,12680,0,13610.0,101,13615.0,19,B
2018-04-23 09:27:47,13615.0,38,12718,0,13615.0,1,13620.0,31,B
2018-04-23 09:27:48,13615.0,4,12722,-2,13615.0,3,13620.0,31,B
2018-04-23 09:27:51,13620.0,40,12762,34,13615.0,3,13620.0,11,B
2018-04-23 09:27:55,13615.0,2,12764,-2,13615.0,2,13620.0,13,S
2018-04-23 09:27:57,13615.0,2,12766,-2,13615.0,2,13620.0,13,S
2018-04-23 09:28:01,13620.0,24,12790,12,13620.0,1,13625.0,17,B
2018-04-23 09:28:04,13625.0,2,12792,2,13620.0,6,13625.0,3,B
2018-04-23 09:28:09,13620.0,2,12794,-2,13620.0,5,13625.0,3,S
2018-04-23 09:28:11,13625.0,4,12798,2,13625.0,18,13630.0,35,B
2018-04-23 09:28:12,13630.0,48,12846,-36,13625.0,25,13630.0,7,B
2018-04-23 09:28:13,13630.0,14,12860,0,13625.0,27,13635.0,13,B
2018-04-23 09:28:13,13630.0,4,12864,0,13625.0,27,13630.0,1,B
2018-04-23 09:28:15,13635.0,4,12868,0,13630.0,5,13635.0,9,B
2018-04-23 09:28:16,13630.0,2,12870,-2,13630.0,4,13635.0,9,S
2018-04-23 09:28:16,13630.0,2,12872,-2,13630.0,3,13635.0,9,S
2018-04-23 09:28:31,13635.0,6,12878,-6,13630.0,17,13635.0,5,B
2018-04-23 09:28:32,13635.0,8,12886,-8,13630.0,17,13635.0,1,B
2018-04-23 09:28:32,13635.0,2,12888,0,13635.0,23,13640.0,5,B
2018-04-23 09:28:36,13640.0,12,12900,4,13640.0,8,13645.0,17,B
2018-04-23 09:28:37,13640.0,14,12914,2,13640.0,1,13645.0,19,B
2018-04-23 09:28:37,13640.0,2,12916,0,13635.0,15,13640.0,2,B
2018-04-23 09:28:39,13640.0,2,12918,2,13635.0,19,13645.0,17,B
2018-04-23 09:28:41,13640.0,2,12920,-2,13635.0,20,13640.0,2,B
2018-04-23 09:28:42,13640.0,2,12922,2,13635.0,20,13640.0,1,B
2018-04-23 09:28:43,13635.0,30,12952,24,13630.0,6,13635.0,8,S
2018-04-23 09:28:48,13635.0,2,12954,0,13630.0,9,13635.0,2,S
2018-04-23 09:28:50,13635.0,2,12956,2,13630.0,9,13635.0,1,S
2018-04-23 09:28:56,13635.0,2,12958,0,13630.0,9,13640.0,7,S
2018-04-23 09:29:07,13645.0,14,12972,-6,13640.0,20,13650.0,2,B
2018-04-23 09:29:15,13650.0,6,12978,4,13650.0,2,13655.0,8,B
2018-04-23 09:29:15,13655.0,8,12986,0,13650.0,14,13655.0,1,B
2018-04-23 09:29:16,13655.0,2,12988,-2,13650.0,14,13660.0,2,B
2018-04-23 09:29:17,13655.0,4,12992,4,13650.0,7,13655.0,3,B
2018-04-23 09:29:18,13650.0,8,13000,4,13650.0,7,13655.0,3,S
2018-04-23 09:29:19,13650.0,12,13012,-10,13645.0,16,13655.0,3,S
2018-04-23 09:29:24,13655.0,2,13014,-2,13650.0,9,13655.0,7,B
2018-04-23 09:29:25,13655.0,4,13018,-2,13650.0,11,13655.0,5,B
2018-04-23 09:29:27,13655.0,2,13020,2,13650.0,10,13655.0,4,B
2018-04-23 09:29:27,13650.0,2,13022,0,13650.0,7,13655.0,4,S
2018-04-23 09:29:30,13650.0,10,13032,6,13650.0,2,13655.0,4,S
2018-04-23 09:29:31,13650.0,2,13034,0,13645.0,9,13655.0,6,S
2018-04-23 09:29:34,13650.0,2,13036,0,13645.0,9,13655.0,10,S
2018-04-23 09:29:34,13645.0,24,13060,8,13640.0,6,13645.0,18,S
2018-04-23 09:29:35,13645.0,8,13068,8,13640.0,12,13645.0,14,S
2018-04-23 09:29:35,13645.0,4,13072,4,13640.0,11,13645.0,14,S
2018-04-23 09:29:36,13645.0,30,13102,26,13640.0,5,13650.0,4,S
2018-04-23 09:29:39,13650.0,2,13104,2,13650.0,2,13655.0,9,B
2018-04-23 09:29:41,13655.0,10,13114,8,13650.0,4,13655.0,3,B
2018-04-23 09:29:41,13655.0,4,13118,0,13650.0,12,13660.0,12,B
2018-04-23 09:29:42,13655.0,2,13120,0,13650.0,4,13655.0,1,B
2018-04-23 09:29:43,13650.0,6,13126,4,13650.0,4,13660.0,15,S
2018-04-23 09:29:46,13660.0,4,13130,0,13655.0,3,13660.0,5,B
2018-04-23 09:29:49,13660.0,4,13134,4,13655.0,6,13660.0,4,B
2018-04-23 09:29:49,13655.0,10,13144,8,13655.0,5,13665.0,5,S
2018-04-23 09:29:50,13655.0,2,13146,2,13660.0,1,13665.0,2,S
2018-04-23 09:29:50,13660.0,4,13150,2,13655.0,13,13665.0,2,B
2018-04-23 09:29:51,13660.0,4,13154,-4,13660.0,1,13665.0,12,B
2018-04-23 09:29:51,13660.0,2,13156,0,13655.0,5,13660.0,1,B
2018-04-23 09:29:54,13660.0,2,13158,0,13655.0,7,13665.0,12,B
2018-04-23 09:29:55,13660.0,4,13162,-4,13655.0,7,13665.0,13,B
2018-04-23 09:29:55,13655.0,2,13164,0,13655.0,6,13660.0,1,S
2018-04-23 09:29:57,13660.0,2,13166,-2,13660.0,2,13665.0,12,B
2018-04-23 09:29:58,13660.0,4,13170,-4,13655.0,4,13660.0,1,B
2018-04-23 09:29:58,13660.0,2,13172,0,13660.0,1,13665.0,7,B
2018-04-23 09:29:59,13660.0,4,13176,4,13655.0,11,13665.0,4,B
2018-04-23 09:30:02,13660.0,4,13180,-4,13660.0,3,13665.0,16,B
2018-04-23 09:30:02,13660.0,10,13190,-6,13655.0,2,13660.0,3,B
2018-04-23 09:30:04,13660.0,4,13194,-4,13655.0,3,13660.0,3,B
2018-04-23 09:30:05,13655.0,10,13204,4,13650.0,3,13660.0,17,S
2018-04-23 09:30:06,13655.0,12,13216,0,13645.0,3,13655.0,8,S
2018-04-23 09:30:08,13650.0,2,13218,0,13645.0,3,13650.0,1,S
2018-04-23 09:30:08,13650.0,2,13220,0,13650.0,7,13655.0,3,S
2018-04-23 09:30:10,13655.0,2,13222,2,13655.0,14,13660.0,18,B
2018-04-23 09:30:11,13655.0,28,13250,0,13650.0,4,13655.0,13,B
2018-04-23 09:30:15,13650.0,2,13252,-2,13650.0,2,13655.0,22,S
2018-04-23 09:30:15,13650.0,4,13256,0,13645.0,2,13650.0,1,S
2018-04-23 09:30:16,13640.0,2,13258,-2,13640.0,3,13650.0,9,S
2018-04-23 09:30:16,13650.0,2,13260,0,13640.0,6,13650.0,12,B
2018-04-23 09:30:19,13645.0,2,13262,0,13640.0,6,13645.0,1,S
2018-04-23 09:30:19,13640.0,2,13264,-2,13640.0,5,13645.0,3,S
2018-04-23 09:30:20,13640.0,2,13266,0,13640.0,2,13645.0,14,S
2018-04-23 09:30:21,13640.0,4,13270,-4,13635.0,9,13645.0,14,S
2018-04-23 09:30:22,13640.0,2,13272,-2,13640.0,5,13645.0,6,S
2018-04-23 09:30:22,13640.0,2,13274,0,13640.0,2,13645.0,6,S
2018-04-23 09:30:23,13640.0,2,13276,0,13640.0,1,13645.0,6,S
2018-04-23 09:30:24,13640.0,2,13278,-2,13635.0,10,13640.0,4,S
2018-04-23 09:30:28,13635.0,20,13298,0,13630.0,12,13640.0,5,S
2018-04-23 09:30:29,13630.0,2,13300,0,13630.0,11,13640.0,10,S
2018-04-23 09:30:31,13630.0,2,13302,0,13630.0,10,13635.0,1,S
2018-04-23 09:30:33,13630.0,2,13304,0,13630.0,9,13635.0,1,S
2018-04-23 09:30:36,13630.0,2,13306,0,13630.0,8,13635.0,1,S
2018-04-23 09:30:38,13630.0,20,13326,-2,13625.0,20,13635.0,12,S
2018-04-23 09:30:43,13630.0,4,13330,-4,13625.0,20,13635.0,20,S
2018-04-23 09:30:43,13625.0,2,13332,0,13625.0,19,13635.0,20,S
2018-04-23 09:30:53,13625.0,4,13336,-2,13625.0,19,13630.0,6,S
2018-04-23 09:30:54,13630.0,6,13342,6,13625.0,19,13630.0,2,B
2018-04-23 09:30:55,13625.0,6,13348,6,13625.0,16,13630.0,2,S
2018-04-23 09:30:57,13625.0,2,13350,0,13625.0,15,13630.0,2,S
2018-04-23 09:30:58,13630.0,2,13352,0,13625.0,14,13630.0,1,B
2018-04-23 09:31:04,13635.0,2,13354,-2,13630.0,6,13640.0,15,B
2018-04-23 09:31:05,13630.0,6,13360,-6,13625.0,14,13630.0,1,S
2018-04-23 09:31:06,13630.0,4,13364,2,13625.0,14,13630.0,3,S
2018-04-23 09:31:10,13630.0,4,13368,0,13625.0,13,13630.0,2,S
2018-04-23 09:31:11,13625.0,4,13372,2,13625.0,11,13630.0,2,S
2018-04-23 09:31:12,13625.0,2,13374,0,13625.0,10,13630.0,13,S
2018-04-23 09:31:12,13625.0,18,13392,8,13625.0,2,13630.0,16,S
2018-04-23 09:31:13,13625.0,4,13396,0,13620.0,2,13625.0,1,S
2018-04-23 09:31:17,13620.0,4,13400,-2,13615.0,4,13620.0,1,S
2018-04-23 09:31:18,13615.0,4,13404,-2,13615.0,2,13620.0,1,S
2018-04-23 09:31:19,13615.0,2,13406,0,13615.0,1,13620.0,1,S
2018-04-23 09:31:20,13615.0,2,13408,-2,13615.0,2,13625.0,17,S
2018-04-23 09:31:23,13625.0,2,13410,-2,13620.0,7,13625.0,2,B
2018-04-23 09:31:24,13625.0,2,13412,0,13620.0,7,13625.0,1,B
2018-04-23 09:31:25,13620.0,2,13414,0,13620.0,4,13625.0,2,S
2018-04-23 09:31:32,13620.0,10,13424,-4,13620.0,3,13625.0,11,S
2018-04-23 09:31:32,13620.0,2,13426,0,13620.0,3,13625.0,11,S
2018-04-23 09:31:33,13620.0,2,13428,0,13620.0,2,13625.0,9,S
2018-04-23 09:31:34,13620.0,2,13430,0,13620.0,1,13625.0,9,S
2018-04-23 09:31:35,13620.0,2,13432,-2,13620.0,1,13625.0,9,S
2018-04-23 09:31:36,13620.0,2,13434,0,13620.0,1,13625.0,9,S
2018-04-23 09:31:37,13620.0,2,13436,0,13615.0,11,13625.0,9,S
2018-04-23 09:31:41,13620.0,34,13470,14,13620.0,2,13625.0,9,S
2018-04-23 09:31:42,13625.0,6,13476,-4,13625.0,1,13630.0,10,B
2018-04-23 09:31:45,13630.0,2,13478,0,13625.0,2,13630.0,6,B
2018-04-23 09:31:48,13630.0,6,13484,4,13620.0,46,13630.0,2,B
2018-04-23 09:31:51,13620.0,2,13486,0,13620.0,45,13630.0,5,S
2018-04-23 09:31:52,13620.0,2,13488,-2,13620.0,13,13625.0,1,S
2018-04-23 09:31:53,13620.0,2,13490,-2,13620.0,12,13630.0,16,S
2018-04-23 09:31:54,13620.0,2,13492,-2,13620.0,11,13630.0,16,S
2018-04-23 09:31:55,13620.0,2,13494,-2,13620.0,10,13630.0,16,S
2018-04-23 09:31:55,13620.0,2,13496,-2,13620.0,10,13630.0,16,S
2018-04-23 09:32:02,13630.0,6,13502,0,13620.0,16,13630.0,3,B
2018-04-23 09:32:08,13630.0,6,13508,4,13630.0,2,13635.0,12,B
2018-04-23 09:32:09,13630.0,10,13518,-2,13625.0,2,13630.0,6,B
2018-04-23 09:32:10,13620.0,4,13522,-4,13620.0,13,13630.0,1,S
2018-04-23 09:32:13,13630.0,4,13526,0,13625.0,4,13635.0,18,B
2018-04-23 09:32:13,13630.0,2,13528,0,13625.0,13,13635.0,2,B
2018-04-23 09:32:19,13625.0,2,13530,0,13625.0,3,13630.0,1,S
2018-04-23 09:32:20,13625.0,2,13532,0,13625.0,1,13630.0,1,S
2018-04-23 09:32:20,13625.0,2,13534,0,13620.0,8,13630.0,3,S
2018-04-23 09:32:26,13630.0,2,13536,-2,13620.0,10,13630.0,4,B
2018-04-23 09:32:35,13620.0,2,13538,-2,13620.0,10,13630.0,7,S
2018-04-23 09:32:36,13620.0,2,13540,-2,13620.0,9,13630.0,7,S
2018-04-23 09:32:37,13620.0,2,13542,0,13620.0,8,13630.0,8,S
2018-04-23 09:32:38,13620.0,2,13544,-2,13620.0,6,13630.0,8,S
2018-04-23 09:32:39,13620.0,2,13546,-2,13620.0,8,13630.0,9,S
2018-04-23 09:32:39,13620.0,2,13548,-2,13620.0,3,13630.0,21,S
2018-04-23 09:32:40,13630.0,2,13550,2,13620.0,3,13630.0,24,B
2018-04-23 09:32:40,13620.0,2,13552,-2,13620.0,4,13630.0,25,S
2018-04-23 09:32:41,13620.0,2,13554,0,13620.0,12,13630.0,9,S
2018-04-23 09:32:46,13625.0,4,13558,0,13620.0,7,13625.0,1,B
2018-04-23 09:32:48,13620.0,2,13560,-2,13615.0,12,13625.0,13,S
2018-04-23 09:32:50,13625.0,2,13562,-2,13615.0,14,13625.0,11,B
2018-04-23 09:32:55,13625.0,2,13564,2,13615.0,15,13625.0,12,B
2018-04-23 09:32:56,13620.0,2,13566,0,13620.0,1,13625.0,9,S
2018-04-23 09:32:57,13620.0,2,13568,-2,13615.0,13,13620.0,2,S
2018-04-23 09:33:01,13615.0,6,13574,0,13610.0,14,13620.0,18,S
2018-04-23 09:33:01,13610.0,2,13576,0,13610.0,8,13620.0,17,S
2018-04-23 09:33:03,13615.0,2,13578,0,13615.0,33,13620.0,18,B
2018-04-23 09:33:05,13620.0,2,13580,0,13615.0,33,13620.0,17,B
2018-04-23 09:33:09,13620.0,2,13582,-2,13615.0,33,13620.0,14,B
2018-04-23 09:33:10,13620.0,4,13586,-4,13615.0,33,13620.0,12,B
2018-04-23 09:33:13,13620.0,2,13588,0,13615.0,33,13620.0,11,B
2018-04-23 09:33:18,13620.0,22,13610,0,13620.0,1,13625.0,6,B
2018-04-23 09:33:25,13620.0,2,13612,0,13620.0,8,13625.0,3,B
2018-04-23 09:33:26,13630.0,20,13632,4,13620.0,12,13635.0,23,B
2018-04-23 09:33:33,13620.0,2,13634,0,13620.0,10,13625.0,7,S
2018-04-23 09:33:34,13620.0,2,13636,0,13620.0,9,13625.0,7,S
2018-04-23 09:33:35,13620.0,2,13638,0,13620.0,8,13625.0,7,S
2018-04-23 09:33:36,13620.0,2,13640,0,13620.0,7,13625.0,7,S
2018-04-23 09:33:37,13620.0,2,13642,0,13620.0,6,13625.0,7,S
2018-04-23 09:33:37,13620.0,2,13644,0,13620.0,5,13625.0,7,S
2018-04-23 09:33:38,13620.0,2,13646,0,13620.0,3,13625.0,7,S
2018-04-23 09:33:42,13620.0,6,13652,-4,13615.0,9,13625.0,8,S
2018-04-23 09:33:45,13625.0,2,13654,0,13615.0,12,13625.0,13,B
2018-04-23 09:33:51,13615.0,10,13664,-6,13615.0,9,13625.0,13,S
2018-04-23 09:33:56,13615.0,10,13674,-2,13615.0,6,13625.0,15,S
2018-04-23 09:34:04,13615.0,12,13686,0,13610.0,7,13615.0,9,S
2018-04-23 09:34:05,13615.0,18,13704,-4,13615.0,24,13620.0,2,S
2018-04-23 09:34:18,13620.0,4,13708,0,13615.0,18,13625.0,16,B
2018-04-23 09:34:23,13620.0,2,13710,0,13615.0,20,13625.0,17,B
2018-04-23 09:34:38,13620.0,2,13712,0,13620.0,2,13625.0,3,B
2018-04-23 09:34:56,13620.0,2,13714,0,13615.0,9,13625.0,17,B
2018-04-23 09:35:00,13615.0,32,13746,16,13610.0,5,13620.0,14,S
2018-04-23 09:35:01,13620.0,10,13756,0,13610.0,13,13620.0,9,B
2018-04-23 09:35:02,13620.0,18,13774,8,13610.0,14,13620.0,1,B
2018-04-23 09:35:03,13615.0,2,13776,-2,13610.0,16,13620.0,5,S
2018-04-23 09:35:06,13615.0,2,13778,-2,13615.0,1,13620.0,5,S
2018-04-23 09:35:06,13615.0,2,13780,-2,13615.0,3,13620.0,5,S
2018-04-23 09:35:07,13615.0,4,13784,0,13615.0,1,13620.0,5,S
2018-04-23 09:35:07,13615.0,2,13786,2,13610.0,17,13620.0,5,S
2018-04-23 09:35:10,13615.0,2,13788,0,13610.0,21,13615.0,1,S
2018-04-23 09:35:11,13615.0,2,13790,0,13615.0,1,13620.0,6,S
2018-04-23 09:35:11,13615.0,2,13792,0,13615.0,11,13620.0,2,S
2018-04-23 09:35:15,13615.0,2,13794,0,13610.0,12,13620.0,8,S
2018-04-23 09:35:17,13610.0,4,13798,-2,13605.0,26,13615.0,15,S
2018-04-23 09:35:18,13615.0,6,13804,0,13605.0,31,13615.0,13,B
2018-04-23 09:35:25,13605.0,10,13814,-10,13605.0,28,13615.0,15,S
2018-04-23 09:35:33,13610.0,6,13820,6,13610.0,2,13615.0,14,B
2018-04-23 09:35:37,13610.0,2,13822,0,13610.0,1,13615.0,14,B
2018-04-23 09:35:38,13610.0,2,13824,0,13605.0,28,13610.0,2,B
2018-04-23 09:35:40,13605.0,4,13828,-4,13605.0,21,13610.0,13,S
2018-04-23 09:35:40,13605.0,2,13830,-2,13605.0,20,13610.0,13,S
2018-04-23 09:35:43,13605.0,4,13834,-4,13605.0,18,13610.0,11,S
2018-04-23 09:35:46,13605.0,4,13838,-4,13605.0,16,13610.0,10,S
2018-04-23 09:35:47,13605.0,4,13842,0,13605.0,14,13610.0,10,S
2018-04-23 09:35:48,13605.0,4,13846,0,13605.0,12,13610.0,10,S
2018-04-23 09:35:49,13605.0,4,13850,0,13605.0,10,13610.0,10,S
2018-04-23 09:35:49,13605.0,20,13870,16,13600.0,30,13605.0,1,S
2018-04-23 09:35:54,13605.0,12,13882,-4,13600.0,38,13610.0,14,S
2018-04-23 09:35:56,13605.0,6,13888,0,13600.0,38,13605.0,17,S
2018-04-23 09:36:00,13605.0,12,13900,12,13600.0,41,13605.0,11,S
2018-04-23 09:36:01,13605.0,22,13922,18,13600.0,41,13610.0,8,S
2018-04-23 09:36:05,13605.0,2,13924,2,13605.0,22,13615.0,11,S
2018-04-23 09:36:13,13615.0,6,13930,0,13605.0,23,13615.0,8,B
2018-04-23 09:36:17,13615.0,4,13934,4,13605.0,24,13615.0,7,B
2018-04-23 09:36:36,13610.0,4,13938,-2,13610.0,2,13615.0,7,S
2018-04-23 09:36:36,13610.0,2,13940,-2,13610.0,1,13615.0,6,S
2018-04-23 09:36:37,13610.0,2,13942,-2,13605.0,24,13610.0,1,S
2018-04-23 09:36:37,13610.0,2,13944,0,13605.0,24,13615.0,7,S
2018-04-23 09:36:49,13610.0,4,13948,0,13605.0,25,13615.0,6,S
2018-04-23 09:36:54,13610.0,2,13950,2,13605.0,25,13615.0,7,S
2018-04-23 09:37:00,13610.0,2,13952,0,13610.0,1,13615.0,6,S
2018-04-23 09:37:01,13610.0,2,13954,-2,13605.0,25,13615.0,6,S
2018-04-23 09:37:07,13615.0,2,13956,2,13605.0,27,13615.0,6,B
2018-04-23 09:37:40,13615.0,18,13974,-2,13610.0,26,13620.0,7,B
2018-04-23 09:37:48,13615.0,4,13978,0,13610.0,23,13620.0,11,B
2018-04-23 09:38:14,13615.0,2,13980,0,13610.0,23,13620.0,8,B
2018-04-23 09:38:19,13610.0,2,13982,0,13610.0,22,13620.0,8,S
2018-04-23 09:38:23,13610.0,2,13984,0,13610.0,21,13620.0,8,S
2018-04-23 09:38:33,13610.0,2,13986,0,13610.0,2,13615.0,5,S
2018-04-23 09:38:39,13610.0,4,13990,0,13605.0,18,13610.0,8,S
2018-04-23 09:38:42,13610.0,4,13994,-4,13605.0,21,13610.0,7,S
2018-04-23 09:39:01,13605.0,14,14008,-4,13600.0,30,13610.0,12,S
2018-04-23 09:39:04,13610.0,2,14010,0,13600.0,35,13610.0,11,B
2018-04-23 09:39:14,13605.0,8,14018,-8,13600.0,22,13605.0,7,S
2018-04-23 09:39:15,13600.0,2,14020,0,13600.0,21,13605.0,8,S
2018-04-23 09:39:15,13600.0,2,14022,0,13600.0,21,13605.0,6,S
2018-04-23 09:39:16,13600.0,2,14024,0,13600.0,20,13605.0,6,S
2018-04-23 09:39:16,13600.0,2,14026,-2,13600.0,19,13605.0,5,S
2018-04-23 09:39:17,13600.0,2,14028,0,13600.0,18,13605.0,5,S
2018-04-23 09:39:18,13600.0,2,14030,0,13600.0,17,13605.0,5,S
2018-04-23 09:39:20,13600.0,4,14034,0,13600.0,15,13605.0,5,S
2018-04-23 09:39:20,13600.0,2,14036,0,13600.0,14,13605.0,6,S
2018-04-23 09:39:21,13600.0,2,14038,0,13600.0,13,13605.0,6,S
2018-04-23 09:39:21,13600.0,6,14044,4,13600.0,10,13605.0,6,S
2018-04-23 09:39:22,13605.0,6,14050,-2,13600.0,9,13605.0,4,B
2018-04-23 09:39:22,13600.0,2,14052,0,13600.0,8,13605.0,5,S
2018-04-23 09:39:23,13600.0,4,14056,0,13600.0,6,13605.0,5,S
2018-04-23 09:39:23,13600.0,2,14058,0,13600.0,5,13605.0,4,S
2018-04-23 09:39:24,13600.0,2,14060,0,13600.0,5,13605.0,4,S
2018-04-23 09:39:24,13600.0,2,14062,-2,13600.0,4,13605.0,4,S
2018-04-23 09:39:25,13600.0,2,14064,-2,13600.0,3,13605.0,4,S
2018-04-23 09:39:25,13600.0,2,14066,-2,13600.0,1,13605.0,4,S
2018-04-23 09:39:26,13600.0,2,14068,-2,13600.0,1,13605.0,4,S
2018-04-23 09:39:27,13600.0,2,14070,2,13595.0,18,13600.0,1,S
2018-04-23 09:39:28,13600.0,2,14072,-2,13595.0,20,13605.0,5,S
2018-04-23 09:39:34,13600.0,2,14074,0,13600.0,2,13605.0,6,S
2018-04-23 09:39:35,13605.0,4,14078,4,13605.0,9,13610.0,8,B
2018-04-23 09:39:36,13605.0,14,14092,0,13605.0,23,13610.0,2,B
2018-04-23 09:39:41,13600.0,2,14094,-2,13600.0,14,13610.0,12,S
2018-04-23 09:39:43,13610.0,4,14098,-4,13600.0,14,13610.0,9,B
2018-04-23 09:39:48,13605.0,2,14100,0,13605.0,2,13610.0,9,S
2018-04-23 09:39:49,13605.0,2,14102,0,13605.0,1,13610.0,8,S
2018-04-23 09:39:50,13605.0,2,14104,0,13600.0,15,13610.0,8,S
2018-04-23 09:40:05,13610.0,2,14106,2,13605.0,19,13615.0,5,B
2018-04-23 09:40:09,13605.0,2,14108,-2,13600.0,15,13610.0,5,S
2018-04-23 09:40:17,13610.0,4,14112,-4,13600.0,11,13610.0,15,B
2018-04-23 09:40:19,13610.0,2,14114,0,13600.0,11,13610.0,14,B
2018-04-23 09:40:23,13610.0,4,14118,-2,13610.0,2,13615.0,13,B
2018-04-23 09:40:23,13610.0,4,14122,0,13605.0,26,13610.0,1,B
2018-04-23 09:40:24,13610.0,2,14124,0,13605.0,26,13615.0,13,B
2018-04-23 09:40:26,13610.0,2,14126,-2,13610.0,3,13615.0,13,B
2018-04-23 09:40:27,13610.0,2,14128,-2,13610.0,2,13615.0,12,B
2018-04-23 09:40:28,13610.0,2,14130,0,13610.0,1,13615.0,12,B
2018-04-23 09:40:44,13610.0,2,14132,0,13605.0,26,13615.0,9,B
2018-04-23 09:40:59,13610.0,4,14136,-4,13600.0,16,13610.0,13,B
2018-04-23 09:41:05,13600.0,32,14168,18,13595.0,12,13600.0,11,S
2018-04-23 09:41:05,13600.0,22,14190,14,13600.0,1,13605.0,1,S
2018-04-23 09:41:09,13600.0,16,14206,0,13595.0,13,13600.0,12,S
2018-04-23 09:41:09,13600.0,22,14228,-6,13595.0,17,13600.0,1,S
2018-04-23 09:41:10,13600.0,2,14230,0,13600.0,1,13605.0,4,S
2018-04-23 09:41:19,13600.0,2,14232,2,13600.0,12,13605.0,3,S
2018-04-23 09:41:19,13605.0,4,14236,0,13600.0,12,13605.0,1,B
2018-04-23 09:41:20,13605.0,2,14238,2,13600.0,12,13610.0,8,B
2018-04-23 09:41:25,13610.0,16,14254,-6,13610.0,14,13615.0,13,B
2018-04-23 09:41:25,13610.0,20,14274,-16,13610.0,4,13615.0,17,B
2018-04-23 09:41:26,13610.0,8,14282,-8,13605.0,1,13610.0,7,B
2018-04-23 09:41:26,13610.0,2,14284,-2,13600.0,13,13610.0,7,B
2018-04-23 09:41:27,13600.0,2,14286,0,13600.0,16,13610.0,6,S
2018-04-23 09:41:35,13610.0,6,14292,0,13605.0,15,13615.0,5,B
2018-04-23 09:41:37,13610.0,2,14294,0,13605.0,14,13615.0,4,B
2018-04-23 09:41:40,13615.0,2,14296,-2,13610.0,5,13620.0,8,B
2018-04-23 09:41:43,13615.0,16,14312,-2,13610.0,11,13615.0,1,B
2018-04-23 09:41:57,13610.0,4,14316,4,13605.0,7,13610.0,3,S
2018-04-23 09:42:02,13610.0,10,14326,6,13605.0,11,13610.0,1,S
2018-04-23 09:42:02,13610.0,2,14328,0,13610.0,11,13615.0,1,S
2018-04-23 09:42:03,13615.0,2,14330,-2,13610.0,19,13620.0,11,B
2018-04-23 09:42:06,13620.0,12,14342,4,13610.0,23,13620.0,5,B
2018-04-23 09:42:10,13620.0,2,14344,0,13610.0,22,13620.0,8,B
2018-04-23 09:42:21,13615.0,6,14350,6,13610.0,19,13615.0,2,S
2018-04-23 09:42:22,13615.0,4,14354,0,13610.0,19,13620.0,8,S
2018-04-23 09:42:54,13615.0,12,14366,8,13610.0,15,13620.0,9,S
2018-04-23 09:42:58,13610.0,12,14378,-2,13605.0,20,13615.0,11,S
2018-04-23 09:43:00,13615.0,2,14380,0,13605.0,30,13615.0,14,B
2018-04-23 09:43:14,13620.0,22,14402,-6,13615.0,11,13625.0,32,B
2018-04-23 09:43:22,13620.0,20,14422,-8,13620.0,4,13625.0,37,B
2018-04-23 09:43:23,13620.0,2,14424,-2,13620.0,3,13625.0,35,B
2018-04-23 09:43:24,13620.0,6,14430,-6,13615.0,9,13625.0,35,B
2018-04-23 09:43:25,13620.0,2,14432,0,13615.0,11,13620.0,5,B
2018-04-23 09:43:31,13615.0,2,14434,0,13615.0,9,13620.0,5,S
2018-04-23 09:43:32,13615.0,2,14436,0,13615.0,8,13620.0,5,S
2018-04-23 09:43:33,13615.0,2,14438,0,13615.0,7,13620.0,5,S
2018-04-23 09:43:33,13615.0,2,14440,0,13615.0,6,13620.0,5,S
2018-04-23 09:43:34,13615.0,2,14442,0,13615.0,5,13620.0,5,S
2018-04-23 09:43:34,13615.0,2,14444,2,13615.0,4,13620.0,5,S
2018-04-23 09:43:42,13615.0,2,14446,0,13615.0,5,13620.0,5,S
2018-04-23 09:43:47,13615.0,12,14458,-6,13610.0,3,13615.0,4,S
2018-04-23 09:43:48,13615.0,2,14460,0,13610.0,14,13615.0,3,S
2018-04-23 09:43:48,13615.0,6,14466,-2,13610.0,17,13620.0,9,S
2018-04-23 09:43:50,13615.0,8,14474,-4,13610.0,15,13615.0,6,S
2018-04-23 09:43:56,13615.0,2,14476,0,13610.0,18,13615.0,5,S
2018-04-23 09:44:03,13615.0,10,14486,-2,13615.0,11,13620.0,9,S
2018-04-23 09:44:33,13615.0,4,14490,-2,13610.0,5,13615.0,7,S
2018-04-23 09:44:38,13610.0,4,14494,0,13605.0,17,13610.0,8,S
2018-04-23 09:44:38,13610.0,16,14510,-2,13605.0,32,13615.0,6,S
2018-04-23 09:44:39,13615.0,2,14512,0,13610.0,1,13615.0,8,B
2018-04-23 09:44:40,13610.0,20,14532,-4,13610.0,8,13620.0,21,S
2018-04-23 09:44:44,13610.0,4,14536,0,13605.0,25,13615.0,11,S
2018-04-23 09:44:45,13610.0,2,14538,0,13610.0,1,13615.0,17,S
2018-04-23 09:44:46,13610.0,2,14540,0,13605.0,25,13615.0,17,S
2018-04-23 09:45:15,13620.0,2,14542,0,13615.0,2,13620.0,15,B
2018-04-23 09:45:23,13620.0,2,14544,0,13615.0,5,13620.0,13,B
2018-04-23 09:45:24,13620.0,4,14548,0,13615.0,6,13620.0,12,B
2018-04-23 09:45:27,13620.0,2,14550,0,13615.0,6,13620.0,11,B
2018-04-23 09:45:27,13615.0,2,14552,2,13615.0,5,13620.0,11,S
2018-04-23 09:45:36,13615.0,12,14564,6,13615.0,2,13620.0,11,S
2018-04-23 09:45:37,13615.0,8,14572,0,13615.0,1,13620.0,12,S
2018-04-23 09:45:37,13615.0,2,14574,2,13610.0,10,13615.0,5,S
2018-04-23 09:45:41,13610.0,10,14584,2,13610.0,1,13615.0,11,S
2018-04-23 09:45:41,13610.0,2,14586,2,13605.0,25,13610.0,1,S
2018-04-23 09:45:42,13610.0,4,14590,0,13610.0,4,13615.0,11,S
2018-04-23 09:45:42,13610.0,8,14598,4,13605.0,15,13610.0,4,S
2018-04-23 09:45:43,13610.0,6,14604,-6,13605.0,18,13615.0,12,S
2018-04-23 09:45:45,13615.0,2,14606,0,13610.0,2,13615.0,5,B
2018-04-23 09:46:00,13615.0,2,14608,0,13610.0,6,13615.0,4,B
2018-04-23 09:46:02,13610.0,4,14612,4,13610.0,4,13615.0,4,S
2018-04-23 09:46:13,13615.0,8,14620,-2,13615.0,4,13620.0,19,B
2018-04-23 09:46:22,13615.0,2,14622,-2,13615.0,4,13620.0,13,B
2018-04-23 09:46:22,13620.0,26,14648,10,13620.0,2,13625.0,40,B
2018-04-23 09:46:23,13620.0,10,14658,4,13620.0,7,13625.0,45,B
2018-04-23 09:46:26,13625.0,8,14666,2,13620.0,12,13625.0,8,B
2018-04-23 09:46:26,13625.0,10,14676,-2,13620.0,12,13625.0,3,B
2018-04-23 09:46:27,13630.0,8,14684,0,13620.0,13,13630.0,4,B
2018-04-23 09:46:34,13630.0,20,14704,-12,13620.0,11,13635.0,27,B
2018-04-23 09:46:35,13625.0,2,14706,0,13620.0,11,13630.0,12,S
2018-04-23 09:46:36,13630.0,2,14708,0,13620.0,12,13630.0,13,B
2018-04-23 09:46:52,13625.0,6,14714,0,13620.0,17,13630.0,20,S
2018-04-23 09:47:00,13625.0,2,14716,0,13620.0,28,13625.0,3,S
2018-04-23 09:47:03,13620.0,2,14718,0,13620.0,26,13625.0,4,S
2018-04-23 09:47:04,13620.0,20,14738,-4,13620.0,16,13625.0,12,S
2018-04-23 09:47:05,13620.0,8,14746,4,13620.0,12,13625.0,15,S
2018-04-23 09:47:06,13620.0,2,14748,2,13620.0,11,13625.0,13,S
2018-04-23 09:47:11,13620.0,20,14768,4,13620.0,1,13625.0,13,S
2018-04-23 09:47:11,13620.0,2,14770,0,13615.0,6,13620.0,1,S
2018-04-23 09:47:13,13615.0,2,14772,-2,13610.0,5,13620.0,18,S
2018-04-23 09:47:13,13615.0,2,14774,2,13615.0,1,13620.0,17,S
2018-04-23 09:47:15,13620.0,2,14776,0,13615.0,6,13620.0,8,B
2018-04-23 09:47:39,13615.0,8,14784,8,13610.0,16,13620.0,13,S
2018-04-23 09:47:46,13620.0,12,14796,-4,13620.0,4,13625.0,11,B
2018-04-23 09:47:53,13620.0,2,14798,-2,13620.0,2,13625.0,7,B
2018-04-23 09:47:53,13620.0,4,14802,-4,13615.0,62,13620.0,2,B
2018-04-23 09:47:54,13615.0,2,14804,0,13615.0,49,13620.0,10,S
2018-04-23 09:47:54,13615.0,6,14810,0,13615.0,46,13620.0,12,S
2018-04-23 09:47:56,13620.0,2,14812,0,13615.0,57,13625.0,10,B
2018-04-23 09:48:03,13615.0,4,14816,4,13615.0,55,13625.0,10,S
2018-04-23 09:48:07,13625.0,4,14820,2,13615.0,55,13625.0,8,B
2018-04-23 09:48:10,13620.0,6,14826,0,13615.0,55,13625.0,8,S
2018-04-23 09:48:23,13620.0,10,14836,-4,13615.0,44,13625.0,50,S
2018-04-23 09:48:28,13615.0,2,14838,0,13615.0,46,13625.0,47,S
2018-04-23 09:48:50,13615.0,6,14844,0,13615.0,40,13620.0,12,S
2018-04-23 09:48:56,13615.0,4,14848,0,13615.0,38,13620.0,9,S
2018-04-23 09:48:56,13615.0,12,14860,12,13615.0,32,13620.0,12,S
2018-04-23 09:49:01,13615.0,2,14862,0,13615.0,31,13620.0,15,S
2018-04-23 09:49:07,13615.0,2,14864,0,13615.0,30,13620.0,16,S
2018-04-23 09:49:13,13615.0,2,14866,0,13615.0,29,13620.0,21,S
2018-04-23 09:49:17,13615.0,2,14868,0,13615.0,28,13620.0,25,S
2018-04-23 09:49:19,13615.0,4,14872,4,13615.0,26,13620.0,25,S
2018-04-23 09:49:31,13615.0,4,14876,4,13615.0,25,13620.0,30,S
2018-04-23 09:49:31,13615.0,10,14886,6,13615.0,20,13620.0,47,S
2018-04-23 09:49:32,13615.0,20,14906,20,13615.0,16,13620.0,22,S
2018-04-23 09:49:33,13615.0,2,14908,0,13615.0,15,13620.0,19,S
2018-04-23 09:49:33,13615.0,2,14910,0,13615.0,14,13620.0,19,S
2018-04-23 09:49:35,13615.0,4,14914,4,13615.0,12,13620.0,19,S
2018-04-23 09:49:42,13620.0,18,14932,-6,13615.0,13,13620.0,10,B
2018-04-23 09:49:42,13620.0,20,14952,-2,13620.0,2,13625.0,7,B
2018-04-23 09:49:45,13620.0,12,14964,0,13615.0,19,13625.0,12,B
2018-04-23 09:49:46,13620.0,2,14966,0,13615.0,7,13620.0,2,B
2018-04-23 09:49:46,13620.0,4,14970,2,13615.0,21,13625.0,16,B
2018-04-23 09:49:51,13615.0,18,14988,-4,13615.0,12,13625.0,17,S
2018-04-23 09:49:56,13620.0,2,14990,0,13615.0,12,13620.0,5,B
2018-04-23 09:49:57,13625.0,40,15030,14,13615.0,12,13625.0,3,B
2018-04-23 09:50:01,13625.0,6,15036,-6,13615.0,12,13625.0,2,B
2018-04-23 09:50:05,13620.0,8,15044,8,13615.0,17,13625.0,3,S
2018-04-23 09:50:08,13625.0,6,15050,2,13625.0,1,13630.0,8,B
2018-04-23 09:50:18,13625.0,2,15052,2,13625.0,7,13630.0,6,B
2018-04-23 09:50:19,13625.0,10,15062,-8,13625.0,3,13630.0,4,B
2018-04-23 09:50:20,13625.0,8,15070,8,13625.0,5,13630.0,4,B
2018-04-23 09:50:22,13625.0,2,15072,2,13625.0,6,13630.0,4,B
2018-04-23 09:50:22,13630.0,8,15080,6,13625.0,12,13635.0,9,B
2018-04-23 09:50:31,13625.0,8,15088,8,13625.0,2,13630.0,5,S
2018-04-23 09:50:32,13630.0,2,15090,-2,13620.0,26,13630.0,3,B
2018-04-23 09:50:37,13620.0,2,15092,-2,13620.0,20,13630.0,10,S
2018-04-23 09:50:38,13620.0,2,15094,-2,13620.0,19,13630.0,8,S
2018-04-23 09:50:40,13620.0,2,15096,-2,13625.0,2,13630.0,9,S
2018-04-23 09:50:44,13620.0,6,15102,-6,13620.0,56,13625.0,13,S
2018-04-23 09:50:45,13620.0,2,15104,-2,13620.0,55,13625.0,12,S
2018-04-23 09:50:46,13620.0,2,15106,-2,13620.0,54,13625.0,8,S
2018-04-23 09:50:47,13620.0,2,15108,-2,13620.0,53,13625.0,5,S
2018-04-23 09:50:47,13620.0,2,15110,-2,13620.0,52,13625.0,4,S
2018-04-23 09:50:48,13620.0,2,15112,-2,13620.0,57,13630.0,36,S
2018-04-23 09:50:49,13625.0,4,15116,2,13620.0,59,13625.0,1,B
2018-04-23 09:50:50,13625.0,2,15118,0,13620.0,51,13625.0,11,B
2018-04-23 09:50:50,13620.0,2,15120,-2,13620.0,50,13625.0,12,S
2018-04-23 09:50:51,13620.0,2,15122,0,13620.0,49,13625.0,12,S
2018-04-23 09:50:52,13620.0,2,15124,0,13620.0,48,13625.0,12,S
2018-04-23 09:50:52,13620.0,2,15126,0,13620.0,47,13625.0,12,S
2018-04-23 09:50:53,13620.0,2,15128,0,13620.0,46,13625.0,9,S
2018-04-23 09:50:54,13620.0,6,15134,-4,13620.0,57,13630.0,17,S
2018-04-23 09:50:54,13620.0,2,15136,0,13620.0,56,13630.0,13,S
2018-04-23 09:50:55,13620.0,2,15138,0,13620.0,55,13630.0,13,S
2018-04-23 09:50:56,13620.0,2,15140,0,13620.0,54,13630.0,17,S
2018-04-23 09:50:57,13620.0,2,15142,0,13620.0,53,13630.0,17,S
2018-04-23 09:50:58,13620.0,2,15144,0,13620.0,52,13630.0,17,S
2018-04-23 09:50:59,13620.0,2,15146,0,13620.0,51,13630.0,17,S
2018-04-23 09:50:59,13620.0,2,15148,0,13620.0,50,13630.0,17,S
2018-04-23 09:51:00,13620.0,2,15150,0,13620.0,49,13630.0,17,S
2018-04-23 09:51:01,13620.0,10,15160,8,13620.0,44,13630.0,17,S
2018-04-23 09:51:02,13620.0,2,15162,0,13620.0,43,13630.0,17,S
2018-04-23 09:51:02,13620.0,2,15164,0,13620.0,42,13630.0,17,S
2018-04-23 09:51:03,13620.0,2,15166,0,13620.0,41,13630.0,17,S
2018-04-23 09:51:04,13620.0,2,15168,0,13620.0,36,13630.0,16,S
2018-04-23 09:51:04,13620.0,2,15170,0,13620.0,27,13625.0,8,S
2018-04-23 09:51:15,13620.0,54,15224,42,13615.0,9,13620.0,2,S
2018-04-23 09:51:16,13615.0,4,15228,-4,13610.0,17,13620.0,5,S
2018-04-23 09:51:36,13615.0,2,15230,0,13610.0,25,13615.0,3,S
2018-04-23 09:51:36,13615.0,6,15236,2,13610.0,25,13620.0,10,S
2018-04-23 09:51:43,13610.0,8,15244,2,13610.0,20,13620.0,11,S
2018-04-23 09:51:50,13610.0,8,15252,0,13610.0,16,13615.0,2,S
2018-04-23 09:51:59,13610.0,18,15270,-12,13605.0,17,13610.0,1,S
2018-04-23 09:52:00,13610.0,2,15272,-2,13605.0,22,13610.0,4,S
2018-04-23 09:52:07,13605.0,8,15280,0,13605.0,15,13610.0,6,S
2018-04-23 09:52:17,13605.0,4,15284,-4,13605.0,10,13610.0,14,S
2018-04-23 09:52:18,13605.0,22,15306,-2,13600.0,4,13610.0,18,S
2018-04-23 09:52:24,13605.0,4,15310,-4,13605.0,3,13610.0,7,S
2018-04-23 09:52:26,13605.0,2,15312,-2,13600.0,17,13605.0,6,S
2018-04-23 09:52:38,13600.0,2,15314,-2,13600.0,10,13605.0,6,S
2018-04-23 09:53:02,13605.0,2,15316,0,13600.0,6,13605.0,6,B
2018-04-23 09:53:02,13605.0,12,15328,0,13600.0,15,13610.0,36,B
2018-04-23 09:53:05,13605.0,24,15352,-12,13600.0,21,13610.0,4,B
2018-04-23 09:53:25,13605.0,2,15354,2,13600.0,5,13605.0,3,B
2018-04-23 09:53:31,13605.0,2,15356,2,13600.0,6,13605.0,2,B
2018-04-23 09:53:36,13605.0,2,15358,2,13600.0,7,13605.0,1,B
2018-04-23 09:53:41,13600.0,14,15372,-10,13600.0,2,13605.0,2,S
2018-04-23 09:53:41,13600.0,4,15376,-2,13595.0,10,13605.0,31,S
2018-04-23 09:53:47,13595.0,40,15416,-28,13590.0,3,13600.0,10,S
2018-04-23 09:53:47,13590.0,14,15430,-6,13590.0,10,13600.0,8,S
2018-04-23 09:53:48,13590.0,12,15442,-4,13590.0,7,13600.0,8,S
2018-04-23 09:53:49,13600.0,6,15448,-6,13595.0,11,13600.0,8,B
2018-04-23 09:53:50,13600.0,12,15460,-10,13600.0,2,13605.0,8,B
2018-04-23 09:53:52,13600.0,2,15462,2,13600.0,3,13605.0,7,B
2018-04-23 09:54:06,13605.0,2,15464,0,13605.0,5,13610.0,8,B
2018-04-23 09:54:11,13605.0,16,15480,-12,13600.0,8,13605.0,2,B
2018-04-23 09:54:13,13605.0,2,15482,0,13600.0,13,13605.0,1,B
2018-04-23 09:54:16,13600.0,22,15504,20,13595.0,8,13605.0,8,S
2018-04-23 09:54:17,13600.0,2,15506,2,13595.0,8,13600.0,2,S
2018-04-23 09:54:23,13595.0,2,15508,0,13595.0,6,13600.0,2,S
2018-04-23 09:54:28,13600.0,2,15510,2,13595.0,6,13600.0,1,B
2018-04-23 09:54:32,13600.0,2,15512,2,13595.0,6,13605.0,10,B
2018-04-23 09:54:36,13600.0,4,15516,0,13595.0,6,13600.0,2,B
2018-04-23 09:54:52,13595.0,2,15518,2,13590.0,8,13595.0,5,S
2018-04-23 09:55:05,13595.0,4,15522,2,13590.0,14,13595.0,3,S
2018-04-23 09:55:07,13595.0,2,15524,0,13595.0,4,13600.0,9,S
2018-04-23 09:55:12,13595.0,4,15528,4,13590.0,14,13600.0,9,S
2018-04-23 09:55:13,13595.0,2,15530,-2,13590.0,14,13600.0,10,S
2018-04-23 09:55:18,13590.0,2,15532,0,13590.0,11,13600.0,13,S
2018-04-23 09:55:34,13600.0,4,15536,-4,13590.0,13,13600.0,8,B
2018-04-23 09:55:35,13595.0,2,15538,2,13590.0,13,13600.0,10,S
2018-04-23 09:55:39,13590.0,2,15540,2,13590.0,13,13600.0,10,S
2018-04-23 09:55:43,13590.0,6,15546,-2,13585.0,18,13595.0,6,S
2018-04-23 09:55:57,13590.0,2,15548,0,13585.0,21,13590.0,9,S
2018-04-23 09:55:57,13590.0,18,15566,0,13585.0,21,13595.0,7,S
2018-04-23 09:56:02,13595.0,2,15568,-2,13590.0,6,13595.0,1,B
2018-04-23 09:56:10,13590.0,6,15574,0,13585.0,21,13595.0,12,S
2018-04-23 09:56:16,13590.0,2,15576,0,13590.0,1,13595.0,6,S
2018-04-23 09:56:24,13595.0,2,15578,0,13590.0,1,13595.0,9,B
2018-04-23 09:56:24,13590.0,2,15580,0,13585.0,28,13595.0,11,S
2018-04-23 09:56:39,13590.0,4,15584,0,13585.0,19,13590.0,5,S
2018-04-23 09:56:40,13585.0,10,15594,-6,13585.0,11,13590.0,8,S
2018-04-23 09:56:40,13585.0,22,15616,-2,13580.0,20,13585.0,5,S
2018-04-23 09:56:41,13580.0,4,15620,-4,13580.0,19,13585.0,5,S
2018-04-23 09:56:41,13580.0,22,15642,-16,13580.0,11,13590.0,13,S
2018-04-23 09:56:42,13580.0,18,15660,-6,13575.0,5,13580.0,2,S
2018-04-23 09:56:43,13575.0,8,15668,0,13570.0,10,13575.0,1,S
2018-04-23 09:56:43,13570.0,10,15678,-4,13570.0,4,13575.0,7,S
2018-04-23 09:56:44,13570.0,4,15682,-4,13570.0,4,13575.0,7,S
2018-04-23 09:56:45,13570.0,4,15686,-4,13570.0,2,13575.0,9,S
2018-04-23 09:56:45,13570.0,6,15692,6,13570.0,1,13575.0,10,S
2018-04-23 09:56:46,13570.0,6,15698,0,13570.0,3,13575.0,10,S
2018-04-23 09:56:47,13570.0,6,15704,-6,13565.0,16,13575.0,10,S
2018-04-23 09:56:48,13565.0,4,15708,-4,13565.0,13,13570.0,8,S
2018-04-23 09:56:49,13565.0,26,15734,-6,13560.0,7,13565.0,2,S
2018-04-23 09:56:49,13560.0,4,15738,-2,13560.0,4,13565.0,2,S
2018-04-23 09:56:50,13555.0,10,15748,-4,13555.0,4,13565.0,6,S
2018-04-23 09:56:50,13555.0,2,15750,0,13555.0,10,13560.0,10,S
2018-04-23 09:56:51,13560.0,34,15784,4,13550.0,13,13560.0,24,B
2018-04-23 09:56:52,13550.0,20,15804,-16,13550.0,3,13560.0,20,S
2018-04-23 09:56:57,13555.0,2,15806,0,13555.0,1,13560.0,12,B
2018-04-23 09:56:58,13555.0,2,15808,2,13550.0,18,13560.0,16,B
2018-04-23 09:56:59,13560.0,2,15810,2,13555.0,3,13560.0,14,B
2018-04-23 09:57:00,13560.0,6,15816,0,13555.0,4,13560.0,10,B
2018-04-23 09:57:00,13560.0,30,15846,0,13560.0,4,13565.0,5,B
2018-04-23 09:57:01,13555.0,32,15878,16,13550.0,14,13555.0,1,S
2018-04-23 09:57:01,13555.0,34,15912,4,13550.0,8,13555.0,1,S
2018-04-23 09:57:02,13555.0,2,15914,0,13550.0,8,13555.0,2,S
2018-04-23 09:57:04,13550.0,16,15930,-2,13545.0,4,13550.0,3,S
2018-04-23 09:57:05,13550.0,2,15932,0,13545.0,4,13555.0,9,S
2018-04-23 09:57:06,13545.0,6,15938,2,13540.0,5,13550.0,18,S
2018-04-23 09:57:07,13545.0,10,15948,-4,13540.0,1,13550.0,16,S
2018-04-23 09:57:07,13540.0,2,15950,0,13535.0,7,13540.0,4,S
2018-04-23 09:57:08,13530.0,18,15968,6,13530.0,4,13540.0,4,S
2018-04-23 09:57:10,13530.0,4,15972,2,13530.0,6,13535.0,1,S
2018-04-23 09:57:10,13535.0,2,15974,0,13535.0,1,13540.0,7,B
2018-04-23 09:57:11,13535.0,2,15976,-2,13535.0,1,13540.0,5,B
2018-04-23 09:57:14,13535.0,6,15982,-4,13530.0,9,13535.0,52,B
2018-04-23 09:57:14,13535.0,50,16032,-30,13530.0,20,13535.0,27,B
2018-04-23 09:57:15,13535.0,54,16086,-18,13535.0,20,13540.0,5,B
2018-04-23 09:57:15,13540.0,2,16088,2,13535.0,1,13540.0,3,B
2018-04-23 09:57:16,13535.0,4,16092,-2,13535.0,1,13540.0,1,S
2018-04-23 09:57:18,13535.0,4,16096,-2,13535.0,2,13540.0,8,S
2018-04-23 09:57:19,13540.0,4,16100,-2,13540.0,3,13545.0,6,B
2018-04-23 09:57:25,13540.0,2,16102,2,13540.0,2,13545.0,3,B
2018-04-23 09:57:30,13540.0,6,16108,0,13540.0,4,13550.0,7,B
2018-04-23 09:57:33,13550.0,2,16110,0,13545.0,12,13550.0,1,B
2018-04-23 09:57:36,13550.0,4,16114,-2,13550.0,13,13560.0,6,B
2018-04-23 09:57:37,13560.0,18,16132,18,13545.0,12,13560.0,2,B
2018-04-23 09:57:40,13560.0,2,16134,0,13550.0,9,13560.0,7,B
2018-04-23 09:57:42,13560.0,10,16144,2,13550.0,14,13560.0,1,B
2018-04-23 09:57:45,13555.0,2,16146,0,13555.0,5,13560.0,3,S
2018-04-23 09:57:46,13560.0,2,16148,2,13555.0,5,13560.0,2,B
2018-04-23 09:57:58,13560.0,8,16156,8,13560.0,2,13565.0,4,B
2018-04-23 09:57:59,13560.0,4,16160,4,13555.0,5,13560.0,8,B
2018-04-23 09:58:02,13560.0,2,16162,2,13560.0,3,13565.0,5,B
2018-04-23 09:58:17,13560.0,8,16170,-6,13555.0,10,13565.0,5,B
2018-04-23 09:58:19,13560.0,22,16192,-20,13555.0,4,13560.0,8,B
2018-04-23 09:58:23,13555.0,8,16200,-4,13550.0,8,13555.0,1,S
2018-04-23 09:58:25,13550.0,6,16206,-6,13550.0,2,13555.0,4,S
2018-04-23 09:58:30,13555.0,2,16208,0,13550.0,5,13555.0,7,B
2018-04-23 09:58:31,13555.0,2,16210,2,13550.0,5,13555.0,6,B
2018-04-23 09:58:34,13550.0,2,16212,2,13550.0,4,13555.0,5,S
2018-04-23 09:58:36,13560.0,68,16280,0,13555.0,1,13560.0,6,B
2018-04-23 09:58:36,13560.0,20,16300,0,13560.0,32,13570.0,2,B
2018-04-23 09:58:37,13565.0,4,16304,4,13565.0,6,13570.0,3,B
2018-04-23 09:58:38,13565.0,4,16308,-2,13560.0,9,13570.0,7,B
2018-04-23 09:58:40,13560.0,2,16310,0,13560.0,3,13565.0,10,S
2018-04-23 09:58:41,13565.0,2,16312,2,13560.0,4,13565.0,7,B
2018-04-23 09:58:43,13565.0,2,16314,0,13560.0,4,13565.0,6,B
2018-04-23 09:58:46,13565.0,4,16318,0,13565.0,3,13570.0,9,B
2018-04-23 09:58:50,13565.0,2,16320,-2,13560.0,6,13570.0,13,B
2018-04-23 09:58:52,13570.0,8,16328,-4,13565.0,1,13575.0,11,B
2018-04-23 09:58:54,13570.0,2,16330,0,13565.0,2,13570.0,1,B
2018-04-23 09:58:57,13570.0,4,16334,4,13560.0,5,13570.0,11,B
2018-04-23 09:59:06,13570.0,2,16336,0,13565.0,6,13570.0,2,B
2018-04-23 09:59:08,13565.0,10,16346,6,13560.0,6,13570.0,11,S
2018-04-23 09:59:10,13570.0,2,16348,2,13560.0,6,13570.0,11,B
2018-04-23 09:59:37,13570.0,24,16372,12,13570.0,43,13575.0,10,B
2018-04-23 09:59:38,13570.0,16,16388,2,13570.0,36,13575.0,11,B
2018-04-23 09:59:38,13570.0,4,16392,0,13570.0,36,13575.0,10,B
2018-04-23 09:59:44,13570.0,48,16440,8,13570.0,12,13575.0,10,B
2018-04-23 09:59:45,13570.0,24,16464,-4,13565.0,2,13575.0,11,B
2018-04-23 09:59:46,13575.0,6,16470,2,13570.0,8,13575.0,4,B
2018-04-23 09:59:46,13575.0,8,16478,8,13575.0,2,13580.0,7,B
2018-04-23 09:59:50,13575.0,4,16482,-4,13570.0,5,13575.0,11,B
2018-04-23 10:00:05,13580.0,8,16490,-6,13575.0,12,13580.0,2,B
2018-04-23 10:00:08,13580.0,2,16492,0,13575.0,12,13580.0,1,B
2018-04-23 10:00:12,13580.0,2,16494,2,13575.0,12,13585.0,9,B
2018-04-23 10:00:21,13580.0,2,16496,-2,13580.0,5,13585.0,4,B
2018-04-23 10:00:23,13585.0,2,16498,2,13580.0,5,13585.0,3,B
2018-04-23 10:00:26,13580.0,4,16502,4,13580.0,1,13585.0,4,S
2018-04-23 10:00:33,13585.0,2,16504,2,13585.0,1,13590.0,5,B
2018-04-23 10:00:35,13585.0,2,16506,0,13580.0,4,13590.0,9,B
2018-04-23 10:00:39,13580.0,6,16512,-4,13575.0,6,13585.0,10,S
2018-04-23 10:00:40,13575.0,2,16514,0,13570.0,1,13575.0,1,S
2018-04-23 10:00:42,13570.0,6,16520,0,13565.0,5,13575.0,14,S
2018-04-23 10:00:47,13570.0,2,16522,0,13570.0,2,13575.0,10,S
2018-04-23 10:00:52,13575.0,4,16526,0,13570.0,2,13575.0,8,B
2018-04-23 10:01:12,13570.0,6,16532,-2,13565.0,8,13575.0,23,S
2018-04-23 10:01:23,13570.0,2,16534,-2,13570.0,4,13575.0,9,S
2018-04-23 10:01:31,13570.0,2,16536,0,13565.0,12,13575.0,9,S
2018-04-23 10:01:41,13570.0,2,16538,0,13565.0,10,13575.0,13,S
2018-04-23 10:01:54,13565.0,18,16556,-6,13560.0,26,13565.0,1,S
2018-04-23 10:01:55,13560.0,12,16568,0,13560.0,6,13565.0,7,S
2018-04-23 10:02:16,13565.0,2,16570,2,13560.0,6,13565.0,4,B
2018-04-23 10:02:19,13560.0,4,16574,4,13560.0,4,13565.0,6,S
2018-04-23 10:02:26,13565.0,18,16592,2,13565.0,7,13570.0,5,B
2018-04-23 10:02:48,13565.0,2,16594,-2,13565.0,4,13570.0,4,B
2018-04-23 10:02:57,13570.0,2,16596,0,13565.0,5,13570.0,4,B
2018-04-23 10:03:04,13565.0,10,16606,2,13560.0,13,13565.0,1,S
2018-04-23 10:03:04,13560.0,10,16616,-2,13555.0,3,13565.0,6,S
2018-04-23 10:03:20,13560.0,6,16622,6,13560.0,3,13565.0,8,S
2018-04-23 10:03:21,13560.0,6,16628,-2,13555.0,6,13565.0,19,S
2018-04-23 10:03:22,13560.0,6,16634,-6,13560.0,1,13565.0,22,S
2018-04-23 10:03:23,13565.0,24,16658,4,13565.0,3,13570.0,4,B
2018-04-23 10:03:34,13560.0,2,16660,-2,13560.0,16,13565.0,1,S
2018-04-23 10:03:39,13565.0,2,16662,2,13560.0,31,13565.0,1,B
2018-04-23 10:03:46,13565.0,2,16664,0,13560.0,19,13570.0,9,B
2018-04-23 10:04:25,13565.0,2,16666,0,13565.0,2,13570.0,4,B
2018-04-23 10:04:28,13570.0,2,16668,2,13565.0,3,13570.0,4,B
2018-04-23 10:04:37,13570.0,2,16670,0,13565.0,7,13570.0,2,B
2018-04-23 10:04:41,13570.0,4,16674,-2,13570.0,2,13575.0,4,B
2018-04-23 10:04:47,13575.0,2,16676,2,13570.0,5,13575.0,3,B
2018-04-23 10:04:54,13575.0,2,16678,-2,13570.0,5,13580.0,7,B
2018-04-23 10:04:54,13580.0,2,16680,2,13575.0,24,13585.0,4,B
2018-04-23 10:04:55,13580.0,2,16682,-2,13575.0,7,13585.0,2,B
2018-04-23 10:05:02,13585.0,2,16684,0,13580.0,2,13590.0,3,B
2018-04-23 10:05:03,13585.0,2,16686,0,13580.0,3,13590.0,5,B
2018-04-23 10:05:08,13590.0,2,16688,-2,13580.0,3,13590.0,5,B
2018-04-23 10:05:08,13580.0,2,16690,2,13580.0,2,13585.0,1,S
2018-04-23 10:05:09,13585.0,2,16692,-2,13580.0,3,13590.0,5,B
2018-04-23 10:05:15,13590.0,2,16694,0,13580.0,5,13590.0,5,B
2018-04-23 10:05:17,13590.0,2,16696,0,13580.0,6,13590.0,8,B
2018-04-23 10:05:23,13580.0,2,16698,0,13580.0,1,13585.0,9,S
2018-04-23 10:05:28,13580.0,2,16700,0,13575.0,6,13585.0,14,S
2018-04-23 10:05:39,13575.0,4,16704,-2,13570.0,6,13580.0,12,S
2018-04-23 10:06:09,13570.0,8,16712,4,13565.0,20,13580.0,12,S
2018-04-23 10:06:09,13570.0,4,16716,4,13570.0,4,13575.0,1,S
2018-04-23 10:06:17,13570.0,2,16718,0,13570.0,6,13580.0,11,S
2018-04-23 10:06:25,13580.0,6,16724,4,13570.0,6,13580.0,8,B
2018-04-23 10:06:38,13580.0,10,16734,6,13570.0,8,13580.0,4,B
2018-04-23 10:06:53,13580.0,2,16736,2,13570.0,9,13580.0,6,B
2018-04-23 10:07:08,13580.0,2,16738,2,13570.0,7,13580.0,8,B
2018-04-23 10:07:15,13580.0,2,16740,2,13570.0,7,13580.0,7,B
2018-04-23 10:07:31,13570.0,2,16742,-2,13565.0,6,13575.0,5,S
2018-04-23 10:07:52,13570.0,10,16752,10,13565.0,7,13575.0,11,S
2018-04-23 10:08:13,13570.0,2,16754,2,13565.0,7,13570.0,7,S
2018-04-23 10:08:22,13570.0,2,16756,2,13565.0,2,13570.0,3,S
2018-04-23 10:08:41,13570.0,10,16766,-6,13570.0,6,13575.0,6,S
2018-04-23 10:08:58,13575.0,12,16778,6,13570.0,3,13575.0,2,B
2018-04-23 10:08:59,13575.0,2,16780,0,13570.0,3,13575.0,2,B
2018-04-23 10:09:02,13575.0,2,16782,0,13570.0,6,13575.0,2,B
2018-04-23 10:09:14,13575.0,2,16784,-2,13570.0,5,13575.0,1,B
2018-04-23 10:09:14,13575.0,2,16786,-2,13570.0,6,13580.0,5,B
2018-04-23 10:09:19,13580.0,2,16788,-2,13575.0,8,13580.0,1,B
2018-04-23 10:09:30,13580.0,2,16790,0,13575.0,6,13580.0,1,B
2018-04-23 10:09:38,13580.0,2,16792,-2,13575.0,6,13585.0,20,B
2018-04-23 10:10:09,13580.0,12,16804,10,13575.0,9,13585.0,6,B
2018-04-23 10:10:35,13580.0,2,16806,0,13575.0,21,13585.0,6,B
2018-04-23 10:10:35,13585.0,10,16816,0,13575.0,21,13585.0,1,B
2018-04-23 10:10:38,13580.0,2,16818,0,13575.0,21,13585.0,4,S
2018-04-23 10:10:39,13575.0,2,16820,0,13575.0,20,13585.0,4,S
2018-04-23 10:10:41,13575.0,2,16822,2,13575.0,20,13585.0,4,S
2018-04-23 10:10:45,13575.0,2,16824,2,13575.0,20,13585.0,3,S
2018-04-23 10:10:47,13575.0,2,16826,2,13575.0,20,13585.0,4,S
2018-04-23 10:10:54,13580.0,2,16828,2,13575.0,10,13580.0,26,B
2018-04-23 10:10:56,13580.0,2,16830,2,13575.0,10,13580.0,25,B
2018-04-23 10:10:59,13580.0,2,16832,2,13575.0,9,13580.0,24,B
2018-04-23 10:11:19,13580.0,2,16834,0,13575.0,13,13580.0,23,B
2018-04-23 10:11:20,13580.0,14,16848,2,13575.0,13,13580.0,16,B
2018-04-23 10:11:20,13580.0,6,16854,4,13575.0,14,13580.0,13,B
2018-04-23 10:11:21,13580.0,24,16878,12,13575.0,28,13580.0,1,B
2018-04-23 10:11:21,13580.0,2,16880,0,13580.0,2,13585.0,6,B
2018-04-23 10:11:23,13585.0,10,16890,-6,13580.0,5,13590.0,4,B
2018-04-23 10:11:24,13590.0,8,16898,-6,13580.0,5,13590.0,2,B
2018-04-23 10:11:29,13590.0,2,16900,0,13580.0,10,13590.0,3,B
2018-04-23 10:11:32,13585.0,4,16904,4,13585.0,3,13590.0,4,S
2018-04-23 10:11:33,13585.0,6,16910,6,13580.0,5,13590.0,4,S
2018-04-23 10:11:35,13585.0,10,16920,0,13580.0,6,13590.0,4,S
2018-04-23 10:11:36,13580.0,2,16922,0,13580.0,5,13590.0,4,S
2018-04-23 10:11:44,13580.0,20,16942,-10,13580.0,18,13590.0,1,S
2018-04-23 10:11:44,13590.0,2,16944,0,13585.0,5,13590.0,1,B
2018-04-23 10:11:45,13590.0,2,16946,0,13590.0,1,13595.0,5,B
2018-04-23 10:11:59,13595.0,2,16948,0,13590.0,2,13595.0,3,B
2018-04-23 10:12:13,13595.0,2,16950,-2,13590.0,3,13595.0,1,B
2018-04-23 10:12:20,13595.0,2,16952,0,13595.0,1,13600.0,5,B
2018-04-23 10:12:21,13595.0,2,16954,2,13595.0,2,13600.0,2,B
2018-04-23 10:12:22,13595.0,4,16958,2,13590.0,10,13600.0,2,B
2018-04-23 10:12:23,13605.0,12,16970,2,13600.0,1,13605.0,1,B
2018-04-23 10:12:24,13605.0,2,16972,0,13600.0,8,13610.0,6,B
2018-04-23 10:12:25,13600.0,12,16984,8,13595.0,4,13600.0,4,S
2018-04-23 10:12:27,13590.0,4,16988,2,13590.0,3,13595.0,3,S
2018-04-23 10:12:29,13595.0,2,16990,0,13590.0,7,13595.0,3,B
2018-04-23 10:12:29,13595.0,4,16994,0,13590.0,12,13595.0,1,B
2018-04-23 10:12:30,13595.0,2,16996,-2,13590.0,12,13595.0,1,B
2018-04-23 10:12:30,13590.0,4,17000,-2,13590.0,12,13600.0,8,S
2018-04-23 10:12:39,13600.0,2,17002,0,13595.0,5,13600.0,2,B
2018-04-23 10:12:40,13600.0,2,17004,0,13595.0,3,13600.0,2,B
2018-04-23 10:13:07,13600.0,2,17006,0,13595.0,6,13600.0,5,B
2018-04-23 10:13:12,13600.0,10,17016,4,13595.0,5,13600.0,1,B
2018-04-23 10:13:21,13595.0,10,17026,10,13590.0,11,13595.0,2,S
2018-04-23 10:13:28,13595.0,2,17028,0,13590.0,8,13595.0,2,S
2018-04-23 10:13:31,13595.0,2,17030,0,13590.0,8,13595.0,1,S
2018-04-23 10:13:33,13595.0,8,17038,-2,13590.0,5,13600.0,9,S
2018-04-23 10:13:34,13595.0,4,17042,0,13590.0,5,13600.0,8,S
2018-04-23 10:13:45,13595.0,4,17046,0,13595.0,3,13600.0,6,S
2018-04-23 10:13:46,13595.0,6,17052,-6,13590.0,32,13600.0,8,S
2018-04-23 10:14:06,13590.0,2,17054,2,13590.0,30,13600.0,11,S
2018-04-23 10:14:27,13590.0,6,17060,4,13590.0,33,13600.0,8,S
2018-04-23 10:14:30,13600.0,6,17066,-6,13590.0,29,13600.0,6,B
2018-04-23 10:14:37,13600.0,2,17068,2,13590.0,28,13600.0,6,B
2018-04-23 10:14:44,13595.0,2,17070,2,13590.0,28,13600.0,9,S
2018-04-23 10:14:54,13595.0,2,17072,0,13590.0,43,13595.0,9,S
2018-04-23 10:14:55,13595.0,6,17078,-6,13590.0,43,13595.0,6,S
2018-04-23 10:14:55,13595.0,6,17084,-6,13590.0,31,13595.0,3,S
2018-04-23 10:14:56,13595.0,6,17090,-6,13590.0,31,13600.0,4,S
2018-04-23 10:30:00,13595.0,4,17094,2,13595.0,4,13600.0,3,S
2018-04-23 10:30:01,13600.0,2,17096,2,13595.0,4,13600.0,8,B
2018-04-23 10:30:07,13595.0,8,17104,8,13590.0,27,13600.0,3,S
2018-04-23 10:30:11,13600.0,2,17106,0,13595.0,2,13605.0,5,B
2018-04-23 10:30:15,13600.0,4,17110,0,13600.0,1,13605.0,7,B
2018-04-23 10:30:17,13600.0,2,17112,-2,13595.0,7,13605.0,9,B
2018-04-23 10:30:32,13600.0,2,17114,-2,13595.0,3,13600.0,5,B
2018-04-23 10:30:38,13595.0,2,17116,0,13595.0,2,13600.0,5,S
2018-04-23 10:30:51,13595.0,4,17120,4,13595.0,5,13600.0,8,S
2018-04-23 10:30:54,13595.0,2,17122,2,13595.0,4,13600.0,8,S
2018-04-23 10:31:03,13595.0,2,17124,0,13595.0,3,13600.0,8,S
2018-04-23 10:31:18,13595.0,2,17126,2,13595.0,2,13600.0,10,S
2018-04-23 10:31:21,13595.0,2,17128,2,13595.0,1,13600.0,9,S
2018-04-23 10:31:23,13595.0,2,17130,2,13590.0,31,13600.0,9,S
2018-04-23 10:31:28,13590.0,2,17132,0,13590.0,27,13595.0,14,S
2018-04-23 10:31:28,13590.0,6,17138,0,13590.0,24,13595.0,20,S
2018-04-23 10:31:29,13590.0,8,17146,8,13590.0,20,13595.0,20,S
2018-04-23 10:31:30,13590.0,6,17152,6,13590.0,17,13595.0,20,S
2018-04-23 10:31:30,13590.0,6,17158,6,13590.0,14,13595.0,20,S
2018-04-23 10:31:31,13590.0,6,17164,6,13590.0,11,13595.0,19,S
2018-04-23 10:31:32,13590.0,4,17168,4,13590.0,9,13595.0,17,S
2018-04-23 10:31:33,13590.0,4,17172,2,13590.0,7,13595.0,17,S
2018-04-23 10:31:34,13590.0,2,17174,2,13590.0,6,13595.0,17,S
2018-04-23 10:31:35,13590.0,4,17178,4,13590.0,4,13595.0,17,S
2018-04-23 10:31:37,13590.0,2,17180,2,13590.0,3,13595.0,20,S
2018-04-23 10:31:39,13590.0,6,17186,6,13585.0,3,13595.0,20,S
2018-04-23 10:31:39,13585.0,6,17192,2,13585.0,1,13595.0,21,S
2018-04-23 10:31:44,13595.0,2,17194,0,13585.0,17,13595.0,20,B
2018-04-23 10:31:52,13590.0,4,17198,-2,13580.0,5,13590.0,9,S
2018-04-23 10:31:59,13590.0,2,17200,-2,13580.0,8,13590.0,9,S
2018-04-23 10:32:01,13590.0,4,17204,-2,13585.0,1,13590.0,7,S
2018-04-23 10:32:01,13590.0,2,17206,0,13585.0,1,13590.0,6,S
2018-04-23 10:32:09,13585.0,2,17208,0,13580.0,8,13590.0,10,S
2018-04-23 10:32:20,13580.0,2,17210,0,13580.0,7,13590.0,15,S
2018-04-23 10:32:20,13580.0,2,17212,0,13580.0,6,13590.0,15,S
2018-04-23 10:32:29,13580.0,2,17214,0,13580.0,4,13590.0,15,S
2018-04-23 10:32:32,13580.0,4,17218,0,13580.0,2,13590.0,15,S
2018-04-23 10:32:34,13580.0,6,17224,-2,13575.0,19,13580.0,7,S
2018-04-23 10:32:34,13580.0,14,17238,-6,13575.0,28,13585.0,2,S
2018-04-23 10:32:38,13580.0,12,17250,0,13575.0,30,13580.0,4,S
2018-04-23 10:32:55,13575.0,2,17252,0,13575.0,13,13580.0,10,S
2018-04-23 10:33:02,13575.0,4,17256,0,13575.0,14,13580.0,7,S
2018-04-23 10:33:04,13580.0,2,17258,0,13575.0,14,13580.0,6,B
2018-04-23 10:33:09,13580.0,4,17262,0,13575.0,14,13580.0,5,B
2018-04-23 10:33:18,13575.0,2,17264,0,13575.0,13,13580.0,8,S
2018-04-23 10:33:18,13575.0,26,17290,16,13570.0,6,13580.0,9,S
2018-04-23 10:33:19,13575.0,2,17292,2,13570.0,6,13580.0,11,S
2018-04-23 10:33:22,13570.0,12,17304,6,13565.0,13,13575.0,10,S
2018-04-23 10:33:38,13570.0,2,17306,0,13565.0,14,13570.0,6,S
2018-04-23 10:33:41,13565.0,2,17308,2,13565.0,16,13570.0,7,S
2018-04-23 10:33:45,13565.0,4,17312,0,13565.0,14,13570.0,5,S
2018-04-23 10:33:55,13565.0,8,17320,2,13565.0,11,13570.0,7,S
2018-04-23 10:34:06,13565.0,2,17322,2,13565.0,10,13570.0,7,S
2018-04-23 10:34:06,13565.0,2,17324,2,13565.0,9,13570.0,5,S
2018-04-23 10:34:12,13570.0,10,17334,4,13570.0,14,13575.0,9,B
2018-04-23 10:34:12,13575.0,6,17340,-2,13575.0,1,13580.0,11,B
2018-04-23 10:34:14,13575.0,4,17344,0,13575.0,2,13580.0,5,B
2018-04-23 10:34:14,13575.0,4,17348,-2,13570.0,16,13575.0,1,B
2018-04-23 10:34:19,13575.0,6,17354,-6,13570.0,17,13580.0,24,B
2018-04-23 10:34:52,13575.0,6,17360,-2,13570.0,22,13575.0,5,B
2018-04-23 10:34:53,13575.0,10,17370,-10,13570.0,21,13580.0,14,B
2018-04-23 10:35:04,13580.0,4,17374,2,13575.0,5,13580.0,2,B
2018-04-23 10:35:06,13580.0,2,17376,0,13575.0,5,13580.0,1,B
2018-04-23 10:35:31,13580.0,4,17380,0,13575.0,6,13585.0,13,B
2018-04-23 10:35:43,13585.0,4,17384,-4,13580.0,5,13585.0,4,B
2018-04-23 10:35:44,13585.0,8,17392,8,13580.0,5,13590.0,11,B
2018-04-23 10:35:47,13585.0,4,17396,0,13580.0,5,13590.0,16,B
2018-04-23 10:36:27,13590.0,8,17404,4,13590.0,1,13595.0,6,B
2018-04-23 10:36:27,13595.0,12,17416,-8,13595.0,2,13600.0,3,B
2018-04-23 10:36:28,13595.0,2,17418,0,13590.0,27,13600.0,3,B
2018-04-23 10:36:29,13590.0,10,17428,10,13585.0,7,13590.0,2,S
2018-04-23 10:36:31,13590.0,2,17430,0,13585.0,7,13590.0,1,S
2018-04-23 10:36:42,13595.0,2,17432,0,13595.0,4,13600.0,10,B
2018-04-23 10:36:43,13595.0,8,17440,-2,13590.0,11,13600.0,10,B
2018-04-23 10:37:07,13595.0,2,17442,-2,13590.0,8,13600.0,12,B
2018-04-23 10:37:09,13595.0,2,17444,2,13585.0,8,13595.0,8,B
2018-04-23 10:37:21,13590.0,2,17446,-2,13590.0,3,13600.0,15,S
2018-04-23 10:37:30,13590.0,2,17448,2,13590.0,3,13600.0,15,S
2018-04-23 10:37:55,13590.0,2,17450,0,13585.0,9,13595.0,13,S
2018-04-23 10:38:03,13590.0,2,17452,0,13585.0,7,13595.0,11,S
2018-04-23 10:38:10,13595.0,2,17454,2,13585.0,8,13595.0,9,B
2018-04-23 10:38:14,13595.0,2,17456,-2,13595.0,20,13600.0,14,B
2018-04-23 10:38:17,13595.0,2,17458,0,13595.0,20,13600.0,11,B
2018-04-23 10:38:37,13600.0,8,17466,-4,13595.0,23,13605.0,6,B
2018-04-23 10:38:43,13605.0,2,17468,0,13595.0,19,13605.0,15,B
2018-04-23 10:38:48,13600.0,4,17472,4,13595.0,20,13605.0,15,S
2018-04-23 10:38:51,13600.0,4,17476,-4,13600.0,16,13605.0,13,S
2018-04-23 10:38:52,13605.0,10,17486,-2,13600.0,18,13605.0,1,B
2018-04-23 10:38:57,13605.0,4,17490,2,13605.0,8,13610.0,9,B
2018-04-23 10:38:58,13605.0,2,17492,0,13605.0,7,13610.0,13,B
2018-04-23 10:38:58,13600.0,16,17508,14,13600.0,18,13610.0,15,S
2018-04-23 10:39:07,13605.0,8,17516,-8,13605.0,11,13610.0,19,B
2018-04-23 10:39:08,13605.0,22,17538,-10,13600.0,2,13605.0,11,B
2018-04-23 10:39:20,13605.0,2,17540,2,13600.0,5,13605.0,6,B
2018-04-23 10:39:27,13600.0,2,17542,2,13595.0,4,13600.0,4,S
2018-04-23 10:39:29,13600.0,2,17544,2,13595.0,6,13600.0,3,S
2018-04-23 10:39:31,13600.0,2,17546,2,13595.0,6,13600.0,2,S
2018-04-23 10:39:32,13600.0,2,17548,2,13595.0,5,13600.0,1,S
2018-04-23 10:39:36,13600.0,2,17550,2,13595.0,5,13605.0,7,S
2018-04-23 10:40:25,13600.0,6,17556,4,13595.0,5,13600.0,4,S
2018-04-23 10:40:29,13600.0,8,17564,2,13600.0,1,13605.0,9,S
2018-04-23 10:40:40,13600.0,2,17566,0,13600.0,5,13605.0,5,S
2018-04-23 10:40:57,13600.0,2,17568,0,13600.0,4,13605.0,5,S
2018-04-23 10:41:00,13605.0,2,17570,-2,13600.0,6,13605.0,4,B
2018-04-23 10:41:01,13605.0,4,17574,4,13605.0,2,13610.0,21,B
2018-04-23 10:41:03,13605.0,2,17576,2,13605.0,7,13610.0,10,B
2018-04-23 10:41:04,13610.0,2,17578,0,13605.0,7,13610.0,9,B
2018-04-23 10:41:20,13610.0,4,17582,4,13605.0,4,13610.0,7,B
2018-04-23 10:41:20,13610.0,8,17590,8,13605.0,4,13610.0,3,B
2018-04-23 10:41:41,13605.0,8,17598,8,13600.0,10,13610.0,9,S
2018-04-23 10:41:43,13605.0,2,17600,0,13600.0,5,13605.0,9,S
2018-04-23 10:41:53,13605.0,8,17608,-6,13600.0,7,13605.0,4,S
2018-04-23 10:42:04,13600.0,12,17620,6,13600.0,1,13605.0,7,S
2018-04-23 10:42:06,13610.0,20,17640,10,13600.0,2,13610.0,29,B
2018-04-23 10:42:18,13600.0,2,17642,0,13595.0,46,13605.0,9,S
2018-04-23 10:42:23,13605.0,2,17644,2,13600.0,9,13610.0,17,B
2018-04-23 10:42:25,13600.0,2,17646,-2,13600.0,6,13605.0,1,S
2018-04-23 10:42:33,13605.0,2,17648,-2,13600.0,6,13610.0,19,B
2018-04-23 10:42:40,13600.0,2,17650,2,13600.0,7,13610.0,18,S
2018-04-23 10:42:45,13605.0,8,17658,0,13600.0,8,13605.0,1,B
2018-04-23 10:42:46,13600.0,6,17664,-2,13600.0,5,13605.0,1,S
2018-04-23 10:42:54,13600.0,10,17674,10,13600.0,1,13605.0,4,S
2018-04-23 10:42:56,13600.0,4,17678,4,13595.0,45,13605.0,9,S
2018-04-23 10:43:05,13600.0,4,17682,2,13595.0,60,13605.0,6,S
2018-04-23 10:43:06,13600.0,2,17684,-2,13595.0,60,13605.0,5,S
2018-04-23 10:43:13,13600.0,8,17692,-2,13595.0,41,13605.0,10,S
2018-04-23 10:43:23,13600.0,2,17694,0,13600.0,6,13605.0,11,S
2018-04-23 10:43:24,13600.0,2,17696,2,13600.0,5,13605.0,11,S
2018-04-23 10:43:41,13605.0,12,17708,-2,13600.0,8,13610.0,24,B
2018-04-23 10:43:42,13600.0,10,17718,4,13600.0,6,13610.0,11,S
2018-04-23 10:43:45,13610.0,2,17720,0,13600.0,7,13610.0,10,B
2018-04-23 10:44:20,13610.0,4,17724,2,13600.0,12,13610.0,14,B
2018-04-23 10:44:37,13610.0,2,17726,0,13600.0,11,13610.0,9,B
2018-04-23 10:44:39,13610.0,4,17730,-2,13605.0,14,13610.0,2,B
2018-04-23 10:44:46,13610.0,4,17734,2,13605.0,16,13615.0,4,B
2018-04-23 10:44:57,13615.0,2,17736,-2,13610.0,6,13615.0,4,B
2018-04-23 10:45:09,13610.0,2,17738,-2,13605.0,15,13615.0,9,S
2018-04-23 10:45:23,13605.0,6,17744,-2,13600.0,11,13605.0,3,S
2018-04-23 10:45:32,13610.0,2,17746,2,13600.0,12,13610.0,5,B
2018-04-23 10:45:46,13610.0,2,17748,0,13605.0,2,13610.0,5,B
2018-04-23 10:45:49,13605.0,2,17750,0,13605.0,1,13610.0,5,S
2018-04-23 10:45:56,13605.0,2,17752,0,13600.0,10,13605.0,1,S
2018-04-23 10:46:06,13605.0,2,17754,-2,13600.0,13,13610.0,12,S
2018-04-23 10:46:25,13600.0,4,17758,-2,13600.0,10,13605.0,3,S
2018-04-23 10:46:28,13600.0,2,17760,2,13600.0,4,13605.0,9,S
2018-04-23 10:46:29,13600.0,8,17768,8,13595.0,41,13605.0,9,S
2018-04-23 10:46:36,13600.0,2,17770,2,13595.0,49,13605.0,9,S
2018-04-23 10:47:05,13595.0,70,17840,-6,13595.0,7,13600.0,18,S
2018-04-23 10:47:05,13590.0,16,17856,8,13585.0,7,13595.0,14,S
2018-04-23 10:47:06,13585.0,2,17858,-2,13585.0,6,13590.0,2,S
2018-04-23 10:47:06,13585.0,6,17864,0,13585.0,13,13595.0,12,S
2018-04-23 10:47:10,13590.0,2,17866,-2,13590.0,1,13595.0,10,B
2018-04-23 10:47:13,13590.0,2,17868,0,13585.0,17,13590.0,2,B
2018-04-23 10:47:13,13590.0,4,17872,4,13590.0,1,13595.0,10,B
2018-04-23 10:47:14,13590.0,2,17874,-2,13585.0,17,13595.0,9,B
2018-04-23 10:47:21,13590.0,2,17876,0,13585.0,17,13595.0,9,B
2018-04-23 10:47:26,13590.0,2,17878,2,13585.0,17,13595.0,12,B
2018-04-23 10:47:26,13595.0,2,17880,2,13585.0,17,13595.0,11,B
2018-04-23 10:47:37,13595.0,18,17898,-8,13590.0,12,13600.0,11,B
2018-04-23 10:47:39,13595.0,14,17912,14,13590.0,16,13595.0,1,B
2018-04-23 10:47:59,13595.0,12,17924,0,13595.0,3,13600.0,10,B
2018-04-23 10:48:05,13595.0,4,17928,-2,13590.0,10,13595.0,2,B
2018-04-23 10:48:09,13590.0,2,17930,0,13590.0,3,13595.0,3,S
2018-04-23 10:49:23,13590.0,10,17940,-8,13585.0,10,13590.0,1,S
2018-04-23 10:49:32,13585.0,12,17952,-6,13580.0,6,13585.0,4,S
2018-04-23 10:49:34,13585.0,8,17960,-8,13580.0,25,13590.0,2,S
2018-04-23 10:49:48,13585.0,2,17962,0,13585.0,11,13590.0,1,S
2018-04-23 10:50:00,13585.0,2,17964,0,13585.0,14,13595.0,9,S
2018-04-23 10:50:10,13590.0,2,17966,2,13585.0,14,13595.0,7,B
2018-04-23 10:50:20,13595.0,2,17968,2,13585.0,14,13595.0,8,B
2018-04-23 10:50:35,13595.0,2,17970,0,13590.0,3,13595.0,6,B
2018-04-23 10:51:14,13595.0,12,17982,-6,13590.0,26,13600.0,16,B
2018-04-23 10:51:24,13600.0,10,17992,0,13595.0,3,13600.0,8,B
2018-04-23 10:51:25,13600.0,16,18008,-6,13600.0,4,13605.0,5,B
2018-04-23 10:51:37,13600.0,10,18018,0,13595.0,13,13605.0,20,B
2018-04-23 10:51:40,13600.0,2,18020,0,13595.0,6,13605.0,22,B
2018-04-23 10:52:02,13600.0,2,18022,-2,13600.0,3,13605.0,14,B
2018-04-23 10:52:14,13600.0,2,18024,2,13600.0,12,13605.0,5,B
2018-04-23 10:52:39,13605.0,2,18026,2,13600.0,12,13605.0,3,B
2018-04-23 10:52:47,13600.0,20,18046,0,13600.0,2,13605.0,26,S
2018-04-23 10:52:48,13600.0,4,18050,0,13595.0,9,13600.0,1,S
2018-04-23 10:53:08,13595.0,4,18054,0,13590.0,12,13595.0,5,S
2018-04-23 10:53:09,13595.0,2,18056,0,13590.0,6,13595.0,4,S
2018-04-23 10:53:21,13595.0,8,18064,8,13590.0,17,13600.0,15,S
2018-04-23 10:54:53,13595.0,4,18068,0,13595.0,9,13600.0,5,S
2018-04-23 10:55:02,13600.0,10,18078,-8,13595.0,9,13605.0,7,B
2018-04-23 10:56:43,13600.0,2,18080,0,13595.0,2,13600.0,5,B
2018-04-23 10:56:59,13595.0,4,18084,2,13595.0,1,13600.0,22,S
2018-04-23 10:57:05,13595.0,2,18086,-2,13590.0,13,13600.0,22,S
2018-04-23 10:57:08,13595.0,2,18088,2,13595.0,4,13600.0,22,S
2018-04-23 10:57:31,13595.0,8,18096,0,13590.0,12,13595.0,1,S
2018-04-23 10:57:46,13595.0,2,18098,0,13590.0,12,13600.0,22,S
2018-04-23 10:58:12,13600.0,6,18104,0,13600.0,3,13605.0,10,B
2018-04-23 10:58:26,13605.0,4,18108,0,13600.0,11,13605.0,2,B
2018-04-23 10:58:27,13605.0,4,18112,-4,13600.0,10,13605.0,1,B
2018-04-23 10:58:28,13605.0,2,18114,-2,13605.0,1,13610.0,20,B
2018-04-23 10:58:28,13605.0,2,18116,-2,13600.0,16,13610.0,23,B
2018-04-23 10:58:42,13605.0,2,18118,2,13605.0,3,13610.0,24,B
2018-04-23 10:58:43,13605.0,6,18124,6,13600.0,14,13610.0,12,B
2018-04-23 10:58:45,13600.0,6,18130,0,13595.0,15,13605.0,10,S
2018-04-23 10:58:45,13595.0,6,18136,0,13595.0,12,13600.0,1,S
2018-04-23 10:59:09,13595.0,12,18148,0,13590.0,10,13595.0,7,S
2018-04-23 10:59:09,13590.0,12,18160,4,13590.0,1,13595.0,10,S
2018-04-23 10:59:10,13590.0,4,18164,2,13585.0,19,13595.0,9,S
2018-04-23 10:59:10,13590.0,2,18166,0,13585.0,22,13595.0,15,S
2018-04-23 10:59:14,13590.0,8,18174,8,13590.0,16,13595.0,17,S
2018-04-23 10:59:15,13590.0,20,18194,20,13590.0,6,13595.0,17,S
2018-04-23 10:59:16,13585.0,16,18210,12,13585.0,3,13595.0,17,S
2018-04-23 10:59:17,13580.0,12,18222,10,13585.0,1,13590.0,4,S
2018-04-23 10:59:17,13585.0,2,18224,0,13585.0,1,13590.0,4,B
2018-04-23 10:59:34,13585.0,2,18226,0,13585.0,1,13590.0,6,B
2018-04-23 10:59:35,13585.0,2,18228,2,13580.0,2,13590.0,14,B
2018-04-23 10:59:38,13580.0,4,18232,2,13575.0,3,13580.0,4,S
2018-04-23 10:59:40,13580.0,10,18242,-2,13575.0,21,13585.0,9,S
2018-04-23 10:59:44,13580.0,2,18244,2,13580.0,2,13585.0,2,S
2018-04-23 10:59:44,13585.0,4,18248,-2,13580.0,7,13590.0,21,B
2018-04-23 10:59:48,13580.0,8,18256,-6,13580.0,5,13590.0,11,S
2018-04-23 10:59:55,13590.0,2,18258,-2,13585.0,13,13595.0,4,B
2018-04-23 11:00:02,13595.0,6,18264,2,13595.0,3,13600.0,4,B
2018-04-23 11:00:20,13600.0,4,18268,-2,13595.0,8,13605.0,3,B
2018-04-23 11:00:21,13600.0,2,18270,0,13595.0,7,13600.0,5,B
2018-04-23 11:00:22,13595.0,2,18272,0,13595.0,1,13600.0,11,S
2018-04-23 11:00:23,13595.0,2,18274,2,13590.0,6,13600.0,24,S
2018-04-23 11:00:43,13595.0,4,18278,-2,13590.0,8,13600.0,3,S
2018-04-23 11:01:06,13595.0,4,18282,-4,13590.0,12,13600.0,4,S
2018-04-23 11:01:33,13595.0,2,18284,0,13590.0,9,13600.0,5,S
2018-04-23 11:01:47,13595.0,2,18286,2,13590.0,7,13595.0,1,S
2018-04-23 11:01:58,13595.0,6,18292,0,13595.0,7,13600.0,16,S
2018-04-23 11:02:11,13600.0,4,18296,-2,13595.0,11,13605.0,17,B
2018-04-23 11:02:14,13605.0,2,18298,2,13595.0,11,13605.0,21,B
2018-04-23 11:02:33,13600.0,6,18304,6,13600.0,1,13605.0,11,S
2018-04-23 11:02:33,13600.0,2,18306,0,13595.0,17,13600.0,1,S
2018-04-23 11:02:34,13595.0,4,18310,2,13595.0,16,13605.0,11,S
2018-04-23 11:02:51,13595.0,32,18342,26,13590.0,5,13600.0,12,S
2018-04-23 11:02:54,13590.0,12,18354,-8,13585.0,10,13590.0,4,S
2018-04-23 11:02:54,13590.0,8,18362,0,13585.0,12,13595.0,2,S
2018-04-23 11:03:01,13595.0,2,18364,-2,13590.0,5,13600.0,10,B
2018-04-23 11:03:10,13600.0,4,18368,0,13595.0,1,13600.0,1,B
2018-04-23 11:03:16,13600.0,10,18378,2,13590.0,6,13600.0,6,B
2018-04-23 11:03:20,13595.0,2,18380,2,13595.0,99,13600.0,8,S
2018-04-23 11:03:29,13600.0,10,18390,-8,13600.0,2,13605.0,5,B
2018-04-23 11:03:30,13600.0,4,18394,4,13600.0,1,13605.0,6,B
2018-04-23 11:03:30,13600.0,2,18396,0,13595.0,103,13600.0,3,B
2018-04-23 11:03:31,13595.0,8,18404,0,13595.0,102,13605.0,9,S
2018-04-23 11:03:33,13595.0,6,18410,6,13595.0,102,13605.0,11,S
2018-04-23 11:03:45,13600.0,2,18412,-2,13600.0,1,13605.0,13,B
2018-04-23 11:03:46,13600.0,2,18414,0,13595.0,103,13605.0,13,B
2018-04-23 11:03:51,13600.0,2,18416,0,13600.0,1,13605.0,13,B
2018-04-23 11:03:52,13600.0,2,18418,0,13600.0,1,13605.0,12,B
2018-04-23 11:03:53,13600.0,2,18420,2,13600.0,1,13605.0,12,B
2018-04-23 11:03:54,13600.0,4,18424,-2,13595.0,102,13600.0,8,B
2018-04-23 11:03:54,13600.0,4,18428,0,13595.0,103,13600.0,6,B
2018-04-23 11:03:55,13600.0,14,18442,-12,13595.0,103,13605.0,13,B
2018-04-23 11:03:57,13600.0,2,18444,2,13595.0,103,13605.0,12,B
2018-04-23 11:04:06,13605.0,4,18448,-4,13600.0,5,13605.0,7,B
2018-04-23 11:04:08,13600.0,10,18458,-8,13595.0,102,13605.0,7,S
2018-04-23 11:04:10,13605.0,4,18462,0,13600.0,2,13605.0,7,B
2018-04-23 11:04:20,13600.0,12,18474,-8,13595.0,115,13600.0,4,S
2018-04-23 11:04:21,13600.0,4,18478,0,13595.0,100,13600.0,3,S
2018-04-23 11:04:25,13600.0,6,18484,0,13600.0,1,13605.0,6,S
2018-04-23 11:04:27,13600.0,2,18486,0,13595.0,101,13600.0,9,S
2018-04-23 11:04:29,13600.0,18,18504,0,13600.0,1,13605.0,9,S
2018-04-23 11:04:29,13600.0,2,18506,2,13595.0,101,13605.0,9,S
2018-04-23 11:04:30,13600.0,2,18508,0,13595.0,101,13605.0,9,S
2018-04-23 11:04:37,13600.0,2,18510,2,13595.0,101,13605.0,10,S
2018-04-23 11:04:42,13600.0,2,18512,2,13600.0,1,13605.0,5,S
2018-04-23 11:04:44,13605.0,20,18532,0,13605.0,90,13610.0,35,B
2018-04-23 11:04:45,13605.0,4,18536,4,13605.0,88,13610.0,43,B
2018-04-23 11:04:50,13605.0,6,18542,0,13605.0,86,13610.0,46,B
2018-04-23 11:04:51,13605.0,2,18544,0,13605.0,85,13610.0,46,B
2018-04-23 11:04:51,13605.0,2,18546,0,13605.0,84,13610.0,46,B
2018-04-23 11:04:54,13605.0,2,18548,0,13605.0,83,13610.0,33,B
2018-04-23 11:04:55,13605.0,6,18554,0,13605.0,80,13610.0,33,B
2018-04-23 11:04:55,13605.0,2,18556,0,13605.0,79,13610.0,33,B
2018-04-23 11:05:11,13605.0,20,18576,18,13605.0,69,13610.0,34,B
2018-04-23 11:05:12,13605.0,6,18582,0,13605.0,66,13610.0,34,B
2018-04-23 11:05:27,13605.0,16,18598,8,13605.0,57,13610.0,35,B
2018-04-23 11:05:28,13605.0,6,18604,0,13605.0,54,13610.0,35,B
2018-04-23 11:05:28,13600.0,112,18716,30,13600.0,1,13610.0,40,S
2018-04-23 11:05:29,13605.0,4,18720,-4,13605.0,1,13610.0,20,B
2018-04-23 11:05:29,13605.0,2,18722,0,13600.0,7,13605.0,2,B
2018-04-23 11:05:31,13600.0,4,18726,4,13595.0,2,13600.0,3,S
2018-04-23 11:05:38,13600.0,2,18728,-2,13595.0,17,13605.0,7,S
2018-04-23 11:05:39,13600.0,2,18730,-2,13595.0,5,13605.0,7,S
2018-04-23 11:05:42,13600.0,2,18732,0,13595.0,6,13605.0,7,S
2018-04-23 11:06:14,13600.0,10,18742,2,13595.0,8,13605.0,10,S
2018-04-23 11:06:39,13600.0,8,18750,2,13595.0,20,13600.0,6,S
2018-04-23 11:06:43,13605.0,30,18780,24,13605.0,85,13610.0,17,B
2018-04-23 11:06:44,13605.0,20,18800,6,13605.0,75,13610.0,19,B
2018-04-23 11:06:54,13605.0,44,18844,8,13605.0,53,13610.0,27,B
2018-04-23 11:06:56,13605.0,2,18846,0,13605.0,52,13610.0,24,B
2018-04-23 11:07:07,13610.0,14,18860,0,13605.0,58,13610.0,9,B
2018-04-23 11:07:07,13610.0,12,18872,0,13610.0,1,13615.0,15,B
2018-04-23 11:07:13,13615.0,10,18882,-8,13610.0,2,13615.0,13,B
2018-04-23 11:07:15,13610.0,6,18888,2,13605.0,60,13610.0,7,S
2018-04-23 11:07:20,13610.0,10,18898,0,13605.0,60,13610.0,2,S
2018-04-23 11:07:28,13610.0,4,18902,4,13610.0,19,13615.0,10,S
2018-04-23 11:07:28,13615.0,8,18910,-2,13610.0,17,13615.0,5,B
2018-04-23 11:07:31,13610.0,4,18914,4,13610.0,14,13615.0,6,S
2018-04-23 11:07:34,13615.0,10,18924,-10,13610.0,14,13615.0,1,B
2018-04-23 11:07:36,13615.0,2,18926,0,13615.0,3,13620.0,8,B
2018-04-23 11:07:36,13615.0,4,18930,2,13615.0,4,13620.0,7,B
2018-04-23 11:07:39,13620.0,14,18944,6,13615.0,12,13625.0,2,B
2018-04-23 11:07:49,13620.0,68,19012,34,13620.0,16,13625.0,25,B
2018-04-23 11:07:50,13620.0,2,19014,2,13620.0,15,13625.0,23,B
2018-04-23 11:07:56,13625.0,2,19016,0,13620.0,16,13625.0,23,B
2018-04-23 11:08:09,13625.0,10,19026,-4,13620.0,18,13625.0,18,B
2018-04-23 11:08:18,13625.0,38,19064,-4,13620.0,19,13630.0,36,B
2018-04-23 11:08:21,13625.0,8,19072,-4,13620.0,25,13630.0,15,B
2018-04-23 11:08:26,13625.0,4,19076,0,13620.0,25,13625.0,5,B
2018-04-23 11:08:26,13625.0,10,19086,0,13625.0,11,13630.0,9,B
2018-04-23 11:08:28,13625.0,2,19088,2,13625.0,11,13630.0,9,B
2018-04-23 11:08:32,13630.0,18,19106,16,13625.0,4,13630.0,1,B
2018-04-23 11:08:32,13630.0,4,19110,0,13625.0,3,13630.0,7,B
2018-04-23 11:08:33,13630.0,6,19116,0,13630.0,1,13635.0,5,B
2018-04-23 11:08:33,13630.0,4,19120,2,13630.0,3,13635.0,9,B
2018-04-23 11:08:34,13630.0,6,19126,2,13625.0,12,13630.0,3,B
2018-04-23 11:08:34,13630.0,2,19128,0,13625.0,4,13630.0,8,B
2018-04-23 11:08:38,13625.0,2,19130,0,13625.0,21,13630.0,11,S
2018-04-23 11:08:45,13625.0,2,19132,2,13625.0,25,13630.0,11,S
2018-04-23 11:08:45,13630.0,2,19134,0,13625.0,25,13630.0,11,B
2018-04-23 11:08:46,13625.0,2,19136,2,13625.0,24,13630.0,11,S
2018-04-23 11:08:54,13630.0,8,19144,-6,13625.0,24,13630.0,8,B
2018-04-23 11:09:01,13625.0,2,19146,0,13625.0,20,13630.0,8,S
2018-04-23 11:09:05,13625.0,2,19148,2,13625.0,19,13630.0,20,S
2018-04-23 11:09:07,13625.0,2,19150,0,13625.0,18,13630.0,20,S
2018-04-23 11:09:08,13625.0,24,19174,24,13625.0,4,13630.0,20,S
2018-04-23 11:09:09,13625.0,8,19182,6,13620.0,8,13625.0,8,S
2018-04-23 11:09:10,13625.0,2,19184,2,13620.0,5,13625.0,15,S
2018-04-23 11:09:20,13620.0,10,19194,4,13620.0,2,13625.0,14,S
2018-04-23 11:09:29,13620.0,10,19204,8,13620.0,7,13625.0,12,S
2018-04-23 11:09:34,13625.0,12,19216,6,13620.0,1,13625.0,9,B
2018-04-23 11:09:36,13625.0,2,19218,0,13620.0,2,13625.0,5,B
2018-04-23 11:09:57,13625.0,10,19228,-10,13620.0,3,13630.0,19,B
2018-04-23 11:10:02,13620.0,6,19234,-2,13615.0,6,13620.0,1,S
2018-04-23 11:10:10,13620.0,2,19236,0,13615.0,19,13620.0,2,S
2018-04-23 11:10:11,13620.0,4,19240,0,13620.0,2,13625.0,5,S
2018-04-23 11:10:26,13615.0,2,19242,0,13615.0,5,13620.0,1,S
2018-04-23 11:10:30,13620.0,2,19244,0,13620.0,5,13625.0,5,B
2018-04-23 11:10:31,13620.0,10,19254,2,13620.0,4,13625.0,5,B
2018-04-23 11:10:35,13625.0,10,19264,0,13620.0,6,13630.0,29,B
2018-04-23 11:10:37,13630.0,2,19266,0,13625.0,5,13630.0,27,B
2018-04-23 11:10:38,13625.0,6,19272,6,13625.0,11,13630.0,35,S
2018-04-23 11:10:38,13625.0,4,19276,4,13625.0,9,13630.0,35,S
2018-04-23 11:10:39,13625.0,18,19294,6,13620.0,8,13630.0,35,S
2018-04-23 11:10:52,13620.0,20,19314,-8,13615.0,28,13620.0,2,S
2018-04-23 11:10:53,13620.0,4,19318,-4,13620.0,1,13625.0,1,S
2018-04-23 11:11:11,13625.0,2,19320,0,13615.0,14,13625.0,6,B
2018-04-23 11:11:50,13625.0,10,19330,-8,13615.0,15,13625.0,5,B
2018-04-23 11:11:59,13620.0,8,19338,-2,13620.0,2,13625.0,5,S
2018-04-23 11:12:03,13625.0,2,19340,0,13625.0,1,13630.0,23,B
2018-04-23 11:12:17,13630.0,2,19342,0,13625.0,3,13630.0,19,B
2018-04-23 11:12:30,13625.0,2,19344,0,13620.0,11,13625.0,1,S
2018-04-23 11:12:31,13625.0,2,19346,0,13620.0,11,13630.0,23,S
2018-04-23 11:12:43,13625.0,2,19348,-2,13625.0,5,13630.0,22,S
2018-04-23 11:12:57,13625.0,10,19358,0,13620.0,7,13630.0,33,S
2018-04-23 11:13:05,13625.0,2,19360,-2,13625.0,7,13630.0,21,S
2018-04-23 11:13:06,13630.0,4,19364,2,13625.0,2,13630.0,20,B
2018-04-23 11:13:08,13625.0,4,19368,4,13620.0,8,13630.0,24,S
2018-04-23 11:13:20,13620.0,4,19372,0,13615.0,8,13620.0,8,S
2018-04-23 11:13:23,13615.0,8,19380,4,13610.0,12,13620.0,10,S
2018-04-23 11:13:52,13615.0,10,19390,10,13610.0,16,13620.0,11,S
2018-04-23 11:13:53,13610.0,2,19392,0,13610.0,15,13620.0,11,S
2018-04-23 11:14:05,13610.0,2,19394,0,13610.0,14,13620.0,12,S
2018-04-23 11:14:14,13615.0,2,19396,0,13610.0,13,13615.0,2,B
2018-04-23 11:14:15,13615.0,4,19400,-4,13615.0,13,13620.0,12,B
2018-04-23 11:14:17,13615.0,4,19404,-4,13615.0,11,13620.0,12,B
2018-04-23 11:14:25,13620.0,2,19406,-2,13615.0,16,13620.0,7,B
2018-04-23 11:14:40,13615.0,10,19416,-10,13615.0,10,13620.0,14,S
2018-04-23 11:15:10,13615.0,2,19418,0,13615.0,9,13620.0,11,S
2018-04-23 11:15:10,13615.0,18,19436,-2,13610.0,11,13615.0,1,S
2018-04-23 11:15:16,13615.0,2,19438,0,13610.0,9,13615.0,4,S
2018-04-23 11:15:19,13615.0,2,19440,2,13610.0,9,13615.0,3,S
2018-04-23 11:15:21,13610.0,2,19442,0,13610.0,8,13615.0,9,S
2018-04-23 11:15:22,13610.0,16,19458,-10,13605.0,6,13615.0,19,S
2018-04-23 11:15:24,13605.0,2,19460,2,13605.0,4,13610.0,3,S
2018-04-23 11:15:27,13605.0,2,19462,0,13605.0,2,13610.0,3,S
2018-04-23 11:15:33,13605.0,2,19464,0,13600.0,6,13610.0,6,S
2018-04-23 11:15:46,13600.0,6,19470,6,13600.0,6,13610.0,7,S
2018-04-23 11:15:47,13600.0,2,19472,0,13600.0,5,13610.0,7,S
2018-04-23 11:16:04,13610.0,8,19480,6,13605.0,11,13615.0,16,B
2018-04-23 11:16:15,13615.0,4,19484,-2,13610.0,12,13615.0,9,B
2018-04-23 11:16:19,13610.0,2,19486,0,13610.0,8,13615.0,9,S
2018-04-23 11:16:32,13615.0,2,19488,0,13610.0,7,13615.0,8,B
2018-04-23 11:16:36,13610.0,2,19490,-2,13605.0,7,13610.0,3,S
2018-04-23 11:16:56,13605.0,4,19494,-2,13605.0,1,13610.0,1,S
2018-04-23 11:17:07,13605.0,16,19510,4,13605.0,1,13615.0,15,S
2018-04-23 11:17:19,13605.0,8,19518,4,13600.0,4,13615.0,16,S
2018-04-23 11:17:26,13605.0,6,19524,6,13605.0,7,13615.0,16,S
2018-04-23 11:17:31,13615.0,2,19526,0,13610.0,4,13615.0,8,B
2018-04-23 11:17:39,13615.0,2,19528,0,13610.0,4,13615.0,8,B
2018-04-23 11:17:43,13610.0,10,19538,4,13605.0,8,13615.0,8,S
2018-04-23 11:17:46,13615.0,2,19540,-2,13610.0,1,13615.0,7,B
2018-04-23 11:17:59,13610.0,2,19542,0,13605.0,8,13615.0,6,S
2018-04-23 11:18:05,13610.0,4,19546,2,13605.0,4,13610.0,4,S
2018-04-23 11:18:09,13610.0,2,19548,-2,13605.0,8,13615.0,12,S
2018-04-23 11:19:00,13610.0,2,19550,-2,13610.0,8,13615.0,8,S
2018-04-23 11:19:42,13610.0,6,19556,-6,13610.0,5,13615.0,9,S
2018-04-23 11:19:45,13615.0,2,19558,-2,13610.0,9,13615.0,8,B
2018-04-23 11:19:46,13615.0,16,19574,-8,13615.0,1,13620.0,5,B
2018-04-23 11:19:52,13610.0,2,19576,0,13610.0,10,13620.0,6,S
2018-04-23 11:20:05,13620.0,4,19580,-4,13620.0,1,13625.0,6,B
2018-04-23 11:20:18,13620.0,2,19582,0,13615.0,9,13620.0,1,B
2018-04-23 11:20:18,13620.0,2,19584,-2,13620.0,2,13625.0,6,B
2018-04-23 11:20:20,13620.0,2,19586,-2,13615.0,9,13625.0,8,B
2018-04-23 11:20:25,13620.0,18,19604,-12,13620.0,16,13625.0,10,B
2018-04-23 11:20:26,13620.0,12,19616,0,13620.0,4,13625.0,9,B
2018-04-23 11:20:27,13620.0,8,19624,-2,13615.0,5,13625.0,9,B
2018-04-23 11:20:28,13620.0,4,19628,-4,13615.0,10,13625.0,9,B
2018-04-23 11:20:30,13625.0,2,19630,0,13615.0,10,13625.0,8,B
2018-04-23 11:20:34,13625.0,4,19634,2,13615.0,10,13625.0,6,B
2018-04-23 11:20:39,13620.0,4,19638,-4,13615.0,10,13620.0,1,S
2018-04-23 11:20:41,13620.0,22,19660,10,13615.0,11,13625.0,8,S
2018-04-23 11:20:51,13615.0,2,19662,0,13615.0,11,13625.0,8,S
2018-04-23 11:20:59,13625.0,2,19664,0,13615.0,11,13625.0,7,B
2018-04-23 11:21:04,13625.0,4,19668,2,13620.0,10,13625.0,1,B
2018-04-23 11:21:05,13625.0,2,19670,-2,13625.0,3,13630.0,23,B
2018-04-23 11:21:10,13630.0,12,19682,4,13625.0,22,13630.0,16,B
2018-04-23 11:21:11,13630.0,32,19714,-8,13625.0,22,13635.0,7,B
2018-04-23 11:21:19,13635.0,4,19718,-2,13630.0,11,13635.0,10,B
2018-04-23 11:21:26,13635.0,2,19720,0,13630.0,5,13635.0,11,B
2018-04-23 11:21:27,13635.0,2,19722,0,13630.0,5,13635.0,10,B
2018-04-23 11:21:29,13630.0,2,19724,2,13625.0,18,13635.0,13,S
2018-04-23 11:21:31,13630.0,2,19726,0,13625.0,20,13635.0,29,S
2018-04-23 11:21:35,13635.0,4,19730,2,13630.0,2,13635.0,22,B
2018-04-23 11:21:36,13630.0,12,19742,0,13625.0,19,13635.0,25,S
2018-04-23 11:21:43,13630.0,2,19744,2,13625.0,19,13635.0,24,S
2018-04-23 11:22:06,13625.0,6,19750,0,13625.0,3,13630.0,13,S
2018-04-23 11:22:07,13625.0,6,19756,-2,13620.0,6,13630.0,13,S
2018-04-23 11:22:22,13620.0,10,19766,4,13615.0,18,13625.0,9,S
2018-04-23 11:22:32,13625.0,2,19768,-2,13620.0,5,13630.0,16,B
2018-04-23 11:22:52,13620.0,4,19772,0,13620.0,3,13630.0,15,S
2018-04-23 11:23:39,13620.0,6,19778,0,13615.0,3,13620.0,5,S
2018-04-23 11:23:43,13625.0,2,19780,-2,13620.0,5,13625.0,3,B
2018-04-23 11:23:46,13620.0,2,19782,-2,13620.0,3,13625.0,9,S
2018-04-23 11:23:48,13615.0,4,19786,-4,13615.0,4,13625.0,11,S
2018-04-23 11:23:58,13620.0,6,19792,-4,13615.0,4,13625.0,11,B
2018-04-23 11:24:34,13620.0,2,19794,-2,13620.0,3,13625.0,8,B
2018-04-23 11:24:50,13625.0,2,19796,0,13620.0,3,13625.0,4,B
2018-04-23 11:25:01,13620.0,4,19800,-4,13615.0,13,13620.0,1,S
2018-04-23 11:25:01,13620.0,2,19802,0,13615.0,14,13625.0,4,S
2018-04-23 11:25:30,13620.0,4,19806,0,13615.0,3,13620.0,1,S
2018-04-23 11:25:44,13620.0,2,19808,2,13615.0,4,13620.0,2,S
2018-04-23 11:26:08,13620.0,6,19814,4,13620.0,1,13625.0,8,S
2018-04-23 11:26:08,13625.0,16,19830,-4,13620.0,6,13630.0,10,B
2018-04-23 11:26:09,13630.0,10,19840,4,13625.0,10,13630.0,1,B
2018-04-23 11:26:09,13630.0,2,19842,0,13630.0,1,13635.0,23,B
2018-04-23 11:26:10,13630.0,8,19850,0,13625.0,15,13635.0,23,B
2018-04-23 11:26:12,13625.0,2,19852,0,13625.0,1,13630.0,9,S
2018-04-23 11:26:12,13625.0,2,19854,-2,13620.0,8,13630.0,13,S
2018-04-23 11:26:13,13620.0,2,19856,2,13620.0,4,13630.0,15,S
2018-04-23 11:26:20,13625.0,2,19858,0,13620.0,3,13625.0,4,B
2018-04-23 11:26:21,13625.0,8,19866,6,13620.0,12,13630.0,15,B
2018-04-23 11:26:34,13635.0,2,19868,0,13630.0,7,13635.0,19,B
2018-04-23 11:26:37,13635.0,2,19870,0,13630.0,5,13635.0,19,B
2018-04-23 11:26:41,13635.0,4,19874,0,13630.0,7,13635.0,7,B
2018-04-23 11:26:41,13635.0,2,19876,-2,13630.0,8,13635.0,2,B
2018-04-23 11:26:44,13630.0,18,19894,-8,13625.0,25,13630.0,5,S
2018-04-23 11:26:45,13630.0,10,19904,0,13625.0,35,13635.0,3,S
2018-04-23 11:26:46,13630.0,4,19908,-4,13625.0,13,13635.0,12,S
2018-04-23 11:26:50,13630.0,10,19918,6,13625.0,8,13635.0,12,S
2018-04-23 11:26:56,13630.0,2,19920,0,13625.0,13,13635.0,14,S
2018-04-23 11:26:58,13635.0,10,19930,2,13625.0,13,13635.0,11,B
2018-04-23 11:27:03,13635.0,8,19938,-2,13630.0,5,13640.0,4,B
2018-04-23 11:27:04,13640.0,6,19944,0,13640.0,1,13645.0,6,B
2018-04-23 11:27:04,13645.0,2,19946,0,13640.0,4,13645.0,4,B
2018-04-23 11:27:05,13640.0,8,19954,-4,13635.0,27,13640.0,18,S
2018-04-23 11:27:06,13640.0,2,19956,-2,13635.0,22,13640.0,20,S
2018-04-23 11:27:07,13640.0,28,19984,0,13635.0,40,13640.0,3,S
2018-04-23 11:27:07,13640.0,6,19990,-6,13635.0,40,13645.0,11,S
2018-04-23 11:27:09,13640.0,6,19996,2,13635.0,14,13640.0,1,S
2018-04-23 11:27:10,13635.0,4,20000,0,13635.0,1,13640.0,9,S
2018-04-23 11:27:11,13635.0,2,20002,2,13630.0,9,13635.0,1,S
2018-04-23 11:27:11,13635.0,2,20004,2,13630.0,9,13640.0,10,S
2018-04-23 11:27:14,13640.0,2,20006,0,13640.0,9,13645.0,14,B
2018-04-23 11:27:15,13645.0,20,20026,4,13635.0,12,13640.0,1,B
2018-04-23 11:27:15,13640.0,2,20028,-2,13635.0,12,13645.0,13,S
2018-04-23 11:27:19,13635.0,12,20040,10,13635.0,2,13640.0,9,S
2018-04-23 11:27:25,13640.0,2,20042,2,13640.0,7,13645.0,7,B
2018-04-23 11:27:29,13645.0,4,20046,0,13645.0,1,13650.0,62,B
2018-04-23 11:27:31,13650.0,6,20052,-6,13645.0,5,13650.0,58,B
2018-04-23 11:27:32,13650.0,2,20054,-2,13645.0,5,13650.0,57,B
2018-04-23 11:27:33,13650.0,2,20056,-2,13640.0,10,13650.0,61,B
2018-04-23 11:27:34,13645.0,4,20060,-4,13640.0,4,13645.0,1,S
2018-04-23 11:27:38,13645.0,2,20062,0,13640.0,5,13650.0,62,S
2018-04-23 11:27:41,13645.0,10,20072,0,13640.0,24,13650.0,56,S
2018-04-23 11:27:46,13645.0,2,20074,-2,13640.0,31,13650.0,59,S
2018-04-23 11:27:50,13645.0,4,20078,0,13640.0,2,13645.0,1,S
2018-04-23 11:27:54,13645.0,2,20080,0,13640.0,4,13645.0,3,S
2018-04-23 11:27:58,13645.0,6,20086,0,13645.0,8,13650.0,59,S
2018-04-23 11:27:58,13645.0,16,20102,0,13640.0,7,13650.0,59,S
2018-04-23 11:28:01,13645.0,8,20110,0,13640.0,10,13650.0,61,S
2018-04-23 11:28:01,13650.0,4,20114,-4,13640.0,10,13650.0,59,B
2018-04-23 11:28:04,13650.0,10,20124,6,13645.0,17,13650.0,50,B
2018-04-23 11:28:04,13650.0,44,20168,44,13645.0,35,13650.0,28,B
2018-04-23 11:28:05,13655.0,58,20226,42,13645.0,39,13655.0,2,B
2018-04-23 11:28:05,13655.0,4,20230,4,13655.0,1,13660.0,12,B
2018-04-23 11:28:06,13660.0,20,20250,-16,13655.0,3,13660.0,2,B
2018-04-23 11:28:07,13660.0,6,20256,2,13660.0,3,13665.0,6,B
2018-04-23 11:28:07,13660.0,8,20264,-2,13655.0,4,13660.0,2,B
2018-04-23 11:28:08,13655.0,6,20270,2,13650.0,7,13660.0,16,S
2018-04-23 11:28:11,13650.0,2,20272,2,13645.0,14,13655.0,8,S
2018-04-23 11:28:23,13655.0,2,20274,0,13650.0,5,13655.0,2,B
2018-04-23 11:28:26,13650.0,8,20282,4,13645.0,16,13655.0,9,S
2018-04-23 11:28:27,13645.0,20,20302,-2,13645.0,7,13655.0,9,S
2018-04-23 11:28:42,13650.0,2,20304,0,13645.0,51,13650.0,2,B
2018-04-23 11:28:42,13650.0,4,20308,0,13645.0,51,13655.0,7,B
2018-04-23 11:28:49,13655.0,4,20312,2,13650.0,16,13660.0,18,B
2018-04-23 11:28:51,13660.0,4,20316,-2,13655.0,13,13665.0,9,B
2018-04-23 11:28:52,13660.0,10,20326,2,13660.0,22,13670.0,9,B
2018-04-23 11:28:53,13665.0,42,20368,0,13660.0,4,13670.0,9,B
2018-04-23 11:28:54,13660.0,24,20392,24,13655.0,2,13665.0,9,S
2018-04-23 11:28:58,13660.0,4,20396,0,13655.0,4,13660.0,1,S
2018-04-23 11:28:59,13655.0,2,20398,0,13655.0,5,13665.0,8,S
2018-04-23 11:28:59,13665.0,2,20400,-2,13660.0,1,13665.0,7,B
2018-04-23 11:29:00,13655.0,2,20402,0,13655.0,3,13665.0,3,S
2018-04-23 11:29:01,13655.0,12,20414,-2,13660.0,3,13670.0,10,S
2018-04-23 11:29:04,13670.0,10,20424,2,13665.0,8,13670.0,6,B
2018-04-23 11:29:05,13670.0,6,20430,2,13665.0,10,13670.0,3,B
2018-04-23 11:29:08,13670.0,10,20440,4,13660.0,16,13670.0,2,B
2018-04-23 11:29:11,13665.0,2,20442,2,13660.0,16,13665.0,1,S
2018-04-23 11:29:12,13665.0,2,20444,0,13665.0,9,13670.0,6,S
2018-04-23 11:29:12,13665.0,8,20452,0,13660.0,13,13670.0,6,S
2018-04-23 11:29:16,13665.0,2,20454,0,13660.0,8,13665.0,6,S
2018-04-23 11:29:17,13660.0,4,20458,0,13660.0,11,13665.0,5,S
2018-04-23 11:29:19,13665.0,10,20468,0,13665.0,5,13670.0,8,B
2018-04-23 11:29:20,13665.0,4,20472,2,13665.0,3,13670.0,8,B
2018-04-23 11:29:21,13665.0,2,20474,0,13665.0,2,13670.0,10,B
2018-04-23 11:29:22,13665.0,4,20478,0,13660.0,11,13665.0,3,B
2018-04-23 11:29:23,13665.0,2,20480,0,13660.0,10,13665.0,2,B
2018-04-23 11:29:23,13665.0,4,20484,0,13660.0,6,13670.0,8,B
2018-04-23 11:29:24,13660.0,8,20492,6,13660.0,9,13670.0,8,S
2018-04-23 11:29:26,13665.0,2,20494,2,13660.0,11,13670.0,8,B
2018-04-23 11:29:27,13660.0,2,20496,2,13660.0,11,13670.0,8,S
2018-04-23 11:29:27,13670.0,4,20500,0,13665.0,1,13670.0,6,B
2018-04-23 11:29:28,13670.0,8,20508,-6,13665.0,1,13670.0,2,B
2018-04-23 11:29:30,13670.0,6,20514,2,13660.0,16,13670.0,1,B
2018-04-23 11:29:31,13665.0,6,20520,0,13660.0,14,13665.0,1,S
2018-04-23 11:29:32,13665.0,2,20522,0,13660.0,7,13665.0,4,S
2018-04-23 11:29:32,13660.0,4,20526,4,13660.0,5,13665.0,4,S
2018-04-23 11:29:34,13660.0,4,20530,0,13660.0,4,13665.0,1,S
2018-04-23 11:29:35,13660.0,2,20532,0,13660.0,3,13665.0,2,S
2018-04-23 11:29:37,13660.0,4,20536,0,13660.0,2,13665.0,1,S
2018-04-23 11:29:38,13660.0,4,20540,4,13655.0,4,13665.0,6,S
2018-04-23 11:29:41,13650.0,4,20544,4,13650.0,9,13660.0,6,S
2018-04-23 11:29:42,13650.0,4,20548,2,13650.0,4,13655.0,1,S
2018-04-23 11:29:43,13655.0,2,20550,0,13650.0,4,13655.0,1,B
2018-04-23 11:29:45,13655.0,8,20558,-2,13650.0,8,13660.0,10,B
2018-04-23 11:29:46,13655.0,6,20564,2,13655.0,1,13660.0,3,B
2018-04-23 11:29:47,13655.0,4,20568,2,13655.0,9,13660.0,3,B
2018-04-23 11:29:50,13655.0,2,20570,0,13655.0,7,13660.0,3,B
2018-04-23 11:29:53,13650.0,2,20572,2,13650.0,32,13660.0,3,S
2018-04-23 11:29:53,13650.0,4,20576,0,13650.0,30,13660.0,3,S
2018-04-23 13:30:01,13655.0,2,20578,0,13650.0,87,13655.0,3,B
2018-04-23 13:30:02,13655.0,6,20584,2,13655.0,1,13660.0,5,B
2018-04-23 13:30:02,13660.0,10,20594,4,13655.0,18,13665.0,2,B
2018-04-23 13:30:03,13665.0,2,20596,-2,13660.0,6,13670.0,1,B
2018-04-23 13:30:04,13665.0,20,20616,10,13655.0,7,13670.0,13,B
2018-04-23 13:30:06,13665.0,14,20630,4,13665.0,3,13670.0,19,B
2018-04-23 13:30:07,13655.0,10,20640,10,13650.0,89,13655.0,8,S
2018-04-23 13:30:07,13655.0,16,20656,14,13650.0,89,13665.0,4,S
2018-04-23 13:30:10,13655.0,8,20664,2,13655.0,10,13665.0,6,S
2018-04-23 13:30:11,13655.0,10,20674,-10,13655.0,2,13665.0,9,S
2018-04-23 13:30:13,13660.0,2,20676,0,13650.0,87,13660.0,9,B
2018-04-23 13:30:14,13655.0,12,20688,10,13655.0,5,13665.0,8,S
2018-04-23 13:30:15,13660.0,2,20690,2,13655.0,5,13665.0,2,B
2018-04-23 13:30:17,13660.0,12,20702,-10,13655.0,5,13665.0,3,B
2018-04-23 13:30:18,13655.0,2,20704,2,13655.0,1,13660.0,3,S
2018-04-23 13:30:19,13660.0,2,20706,0,13655.0,5,13660.0,3,B
2018-04-23 13:30:20,13655.0,2,20708,2,13655.0,5,13660.0,3,S
2018-04-23 13:30:22,13655.0,2,20710,2,13655.0,7,13660.0,3,S
2018-04-23 13:30:24,13655.0,2,20712,0,13650.0,89,13660.0,3,S
2018-04-23 13:30:30,13660.0,20,20732,6,13660.0,4,13665.0,2,B
2018-04-23 13:30:30,13655.0,10,20742,0,13650.0,87,13660.0,2,S
2018-04-23 13:30:31,13660.0,2,20744,0,13655.0,2,13665.0,7,B
2018-04-23 13:30:32,13660.0,2,20746,0,13655.0,2,13660.0,10,B
2018-04-23 13:30:34,13660.0,2,20748,0,13655.0,5,13660.0,2,B
2018-04-23 13:30:35,13660.0,2,20750,2,13655.0,8,13660.0,1,B
2018-04-23 13:30:38,13660.0,8,20758,6,13660.0,6,13665.0,9,B
2018-04-23 13:30:38,13665.0,8,20766,2,13660.0,3,13665.0,12,B
2018-04-23 13:30:39,13660.0,4,20770,0,13660.0,1,13665.0,12,S
2018-04-23 13:30:39,13660.0,2,20772,2,13655.0,4,13665.0,12,S
2018-04-23 13:30:40,13660.0,6,20778,6,13660.0,19,13665.0,1,S
2018-04-23 13:30:41,13665.0,2,20780,-2,13665.0,4,13670.0,9,B
2018-04-23 13:30:42,13665.0,8,20788,-8,13660.0,6,13665.0,1,B
2018-04-23 13:30:43,13660.0,6,20794,6,13655.0,6,13660.0,4,S
2018-04-23 13:30:45,13655.0,4,20798,2,13650.0,88,13660.0,6,S
2018-04-23 13:30:46,13660.0,14,20812,6,13650.0,88,13660.0,12,B
2018-04-23 13:30:48,13655.0,2,20814,-2,13655.0,8,13660.0,3,S
2018-04-23 13:30:48,13650.0,16,20830,4,13650.0,88,13655.0,14,S
2018-04-23 13:30:49,13650.0,42,20872,-12,13650.0,65,13655.0,25,S
2018-04-23 13:30:49,13650.0,122,20994,-64,13650.0,4,13655.0,29,S
2018-04-23 13:30:50,13650.0,8,21002,-8,13645.0,7,13650.0,1,S
2018-04-23 13:30:50,13650.0,2,21004,-2,13645.0,9,13655.0,9,S
2018-04-23 13:30:52,13645.0,12,21016,2,13640.0,6,13650.0,8,S
2018-04-23 13:30:55,13650.0,2,21018,0,13640.0,24,13650.0,3,B
2018-04-23 13:30:57,13645.0,2,21020,-2,13640.0,26,13650.0,6,S
2018-04-23 13:30:59,13645.0,4,21024,0,13645.0,4,13650.0,8,S
2018-04-23 13:31:00,13650.0,2,21026,-2,13645.0,7,13650.0,2,B
2018-04-23 13:31:01,13650.0,2,21028,0,13650.0,3,13655.0,8,B
2018-04-23 13:31:05,13650.0,2,21030,-2,13645.0,12,13650.0,1,B
2018-04-23 13:31:07,13650.0,2,21032,-2,13645.0,9,13650.0,5,B
2018-04-23 13:31:09,13650.0,4,21036,4,13645.0,10,13650.0,3,B
2018-04-23 13:31:10,13650.0,6,21042,-2,13650.0,1,13655.0,15,B
2018-04-23 13:31:12,13650.0,4,21046,0,13650.0,1,13655.0,10,B
2018-04-23 13:31:13,13650.0,2,21048,0,13645.0,15,13650.0,1,B
2018-04-23 13:31:13,13645.0,24,21072,-6,13640.0,20,13645.0,1,S
2018-04-23 13:31:14,13645.0,8,21080,2,13640.0,17,13645.0,2,S
2018-04-23 13:31:15,13650.0,16,21096,6,13645.0,17,13650.0,4,B
2018-04-23 13:31:15,13650.0,8,21104,8,13650.0,5,13655.0,9,B
2018-04-23 13:31:16,13650.0,2,21106,0,13650.0,8,13655.0,6,B
2018-04-23 13:31:17,13650.0,6,21112,-6,13645.0,29,13655.0,6,B
2018-04-23 13:31:29,13645.0,16,21128,4,13645.0,4,13650.0,13,S
2018-04-23 13:31:31,13645.0,6,21134,0,13640.0,20,13650.0,13,S
2018-04-23 13:31:33,13650.0,8,21142,0,13645.0,18,13650.0,7,B
2018-04-23 13:31:35,13650.0,2,21144,0,13645.0,2,13650.0,12,B
2018-04-23 13:31:36,13645.0,2,21146,0,13640.0,24,13645.0,3,S
2018-04-23 13:31:39,13640.0,12,21158,12,13640.0,6,13645.0,15,S
2018-04-23 13:31:39,13640.0,4,21162,0,13640.0,4,13645.0,14,S
2018-04-23 13:31:40,13640.0,4,21166,0,13640.0,2,13645.0,9,S
2018-04-23 13:31:46,13640.0,4,21170,4,13635.0,10,13640.0,6,S
2018-04-23 13:31:48,13640.0,12,21182,-6,13635.0,19,13645.0,10,S
2018-04-23 13:31:53,13640.0,2,21184,-2,13640.0,5,13645.0,9,S
2018-04-23 13:31:56,13640.0,2,21186,-2,13640.0,3,13645.0,9,S
2018-04-23 13:31:57,13640.0,2,21188,-2,13635.0,15,13645.0,9,S
2018-04-23 13:31:58,13640.0,10,21198,10,13635.0,15,13645.0,11,S
2018-04-23 13:32:00,13640.0,4,21202,-2,13635.0,14,13645.0,11,S
2018-04-23 13:32:03,13645.0,2,21204,-2,13635.0,14,13645.0,13,B
2018-04-23 13:32:06,13645.0,6,21210,2,13640.0,7,13650.0,14,B
2018-04-23 13:32:08,13645.0,4,21214,0,13640.0,12,13650.0,19,B
2018-04-23 13:32:10,13640.0,10,21224,0,13640.0,7,13650.0,19,S
2018-04-23 13:32:15,13650.0,8,21232,0,13645.0,18,13650.0,7,B
2018-04-23 13:32:16,13650.0,14,21246,-12,13650.0,2,13655.0,11,B
2018-04-23 13:32:21,13655.0,4,21250,4,13650.0,8,13655.0,4,B
2018-04-23 13:32:22,13655.0,10,21260,-2,13655.0,1,13660.0,2,B
2018-04-23 13:32:24,13660.0,2,21262,2,13660.0,2,13665.0,9,B
2018-04-23 13:32:28,13660.0,4,21266,0,13655.0,17,13660.0,3,B
2018-04-23 13:32:28,13660.0,8,21274,0,13660.0,9,13665.0,11,B
2018-04-23 13:32:29,13660.0,34,21308,0,13660.0,17,13665.0,4,B
2018-04-23 13:32:29,13660.0,18,21326,8,13655.0,13,13665.0,11,B
2018-04-23 13:32:32,13655.0,10,21336,8,13655.0,13,13665.0,8,S
2018-04-23 13:32:35,13660.0,8,21344,-8,13660.0,7,13665.0,11,B
2018-04-23 13:32:36,13660.0,22,21366,-16,13660.0,4,13665.0,6,B
2018-04-23 13:32:37,13660.0,8,21374,-8,13655.0,7,13660.0,7,B
2018-04-23 13:32:38,13655.0,2,21376,2,13650.0,8,13655.0,2,S
2018-04-23 13:32:39,13655.0,6,21382,-4,13655.0,7,13660.0,14,S
2018-04-23 13:32:41,13655.0,10,21392,0,13655.0,2,13660.0,11,S
2018-04-23 13:32:41,13660.0,22,21414,4,13660.0,2,13665.0,26,B
2018-04-23 13:32:42,13660.0,4,21418,2,13655.0,5,13660.0,16,B
2018-04-23 13:32:42,13655.0,4,21422,0,13650.0,7,13655.0,3,S
2018-04-23 13:32:43,13655.0,6,21428,0,13655.0,2,13660.0,12,S
2018-04-23 13:32:44,13655.0,2,21430,-2,13655.0,1,13660.0,9,S
2018-04-23 13:32:49,13655.0,2,21432,-2,13650.0,9,13660.0,5,S
2018-04-23 13:32:54,13660.0,12,21444,6,13655.0,18,13665.0,4,B
2018-04-23 13:32:55,13660.0,2,21446,-2,13655.0,18,13665.0,3,B
2018-04-23 13:32:56,13665.0,2,21448,-2,13655.0,17,13665.0,6,B
2018-04-23 13:32:59,13660.0,6,21454,-2,13660.0,4,13670.0,10,S
2018-04-23 13:33:04,13670.0,20,21474,16,13670.0,8,13675.0,3,B
2018-04-23 13:33:05,13675.0,6,21480,-6,13675.0,1,13680.0,16,B
2018-04-23 13:33:05,13675.0,4,21484,0,13675.0,5,13680.0,16,B
2018-04-23 13:33:06,13680.0,8,21492,4,13675.0,9,13680.0,11,B
2018-04-23 13:33:07,13680.0,2,21494,0,13675.0,11,13680.0,10,B
2018-04-23 13:33:08,13675.0,20,21514,2,13675.0,10,13680.0,1,S
2018-04-23 13:33:08,13680.0,4,21518,2,13680.0,1,13685.0,2,B
2018-04-23 13:33:09,13685.0,4,21522,-2,13680.0,4,13685.0,2,B
2018-04-23 13:33:10,13685.0,2,21524,0,13680.0,11,13690.0,9,B
2018-04-23 13:33:11,13685.0,2,21526,-2,13685.0,1,13690.0,9,B
2018-04-23 13:33:11,13695.0,20,21546,10,13690.0,1,13695.0,11,B
2018-04-23 13:33:12,13685.0,24,21570,-8,13685.0,1,13690.0,4,S
2018-04-23 13:33:12,13690.0,8,21578,0,13685.0,7,13695.0,11,B
2018-04-23 13:33:13,13690.0,2,21580,2,13685.0,3,13690.0,1,B
2018-04-23 13:33:13,13685.0,4,21584,0,13685.0,2,13690.0,5,S
2018-04-23 13:33:14,13685.0,4,21588,4,13680.0,4,13690.0,15,S
2018-04-23 13:33:14,13690.0,2,21590,0,13680.0,3,13690.0,18,B
2018-04-23 13:33:16,13680.0,8,21598,0,13675.0,13,13680.0,1,S
2018-04-23 13:33:16,13680.0,2,21600,0,13680.0,10,13685.0,1,S
2018-04-23 13:33:17,13685.0,2,21602,0,13680.0,9,13690.0,19,B
2018-04-23 13:33:18,13690.0,6,21608,-6,13680.0,10,13690.0,9,B
2018-04-23 13:33:19,13690.0,2,21610,0,13685.0,10,13690.0,1,B
2018-04-23 13:33:19,13690.0,2,21612,0,13685.0,13,13695.0,18,B
2018-04-23 13:33:21,13695.0,10,21622,2,13685.0,13,13695.0,14,B
2018-04-23 13:33:21,13685.0,2,21624,0,13685.0,10,13695.0,14,S
2018-04-23 13:33:22,13690.0,2,21626,2,13685.0,7,13695.0,15,B
2018-04-23 13:33:22,13685.0,4,21630,-2,13685.0,1,13690.0,14,S
2018-04-23 13:33:23,13685.0,2,21632,0,13680.0,9,13690.0,21,S
2018-04-23 13:33:31,13685.0,2,21634,0,13685.0,13,13690.0,3,S
2018-04-23 13:33:31,13685.0,2,21636,0,13685.0,11,13690.0,4,S
2018-04-23 13:33:32,13685.0,6,21642,0,13680.0,9,13690.0,20,S
2018-04-23 13:33:37,13685.0,2,21644,0,13680.0,6,13685.0,4,S
2018-04-23 13:33:39,13680.0,12,21656,0,13675.0,11,13685.0,9,S
2018-04-23 13:33:40,13680.0,2,21658,0,13675.0,10,13685.0,17,S
2018-04-23 13:33:42,13680.0,2,21660,0,13675.0,8,13680.0,2,S
2018-04-23 13:33:42,13675.0,12,21672,0,13675.0,1,13685.0,15,S
2018-04-23 13:33:44,13680.0,6,21678,-4,13675.0,2,13680.0,4,B
2018-04-23 13:33:45,13675.0,4,21682,-2,13670.0,8,13680.0,4,S
2018-04-23 13:33:46,13675.0,6,21688,-6,13675.0,3,13680.0,3,S
2018-04-23 13:33:48,13680.0,2,21690,0,13680.0,16,13685.0,3,B
2018-04-23 13:33:49,13685.0,2,21692,0,13685.0,9,13690.0,11,B
2018-04-23 13:33:50,13685.0,20,21712,16,13680.0,16,13685.0,16,B
2018-04-23 13:33:55,13685.0,2,21714,2,13680.0,3,13685.0,11,B
2018-04-23 13:33:56,13680.0,2,21716,-2,13680.0,2,13685.0,11,S
2018-04-23 13:33:56,13685.0,10,21726,4,13680.0,2,13685.0,4,B
2018-04-23 13:33:57,13685.0,8,21734,0,13680.0,21,13690.0,9,B
2018-04-23 13:34:01,13685.0,14,21748,0,13680.0,19,13685.0,4,B
2018-04-23 13:34:01,13685.0,8,21756,-4,13685.0,16,13690.0,2,B
2018-04-23 13:34:02,13685.0,2,21758,0,13685.0,28,13690.0,1,B
2018-04-23 13:34:02,13690.0,2,21760,2,13690.0,2,13695.0,16,B
2018-04-23 13:34:05,13695.0,24,21784,-16,13690.0,7,13700.0,74,B
2018-04-23 13:34:06,13690.0,24,21808,16,13690.0,21,13700.0,68,S
2018-04-23 13:34:08,13690.0,2,21810,0,13685.0,12,13695.0,7,S
2018-04-23 13:34:09,13690.0,2,21812,2,13690.0,15,13695.0,2,S
2018-04-23 13:34:12,13690.0,12,21824,-8,13690.0,5,13700.0,73,S
2018-04-23 13:34:12,13690.0,2,21826,2,13690.0,4,13695.0,3,S
2018-04-23 13:34:14,13695.0,8,21834,0,13695.0,2,13700.0,79,B
2018-04-23 13:34:15,13690.0,6,21840,4,13685.0,12,13695.0,25,S
2018-04-23 13:34:16,13690.0,2,21842,2,13685.0,7,13690.0,1,S
2018-04-23 13:34:17,13690.0,2,21844,-2,13685.0,11,13695.0,16,S
2018-04-23 13:34:18,13685.0,2,21846,0,13685.0,7,13690.0,3,S
2018-04-23 13:34:19,13685.0,6,21852,2,13680.0,9,13685.0,2,S
2018-04-23 13:34:21,13680.0,2,21854,-2,13680.0,7,13685.0,5,S
2018-04-23 13:34:22,13685.0,10,21864,-4,13680.0,6,13690.0,16,B
2018-04-23 13:34:26,13685.0,6,21870,-6,13680.0,10,13685.0,10,B
2018-04-23 13:34:26,13680.0,2,21872,-2,13680.0,9,13685.0,14,S
2018-04-23 13:34:27,13680.0,18,21890,12,13675.0,6,13685.0,21,S
2018-04-23 13:34:31,13685.0,2,21892,-2,13680.0,7,13685.0,14,B
2018-04-23 13:34:32,13680.0,2,21894,-2,13680.0,6,13685.0,14,S
2018-04-23 13:34:33,13685.0,4,21898,0,13680.0,1,13685.0,12,B
2018-04-23 13:34:34,13680.0,2,21900,0,13675.0,19,13685.0,12,S
2018-04-23 13:34:35,13685.0,2,21902,0,13675.0,26,13685.0,13,B
2018-04-23 13:34:40,13680.0,2,21904,0,13675.0,20,13685.0,12,S
2018-04-23 13:34:45,13680.0,2,21906,0,13675.0,4,13680.0,7,S
2018-04-23 13:34:47,13675.0,12,21918,-4,13670.0,6,13680.0,8,S
2018-04-23 13:34:48,13670.0,10,21928,-2,13665.0,2,13670.0,1,S
2018-04-23 13:34:48,13670.0,4,21932,2,13660.0,4,13670.0,10,S
2018-04-23 13:34:49,13665.0,6,21938,0,13660.0,15,13670.0,10,S
2018-04-23 13:34:50,13670.0,2,21940,0,13660.0,18,13670.0,12,B
2018-04-23 13:34:53,13670.0,4,21944,2,13665.0,9,13670.0,6,B
2018-04-23 13:34:54,13670.0,6,21950,4,13665.0,10,13675.0,6,B
2018-04-23 13:34:59,13675.0,6,21956,-6,13670.0,16,13680.0,24,B
2018-04-23 13:35:00,13670.0,2,21958,0,13670.0,13,13675.0,8,S
2018-04-23 13:35:04,13670.0,4,21962,0,13670.0,6,13680.0,12,S
2018-04-23 13:35:07,13675.0,10,21972,8,13675.0,6,13680.0,2,B
2018-04-23 13:35:07,13675.0,12,21984,0,13670.0,11,13675.0,1,B
2018-04-23 13:35:09,13675.0,2,21986,0,13670.0,2,13675.0,4,B
2018-04-23 13:35:13,13675.0,8,21994,0,13675.0,76,13680.0,31,B
2018-04-23 13:35:14,13675.0,2,21996,2,13675.0,75,13680.0,31,B
2018-04-23 13:35:19,13680.0,2,21998,2,13675.0,76,13680.0,10,B
2018-04-23 13:35:20,13675.0,2,22000,2,13675.0,75,13680.0,10,S
2018-04-23 13:35:21,13680.0,14,22014,-10,13675.0,75,13680.0,7,B
2018-04-23 13:35:22,13675.0,2,22016,0,13675.0,74,13680.0,7,S
2018-04-23 13:35:22,13675.0,16,22032,10,13675.0,66,13680.0,41,S
2018-04-23 13:35:23,13675.0,6,22038,6,13675.0,63,13680.0,29,S
2018-04-23 13:35:24,13675.0,2,22040,0,13675.0,62,13680.0,28,S
2018-04-23 13:35:27,13680.0,18,22058,2,13675.0,62,13680.0,22,B
2018-04-23 13:35:30,13680.0,16,22074,-12,13675.0,62,13680.0,14,B
2018-04-23 13:35:33,13680.0,2,22076,0,13675.0,61,13680.0,13,B
2018-04-23 13:35:33,13680.0,2,22078,-2,13675.0,61,13680.0,12,B
2018-04-23 13:35:39,13675.0,2,22080,0,13675.0,61,13680.0,12,S
2018-04-23 13:35:39,13675.0,22,22102,8,13675.0,50,13680.0,15,S
2018-04-23 13:35:40,13675.0,16,22118,10,13675.0,42,13680.0,17,S
2018-04-23 13:35:41,13675.0,2,22120,2,13675.0,45,13680.0,9,S
2018-04-23 13:35:42,13680.0,2,22122,2,13675.0,45,13680.0,6,B
2018-04-23 13:35:47,13680.0,4,22126,4,13675.0,45,13680.0,4,B
2018-04-23 13:35:48,13675.0,12,22138,12,13675.0,35,13680.0,8,S
2018-04-23 13:35:49,13675.0,4,22142,0,13675.0,33,13680.0,32,S
2018-04-23 13:35:49,13675.0,26,22168,0,13675.0,20,13680.0,34,S
2018-04-23 13:35:51,13675.0,2,22170,0,13675.0,19,13680.0,16,S
2018-04-23 13:35:51,13675.0,2,22172,0,13675.0,18,13680.0,8,S
2018-04-23 13:35:52,13675.0,36,22208,0,13670.0,4,13675.0,22,S
2018-04-23 13:35:55,13670.0,4,22212,-4,13665.0,6,13670.0,10,S
2018-04-23 13:35:55,13670.0,6,22218,-4,13665.0,12,13670.0,7,S
2018-04-23 13:35:58,13670.0,14,22232,-10,13670.0,12,13675.0,72,S
2018-04-23 13:36:05,13670.0,6,22238,-2,13670.0,9,13675.0,70,S
2018-04-23 13:36:12,13670.0,2,22240,-2,13670.0,7,13675.0,70,S
2018-04-23 13:36:14,13670.0,2,22242,-2,13670.0,6,13675.0,70,S
2018-04-23 13:36:23,13680.0,2,22244,0,13670.0,12,13680.0,12,B
2018-04-23 13:36:28,13680.0,4,22248,0,13670.0,19,13680.0,12,B
2018-04-23 13:36:29,13675.0,4,22252,0,13675.0,1,13680.0,10,S
2018-04-23 13:36:32,13675.0,38,22290,-2,13670.0,13,13675.0,21,S
2018-04-23 13:36:33,13675.0,6,22296,-6,13670.0,13,13675.0,18,S
2018-04-23 13:36:33,13675.0,2,22298,0,13670.0,19,13675.0,17,S
2018-04-23 13:36:40,13670.0,20,22318,-4,13670.0,1,13675.0,22,S
2018-04-23 13:36:50,13670.0,12,22330,-10,13665.0,10,13670.0,11,S
2018-04-23 13:36:52,13665.0,4,22334,-2,13665.0,3,13670.0,20,S
2018-04-23 13:36:53,13665.0,6,22340,-2,13660.0,6,13670.0,20,S
2018-04-23 13:36:54,13665.0,2,22342,0,13660.0,6,13665.0,13,S
2018-04-23 13:36:56,13660.0,4,22346,2,13660.0,3,13665.0,8,S
2018-04-23 13:37:01,13660.0,2,22348,0,13660.0,2,13665.0,5,S
2018-04-23 13:37:04,13665.0,2,22350,0,13665.0,2,13670.0,20,B
2018-04-23 13:37:10,13670.0,4,22354,0,13665.0,2,13670.0,15,B
2018-04-23 13:37:18,13665.0,4,22358,4,13660.0,10,13665.0,4,S
2018-04-23 13:37:21,13670.0,2,22360,0,13660.0,17,13670.0,13,B
2018-04-23 13:37:28,13660.0,4,22364,0,13660.0,16,13670.0,14,S
2018-04-23 13:37:30,13670.0,14,22378,-2,13665.0,12,13670.0,2,B
2018-04-23 13:37:31,13670.0,4,22382,-2,13665.0,14,13675.0,6,B
2018-04-23 13:37:47,13670.0,4,22386,0,13670.0,4,13675.0,13,B
2018-04-23 13:37:47,13670.0,6,22392,6,13665.0,8,13675.0,27,B
2018-04-23 13:37:52,13675.0,2,22394,2,13665.0,4,13675.0,18,B
2018-04-23 13:38:10,13665.0,12,22406,12,13665.0,8,13670.0,15,S
2018-04-23 13:38:28,13665.0,2,22408,0,13665.0,10,13670.0,7,S
2018-04-23 13:38:37,13670.0,2,22410,-2,13665.0,8,13670.0,6,B
2018-04-23 13:38:58,13665.0,2,22412,0,13665.0,9,13670.0,9,S
2018-04-23 13:39:03,13670.0,2,22414,-2,13665.0,15,13670.0,6,B
2018-04-23 13:39:08,13665.0,2,22416,2,13665.0,14,13670.0,6,S
2018-04-23 13:39:09,13670.0,2,22418,-2,13665.0,14,13670.0,5,B
2018-04-23 13:39:10,13670.0,2,22420,0,13665.0,16,13670.0,4,B
2018-04-23 13:39:14,13665.0,8,22428,4,13665.0,3,13670.0,24,S
2018-04-23 13:39:14,13665.0,6,22434,4,13660.0,5,13665.0,1,S
2018-04-23 13:39:18,13660.0,4,22438,-2,13655.0,3,13665.0,4,S
2018-04-23 13:39:30,13655.0,2,22440,0,13655.0,11,13660.0,2,S
2018-04-23 13:39:31,13660.0,4,22444,0,13660.0,3,13665.0,4,B
2018-04-23 13:39:39,13655.0,10,22454,2,13655.0,11,13665.0,11,S
2018-04-23 13:39:43,13655.0,10,22464,-4,13655.0,6,13665.0,11,S
2018-04-23 13:39:49,13655.0,10,22474,6,13655.0,2,13665.0,11,S
2018-04-23 13:39:54,13655.0,2,22476,0,13655.0,3,13665.0,13,S
2018-04-23 13:39:56,13655.0,2,22478,-2,13655.0,2,13660.0,1,S
2018-04-23 13:40:03,13655.0,4,22482,4,13650.0,5,13655.0,3,S
2018-04-23 13:40:05,13655.0,2,22484,0,13655.0,2,13660.0,6,S
2018-04-23 13:40:06,13655.0,4,22488,4,13650.0,8,13655.0,10,S
2018-04-23 13:40:14,13650.0,10,22498,4,13650.0,6,13655.0,3,S
2018-04-23 13:40:19,13650.0,2,22500,2,13650.0,5,13655.0,6,S
2018-04-23 13:40:20,13650.0,10,22510,-2,13645.0,2,13650.0,10,S
2018-04-23 13:40:22,13650.0,2,22512,0,13645.0,20,13650.0,10,S
2018-04-23 13:40:25,13645.0,6,22518,4,13645.0,4,13650.0,10,S
2018-04-23 13:40:26,13645.0,6,22524,0,13645.0,4,13650.0,10,S
2018-04-23 13:40:27,13645.0,10,22534,6,13640.0,2,13650.0,15,S
2018-04-23 13:40:32,13640.0,6,22540,-2,13635.0,6,13640.0,3,S
2018-04-23 13:40:33,13635.0,6,22546,-6,13635.0,17,13640.0,8,S
2018-04-23 13:40:39,13635.0,2,22548,0,13635.0,4,13640.0,9,S
2018-04-23 13:40:39,13635.0,6,22554,0,13635.0,1,13640.0,9,S
2018-04-23 13:40:40,13635.0,2,22556,-2,13630.0,23,13640.0,9,S
2018-04-23 13:40:48,13635.0,2,22558,0,13630.0,25,13640.0,12,S
2018-04-23 13:40:49,13635.0,2,22560,0,13630.0,23,13635.0,3,S
2018-04-23 13:40:49,13635.0,2,22562,2,13630.0,23,13640.0,18,S
2018-04-23 13:40:52,13630.0,4,22566,0,13630.0,22,13640.0,20,S
2018-04-23 13:40:52,13630.0,18,22584,0,13630.0,14,13640.0,20,S
2018-04-23 13:40:53,13630.0,2,22586,0,13630.0,13,13635.0,1,S
2018-04-23 13:40:55,13635.0,2,22588,0,13635.0,1,13640.0,13,B
2018-04-23 13:40:56,13635.0,2,22590,-2,13635.0,7,13640.0,6,B
2018-04-23 13:40:58,13640.0,2,22592,2,13635.0,7,13640.0,5,B
2018-04-23 13:41:02,13635.0,2,22594,-2,13635.0,4,13640.0,5,S
2018-04-23 13:41:08,13635.0,16,22610,-12,13635.0,1,13640.0,5,S
2018-04-23 13:41:13,13640.0,10,22620,6,13640.0,1,13645.0,7,B
2018-04-23 13:41:14,13645.0,12,22632,2,13640.0,17,13650.0,16,B
2018-04-23 13:41:19,13645.0,2,22634,0,13640.0,11,13645.0,2,B
2018-04-23 13:41:24,13645.0,2,22636,0,13640.0,5,13645.0,2,B
2018-04-23 13:41:36,13640.0,4,22640,0,13640.0,1,13645.0,19,S
2018-04-23 13:41:39,13635.0,4,22644,-2,13635.0,3,13645.0,12,S
2018-04-23 13:41:47,13640.0,20,22664,2,13635.0,22,13645.0,8,B
2018-04-23 13:41:51,13635.0,2,22666,2,13635.0,21,13645.0,8,S
2018-04-23 13:42:07,13645.0,4,22670,-2,13640.0,22,13650.0,10,B
2018-04-23 13:42:10,13645.0,4,22674,-4,13645.0,3,13650.0,10,B
2018-04-23 13:42:12,13645.0,4,22678,4,13640.0,6,13650.0,14,B
2018-04-23 13:42:18,13650.0,8,22686,6,13645.0,17,13655.0,5,B
2018-04-23 13:42:19,13650.0,12,22698,0,13650.0,4,13655.0,14,B
2018-04-23 13:42:20,13650.0,8,22706,0,13645.0,4,13650.0,1,B
2018-04-23 13:42:23,13650.0,2,22708,2,13645.0,4,13650.0,3,B
2018-04-23 13:42:28,13650.0,2,22710,-2,13645.0,2,13650.0,2,B
2018-04-23 13:42:31,13650.0,4,22714,-4,13650.0,2,13655.0,6,B
2018-04-23 13:42:34,13655.0,12,22726,2,13650.0,15,13660.0,5,B
2018-04-23 13:42:38,13650.0,4,22730,4,13650.0,20,13660.0,8,S
2018-04-23 13:42:41,13650.0,36,22766,32,13650.0,4,13655.0,1,S
2018-04-23 13:42:42,13650.0,8,22774,-6,13645.0,5,13650.0,4,S
2018-04-23 13:42:42,13645.0,2,22776,2,13645.0,3,13650.0,1,S
2018-04-23 13:42:44,13650.0,2,22778,2,13645.0,4,13655.0,17,B
2018-04-23 13:42:59,13650.0,2,22780,2,13650.0,7,13655.0,4,B
2018-04-23 13:43:21,13650.0,10,22790,0,13650.0,2,13655.0,4,B
2018-04-23 13:43:29,13650.0,10,22800,-6,13645.0,11,13650.0,3,B
2018-04-23 13:43:30,13650.0,6,22806,-2,13645.0,18,13655.0,3,B
2018-04-23 13:43:38,13645.0,10,22816,0,13645.0,14,13655.0,6,S
2018-04-23 13:43:44,13645.0,10,22826,0,13645.0,10,13655.0,7,S
2018-04-23 13:43:48,13645.0,10,22836,0,13645.0,5,13655.0,8,S
2018-04-23 13:43:54,13645.0,2,22838,2,13645.0,5,13650.0,8,S
2018-04-23 13:44:14,13650.0,4,22842,-4,13640.0,25,13650.0,16,B
2018-04-23 13:44:24,13645.0,2,22844,0,13645.0,4,13650.0,16,S
2018-04-23 13:44:27,13645.0,8,22852,8,13640.0,18,13645.0,5,S
2018-04-23 13:44:31,13645.0,10,22862,4,13640.0,17,13650.0,23,S
2018-04-23 13:44:33,13645.0,14,22876,8,13640.0,23,13645.0,3,S
2018-04-23 13:44:34,13640.0,14,22890,-8,13640.0,19,13650.0,6,S
2018-04-23 13:44:53,13645.0,2,22892,-2,13640.0,19,13645.0,4,B
2018-04-23 13:45:10,13640.0,28,22920,-2,13635.0,7,13645.0,10,S
2018-04-23 13:45:24,13640.0,6,22926,2,13635.0,7,13645.0,25,S
2018-04-23 13:45:28,13640.0,6,22932,-6,13635.0,5,13640.0,1,S
2018-04-23 13:45:30,13635.0,2,22934,2,13635.0,11,13640.0,1,S
2018-04-23 13:45:33,13635.0,8,22942,2,13630.0,14,13635.0,1,S
2018-04-23 13:45:34,13635.0,14,22956,6,13630.0,18,13640.0,16,S
2018-04-23 13:45:38,13635.0,6,22962,-2,13630.0,15,13635.0,3,S
2018-04-23 13:45:41,13630.0,2,22964,-2,13630.0,19,13640.0,18,S
2018-04-23 13:45:49,13635.0,2,22966,-2,13635.0,2,13640.0,9,B
2018-04-23 13:45:54,13635.0,2,22968,-2,13635.0,1,13640.0,12,B
2018-04-23 13:46:02,13640.0,4,22972,-2,13635.0,13,13640.0,7,B
2018-04-23 13:46:04,13640.0,2,22974,0,13635.0,4,13640.0,6,B
2018-04-23 13:46:07,13640.0,2,22976,-2,13635.0,15,13640.0,5,B
2018-04-23 13:46:36,13635.0,2,22978,-2,13635.0,10,13640.0,4,S
2018-04-23 13:46:39,13640.0,2,22980,-2,13635.0,10,13640.0,3,B
2018-04-23 13:46:42,13635.0,20,23000,-10,13630.0,19,13635.0,6,S
2018-04-23 13:46:42,13635.0,12,23012,-12,13635.0,6,13640.0,6,S
2018-04-23 13:46:46,13635.0,6,23018,6,13635.0,1,13640.0,6,S
2018-04-23 13:46:51,13635.0,2,23020,0,13635.0,1,13640.0,6,S
2018-04-23 13:46:55,13635.0,2,23022,0,13635.0,1,13640.0,6,S
2018-04-23 13:47:10,13635.0,4,23026,2,13630.0,20,13640.0,10,S
2018-04-23 13:47:27,13635.0,2,23028,0,13635.0,5,13640.0,15,S
2018-04-23 13:47:42,13640.0,2,23030,-2,13635.0,5,13640.0,12,B
2018-04-23 13:47:47,13640.0,8,23038,6,13635.0,12,13645.0,10,B
2018-04-23 13:48:04,13640.0,4,23042,0,13640.0,8,13645.0,13,B
2018-04-23 13:48:09,13645.0,2,23044,-2,13640.0,8,13645.0,12,B
2018-04-23 13:48:15,13645.0,6,23050,-6,13640.0,8,13645.0,9,B
2018-04-23 13:48:24,13645.0,6,23056,4,13640.0,8,13645.0,6,B
2018-04-23 13:48:37,13645.0,2,23058,0,13640.0,8,13645.0,5,B
2018-04-23 13:49:00,13640.0,6,23064,-6,13640.0,5,13645.0,8,S
2018-04-23 13:49:33,13645.0,2,23066,-2,13640.0,6,13645.0,5,B
2018-04-23 13:50:01,13645.0,2,23068,0,13640.0,6,13645.0,5,B
2018-04-23 13:50:25,13645.0,12,23080,-2,13640.0,12,13650.0,13,B
2018-04-23 13:51:10,13650.0,2,23082,2,13645.0,3,13650.0,10,B
2018-04-23 13:51:27,13650.0,20,23102,0,13645.0,9,13655.0,6,B
2018-04-23 13:51:34,13650.0,2,23104,-2,13645.0,11,13655.0,12,B
2018-04-23 13:51:38,13650.0,2,23106,-2,13645.0,13,13655.0,13,B
2018-04-23 13:51:52,13650.0,2,23108,0,13645.0,19,13655.0,26,B
2018-04-23 13:51:58,13650.0,2,23110,2,13645.0,15,13650.0,22,B
2018-04-23 13:52:03,13645.0,8,23118,0,13645.0,10,13650.0,24,S
2018-04-23 13:52:03,13645.0,20,23138,4,13640.0,5,13645.0,1,S
2018-04-23 13:52:06,13650.0,4,23142,-2,13640.0,4,13650.0,21,B
2018-04-23 13:52:20,13640.0,4,23146,-4,13640.0,1,13645.0,4,S
2018-04-23 13:52:20,13645.0,2,23148,0,13640.0,1,13645.0,3,B
2018-04-23 13:52:33,13635.0,2,23150,0,13635.0,10,13645.0,11,S
2018-04-23 13:52:41,13635.0,6,23156,6,13635.0,5,13640.0,22,S
2018-04-23 13:52:48,13635.0,2,23158,-2,13635.0,4,13640.0,7,S
2018-04-23 13:52:53,13640.0,6,23164,0,13635.0,15,13645.0,9,B
2018-04-23 13:52:58,13635.0,2,23166,2,13635.0,7,13645.0,17,S
2018-04-23 13:53:37,13645.0,8,23174,0,13640.0,13,13645.0,2,B
2018-04-23 13:53:37,13645.0,4,23178,4,13640.0,13,13650.0,4,B
2018-04-23 13:54:08,13650.0,2,23180,-2,13640.0,13,13650.0,12,B
2018-04-23 13:54:28,13650.0,10,23190,-8,13640.0,15,13650.0,10,B
2018-04-23 13:54:42,13645.0,4,23194,0,13640.0,7,13650.0,26,S
2018-04-23 13:54:44,13645.0,2,23196,-2,13645.0,1,13650.0,23,S
2018-04-23 13:54:45,13645.0,2,23198,0,13640.0,10,13650.0,23,S
2018-04-23 13:54:52,13645.0,2,23200,0,13640.0,7,13650.0,13,S
2018-04-23 13:55:02,13650.0,2,23202,-2,13640.0,8,13650.0,12,B
2018-04-23 13:55:57,13645.0,2,23204,0,13640.0,14,13645.0,2,S
2018-04-23 13:56:03,13645.0,2,23206,-2,13640.0,14,13645.0,1,S
2018-04-23 13:56:04,13645.0,2,23208,0,13640.0,14,13650.0,28,S
2018-04-23 13:56:06,13645.0,10,23218,2,13640.0,17,13645.0,2,S
2018-04-23 13:56:17,13640.0,24,23242,22,13635.0,14,13645.0,23,S
2018-04-23 13:56:25,13645.0,10,23252,-2,13635.0,12,13645.0,7,B
2018-04-23 13:56:30,13645.0,4,23256,0,13635.0,12,13645.0,9,B
2018-04-23 13:56:33,13645.0,6,23262,-6,13635.0,16,13645.0,6,B
2018-04-23 13:56:38,13645.0,2,23264,-2,13635.0,16,13645.0,5,B
2018-04-23 13:56:48,13645.0,14,23278,0,13635.0,16,13650.0,34,B
2018-04-23 13:56:48,13645.0,14,23292,0,13635.0,16,13645.0,6,B
2018-04-23 13:56:49,13645.0,12,23304,0,13635.0,16,13650.0,40,B
2018-04-23 13:56:53,13640.0,2,23306,-2,13635.0,15,13645.0,4,S
2018-04-23 13:56:53,13645.0,8,23314,-8,13640.0,6,13650.0,38,B
2018-04-23 13:56:56,13645.0,2,23316,-2,13640.0,8,13645.0,1,B
2018-04-23 13:56:57,13645.0,2,23318,-2,13640.0,8,13650.0,40,B
2018-04-23 13:56:58,13645.0,2,23320,0,13640.0,2,13645.0,4,B
2018-04-23 13:56:58,13645.0,8,23328,-8,13640.0,2,13645.0,9,B
2018-04-23 13:56:59,13645.0,18,23346,-18,13640.0,2,13645.0,2,B
2018-04-23 13:57:08,13645.0,6,23352,-2,13640.0,3,13650.0,29,B
2018-04-23 13:57:12,13645.0,4,23356,-4,13645.0,6,13650.0,27,B
2018-04-23 13:57:13,13645.0,12,23368,-2,13640.0,3,13645.0,1,B
2018-04-23 13:57:16,13640.0,2,23370,0,13635.0,10,13640.0,1,S
2018-04-23 13:57:22,13640.0,2,23372,0,13635.0,10,13640.0,2,S
2018-04-23 13:57:26,13635.0,2,23374,0,13635.0,4,13640.0,23,S
2018-04-23 13:57:26,13635.0,8,23382,-2,13630.0,14,13635.0,7,S
2018-04-23 13:57:27,13630.0,2,23384,-2,13630.0,13,13635.0,6,S
2018-04-23 13:57:28,13630.0,2,23386,-2,13630.0,12,13635.0,6,S
2018-04-23 13:57:28,13630.0,2,23388,-2,13630.0,11,13635.0,6,S
2018-04-23 13:57:30,13635.0,4,23392,-4,13635.0,13,13640.0,5,B
2018-04-23 13:57:36,13635.0,8,23400,0,13635.0,12,13640.0,2,B
2018-04-23 13:57:47,13635.0,12,23412,2,13635.0,6,13640.0,3,B
2018-04-23 13:57:54,13635.0,2,23414,-2,13635.0,5,13640.0,4,B
2018-04-23 13:58:18,13635.0,2,23416,-2,13635.0,2,13640.0,6,B
2018-04-23 13:58:18,13635.0,4,23420,-4,13630.0,15,13640.0,34,B
2018-04-23 13:58:42,13640.0,6,23426,-2,13635.0,8,13645.0,18,B
2018-04-23 13:58:57,13640.0,6,23432,-2,13640.0,10,13645.0,1,B
2018-04-23 13:58:57,13645.0,2,23434,0,13640.0,10,13650.0,12,B
2018-04-23 13:59:11,13640.0,2,23436,0,13640.0,12,13650.0,10,S
2018-04-23 13:59:42,13640.0,4,23440,4,13635.0,8,13640.0,2,S
2018-04-23 13:59:58,13635.0,2,23442,0,13635.0,7,13640.0,13,S
2018-04-23 14:00:02,13640.0,2,23444,0,13635.0,7,13640.0,12,B
2018-04-23 14:00:15,13640.0,8,23452,-4,13635.0,6,13640.0,8,B
2018-04-23 14:00:16,13640.0,4,23456,-2,13635.0,11,13640.0,6,B
2018-04-23 14:00:16,13640.0,2,23458,0,13635.0,11,13640.0,5,B
2018-04-23 14:00:49,13640.0,2,23460,-2,13635.0,11,13640.0,3,B
2018-04-23 14:00:49,13640.0,4,23464,-4,13635.0,11,13640.0,1,B
2018-04-23 14:00:52,13640.0,2,23466,0,13635.0,11,13645.0,5,B
2018-04-23 14:01:06,13640.0,2,23468,0,13635.0,14,13645.0,5,B
2018-04-23 14:01:24,13645.0,2,23470,0,13635.0,17,13645.0,5,B
2018-04-23 14:01:27,13645.0,2,23472,0,13640.0,25,13650.0,14,B
2018-04-23 14:01:47,13650.0,20,23492,-14,13640.0,26,13650.0,5,B
2018-04-23 14:01:54,13650.0,20,23512,-16,13640.0,27,13655.0,17,B
2018-04-23 14:02:06,13655.0,10,23522,-4,13645.0,8,13655.0,26,B
2018-04-23 14:02:11,13650.0,4,23526,2,13645.0,8,13655.0,15,S
2018-04-23 14:02:18,13650.0,2,23528,-2,13650.0,4,13655.0,26,S
2018-04-23 14:02:20,13650.0,2,23530,-2,13650.0,3,13655.0,33,S
2018-04-23 14:02:21,13650.0,2,23532,-2,13650.0,3,13655.0,33,S
2018-04-23 14:02:29,13650.0,6,23538,-2,13645.0,8,13655.0,32,S
2018-04-23 14:02:37,13645.0,2,23540,-2,13645.0,7,13650.0,1,S
2018-04-23 14:03:08,13650.0,2,23542,0,13650.0,1,13655.0,14,B
2018-04-23 14:03:18,13650.0,2,23544,-2,13645.0,13,13650.0,9,B
2018-04-23 14:03:41,13650.0,10,23554,-10,13645.0,13,13650.0,4,B
2018-04-23 14:04:40,13650.0,6,23560,0,13650.0,19,13655.0,23,B
2018-04-23 14:04:40,13650.0,30,23590,16,13650.0,4,13655.0,19,B
2018-04-23 14:04:41,13650.0,8,23598,-2,13645.0,13,13650.0,15,B
2018-04-23 14:04:50,13645.0,6,23604,2,13640.0,13,13645.0,1,S
2018-04-23 14:04:59,13645.0,2,23606,2,13640.0,16,13645.0,3,S
2018-04-23 14:05:02,13640.0,2,23608,0,13640.0,7,13645.0,19,S
2018-04-23 14:05:02,13640.0,2,23610,-2,13640.0,6,13645.0,19,S
2018-04-23 14:05:07,13640.0,2,23612,0,13640.0,5,13645.0,19,S
2018-04-23 14:05:10,13645.0,10,23622,-2,13640.0,5,13645.0,14,B
2018-04-23 14:05:50,13650.0,26,23648,8,13650.0,7,13655.0,10,B
2018-04-23 14:05:58,13660.0,50,23698,-18,13655.0,16,13665.0,10,B
2018-04-23 14:06:07,13660.0,2,23700,-2,13655.0,6,13660.0,1,B
2018-04-23 14:06:09,13660.0,6,23706,0,13655.0,12,13665.0,18,B
2018-04-23 14:06:12,13665.0,8,23714,-8,13655.0,12,13665.0,10,B
2018-04-23 14:06:19,13660.0,2,23716,0,13655.0,12,13660.0,19,S
2018-04-23 14:06:20,13660.0,38,23754,-24,13655.0,12,13665.0,10,S
2018-04-23 14:06:20,13665.0,20,23774,16,13660.0,7,13670.0,8,B
2018-04-23 14:06:22,13670.0,4,23778,0,13665.0,11,13670.0,3,B
2018-04-23 14:06:22,13670.0,6,23784,0,13665.0,11,13675.0,2,B
2018-04-23 14:06:25,13670.0,2,23786,2,13665.0,4,13670.0,4,B
2018-04-23 14:06:30,13675.0,6,23792,0,13670.0,20,13680.0,6,B
2018-04-23 14:06:42,13670.0,16,23808,16,13665.0,8,13670.0,1,S
2018-04-23 14:06:45,13665.0,6,23814,0,13660.0,15,13670.0,8,S
2018-04-23 14:06:51,13665.0,2,23816,0,13665.0,1,13670.0,9,S
2018-04-23 14:06:53,13665.0,2,23818,0,13660.0,16,13670.0,6,S
2018-04-23 14:06:58,13665.0,2,23820,2,13660.0,13,13665.0,7,S
2018-04-23 14:07:09,13665.0,2,23822,-2,13660.0,16,13670.0,9,S
2018-04-23 14:07:14,13665.0,6,23828,-6,13660.0,15,13665.0,1,S
2018-04-23 14:07:21,13665.0,4,23832,-4,13665.0,3,13670.0,8,S
2018-04-23 14:07:21,13665.0,2,23834,0,13665.0,1,13670.0,8,S
2018-04-23 14:07:22,13665.0,2,23836,0,13660.0,11,13665.0,2,S
2018-04-23 14:07:24,13660.0,4,23840,0,13660.0,9,13665.0,9,S
2018-04-23 14:07:25,13660.0,18,23858,6,13655.0,7,13660.0,15,S
2018-04-23 14:07:26,13660.0,6,23864,0,13655.0,4,13660.0,1,S
2018-04-23 14:07:39,13655.0,2,23866,-2,13655.0,4,13660.0,10,S
2018-04-23 14:08:12,13660.0,2,23868,0,13655.0,11,13660.0,6,B
2018-04-23 14:08:12,13660.0,12,23880,0,13655.0,11,13665.0,8,B
2018-04-23 14:08:14,13655.0,2,23882,0,13655.0,13,13665.0,6,S
2018-04-23 14:08:23,13665.0,4,23886,4,13655.0,16,13665.0,4,B
2018-04-23 14:08:54,13665.0,4,23890,0,13660.0,3,13665.0,4,B
2018-04-23 14:08:58,13660.0,6,23896,0,13655.0,14,13660.0,7,S
2018-04-23 14:08:58,13660.0,6,23902,-6,13655.0,14,13660.0,4,S
2018-04-23 14:09:00,13655.0,24,23926,2,13655.0,5,13660.0,4,S
2018-04-23 14:09:00,13655.0,4,23930,4,13655.0,3,13660.0,4,S
2018-04-23 14:09:02,13655.0,6,23936,6,13655.0,3,13660.0,4,S
2018-04-23 14:09:03,13660.0,4,23940,0,13655.0,3,13660.0,2,B
2018-04-23 14:09:03,13660.0,4,23944,-4,13655.0,6,13665.0,6,B
2018-04-23 14:09:04,13660.0,6,23950,6,13660.0,2,13665.0,2,B
2018-04-23 14:09:05,13660.0,2,23952,0,13660.0,1,13665.0,2,B
2018-04-23 14:09:05,13660.0,2,23954,0,13655.0,9,13665.0,4,B
2018-04-23 14:09:09,13660.0,2,23956,2,13655.0,9,13665.0,6,B
2018-04-23 14:09:10,13655.0,2,23958,2,13655.0,8,13665.0,6,S
2018-04-23 14:09:15,13655.0,2,23960,2,13660.0,1,13665.0,7,S
2018-04-23 14:09:16,13665.0,2,23962,0,13660.0,1,13665.0,6,B
2018-04-23 14:09:16,13660.0,2,23964,2,13655.0,10,13665.0,6,S
2018-04-23 14:09:37,13660.0,2,23966,2,13660.0,3,13665.0,6,S
2018-04-23 14:09:38,13660.0,4,23970,2,13660.0,5,13665.0,2,S
2018-04-23 14:09:38,13660.0,4,23974,0,13660.0,4,13665.0,2,S
2018-04-23 14:09:40,13665.0,2,23976,0,13660.0,4,13665.0,1,B
2018-04-23 14:09:40,13665.0,2,23978,0,13660.0,9,13670.0,11,B
2018-04-23 14:09:42,13665.0,4,23982,-4,13665.0,2,13670.0,10,B
2018-04-23 14:10:11,13670.0,2,23984,0,13665.0,6,13670.0,21,B
2018-04-23 14:10:12,13665.0,2,23986,0,13665.0,5,13670.0,21,S
2018-04-23 14:10:12,13665.0,10,23996,-6,13660.0,6,13665.0,3,S
2018-04-23 14:10:20,13665.0,2,23998,2,13660.0,12,13665.0,3,S
2018-04-23 14:10:28,13665.0,2,24000,0,13660.0,10,13665.0,2,S
2018-04-23 14:10:43,13660.0,20,24020,20,13655.0,3,13660.0,10,S
2018-04-23 14:10:46,13655.0,2,24022,-2,13650.0,23,13660.0,15,S
2018-04-23 14:10:59,13655.0,6,24028,6,13650.0,24,13655.0,17,S
2018-04-23 14:11:00,13655.0,6,24034,6,13650.0,30,13655.0,14,S
2018-04-23 14:11:00,13655.0,2,24036,2,13650.0,31,13655.0,13,S
2018-04-23 14:11:01,13655.0,2,24038,2,13650.0,25,13655.0,12,S
2018-04-23 14:11:14,13650.0,40,24078,34,13650.0,10,13655.0,17,S
2018-04-23 14:11:16,13650.0,34,24112,32,13645.0,5,13650.0,3,S
2018-04-23 14:11:17,13655.0,8,24120,2,13650.0,5,13655.0,16,B
2018-04-23 14:11:17,13650.0,4,24124,0,13650.0,7,13655.0,16,S
2018-04-23 14:11:18,13650.0,14,24138,10,13645.0,8,13650.0,13,S
2018-04-23 14:11:19,13650.0,2,24140,0,13645.0,12,13650.0,12,S
2018-04-23 14:11:20,13650.0,2,24142,2,13645.0,13,13650.0,11,S
2018-04-23 14:11:35,13650.0,2,24144,2,13645.0,15,13650.0,10,S
2018-04-23 14:11:53,13650.0,6,24150,0,13645.0,15,13650.0,9,S
2018-04-23 14:11:58,13650.0,20,24170,14,13645.0,15,13655.0,17,S
2018-04-23 14:12:03,13650.0,2,24172,2,13645.0,15,13650.0,20,S
2018-04-23 14:12:22,13650.0,4,24176,4,13645.0,17,13650.0,18,S
2018-04-23 14:12:23,13650.0,36,24212,36,13650.0,2,13655.0,18,S
2018-04-23 14:12:25,13650.0,4,24216,4,13645.0,15,13650.0,18,S
2018-04-23 14:12:33,13650.0,20,24236,20,13645.0,22,13650.0,8,S
2018-04-23 14:12:39,13650.0,16,24252,16,13650.0,2,13655.0,22,S
2018-04-23 14:12:39,13650.0,4,24256,4,13645.0,16,13655.0,22,S
2018-04-23 14:12:51,13650.0,20,24276,20,13645.0,22,13650.0,13,S
2018-04-23 14:12:52,13650.0,4,24280,4,13645.0,22,13650.0,11,S
2018-04-23 14:12:55,13650.0,2,24282,2,13645.0,22,13650.0,10,S
2018-04-23 14:13:02,13650.0,20,24302,20,13645.0,9,13650.0,5,S
2018-04-23 14:13:09,13645.0,14,24316,6,13640.0,15,13645.0,13,S
2018-04-23 14:13:11,13645.0,20,24336,20,13640.0,27,13645.0,3,S
2018-04-23 14:13:13,13645.0,2,24338,2,13640.0,25,13645.0,2,S
2018-04-23 14:13:22,13645.0,4,24342,4,13645.0,8,13650.0,11,S
2018-04-23 14:13:23,13645.0,16,24358,16,13640.0,22,13645.0,12,S
2018-04-23 14:13:25,13645.0,4,24362,4,13640.0,27,13645.0,10,S
2018-04-23 14:13:31,13640.0,2,24364,0,13640.0,12,13645.0,19,S
2018-04-23 14:13:38,13640.0,20,24384,10,13635.0,16,13640.0,10,S
2018-04-23 14:13:39,13635.0,2,24386,0,13635.0,27,13640.0,10,S
2018-04-23 14:13:40,13640.0,2,24388,0,13635.0,25,13640.0,9,B
2018-04-23 14:13:40,13640.0,18,24406,0,13635.0,25,13645.0,21,B
2018-04-23 14:13:41,13635.0,2,24408,2,13635.0,24,13645.0,21,S
2018-04-23 14:13:43,13640.0,2,24410,2,13635.0,19,13645.0,21,B
2018-04-23 14:13:48,13640.0,4,24414,0,13635.0,19,13645.0,21,B
2018-04-23 14:13:58,13635.0,4,24418,-2,13635.0,22,13640.0,1,S
2018-04-23 14:14:07,13635.0,4,24422,0,13635.0,20,13640.0,11,S
2018-04-23 14:14:08,13640.0,22,24444,22,13640.0,16,13645.0,8,B
2018-04-23 14:14:19,13645.0,2,24446,-2,13640.0,22,13645.0,10,B
2018-04-23 14:14:23,13645.0,2,24448,0,13640.0,30,13650.0,8,B
2018-04-23 14:14:46,13650.0,4,24452,2,13645.0,15,13650.0,3,B
2018-04-23 14:14:47,13650.0,6,24458,2,13645.0,26,13655.0,7,B
2018-04-23 14:14:50,13650.0,2,24460,2,13645.0,23,13650.0,19,B
2018-04-23 14:14:51,13650.0,20,24480,0,13645.0,29,13650.0,9,B
2018-04-23 14:14:52,13650.0,18,24498,10,13645.0,28,13655.0,8,B
2018-04-23 14:14:53,13645.0,40,24538,12,13645.0,9,13655.0,7,S
2018-04-23 14:14:56,13650.0,2,24540,-2,13645.0,11,13655.0,9,B
2018-04-23 14:15:08,13645.0,28,24568,26,13640.0,8,13645.0,6,S
2018-04-23 14:15:08,13645.0,18,24586,0,13645.0,1,13650.0,23,S
2018-04-23 14:15:09,13645.0,2,24588,0,13645.0,3,13650.0,25,S
2018-04-23 14:15:11,13645.0,14,24602,14,13640.0,9,13645.0,13,S
2018-04-23 14:15:12,13645.0,28,24630,6,13640.0,12,13645.0,1,S
2018-04-23 14:15:15,13640.0,12,24642,2,13635.0,10,13645.0,8,S
2018-04-23 14:16:11,13640.0,2,24644,0,13640.0,7,13645.0,26,S
2018-04-23 14:16:25,13645.0,6,24650,6,13640.0,4,13645.0,20,B
2018-04-23 14:16:48,13645.0,2,24652,2,13640.0,6,13645.0,19,B
2018-04-23 14:17:08,13640.0,2,24654,0,13640.0,1,13645.0,26,S
2018-04-23 14:17:08,13640.0,2,24656,2,13635.0,13,13640.0,1,S
2018-04-23 14:17:18,13635.0,8,24664,2,13630.0,11,13640.0,23,S
2018-04-23 14:17:20,13635.0,2,24666,0,13630.0,23,13640.0,26,S
2018-04-23 14:17:23,13630.0,12,24678,0,13630.0,22,13640.0,28,S
2018-04-23 14:17:30,13630.0,2,24680,0,13630.0,21,13640.0,30,S
2018-04-23 14:17:38,13635.0,4,24684,0,13630.0,16,13635.0,4,B
2018-04-23 14:17:41,13630.0,4,24688,-2,13630.0,10,13635.0,2,S
2018-04-23 14:17:42,13630.0,4,24692,4,13625.0,2,13635.0,11,S
2018-04-23 14:17:51,13630.0,4,24696,4,13625.0,11,13630.0,21,S
2018-04-23 14:17:52,13625.0,14,24710,-6,13620.0,13,13630.0,37,S
2018-04-23 14:17:55,13625.0,2,24712,2,13620.0,19,13625.0,3,S
2018-04-23 14:17:57,13625.0,2,24714,0,13620.0,14,13625.0,2,S
2018-04-23 14:17:58,13625.0,2,24716,2,13620.0,14,13625.0,6,S
2018-04-23 14:18:03,13620.0,20,24736,4,13620.0,2,13625.0,18,S
2018-04-23 14:18:04,13620.0,4,24740,2,13615.0,7,13625.0,19,S
2018-04-23 14:18:05,13625.0,2,24742,2,13615.0,13,13625.0,18,B
2018-04-23 14:18:06,13615.0,40,24782,12,13610.0,15,13625.0,18,S
2018-04-23 14:18:08,13615.0,2,24784,2,13610.0,24,13615.0,19,S
2018-04-23 14:18:08,13615.0,32,24816,24,13610.0,21,13615.0,3,S
2018-04-23 14:18:09,13615.0,8,24824,2,13610.0,21,13615.0,1,S
2018-04-23 14:18:09,13615.0,2,24826,2,13610.0,21,13620.0,8,S
2018-04-23 14:18:13,13615.0,4,24830,-2,13615.0,1,13620.0,10,S
2018-04-23 14:18:14,13620.0,2,24832,0,13615.0,6,13620.0,2,B
2018-04-23 14:18:14,13620.0,4,24836,2,13620.0,6,13625.0,16,B
2018-04-23 14:18:15,13625.0,14,24850,2,13620.0,7,13630.0,38,B
2018-04-23 14:18:16,13625.0,2,24852,0,13620.0,9,13630.0,38,B
2018-04-23 14:18:18,13625.0,2,24854,2,13620.0,9,13630.0,38,B
2018-04-23 14:18:20,13620.0,18,24872,6,13615.0,6,13620.0,11,S
2018-04-23 14:18:20,13620.0,2,24874,2,13615.0,6,13620.0,10,S
2018-04-23 14:18:21,13630.0,42,24916,18,13620.0,8,13630.0,33,B
2018-04-23 14:18:22,13620.0,20,24936,20,13615.0,16,13620.0,10,S
2018-04-23 14:18:22,13630.0,34,24970,20,13620.0,1,13630.0,29,B
2018-04-23 14:18:23,13620.0,4,24974,2,13615.0,16,13620.0,18,S
2018-04-23 14:18:24,13620.0,22,24996,22,13615.0,31,13620.0,7,S
2018-04-23 14:18:24,13620.0,2,24998,2,13615.0,12,13620.0,6,S
2018-04-23 14:18:25,13620.0,6,25004,6,13615.0,17,13620.0,3,S
2018-04-23 14:18:25,13620.0,6,25010,6,13615.0,8,13625.0,5,S
2018-04-23 14:18:30,13615.0,50,25060,-6,13615.0,4,13625.0,9,S
2018-04-23 14:18:31,13620.0,2,25062,0,13620.0,1,13625.0,11,B
2018-04-23 14:18:36,13620.0,4,25066,2,13615.0,3,13620.0,19,B
2018-04-23 14:18:37,13620.0,38,25104,38,13615.0,14,13625.0,8,B
2018-04-23 14:18:38,13615.0,40,25144,36,13615.0,2,13625.0,12,S
2018-04-23 14:18:40,13615.0,40,25184,40,13610.0,21,13615.0,3,S
2018-04-23 14:18:41,13615.0,6,25190,-6,13615.0,2,13620.0,4,S
2018-04-23 14:18:41,13615.0,6,25196,-4,13610.0,21,13620.0,6,S
2018-04-23 14:18:42,13610.0,2,25198,0,13610.0,20,13620.0,10,S
2018-04-23 14:18:42,13610.0,2,25200,-2,13610.0,19,13620.0,11,S
2018-04-23 14:18:43,13615.0,2,25202,0,13610.0,16,13615.0,12,B
2018-04-23 14:18:44,13610.0,2,25204,2,13610.0,15,13615.0,14,S
2018-04-23 14:18:45,13625.0,34,25238,14,13610.0,23,13620.0,1,B
2018-04-23 14:18:48,13615.0,4,25242,0,13615.0,10,13620.0,2,S
2018-04-23 14:18:50,13620.0,4,25246,2,13615.0,10,13625.0,11,B
2018-04-23 14:18:52,13615.0,4,25250,-2,13615.0,11,13625.0,15,S
2018-04-23 14:18:54,13625.0,4,25254,0,13615.0,14,13625.0,4,B
2018-04-23 14:18:59,13620.0,6,25260,0,13615.0,15,13625.0,5,S
2018-04-23 14:19:02,13615.0,4,25264,2,13610.0,27,13615.0,18,S
2018-04-23 14:19:03,13615.0,36,25300,36,13610.0,28,13620.0,1,S
2018-04-23 14:19:05,13610.0,36,25336,22,13605.0,10,13610.0,2,S
2018-04-23 14:19:06,13615.0,8,25344,4,13605.0,12,13615.0,2,B
2018-04-23 14:19:07,13615.0,8,25352,6,13605.0,13,13615.0,1,B
2018-04-23 14:19:07,13605.0,8,25360,4,13605.0,11,13615.0,1,S
2018-04-23 14:19:12,13615.0,2,25362,2,13605.0,13,13615.0,2,B
2018-04-23 14:19:15,13610.0,8,25370,4,13605.0,11,13610.0,1,S
2018-04-23 14:19:16,13605.0,4,25374,-2,13600.0,21,13610.0,5,S
2018-04-23 14:19:16,13600.0,58,25432,38,13595.0,1,13600.0,21,S
2018-04-23 14:19:17,13600.0,84,25516,44,13600.0,7,13610.0,1,S
2018-04-23 14:19:18,13605.0,2,25518,0,13600.0,18,13610.0,3,B
2018-04-23 14:19:18,13600.0,2,25520,0,13600.0,16,13605.0,13,S
2018-04-23 14:19:19,13600.0,8,25528,8,13595.0,6,13605.0,26,S
2018-04-23 14:19:20,13600.0,2,25530,-2,13600.0,2,13605.0,21,S
2018-04-23 14:19:21,13600.0,4,25534,0,13595.0,16,13600.0,3,S
2018-04-23 14:19:22,13595.0,12,25546,0,13595.0,11,13605.0,14,S
2018-04-23 14:19:23,13590.0,14,25560,-2,13590.0,6,13600.0,13,S
2018-04-23 14:19:23,13590.0,2,25562,2,13590.0,29,13600.0,16,S
2018-04-23 14:19:26,13595.0,2,25564,2,13590.0,23,13600.0,18,B
2018-04-23 14:19:26,13590.0,16,25580,10,13585.0,6,13590.0,42,S
2018-04-23 14:19:27,13585.0,36,25616,10,13585.0,9,13590.0,40,S
2018-04-23 14:19:27,13585.0,14,25630,12,13580.0,2,13585.0,11,S
2018-04-23 14:19:28,13585.0,6,25636,-4,13580.0,3,13585.0,8,S
2018-04-23 14:19:28,13580.0,4,25640,2,13580.0,4,13585.0,11,S
2018-04-23 14:19:29,13585.0,8,25648,0,13580.0,5,13585.0,4,B
2018-04-23 14:19:29,13585.0,8,25656,-4,13585.0,10,13590.0,44,B
2018-04-23 14:19:31,13590.0,28,25684,28,13585.0,11,13590.0,29,B
2018-04-23 14:19:32,13590.0,14,25698,2,13585.0,19,13590.0,19,B
2018-04-23 14:19:32,13590.0,22,25720,22,13585.0,19,13590.0,8,B
2018-04-23 14:19:33,13590.0,16,25736,8,13585.0,19,13595.0,5,B
2018-04-23 14:19:35,13590.0,22,25758,6,13590.0,15,13600.0,17,B
2018-04-23 14:19:37,13590.0,54,25812,48,13585.0,18,13590.0,23,B
2018-04-23 14:19:37,13590.0,46,25858,36,13590.0,5,13595.0,1,B
2018-04-23 14:19:39,13595.0,6,25864,6,13595.0,1,13600.0,16,B
2018-04-23 14:19:39,13595.0,2,25866,0,13590.0,3,13595.0,5,B
2018-04-23 14:19:42,13595.0,16,25882,-10,13595.0,12,13600.0,25,B
2018-04-23 14:19:43,13595.0,26,25908,-26,13590.0,6,13600.0,25,B
2018-04-23 14:19:45,13590.0,2,25910,-2,13590.0,9,13600.0,24,S
2018-04-23 14:19:47,13590.0,10,25920,6,13585.0,21,13590.0,45,S
2018-04-23 14:19:47,13590.0,2,25922,2,13585.0,21,13590.0,44,S
2018-04-23 14:19:48,13590.0,2,25924,2,13585.0,19,13590.0,43,S
2018-04-23 14:19:48,13590.0,2,25926,2,13585.0,19,13590.0,42,S
2018-04-23 14:19:49,13590.0,2,25928,2,13585.0,21,13590.0,41,S
2018-04-23 14:19:49,13590.0,2,25930,2,13585.0,22,13590.0,40,S
2018-04-23 14:19:50,13590.0,2,25932,2,13585.0,17,13590.0,39,S
2018-04-23 14:19:52,13590.0,42,25974,40,13585.0,17,13590.0,19,S
2018-04-23 14:19:53,13590.0,8,25982,4,13585.0,22,13590.0,15,S
2018-04-23 14:19:53,13590.0,30,26012,0,13590.0,3,13595.0,5,S
2018-04-23 14:19:54,13590.0,6,26018,0,13585.0,20,13595.0,9,S
2018-04-23 14:20:00,13590.0,2,26020,2,13585.0,22,13590.0,49,S
2018-04-23 14:20:01,13585.0,40,26060,2,13580.0,8,13590.0,52,S
2018-04-23 14:20:03,13590.0,82,26142,-2,13580.0,8,13590.0,12,B
2018-04-23 14:20:04,13585.0,2,26144,0,13580.0,7,13590.0,14,S
2018-04-23 14:20:05,13585.0,2,26146,2,13585.0,3,13590.0,14,S
2018-04-23 14:20:06,13585.0,2,26148,0,13580.0,9,13590.0,15,S
2018-04-23 14:20:18,13590.0,6,26154,2,13585.0,6,13590.0,10,B
2018-04-23 14:20:19,13585.0,6,26160,-2,13585.0,4,13590.0,9,S
2018-04-23 14:20:19,13590.0,2,26162,2,13585.0,4,13590.0,8,B
2018-04-23 14:20:20,13590.0,2,26164,2,13585.0,4,13590.0,7,B
2018-04-23 14:20:20,13590.0,12,26176,0,13585.0,4,13590.0,1,B
2018-04-23 14:20:21,13590.0,2,26178,2,13585.0,4,13595.0,6,B
2018-04-23 14:20:22,13590.0,2,26180,2,13585.0,4,13590.0,1,B
2018-04-23 14:20:31,13595.0,6,26186,-2,13590.0,5,13595.0,6,B
2018-04-23 14:20:31,13595.0,12,26198,0,13590.0,5,13600.0,23,B
2018-04-23 14:20:33,13590.0,24,26222,16,13585.0,8,13590.0,38,S
2018-04-23 14:20:33,13590.0,74,26296,44,13585.0,10,13590.0,1,S
2018-04-23 14:20:34,13590.0,2,26298,2,13590.0,6,13595.0,3,S
2018-04-23 14:20:34,13585.0,30,26328,-20,13580.0,15,13585.0,15,S
2018-04-23 14:20:35,13595.0,32,26360,-4,13585.0,42,13595.0,2,B
2018-04-23 14:20:35,13595.0,10,26370,-2,13595.0,13,13600.0,22,B
2018-04-23 14:20:36,13595.0,8,26378,8,13595.0,3,13600.0,24,B
2018-04-23 14:20:36,13595.0,6,26384,4,13590.0,19,13595.0,4,B
2018-04-23 14:20:37,13590.0,20,26404,-18,13590.0,9,13595.0,4,S
2018-04-23 14:20:39,13595.0,4,26408,4,13590.0,7,13600.0,27,B
2018-04-23 14:20:41,13595.0,2,26410,0,13590.0,29,13600.0,23,B
2018-04-23 14:20:42,13590.0,66,26476,48,13585.0,7,13590.0,17,S
2018-04-23 14:20:42,13590.0,34,26510,26,13590.0,1,13595.0,1,S
2018-04-23 14:20:45,13595.0,4,26514,0,13590.0,3,13595.0,2,B
2018-04-23 14:20:46,13595.0,2,26516,0,13590.0,4,13600.0,22,B
2018-04-23 14:20:46,13595.0,2,26518,0,13590.0,1,13595.0,3,B
2018-04-23 14:20:47,13595.0,2,26520,0,13585.0,8,13595.0,4,B
2018-04-23 14:20:47,13595.0,2,26522,0,13585.0,11,13595.0,4,B
2018-04-23 14:20:48,13595.0,2,26524,0,13585.0,11,13595.0,4,B
2018-04-23 14:20:48,13595.0,2,26526,2,13585.0,11,13595.0,3,B
2018-04-23 14:20:49,13595.0,2,26528,2,13585.0,11,13595.0,2,B
2018-04-23 14:20:49,13595.0,2,26530,0,13590.0,1,13595.0,1,B
2018-04-23 14:20:50,13595.0,2,26532,0,13590.0,1,13600.0,29,B
2018-04-23 14:20:50,13595.0,2,26534,0,13590.0,4,13595.0,1,B
2018-04-23 14:20:51,13595.0,2,26536,0,13590.0,4,13595.0,3,B
2018-04-23 14:20:51,13595.0,2,26538,2,13590.0,4,13595.0,2,B
2018-04-23 14:20:52,13590.0,10,26548,10,13585.0,10,13590.0,46,S
2018-04-23 14:20:52,13590.0,2,26550,2,13585.0,10,13590.0,45,S
2018-04-23 14:20:53,13590.0,2,26552,2,13585.0,10,13590.0,44,S
2018-04-23 14:20:53,13590.0,2,26554,2,13585.0,10,13590.0,43,S
2018-04-23 14:20:54,13590.0,2,26556,2,13585.0,10,13590.0,42,S
2018-04-23 14:20:54,13590.0,2,26558,2,13585.0,10,13590.0,41,S
2018-04-23 14:20:55,13590.0,2,26560,2,13585.0,9,13590.0,40,S
2018-04-23 14:20:55,13590.0,4,26564,4,13585.0,11,13590.0,38,S
2018-04-23 14:20:56,13590.0,2,26566,2,13585.0,11,13590.0,37,S
2018-04-23 14:20:56,13590.0,2,26568,2,13585.0,11,13590.0,36,S
2018-04-23 14:20:57,13590.0,2,26570,2,13585.0,11,13590.0,35,S
2018-04-23 14:20:57,13590.0,2,26572,2,13585.0,10,13590.0,34,S
2018-04-23 14:20:58,13590.0,2,26574,2,13585.0,9,13590.0,37,S
2018-04-23 14:20:58,13585.0,4,26578,4,13585.0,8,13590.0,36,S
2018-04-23 14:20:59,13590.0,2,26580,2,13585.0,8,13590.0,35,B
2018-04-23 14:21:09,13585.0,2,26582,2,13585.0,10,13590.0,33,S
2018-04-23 14:21:10,13595.0,74,26656,68,13590.0,2,13600.0,27,B
2018-04-23 14:21:11,13590.0,10,26666,4,13585.0,10,13595.0,16,S
2018-04-23 14:21:14,13595.0,22,26688,0,13595.0,9,13600.0,24,B
2018-04-23 14:21:18,13600.0,40,26728,32,13595.0,29,13600.0,6,B
2018-04-23 14:21:21,13600.0,2,26730,0,13595.0,31,13600.0,7,B
2018-04-23 14:21:22,13595.0,62,26792,62,13590.0,2,13595.0,19,S
2018-04-23 14:21:28,13595.0,20,26812,0,13590.0,9,13595.0,15,S
2018-04-23 14:21:32,13595.0,2,26814,2,13590.0,18,13595.0,8,S
2018-04-23 14:21:32,13595.0,16,26830,16,13595.0,12,13600.0,5,S
2018-04-23 14:21:40,13595.0,42,26872,28,13590.0,15,13595.0,29,S
2018-04-23 14:21:40,13595.0,2,26874,2,13590.0,18,13595.0,28,S
2018-04-23 14:21:41,13590.0,2,26876,0,13590.0,17,13595.0,28,S
2018-04-23 14:21:41,13590.0,10,26886,-2,13590.0,3,13595.0,36,S
2018-04-23 14:21:42,13590.0,6,26892,-2,13585.0,30,13590.0,1,S
2018-04-23 14:21:43,13590.0,4,26896,0,13585.0,28,13590.0,5,S
2018-04-23 14:21:44,13590.0,10,26906,-4,13590.0,3,13595.0,32,S
2018-04-23 14:21:44,13590.0,4,26910,-4,13590.0,4,13595.0,30,S
2018-04-23 14:21:53,13590.0,2,26912,0,13590.0,4,13595.0,28,S
2018-04-23 14:21:56,13595.0,6,26918,0,13590.0,13,13595.0,25,B
2018-04-23 14:22:02,13595.0,10,26928,10,13590.0,8,13595.0,23,B
2018-04-23 14:22:08,13590.0,16,26944,4,13585.0,30,13590.0,12,S
2018-04-23 14:22:14,13590.0,2,26946,2,13585.0,35,13590.0,11,S
2018-04-23 14:22:18,13585.0,4,26950,-2,13585.0,33,13590.0,11,S
2018-04-23 14:22:24,13590.0,10,26960,10,13585.0,32,13590.0,7,B
2018-04-23 14:22:27,13590.0,14,26974,0,13590.0,5,13595.0,4,B
2018-04-23 14:22:29,13590.0,10,26984,0,13585.0,32,13590.0,45,B
2018-04-23 14:22:34,13590.0,2,26986,2,13585.0,44,13590.0,44,B
2018-04-23 14:22:42,13590.0,2,26988,2,13585.0,43,13590.0,44,B
2018-04-23 14:22:44,13585.0,20,27008,-4,13585.0,34,13590.0,44,S
2018-04-23 14:22:50,13590.0,2,27010,2,13585.0,37,13590.0,43,B
2018-04-23 14:23:02,13585.0,2,27012,0,13585.0,34,13590.0,43,S
2018-04-23 14:23:02,13585.0,4,27016,0,13585.0,25,13590.0,46,S
2018-04-23 14:23:05,13585.0,6,27022,0,13585.0,22,13590.0,46,S
2018-04-23 14:23:06,13585.0,14,27036,8,13585.0,15,13590.0,46,S
2018-04-23 14:23:07,13585.0,2,27038,0,13585.0,14,13590.0,46,S
2018-04-23 14:23:12,13585.0,10,27048,8,13585.0,9,13590.0,46,S
2018-04-23 14:23:13,13585.0,10,27058,10,13585.0,4,13590.0,46,S
2018-04-23 14:23:14,13585.0,8,27066,-2,13580.0,18,13590.0,46,S
2018-04-23 14:23:22,13580.0,24,27090,-18,13580.0,13,13590.0,48,S
2018-04-23 14:23:25,13585.0,8,27098,-6,13585.0,3,13590.0,48,B
2018-04-23 14:23:25,13585.0,6,27104,-6,13580.0,12,13585.0,3,B
2018-04-23 14:23:27,13585.0,2,27106,2,13580.0,11,13585.0,5,B
2018-04-23 14:23:34,13580.0,2,27108,0,13580.0,11,13585.0,5,S
2018-04-23 14:23:38,13580.0,10,27118,-2,13575.0,7,13585.0,14,S
2018-04-23 14:23:39,13585.0,2,27120,2,13575.0,14,13585.0,13,B
2018-04-23 14:23:47,13575.0,2,27122,0,13575.0,13,13585.0,12,S
2018-04-23 14:23:55,13575.0,2,27124,-2,13575.0,11,13585.0,13,S
2018-04-23 14:23:59,13580.0,10,27134,-4,13575.0,11,13585.0,13,B
2018-04-23 14:24:01,13575.0,2,27136,-2,13575.0,16,13585.0,13,S
2018-04-23 14:24:07,13580.0,2,27138,2,13575.0,13,13580.0,41,B
2018-04-23 14:24:09,13575.0,2,27140,0,13575.0,3,13580.0,46,S
2018-04-23 14:24:10,13580.0,20,27160,20,13575.0,3,13580.0,36,B
2018-04-23 14:24:10,13575.0,2,27162,-2,13575.0,2,13580.0,36,S
2018-04-23 14:24:11,13575.0,4,27166,0,13570.0,17,13575.0,4,S
2018-04-23 14:24:13,13570.0,10,27176,4,13570.0,20,13580.0,36,S
2018-04-23 14:24:14,13570.0,10,27186,-2,13570.0,15,13580.0,36,S
2018-04-23 14:24:16,13575.0,10,27196,10,13570.0,4,13575.0,13,B
2018-04-23 14:24:17,13570.0,8,27204,-2,13565.0,21,13570.0,1,S
2018-04-23 14:24:18,13570.0,2,27206,0,13565.0,27,13570.0,2,S
2018-04-23 14:24:21,13570.0,2,27208,-2,13565.0,27,13570.0,1,S
2018-04-23 14:24:22,13565.0,54,27262,16,13560.0,7,13565.0,4,S
2018-04-23 14:24:22,13565.0,8,27270,8,13565.0,8,13570.0,4,S
2018-04-23 14:24:23,13570.0,12,27282,-8,13565.0,7,13575.0,9,B
2018-04-23 14:24:24,13575.0,8,27290,2,13565.0,3,13575.0,11,B
2018-04-23 14:24:33,13570.0,2,27292,0,13565.0,6,13575.0,12,S
2018-04-23 14:24:38,13565.0,6,27298,2,13560.0,8,13565.0,39,S
2018-04-23 14:24:39,13565.0,70,27368,62,13560.0,10,13565.0,4,S
2018-04-23 14:24:39,13565.0,4,27372,2,13560.0,8,13565.0,2,S
2018-04-23 14:24:40,13565.0,6,27378,0,13565.0,1,13570.0,7,S
2018-04-23 14:24:42,13565.0,2,27380,0,13560.0,7,13570.0,14,S
2018-04-23 14:24:47,13570.0,2,27382,0,13565.0,8,13570.0,1,B
2018-04-23 14:24:47,13570.0,2,27384,2,13570.0,1,13575.0,8,B
2018-04-23 14:24:51,13570.0,2,27386,0,13565.0,13,13570.0,7,B
2018-04-23 14:24:51,13570.0,6,27392,6,13565.0,13,13570.0,4,B
2018-04-23 14:24:52,13570.0,2,27394,2,13565.0,13,13570.0,3,B
2018-04-23 14:24:53,13570.0,2,27396,0,13565.0,13,13570.0,2,B
2018-04-23 14:24:54,13570.0,4,27400,0,13570.0,1,13575.0,15,B
2018-04-23 14:24:55,13575.0,12,27412,8,13570.0,15,13580.0,7,B
2018-04-23 14:24:56,13570.0,20,27432,16,13570.0,5,13580.0,11,S
2018-04-23 14:25:04,13575.0,2,27434,-2,13570.0,7,13580.0,9,B
2018-04-23 14:25:08,13575.0,6,27440,6,13570.0,7,13575.0,47,B
2018-04-23 14:25:10,13575.0,2,27442,0,13570.0,6,13575.0,46,B
2018-04-23 14:25:13,13570.0,4,27446,0,13570.0,4,13575.0,46,S
2018-04-23 14:25:13,13575.0,10,27456,0,13570.0,5,13575.0,41,B
2018-04-23 14:25:19,13575.0,82,27538,38,13570.0,8,13580.0,5,B
2018-04-23 14:25:30,13585.0,10,27548,-6,13575.0,13,13585.0,10,B
2018-04-23 14:25:33,13575.0,26,27574,22,13570.0,11,13575.0,37,S
2018-04-23 14:25:33,13575.0,36,27610,36,13570.0,8,13575.0,19,S
2018-04-23 14:25:34,13575.0,12,27622,12,13570.0,5,13575.0,15,S
2018-04-23 14:25:36,13575.0,2,27624,2,13570.0,3,13575.0,15,S
2018-04-23 14:25:36,13575.0,8,27632,8,13570.0,4,13575.0,9,S
2018-04-23 14:25:38,13575.0,16,27648,16,13575.0,1,13580.0,5,S
2018-04-23 14:25:43,13585.0,2,27650,0,13575.0,1,13585.0,12,B
2018-04-23 14:25:52,13580.0,8,27658,0,13580.0,1,13585.0,12,S
2018-04-23 14:25:52,13580.0,2,27660,-2,13575.0,3,13580.0,1,S
2018-04-23 14:26:02,13575.0,2,27662,0,13575.0,1,13580.0,1,S
2018-04-23 14:26:04,13585.0,8,27670,-6,13575.0,1,13585.0,10,B
2018-04-23 14:26:05,13580.0,10,27680,-10,13575.0,3,13580.0,3,S
2018-04-23 14:26:18,13580.0,2,27682,0,13575.0,8,13580.0,2,S
2018-04-23 14:26:19,13580.0,2,27684,0,13575.0,8,13580.0,1,S
2018-04-23 14:26:20,13580.0,2,27686,-2,13580.0,9,13585.0,13,S
2018-04-23 14:26:20,13580.0,18,27704,-18,13575.0,8,13585.0,13,S
2018-04-23 14:26:30,13575.0,6,27710,-2,13570.0,7,13575.0,3,S
2018-04-23 14:26:33,13575.0,2,27712,0,13570.0,6,13575.0,3,S
2018-04-23 14:26:37,13575.0,2,27714,0,13570.0,6,13575.0,4,S
2018-04-23 14:26:39,13570.0,2,27716,0,13570.0,4,13575.0,4,S
2018-04-23 14:26:45,13570.0,2,27718,2,13570.0,3,13575.0,11,S
2018-04-23 14:26:53,13570.0,2,27720,2,13570.0,4,13580.0,19,S
2018-04-23 14:27:04,13575.0,2,27722,0,13570.0,9,13580.0,23,B
2018-04-23 14:27:14,13580.0,18,27740,0,13570.0,11,13580.0,15,B
2018-04-23 14:27:20,13575.0,2,27742,-2,13570.0,9,13580.0,15,S
2018-04-23 14:27:28,13580.0,2,27744,0,13575.0,3,13580.0,11,B
2018-04-23 14:27:29,13575.0,4,27748,0,13575.0,1,13580.0,11,S
2018-04-23 14:27:33,13575.0,4,27752,4,13570.0,13,13575.0,3,S
2018-04-23 14:27:33,13575.0,6,27758,4,13575.0,2,13580.0,14,S
2018-04-23 14:27:34,13580.0,16,27774,4,13575.0,15,13585.0,9,B
2018-04-23 14:27:45,13580.0,2,27776,0,13575.0,18,13585.0,10,B
2018-04-23 14:27:48,13585.0,2,27778,0,13575.0,19,13585.0,13,B
2018-04-23 14:27:49,13585.0,2,27780,0,13575.0,19,13585.0,12,B
2018-04-23 14:27:50,13585.0,2,27782,0,13575.0,20,13585.0,11,B
2018-04-23 14:27:55,13585.0,2,27784,0,13575.0,20,13585.0,10,B
2018-04-23 14:27:55,13585.0,2,27786,0,13575.0,20,13585.0,9,B
2018-04-23 14:27:56,13585.0,2,27788,2,13575.0,20,13585.0,8,B
2018-04-23 14:27:57,13585.0,2,27790,0,13575.0,20,13585.0,7,B
2018-04-23 14:27:58,13585.0,2,27792,0,13575.0,20,13585.0,9,B
2018-04-23 14:28:00,13575.0,48,27840,44,13570.0,10,13575.0,26,S
2018-04-23 14:28:01,13575.0,10,27850,10,13570.0,9,13575.0,21,S
2018-04-23 14:28:01,13575.0,2,27852,0,13570.0,10,13575.0,20,S
2018-04-23 14:28:02,13575.0,12,27864,12,13570.0,10,13575.0,14,S
2018-04-23 14:28:03,13575.0,4,27868,0,13570.0,10,13575.0,12,S
2018-04-23 14:28:05,13575.0,24,27892,0,13570.0,10,13580.0,7,S
2018-04-23 14:28:08,13580.0,2,27894,-2,13570.0,15,13580.0,7,B
2018-04-23 14:28:12,13575.0,20,27914,20,13570.0,16,13575.0,40,S
2018-04-23 14:28:13,13575.0,44,27958,38,13570.0,16,13575.0,18,S
2018-04-23 14:28:16,13575.0,2,27960,2,13570.0,9,13575.0,17,S
2018-04-23 14:28:16,13575.0,12,27972,12,13570.0,15,13575.0,11,S
2018-04-23 14:28:23,13575.0,10,27982,0,13570.0,20,13575.0,6,S
2018-04-23 14:28:24,13575.0,2,27984,2,13570.0,20,13575.0,5,S
2018-04-23 14:28:25,13575.0,2,27986,2,13570.0,20,13575.0,4,S
2018-04-23 14:28:26,13575.0,8,27994,8,13575.0,1,13580.0,11,S
2018-04-23 14:28:26,13580.0,4,27998,4,13575.0,10,13580.0,7,B
2018-04-23 14:28:27,13580.0,10,28008,-2,13580.0,1,13585.0,8,B
2018-04-23 14:28:27,13585.0,2,28010,0,13580.0,1,13585.0,7,B
2018-04-23 14:28:29,13585.0,2,28012,0,13580.0,1,13585.0,6,B
2018-04-23 14:28:36,13585.0,2,28014,0,13580.0,2,13585.0,3,B
2018-04-23 14:28:37,13585.0,2,28016,0,13580.0,2,13585.0,3,B
2018-04-23 14:28:38,13585.0,2,28018,0,13580.0,2,13585.0,2,B
2018-04-23 14:28:42,13585.0,2,28020,0,13580.0,4,13585.0,2,B
2018-04-23 14:28:43,13580.0,8,28028,-2,13575.0,7,13585.0,14,S
2018-04-23 14:28:43,13580.0,2,28030,0,13575.0,7,13585.0,14,S
2018-04-23 14:28:45,13585.0,6,28036,0,13575.0,7,13585.0,11,B
2018-04-23 14:28:48,13585.0,2,28038,0,13575.0,1,13580.0,15,B
2018-04-23 14:28:51,13585.0,2,28040,0,13575.0,4,13580.0,12,B
2018-04-23 14:28:56,13585.0,2,28042,0,13575.0,12,13585.0,11,B
2018-04-23 14:28:57,13585.0,2,28044,0,13575.0,13,13585.0,10,B
2018-04-23 14:28:59,13585.0,2,28046,0,13575.0,14,13585.0,9,B
2018-04-23 14:29:03,13585.0,4,28050,0,13580.0,1,13585.0,4,B
2018-04-23 14:29:16,13585.0,4,28054,0,13580.0,1,13585.0,2,B
2018-04-23 14:29:32,13585.0,6,28060,0,13580.0,8,13590.0,18,B
2018-04-23 14:29:49,13585.0,2,28062,0,13580.0,7,13585.0,2,B
2018-04-23 14:29:56,13585.0,2,28064,0,13580.0,9,13585.0,1,B
2018-04-23 14:30:11,13585.0,2,28066,0,13580.0,15,13585.0,2,B
2018-04-23 14:30:12,13585.0,4,28070,0,13585.0,1,13590.0,12,B
2018-04-23 14:30:13,13590.0,2,28072,2,13585.0,7,13590.0,6,B
2018-04-23 14:30:17,13590.0,4,28076,4,13585.0,9,13590.0,4,B
2018-04-23 14:30:21,13590.0,2,28078,0,13585.0,9,13590.0,4,B
2018-04-23 14:30:22,13590.0,2,28080,0,13585.0,9,13590.0,3,B
2018-04-23 14:30:26,13585.0,4,28084,0,13585.0,7,13590.0,4,S
2018-04-23 14:30:35,13590.0,2,28086,2,13585.0,7,13590.0,4,B
2018-04-23 14:30:44,13590.0,8,28094,0,13585.0,8,13595.0,11,B
2018-04-23 14:30:45,13590.0,2,28096,-2,13585.0,8,13595.0,14,B
2018-04-23 14:31:02,13590.0,2,28098,0,13585.0,7,13595.0,14,B
2018-04-23 14:31:29,13585.0,40,28138,36,13585.0,46,13595.0,16,S
2018-04-23 14:31:30,13590.0,2,28140,2,13585.0,46,13595.0,18,B
2018-04-23 14:31:37,13595.0,2,28142,2,13590.0,1,13595.0,15,B
2018-04-23 14:31:39,13595.0,2,28144,0,13590.0,4,13595.0,13,B
2018-04-23 14:31:43,13590.0,8,28152,6,13585.0,49,13590.0,16,S
2018-04-23 14:31:44,13590.0,10,28162,10,13585.0,52,13590.0,11,S
2018-04-23 14:31:44,13590.0,22,28184,22,13585.0,53,13595.0,7,S
2018-04-23 14:31:50,13585.0,40,28224,40,13585.0,33,13590.0,20,S
2018-04-23 14:31:55,13585.0,22,28246,2,13585.0,29,13590.0,19,S
2018-04-23 14:31:56,13590.0,2,28248,2,13585.0,29,13590.0,18,B
2018-04-23 14:31:57,13585.0,40,28288,38,13585.0,9,13590.0,18,S
2018-04-23 14:32:00,13590.0,2,28290,0,13585.0,10,13590.0,17,B
2018-04-23 14:32:12,13585.0,20,28310,18,13580.0,10,13585.0,10,S
2018-04-23 14:32:13,13590.0,36,28346,0,13585.0,4,13590.0,12,B
2018-04-23 14:32:13,13590.0,16,28362,0,13585.0,4,13590.0,7,B
2018-04-23 14:32:17,13585.0,2,28364,2,13580.0,10,13585.0,19,S
2018-04-23 14:32:17,13585.0,14,28378,12,13580.0,18,13585.0,12,S
2018-04-23 14:32:22,13585.0,2,28380,2,13580.0,18,13585.0,11,S
2018-04-23 14:32:23,13585.0,2,28382,0,13580.0,18,13585.0,10,S
2018-04-23 14:32:24,13585.0,2,28384,2,13580.0,18,13585.0,9,S
2018-04-23 14:32:26,13585.0,4,28388,4,13580.0,21,13585.0,57,S
2018-04-23 14:32:29,13585.0,2,28390,2,13580.0,19,13585.0,56,S
2018-04-23 14:32:30,13580.0,38,28428,30,13575.0,12,13580.0,1,S
2018-04-23 14:32:31,13580.0,12,28440,2,13580.0,3,13585.0,59,S
2018-04-23 14:32:31,13580.0,10,28450,-6,13575.0,14,13585.0,59,S
2018-04-23 14:32:32,13575.0,20,28470,-2,13575.0,6,13585.0,62,S
2018-04-23 14:32:32,13580.0,2,28472,0,13575.0,13,13585.0,62,B
2018-04-23 14:32:34,13580.0,2,28474,0,13575.0,6,13580.0,1,B
2018-04-23 14:32:34,13580.0,2,28476,0,13575.0,6,13585.0,64,B
2018-04-23 14:32:35,13575.0,28,28504,26,13570.0,11,13575.0,7,S
2018-04-23 14:32:36,13580.0,22,28526,14,13575.0,6,13580.0,3,B
2018-04-23 14:32:37,13580.0,2,28528,0,13575.0,1,13585.0,64,B
2018-04-23 14:32:38,13585.0,2,28530,2,13575.0,3,13585.0,65,B
2018-04-23 14:32:40,13585.0,2,28532,2,13575.0,5,13585.0,64,B
2018-04-23 14:32:41,13585.0,14,28546,14,13575.0,5,13585.0,53,B
2018-04-23 14:32:43,13585.0,2,28548,2,13575.0,5,13585.0,52,B
2018-04-23 14:32:44,13585.0,20,28568,0,13575.0,11,13585.0,42,B
2018-04-23 14:32:48,13575.0,30,28598,26,13570.0,9,13575.0,5,S
2018-04-23 14:32:48,13580.0,12,28610,6,13580.0,2,13585.0,42,B
2018-04-23 14:32:49,13580.0,8,28618,4,13580.0,1,13585.0,42,B
2018-04-23 14:32:49,13580.0,4,28622,4,13580.0,1,13585.0,39,B
2018-04-23 14:32:51,13580.0,12,28634,12,13575.0,9,13580.0,14,B
2018-04-23 14:32:51,13580.0,20,28654,16,13575.0,9,13580.0,5,B
2018-04-23 14:32:53,13580.0,2,28656,2,13575.0,9,13580.0,4,B
2018-04-23 14:32:53,13580.0,2,28658,2,13575.0,9,13580.0,23,B
2018-04-23 14:32:56,13575.0,2,28660,2,13575.0,8,13580.0,25,S
2018-04-23 14:32:57,13580.0,22,28682,4,13575.0,8,13580.0,14,B
2018-04-23 14:32:58,13580.0,4,28686,-4,13575.0,8,13580.0,12,B
2018-04-23 14:33:01,13575.0,18,28704,18,13570.0,12,13575.0,11,S
2018-04-23 14:33:02,13575.0,14,28718,10,13570.0,17,13575.0,4,S
2018-04-23 14:33:02,13575.0,8,28726,8,13575.0,4,13580.0,16,S
2018-04-23 14:33:10,13580.0,2,28728,0,13575.0,1,13580.0,17,B
2018-04-23 14:33:13,13580.0,4,28732,0,13575.0,5,13580.0,13,B
2018-04-23 14:33:14,13575.0,14,28746,10,13570.0,36,13575.0,15,S
2018-04-23 14:33:14,13575.0,30,28776,20,13570.0,36,13580.0,11,S
2018-04-23 14:33:24,13580.0,2,28778,0,13570.0,41,13580.0,12,B
2018-04-23 14:33:27,13575.0,8,28786,8,13570.0,39,13575.0,16,S
2018-04-23 14:33:29,13575.0,8,28794,0,13570.0,40,13575.0,12,S
2018-04-23 14:33:30,13575.0,14,28808,2,13570.0,37,13575.0,5,S
2018-04-23 14:33:30,13575.0,4,28812,4,13570.0,37,13575.0,3,S
2018-04-23 14:33:33,13575.0,4,28816,4,13570.0,37,13575.0,6,S
2018-04-23 14:33:36,13575.0,2,28818,0,13570.0,37,13575.0,5,S
2018-04-23 14:33:37,13575.0,26,28844,8,13570.0,22,13575.0,26,S
2018-04-23 14:33:37,13570.0,24,28868,8,13570.0,10,13575.0,31,S
2018-04-23 14:33:38,13570.0,20,28888,4,13565.0,8,13570.0,2,S
2018-04-23 14:33:41,13570.0,2,28890,-2,13565.0,9,13575.0,31,S
2018-04-23 14:33:44,13565.0,24,28914,18,13560.0,5,13565.0,8,S
2018-04-23 14:33:44,13570.0,38,28952,6,13570.0,5,13575.0,30,B
2018-04-23 14:33:45,13570.0,10,28962,-10,13565.0,7,13570.0,6,B
2018-04-23 14:33:58,13565.0,4,28966,4,13565.0,8,13570.0,6,S
2018-04-23 14:33:59,13570.0,2,28968,2,13565.0,8,13570.0,5,B
2018-04-23 14:34:00,13570.0,2,28970,0,13565.0,8,13570.0,4,B
2018-04-23 14:34:01,13570.0,4,28974,0,13565.0,8,13570.0,2,B
2018-04-23 14:34:05,13565.0,4,28978,0,13565.0,16,13570.0,2,S
2018-04-23 14:34:05,13565.0,4,28982,0,13565.0,14,13570.0,2,S
2018-04-23 14:34:06,13565.0,2,28984,0,13565.0,13,13570.0,2,S
2018-04-23 14:34:06,13565.0,28,29012,28,13560.0,10,13565.0,6,S
2018-04-23 14:34:07,13565.0,12,29024,8,13565.0,1,13570.0,4,S
2018-04-23 14:34:10,13565.0,4,29028,0,13565.0,1,13570.0,5,S
2018-04-23 14:34:12,13570.0,6,29034,2,13565.0,1,13570.0,9,B
2018-04-23 14:34:13,13565.0,6,29040,0,13560.0,13,13565.0,8,S
2018-04-23 14:34:16,13560.0,28,29068,20,13555.0,10,13560.0,6,S
2018-04-23 14:34:16,13565.0,20,29088,0,13560.0,9,13565.0,9,B
2018-04-23 14:34:17,13565.0,2,29090,0,13560.0,5,13565.0,11,B
2018-04-23 14:34:18,13560.0,4,29094,0,13560.0,4,13565.0,10,S
2018-04-23 14:34:19,13560.0,8,29102,8,13555.0,13,13560.0,16,S
2018-04-23 14:34:20,13560.0,32,29134,0,13560.0,1,13565.0,10,S
2018-04-23 14:34:20,13560.0,8,29142,-4,13555.0,14,13565.0,10,S
2018-04-23 14:34:21,13560.0,2,29144,2,13555.0,16,13560.0,3,S
2018-04-23 14:34:22,13560.0,6,29150,0,13555.0,22,13565.0,12,S
2018-04-23 14:34:24,13565.0,4,29154,0,13560.0,11,13565.0,8,B
2018-04-23 14:34:25,13560.0,22,29176,0,13555.0,18,13560.0,4,S
2018-04-23 14:34:26,13555.0,10,29186,-4,13555.0,13,13560.0,1,S
2018-04-23 14:34:27,13555.0,26,29212,-6,13560.0,6,13565.0,12,S
2018-04-23 14:34:27,13560.0,12,29224,-12,13555.0,8,13565.0,12,B
2018-04-23 14:34:32,13555.0,8,29232,-2,13555.0,2,13560.0,13,S
2018-04-23 14:34:33,13555.0,14,29246,12,13550.0,33,13555.0,13,S
2018-04-23 14:34:34,13555.0,28,29274,28,13555.0,4,13560.0,16,S
2018-04-23 14:34:36,13555.0,4,29278,-4,13555.0,1,13560.0,19,S
2018-04-23 14:34:37,13560.0,2,29280,0,13555.0,2,13560.0,18,B
2018-04-23 14:34:38,13560.0,10,29290,0,13555.0,2,13560.0,10,B
2018-04-23 14:34:39,13560.0,2,29292,0,13555.0,1,13560.0,9,B
2018-04-23 14:34:40,13560.0,10,29302,0,13555.0,2,13560.0,4,B
2018-04-23 14:34:43,13555.0,2,29304,2,13555.0,1,13560.0,22,S
2018-04-23 14:34:44,13560.0,2,29306,0,13555.0,2,13560.0,21,B
2018-04-23 14:34:48,13555.0,10,29316,4,13550.0,35,13555.0,16,S
2018-04-23 14:34:48,13555.0,12,29328,6,13550.0,45,13555.0,10,S
2018-04-23 14:34:50,13550.0,6,29334,0,13550.0,43,13555.0,9,S
2018-04-23 14:34:51,13550.0,6,29340,4,13550.0,42,13555.0,7,S
2018-04-23 14:34:53,13555.0,4,29344,4,13550.0,42,13555.0,5,B
2018-04-23 14:34:54,13555.0,4,29348,0,13550.0,42,13555.0,3,B
2018-04-23 14:34:54,13555.0,6,29354,4,13555.0,2,13560.0,23,B
2018-04-23 14:34:56,13555.0,2,29356,2,13550.0,35,13555.0,19,B
2018-04-23 14:34:57,13550.0,6,29362,-2,13550.0,29,13555.0,29,S
2018-04-23 14:34:57,13555.0,40,29402,-2,13550.0,29,13555.0,9,B
2018-04-23 14:34:59,13555.0,2,29404,2,13550.0,29,13555.0,8,B
2018-04-23 14:35:01,13550.0,40,29444,32,13550.0,9,13555.0,26,S
2018-04-23 14:35:01,13550.0,18,29462,-14,13550.0,5,13555.0,26,S
2018-04-23 14:35:02,13555.0,6,29468,2,13545.0,3,13555.0,25,B
2018-04-23 14:35:04,13550.0,2,29470,-2,13550.0,2,13555.0,25,S
2018-04-23 14:35:04,13550.0,2,29472,0,13550.0,1,13555.0,25,S
2018-04-23 14:35:05,13550.0,2,29474,0,13550.0,1,13555.0,25,S
2018-04-23 14:35:09,13550.0,4,29478,0,13545.0,10,13550.0,9,S
2018-04-23 14:35:10,13545.0,30,29508,24,13540.0,5,13545.0,5,S
2018-04-23 14:35:11,13545.0,22,29530,-6,13545.0,4,13550.0,7,S
2018-04-23 14:35:12,13550.0,18,29548,2,13545.0,2,13550.0,1,B
2018-04-23 14:35:13,13550.0,2,29550,2,13550.0,9,13555.0,32,B
2018-04-23 14:35:13,13550.0,4,29554,0,13550.0,7,13555.0,36,B
2018-04-23 14:35:14,13555.0,8,29562,0,13550.0,5,13555.0,34,B
2018-04-23 14:35:14,13555.0,6,29568,0,13550.0,5,13555.0,32,B
2018-04-23 14:35:15,13555.0,20,29588,-4,13550.0,1,13555.0,23,B
2018-04-23 14:35:15,13555.0,18,29606,-2,13545.0,6,13555.0,13,B
2018-04-23 14:35:16,13555.0,24,29630,8,13545.0,9,13560.0,8,B
2018-04-23 14:35:16,13560.0,2,29632,0,13550.0,18,13560.0,13,B
2018-04-23 14:35:17,13560.0,4,29636,0,13555.0,10,13560.0,13,B
2018-04-23 14:35:18,13555.0,12,29648,-6,13555.0,5,13560.0,13,S
2018-04-23 14:35:19,13555.0,10,29658,0,13550.0,14,13555.0,15,S
2018-04-23 14:35:19,13555.0,4,29662,0,13550.0,13,13555.0,13,S
2018-04-23 14:35:20,13555.0,2,29664,0,13550.0,13,13555.0,16,S
2018-04-23 14:35:25,13550.0,8,29672,-4,13550.0,12,13555.0,12,S
2018-04-23 14:35:25,13555.0,2,29674,2,13550.0,12,13555.0,11,B
2018-04-23 14:35:27,13550.0,2,29676,-2,13550.0,12,13555.0,11,S
2018-04-23 14:35:35,13555.0,8,29684,8,13550.0,14,13555.0,16,B
2018-04-23 14:35:37,13555.0,10,29694,10,13550.0,14,13555.0,11,B
2018-04-23 14:35:39,13555.0,2,29696,2,13550.0,16,13555.0,10,B
2018-04-23 14:35:40,13550.0,2,29698,-2,13550.0,15,13555.0,9,S
2018-04-23 14:35:43,13555.0,18,29716,-12,13555.0,1,13560.0,24,B
2018-04-23 14:35:43,13555.0,8,29724,-4,13550.0,16,13555.0,2,B
2018-04-23 14:35:44,13555.0,6,29730,-6,13550.0,19,13555.0,2,B
2018-04-23 14:35:45,13555.0,4,29734,0,13550.0,16,13560.0,25,B
2018-04-23 14:35:46,13555.0,2,29736,0,13550.0,19,13555.0,2,B
2018-04-23 14:35:53,13550.0,20,29756,-4,13550.0,3,13555.0,4,S
2018-04-23 14:35:53,13555.0,2,29758,2,13550.0,3,13555.0,3,B
2018-04-23 14:35:56,13550.0,30,29788,-10,13545.0,14,13550.0,1,S
2018-04-23 14:35:56,13550.0,6,29794,-6,13545.0,12,13550.0,1,S
2018-04-23 14:35:57,13550.0,10,29804,2,13545.0,12,13550.0,8,S
2018-04-23 14:35:57,13550.0,16,29820,0,13550.0,2,13555.0,6,S
2018-04-23 14:35:59,13550.0,14,29834,8,13545.0,19,13550.0,13,S
2018-04-23 14:36:00,13550.0,10,29844,8,13545.0,21,13550.0,8,S
2018-04-23 14:36:02,13550.0,26,29870,26,13550.0,27,13555.0,11,S
2018-04-23 14:36:04,13550.0,20,29890,0,13550.0,17,13555.0,8,S
2018-04-23 14:36:11,13555.0,4,29894,4,13550.0,23,13555.0,34,B
2018-04-23 14:36:12,13555.0,24,29918,24,13550.0,25,13555.0,22,B
2018-04-23 14:36:12,13555.0,8,29926,8,13550.0,29,13555.0,18,B
2018-04-23 14:36:13,13555.0,4,29930,4,13550.0,34,13555.0,16,B
2018-04-23 14:36:13,13550.0,72,30002,52,13545.0,14,13550.0,14,S
2018-04-23 14:36:14,13550.0,2,30004,2,13545.0,15,13550.0,13,S
2018-04-23 14:36:14,13550.0,4,30008,2,13545.0,15,13550.0,11,S
2018-04-23 14:36:15,13550.0,2,30010,2,13545.0,15,13550.0,10,S
2018-04-23 14:36:20,13550.0,18,30028,12,13545.0,14,13550.0,4,S
2018-04-23 14:36:20,13550.0,8,30036,8,13550.0,1,13555.0,22,S
2018-04-23 14:36:27,13550.0,60,30096,56,13545.0,20,13550.0,21,S
2018-04-23 14:36:28,13550.0,22,30118,20,13545.0,28,13550.0,10,S
2018-04-23 14:36:28,13545.0,8,30126,6,13545.0,26,13550.0,10,S
2018-04-23 14:36:31,13550.0,2,30128,0,13545.0,25,13550.0,13,B
2018-04-23 14:36:31,13550.0,2,30130,2,13545.0,25,13550.0,12,B
2018-04-23 14:36:35,13550.0,4,30134,2,13545.0,24,13550.0,10,B
2018-04-23 14:36:36,13550.0,2,30136,0,13545.0,24,13550.0,9,B
2018-04-23 14:36:37,13550.0,2,30138,2,13545.0,24,13550.0,8,B
2018-04-23 14:36:39,13545.0,8,30146,2,13545.0,20,13550.0,8,S
2018-04-23 14:36:44,13545.0,6,30152,4,13545.0,11,13550.0,15,S
2018-04-23 14:36:49,13550.0,2,30154,2,13545.0,17,13550.0,10,B
2018-04-23 14:36:51,13550.0,2,30156,2,13545.0,20,13550.0,9,B
2018-04-23 14:36:56,13550.0,2,30158,2,13545.0,20,13550.0,8,B
2018-04-23 14:36:57,13550.0,2,30160,2,13545.0,20,13550.0,7,B
2018-04-23 14:36:57,13550.0,2,30162,-2,13545.0,20,13550.0,6,B
2018-04-23 14:37:02,13550.0,2,30164,0,13545.0,20,13550.0,10,B
2018-04-23 14:37:03,13550.0,10,30174,6,13545.0,24,13550.0,2,B
2018-04-23 14:37:10,13550.0,6,30180,4,13550.0,8,13555.0,23,B
2018-04-23 14:37:11,13550.0,20,30200,20,13545.0,23,13550.0,40,B
2018-04-23 14:37:13,13550.0,2,30202,2,13545.0,23,13550.0,39,B
2018-04-23 14:37:14,13550.0,12,30214,12,13545.0,25,13550.0,33,B
2018-04-23 14:37:15,13550.0,4,30218,4,13545.0,25,13550.0,31,B
2018-04-23 14:37:15,13545.0,2,30220,0,13545.0,23,13550.0,31,S
2018-04-23 14:37:21,13550.0,2,30222,2,13545.0,23,13550.0,30,B
2018-04-23 14:37:23,13550.0,6,30228,6,13545.0,24,13550.0,27,B
2018-04-23 14:37:31,13550.0,2,30230,2,13545.0,25,13550.0,28,B
2018-04-23 14:37:44,13545.0,44,30274,12,13540.0,11,13545.0,5,S
2018-04-23 14:37:45,13545.0,6,30280,6,13540.0,12,13545.0,6,S
2018-04-23 14:37:49,13545.0,18,30298,-14,13545.0,1,13550.0,45,S
2018-04-23 14:37:49,13545.0,2,30300,-2,13540.0,17,13550.0,45,S
2018-04-23 14:37:53,13545.0,6,30306,0,13545.0,1,13550.0,41,S
2018-04-23 14:37:54,13550.0,2,30308,2,13545.0,1,13550.0,38,B
2018-04-23 14:37:58,13545.0,6,30314,-2,13540.0,16,13545.0,27,S
2018-04-23 14:37:58,13545.0,2,30316,-2,13540.0,15,13545.0,26,S
2018-04-23 14:38:00,13545.0,16,30332,0,13540.0,15,13545.0,18,S
2018-04-23 14:38:02,13545.0,4,30336,0,13540.0,15,13545.0,16,S
2018-04-23 14:38:02,13540.0,16,30352,-6,13540.0,7,13545.0,16,S
2018-04-23 14:38:03,13540.0,14,30366,0,13535.0,14,13540.0,9,S
2018-04-23 14:38:03,13540.0,36,30402,-2,13540.0,29,13545.0,1,S
2018-04-23 14:38:04,13545.0,2,30404,2,13540.0,36,13545.0,1,B
2018-04-23 14:38:05,13550.0,18,30422,18,13540.0,27,13550.0,34,B
2018-04-23 14:38:06,13550.0,18,30440,18,13540.0,19,13550.0,25,B
2018-04-23 14:38:06,13540.0,10,30450,0,13540.0,17,13550.0,25,S
2018-04-23 14:38:09,13540.0,10,30460,0,13540.0,20,13550.0,25,S
2018-04-23 14:38:10,13540.0,4,30464,4,13540.0,20,13550.0,27,S
2018-04-23 14:38:11,13545.0,2,30466,0,13540.0,19,13550.0,27,B
2018-04-23 14:38:13,13540.0,2,30468,0,13540.0,21,13550.0,27,S
2018-04-23 14:38:14,13540.0,2,30470,0,13540.0,20,13550.0,27,S
2018-04-23 14:38:16,13545.0,8,30478,-8,13540.0,16,13550.0,27,B
2018-04-23 14:38:26,13545.0,2,30480,0,13540.0,10,13545.0,14,B
2018-04-23 14:38:28,13545.0,2,30482,0,13540.0,17,13545.0,7,B
2018-04-23 14:38:31,13545.0,4,30486,2,13540.0,20,13545.0,5,B
2018-04-23 14:38:34,13545.0,4,30490,2,13540.0,18,13545.0,4,B
2018-04-23 14:38:38,13545.0,6,30496,6,13540.0,16,13545.0,1,B
2018-04-23 14:38:43,13545.0,2,30498,2,13540.0,16,13545.0,1,B
2018-04-23 14:38:44,13545.0,4,30502,-2,13540.0,12,13545.0,1,B
2018-04-23 14:38:46,13545.0,2,30504,0,13540.0,9,13545.0,6,B
2018-04-23 14:38:48,13545.0,2,30506,2,13540.0,8,13545.0,4,B
2018-04-23 14:38:50,13540.0,14,30520,-4,13540.0,1,13545.0,5,S
2018-04-23 14:38:53,13540.0,2,30522,0,13540.0,1,13545.0,4,S
2018-04-23 14:38:55,13540.0,2,30524,-2,13540.0,16,13550.0,36,S
2018-04-23 14:39:00,13550.0,2,30526,2,13540.0,14,13550.0,35,B
2018-04-23 14:39:05,13545.0,4,30530,2,13540.0,3,13545.0,8,S
2018-04-23 14:39:07,13545.0,2,30532,0,13540.0,3,13545.0,7,S
2018-04-23 14:39:13,13545.0,2,30534,2,13540.0,2,13545.0,6,S
2018-04-23 14:39:14,13540.0,4,30538,-4,13535.0,16,13540.0,8,S
2018-04-23 14:39:15,13540.0,2,30540,-2,13535.0,23,13540.0,7,S
2018-04-23 14:39:17,13540.0,4,30544,0,13535.0,23,13540.0,5,S
2018-04-23 14:39:17,13540.0,10,30554,-6,13540.0,4,13545.0,8,S
2018-04-23 14:39:20,13545.0,2,30556,0,13540.0,1,13545.0,8,B
2018-04-23 14:39:29,13545.0,4,30560,0,13540.0,1,13545.0,4,B
2018-04-23 14:39:30,13545.0,2,30562,0,13540.0,1,13545.0,4,B
2018-04-23 14:39:36,13545.0,2,30564,0,13540.0,8,13545.0,3,B
2018-04-23 14:39:42,13545.0,4,30568,4,13540.0,9,13545.0,50,B
2018-04-23 14:39:50,13540.0,2,30570,-2,13540.0,7,13545.0,50,S
2018-04-23 14:39:54,13545.0,10,30580,10,13540.0,9,13545.0,45,B
2018-04-23 14:39:55,13545.0,10,30590,10,13540.0,9,13545.0,40,B
2018-04-23 14:40:01,13545.0,2,30592,2,13540.0,9,13545.0,39,B
2018-04-23 14:40:09,13545.0,2,30594,2,13540.0,12,13545.0,38,B
2018-04-23 14:40:12,13540.0,20,30614,-2,13540.0,3,13545.0,38,S
2018-04-23 14:40:23,13535.0,2,30616,-2,13535.0,23,13545.0,39,S
2018-04-23 14:40:24,13535.0,2,30618,0,13535.0,22,13545.0,39,S
2018-04-23 14:40:27,13540.0,4,30622,0,13535.0,22,13540.0,2,B
2018-04-23 14:40:33,13540.0,2,30624,0,13535.0,20,13540.0,4,B
2018-04-23 14:40:33,13540.0,4,30628,0,13535.0,20,13540.0,2,B
2018-04-23 14:40:35,13540.0,2,30630,0,13535.0,20,13540.0,1,B
2018-04-23 14:40:37,13540.0,2,30632,0,13540.0,1,13545.0,42,B
2018-04-23 14:40:37,13540.0,2,30634,0,13535.0,24,13545.0,42,B
2018-04-23 14:40:48,13545.0,12,30646,10,13540.0,8,13545.0,44,B
2018-04-23 14:40:48,13545.0,12,30658,12,13540.0,5,13545.0,38,B
2018-04-23 14:40:51,13545.0,6,30664,6,13540.0,11,13545.0,35,B
2018-04-23 14:41:01,13545.0,2,30666,2,13540.0,3,13545.0,35,B
2018-04-23 14:41:39,13540.0,2,30668,0,13540.0,8,13545.0,33,S
2018-04-23 14:41:42,13540.0,2,30670,0,13540.0,8,13545.0,33,S
2018-04-23 14:41:43,13540.0,16,30686,10,13535.0,19,13540.0,1,S
2018-04-23 14:41:43,13540.0,2,30688,0,13535.0,24,13545.0,35,S
2018-04-23 14:41:47,13540.0,2,30690,0,13535.0,24,13545.0,33,S
2018-04-23 14:41:52,13545.0,4,30694,4,13540.0,1,13545.0,31,B
2018-04-23 14:41:53,13540.0,2,30696,2,13535.0,24,13540.0,1,S
2018-04-23 14:41:53,13545.0,22,30718,20,13535.0,24,13545.0,23,B
2018-04-23 14:42:03,13540.0,2,30720,2,13535.0,29,13545.0,27,S
2018-04-23 14:42:10,13540.0,2,30722,2,13535.0,29,13545.0,29,S
2018-04-23 14:42:19,13540.0,12,30734,0,13535.0,30,13545.0,24,S
2018-04-23 14:42:25,13540.0,2,30736,0,13535.0,29,13540.0,4,S
2018-04-23 14:42:25,13540.0,8,30744,0,13535.0,29,13545.0,24,S
2018-04-23 14:42:26,13545.0,16,30760,16,13540.0,9,13545.0,13,B
2018-04-23 14:42:34,13545.0,2,30762,0,13540.0,9,13545.0,12,B
2018-04-23 14:42:36,13545.0,6,30768,6,13540.0,10,13545.0,9,B
2018-04-23 14:42:42,13545.0,2,30770,0,13540.0,10,13545.0,7,B
2018-04-23 14:42:44,13545.0,2,30772,0,13540.0,12,13545.0,6,B
2018-04-23 14:42:57,13545.0,2,30774,0,13540.0,21,13545.0,5,B
2018-04-23 14:42:58,13545.0,2,30776,-2,13540.0,21,13545.0,4,B
2018-04-23 14:43:02,13545.0,4,30780,0,13540.0,21,13545.0,2,B
2018-04-23 14:43:04,13545.0,2,30782,-2,13540.0,21,13545.0,1,B
2018-04-23 14:43:18,13545.0,2,30784,0,13540.0,27,13545.0,15,B
2018-04-23 14:43:19,13545.0,2,30786,-2,13540.0,27,13545.0,14,B
2018-04-23 14:43:20,13545.0,10,30796,0,13540.0,27,13545.0,9,B
2018-04-23 14:43:24,13545.0,18,30814,12,13545.0,16,13550.0,35,B
2018-04-23 14:43:29,13545.0,40,30854,40,13540.0,22,13545.0,30,B
2018-04-23 14:43:30,13545.0,60,30914,60,13545.0,9,13550.0,29,B
2018-04-23 14:43:30,13545.0,4,30918,0,13545.0,6,13550.0,31,B
2018-04-23 14:43:36,13550.0,2,30920,0,13545.0,11,13550.0,27,B
2018-04-23 14:43:37,13550.0,12,30932,0,13545.0,5,13550.0,21,B
2018-04-23 14:43:40,13550.0,2,30934,-2,13545.0,8,13550.0,20,B
2018-04-23 14:43:41,13550.0,2,30936,0,13545.0,8,13550.0,19,B
2018-04-23 14:43:45,13545.0,26,30962,24,13545.0,2,13550.0,25,S
2018-04-23 14:43:45,13545.0,6,30968,-2,13540.0,17,13550.0,25,S
2018-04-23 14:43:46,13545.0,2,30970,2,13540.0,17,13550.0,25,S
2018-04-23 14:43:49,13550.0,2,30972,0,13545.0,17,13550.0,18,B
2018-04-23 14:43:56,13550.0,2,30974,2,13545.0,20,13550.0,16,B
2018-04-23 14:43:58,13550.0,2,30976,2,13545.0,20,13550.0,15,B
2018-04-23 14:44:00,13545.0,40,31016,34,13545.0,1,13550.0,15,S
2018-04-23 14:44:03,13545.0,6,31022,2,13540.0,22,13545.0,17,S
2018-04-23 14:44:03,13550.0,54,31076,52,13545.0,12,13550.0,5,B
2018-04-23 14:44:04,13550.0,12,31088,10,13550.0,11,13555.0,35,B
2018-04-23 14:44:04,13550.0,40,31128,22,13545.0,4,13555.0,29,B
2018-04-23 14:44:06,13550.0,2,31130,-2,13550.0,1,13555.0,30,B
2018-04-23 14:44:08,13550.0,10,31140,8,13545.0,12,13550.0,15,B
2018-04-23 14:44:11,13550.0,4,31144,4,13545.0,14,13550.0,13,B
2018-04-23 14:44:18,13550.0,10,31154,-2,13545.0,9,13550.0,12,B
2018-04-23 14:44:22,13545.0,4,31158,2,13545.0,18,13550.0,12,S
2018-04-23 14:44:30,13550.0,2,31160,2,13545.0,19,13550.0,12,B
2018-04-23 14:44:36,13545.0,2,31162,0,13545.0,19,13550.0,13,S
2018-04-23 14:44:45,13550.0,2,31164,2,13545.0,21,13550.0,15,B
2018-04-23 14:44:53,13550.0,2,31166,0,13545.0,31,13550.0,14,B
2018-04-23 14:44:56,13545.0,40,31206,34,13545.0,11,13550.0,14,S
2018-04-23 14:45:05,13550.0,26,31232,-8,13545.0,21,13550.0,5,B
2018-04-23 14:45:06,13545.0,40,31272,16,13545.0,1,13550.0,5,S
2018-04-23 14:45:07,13550.0,2,31274,-2,13545.0,1,13550.0,4,B
2018-04-23 14:45:08,13545.0,10,31284,10,13540.0,19,13545.0,15,S
2018-04-23 14:45:08,13545.0,4,31288,4,13540.0,21,13545.0,13,S
2018-04-23 14:45:09,13545.0,20,31308,20,13540.0,16,13545.0,3,S
2018-04-23 14:45:12,13545.0,6,31314,6,13545.0,7,13550.0,12,S
2018-04-23 14:45:14,13550.0,4,31318,0,13545.0,9,13550.0,7,B
2018-04-23 14:45:15,13550.0,14,31332,10,13545.0,2,13555.0,29,B
2018-04-23 14:45:17,13550.0,2,31334,0,13545.0,5,13550.0,2,B
2018-04-23 14:45:20,13545.0,12,31346,4,13540.0,20,13545.0,14,S
2018-04-23 14:45:20,13545.0,14,31360,10,13540.0,22,13545.0,7,S
2018-04-23 14:45:21,13545.0,14,31374,14,13545.0,2,13550.0,7,S
2018-04-23 14:45:26,13545.0,20,31394,20,13540.0,22,13545.0,10,S
2018-04-23 14:45:26,13545.0,8,31402,8,13540.0,25,13545.0,6,S
2018-04-23 14:45:29,13545.0,10,31412,10,13540.0,23,13545.0,1,S
2018-04-23 14:45:29,13545.0,2,31414,2,13545.0,2,13550.0,8,S
2018-04-23 14:45:30,13545.0,4,31418,4,13540.0,22,13545.0,18,S
2018-04-23 14:45:33,13545.0,10,31428,8,13540.0,24,13545.0,13,S
2018-04-23 14:45:36,13545.0,2,31430,0,13540.0,24,13545.0,12,S
2018-04-23 14:45:43,13545.0,6,31436,6,13540.0,25,13545.0,10,S
2018-04-23 14:45:44,13545.0,10,31446,10,13540.0,25,13545.0,5,S
2018-04-23 14:45:44,13545.0,10,31456,-2,13540.0,25,13550.0,9,S
2018-04-23 14:45:57,13545.0,4,31460,0,13540.0,27,13545.0,1,S
2018-04-23 14:45:57,13545.0,2,31462,-2,13540.0,25,13550.0,15,S
2018-04-23 14:46:05,13545.0,2,31464,0,13540.0,29,13545.0,21,S
2018-04-23 14:46:05,13545.0,40,31504,24,13540.0,27,13545.0,1,S
2018-04-23 14:46:06,13545.0,2,31506,-2,13545.0,7,13550.0,10,S
2018-04-23 14:46:08,13550.0,20,31526,-12,13545.0,7,13555.0,28,B
2018-04-23 14:46:10,13545.0,10,31536,10,13540.0,27,13550.0,23,S
2018-04-23 14:46:12,13545.0,2,31538,0,13540.0,31,13550.0,43,S
2018-04-23 14:46:14,13550.0,20,31558,10,13540.0,31,13550.0,33,B
2018-04-23 14:46:19,13545.0,4,31562,-2,13540.0,31,13550.0,33,S
2018-04-23 14:46:21,13550.0,20,31582,14,13540.0,36,13550.0,25,B
2018-04-23 14:46:25,13550.0,2,31584,-2,13540.0,36,13550.0,24,B
2018-04-23 14:46:29,13550.0,2,31586,0,13540.0,38,13550.0,25,B
2018-04-23 14:46:30,13550.0,2,31588,0,13540.0,39,13550.0,24,B
2018-04-23 14:46:31,13545.0,2,31590,-2,13540.0,46,13550.0,29,S
2018-04-23 14:46:35,13545.0,20,31610,20,13540.0,51,13545.0,10,S
2018-04-23 14:46:36,13545.0,10,31620,10,13540.0,51,13545.0,5,S
2018-04-23 14:46:37,13545.0,4,31624,4,13540.0,49,13545.0,3,S
2018-04-23 14:46:48,13545.0,2,31626,2,13540.0,41,13545.0,8,S
2018-04-23 14:46:55,13545.0,2,31628,2,13540.0,43,13545.0,3,S
2018-04-23 14:47:00,13540.0,40,31668,30,13540.0,24,13545.0,3,S
2018-04-23 14:47:03,13540.0,4,31672,0,13540.0,23,13545.0,3,S
2018-04-23 14:47:05,13545.0,2,31674,0,13540.0,22,13545.0,4,B
2018-04-23 14:47:10,13540.0,4,31678,0,13540.0,19,13545.0,2,S
2018-04-23 14:47:13,13540.0,50,31728,42,13540.0,2,13550.0,11,S
2018-04-23 14:47:14,13540.0,10,31738,0,13535.0,17,13540.0,45,S
2018-04-23 14:47:14,13540.0,4,31742,-4,13535.0,23,13540.0,43,S
2018-04-23 14:47:21,13540.0,2,31744,-2,13535.0,20,13540.0,42,S
2018-04-23 14:47:23,13540.0,10,31754,0,13535.0,20,13540.0,37,S
2018-04-23 14:47:26,13535.0,40,31794,28,13535.0,2,13540.0,38,S
2018-04-23 14:47:26,13535.0,8,31802,0,13530.0,9,13535.0,2,S
2018-04-23 14:47:27,13535.0,10,31812,-4,13535.0,6,13540.0,41,S
2018-04-23 14:47:27,13535.0,12,31824,-8,13535.0,2,13540.0,42,S
2018-04-23 14:47:28,13535.0,2,31826,0,13535.0,1,13540.0,42,S
2018-04-23 14:47:28,13535.0,4,31830,4,13530.0,9,13535.0,1,S
2018-04-23 14:47:29,13535.0,2,31832,-2,13530.0,8,13535.0,2,S
2018-04-23 14:47:35,13535.0,2,31834,0,13530.0,8,13535.0,21,S
2018-04-23 14:47:36,13530.0,4,31838,2,13530.0,6,13535.0,21,S
2018-04-23 14:47:39,13530.0,2,31840,0,13530.0,5,13535.0,21,S
2018-04-23 14:47:40,13530.0,2,31842,0,13530.0,4,13535.0,21,S
2018-04-23 14:47:41,13530.0,2,31844,2,13530.0,3,13535.0,21,S
2018-04-23 14:47:42,13530.0,6,31850,-4,13525.0,6,13535.0,21,S
2018-04-23 14:47:43,13530.0,2,31852,-2,13525.0,10,13530.0,1,S
2018-04-23 14:47:43,13530.0,2,31854,-2,13525.0,11,13535.0,27,S
2018-04-23 14:47:45,13535.0,2,31856,0,13530.0,2,13535.0,26,B
2018-04-23 14:48:00,13530.0,2,31858,0,13525.0,15,13535.0,31,S
2018-04-23 14:48:04,13530.0,6,31864,6,13525.0,18,13530.0,17,S
2018-04-23 14:48:04,13530.0,2,31866,0,13525.0,17,13530.0,16,S
2018-04-23 14:48:05,13530.0,2,31868,0,13525.0,16,13530.0,15,S
2018-04-23 14:48:05,13530.0,2,31870,0,13525.0,15,13530.0,14,S
2018-04-23 14:48:06,13530.0,2,31872,0,13525.0,15,13530.0,13,S
2018-04-23 14:48:13,13530.0,2,31874,0,13525.0,13,13530.0,13,S
2018-04-23 14:48:15,13530.0,2,31876,2,13525.0,13,13530.0,12,S
2018-04-23 14:48:20,13525.0,28,31904,-8,13520.0,20,13525.0,23,S
2018-04-23 14:48:20,13525.0,46,31950,0,13525.0,5,13530.0,19,S
2018-04-23 14:48:23,13530.0,2,31952,2,13525.0,12,13530.0,23,B
2018-04-23 14:48:24,13530.0,10,31962,4,13525.0,22,13530.0,15,B
2018-04-23 14:48:25,13530.0,30,31992,22,13530.0,2,13535.0,29,B
2018-04-23 14:48:26,13530.0,4,31996,2,13525.0,19,13530.0,18,B
2018-04-23 14:48:27,13530.0,4,32000,2,13525.0,19,13530.0,16,B
2018-04-23 14:48:27,13530.0,2,32002,0,13525.0,18,13530.0,15,B
2018-04-23 14:48:28,13530.0,2,32004,0,13525.0,18,13530.0,14,B
2018-04-23 14:48:30,13525.0,40,32044,-4,13525.0,8,13530.0,4,S
2018-04-23 14:48:32,13525.0,2,32046,2,13525.0,8,13530.0,4,S
2018-04-23 14:48:34,13525.0,2,32048,2,13525.0,7,13530.0,4,S
2018-04-23 14:48:36,13530.0,2,32050,2,13525.0,8,13530.0,4,B
2018-04-23 14:48:39,13530.0,4,32054,2,13525.0,9,13530.0,2,B
2018-04-23 14:48:39,13530.0,2,32056,2,13525.0,9,13530.0,1,B
2018-04-23 14:48:44,13530.0,2,32058,0,13525.0,8,13530.0,21,B
2018-04-23 14:48:46,13530.0,20,32078,-2,13525.0,9,13530.0,11,B
2018-04-23 14:48:46,13530.0,20,32098,20,13525.0,9,13530.0,1,B
2018-04-23 14:48:47,13530.0,2,32100,0,13525.0,9,13535.0,28,B
2018-04-23 14:48:53,13535.0,2,32102,2,13530.0,12,13535.0,34,B
2018-04-23 14:48:55,13530.0,20,32122,0,13530.0,2,13535.0,34,S
2018-04-23 14:48:58,13530.0,10,32132,10,13525.0,13,13530.0,15,S
2018-04-23 14:48:59,13530.0,6,32138,6,13525.0,12,13530.0,12,S
2018-04-23 14:48:59,13530.0,2,32140,2,13525.0,12,13530.0,12,S
2018-04-23 14:49:12,13525.0,20,32160,-6,13525.0,6,13530.0,12,S
2018-04-23 14:49:16,13525.0,6,32166,6,13525.0,5,13530.0,27,S
2018-04-23 14:49:16,13525.0,6,32172,0,13525.0,2,13530.0,27,S
2018-04-23 14:49:17,13525.0,4,32176,-2,13520.0,22,13530.0,27,S
2018-04-23 14:49:18,13525.0,2,32178,0,13520.0,22,13525.0,1,S
2018-04-23 14:49:18,13525.0,2,32180,0,13520.0,22,13530.0,24,S
2018-04-23 14:49:22,13530.0,16,32196,14,13520.0,25,13530.0,20,B
2018-04-23 14:49:23,13525.0,2,32198,0,13520.0,25,13530.0,20,S
2018-04-23 14:49:25,13520.0,40,32238,14,13520.0,6,13530.0,20,S
2018-04-23 14:49:25,13520.0,2,32240,-2,13520.0,7,13525.0,1,S
2018-04-23 14:49:28,13525.0,2,32242,2,13520.0,7,13525.0,5,B
2018-04-23 14:49:29,13520.0,14,32256,-4,13515.0,10,13520.0,4,S
2018-04-23 14:49:30,13525.0,22,32278,10,13520.0,4,13525.0,1,B
2018-04-23 14:49:34,13520.0,4,32282,0,13520.0,5,13525.0,6,S
2018-04-23 14:49:35,13520.0,10,32292,8,13515.0,13,13520.0,15,S
2018-04-23 14:49:35,13520.0,26,32318,20,13515.0,14,13520.0,4,S
2018-04-23 14:49:36,13520.0,8,32326,2,13515.0,14,13520.0,1,S
2018-04-23 14:49:36,13520.0,2,32328,-2,13515.0,14,13525.0,8,S
2018-04-23 14:49:40,13520.0,2,32330,-2,13515.0,16,13520.0,1,S
2018-04-23 14:49:40,13520.0,2,32332,-2,13515.0,12,13520.0,12,S
2018-04-23 14:49:41,13520.0,2,32334,0,13515.0,10,13520.0,7,S
2018-04-23 14:49:42,13520.0,2,32336,2,13515.0,10,13520.0,7,S
2018-04-23 14:49:47,13520.0,20,32356,10,13515.0,8,13525.0,15,S
2018-04-23 14:49:49,13515.0,22,32378,-14,13510.0,11,13515.0,49,S
2018-04-23 14:49:49,13515.0,24,32402,-6,13510.0,12,13515.0,39,S
2018-04-23 14:49:53,13510.0,34,32436,16,13505.0,6,13510.0,3,S
2018-04-23 14:49:53,13510.0,10,32446,4,13510.0,8,13515.0,41,S
2018-04-23 14:49:54,13515.0,2,32448,0,13510.0,9,13515.0,43,B
2018-04-23 14:49:55,13515.0,20,32468,-20,13510.0,6,13515.0,33,B
2018-04-23 14:50:00,13510.0,12,32480,4,13505.0,8,13510.0,15,S
2018-04-23 14:50:00,13510.0,16,32496,10,13505.0,9,13510.0,7,S
2018-04-23 14:50:01,13510.0,2,32498,0,13505.0,10,13510.0,8,S
2018-04-23 14:50:01,13510.0,4,32502,2,13505.0,10,13510.0,6,S
2018-04-23 14:50:02,13505.0,4,32506,2,13505.0,5,13510.0,15,S
2018-04-23 14:50:02,13505.0,2,32508,-2,13505.0,7,13510.0,16,S
2018-04-23 14:50:03,13505.0,6,32514,-2,13505.0,5,13510.0,17,S
2018-04-23 14:50:04,13510.0,4,32518,0,13505.0,5,13510.0,16,B
2018-04-23 14:50:07,13510.0,2,32520,0,13505.0,10,13510.0,5,B
2018-04-23 14:50:08,13510.0,6,32526,2,13505.0,10,13510.0,2,B
2018-04-23 14:50:09,13505.0,14,32540,-8,13505.0,3,13510.0,2,S
2018-04-23 14:50:11,13510.0,4,32544,4,13510.0,1,13515.0,7,B
2018-04-23 14:50:12,13510.0,6,32550,2,13505.0,6,13510.0,27,B
2018-04-23 14:50:13,13510.0,2,32552,0,13505.0,6,13510.0,29,B
2018-04-23 14:50:17,13510.0,4,32556,0,13505.0,15,13510.0,28,B
2018-04-23 14:50:20,13505.0,30,32586,12,13500.0,35,13505.0,6,S
2018-04-23 14:50:21,13505.0,10,32596,2,13500.0,37,13505.0,1,S
2018-04-23 14:50:21,13505.0,2,32598,0,13505.0,1,13510.0,33,S
2018-04-23 14:50:24,13505.0,2,32600,0,13500.0,41,13505.0,9,S
2018-04-23 14:50:25,13505.0,4,32604,-4,13500.0,41,13505.0,7,S
2018-04-23 14:50:25,13505.0,2,32606,-2,13500.0,40,13505.0,6,S
2018-04-23 14:50:26,13505.0,12,32618,0,13505.0,14,13510.0,35,S
2018-04-23 14:50:29,13505.0,28,32646,28,13500.0,40,13505.0,6,S
2018-04-23 14:50:32,13505.0,2,32648,2,13500.0,39,13505.0,13,S
2018-04-23 14:50:33,13505.0,14,32662,14,13500.0,38,13505.0,6,S
2018-04-23 14:50:34,13500.0,2,32664,0,13500.0,37,13505.0,6,S
2018-04-23 14:50:34,13500.0,32,32696,-12,13500.0,22,13505.0,6,S
2018-04-23 14:50:36,13505.0,12,32708,-12,13500.0,21,13510.0,33,B
2018-04-23 14:50:38,13505.0,20,32728,20,13500.0,29,13505.0,13,B
2018-04-23 14:50:39,13505.0,8,32736,0,13500.0,29,13505.0,9,B
2018-04-23 14:50:39,13505.0,2,32738,0,13500.0,29,13505.0,8,B
2018-04-23 14:50:42,13505.0,2,32740,0,13500.0,27,13505.0,7,B
2018-04-23 14:50:43,13500.0,2,32742,-2,13500.0,26,13505.0,10,S
2018-04-23 14:50:43,13505.0,2,32744,0,13500.0,26,13505.0,9,B
2018-04-23 14:50:46,13505.0,10,32754,8,13500.0,32,13505.0,4,B
2018-04-23 14:50:46,13505.0,8,32762,-4,13505.0,1,13510.0,36,B
2018-04-23 14:50:51,13510.0,2,32764,2,13505.0,7,13510.0,34,B
2018-04-23 14:50:54,13510.0,10,32774,10,13505.0,8,13510.0,29,B
2018-04-23 14:51:00,13510.0,20,32794,20,13505.0,9,13510.0,20,B
2018-04-23 14:51:01,13510.0,6,32800,6,13505.0,9,13510.0,17,B
2018-04-23 14:51:04,13510.0,2,32802,2,13505.0,61,13510.0,16,B
2018-04-23 14:51:05,13510.0,2,32804,2,13505.0,62,13510.0,12,B
2018-04-23 14:51:06,13510.0,20,32824,14,13505.0,62,13510.0,2,B
2018-04-23 14:51:06,13510.0,4,32828,2,13510.0,2,13515.0,9,B
2018-04-23 14:51:08,13515.0,6,32834,6,13510.0,6,13515.0,12,B
2018-04-23 14:51:09,13510.0,4,32838,0,13510.0,5,13515.0,11,S
2018-04-23 14:51:10,13510.0,10,32848,8,13505.0,67,13510.0,45,S
2018-04-23 14:51:13,13510.0,4,32852,0,13505.0,67,13510.0,43,S
2018-04-23 14:51:14,13510.0,4,32856,4,13505.0,65,13510.0,41,S
2018-04-23 14:51:18,13505.0,52,32908,2,13505.0,42,13510.0,40,S
2018-04-23 14:51:20,13510.0,2,32910,2,13505.0,45,13510.0,39,B
2018-04-23 14:51:25,13510.0,2,32912,2,13505.0,46,13510.0,40,B
2018-04-23 14:51:32,13510.0,14,32926,10,13505.0,47,13510.0,33,B
2018-04-23 14:51:38,13510.0,2,32928,2,13505.0,48,13510.0,34,B
2018-04-23 14:51:41,13510.0,60,32988,60,13505.0,48,13510.0,4,B
2018-04-23 14:51:41,13515.0,10,32998,-2,13510.0,1,13515.0,15,B
2018-04-23 14:51:42,13510.0,2,33000,-2,13505.0,51,13515.0,17,S
2018-04-23 14:51:49,13510.0,4,33004,0,13510.0,4,13515.0,1,S
2018-04-23 14:51:51,13515.0,2,33006,2,13510.0,14,13520.0,10,B
2018-04-23 14:51:56,13515.0,2,33008,2,13510.0,15,13515.0,49,B
2018-04-23 14:51:58,13515.0,2,33010,2,13510.0,15,13515.0,48,B
2018-04-23 14:52:09,13515.0,40,33050,40,13510.0,20,13515.0,28,B
2018-04-23 14:52:11,13515.0,56,33106,56,13515.0,2,13520.0,15,B
2018-04-23 14:52:14,13520.0,2,33108,2,13515.0,6,13520.0,15,B
2018-04-23 14:52:17,13520.0,2,33110,2,13515.0,6,13520.0,15,B
2018-04-23 14:52:17,13520.0,2,33112,0,13515.0,6,13520.0,14,B
2018-04-23 14:52:24,13520.0,2,33114,2,13515.0,19,13520.0,13,B
2018-04-23 14:52:28,13520.0,2,33116,2,13515.0,21,13520.0,62,B
2018-04-23 14:52:32,13515.0,8,33124,2,13515.0,47,13520.0,58,S
2018-04-23 14:52:32,13520.0,8,33132,-4,13515.0,46,13520.0,56,B
2018-04-23 14:52:39,13520.0,2,33134,0,13515.0,46,13520.0,54,B
2018-04-23 14:52:40,13520.0,20,33154,-2,13515.0,46,13520.0,44,B
2018-04-23 14:52:49,13520.0,2,33156,0,13515.0,48,13520.0,44,B
2018-04-23 14:52:49,13520.0,46,33202,42,13515.0,47,13520.0,22,B
2018-04-23 14:52:50,13520.0,2,33204,2,13515.0,47,13520.0,21,B
2018-04-23 14:52:51,13520.0,2,33206,2,13515.0,47,13520.0,21,B
2018-04-23 14:52:57,13520.0,40,33246,38,13515.0,48,13520.0,13,B
2018-04-23 14:52:58,13520.0,6,33252,0,13515.0,50,13525.0,22,B
2018-04-23 14:52:59,13520.0,2,33254,0,13515.0,53,13525.0,23,B
2018-04-23 14:53:04,13520.0,6,33260,-2,13515.0,46,13520.0,6,B
2018-04-23 14:53:04,13515.0,6,33266,-6,13515.0,43,13520.0,9,S
2018-04-23 14:53:05,13515.0,4,33270,-4,13515.0,41,13520.0,9,S
2018-04-23 14:53:05,13520.0,6,33276,0,13515.0,41,13520.0,6,B
2018-04-23 14:53:06,13520.0,6,33282,0,13515.0,41,13520.0,3,B
2018-04-23 14:53:08,13520.0,10,33292,4,13520.0,25,13525.0,23,B
2018-04-23 14:53:08,13520.0,2,33294,0,13520.0,24,13525.0,25,B
2018-04-23 14:53:09,13520.0,8,33302,8,13520.0,20,13525.0,22,B
2018-04-23 14:53:09,13520.0,2,33304,0,13520.0,19,13525.0,22,B
2018-04-23 14:53:10,13525.0,2,33306,2,13520.0,19,13525.0,21,B
2018-04-23 14:53:19,13525.0,26,33332,6,13520.0,20,13525.0,8,B
2018-04-23 14:53:20,13525.0,6,33338,-6,13520.0,20,13525.0,5,B
2018-04-23 14:53:21,13520.0,4,33342,0,13520.0,18,13525.0,6,S
2018-04-23 14:53:22,13525.0,12,33354,-8,13525.0,4,13530.0,12,B
2018-04-23 14:53:22,13525.0,8,33362,-4,13520.0,21,13530.0,12,B
2018-04-23 14:53:32,13525.0,2,33364,-2,13520.0,22,13530.0,15,B
2018-04-23 14:53:35,13520.0,26,33390,26,13520.0,12,13530.0,15,S
2018-04-23 14:53:35,13520.0,2,33392,0,13520.0,11,13530.0,15,S
2018-04-23 14:53:36,13530.0,2,33394,2,13520.0,23,13530.0,14,B
2018-04-23 14:53:40,13525.0,2,33396,-2,13525.0,11,13530.0,11,S
2018-04-23 14:53:41,13530.0,6,33402,4,13525.0,11,13530.0,8,B
2018-04-23 14:53:45,13525.0,4,33406,0,13520.0,23,13525.0,1,S
2018-04-23 14:53:48,13525.0,2,33408,0,13520.0,18,13525.0,3,S
2018-04-23 14:53:48,13525.0,2,33410,-2,13520.0,18,13525.0,2,S
2018-04-23 14:53:50,13525.0,10,33420,-10,13525.0,4,13530.0,13,S
2018-04-23 14:53:59,13530.0,2,33422,0,13525.0,4,13530.0,11,B
2018-04-23 14:54:00,13530.0,30,33452,16,13525.0,4,13530.0,1,B
2018-04-23 14:54:01,13520.0,28,33480,-8,13520.0,17,13535.0,20,S
2018-04-23 14:54:02,13530.0,14,33494,10,13520.0,23,13535.0,15,B
2018-04-23 14:54:03,13535.0,6,33500,4,13525.0,2,13535.0,18,B
2018-04-23 14:54:06,13530.0,2,33502,2,13525.0,3,13535.0,13,S
2018-04-23 14:54:14,13530.0,12,33514,-6,13530.0,18,13535.0,7,S
2018-04-23 14:54:15,13530.0,8,33522,2,13530.0,18,13535.0,11,S
2018-04-23 14:54:16,13535.0,2,33524,0,13535.0,11,13540.0,9,B
2018-04-23 14:54:17,13535.0,2,33526,0,13535.0,13,13540.0,17,B
2018-04-23 14:54:21,13535.0,2,33528,0,13535.0,12,13540.0,17,B
2018-04-23 14:54:26,13540.0,30,33558,4,13535.0,13,13540.0,3,B
2018-04-23 14:54:27,13540.0,6,33564,0,13535.0,16,13540.0,4,B
2018-04-23 14:54:28,13540.0,60,33624,10,13535.0,16,13540.0,1,B
2018-04-23 14:54:28,13540.0,4,33628,-2,13535.0,18,13545.0,13,B
2018-04-23 14:54:33,13540.0,2,33630,2,13540.0,12,13545.0,6,B
2018-04-23 14:54:34,13540.0,2,33632,0,13540.0,11,13545.0,6,B
2018-04-23 14:54:35,13545.0,2,33634,2,13540.0,11,13545.0,5,B
2018-04-23 14:54:36,13545.0,2,33636,2,13540.0,11,13545.0,4,B
2018-04-23 14:54:37,13545.0,2,33638,2,13540.0,11,13545.0,3,B
2018-04-23 14:54:40,13545.0,4,33642,4,13540.0,10,13545.0,3,B
2018-04-23 14:54:47,13545.0,6,33648,-6,13540.0,7,13545.0,3,B
2018-04-23 14:54:51,13545.0,2,33650,0,13540.0,7,13545.0,2,B
2018-04-23 14:54:51,13540.0,2,33652,0,13540.0,6,13545.0,2,S
2018-04-23 14:54:54,13540.0,4,33656,2,13540.0,4,13545.0,3,S
2018-04-23 14:54:55,13540.0,8,33664,6,13535.0,19,13540.0,1,S
2018-04-23 14:54:55,13540.0,2,33666,0,13540.0,1,13545.0,5,S
2018-04-23 14:54:56,13540.0,2,33668,-2,13535.0,24,13545.0,4,S
2018-04-23 14:55:00,13540.0,4,33672,0,13535.0,26,13545.0,10,S
2018-04-23 14:55:05,13540.0,2,33674,0,13535.0,25,13545.0,11,S
2018-04-23 14:55:08,13540.0,6,33680,0,13535.0,25,13540.0,7,S
2018-04-23 14:55:14,13540.0,2,33682,2,13535.0,16,13540.0,9,S
2018-04-23 14:55:17,13535.0,4,33686,4,13535.0,14,13540.0,8,S
2018-04-23 14:55:19,13535.0,2,33688,2,13535.0,10,13540.0,8,S
2018-04-23 14:55:22,13535.0,4,33692,4,13535.0,8,13540.0,8,S
2018-04-23 14:55:24,13535.0,2,33694,2,13535.0,7,13540.0,8,S
2018-04-23 14:55:28,13540.0,8,33702,0,13535.0,7,13540.0,4,B
2018-04-23 14:55:28,13535.0,10,33712,-2,13535.0,2,13540.0,4,S
2018-04-23 14:55:29,13535.0,2,33714,0,13535.0,2,13540.0,4,S
2018-04-23 14:55:32,13540.0,6,33720,-2,13535.0,3,13540.0,2,B
2018-04-23 14:55:41,13540.0,2,33722,0,13535.0,8,13540.0,2,B
2018-04-23 14:55:42,13535.0,2,33724,0,13535.0,7,13540.0,2,S
2018-04-23 14:55:44,13540.0,6,33730,2,13535.0,8,13540.0,1,B
2018-04-23 14:55:51,13535.0,2,33732,-2,13535.0,7,13540.0,1,S
2018-04-23 14:55:53,13540.0,2,33734,-2,13535.0,17,13545.0,13,B
2018-04-23 14:56:10,13540.0,4,33738,-2,13535.0,17,13545.0,12,B
2018-04-23 14:56:42,13535.0,16,33754,2,13530.0,21,13535.0,1,S
2018-04-23 14:56:43,13535.0,2,33756,0,13530.0,18,13535.0,1,S
2018-04-23 14:56:57,13535.0,2,33758,-2,13530.0,22,13535.0,5,S
2018-04-23 14:57:01,13535.0,2,33760,-2,13530.0,21,13535.0,4,S
2018-04-23 14:57:02,13535.0,2,33762,-2,13530.0,21,13535.0,3,S
2018-04-23 14:57:04,13535.0,2,33764,0,13530.0,25,13535.0,2,S
2018-04-23 14:57:10,13535.0,2,33766,0,13530.0,25,13535.0,1,S
2018-04-23 14:57:10,13530.0,2,33768,-2,13530.0,24,13535.0,1,S
2018-04-23 14:57:24,13530.0,8,33776,-8,13530.0,19,13535.0,4,S
2018-04-23 14:57:28,13530.0,4,33780,-4,13530.0,20,13535.0,5,S
2018-04-23 14:57:29,13530.0,4,33784,4,13530.0,18,13535.0,1,S
2018-04-23 14:57:31,13535.0,2,33786,2,13530.0,18,13535.0,5,B
2018-04-23 14:57:36,13535.0,2,33788,-2,13530.0,18,13540.0,23,B
2018-04-23 14:57:40,13530.0,4,33792,0,13530.0,12,13535.0,7,S
2018-04-23 14:57:42,13530.0,4,33796,0,13530.0,9,13535.0,8,S
2018-04-23 14:57:44,13535.0,2,33798,-2,13530.0,9,13535.0,7,B
2018-04-23 14:57:46,13530.0,8,33806,-6,13530.0,9,13535.0,1,S
2018-04-23 14:57:49,13535.0,2,33808,0,13535.0,1,13540.0,23,B
2018-04-23 14:57:49,13535.0,2,33810,0,13530.0,13,13540.0,26,B
2018-04-23 14:57:56,13540.0,10,33820,2,13530.0,14,13540.0,21,B
2018-04-23 14:58:00,13525.0,46,33866,-24,13530.0,1,13540.0,21,S
2018-04-23 14:58:02,13535.0,10,33876,2,13525.0,4,13540.0,18,B
2018-04-23 14:58:03,13530.0,2,33878,-2,13525.0,5,13535.0,8,S
2018-04-23 14:58:05,13535.0,10,33888,10,13525.0,5,13535.0,3,B
2018-04-23 14:58:07,13525.0,2,33890,0,13525.0,5,13535.0,3,S
2018-04-23 14:58:08,13535.0,10,33900,0,13525.0,5,13535.0,2,B
2018-04-23 14:58:37,13535.0,2,33902,-2,13530.0,17,13540.0,17,B
2018-04-23 14:58:49,13535.0,2,33904,2,13530.0,12,13535.0,2,B
2018-04-23 14:58:49,13535.0,4,33908,0,13535.0,3,13540.0,19,B
2018-04-23 14:58:50,13535.0,6,33914,-6,13530.0,12,13535.0,5,B
2018-04-23 14:58:52,13530.0,2,33916,2,13530.0,11,13535.0,6,S
2018-04-23 14:59:00,13535.0,6,33922,-6,13530.0,12,13535.0,3,B
2018-04-23 14:59:01,13530.0,12,33934,-6,13530.0,9,13535.0,1,S
2018-04-23 14:59:01,13535.0,20,33954,-20,13535.0,10,13540.0,16,B
2018-04-23 14:59:02,13540.0,8,33962,0,13535.0,12,13540.0,15,B
2018-04-23 14:59:07,13540.0,20,33982,-20,13535.0,3,13540.0,5,B
2018-04-23 14:59:07,13540.0,4,33986,-2,13535.0,3,13540.0,3,B
2018-04-23 14:59:11,13545.0,6,33992,4,13540.0,1,13545.0,1,B
2018-04-23 14:59:12,13535.0,20,34012,2,13540.0,1,13545.0,4,S
2018-04-23 14:59:12,13540.0,2,34014,-2,13540.0,1,13545.0,4,B
2018-04-23 14:59:13,13540.0,2,34016,-2,13535.0,1,13545.0,4,B
2018-04-23 14:59:14,13545.0,4,34020,-4,13535.0,1,13545.0,3,B
2018-04-23 14:59:16,13545.0,8,34028,0,13545.0,6,13550.0,5,B
2018-04-23 14:59:17,13530.0,20,34048,0,13525.0,5,13550.0,6,S
2018-04-23 14:59:25,13535.0,2,34050,0,13535.0,1,13545.0,2,B
2018-04-23 14:59:30,13540.0,6,34056,-4,13535.0,2,13545.0,2,B
2018-04-23 14:59:30,13535.0,2,34058,2,13530.0,4,13535.0,9,S
2018-04-23 14:59:31,13535.0,16,34074,-4,13530.0,1,13535.0,5,S
2018-04-23 14:59:31,13530.0,2,34076,0,13525.0,5,13535.0,5,S
2018-04-23 14:59:32,13535.0,2,34078,0,13525.0,5,13535.0,4,B
2018-04-23 14:59:33,13535.0,2,34080,2,13525.0,5,13535.0,3,B
2018-04-23 14:59:33,13535.0,4,34084,4,13525.0,5,13535.0,1,B
2018-04-23 14:59:37,13535.0,2,34086,0,13535.0,9,13545.0,2,B
2018-04-23 14:59:37,13535.0,4,34090,-4,13535.0,7,13545.0,4,B
2018-04-23 14:59:41,13535.0,8,34098,-8,13535.0,3,13545.0,4,B
2018-04-23 14:59:41,13545.0,2,34100,2,13535.0,3,13545.0,3,B
2018-04-23 14:59:46,13540.0,2,34102,-2,13535.0,6,13545.0,3,S
2018-04-23 14:59:51,13540.0,2,34104,-2,13535.0,6,13545.0,3,S
2018-04-23 14:59:53,13535.0,6,34110,-6,13535.0,3,13540.0,1,S
2018-04-23 14:59:56,13535.0,6,34116,0,13535.0,1,13540.0,1,S
2018-04-23 14:59:56,13535.0,2,34118,0,13530.0,2,13540.0,3,S
2018-04-23 20:59:00,13435.0,38,38,79808,0.0,0,0.0,0,B
2018-04-23 21:00:00,13450.0,12,50,0,13435.0,4,13475.0,3,B
2018-04-23 21:00:01,13405.0,40,90,-10,13400.0,6,13430.0,1,S
2018-04-23 21:00:01,13395.0,22,112,6,13405.0,3,13425.0,3,S
2018-04-23 21:00:02,13420.0,12,124,2,13405.0,3,13420.0,4,B
2018-04-23 21:00:02,13420.0,24,148,-2,13380.0,2,13420.0,4,B
2018-04-23 21:00:03,13380.0,4,152,4,13370.0,5,13395.0,1,S
2018-04-23 21:00:04,13380.0,12,164,0,13360.0,5,13385.0,4,S
2018-04-23 21:00:05,13380.0,2,166,0,13350.0,6,13365.0,8,S
2018-04-23 21:00:05,13365.0,18,184,14,13350.0,5,13370.0,2,S
2018-04-23 21:00:06,13370.0,2,186,0,13355.0,7,13370.0,6,B
2018-04-23 21:00:07,13370.0,4,190,-4,13370.0,17,13385.0,2,B
2018-04-23 21:00:08,13370.0,8,198,-2,13370.0,25,13395.0,3,B
2018-04-23 21:00:08,13370.0,6,204,-6,13375.0,5,13390.0,1,B
2018-04-23 21:00:09,13390.0,2,206,2,13375.0,6,13390.0,2,B
2018-04-23 21:00:09,13390.0,2,208,0,13375.0,5,13390.0,1,B
2018-04-23 21:00:10,13385.0,12,220,-2,13370.0,22,13375.0,1,S
2018-04-23 21:00:11,13370.0,20,240,-8,13370.0,12,13375.0,6,S
2018-04-23 21:00:11,13375.0,30,270,-10,13365.0,1,13375.0,3,B
2018-04-23 21:00:12,13365.0,12,282,-10,13360.0,35,13370.0,1,S
2018-04-23 21:00:12,13385.0,18,300,0,13375.0,1,13385.0,1,B
2018-04-23 21:00:13,13375.0,2,302,0,13370.0,1,13375.0,6,S
2018-04-23 21:00:13,13370.0,10,312,-10,13365.0,6,13375.0,3,S
2018-04-23 21:00:14,13385.0,8,320,0,13375.0,4,13390.0,1,B
2018-04-23 21:00:16,13375.0,2,322,0,13375.0,8,13380.0,1,S
2018-04-23 21:00:16,13380.0,2,324,0,13380.0,1,13385.0,6,B
2018-04-23 21:00:17,13380.0,2,326,0,13375.0,8,13380.0,2,B
2018-04-23 21:00:17,13385.0,8,334,-2,13375.0,8,13385.0,7,B
2018-04-23 21:00:18,13385.0,2,336,-2,13375.0,8,13385.0,6,B
2018-04-23 21:00:19,13380.0,2,338,2,13375.0,8,13380.0,5,S
2018-04-23 21:00:20,13380.0,10,348,10,13375.0,8,13390.0,1,S
2018-04-23 21:00:21,13390.0,2,350,0,13385.0,1,13395.0,1,B
2018-04-23 21:00:22,13395.0,2,352,2,13390.0,1,13395.0,7,B
2018-04-23 21:00:23,13390.0,2,354,-2,13385.0,3,13395.0,6,S
2018-04-23 21:00:24,13395.0,2,356,0,13385.0,5,13405.0,3,B
2018-04-23 21:00:27,13395.0,4,360,0,13385.0,4,13395.0,1,B
2018-04-23 21:00:28,13385.0,4,364,-2,13385.0,2,13395.0,4,S
2018-04-23 21:00:29,13390.0,2,366,0,13385.0,7,13395.0,3,B
2018-04-23 21:00:30,13395.0,2,368,-2,13385.0,7,13395.0,2,B
2018-04-23 21:00:31,13395.0,2,370,2,13385.0,7,13395.0,1,B
2018-04-23 21:00:31,13385.0,2,372,2,13385.0,7,13395.0,1,S
2018-04-23 21:00:34,13395.0,4,376,0,13390.0,1,13395.0,6,B
2018-04-23 21:00:35,13395.0,6,382,-6,13395.0,14,13400.0,2,B
2018-04-23 21:00:35,13395.0,2,384,-2,13395.0,13,13400.0,4,B
2018-04-23 21:00:36,13395.0,8,392,0,13395.0,9,13400.0,4,B
2018-04-23 21:00:36,13395.0,2,394,0,13395.0,9,13400.0,4,B
2018-04-23 21:00:39,13395.0,18,412,2,13390.0,1,13400.0,4,B
2018-04-23 21:00:41,13390.0,2,414,-2,13385.0,18,13390.0,3,S
2018-04-23 21:00:42,13390.0,6,420,0,13390.0,3,13395.0,2,S
2018-04-23 21:00:43,13395.0,2,422,0,13385.0,22,13400.0,11,B
2018-04-23 21:00:45,13395.0,2,424,0,13390.0,5,13395.0,2,B
2018-04-23 21:00:48,13390.0,8,432,0,13390.0,3,13395.0,3,S
2018-04-23 21:00:48,13390.0,6,438,2,13385.0,18,13400.0,8,S
2018-04-23 21:00:49,13395.0,2,440,2,13385.0,17,13395.0,3,B
2018-04-23 21:00:53,13390.0,2,442,0,13385.0,17,13390.0,2,S
2018-04-23 21:00:53,13390.0,2,444,2,13385.0,17,13390.0,1,S
2018-04-23 21:00:54,13390.0,2,446,2,13390.0,4,13395.0,5,S
2018-04-23 21:00:55,13390.0,2,448,2,13385.0,17,13390.0,4,S
2018-04-23 21:00:55,13390.0,2,450,2,13385.0,17,13395.0,7,S
2018-04-23 21:00:56,13385.0,4,454,0,13385.0,15,13395.0,10,S
2018-04-23 21:00:56,13385.0,14,468,-12,13385.0,8,13390.0,8,S
2018-04-23 21:00:57,13385.0,16,484,-10,13380.0,5,13390.0,9,S
2018-04-23 21:00:58,13385.0,2,486,0,13380.0,5,13390.0,6,S
2018-04-23 21:00:58,13390.0,2,488,2,13380.0,5,13390.0,5,B
2018-04-23 21:00:59,13390.0,2,490,2,13380.0,5,13390.0,1,B
2018-04-23 21:01:01,13390.0,2,492,2,13380.0,7,13390.0,15,B
2018-04-23 21:01:02,13380.0,18,510,6,13375.0,6,13390.0,14,S
2018-04-23 21:01:03,13375.0,12,522,4,13370.0,4,13380.0,6,S
2018-04-23 21:01:03,13370.0,8,530,-4,13370.0,1,13375.0,8,S
2018-04-23 21:01:04,13370.0,2,532,0,13365.0,2,13370.0,1,S
2018-04-23 21:01:04,13365.0,4,536,2,13360.0,36,13365.0,4,S
2018-04-23 21:01:05,13360.0,44,580,42,13360.0,14,13365.0,11,S
2018-04-23 21:01:06,13350.0,78,658,4,13350.0,6,13355.0,7,S
2018-04-23 21:01:06,13330.0,86,744,58,13325.0,1,13345.0,7,S
2018-04-23 21:01:07,13310.0,64,808,22,13305.0,1,13330.0,3,S
2018-04-23 21:01:07,13285.0,30,838,20,13280.0,3,13305.0,4,S
2018-04-23 21:01:08,13270.0,52,890,-12,13270.0,4,13280.0,5,S
2018-04-23 21:01:08,13300.0,76,966,-66,13290.0,4,13300.0,13,B
2018-04-23 21:01:09,13300.0,44,1010,-16,13300.0,31,13325.0,15,B
2018-04-23 21:01:09,13325.0,16,1026,0,13310.0,3,13325.0,3,B
2018-04-23 21:01:10,13315.0,6,1032,2,13325.0,1,13340.0,16,S
2018-04-23 21:01:10,13325.0,6,1038,-2,13325.0,4,13330.0,7,B
2018-04-23 21:01:11,13305.0,28,1066,-14,13305.0,5,13320.0,7,S
2018-04-23 21:01:11,13315.0,6,1072,6,13305.0,8,13320.0,12,B
2018-04-23 21:01:12,13305.0,10,1082,-4,13300.0,5,13305.0,22,S
2018-04-23 21:01:12,13300.0,12,1094,-8,13290.0,7,13305.0,24,S
2018-04-23 21:01:13,13305.0,2,1096,0,13300.0,4,13305.0,23,B
2018-04-23 21:01:13,13305.0,46,1142,-6,13300.0,5,13305.0,17,B
2018-04-23 21:01:14,13305.0,34,1176,-4,13305.0,11,13315.0,3,B
2018-04-23 21:01:14,13305.0,2,1178,0,13305.0,3,13315.0,10,B
2018-04-23 21:01:15,13305.0,6,1184,0,13300.0,8,13315.0,17,B
2018-04-23 21:01:15,13315.0,12,1196,-2,13300.0,5,13315.0,16,B
2018-04-23 21:01:16,13305.0,6,1202,0,13295.0,2,13305.0,1,S
2018-04-23 21:01:16,13315.0,12,1214,-6,13305.0,23,13315.0,3,B
2018-04-23 21:01:17,13305.0,14,1228,0,13305.0,16,13315.0,9,S
2018-04-23 21:01:18,13305.0,32,1260,-26,13295.0,8,13305.0,8,S
2018-04-23 21:01:19,13300.0,34,1294,-24,13295.0,5,13300.0,7,S
2018-04-23 21:01:19,13295.0,10,1304,6,13280.0,51,13295.0,4,S
2018-04-23 21:01:20,13295.0,6,1310,0,13280.0,56,13295.0,4,S
2018-04-23 21:01:20,13295.0,8,1318,-4,13295.0,3,13300.0,7,S
2018-04-23 21:01:21,13300.0,14,1332,-14,13300.0,73,13315.0,7,B
2018-04-23 21:01:21,13300.0,2,1334,-2,13300.0,73,13305.0,2,B
2018-04-23 21:01:22,13300.0,8,1342,-4,13300.0,70,13305.0,2,B
2018-04-23 21:01:22,13300.0,56,1398,-56,13300.0,42,13305.0,2,B
2018-04-23 21:01:23,13300.0,4,1402,-2,13300.0,40,13305.0,5,B
2018-04-23 21:01:23,13305.0,6,1408,0,13305.0,1,13310.0,2,B
2018-04-23 21:01:24,13310.0,4,1412,0,13305.0,10,13310.0,2,B
2018-04-23 21:01:24,13310.0,8,1420,-6,13305.0,10,13310.0,2,B
2018-04-23 21:01:25,13310.0,4,1424,0,13305.0,10,13315.0,7,B
2018-04-23 21:01:26,13315.0,2,1426,2,13305.0,5,13315.0,9,B
2018-04-23 21:01:27,13310.0,8,1434,2,13305.0,5,13310.0,3,S
2018-04-23 21:01:27,13310.0,6,1440,-4,13305.0,5,13315.0,6,S
2018-04-23 21:01:28,13320.0,10,1450,-10,13310.0,6,13320.0,2,B
2018-04-23 21:01:30,13320.0,2,1452,-2,13310.0,22,13325.0,1,B
2018-04-23 21:01:33,13340.0,4,1456,4,13335.0,1,13345.0,7,B
2018-04-23 21:01:33,13340.0,4,1460,-4,13325.0,19,13335.0,4,B
2018-04-23 21:01:34,13340.0,10,1470,2,13325.0,8,13335.0,11,B
2018-04-23 21:01:34,13325.0,14,1484,2,13315.0,6,13335.0,13,S
2018-04-23 21:01:36,13320.0,10,1494,-4,13315.0,10,13335.0,8,S
2018-04-23 21:01:37,13335.0,2,1496,0,13330.0,3,13335.0,5,B
2018-04-23 21:01:38,13330.0,2,1498,-2,13330.0,9,13335.0,5,S
2018-04-23 21:01:39,13335.0,18,1516,-10,13320.0,4,13335.0,6,B
2018-04-23 21:01:40,13320.0,6,1522,0,13320.0,16,13335.0,7,S
2018-04-23 21:01:40,13335.0,2,1524,0,13320.0,16,13335.0,6,B
2018-04-23 21:01:44,13335.0,2,1526,-2,13320.0,16,13335.0,4,B
2018-04-23 21:01:45,13320.0,2,1528,-2,13320.0,15,13335.0,6,S
2018-04-23 21:01:46,13320.0,8,1536,-8,13320.0,18,13335.0,1,S
2018-04-23 21:01:46,13320.0,2,1538,0,13325.0,9,13335.0,1,S
2018-04-23 21:01:48,13335.0,2,1540,-2,13335.0,2,13340.0,2,B
2018-04-23 21:01:49,13335.0,4,1544,0,13335.0,5,13340.0,5,B
2018-04-23 21:01:50,13335.0,10,1554,0,13335.0,1,13340.0,6,B
2018-04-23 21:01:51,13335.0,2,1556,-2,13330.0,10,13340.0,5,B
2018-04-23 21:01:51,13340.0,8,1564,0,13340.0,2,13345.0,2,B
2018-04-23 21:01:53,13345.0,16,1580,0,13345.0,6,13350.0,2,B
2018-04-23 21:01:54,13345.0,12,1592,-2,13340.0,7,13345.0,1,B
2018-04-23 21:01:55,13345.0,2,1594,-2,13340.0,7,13350.0,5,B
2018-04-23 21:01:56,13345.0,8,1602,2,13345.0,1,13350.0,6,B
2018-04-23 21:01:56,13345.0,2,1604,0,13335.0,6,13345.0,6,B
2018-04-23 21:01:57,13335.0,10,1614,-10,13335.0,9,13345.0,5,S
2018-04-23 21:01:57,13345.0,26,1640,-26,13345.0,9,13350.0,3,B
2018-04-23 21:01:58,13350.0,6,1646,4,13345.0,13,13360.0,12,B
2018-04-23 21:01:59,13350.0,2,1648,0,13345.0,9,13350.0,1,B
2018-04-23 21:02:00,13350.0,2,1650,-2,13345.0,9,13350.0,1,B
2018-04-23 21:02:00,13350.0,2,1652,0,13345.0,13,13350.0,6,B
2018-04-23 21:02:01,13350.0,2,1654,0,13345.0,11,13350.0,5,B
2018-04-23 21:02:01,13345.0,10,1664,-8,13345.0,5,13350.0,5,S
2018-04-23 21:02:02,13345.0,10,1674,-4,13340.0,1,13345.0,17,S
2018-04-23 21:02:02,13340.0,2,1676,0,13335.0,9,13345.0,19,S
2018-04-23 21:02:03,13345.0,6,1682,-4,13340.0,10,13345.0,15,B
2018-04-23 21:02:03,13345.0,30,1712,-2,13345.0,1,13350.0,5,B
2018-04-23 21:02:04,13350.0,10,1722,-10,13345.0,4,13350.0,2,B
2018-04-23 21:02:04,13350.0,20,1742,-16,13345.0,14,13355.0,1,B
2018-04-23 21:02:06,13345.0,6,1748,-2,13345.0,14,13355.0,3,S
2018-04-23 21:02:06,13355.0,12,1760,6,13350.0,9,13360.0,1,B
2018-04-23 21:02:07,13360.0,2,1762,-2,13355.0,19,13385.0,1,B
2018-04-23 21:02:08,13360.0,30,1792,-12,13360.0,1,13370.0,4,B
2018-04-23 21:02:08,13355.0,4,1796,-2,13355.0,8,13360.0,3,S
2018-04-23 21:02:09,13360.0,2,1798,0,13355.0,8,13360.0,3,B
2018-04-23 21:02:09,13360.0,10,1808,-4,13360.0,10,13370.0,17,B
2018-04-23 21:02:10,13360.0,16,1824,-16,13360.0,7,13365.0,5,B
2018-04-23 21:02:11,13370.0,10,1834,-8,13360.0,7,13370.0,3,B
2018-04-23 21:02:12,13370.0,8,1842,-4,13360.0,13,13370.0,10,B
2018-04-23 21:02:13,13360.0,20,1862,12,13360.0,3,13370.0,11,S
2018-04-23 21:02:14,13370.0,2,1864,0,13365.0,3,13370.0,10,B
2018-04-23 21:02:14,13370.0,4,1868,-2,13365.0,2,13370.0,9,B
2018-04-23 21:02:15,13370.0,10,1878,-4,13365.0,4,13370.0,6,B
2018-04-23 21:02:16,13370.0,2,1880,0,13365.0,4,13370.0,5,B
2018-04-23 21:02:17,13365.0,8,1888,-6,13365.0,3,13370.0,2,S
2018-04-23 21:02:18,13370.0,4,1892,-2,13365.0,8,13380.0,3,B
2018-04-23 21:02:19,13370.0,2,1894,2,13365.0,8,13380.0,11,B
2018-04-23 21:02:20,13370.0,4,1898,2,13370.0,7,13385.0,2,B
2018-04-23 21:02:20,13385.0,4,1902,2,13370.0,6,13385.0,14,B
2018-04-23 21:02:21,13370.0,2,1904,-2,13370.0,9,13385.0,16,S
2018-04-23 21:02:22,13375.0,4,1908,0,13375.0,1,13385.0,15,B
2018-04-23 21:02:23,13370.0,10,1918,2,13375.0,3,13385.0,11,S
2018-04-23 21:02:24,13385.0,10,1928,2,13375.0,3,13385.0,6,B
2018-04-23 21:02:24,13375.0,18,1946,4,13370.0,6,13375.0,14,S
2018-04-23 21:02:25,13375.0,2,1948,0,13370.0,5,13375.0,14,S
2018-04-23 21:02:26,13370.0,8,1956,-8,13365.0,5,13370.0,5,S
2018-04-23 21:02:26,13370.0,10,1966,-10,13365.0,4,13375.0,15,S
2018-04-23 21:02:28,13365.0,8,1974,6,13360.0,5,13365.0,5,S
2018-04-23 21:02:29,13360.0,20,1994,-12,13355.0,10,13360.0,3,S
2018-04-23 21:02:29,13365.0,12,2006,8,13360.0,21,13365.0,10,B
2018-04-23 21:02:30,13365.0,8,2014,2,13360.0,1,13365.0,6,B
2018-04-23 21:02:31,13360.0,2,2016,-2,13355.0,11,13360.0,3,S
2018-04-23 21:02:31,13360.0,6,2022,-6,13355.0,11,13365.0,10,S
2018-04-23 21:02:33,13360.0,40,2062,-40,13355.0,10,13360.0,37,S
2018-04-23 21:02:33,13360.0,28,2090,0,13355.0,11,13360.0,23,S
2018-04-23 21:02:34,13360.0,48,2138,-42,13355.0,11,13360.0,9,S
2018-04-23 21:02:34,13360.0,18,2156,18,13360.0,8,13365.0,10,S
2018-04-23 21:02:35,13360.0,10,2166,6,13355.0,12,13360.0,8,S
2018-04-23 21:02:35,13360.0,8,2174,6,13355.0,14,13360.0,4,S
2018-04-23 21:02:36,13360.0,8,2182,2,13360.0,7,13365.0,7,S
2018-04-23 21:02:36,13365.0,10,2192,-4,13360.0,3,13365.0,6,B
2018-04-23 21:02:38,13360.0,8,2200,-6,13355.0,12,13365.0,7,S
2018-04-23 21:02:38,13365.0,2,2202,-2,13355.0,11,13365.0,8,B
2018-04-23 21:02:41,13365.0,4,2206,-4,13355.0,11,13360.0,4,B
2018-04-23 21:02:42,13355.0,22,2228,-6,13350.0,6,13360.0,6,S
2018-04-23 21:02:44,13350.0,4,2232,-2,13350.0,5,13360.0,13,S
2018-04-23 21:02:47,13350.0,10,2242,-6,13350.0,1,13360.0,13,S
2018-04-23 21:02:48,13350.0,2,2244,0,13355.0,4,13360.0,6,S
2018-04-23 21:02:48,13350.0,10,2254,-8,13340.0,19,13355.0,23,S
2018-04-23 21:02:50,13355.0,2,2256,-2,13350.0,1,13360.0,13,B
2018-04-23 21:02:50,13350.0,2,2258,2,13345.0,1,13360.0,4,S
2018-04-23 21:02:54,13350.0,4,2262,0,13350.0,1,13355.0,1,S
2018-04-23 21:02:56,13350.0,4,2266,-2,13350.0,1,13360.0,9,S
2018-04-23 21:03:00,13360.0,4,2270,0,13350.0,4,13360.0,2,B
2018-04-23 21:03:04,13360.0,6,2276,2,13350.0,3,13360.0,10,B
2018-04-23 21:03:05,13360.0,22,2298,-8,13350.0,1,13365.0,8,B
2018-04-23 21:03:07,13350.0,8,2306,-6,13345.0,3,13350.0,5,S
2018-04-23 21:03:08,13350.0,10,2316,-2,13350.0,5,13355.0,4,S
2018-04-23 21:03:10,13350.0,12,2328,-4,13345.0,5,13350.0,4,S
2018-04-23 21:03:10,13350.0,2,2330,2,13345.0,5,13350.0,4,S
2018-04-23 21:03:13,13350.0,2,2332,0,13345.0,6,13350.0,2,S
2018-04-23 21:03:13,13350.0,16,2348,8,13340.0,6,13350.0,1,S
2018-04-23 21:03:15,13350.0,2,2350,0,13350.0,1,13355.0,5,S
2018-04-23 21:03:15,13350.0,2,2352,-2,13350.0,1,13355.0,4,S
2018-04-23 21:03:16,13355.0,16,2368,-12,13355.0,1,13360.0,1,B
2018-04-23 21:03:16,13355.0,4,2372,2,13355.0,3,13365.0,6,B
2018-04-23 21:03:18,13360.0,2,2374,0,13360.0,3,13365.0,4,B
2018-04-23 21:03:20,13360.0,4,2378,0,13355.0,4,13365.0,5,B
2018-04-23 21:03:22,13365.0,2,2380,0,13360.0,26,13365.0,3,B
2018-04-23 21:03:23,13365.0,4,2384,0,13360.0,26,13365.0,2,B
2018-04-23 21:03:25,13360.0,2,2386,2,13360.0,25,13365.0,3,S
2018-04-23 21:03:25,13365.0,4,2390,2,13360.0,25,13365.0,1,B
2018-04-23 21:03:27,13365.0,2,2392,-2,13360.0,25,13370.0,10,B
2018-04-23 21:03:29,13370.0,8,2400,8,13365.0,8,13370.0,6,B
2018-04-23 21:03:29,13370.0,12,2412,6,13365.0,8,13375.0,3,B
2018-04-23 21:03:31,13375.0,4,2416,-2,13375.0,1,13380.0,3,B
2018-04-23 21:03:31,13375.0,8,2424,-4,13375.0,1,13380.0,9,B
2018-04-23 21:03:34,13385.0,12,2436,4,13375.0,3,13385.0,4,B
2018-04-23 21:03:35,13380.0,6,2442,2,13380.0,2,13385.0,3,S
2018-04-23 21:03:36,13385.0,6,2448,0,13380.0,3,13390.0,1,B
2018-04-23 21:03:37,13390.0,2,2450,2,13390.0,5,13395.0,4,B
2018-04-23 21:03:37,13395.0,16,2466,8,13380.0,5,13395.0,7,B
2018-04-23 21:03:38,13380.0,16,2482,10,13375.0,7,13380.0,14,S
2018-04-23 21:03:38,13380.0,28,2510,22,13380.0,4,13395.0,5,S
2018-04-23 21:03:39,13395.0,2,2512,-2,13385.0,1,13395.0,7,B
2018-04-23 21:03:40,13395.0,4,2516,-2,13385.0,1,13395.0,10,B
2018-04-23 21:03:40,13395.0,8,2524,-6,13385.0,1,13395.0,6,B
2018-04-23 21:03:41,13395.0,2,2526,2,13385.0,1,13395.0,5,B
2018-04-23 21:03:42,13390.0,10,2536,-2,13380.0,2,13390.0,1,S
2018-04-23 21:03:43,13380.0,2,2538,0,13380.0,1,13385.0,4,S
2018-04-23 21:03:43,13380.0,2,2540,0,13375.0,3,13380.0,1,S
2018-04-23 21:03:44,13380.0,2,2542,0,13380.0,2,13385.0,9,S
2018-04-23 21:03:45,13380.0,4,2546,0,13375.0,4,13380.0,5,S
2018-04-23 21:03:45,13385.0,10,2556,10,13375.0,4,13385.0,4,B
2018-04-23 21:03:47,13385.0,4,2560,4,13385.0,8,13390.0,11,B
2018-04-23 21:03:47,13385.0,16,2576,12,13375.0,2,13385.0,4,B
2018-04-23 21:03:48,13375.0,2,2578,0,13370.0,2,13385.0,1,S
2018-04-23 21:03:49,13385.0,6,2584,-4,13375.0,4,13385.0,1,B
2018-04-23 21:03:50,13375.0,2,2586,-2,13375.0,8,13385.0,6,S
2018-04-23 21:03:51,13375.0,2,2588,2,13370.0,6,13380.0,2,S
2018-04-23 21:03:55,13375.0,12,2600,-4,13370.0,8,13380.0,5,S
2018-04-23 21:03:57,13380.0,2,2602,0,13375.0,4,13385.0,8,B
2018-04-23 21:03:57,13375.0,2,2604,2,13380.0,1,13385.0,5,S
2018-04-23 21:04:00,13380.0,10,2614,4,13380.0,1,13385.0,1,B
2018-04-23 21:04:01,13385.0,12,2626,-4,13375.0,3,13385.0,9,B
2018-04-23 21:04:03,13380.0,2,2628,-2,13375.0,7,13380.0,1,S
2018-04-23 21:04:07,13390.0,24,2652,14,13385.0,1,13395.0,4,B
2018-04-23 21:04:08,13385.0,4,2656,-2,13380.0,6,13390.0,6,S
2018-04-23 21:04:11,13385.0,4,2660,-4,13380.0,10,13390.0,7,S
2018-04-23 21:04:15,13385.0,2,2662,2,13385.0,10,13390.0,12,S
2018-04-23 21:04:17,13385.0,2,2664,-2,13385.0,9,13390.0,12,S
2018-04-23 21:04:17,13385.0,18,2682,-6,13380.0,6,13385.0,4,S
2018-04-23 21:04:19,13385.0,4,2686,-2,13380.0,5,13385.0,1,S
2018-04-23 21:04:20,13380.0,2,2688,0,13380.0,4,13385.0,1,S
2018-04-23 21:04:21,13385.0,4,2692,4,13385.0,1,13390.0,12,B
2018-04-23 21:04:21,13385.0,2,2694,0,13380.0,4,13385.0,2,B
2018-04-23 21:04:25,13380.0,6,2700,2,13375.0,3,13380.0,2,S
2018-04-23 21:04:29,13380.0,2,2702,0,13375.0,5,13380.0,1,S
2018-04-23 21:04:29,13380.0,2,2704,-2,13380.0,8,13385.0,7,S
2018-04-23 21:04:30,13385.0,12,2716,6,13385.0,12,13390.0,12,B
2018-04-23 21:04:30,13385.0,2,2718,2,13385.0,11,13390.0,12,B
2018-04-23 21:04:31,13385.0,4,2722,4,13385.0,9,13390.0,10,B
2018-04-23 21:04:35,13385.0,14,2736,2,13385.0,2,13390.0,3,B
2018-04-23 21:04:35,13390.0,6,2742,2,13390.0,7,13395.0,5,B
2018-04-23 21:04:36,13390.0,2,2744,0,13390.0,6,13395.0,7,B
2018-04-23 21:04:36,13390.0,12,2756,12,13385.0,2,13390.0,1,B
2018-04-23 21:04:43,13390.0,10,2766,2,13390.0,5,13395.0,11,B
2018-04-23 21:04:44,13390.0,4,2770,2,13390.0,3,13395.0,12,B
2018-04-23 21:04:44,13390.0,6,2776,4,13385.0,2,13395.0,12,B
2018-04-23 21:04:53,13390.0,4,2780,2,13385.0,2,13390.0,1,B
2018-04-23 21:04:54,13390.0,4,2784,2,13390.0,19,13395.0,11,B
2018-04-23 21:04:57,13390.0,22,2806,12,13390.0,9,13395.0,12,B
2018-04-23 21:04:58,13395.0,2,2808,0,13390.0,9,13395.0,14,B
2018-04-23 21:05:03,13395.0,22,2830,-12,13390.0,30,13395.0,1,B
2018-04-23 21:05:03,13395.0,2,2832,0,13395.0,1,13400.0,8,B
2018-04-23 21:05:06,13395.0,10,2842,-2,13395.0,7,13400.0,3,B
2018-04-23 21:05:07,13400.0,6,2848,-4,13400.0,4,13405.0,5,B
2018-04-23 21:05:08,13405.0,22,2870,-14,13405.0,1,13410.0,1,B
2018-04-23 21:05:11,13405.0,2,2872,-2,13405.0,11,13410.0,1,B
2018-04-23 21:05:11,13410.0,2,2874,2,13405.0,11,13410.0,5,B
2018-04-23 21:05:13,13410.0,6,2880,-4,13405.0,11,13410.0,2,B
2018-04-23 21:05:13,13410.0,4,2884,-4,13410.0,8,13415.0,1,B
2018-04-23 21:05:15,13415.0,2,2886,-2,13410.0,7,13420.0,3,B
2018-04-23 21:05:17,13415.0,2,2888,2,13415.0,3,13420.0,9,B
2018-04-23 21:05:18,13415.0,2,2890,0,13410.0,8,13420.0,6,B
2018-04-23 21:05:19,13415.0,2,2892,0,13415.0,1,13420.0,16,B
2018-04-23 21:05:20,13415.0,4,2896,2,13410.0,10,13420.0,16,B
2018-04-23 21:05:20,13420.0,6,2902,-4,13410.0,9,13420.0,16,B
2018-04-23 21:05:21,13460.0,78,2980,-50,13410.0,12,13420.0,2,B
2018-04-23 21:05:21,13415.0,10,2990,-10,13410.0,12,13415.0,4,S
2018-04-23 21:05:22,13410.0,12,3002,-2,13410.0,3,13420.0,6,S
2018-04-23 21:05:22,13405.0,28,3030,0,13405.0,39,13410.0,18,S
2018-04-23 21:05:24,13410.0,12,3042,-10,13405.0,40,13410.0,6,B
2018-04-23 21:05:24,13410.0,4,3046,0,13405.0,43,13410.0,4,B
2018-04-23 21:05:25,13410.0,4,3050,0,13405.0,43,13410.0,2,B
2018-04-23 21:05:25,13410.0,4,3054,-4,13405.0,43,13415.0,4,B
2018-04-23 21:05:27,13410.0,8,3062,-8,13405.0,44,13415.0,7,B
2018-04-23 21:05:27,13405.0,2,3064,0,13405.0,43,13415.0,7,S
2018-04-23 21:05:29,13415.0,2,3066,2,13405.0,43,13415.0,7,B
2018-04-23 21:05:30,13410.0,2,3068,2,13410.0,11,13415.0,4,S
2018-04-23 21:05:32,13410.0,2,3070,0,13410.0,2,13415.0,4,S
2018-04-23 21:05:33,13415.0,4,3074,-2,13410.0,1,13415.0,3,B
2018-04-23 21:05:34,13415.0,6,3080,6,13410.0,8,13420.0,7,B
2018-04-23 21:05:37,13415.0,2,3082,2,13410.0,10,13420.0,7,B
2018-04-23 21:05:39,13415.0,4,3086,4,13415.0,5,13420.0,7,B
2018-04-23 21:05:42,13415.0,2,3088,0,13415.0,5,13420.0,6,B
2018-04-23 21:05:42,13420.0,12,3100,-6,13420.0,1,13425.0,3,B
2018-04-23 21:05:44,13420.0,2,3102,0,13415.0,11,13425.0,12,B
2018-04-23 21:05:47,13420.0,2,3104,0,13415.0,6,13425.0,12,B
2018-04-23 21:05:49,13425.0,2,3106,0,13415.0,6,13425.0,12,B
2018-04-23 21:05:51,13425.0,6,3112,0,13415.0,9,13425.0,1,B
2018-04-23 21:05:52,13425.0,2,3114,-2,13415.0,9,13430.0,2,B
2018-04-23 21:05:53,13415.0,2,3116,0,13415.0,8,13430.0,9,S
2018-04-23 21:05:58,13425.0,4,3120,-2,13415.0,6,13425.0,8,B
2018-04-23 21:06:08,13425.0,2,3122,0,13420.0,12,13425.0,2,B
2018-04-23 21:06:10,13425.0,2,3124,0,13420.0,10,13425.0,3,B
2018-04-23 21:06:10,13425.0,6,3130,4,13425.0,3,13430.0,7,B
2018-04-23 21:06:13,13430.0,4,3134,-2,13425.0,10,13430.0,1,B
2018-04-23 21:06:13,13430.0,2,3136,-2,13425.0,10,13435.0,1,B
2018-04-23 21:06:14,13435.0,2,3138,0,13430.0,57,13445.0,1,B
2018-04-23 21:06:24,13445.0,8,3146,-6,13445.0,8,13450.0,1,B
2018-04-23 21:06:27,13445.0,20,3166,-16,13445.0,1,13450.0,10,B
2018-04-23 21:06:28,13445.0,4,3170,0,13440.0,12,13445.0,2,B
2018-04-23 21:06:30,13445.0,2,3172,0,13440.0,13,13450.0,13,B
2018-04-23 21:06:30,13445.0,2,3174,2,13440.0,10,13445.0,5,B
2018-04-23 21:06:34,13440.0,6,3180,-2,13440.0,10,13445.0,3,S
2018-04-23 21:06:34,13440.0,18,3198,18,13435.0,2,13445.0,4,S
2018-04-23 21:06:35,13445.0,36,3234,14,13445.0,39,13450.0,10,B
2018-04-23 21:06:35,13445.0,92,3326,46,13425.0,15,13445.0,12,B
2018-04-23 21:06:38,13425.0,4,3330,-2,13425.0,3,13435.0,1,S
2018-04-23 21:06:39,13445.0,20,3350,-12,13425.0,5,13445.0,8,B
2018-04-23 21:06:41,13435.0,2,3352,0,13430.0,3,13435.0,1,S
2018-04-23 21:06:44,13435.0,2,3354,0,13435.0,9,13440.0,6,S
2018-04-23 21:06:44,13435.0,10,3364,6,13435.0,4,13440.0,6,S
2018-04-23 21:06:45,13435.0,2,3366,0,13435.0,5,13440.0,6,S
2018-04-23 21:06:47,13435.0,4,3370,0,13435.0,8,13440.0,6,S
2018-04-23 21:06:48,13440.0,4,3374,2,13435.0,7,13440.0,6,B
2018-04-23 21:06:49,13435.0,8,3382,0,13435.0,2,13440.0,6,S
2018-04-23 21:06:49,13430.0,10,3392,0,13425.0,4,13435.0,13,S
2018-04-23 21:06:50,13435.0,2,3394,2,13425.0,3,13435.0,6,B
2018-04-23 21:06:54,13435.0,4,3398,4,13425.0,6,13435.0,6,B
2018-04-23 21:06:55,13425.0,2,3400,0,13420.0,12,13430.0,2,S
2018-04-23 21:07:00,13430.0,4,3404,-2,13430.0,49,13435.0,5,B
2018-04-23 21:07:01,13430.0,2,3406,0,13430.0,48,13435.0,8,B
2018-04-23 21:07:05,13430.0,4,3410,4,13430.0,46,13435.0,6,B
2018-04-23 21:07:06,13430.0,62,3472,4,13430.0,16,13435.0,4,B
2018-04-23 21:07:06,13430.0,32,3504,12,13425.0,4,13430.0,1,B
2018-04-23 21:07:09,13430.0,2,3506,2,13425.0,4,13430.0,3,B
2018-04-23 21:07:11,13425.0,2,3508,0,13425.0,4,13430.0,5,S
2018-04-23 21:07:15,13425.0,4,3512,4,13425.0,1,13430.0,6,S
2018-04-23 21:07:15,13425.0,4,3516,-2,13420.0,13,13430.0,7,S
2018-04-23 21:07:16,13430.0,2,3518,-2,13420.0,19,13430.0,6,B
2018-04-23 21:07:19,13420.0,2,3520,-2,13420.0,18,13425.0,1,S
2018-04-23 21:07:19,13430.0,16,3536,12,13430.0,3,13435.0,7,B
2018-04-23 21:07:20,13430.0,6,3542,0,13425.0,1,13435.0,8,B
2018-04-23 21:07:20,13425.0,2,3544,0,13420.0,19,13430.0,4,S
2018-04-23 21:07:22,13420.0,4,3548,2,13420.0,17,13430.0,5,S
2018-04-23 21:07:26,13425.0,10,3558,-6,13425.0,6,13430.0,1,B
2018-04-23 21:07:26,13425.0,4,3562,0,13425.0,10,13435.0,7,B
2018-04-23 21:07:28,13430.0,2,3564,2,13425.0,8,13435.0,7,B
2018-04-23 21:07:32,13425.0,6,3570,2,13425.0,4,13435.0,13,S
2018-04-23 21:07:35,13425.0,2,3572,2,13430.0,9,13435.0,11,S
2018-04-23 21:07:36,13430.0,4,3576,2,13430.0,7,13435.0,11,B
2018-04-23 21:07:37,13430.0,4,3580,0,13430.0,5,13435.0,11,B
2018-04-23 21:07:38,13435.0,2,3582,0,13430.0,5,13435.0,7,B
2018-04-23 21:07:40,13430.0,2,3584,2,13430.0,5,13435.0,1,S
2018-04-23 21:07:41,13435.0,4,3588,2,13430.0,5,13440.0,6,B
2018-04-23 21:07:44,13430.0,2,3590,2,13430.0,13,13440.0,1,S
2018-04-23 21:07:48,13440.0,2,3592,0,13430.0,13,13440.0,3,B
2018-04-23 21:07:52,13435.0,2,3594,0,13430.0,10,13440.0,2,S
2018-04-23 21:07:54,13430.0,2,3596,2,13430.0,10,13440.0,1,S
2018-04-23 21:07:55,13440.0,2,3598,0,13430.0,10,13445.0,7,B
2018-04-23 21:08:01,13430.0,2,3600,2,13430.0,4,13440.0,8,S
2018-04-23 21:08:03,13440.0,2,3602,2,13430.0,3,13440.0,15,B
2018-04-23 21:08:03,13430.0,2,3604,0,13430.0,3,13440.0,15,S
2018-04-23 21:08:04,13440.0,2,3606,0,13430.0,3,13440.0,14,B
2018-04-23 21:08:05,13440.0,2,3608,0,13430.0,3,13440.0,13,B
2018-04-23 21:08:05,13430.0,6,3614,0,13425.0,2,13435.0,5,S
2018-04-23 21:08:11,13425.0,2,3616,0,13425.0,2,13435.0,12,S
2018-04-23 21:08:13,13425.0,2,3618,-2,13420.0,10,13430.0,8,S
2018-04-23 21:08:14,13425.0,2,3620,0,13420.0,10,13430.0,8,S
2018-04-23 21:08:21,13425.0,2,3622,2,13425.0,5,13430.0,5,S
2018-04-23 21:08:23,13425.0,2,3624,-2,13420.0,11,13430.0,12,S
2018-04-23 21:08:31,13430.0,22,3646,12,13420.0,8,13430.0,3,B
2018-04-23 21:08:40,13425.0,4,3650,-4,13420.0,9,13425.0,2,S
2018-04-23 21:08:44,13420.0,2,3652,0,13420.0,7,13425.0,4,S
2018-04-23 21:08:45,13420.0,2,3654,0,13420.0,6,13425.0,4,S
2018-04-23 21:08:45,13410.0,24,3678,-6,13410.0,23,13420.0,1,S
2018-04-23 21:08:48,13420.0,10,3688,2,13415.0,7,13425.0,6,B
2018-04-23 21:08:49,13415.0,4,3692,-4,13415.0,9,13425.0,7,S
2018-04-23 21:08:52,13420.0,2,3694,2,13415.0,9,13425.0,7,B
2018-04-23 21:09:10,13420.0,6,3700,-6,13415.0,9,13425.0,7,B
2018-04-23 21:09:12,13420.0,6,3706,0,13420.0,9,13425.0,2,B
2018-04-23 21:09:13,13420.0,6,3712,6,13420.0,6,13425.0,2,B
2018-04-23 21:09:14,13420.0,2,3714,-2,13420.0,6,13425.0,2,B
2018-04-23 21:09:16,13420.0,2,3716,0,13420.0,5,13425.0,2,B
2018-04-23 21:09:18,13420.0,2,3718,0,13420.0,4,13425.0,2,B
2018-04-23 21:09:21,13425.0,2,3720,0,13420.0,9,13425.0,1,B
2018-04-23 21:09:21,13425.0,2,3722,0,13420.0,9,13430.0,4,B
2018-04-23 21:09:25,13420.0,2,3724,2,13420.0,11,13430.0,13,S
2018-04-23 21:09:35,13425.0,10,3734,-8,13425.0,1,13430.0,1,B
2018-04-23 21:09:42,13430.0,6,3740,-2,13425.0,4,13435.0,3,B
2018-04-23 21:09:45,13435.0,2,3742,2,13425.0,7,13435.0,14,B
2018-04-23 21:09:51,13435.0,2,3744,0,13435.0,10,13440.0,5,B
2018-04-23 21:09:54,13435.0,20,3764,0,13430.0,6,13435.0,1,B
2018-04-23 21:09:55,13435.0,2,3766,-2,13430.0,7,13440.0,10,B
2018-04-23 21:09:59,13440.0,20,3786,12,13430.0,7,13440.0,4,B
2018-04-23 21:09:59,13430.0,16,3802,8,13425.0,19,13435.0,1,S
2018-04-23 21:10:00,13430.0,8,3810,4,13430.0,1,13440.0,2,S
2018-04-23 21:10:04,13435.0,4,3814,4,13435.0,20,13445.0,11,B
2018-04-23 21:10:06,13435.0,26,3840,0,13435.0,6,13440.0,12,B
2018-04-23 21:10:06,13435.0,12,3852,-2,13430.0,2,13435.0,2,B
2018-04-23 21:10:07,13430.0,2,3854,-2,13425.0,5,13430.0,3,S
2018-04-23 21:10:07,13430.0,2,3856,2,13425.0,9,13435.0,9,S
2018-04-23 21:10:10,13435.0,2,3858,2,13425.0,13,13435.0,8,B
2018-04-23 21:10:11,13430.0,2,3860,2,13430.0,9,13435.0,5,S
2018-04-23 21:10:16,13430.0,2,3862,2,13430.0,8,13435.0,6,S
2018-04-23 21:10:19,13435.0,2,3864,-2,13430.0,18,13440.0,12,B
2018-04-23 21:10:21,13435.0,12,3876,2,13430.0,11,13435.0,2,B
2018-04-23 21:10:25,13435.0,12,3888,-12,13435.0,14,13440.0,13,B
2018-04-23 21:10:25,13435.0,12,3900,-12,13435.0,8,13440.0,15,B
2018-04-23 21:10:26,13435.0,2,3902,-2,13435.0,7,13440.0,14,B
2018-04-23 21:10:47,13440.0,20,3922,10,13435.0,7,13440.0,5,B
2018-04-23 21:10:54,13440.0,14,3936,-8,13435.0,7,13440.0,1,B
2018-04-23 21:10:55,13440.0,2,3938,-2,13440.0,8,13445.0,7,B
2018-04-23 21:10:55,13445.0,2,3940,-2,13440.0,8,13445.0,2,B
2018-04-23 21:10:57,13445.0,2,3942,2,13440.0,7,13445.0,3,B
2018-04-23 21:11:01,13440.0,2,3944,2,13440.0,4,13445.0,5,S
2018-04-23 21:11:02,13445.0,2,3946,2,13440.0,4,13445.0,5,B
2018-04-23 21:11:06,13440.0,6,3952,0,13440.0,1,13445.0,7,S
2018-04-23 21:11:07,13440.0,2,3954,0,13435.0,17,13445.0,8,S
2018-04-23 21:11:19,13440.0,2,3956,0,13435.0,14,13440.0,5,S
2018-04-23 21:11:26,13440.0,2,3958,0,13435.0,14,13440.0,6,S
2018-04-23 21:11:27,13440.0,6,3964,-2,13435.0,14,13440.0,3,S
2018-04-23 21:11:28,13440.0,8,3972,2,13440.0,6,13445.0,6,S
2018-04-23 21:11:29,13440.0,20,3992,12,13440.0,12,13445.0,8,S
2018-04-23 21:11:32,13445.0,2,3994,0,13440.0,14,13445.0,4,B
2018-04-23 21:11:38,13445.0,8,4002,-8,13440.0,14,13445.0,1,B
2018-04-23 21:11:41,13445.0,2,4004,-2,13440.0,14,13445.0,16,B
2018-04-23 21:11:46,13445.0,2,4006,0,13440.0,14,13445.0,21,B
2018-04-23 21:11:49,13440.0,4,4010,-4,13440.0,12,13445.0,21,S
2018-04-23 21:11:55,13445.0,2,4012,0,13440.0,17,13445.0,20,B
2018-04-23 21:12:02,13445.0,2,4014,0,13440.0,13,13445.0,21,B
2018-04-23 21:12:04,13440.0,2,4016,0,13440.0,12,13445.0,21,S
2018-04-23 21:12:06,13440.0,6,4022,-6,13440.0,9,13445.0,18,S
2018-04-23 21:12:07,13440.0,18,4040,-12,13435.0,9,13440.0,5,S
2018-04-23 21:12:12,13440.0,20,4060,-20,13435.0,8,13440.0,6,S
2018-04-23 21:12:14,13440.0,18,4078,-18,13440.0,6,13445.0,19,S
2018-04-23 21:12:15,13435.0,28,4106,-26,13430.0,14,13440.0,5,S
2018-04-23 21:12:17,13430.0,8,4114,8,13430.0,32,13440.0,2,S
2018-04-23 21:12:18,13430.0,8,4122,8,13430.0,28,13440.0,2,S
2018-04-23 21:12:22,13440.0,10,4132,-6,13430.0,31,13445.0,19,B
2018-04-23 21:12:42,13440.0,4,4136,-4,13435.0,4,13440.0,1,B
2018-04-23 21:12:42,13440.0,2,4138,0,13440.0,1,13445.0,19,B
2018-04-23 21:12:43,13435.0,6,4144,2,13435.0,2,13440.0,4,S
2018-04-23 21:12:52,13435.0,2,4146,2,13435.0,4,13440.0,2,S
2018-04-23 21:12:54,13435.0,2,4148,0,13435.0,3,13440.0,5,S
2018-04-23 21:12:54,13440.0,2,4150,0,13435.0,3,13440.0,4,B
2018-04-23 21:12:55,13435.0,4,4154,2,13435.0,1,13440.0,4,S
2018-04-23 21:13:13,13430.0,24,4178,-4,13425.0,6,13430.0,2,S
2018-04-23 21:13:15,13425.0,2,4180,0,13425.0,5,13430.0,2,S
2018-04-23 21:13:21,13425.0,2,4182,0,13425.0,2,13430.0,2,S
2018-04-23 21:13:23,13425.0,4,4186,-4,13425.0,4,13430.0,8,S
2018-04-23 21:13:24,13425.0,8,4194,-8,13420.0,12,13430.0,6,S
2018-04-23 21:13:25,13425.0,4,4198,-2,13425.0,1,13430.0,3,S
2018-04-23 21:13:30,13425.0,2,4200,2,13425.0,2,13430.0,4,S
2018-04-23 21:13:31,13420.0,6,4206,2,13420.0,19,13430.0,7,S
2018-04-23 21:13:33,13425.0,6,4212,4,13420.0,20,13430.0,7,B
2018-04-23 21:13:33,13430.0,4,4216,-4,13420.0,11,13425.0,1,B
2018-04-23 21:13:34,13425.0,2,4218,0,13425.0,1,13430.0,5,S
2018-04-23 21:13:36,13420.0,2,4220,0,13420.0,18,13425.0,1,S
2018-04-23 21:13:37,13430.0,16,4236,6,13430.0,2,13435.0,4,B
2018-04-23 21:13:37,13420.0,6,4242,4,13420.0,15,13430.0,3,S
2018-04-23 21:13:39,13420.0,10,4252,-6,13420.0,15,13430.0,7,S
2018-04-23 21:13:40,13420.0,2,4254,0,13420.0,14,13430.0,11,S
2018-04-23 21:13:41,13425.0,2,4256,-2,13425.0,1,13430.0,11,B
2018-04-23 21:13:42,13425.0,2,4258,-2,13425.0,1,13430.0,10,B
2018-04-23 21:13:47,13430.0,18,4276,-6,13425.0,13,13435.0,4,B
2018-04-23 21:13:55,13425.0,4,4280,-2,13425.0,12,13435.0,6,S
2018-04-23 21:14:04,13425.0,2,4282,-2,13430.0,15,13435.0,17,S
2018-04-23 21:14:05,13435.0,20,4302,6,13430.0,15,13435.0,7,B
2018-04-23 21:14:08,13430.0,20,4322,-14,13430.0,5,13435.0,7,S
2018-04-23 21:14:10,13430.0,2,4324,0,13430.0,7,13435.0,7,S
2018-04-23 21:14:10,13425.0,40,4364,32,13425.0,9,13435.0,7,S
2018-04-23 21:14:12,13430.0,4,4368,4,13425.0,3,13430.0,2,B
2018-04-23 21:14:12,13430.0,4,4372,0,13425.0,5,13435.0,11,B
2018-04-23 21:14:13,13435.0,2,4374,0,13425.0,7,13435.0,13,B
2018-04-23 21:14:16,13430.0,2,4376,2,13425.0,12,13435.0,13,S
2018-04-23 21:14:17,13425.0,4,4380,-2,13425.0,11,13435.0,13,S
2018-04-23 21:14:36,13425.0,2,4382,2,13425.0,1,13435.0,23,S
2018-04-23 21:14:47,13425.0,6,4388,6,13425.0,2,13435.0,10,S
2018-04-23 21:14:47,13425.0,4,4392,0,13425.0,3,13435.0,10,S
2018-04-23 21:14:48,13425.0,4,4396,0,13420.0,7,13425.0,1,S
2018-04-23 21:14:48,13425.0,2,4398,0,13425.0,4,13435.0,10,S
2018-04-23 21:15:04,13420.0,22,4420,14,13415.0,5,13425.0,10,S
2018-04-23 21:15:07,13415.0,2,4422,0,13415.0,4,13425.0,13,S
2018-04-23 21:15:07,13415.0,2,4424,0,13415.0,4,13425.0,13,S
2018-04-23 21:15:13,13425.0,2,4426,0,13425.0,9,13430.0,10,B
2018-04-23 21:15:16,13425.0,2,4428,2,13425.0,8,13430.0,14,B
2018-04-23 21:15:23,13425.0,10,4438,2,13425.0,8,13430.0,15,B
2018-04-23 21:15:32,13430.0,4,4442,0,13425.0,18,13430.0,14,B
2018-04-23 21:15:40,13430.0,20,4462,8,13425.0,19,13435.0,24,B
2018-04-23 21:15:41,13430.0,2,4464,-2,13425.0,19,13430.0,3,B
2018-04-23 21:15:44,13430.0,6,4470,4,13425.0,16,13430.0,1,B
2018-04-23 21:15:49,13430.0,2,4472,0,13430.0,9,13435.0,15,B
2018-04-23 21:15:56,13430.0,20,4492,0,13430.0,1,13435.0,12,B
2018-04-23 21:16:02,13435.0,20,4512,14,13430.0,2,13435.0,1,B
2018-04-23 21:16:02,13430.0,4,4516,2,13430.0,1,13435.0,2,S
2018-04-23 21:16:13,13430.0,2,4518,-2,13425.0,5,13430.0,1,S
2018-04-23 21:16:16,13430.0,4,4522,0,13425.0,8,13435.0,17,S
2018-04-23 21:16:33,13435.0,4,4526,0,13430.0,1,13435.0,6,B
2018-04-23 21:16:42,13435.0,6,4532,0,13430.0,5,13440.0,26,B
2018-04-23 21:16:46,13435.0,2,4534,2,13430.0,5,13435.0,6,B
2018-04-23 21:16:54,13430.0,30,4564,22,13425.0,11,13435.0,34,S
2018-04-23 21:16:55,13430.0,2,4566,2,13425.0,11,13435.0,34,S
2018-04-23 21:17:08,13425.0,10,4576,-4,13420.0,2,13430.0,23,S
2018-04-23 21:17:09,13420.0,2,4578,0,13420.0,3,13430.0,39,S
2018-04-23 21:17:13,13420.0,8,4586,4,13415.0,4,13420.0,2,S
2018-04-23 21:17:14,13420.0,2,4588,2,13415.0,10,13420.0,3,S
2018-04-23 21:17:19,13415.0,2,4590,0,13415.0,3,13420.0,6,S
2018-04-23 21:17:21,13415.0,2,4592,2,13415.0,3,13420.0,12,S
2018-04-23 21:17:22,13415.0,2,4594,2,13415.0,2,13420.0,12,S
2018-04-23 21:17:24,13415.0,2,4596,2,13410.0,1,13415.0,5,S
2018-04-23 21:17:30,13410.0,6,4602,4,13405.0,42,13410.0,5,S
2018-04-23 21:17:31,13410.0,10,4612,0,13410.0,1,13415.0,5,S
2018-04-23 21:17:33,13410.0,2,4614,2,13405.0,49,13415.0,3,S
2018-04-23 21:17:37,13405.0,2,4616,0,13405.0,48,13415.0,6,S
2018-04-23 21:17:37,13405.0,4,4620,2,13405.0,46,13415.0,6,S
2018-04-23 21:17:39,13405.0,2,4622,0,13405.0,45,13415.0,14,S
2018-04-23 21:17:40,13405.0,8,4630,4,13405.0,34,13410.0,2,S
2018-04-23 21:17:42,13410.0,4,4634,-2,13405.0,33,13410.0,3,B
2018-04-23 21:17:42,13415.0,8,4642,-4,13405.0,34,13415.0,12,B
2018-04-23 21:17:43,13410.0,2,4644,-2,13410.0,2,13415.0,12,S
2018-04-23 21:17:45,13410.0,2,4646,0,13410.0,2,13415.0,6,S
2018-04-23 21:17:47,13410.0,6,4652,4,13405.0,41,13415.0,5,S
2018-04-23 21:17:50,13405.0,24,4676,24,13405.0,22,13410.0,2,S
2018-04-23 21:17:52,13410.0,2,4678,-2,13410.0,4,13415.0,17,B
2018-04-23 21:17:52,13410.0,10,4688,-6,13405.0,23,13410.0,5,B
2018-04-23 21:17:53,13410.0,2,4690,0,13405.0,22,13410.0,4,B
2018-04-23 21:17:57,13410.0,6,4696,2,13405.0,30,13415.0,3,B
2018-04-23 21:18:01,13410.0,2,4698,0,13410.0,4,13415.0,5,B
2018-04-23 21:18:03,13410.0,8,4706,-8,13410.0,1,13415.0,30,B
2018-04-23 21:18:03,13410.0,2,4708,-2,13405.0,24,13415.0,20,B
2018-04-23 21:18:05,13410.0,2,4710,0,13405.0,33,13415.0,2,B
2018-04-23 21:18:09,13415.0,4,4714,2,13410.0,1,13415.0,2,B
2018-04-23 21:18:17,13420.0,4,4718,0,13415.0,4,13425.0,10,B
2018-04-23 21:18:18,13420.0,2,4720,0,13415.0,4,13420.0,4,B
2018-04-23 21:18:20,13420.0,8,4728,-8,13415.0,7,13425.0,7,B
2018-04-23 21:18:22,13420.0,2,4730,2,13415.0,14,13425.0,6,B
2018-04-23 21:18:39,13420.0,2,4732,2,13415.0,7,13425.0,22,B
2018-04-23 21:18:53,13420.0,20,4752,6,13415.0,14,13425.0,8,B
2018-04-23 21:19:03,13420.0,2,4754,0,13415.0,14,13425.0,5,B
2018-04-23 21:19:04,13415.0,12,4766,12,13415.0,9,13425.0,5,S
2018-04-23 21:19:12,13420.0,6,4772,0,13420.0,1,13425.0,3,B
2018-04-23 21:19:12,13420.0,2,4774,0,13420.0,7,13425.0,3,B
2018-04-23 21:19:14,13425.0,2,4776,0,13420.0,9,13430.0,9,B
2018-04-23 21:19:20,13430.0,2,4778,2,13425.0,1,13430.0,8,B
2018-04-23 21:19:26,13430.0,2,4780,0,13425.0,6,13435.0,20,B
2018-04-23 21:19:27,13435.0,8,4788,0,13430.0,1,13435.0,5,B
2018-04-23 21:19:35,13435.0,4,4792,0,13425.0,12,13435.0,3,B
2018-04-23 21:19:36,13425.0,2,4794,2,13425.0,11,13435.0,4,S
2018-04-23 21:19:41,13430.0,2,4796,0,13425.0,3,13430.0,6,B
2018-04-23 21:19:42,13430.0,2,4798,0,13425.0,4,13430.0,6,B
2018-04-23 21:19:51,13430.0,2,4800,0,13425.0,8,13430.0,2,B
2018-04-23 21:20:01,13430.0,8,4808,0,13425.0,15,13435.0,12,B
2018-04-23 21:20:02,13430.0,2,4810,0,13425.0,16,13435.0,12,B
2018-04-23 21:20:15,13435.0,6,4816,-6,13430.0,6,13440.0,26,B
2018-04-23 21:20:16,13435.0,2,4818,0,13435.0,12,13440.0,14,B
2018-04-23 21:20:19,13440.0,2,4820,2,13435.0,8,13440.0,10,B
2018-04-23 21:20:24,13440.0,2,4822,2,13435.0,8,13440.0,8,B
2018-04-23 21:20:27,13440.0,2,4824,2,13435.0,8,13440.0,7,B
2018-04-23 21:20:37,13440.0,16,4840,8,13440.0,1,13445.0,13,B
2018-04-23 21:20:38,13440.0,2,4842,0,13440.0,1,13445.0,13,B
2018-04-23 21:21:00,13445.0,10,4852,0,13440.0,6,13445.0,6,B
2018-04-23 21:21:04,13440.0,8,4860,-4,13440.0,2,13445.0,9,S
2018-04-23 21:21:04,13440.0,4,4864,4,13435.0,6,13440.0,5,S
2018-04-23 21:21:07,13440.0,2,4866,-2,13435.0,5,13440.0,1,S
2018-04-23 21:21:12,13440.0,4,4870,0,13435.0,12,13440.0,3,S
2018-04-23 21:21:12,13440.0,6,4876,-6,13435.0,12,13445.0,13,S
2018-04-23 21:21:20,13440.0,8,4884,-6,13435.0,5,13440.0,1,S
2018-04-23 21:21:21,13435.0,4,4888,-2,13435.0,2,13440.0,7,S
2018-04-23 21:21:21,13435.0,4,4892,0,13430.0,4,13435.0,7,S
2018-04-23 21:21:22,13430.0,2,4894,2,13425.0,6,13435.0,7,S
2018-04-23 21:21:25,13430.0,2,4896,-2,13425.0,12,13435.0,21,S
2018-04-23 21:21:26,13435.0,4,4900,4,13430.0,1,13435.0,19,B
2018-04-23 21:21:36,13435.0,2,4902,0,13430.0,4,13435.0,14,B
2018-04-23 21:21:44,13430.0,10,4912,0,13430.0,6,13435.0,6,S
2018-04-23 21:21:55,13430.0,8,4920,8,13425.0,13,13435.0,6,S
2018-04-23 21:22:38,13435.0,2,4922,2,13430.0,1,13435.0,10,B
2018-04-23 21:22:42,13430.0,2,4924,0,13425.0,18,13430.0,2,S
2018-04-23 21:22:42,13430.0,2,4926,0,13425.0,18,13430.0,1,S
2018-04-23 21:22:43,13430.0,2,4928,0,13430.0,1,13435.0,10,S
2018-04-23 21:23:01,13435.0,8,4936,2,13430.0,7,13435.0,5,B
2018-04-23 21:23:02,13435.0,6,4942,6,13430.0,7,13435.0,2,B
2018-04-23 21:23:03,13435.0,2,4944,-2,13430.0,7,13440.0,22,B
2018-04-23 21:23:08,13435.0,2,4946,2,13430.0,18,13440.0,8,B
2018-04-23 21:23:10,13445.0,20,4966,8,13430.0,18,13440.0,2,B
2018-04-23 21:23:19,13440.0,2,4968,2,13440.0,6,13445.0,11,S
2018-04-23 21:23:21,13445.0,2,4970,2,13440.0,9,13445.0,4,B
2018-04-23 21:23:21,13445.0,8,4978,4,13440.0,17,13450.0,28,B
2018-04-23 21:23:34,13445.0,2,4980,-2,13445.0,4,13450.0,44,B
2018-04-23 21:23:34,13445.0,16,4996,-2,13440.0,7,13445.0,2,B
2018-04-23 21:23:40,13445.0,2,4998,0,13445.0,2,13450.0,32,B
2018-04-23 21:23:41,13440.0,2,5000,0,13440.0,16,13450.0,29,S
2018-04-23 21:23:48,13445.0,2,5002,-2,13440.0,2,13445.0,1,B
2018-04-23 21:23:50,13445.0,2,5004,2,13440.0,2,13450.0,43,B
2018-04-23 21:23:56,13445.0,2,5006,-2,13440.0,17,13450.0,31,B
2018-04-23 21:24:01,13445.0,6,5012,-2,13445.0,1,13450.0,25,B
2018-04-23 21:24:01,13445.0,2,5014,-2,13440.0,17,13450.0,25,B
2018-04-23 21:24:08,13445.0,4,5018,-2,13440.0,16,13450.0,28,B
2018-04-23 21:24:10,13445.0,2,5020,-2,13440.0,17,13450.0,27,B
2018-04-23 21:24:11,13450.0,6,5026,0,13440.0,4,13450.0,41,B
2018-04-23 21:24:12,13440.0,8,5034,0,13435.0,10,13445.0,1,S
2018-04-23 21:24:28,13445.0,2,5036,2,13445.0,3,13450.0,27,B
2018-04-23 21:24:29,13445.0,2,5038,0,13445.0,2,13450.0,27,B
2018-04-23 21:24:35,13445.0,2,5040,0,13445.0,1,13450.0,25,B
2018-04-23 21:24:49,13445.0,2,5042,0,13440.0,9,13450.0,24,B
2018-04-23 21:25:18,13440.0,2,5044,0,13435.0,22,13440.0,1,S
2018-04-23 21:25:18,13440.0,2,5046,-2,13435.0,8,13440.0,5,S
2018-04-23 21:25:41,13435.0,4,5050,0,13435.0,7,13440.0,6,S
2018-04-23 21:25:41,13440.0,12,5062,4,13435.0,17,13445.0,8,B
2018-04-23 21:25:43,13450.0,10,5072,-4,13440.0,4,13450.0,53,B
2018-04-23 21:25:44,13440.0,2,5074,0,13440.0,3,13450.0,55,S
2018-04-23 21:25:45,13440.0,2,5076,2,13440.0,2,13450.0,55,S
2018-04-23 21:25:56,13440.0,2,5078,2,13440.0,2,13445.0,2,S
2018-04-23 21:26:01,13440.0,2,5080,0,13435.0,21,13445.0,2,S
2018-04-23 21:26:01,13445.0,4,5084,-4,13435.0,27,13450.0,53,B
2018-04-23 21:26:20,13440.0,16,5100,-6,13435.0,4,13440.0,3,S
2018-04-23 21:26:23,13440.0,4,5104,-2,13435.0,14,13445.0,9,S
2018-04-23 21:26:28,13445.0,12,5116,-8,13445.0,6,13450.0,53,B
2018-04-23 21:26:28,13445.0,2,5118,-2,13445.0,5,13450.0,55,B
2018-04-23 21:26:30,13445.0,10,5128,-10,13440.0,4,13450.0,51,B
2018-04-23 21:26:48,13450.0,2,5130,2,13445.0,6,13450.0,21,B
2018-04-23 21:26:56,13445.0,2,5132,2,13445.0,2,13450.0,24,S
2018-04-23 21:26:57,13445.0,4,5136,0,13440.0,10,13450.0,41,S
2018-04-23 21:27:12,13445.0,2,5138,2,13440.0,12,13445.0,3,S
2018-04-23 21:27:12,13445.0,6,5144,0,13440.0,19,13450.0,30,S
2018-04-23 21:27:35,13445.0,2,5146,-2,13445.0,2,13450.0,22,S
2018-04-23 21:27:35,13445.0,4,5150,0,13440.0,10,13450.0,22,S
2018-04-23 21:27:44,13445.0,8,5158,0,13440.0,18,13445.0,4,S
2018-04-23 21:27:44,13445.0,8,5166,4,13440.0,18,13450.0,26,S
2018-04-23 21:27:51,13445.0,2,5168,-2,13445.0,4,13450.0,26,S
2018-04-23 21:27:58,13450.0,2,5170,0,13445.0,4,13450.0,21,B
2018-04-23 21:28:12,13445.0,8,5178,0,13440.0,10,13445.0,5,S
2018-04-23 21:28:17,13445.0,2,5180,0,13440.0,6,13445.0,5,S
2018-04-23 21:28:35,13440.0,8,5188,-4,13440.0,2,13445.0,2,S
2018-04-23 21:28:52,13440.0,2,5190,2,13435.0,6,13445.0,5,S
2018-04-23 21:28:54,13440.0,2,5192,0,13435.0,14,13445.0,6,S
2018-04-23 21:29:32,13440.0,2,5194,0,13435.0,2,13445.0,36,S
2018-04-23 21:29:53,13440.0,2,5196,0,13435.0,8,13440.0,6,S
2018-04-23 21:30:01,13440.0,4,5200,0,13435.0,10,13445.0,33,S
2018-04-23 21:30:26,13440.0,2,5202,0,13435.0,10,13440.0,2,S
2018-04-23 21:30:35,13445.0,20,5222,18,13435.0,9,13445.0,29,B
2018-04-23 21:30:40,13435.0,16,5238,14,13430.0,5,13440.0,39,S
2018-04-23 21:30:40,13430.0,2,5240,-2,13430.0,4,13435.0,1,S
2018-04-23 21:30:42,13430.0,4,5244,-2,13425.0,6,13430.0,2,S
2018-04-23 21:30:51,13430.0,2,5246,0,13430.0,3,13435.0,1,S
2018-04-23 21:30:52,13430.0,2,5248,-2,13425.0,18,13435.0,9,S
2018-04-23 21:30:53,13430.0,2,5250,0,13425.0,3,13430.0,1,S
2018-04-23 21:30:56,13425.0,2,5252,0,13425.0,4,13430.0,1,S
2018-04-23 21:31:08,13430.0,4,5256,-4,13430.0,6,13435.0,10,B
2018-04-23 21:31:11,13435.0,2,5258,0,13430.0,10,13440.0,35,B
2018-04-23 21:31:13,13430.0,2,5260,0,13430.0,9,13440.0,42,S
2018-04-23 21:31:19,13430.0,2,5262,0,13430.0,16,13440.0,3,S
2018-04-23 21:31:30,13435.0,2,5264,0,13435.0,1,13440.0,14,B
2018-04-23 21:31:37,13440.0,2,5266,-2,13435.0,5,13440.0,3,B
2018-04-23 21:31:46,13435.0,10,5276,6,13430.0,15,13440.0,3,S
2018-04-23 21:32:00,13440.0,4,5280,2,13440.0,1,13445.0,32,B
2018-04-23 21:32:04,13445.0,8,5288,2,13440.0,5,13450.0,39,B
2018-04-23 21:32:11,13440.0,8,5296,-2,13435.0,9,13445.0,12,S
2018-04-23 21:32:24,13440.0,2,5298,2,13435.0,16,13445.0,28,S
2018-04-23 21:32:26,13445.0,10,5308,-8,13435.0,15,13445.0,24,B
2018-04-23 21:32:26,13445.0,2,5310,2,13435.0,15,13445.0,23,B
2018-04-23 21:33:02,13435.0,2,5312,-2,13435.0,14,13445.0,24,S
2018-04-23 21:33:02,13435.0,10,5322,6,13435.0,2,13440.0,4,S
2018-04-23 21:33:03,13435.0,4,5326,-2,13430.0,7,13440.0,24,S
2018-04-23 21:33:05,13435.0,2,5328,0,13430.0,15,13440.0,14,S
2018-04-23 21:33:09,13435.0,2,5330,-2,13430.0,22,13440.0,3,S
2018-04-23 21:33:31,13435.0,10,5340,10,13435.0,3,13440.0,8,S
2018-04-23 21:33:42,13440.0,6,5346,0,13435.0,13,13445.0,15,B
2018-04-23 21:33:54,13440.0,12,5358,8,13435.0,14,13445.0,20,B
2018-04-23 21:34:10,13440.0,2,5360,0,13435.0,6,13440.0,2,B
2018-04-23 21:34:14,13440.0,2,5362,0,13435.0,15,13445.0,22,B
2018-04-23 21:34:15,13440.0,2,5364,0,13435.0,16,13445.0,18,B
2018-04-23 21:34:30,13440.0,10,5374,-4,13435.0,16,13445.0,19,B
2018-04-23 21:34:51,13440.0,2,5376,0,13435.0,23,13445.0,13,B
2018-04-23 21:35:03,13440.0,12,5388,6,13440.0,9,13445.0,7,B
2018-04-23 21:35:04,13445.0,6,5394,0,13440.0,19,13445.0,4,B
2018-04-23 21:35:04,13445.0,8,5402,6,13445.0,12,13450.0,23,B
2018-04-23 21:35:15,13445.0,10,5412,8,13445.0,9,13450.0,22,B
2018-04-23 21:35:20,13445.0,16,5428,-4,13440.0,12,13450.0,28,B
2018-04-23 21:35:24,13450.0,4,5432,-4,13440.0,12,13450.0,26,B
2018-04-23 21:35:28,13450.0,4,5436,0,13440.0,12,13450.0,23,B
2018-04-23 21:35:32,13450.0,2,5438,2,13440.0,13,13450.0,23,B
2018-04-23 21:35:42,13445.0,2,5440,2,13440.0,12,13445.0,3,S
2018-04-23 21:35:47,13440.0,2,5442,2,13440.0,7,13445.0,12,S
2018-04-23 21:35:48,13435.0,16,5458,8,13435.0,11,13445.0,12,S
2018-04-23 21:35:50,13435.0,6,5464,0,13435.0,3,13440.0,14,S
2018-04-23 21:35:54,13440.0,2,5466,-2,13435.0,3,13440.0,12,B
2018-04-23 21:35:58,13440.0,2,5468,0,13435.0,3,13440.0,11,B
2018-04-23 21:36:05,13440.0,2,5470,-2,13435.0,4,13440.0,10,B
2018-04-23 21:36:08,13435.0,8,5478,8,13430.0,9,13440.0,12,S
2018-04-23 21:36:11,13435.0,2,5480,0,13430.0,6,13435.0,9,S
2018-04-23 21:36:13,13435.0,2,5482,2,13430.0,6,13435.0,8,S
2018-04-23 21:36:15,13435.0,2,5484,2,13430.0,7,13435.0,6,S
2018-04-23 21:36:16,13435.0,10,5494,0,13430.0,15,13440.0,10,S
2018-04-23 21:36:18,13440.0,2,5496,2,13430.0,15,13440.0,8,B
2018-04-23 21:36:19,13440.0,2,5498,2,13430.0,15,13440.0,7,B
2018-04-23 21:36:20,13430.0,22,5520,10,13430.0,7,13440.0,7,S
2018-04-23 21:36:33,13435.0,2,5522,0,13430.0,10,13440.0,5,B
2018-04-23 21:36:43,13435.0,2,5524,2,13430.0,10,13435.0,1,B
2018-04-23 21:36:43,13435.0,2,5526,0,13430.0,10,13440.0,6,B
2018-04-23 21:36:51,13430.0,2,5528,0,13430.0,19,13440.0,6,S
2018-04-23 21:36:53,13440.0,4,5532,0,13435.0,9,13445.0,9,B
2018-04-23 21:37:22,13440.0,2,5534,0,13430.0,15,13440.0,11,B
2018-04-23 21:37:32,13435.0,2,5536,-2,13430.0,4,13435.0,7,S
2018-04-23 21:37:33,13430.0,2,5538,2,13430.0,3,13435.0,7,S
2018-04-23 21:37:34,13435.0,12,5550,-6,13430.0,3,13435.0,1,B
2018-04-23 21:37:37,13430.0,2,5552,0,13430.0,2,13440.0,22,S
2018-04-23 21:37:56,13430.0,2,5554,-2,13430.0,2,13435.0,1,S
2018-04-23 21:38:03,13430.0,2,5556,2,13430.0,14,13440.0,3,S
2018-04-23 21:38:13,13430.0,2,5558,-2,13430.0,12,13440.0,7,S
2018-04-23 21:38:37,13430.0,2,5560,-2,13430.0,11,13435.0,1,S
2018-04-23 21:38:41,13430.0,4,5564,-4,13430.0,9,13435.0,3,S
2018-04-23 21:38:43,13435.0,4,5568,0,13430.0,9,13435.0,1,B
2018-04-23 21:39:40,13435.0,36,5604,-14,13430.0,56,13445.0,10,B
2018-04-23 21:39:56,13435.0,2,5606,0,13435.0,3,13440.0,9,B
2018-04-23 21:39:57,13435.0,6,5612,-6,13430.0,44,13435.0,4,B
2018-04-23 21:39:57,13435.0,2,5614,0,13430.0,46,13435.0,3,B
2018-04-23 21:40:00,13435.0,6,5620,-6,13430.0,46,13440.0,13,B
2018-04-23 21:40:01,13435.0,2,5622,0,13430.0,46,13435.0,4,B
2018-04-23 21:40:02,13435.0,8,5630,6,13430.0,46,13440.0,13,B
2018-04-23 21:40:03,13435.0,10,5640,6,13435.0,20,13440.0,2,B
2018-04-23 21:40:23,13435.0,2,5642,2,13435.0,19,13440.0,5,B
2018-04-23 21:40:26,13440.0,2,5644,0,13435.0,19,13440.0,4,B
2018-04-23 21:40:39,13440.0,6,5650,-6,13435.0,19,13440.0,1,B
2018-04-23 21:40:40,13435.0,2,5652,0,13435.0,18,13440.0,1,S
2018-04-23 21:40:43,13440.0,2,5654,0,13435.0,18,13445.0,16,B
2018-04-23 21:41:02,13440.0,2,5656,0,13435.0,18,13440.0,4,B
2018-04-23 21:41:04,13440.0,4,5660,0,13435.0,18,13440.0,2,B
2018-04-23 21:41:29,13440.0,2,5662,0,13435.0,19,13440.0,1,B
2018-04-23 21:41:43,13435.0,10,5672,-2,13435.0,13,13440.0,1,S
2018-04-23 21:41:44,13440.0,2,5674,-2,13440.0,5,13445.0,10,B
2018-04-23 21:41:45,13440.0,12,5686,-2,13435.0,15,13440.0,6,B
2018-04-23 21:41:52,13435.0,10,5696,-2,13435.0,6,13440.0,3,S
2018-04-23 21:42:00,13440.0,6,5702,0,13435.0,6,13445.0,18,B
2018-04-23 21:42:01,13435.0,10,5712,-6,13435.0,1,13445.0,18,S
2018-04-23 21:42:11,13435.0,4,5716,2,13430.0,45,13435.0,1,S
2018-04-23 21:42:16,13435.0,2,5718,0,13430.0,39,13435.0,2,S
2018-04-23 21:42:22,13430.0,40,5758,-40,13430.0,19,13435.0,2,S
2018-04-23 21:42:25,13435.0,2,5760,0,13430.0,19,13435.0,1,B
2018-04-23 21:42:29,13430.0,30,5790,-30,13430.0,4,13435.0,1,S
2018-04-23 21:42:30,13430.0,2,5792,-2,13430.0,4,13435.0,2,S
2018-04-23 21:42:35,13430.0,6,5798,-2,13425.0,30,13435.0,8,S
2018-04-23 21:43:08,13425.0,2,5800,0,13425.0,6,13430.0,3,S
2018-04-23 21:43:41,13430.0,2,5802,2,13430.0,1,13435.0,11,B
2018-04-23 21:43:50,13435.0,2,5804,0,13430.0,2,13435.0,10,B
2018-04-23 21:44:00,13430.0,4,5808,-4,13425.0,19,13435.0,33,S
2018-04-23 21:44:03,13435.0,20,5828,12,13425.0,21,13435.0,26,B
2018-04-23 21:44:12,13425.0,2,5830,2,13425.0,50,13435.0,9,S
2018-04-23 21:44:13,13425.0,2,5832,0,13425.0,49,13435.0,10,S
2018-04-23 21:44:33,13430.0,2,5834,-2,13430.0,9,13435.0,12,B
2018-04-23 21:44:38,13435.0,10,5844,8,13430.0,9,13435.0,3,B
2018-04-23 21:44:39,13435.0,6,5850,6,13430.0,9,13440.0,11,B
2018-04-23 21:45:10,13430.0,2,5852,-2,13430.0,14,13435.0,1,S
2018-04-23 21:45:21,13435.0,2,5854,2,13430.0,11,13435.0,2,B
2018-04-23 21:45:27,13430.0,2,5856,0,13430.0,9,13435.0,3,S
2018-04-23 21:45:32,13435.0,2,5858,0,13430.0,9,13435.0,1,B
2018-04-23 21:45:35,13435.0,2,5860,0,13430.0,9,13440.0,28,B
2018-04-23 21:46:00,13430.0,18,5878,-10,13425.0,50,13430.0,6,S
2018-04-23 21:46:00,13430.0,12,5890,-10,13425.0,50,13435.0,5,S
2018-04-23 21:46:09,13430.0,2,5892,0,13425.0,38,13435.0,7,S
2018-04-23 21:46:24,13430.0,6,5898,2,13425.0,28,13435.0,34,S
2018-04-23 21:46:44,13425.0,44,5942,10,13425.0,5,13430.0,10,S
2018-04-23 21:46:45,13425.0,10,5952,0,13420.0,8,13425.0,16,S
2018-04-23 21:46:49,13425.0,4,5956,0,13420.0,4,13425.0,10,S
2018-04-23 21:46:59,13420.0,8,5964,4,13415.0,5,13420.0,7,S
2018-04-23 21:47:00,13410.0,4,5968,-2,13410.0,7,13420.0,7,S
2018-04-23 21:47:00,13410.0,2,5970,-2,13410.0,27,13420.0,6,S
2018-04-23 21:47:01,13410.0,4,5974,-2,13410.0,40,13420.0,6,S
2018-04-23 21:47:06,13415.0,2,5976,2,13415.0,4,13420.0,5,B
2018-04-23 21:47:10,13415.0,2,5978,0,13410.0,28,13420.0,10,B
2018-04-23 21:47:11,13415.0,8,5986,-6,13410.0,28,13420.0,9,B
2018-04-23 21:47:33,13415.0,2,5988,-2,13410.0,4,13415.0,4,B
2018-04-23 21:47:41,13410.0,2,5990,0,13410.0,3,13415.0,1,S
2018-04-23 21:47:41,13410.0,6,5996,2,13405.0,56,13410.0,2,S
2018-04-23 21:47:42,13410.0,4,6000,2,13405.0,59,13415.0,3,S
2018-04-23 21:47:50,13415.0,2,6002,0,13410.0,2,13415.0,7,B
2018-04-23 21:47:58,13410.0,4,6006,-2,13410.0,2,13415.0,8,S
2018-04-23 21:48:22,13415.0,8,6014,4,13415.0,1,13420.0,27,B
2018-04-23 21:48:22,13420.0,6,6020,2,13420.0,1,13425.0,10,B
2018-04-23 21:48:23,13420.0,2,6022,0,13420.0,1,13425.0,10,B
2018-04-23 21:48:23,13420.0,2,6024,2,13420.0,1,13425.0,11,B
2018-04-23 21:48:24,13420.0,2,6026,-2,13415.0,37,13425.0,11,B
2018-04-23 21:48:43,13425.0,2,6028,0,13420.0,6,13425.0,2,B
2018-04-23 21:48:54,13425.0,2,6030,2,13420.0,9,13430.0,8,B
2018-04-23 21:48:57,13425.0,2,6032,2,13425.0,2,13430.0,8,B
2018-04-23 21:48:58,13425.0,4,6036,0,13420.0,10,13425.0,2,B
2018-04-23 21:48:58,13425.0,2,6038,-2,13420.0,6,13425.0,2,B
2018-04-23 21:48:59,13425.0,2,6040,2,13420.0,6,13425.0,1,B
2018-04-23 21:49:08,13425.0,2,6042,2,13420.0,8,13425.0,2,B
2018-04-23 21:49:16,13425.0,2,6044,0,13420.0,10,13425.0,1,B
2018-04-23 21:49:43,13425.0,2,6046,2,13420.0,9,13425.0,4,B
2018-04-23 21:50:02,13420.0,4,6050,2,13420.0,2,13425.0,19,S
2018-04-23 21:50:03,13420.0,4,6054,2,13415.0,13,13425.0,31,S
2018-04-23 21:50:14,13420.0,8,6062,-4,13415.0,31,13420.0,1,S
2018-04-23 21:50:15,13420.0,2,6064,-2,13420.0,1,13425.0,7,S
2018-04-23 21:50:54,13420.0,2,6066,0,13420.0,2,13425.0,3,S
2018-04-23 21:51:15,13420.0,2,6068,2,13415.0,11,13425.0,28,S
2018-04-23 21:51:20,13420.0,2,6070,0,13415.0,12,13420.0,2,S
2018-04-23 21:51:37,13420.0,6,6076,0,13415.0,9,13420.0,2,S
2018-04-23 21:51:38,13415.0,2,6078,-2,13415.0,8,13420.0,2,S
2018-04-23 21:51:43,13415.0,16,6094,-2,13410.0,7,13415.0,5,S
2018-04-23 21:51:45,13415.0,10,6104,0,13410.0,2,13415.0,2,S
2018-04-23 21:51:48,13415.0,6,6110,4,13410.0,2,13420.0,29,S
2018-04-23 21:52:21,13415.0,8,6118,0,13415.0,3,13420.0,26,S
2018-04-23 21:52:30,13415.0,2,6120,2,13415.0,7,13420.0,1,S
2018-04-23 21:52:39,13420.0,2,6122,0,13415.0,11,13425.0,21,B
2018-04-23 21:52:41,13420.0,2,6124,-2,13420.0,4,13425.0,2,B
2018-04-23 21:52:44,13420.0,2,6126,-2,13420.0,3,13425.0,4,B
2018-04-23 21:53:18,13420.0,2,6128,0,13420.0,4,13425.0,5,B
2018-04-23 21:53:27,13425.0,2,6130,0,13420.0,4,13425.0,3,B
2018-04-23 21:53:35,13425.0,2,6132,0,13420.0,4,13425.0,2,B
2018-04-23 21:53:48,13425.0,2,6134,2,13420.0,4,13425.0,3,B
2018-04-23 21:53:51,13420.0,8,6142,4,13415.0,21,13420.0,11,S
2018-04-23 21:53:51,13420.0,4,6146,0,13415.0,23,13420.0,9,S
2018-04-23 21:53:52,13420.0,2,6148,2,13415.0,28,13420.0,8,S
2018-04-23 21:53:54,13420.0,2,6150,0,13415.0,40,13420.0,7,S
2018-04-23 21:54:01,13420.0,2,6152,0,13415.0,28,13420.0,6,S
2018-04-23 21:54:02,13420.0,12,6164,12,13415.0,28,13425.0,9,S
2018-04-23 21:54:07,13425.0,2,6166,2,13420.0,4,13425.0,8,B
2018-04-23 21:54:17,13425.0,4,6170,2,13420.0,10,13425.0,1,B
2018-04-23 21:54:17,13425.0,2,6172,0,13420.0,22,13430.0,10,B
2018-04-23 21:55:02,13430.0,2,6174,2,13425.0,4,13430.0,2,B
2018-04-23 21:55:07,13420.0,14,6188,-2,13420.0,9,13430.0,23,S
2018-04-23 21:55:10,13425.0,4,6192,2,13420.0,6,13425.0,2,B
2018-04-23 21:56:06,13420.0,2,6194,0,13420.0,5,13425.0,2,S
2018-04-23 21:56:08,13425.0,2,6196,-2,13420.0,39,13430.0,8,B
2018-04-23 21:56:12,13425.0,2,6198,0,13420.0,39,13430.0,9,B
2018-04-23 21:56:19,13425.0,2,6200,0,13420.0,9,13425.0,1,B
2018-04-23 21:56:46,13425.0,8,6208,-6,13420.0,6,13430.0,29,B
2018-04-23 21:57:16,13430.0,2,6210,2,13425.0,1,13430.0,10,B
2018-04-23 21:57:18,13430.0,10,6220,4,13425.0,10,13435.0,28,B
2018-04-23 21:57:40,13430.0,6,6226,6,13425.0,27,13435.0,15,B
2018-04-23 21:57:41,13435.0,2,6228,2,13425.0,27,13435.0,14,B
2018-04-23 21:59:13,13430.0,2,6230,0,13430.0,1,13435.0,14,S
2018-04-23 21:59:14,13430.0,2,6232,0,13425.0,10,13430.0,2,S
2018-04-23 21:59:18,13430.0,2,6234,0,13425.0,6,13430.0,2,S
2018-04-23 22:00:35,13430.0,2,6236,0,13425.0,8,13430.0,3,S
2018-04-23 22:00:38,13425.0,4,6240,-2,13425.0,6,13430.0,3,S
2018-04-23 22:01:43,13425.0,2,6242,-2,13425.0,7,13430.0,8,S
2018-04-23 22:01:43,13425.0,14,6256,0,13420.0,21,13425.0,12,S
2018-04-23 22:01:44,13420.0,8,6264,-4,13420.0,13,13425.0,4,S
2018-04-23 22:02:45,13420.0,2,6266,0,13420.0,11,13425.0,4,S
2018-04-23 22:03:12,13420.0,4,6270,0,13420.0,9,13425.0,5,S
2018-04-23 22:03:12,13420.0,6,6276,2,13420.0,6,13425.0,5,S
2018-04-23 22:03:17,13420.0,12,6288,-8,13415.0,11,13425.0,30,S
2018-04-23 22:03:35,13415.0,2,6290,-2,13415.0,3,13420.0,7,S
2018-04-23 22:03:44,13415.0,2,6292,0,13415.0,2,13420.0,7,S
2018-04-23 22:03:56,13420.0,2,6294,0,13415.0,2,13420.0,4,B
2018-04-23 22:03:57,13415.0,2,6296,-2,13415.0,1,13420.0,4,S
2018-04-23 22:03:58,13415.0,2,6298,0,13410.0,18,13420.0,4,S
2018-04-23 22:04:09,13415.0,6,6304,0,13410.0,8,13420.0,12,S
2018-04-23 22:04:14,13415.0,4,6308,0,13415.0,3,13420.0,10,S
2018-04-23 22:04:15,13415.0,2,6310,0,13415.0,2,13420.0,9,S
2018-04-23 22:04:59,13410.0,2,6312,0,13410.0,1,13415.0,3,S
2018-04-23 22:05:05,13415.0,6,6318,-4,13415.0,7,13420.0,7,B
2018-04-23 22:05:22,13415.0,2,6320,-2,13410.0,11,13420.0,13,B
2018-04-23 22:05:32,13420.0,20,6340,6,13410.0,10,13420.0,16,B
2018-04-23 22:05:33,13410.0,20,6360,-18,13405.0,50,13410.0,47,S
2018-04-23 22:05:34,13410.0,10,6370,-4,13405.0,52,13410.0,42,S
2018-04-23 22:05:36,13410.0,2,6372,0,13405.0,40,13410.0,41,S
2018-04-23 22:05:40,13405.0,8,6380,0,13405.0,37,13410.0,41,S
2018-04-23 22:05:40,13405.0,2,6382,0,13405.0,36,13410.0,41,S
2018-04-23 22:05:41,13410.0,8,6390,-8,13405.0,41,13410.0,37,B
2018-04-23 22:05:42,13415.0,82,6472,-68,13410.0,4,13420.0,15,B
2018-04-23 22:05:44,13410.0,2,6474,2,13410.0,5,13420.0,9,S
2018-04-23 22:05:46,13420.0,2,6476,0,13410.0,11,13420.0,8,B
2018-04-23 22:05:49,13420.0,2,6478,0,13410.0,11,13420.0,7,B
2018-04-23 22:06:13,13415.0,2,6480,2,13410.0,16,13415.0,1,S
2018-04-23 22:06:14,13415.0,2,6482,0,13415.0,1,13420.0,5,S
2018-04-23 22:06:22,13420.0,2,6484,2,13410.0,16,13420.0,4,B
2018-04-23 22:07:57,13410.0,12,6496,-6,13410.0,15,13415.0,1,S
2018-04-23 22:07:57,13405.0,38,6534,14,13405.0,17,13410.0,12,S
2018-04-23 22:08:08,13405.0,4,6538,4,13405.0,20,13410.0,1,S
2018-04-23 22:08:12,13410.0,2,6540,0,13405.0,13,13410.0,1,B
2018-04-23 22:08:16,13405.0,4,6544,4,13405.0,11,13410.0,1,S
2018-04-23 22:08:22,13410.0,2,6546,0,13405.0,11,13410.0,3,B
2018-04-23 22:08:26,13405.0,10,6556,10,13405.0,6,13410.0,4,S
2018-04-23 22:08:27,13410.0,2,6558,0,13405.0,6,13410.0,4,B
2018-04-23 22:08:40,13405.0,4,6562,2,13405.0,4,13410.0,3,S
2018-04-23 22:08:40,13405.0,8,6570,-2,13400.0,22,13405.0,4,S
2018-04-23 22:08:42,13400.0,2,6572,2,13400.0,19,13405.0,9,S
2018-04-23 22:08:43,13400.0,20,6592,6,13400.0,20,13410.0,27,S
2018-04-23 22:08:45,13400.0,4,6596,0,13400.0,22,13410.0,27,S
2018-04-23 22:08:48,13400.0,2,6598,0,13400.0,17,13405.0,1,S
2018-04-23 22:08:49,13400.0,4,6602,0,13400.0,15,13405.0,1,S
2018-04-23 22:08:51,13405.0,2,6604,0,13400.0,15,13405.0,1,B
2018-04-23 22:08:52,13400.0,8,6612,0,13400.0,11,13405.0,2,S
2018-04-23 22:09:02,13400.0,2,6614,-2,13400.0,7,13405.0,1,S
2018-04-23 22:09:04,13400.0,4,6618,0,13400.0,5,13405.0,1,S
2018-04-23 22:09:06,13400.0,8,6626,2,13400.0,1,13405.0,1,S
2018-04-23 22:09:09,13405.0,2,6628,0,13400.0,2,13410.0,27,B
2018-04-23 22:09:10,13405.0,2,6630,0,13400.0,2,13405.0,1,B
2018-04-23 22:09:18,13400.0,20,6650,2,13400.0,4,13410.0,27,S
2018-04-23 22:09:19,13405.0,2,6652,2,13400.0,7,13410.0,24,B
2018-04-23 22:09:20,13405.0,2,6654,-2,13405.0,13,13410.0,1,B
2018-04-23 22:09:21,13405.0,2,6656,0,13405.0,12,13410.0,1,B
2018-04-23 22:09:27,13410.0,2,6658,-2,13405.0,4,13410.0,1,B
2018-04-23 22:09:29,13410.0,2,6660,0,13405.0,5,13415.0,34,B
2018-04-23 22:09:35,13415.0,14,6674,8,13405.0,5,13415.0,31,B
2018-04-23 22:09:35,13415.0,2,6676,0,13405.0,7,13415.0,21,B
2018-04-23 22:09:47,13410.0,2,6678,0,13405.0,20,13415.0,61,S
2018-04-23 22:09:49,13410.0,2,6680,0,13405.0,20,13410.0,3,S
2018-04-23 22:09:57,13405.0,10,6690,4,13400.0,27,13405.0,1,S
2018-04-23 22:09:58,13405.0,6,6696,2,13400.0,9,13405.0,4,S
2018-04-23 22:10:02,13405.0,2,6698,0,13400.0,3,13405.0,5,S
2018-04-23 22:10:07,13405.0,4,6702,4,13405.0,2,13410.0,8,S
2018-04-23 22:10:15,13405.0,2,6704,-2,13400.0,25,13410.0,8,S
2018-04-23 22:10:19,13410.0,4,6708,2,13410.0,2,13415.0,58,B
2018-04-23 22:10:20,13410.0,4,6712,0,13405.0,16,13410.0,2,B
2018-04-23 22:10:29,13410.0,2,6714,2,13410.0,2,13415.0,58,B
2018-04-23 22:10:29,13410.0,2,6716,0,13410.0,2,13415.0,58,B
2018-04-23 22:10:30,13410.0,2,6718,2,13405.0,17,13415.0,55,B
2018-04-23 22:10:36,13405.0,2,6720,0,13405.0,16,13415.0,55,S
2018-04-23 22:10:51,13405.0,12,6732,0,13405.0,12,13415.0,58,S
2018-04-23 22:10:59,13405.0,16,6748,-12,13400.0,12,13410.0,5,S
2018-04-23 22:11:07,13405.0,2,6750,2,13400.0,6,13410.0,8,S
2018-04-23 22:11:53,13410.0,2,6752,0,13400.0,14,13410.0,10,B
2018-04-23 22:12:09,13400.0,2,6754,0,13400.0,7,13405.0,10,S
2018-04-23 22:12:24,13400.0,12,6766,-10,13395.0,9,13400.0,4,S
2018-04-23 22:12:24,13400.0,6,6772,-4,13395.0,9,13400.0,1,S
2018-04-23 22:12:25,13400.0,2,6774,0,13395.0,9,13405.0,11,S
2018-04-23 22:12:33,13395.0,2,6776,0,13395.0,7,13400.0,3,S
2018-04-23 22:12:33,13395.0,8,6784,-4,13395.0,3,13400.0,3,S
2018-04-23 22:12:42,13390.0,4,6788,0,13390.0,31,13400.0,5,S
2018-04-23 22:12:42,13390.0,4,6792,-4,13390.0,29,13400.0,5,S
2018-04-23 22:12:43,13390.0,4,6796,0,13390.0,27,13400.0,5,S
2018-04-23 22:12:45,13390.0,4,6800,0,13390.0,25,13400.0,6,S
2018-04-23 22:12:46,13390.0,4,6804,0,13390.0,23,13400.0,6,S
2018-04-23 22:12:48,13390.0,4,6808,0,13390.0,21,13400.0,6,S
2018-04-23 22:12:56,13395.0,2,6810,-2,13395.0,4,13400.0,6,B
2018-04-23 22:12:59,13395.0,4,6814,0,13395.0,2,13400.0,7,B
2018-04-23 22:13:02,13395.0,4,6818,2,13390.0,21,13400.0,7,B
2018-04-23 22:13:07,13390.0,2,6820,0,13390.0,12,13395.0,3,S
2018-04-23 22:13:07,13390.0,4,6824,0,13390.0,10,13395.0,3,S
2018-04-23 22:13:15,13390.0,2,6826,0,13390.0,6,13395.0,3,S
2018-04-23 22:13:15,13390.0,2,6828,0,13390.0,6,13395.0,3,S
2018-04-23 22:13:16,13390.0,4,6832,0,13390.0,4,13395.0,3,S
2018-04-23 22:13:18,13390.0,4,6836,-4,13390.0,2,13395.0,9,S
2018-04-23 22:13:18,13390.0,4,6840,0,13385.0,8,13390.0,1,S
2018-04-23 22:13:21,13385.0,2,6842,0,13385.0,4,13390.0,8,S
2018-04-23 22:13:24,13385.0,2,6844,-2,13385.0,3,13390.0,5,S
2018-04-23 22:13:25,13385.0,2,6846,0,13385.0,2,13390.0,5,S
2018-04-23 22:13:26,13385.0,4,6850,2,13385.0,3,13390.0,5,S
2018-04-23 22:13:28,13385.0,2,6852,-2,13385.0,2,13390.0,7,S
2018-04-23 22:13:28,13385.0,4,6856,0,13380.0,8,13390.0,4,S
2018-04-23 22:13:30,13380.0,2,6858,0,13380.0,13,13390.0,5,S
2018-04-23 22:13:35,13380.0,14,6872,8,13375.0,4,13385.0,2,S
2018-04-23 22:13:35,13375.0,8,6880,0,13370.0,3,13380.0,10,S
2018-04-23 22:13:36,13370.0,4,6884,2,13370.0,1,13375.0,6,S
2018-04-23 22:13:36,13370.0,2,6886,2,13365.0,1,13370.0,1,S
2018-04-23 22:13:37,13370.0,20,6906,4,13370.0,8,13375.0,10,S
2018-04-23 22:13:37,13375.0,20,6926,0,13375.0,2,13380.0,9,B
2018-04-23 22:13:38,13380.0,4,6930,2,13375.0,3,13380.0,1,B
2018-04-23 22:13:38,13380.0,2,6932,0,13375.0,7,13385.0,6,B
2018-04-23 22:13:39,13380.0,4,6936,4,13380.0,2,13385.0,1,B
2018-04-23 22:13:40,13385.0,2,6938,2,13375.0,6,13390.0,8,B
2018-04-23 22:13:44,13385.0,2,6940,2,13375.0,7,13385.0,8,B
2018-04-23 22:13:46,13375.0,2,6942,0,13375.0,1,13380.0,2,S
2018-04-23 22:13:47,13380.0,6,6948,4,13370.0,10,13380.0,3,B
2018-04-23 22:13:50,13375.0,2,6950,0,13370.0,12,13380.0,9,S
2018-04-23 22:13:53,13370.0,8,6958,4,13370.0,4,13380.0,9,S
2018-04-23 22:13:55,13380.0,4,6962,-2,13365.0,9,13380.0,9,B
2018-04-23 22:13:56,13365.0,14,6976,0,13365.0,3,13375.0,2,S
2018-04-23 22:13:57,13370.0,2,6978,0,13365.0,4,13370.0,3,B
2018-04-23 22:13:58,13365.0,2,6980,0,13365.0,1,13370.0,3,S
2018-04-23 22:13:59,13365.0,2,6982,2,13360.0,4,13370.0,3,S
2018-04-23 22:14:03,13365.0,4,6986,2,13360.0,3,13365.0,2,S
2018-04-23 22:14:05,13360.0,12,6998,8,13355.0,5,13365.0,5,S
2018-04-23 22:14:06,13355.0,12,7010,6,13355.0,1,13365.0,7,S
2018-04-23 22:14:06,13365.0,8,7018,-4,13355.0,1,13365.0,5,B
2018-04-23 22:14:07,13355.0,2,7020,2,13350.0,25,13365.0,5,S
2018-04-23 22:14:08,13350.0,2,7022,2,13350.0,28,13360.0,2,S
2018-04-23 22:14:11,13360.0,4,7026,2,13350.0,32,13365.0,4,B
2018-04-23 22:14:16,13365.0,6,7032,0,13360.0,4,13370.0,6,B
2018-04-23 22:14:16,13365.0,6,7038,0,13360.0,3,13365.0,1,B
2018-04-23 22:14:18,13365.0,2,7040,0,13360.0,3,13365.0,6,B
2018-04-23 22:14:23,13365.0,2,7042,0,13365.0,4,13370.0,10,B
2018-04-23 22:14:24,13370.0,4,7046,0,13365.0,4,13370.0,8,B
2018-04-23 22:14:24,13370.0,2,7048,-2,13365.0,4,13370.0,7,B
2018-04-23 22:14:26,13365.0,8,7056,-8,13360.0,10,13370.0,5,S
2018-04-23 22:14:28,13365.0,4,7060,0,13360.0,12,13370.0,5,S
2018-04-23 22:14:29,13370.0,2,7062,0,13360.0,12,13370.0,4,B
2018-04-23 22:14:34,13370.0,2,7064,0,13365.0,2,13375.0,22,B
2018-04-23 22:14:36,13365.0,4,7068,2,13365.0,6,13375.0,25,S
2018-04-23 22:14:40,13370.0,4,7072,-2,13370.0,5,13375.0,16,B
2018-04-23 22:14:41,13370.0,2,7074,0,13370.0,4,13375.0,16,B
2018-04-23 22:14:42,13370.0,8,7082,2,13365.0,8,13375.0,16,B
2018-04-23 22:14:49,13365.0,2,7084,0,13365.0,6,13370.0,1,S
2018-04-23 22:14:52,13370.0,2,7086,0,13370.0,2,13375.0,18,B
2018-04-23 22:14:52,13370.0,4,7090,-4,13365.0,6,13375.0,21,B
2018-04-23 22:14:56,13365.0,2,7092,-2,13365.0,3,13375.0,23,S
2018-04-23 22:14:58,13370.0,2,7094,0,13365.0,2,13370.0,1,B
2018-04-23 22:15:01,13365.0,4,7098,0,13360.0,11,13365.0,1,S
2018-04-23 22:15:03,13360.0,2,7100,-2,13360.0,10,13365.0,2,S
2018-04-23 22:15:06,13360.0,14,7114,6,13355.0,5,13365.0,5,S
2018-04-23 22:15:08,13355.0,10,7124,4,13350.0,33,13355.0,1,S
2018-04-23 22:15:08,13355.0,8,7132,8,13350.0,33,13355.0,22,S
2018-04-23 22:15:09,13355.0,4,7136,4,13350.0,35,13355.0,20,S
2018-04-23 22:15:09,13355.0,2,7138,2,13350.0,35,13355.0,20,S
2018-04-23 22:15:10,13355.0,2,7140,2,13350.0,35,13355.0,19,S
2018-04-23 22:15:11,13350.0,4,7144,4,13350.0,32,13355.0,19,S
2018-04-23 22:15:12,13350.0,8,7152,4,13350.0,28,13355.0,19,S
2018-04-23 22:15:13,13350.0,2,7154,0,13350.0,30,13355.0,19,S
2018-04-23 22:15:14,13350.0,6,7160,4,13350.0,28,13355.0,17,S
2018-04-23 22:15:17,13350.0,10,7170,-2,13350.0,23,13355.0,17,S
2018-04-23 22:15:20,13355.0,4,7174,2,13350.0,23,13355.0,15,B
2018-04-23 22:15:21,13350.0,2,7176,0,13350.0,21,13355.0,16,S
2018-04-23 22:15:22,13355.0,6,7182,4,13350.0,21,13355.0,13,B
2018-04-23 22:15:26,13350.0,2,7184,0,13350.0,20,13355.0,15,S
2018-04-23 22:15:32,13355.0,10,7194,10,13350.0,23,13355.0,10,B
2018-04-23 22:15:32,13355.0,20,7214,16,13350.0,27,13360.0,3,B
2018-04-23 22:15:37,13355.0,4,7218,-2,13350.0,27,13355.0,2,B
2018-04-23 22:15:37,13355.0,4,7222,-4,13350.0,27,13360.0,4,B
2018-04-23 22:15:41,13355.0,6,7228,2,13355.0,3,13360.0,9,B
2018-04-23 22:15:41,13355.0,8,7236,0,13350.0,25,13360.0,10,B
2018-04-23 22:15:43,13350.0,2,7238,2,13350.0,23,13360.0,11,S
2018-04-23 22:15:44,13350.0,2,7240,2,13350.0,22,13360.0,11,S
2018-04-23 22:15:45,13350.0,40,7280,-10,13350.0,4,13360.0,12,S
2018-04-23 22:15:46,13355.0,2,7282,2,13350.0,4,13360.0,12,B
2018-04-23 22:15:52,13350.0,2,7284,2,13350.0,6,13355.0,3,S
2018-04-23 22:15:55,13355.0,2,7286,2,13350.0,6,13355.0,2,B
2018-04-23 22:15:59,13350.0,2,7288,0,13345.0,18,13355.0,13,S
2018-04-23 22:16:02,13345.0,2,7290,0,13345.0,9,13355.0,17,S
2018-04-23 22:16:03,13345.0,2,7292,0,13345.0,6,13355.0,22,S
2018-04-23 22:16:03,13345.0,2,7294,-2,13345.0,5,13355.0,22,S
2018-04-23 22:16:05,13345.0,16,7310,-2,13340.0,4,13345.0,3,S
2018-04-23 22:16:06,13345.0,2,7312,-2,13340.0,4,13345.0,4,S
2018-04-23 22:16:06,13340.0,8,7320,2,13335.0,6,13345.0,9,S
2018-04-23 22:16:07,13335.0,8,7328,-2,13335.0,3,13345.0,11,S
2018-04-23 22:16:07,13335.0,6,7334,0,13340.0,1,13345.0,7,S
2018-04-23 22:16:08,13345.0,2,7336,2,13340.0,7,13345.0,2,B
2018-04-23 22:16:09,13345.0,4,7340,2,13340.0,2,13345.0,1,B
2018-04-23 22:16:13,13340.0,4,7344,-2,13335.0,11,13345.0,2,S
2018-04-23 22:16:14,13340.0,2,7346,0,13335.0,12,13345.0,5,S
2018-04-23 22:16:18,13340.0,4,7350,-2,13335.0,8,13345.0,13,S
2018-04-23 22:16:19,13340.0,30,7380,-12,13340.0,36,13345.0,13,S
2018-04-23 22:16:20,13340.0,58,7438,-32,13340.0,7,13345.0,14,S
2018-04-23 22:16:20,13340.0,14,7452,-2,13335.0,5,13340.0,5,S
2018-04-23 22:16:21,13340.0,2,7454,0,13335.0,5,13340.0,3,S
2018-04-23 22:16:21,13335.0,2,7456,0,13335.0,4,13340.0,4,S
2018-04-23 22:16:22,13340.0,2,7458,2,13335.0,4,13340.0,1,B
2018-04-23 22:16:22,13340.0,2,7460,0,13335.0,5,13340.0,2,B
2018-04-23 22:16:23,13340.0,4,7464,0,13335.0,5,13340.0,1,B
2018-04-23 22:16:24,13340.0,2,7466,0,13335.0,5,13340.0,2,B
2018-04-23 22:16:25,13340.0,2,7468,2,13335.0,6,13340.0,4,B
2018-04-23 22:16:25,13340.0,6,7474,4,13335.0,11,13340.0,1,B
2018-04-23 22:16:26,13340.0,4,7478,2,13335.0,11,13340.0,5,B
2018-04-23 22:16:26,13340.0,4,7482,0,13335.0,11,13340.0,3,B
2018-04-23 22:16:30,13335.0,2,7484,-2,13335.0,6,13340.0,16,S
2018-04-23 22:16:32,13335.0,2,7486,0,13335.0,5,13340.0,15,S
2018-04-23 22:16:35,13340.0,34,7520,20,13335.0,7,13345.0,12,B
2018-04-23 22:16:36,13335.0,26,7546,-8,13335.0,11,13345.0,14,S
2018-04-23 22:16:39,13335.0,14,7560,-14,13335.0,2,13345.0,18,S
2018-04-23 22:16:41,13335.0,22,7582,-8,13335.0,2,13345.0,18,S
2018-04-23 22:16:54,13340.0,2,7584,0,13340.0,5,13345.0,15,B
2018-04-23 22:16:54,13340.0,6,7590,0,13340.0,2,13345.0,15,B
2018-04-23 22:16:55,13340.0,2,7592,0,13340.0,1,13345.0,15,B
2018-04-23 22:16:57,13340.0,2,7594,0,13335.0,9,13345.0,15,B
2018-04-23 22:16:59,13345.0,8,7602,-2,13340.0,6,13345.0,11,B
2018-04-23 22:17:00,13340.0,4,7606,-2,13340.0,5,13345.0,11,S
2018-04-23 22:17:02,13340.0,12,7618,4,13340.0,2,13345.0,11,S
2018-04-23 22:17:05,13345.0,2,7620,2,13340.0,4,13345.0,10,B
2018-04-23 22:17:07,13345.0,2,7622,2,13340.0,6,13345.0,9,B
2018-04-23 22:17:09,13345.0,2,7624,2,13340.0,4,13345.0,10,B
2018-04-23 22:17:16,13345.0,2,7626,2,13340.0,6,13345.0,7,B
2018-04-23 22:17:18,13345.0,2,7628,0,13340.0,6,13345.0,6,B
2018-04-23 22:17:22,13345.0,2,7630,2,13340.0,6,13345.0,5,B
2018-04-23 22:17:30,13345.0,2,7632,0,13340.0,6,13345.0,6,B
2018-04-23 22:17:35,13340.0,2,7634,0,13340.0,5,13345.0,6,S
2018-04-23 22:17:40,13345.0,4,7638,4,13340.0,7,13345.0,3,B
2018-04-23 22:17:41,13345.0,2,7640,0,13340.0,7,13345.0,2,B
2018-04-23 22:17:48,13340.0,12,7652,-4,13340.0,1,13345.0,3,S
2018-04-23 22:17:52,13345.0,2,7654,0,13340.0,4,13345.0,2,B
2018-04-23 22:18:00,13345.0,4,7658,-4,13340.0,5,13350.0,10,B
2018-04-23 22:18:08,13355.0,8,7666,-2,13345.0,7,13355.0,7,B
2018-04-23 22:18:09,13355.0,10,7676,-8,13350.0,7,13360.0,12,B
2018-04-23 22:18:16,13360.0,4,7680,0,13355.0,1,13360.0,9,B
2018-04-23 22:18:23,13360.0,2,7682,-2,13355.0,2,13360.0,3,B
2018-04-23 22:18:27,13360.0,6,7688,2,13355.0,2,13360.0,1,B
2018-04-23 22:18:33,13365.0,2,7690,-2,13360.0,6,13365.0,10,B
2018-04-23 22:18:34,13360.0,30,7720,-2,13355.0,9,13360.0,1,S
2018-04-23 22:18:34,13365.0,4,7724,0,13360.0,14,13365.0,3,B
2018-04-23 22:18:35,13365.0,6,7730,6,13365.0,1,13370.0,9,B
2018-04-23 22:18:36,13360.0,4,7734,-2,13360.0,9,13370.0,12,S
2018-04-23 22:18:38,13365.0,4,7738,-4,13365.0,2,13370.0,8,B
2018-04-23 22:18:39,13370.0,6,7744,2,13370.0,1,13375.0,20,B
2018-04-23 22:18:39,13370.0,2,7746,0,13365.0,16,13375.0,23,B
2018-04-23 22:18:41,13375.0,2,7748,-2,13365.0,16,13375.0,23,B
2018-04-23 22:18:42,13375.0,2,7750,-2,13365.0,16,13370.0,1,B
2018-04-23 22:18:42,13370.0,8,7758,-2,13370.0,3,13375.0,23,S
2018-04-23 22:18:45,13370.0,4,7762,0,13370.0,1,13375.0,24,S
2018-04-23 22:18:45,13370.0,2,7764,2,13365.0,16,13375.0,24,S
2018-04-23 22:18:46,13375.0,4,7768,0,13365.0,16,13375.0,24,B
2018-04-23 22:18:47,13375.0,10,7778,-10,13365.0,16,13375.0,19,B
2018-04-23 22:18:50,13370.0,2,7780,0,13370.0,3,13375.0,18,S
2018-04-23 22:18:52,13370.0,16,7796,-2,13365.0,10,13375.0,17,S
2018-04-23 22:18:53,13365.0,2,7798,-2,13360.0,6,13370.0,25,S
2018-04-23 22:18:55,13360.0,2,7800,0,13355.0,10,13365.0,11,S
2018-04-23 22:19:01,13365.0,2,7802,0,13360.0,12,13365.0,1,B
2018-04-23 22:19:01,13360.0,20,7822,-2,13360.0,2,13365.0,1,S
2018-04-23 22:19:10,13365.0,2,7824,0,13360.0,4,13365.0,1,B
2018-04-23 22:19:24,13365.0,2,7826,0,13365.0,1,13370.0,28,B
2018-04-23 22:19:25,13365.0,2,7828,0,13360.0,9,13370.0,29,B
2018-04-23 22:19:27,13365.0,2,7830,2,13365.0,2,13370.0,21,B
2018-04-23 22:19:31,13365.0,4,7834,0,13360.0,13,13365.0,4,B
2018-04-23 22:19:32,13365.0,8,7842,2,13365.0,2,13370.0,20,B
2018-04-23 22:19:32,13365.0,2,7844,2,13360.0,15,13370.0,22,B
2018-04-23 22:19:36,13365.0,10,7854,-2,13360.0,13,13365.0,9,B
2018-04-23 22:19:40,13365.0,2,7856,-2,13360.0,10,13365.0,9,B
2018-04-23 22:19:44,13365.0,2,7858,-2,13360.0,10,13365.0,8,B
2018-04-23 22:19:47,13365.0,16,7874,-2,13360.0,11,13370.0,23,B
2018-04-23 22:19:50,13365.0,16,7890,10,13365.0,2,13370.0,26,B
2018-04-23 22:19:50,13365.0,4,7894,0,13360.0,10,13370.0,26,B
2018-04-23 22:19:55,13365.0,2,7896,2,13365.0,2,13370.0,26,B
2018-04-23 22:19:55,13365.0,4,7900,4,13360.0,8,13370.0,26,B
2018-04-23 22:19:59,13370.0,2,7902,-2,13360.0,5,13370.0,25,B
2018-04-23 22:20:05,13360.0,2,7904,0,13360.0,5,13365.0,11,S
2018-04-23 22:20:05,13360.0,10,7914,-2,13355.0,10,13365.0,14,S
2018-04-23 22:20:12,13355.0,2,7916,2,13355.0,5,13365.0,17,S
2018-04-23 22:20:13,13355.0,4,7920,-2,13350.0,11,13360.0,12,S
2018-04-23 22:20:20,13350.0,20,7940,-4,13350.0,1,13360.0,13,S
2018-04-23 22:20:29,13350.0,28,7968,18,13345.0,16,13350.0,14,S
2018-04-23 22:20:30,13355.0,30,7998,14,13350.0,12,13360.0,10,B
2018-04-23 22:20:31,13350.0,2,8000,-2,13350.0,7,13360.0,9,S
2018-04-23 22:20:37,13350.0,2,8002,0,13350.0,2,13355.0,8,S
2018-04-23 22:20:56,13355.0,2,8004,-2,13350.0,9,13355.0,7,B
2018-04-23 22:21:06,13355.0,4,8008,2,13350.0,9,13355.0,2,B
2018-04-23 22:21:10,13355.0,2,8010,0,13350.0,9,13355.0,1,B
2018-04-23 22:21:20,13355.0,2,8012,2,13350.0,13,13360.0,8,B
2018-04-23 22:21:25,13360.0,4,8016,2,13355.0,2,13360.0,9,B
2018-04-23 22:21:45,13355.0,2,8018,2,13355.0,8,13360.0,3,S
2018-04-23 22:21:49,13355.0,2,8020,2,13355.0,7,13360.0,6,S
2018-04-23 22:21:53,13355.0,4,8024,0,13355.0,5,13360.0,8,S
2018-04-23 22:21:54,13360.0,2,8026,2,13355.0,5,13360.0,7,B
2018-04-23 22:21:55,13355.0,4,8030,-4,13355.0,3,13360.0,7,S
2018-04-23 22:21:58,13355.0,4,8034,-4,13355.0,1,13360.0,8,S
2018-04-23 22:21:59,13355.0,2,8036,-2,13350.0,15,13355.0,8,S
2018-04-23 22:22:02,13350.0,6,8042,4,13350.0,12,13355.0,6,S
2018-04-23 22:22:04,13355.0,6,8048,0,13350.0,13,13360.0,9,B
2018-04-23 22:22:09,13360.0,2,8050,0,13355.0,4,13360.0,8,B
2018-04-23 22:22:14,13360.0,4,8054,2,13355.0,5,13365.0,16,B
2018-04-23 22:22:34,13360.0,2,8056,2,13360.0,2,13365.0,4,B
2018-04-23 22:22:38,13370.0,10,8066,10,13360.0,4,13370.0,37,B
2018-04-23 22:22:46,13370.0,2,8068,2,13360.0,4,13370.0,38,B
2018-04-23 22:22:57,13370.0,2,8070,2,13360.0,6,13370.0,39,B
2018-04-23 22:22:59,13365.0,2,8072,2,13360.0,58,13370.0,39,S
2018-04-23 22:23:02,13360.0,2,8074,0,13360.0,56,13365.0,5,S
2018-04-23 22:23:05,13365.0,6,8080,4,13360.0,51,13365.0,8,B
2018-04-23 22:23:11,13365.0,6,8086,0,13360.0,52,13365.0,3,B
2018-04-23 22:23:11,13360.0,6,8092,2,13360.0,49,13365.0,4,S
2018-04-23 22:23:17,13365.0,2,8094,-2,13360.0,49,13365.0,3,B
2018-04-23 22:23:17,13365.0,4,8098,-2,13360.0,49,13365.0,1,B
2018-04-23 22:23:18,13360.0,2,8100,0,13360.0,48,13365.0,1,S
2018-04-23 22:23:19,13360.0,4,8104,-4,13360.0,46,13365.0,18,S
2018-04-23 22:23:25,13365.0,2,8106,0,13360.0,47,13365.0,1,B
2018-04-23 22:23:26,13360.0,2,8108,0,13360.0,45,13365.0,5,S
2018-04-23 22:23:27,13360.0,4,8112,-4,13360.0,43,13365.0,13,S
2018-04-23 22:23:33,13360.0,2,8114,0,13360.0,42,13365.0,14,S
2018-04-23 22:23:38,13365.0,4,8118,-4,13360.0,48,13370.0,38,B
2018-04-23 22:23:40,13365.0,2,8120,2,13360.0,46,13370.0,43,B
2018-04-23 22:23:43,13365.0,4,8124,0,13360.0,46,13370.0,43,B
2018-04-23 22:23:53,13365.0,10,8134,8,13365.0,2,13370.0,38,B
2018-04-23 22:23:56,13365.0,2,8136,2,13360.0,50,13370.0,34,B
2018-04-23 22:23:58,13365.0,6,8142,-6,13360.0,50,13365.0,7,B
2018-04-23 22:23:58,13365.0,4,8146,0,13360.0,50,13365.0,5,B
2018-04-23 22:23:59,13365.0,2,8148,-2,13360.0,50,13365.0,4,B
2018-04-23 22:23:59,13365.0,8,8156,-8,13360.0,50,13370.0,34,B
2018-04-23 22:24:17,13380.0,100,8256,56,13365.0,49,13380.0,10,B
2018-04-23 22:24:18,13370.0,8,8264,2,13365.0,52,13375.0,11,S
2018-04-23 22:24:22,13380.0,72,8336,20,13380.0,14,13385.0,33,B
2018-04-23 22:24:23,13380.0,4,8340,4,13380.0,18,13385.0,35,B
2018-04-23 22:24:23,13385.0,18,8358,10,13380.0,19,13385.0,27,B
2018-04-23 22:24:24,13385.0,58,8416,-2,13380.0,19,13390.0,42,B
2018-04-23 22:24:25,13385.0,2,8418,-2,13380.0,17,13385.0,5,B
2018-04-23 22:24:27,13385.0,4,8422,0,13380.0,19,13390.0,44,B
2018-04-23 22:24:28,13380.0,38,8460,30,13375.0,5,13380.0,31,S
2018-04-23 22:24:30,13380.0,4,8464,2,13375.0,8,13380.0,30,S
2018-04-23 22:24:32,13375.0,2,8466,-2,13375.0,8,13380.0,30,S
2018-04-23 22:24:41,13375.0,4,8470,-4,13375.0,3,13380.0,32,S
2018-04-23 22:24:41,13375.0,8,8478,-4,13370.0,54,13375.0,1,S
2018-04-23 22:24:42,13375.0,6,8484,-6,13370.0,52,13375.0,6,S
2018-04-23 22:24:45,13375.0,2,8486,-2,13370.0,49,13375.0,4,S
2018-04-23 22:24:45,13375.0,2,8488,-2,13370.0,49,13375.0,3,S
2018-04-23 22:24:49,13370.0,2,8490,2,13370.0,49,13375.0,3,S
2018-04-23 22:24:49,13375.0,2,8492,0,13370.0,49,13375.0,2,B
2018-04-23 22:24:51,13375.0,4,8496,0,13375.0,3,13380.0,41,B
2018-04-23 22:24:55,13380.0,10,8506,0,13375.0,8,13380.0,29,B
2018-04-23 22:24:57,13380.0,2,8508,2,13375.0,8,13380.0,28,B
2018-04-23 22:24:58,13380.0,56,8564,56,13380.0,22,13385.0,5,B
2018-04-23 22:25:01,13385.0,2,8566,0,13380.0,22,13385.0,6,B
2018-04-23 22:25:05,13380.0,2,8568,2,13380.0,21,13385.0,7,S
2018-04-23 22:25:12,13385.0,2,8570,0,13380.0,21,13385.0,6,B
2018-04-23 22:25:14,13380.0,2,8572,2,13380.0,20,13385.0,6,S
2018-04-23 22:25:25,13380.0,2,8574,0,13380.0,20,13385.0,15,S
2018-04-23 22:25:26,13380.0,2,8576,2,13380.0,19,13385.0,15,S
2018-04-23 22:25:55,13385.0,4,8580,2,13380.0,29,13385.0,14,B
2018-04-23 22:25:56,13385.0,28,8608,14,13385.0,3,13390.0,47,B
2018-04-23 22:25:56,13390.0,90,8698,-14,13390.0,1,13395.0,24,B
2018-04-23 22:25:57,13395.0,4,8702,0,13390.0,17,13395.0,22,B
2018-04-23 22:25:57,13395.0,2,8704,-2,13390.0,18,13395.0,20,B
2018-04-23 22:25:58,13395.0,2,8706,0,13390.0,18,13395.0,19,B
2018-04-23 22:26:01,13390.0,8,8714,0,13390.0,15,13395.0,18,S
2018-04-23 22:26:02,13395.0,2,8716,0,13390.0,16,13395.0,17,B
2018-04-23 22:26:02,13395.0,34,8750,-22,13390.0,14,13400.0,8,B
2018-04-23 22:26:03,13395.0,6,8756,2,13390.0,14,13395.0,1,B
2018-04-23 22:26:04,13395.0,2,8758,0,13390.0,14,13400.0,7,B
2018-04-23 22:26:05,13395.0,2,8760,-2,13395.0,5,13400.0,5,B
2018-04-23 22:26:11,13400.0,10,8770,-6,13395.0,4,13400.0,2,B
2018-04-23 22:26:14,13400.0,8,8778,4,13400.0,47,13405.0,24,B
2018-04-23 22:26:15,13400.0,20,8798,20,13400.0,37,13405.0,28,B
2018-04-23 22:26:15,13400.0,48,8846,36,13400.0,13,13405.0,28,B
2018-04-23 22:26:16,13400.0,26,8872,0,13395.0,3,13400.0,7,B
2018-04-23 22:26:16,13400.0,2,8874,0,13395.0,4,13400.0,4,B
2018-04-23 22:26:17,13405.0,10,8884,0,13395.0,5,13405.0,29,B
2018-04-23 22:26:19,13400.0,8,8892,2,13400.0,46,13405.0,32,S
2018-04-23 22:26:19,13400.0,8,8900,0,13400.0,42,13405.0,32,S
2018-04-23 22:26:24,13400.0,52,8952,36,13400.0,21,13405.0,37,S
2018-04-23 22:26:25,13400.0,42,8994,42,13395.0,4,13400.0,10,S
2018-04-23 22:26:27,13400.0,14,9008,4,13395.0,3,13400.0,1,S
2018-04-23 22:26:28,13395.0,2,9010,0,13395.0,2,13400.0,1,S
2018-04-23 22:26:32,13395.0,2,9012,0,13390.0,7,13395.0,4,S
2018-04-23 22:26:33,13390.0,12,9024,-6,13390.0,1,13395.0,1,S
2018-04-23 22:26:33,13390.0,2,9026,-2,13385.0,6,13390.0,7,S
2018-04-23 22:26:35,13390.0,2,9028,-2,13385.0,4,13395.0,16,S
2018-04-23 22:26:48,13385.0,4,9032,0,13385.0,3,13390.0,5,S
2018-04-23 22:26:49,13385.0,4,9036,-4,13385.0,1,13390.0,5,S
2018-04-23 22:26:49,13385.0,2,9038,0,13380.0,64,13385.0,19,S
2018-04-23 22:26:50,13385.0,2,9040,0,13380.0,67,13385.0,18,S
2018-04-23 22:26:53,13400.0,100,9140,78,13385.0,1,13400.0,29,B
2018-04-23 22:26:53,13385.0,4,9144,-4,13385.0,8,13395.0,1,S
2018-04-23 22:26:56,13385.0,6,9150,-2,13380.0,63,13395.0,15,S
2018-04-23 22:26:57,13400.0,44,9194,32,13400.0,28,13405.0,9,B
2018-04-23 22:26:58,13385.0,66,9260,22,13385.0,3,13395.0,2,S
2018-04-23 22:26:59,13390.0,2,9262,2,13385.0,4,13390.0,5,B
2018-04-23 22:26:59,13390.0,2,9264,0,13385.0,4,13395.0,1,B
2018-04-23 22:27:02,13400.0,100,9364,50,13385.0,8,13400.0,12,B
2018-04-23 22:27:03,13390.0,4,9368,-2,13385.0,8,13390.0,1,S
2018-04-23 22:27:03,13390.0,2,9370,0,13390.0,5,13395.0,12,S
2018-04-23 22:27:04,13390.0,4,9374,-4,13390.0,3,13395.0,17,S
2018-04-23 22:27:04,13390.0,6,9380,0,13390.0,1,13395.0,12,S
2018-04-23 22:27:05,13390.0,2,9382,0,13385.0,8,13395.0,25,S
2018-04-23 22:27:06,13400.0,86,9468,60,13400.0,7,13405.0,24,B
2018-04-23 22:27:07,13395.0,16,9484,14,13390.0,1,13395.0,1,S
2018-04-23 22:27:07,13395.0,4,9488,-2,13390.0,1,13400.0,1,S
2018-04-23 22:27:08,13390.0,2,9490,-2,13385.0,21,13400.0,1,S
2018-04-23 22:27:10,13400.0,30,9520,26,13400.0,35,13405.0,24,B
2018-04-23 22:27:11,13400.0,70,9590,32,13390.0,3,13405.0,35,B
2018-04-23 22:27:11,13395.0,2,9592,-2,13385.0,27,13400.0,13,S
2018-04-23 22:27:13,13395.0,2,9594,0,13385.0,27,13400.0,23,S
2018-04-23 22:27:15,13400.0,2,9596,-2,13390.0,8,13400.0,4,B
2018-04-23 22:27:19,13390.0,2,9598,0,13390.0,7,13400.0,6,S
2018-04-23 22:27:19,13390.0,2,9600,0,13390.0,3,13400.0,8,S
2018-04-23 22:27:20,13390.0,2,9602,-2,13390.0,1,13400.0,30,S
2018-04-23 22:27:21,13390.0,2,9604,0,13385.0,31,13400.0,30,S
2018-04-23 22:27:33,13395.0,2,9606,0,13390.0,3,13400.0,23,B
2018-04-23 22:27:38,13390.0,2,9608,0,13390.0,2,13395.0,3,S
2018-04-23 22:27:44,13390.0,4,9612,-2,13390.0,1,13395.0,2,S
2018-04-23 22:27:58,13390.0,2,9614,0,13390.0,4,13395.0,5,S
2018-04-23 22:28:00,13395.0,10,9624,-2,13390.0,4,13400.0,20,B
2018-04-23 22:28:05,13395.0,2,9626,-2,13390.0,9,13400.0,37,B
2018-04-23 22:28:07,13400.0,6,9632,0,13390.0,9,13400.0,42,B
2018-04-23 22:28:13,13395.0,2,9634,0,13395.0,7,13400.0,3,S
2018-04-23 22:28:14,13400.0,6,9640,0,13400.0,1,13405.0,23,B
2018-04-23 22:28:17,13400.0,2,9642,0,13395.0,10,13405.0,23,B
2018-04-23 22:28:29,13400.0,2,9644,0,13400.0,2,13405.0,17,B
2018-04-23 22:28:33,13405.0,8,9652,-2,13400.0,10,13410.0,10,B
2018-04-23 22:28:37,13405.0,10,9662,0,13400.0,14,13405.0,1,B
2018-04-23 22:28:42,13400.0,4,9666,0,13400.0,4,13405.0,34,S
2018-04-23 22:28:42,13395.0,14,9680,-6,13395.0,6,13400.0,8,S
2018-04-23 22:28:44,13400.0,2,9682,2,13395.0,2,13400.0,34,B
2018-04-23 22:28:50,13395.0,2,9684,0,13395.0,3,13400.0,37,S
2018-04-23 22:28:52,13395.0,2,9686,2,13395.0,2,13400.0,37,S
2018-04-23 22:28:53,13400.0,36,9722,30,13395.0,8,13400.0,18,B
2018-04-23 22:28:54,13400.0,36,9758,-12,13400.0,3,13405.0,5,B
2018-04-23 22:28:56,13400.0,8,9766,-2,13395.0,8,13400.0,2,B
2018-04-23 22:28:57,13395.0,12,9778,2,13395.0,3,13400.0,2,S
2018-04-23 22:29:10,13395.0,2,9780,-2,13395.0,2,13400.0,3,S
2018-04-23 22:29:25,13390.0,2,9782,0,13390.0,2,13395.0,1,S
2018-04-23 22:29:26,13390.0,2,9784,0,13390.0,1,13395.0,6,S
2018-04-23 22:29:36,13390.0,2,9786,0,13385.0,8,13395.0,7,S
2018-04-23 22:29:38,13390.0,2,9788,-2,13385.0,4,13390.0,3,S
2018-04-23 22:29:39,13390.0,6,9794,0,13390.0,11,13395.0,12,S
2018-04-23 22:29:39,13395.0,2,9796,-2,13390.0,14,13395.0,3,B
2018-04-23 22:29:45,13395.0,4,9800,-4,13395.0,1,13400.0,9,B
2018-04-23 22:29:47,13400.0,10,9810,0,13400.0,9,13405.0,5,B
2018-04-23 22:29:53,13400.0,2,9812,2,13400.0,1,13405.0,8,B
2018-04-23 22:29:53,13400.0,2,9814,-2,13395.0,11,13400.0,2,B
2018-04-23 22:29:58,13400.0,18,9832,16,13400.0,49,13405.0,8,B
2018-04-23 22:29:59,13400.0,8,9840,8,13400.0,45,13405.0,12,B
2018-04-23 22:30:00,13400.0,2,9842,0,13400.0,44,13405.0,10,B
2018-04-23 22:30:04,13405.0,10,9852,-4,13400.0,44,13405.0,5,B
2018-04-23 22:30:04,13400.0,2,9854,0,13400.0,43,13405.0,5,S
2018-04-23 22:30:08,13400.0,2,9856,2,13400.0,42,13405.0,5,S
2018-04-23 22:30:13,13400.0,2,9858,2,13400.0,41,13405.0,6,S
2018-04-23 22:30:14,13405.0,2,9860,0,13400.0,41,13405.0,5,B
2018-04-23 22:30:19,13405.0,10,9870,-6,13400.0,41,13410.0,13,B
2018-04-23 22:30:21,13405.0,2,9872,0,13400.0,42,13405.0,7,B
2018-04-23 22:30:21,13400.0,2,9874,2,13400.0,41,13405.0,7,S
2018-04-23 22:30:24,13405.0,14,9888,0,13405.0,1,13410.0,18,B
2018-04-23 22:30:25,13405.0,2,9890,0,13400.0,41,13405.0,2,B
2018-04-23 22:30:25,13405.0,4,9894,2,13400.0,41,13410.0,17,B
2018-04-23 22:30:30,13405.0,2,9896,0,13400.0,41,13410.0,18,B
2018-04-23 22:30:31,13405.0,2,9898,0,13405.0,3,13410.0,17,B
2018-04-23 22:30:32,13405.0,4,9902,4,13405.0,1,13410.0,16,B
2018-04-23 22:30:34,13405.0,2,9904,2,13400.0,44,13410.0,16,B
2018-04-23 22:30:35,13405.0,2,9906,0,13405.0,1,13410.0,17,B
2018-04-23 22:30:40,13410.0,14,9920,-4,13405.0,4,13410.0,10,B
2018-04-23 22:30:40,13410.0,6,9926,-2,13405.0,3,13410.0,8,B
2018-04-23 22:30:49,13410.0,32,9958,-16,13410.0,1,13415.0,8,B
2018-04-23 22:30:51,13415.0,4,9962,0,13410.0,5,13415.0,4,B
2018-04-23 22:30:57,13410.0,2,9964,0,13410.0,4,13415.0,3,S
2018-04-23 22:30:58,13410.0,2,9966,0,13410.0,3,13415.0,3,S
2018-04-23 22:31:01,13410.0,6,9972,-2,13405.0,11,13415.0,3,S
2018-04-23 22:31:05,13415.0,4,9976,-2,13410.0,2,13415.0,4,B
2018-04-23 22:31:08,13405.0,6,9982,-2,13405.0,10,13410.0,3,S
2018-04-23 22:31:09,13410.0,2,9984,0,13405.0,7,13410.0,4,B
2018-04-23 22:31:23,13405.0,6,9990,2,13400.0,45,13405.0,2,S
2018-04-23 22:31:23,13405.0,2,9992,-2,13400.0,44,13405.0,8,S
2018-04-23 22:31:27,13400.0,2,9994,2,13400.0,43,13405.0,8,S
2018-04-23 22:31:28,13400.0,2,9996,0,13400.0,42,13405.0,8,S
2018-04-23 22:31:37,13400.0,66,10062,52,13400.0,6,13405.0,12,S
2018-04-23 22:31:37,13400.0,12,10074,10,13395.0,47,13405.0,13,S
2018-04-23 22:31:42,13395.0,2,10076,0,13395.0,52,13405.0,14,S
2018-04-23 22:31:43,13395.0,2,10078,2,13395.0,51,13405.0,14,S
2018-04-23 22:31:54,13405.0,2,10080,-2,13395.0,51,13405.0,14,B
2018-04-23 22:31:56,13395.0,12,10092,-8,13395.0,45,13405.0,14,S
2018-04-23 22:32:04,13395.0,12,10104,-6,13390.0,41,13400.0,11,S
2018-04-23 22:32:08,13390.0,2,10106,0,13390.0,40,13400.0,18,S
2018-04-23 22:32:30,13390.0,2,10108,-2,13390.0,48,13400.0,12,S
2018-04-23 22:32:47,13400.0,2,10110,-2,13395.0,12,13400.0,5,B
2018-04-23 22:32:47,13400.0,10,10120,8,13395.0,12,13405.0,11,B
2018-04-23 22:32:57,13395.0,2,10122,0,13395.0,7,13400.0,1,S
2018-04-23 22:33:18,13395.0,10,10132,0,13390.0,49,13395.0,50,S
2018-04-23 22:33:18,13395.0,48,10180,12,13390.0,47,13395.0,26,S
2018-04-23 22:33:19,13395.0,4,10184,4,13390.0,47,13395.0,24,S
2018-04-23 22:33:21,13395.0,2,10186,2,13390.0,47,13395.0,23,S
2018-04-23 22:33:34,13395.0,2,10188,2,13390.0,44,13395.0,24,S
2018-04-23 22:33:40,13390.0,50,10238,-14,13390.0,13,13395.0,37,S
2018-04-23 22:33:41,13390.0,6,10244,-2,13390.0,10,13395.0,37,S
2018-04-23 22:33:48,13390.0,10,10254,0,13390.0,5,13395.0,34,S
2018-04-23 22:33:53,13390.0,2,10256,-2,13390.0,6,13395.0,35,S
2018-04-23 22:34:12,13395.0,58,10314,14,13395.0,8,13400.0,3,B
2018-04-23 22:34:13,13400.0,6,10320,2,13400.0,1,13405.0,9,B
2018-04-23 22:34:15,13400.0,6,10326,-2,13395.0,17,13405.0,14,B
2018-04-23 22:34:37,13395.0,2,10328,-2,13395.0,3,13400.0,5,S
2018-04-23 22:34:43,13400.0,8,10336,8,13395.0,26,13405.0,13,B
2018-04-23 22:35:04,13390.0,10,10346,-10,13390.0,19,13400.0,9,S
2018-04-23 22:35:45,13400.0,2,10348,0,13395.0,4,13400.0,1,B
2018-04-23 22:36:42,13400.0,6,10354,4,13395.0,3,13400.0,11,B
2018-04-23 22:37:07,13395.0,2,10356,0,13395.0,2,13400.0,11,S
2018-04-23 22:37:16,13390.0,20,10376,-4,13385.0,11,13395.0,13,S
2018-04-23 22:37:17,13395.0,2,10378,0,13385.0,8,13395.0,15,B
2018-04-23 22:37:35,13390.0,2,10380,0,13390.0,5,13395.0,4,S
2018-04-23 22:37:46,13390.0,2,10382,0,13390.0,1,13395.0,5,S
2018-04-23 22:37:48,13390.0,2,10384,0,13390.0,1,13395.0,5,S
2018-04-23 22:37:55,13390.0,2,10386,2,13390.0,6,13395.0,5,S
2018-04-23 22:38:00,13390.0,2,10388,0,13390.0,5,13395.0,5,S
2018-04-23 22:38:08,13390.0,2,10390,-2,13390.0,5,13395.0,4,S
2018-04-23 22:38:26,13390.0,2,10392,2,13390.0,1,13395.0,5,S
2018-04-23 22:38:58,13395.0,2,10394,-2,13390.0,2,13395.0,4,B
2018-04-23 22:39:06,13390.0,2,10396,0,13385.0,22,13395.0,5,S
2018-04-23 22:39:11,13395.0,2,10398,0,13385.0,24,13395.0,6,B
2018-04-23 22:39:13,13395.0,12,10410,-4,13390.0,1,13400.0,13,B
2018-04-23 22:39:32,13390.0,8,10418,-6,13385.0,37,13395.0,4,S
2018-04-23 22:39:48,13395.0,2,10420,0,13395.0,1,13400.0,13,B
2018-04-23 22:40:07,13395.0,2,10422,0,13390.0,19,13395.0,4,B
2018-04-23 22:40:14,13395.0,6,10428,6,13390.0,19,13395.0,1,B
2018-04-23 22:40:14,13395.0,2,10430,2,13395.0,1,13400.0,14,B
2018-04-23 22:40:55,13400.0,2,10432,0,13395.0,2,13400.0,9,B
2018-04-23 22:41:53,13395.0,2,10434,0,13395.0,1,13400.0,12,S
2018-04-23 22:42:06,13400.0,16,10450,14,13395.0,11,13400.0,1,B
2018-04-23 22:42:06,13400.0,2,10452,-2,13400.0,1,13405.0,9,B
2018-04-23 22:42:51,13400.0,2,10454,-2,13395.0,17,13400.0,2,B
2018-04-23 22:42:51,13405.0,6,10460,0,13400.0,19,13405.0,11,B
2018-04-23 22:42:54,13405.0,12,10472,-2,13405.0,1,13410.0,6,B
2018-04-23 22:42:56,13405.0,2,10474,-2,13405.0,1,13410.0,9,B
2018-04-23 22:42:56,13405.0,2,10476,0,13400.0,11,13410.0,12,B
2018-04-23 22:43:09,13410.0,8,10484,-6,13400.0,15,13410.0,8,B
2018-04-23 22:43:22,13410.0,2,10486,2,13400.0,18,13410.0,7,B
2018-04-23 22:43:24,13405.0,8,10494,2,13405.0,4,13415.0,12,S
2018-04-23 22:43:41,13410.0,8,10502,-2,13405.0,38,13415.0,11,B
2018-04-23 22:43:42,13405.0,24,10526,-22,13405.0,13,13410.0,1,S
2018-04-23 22:44:00,13410.0,2,10528,0,13405.0,3,13410.0,13,B
2018-04-23 22:44:16,13405.0,10,10538,-4,13400.0,5,13405.0,12,S
2018-04-23 22:44:17,13400.0,10,10548,-4,13395.0,7,13405.0,12,S
2018-04-23 22:44:46,13400.0,6,10554,2,13395.0,13,13400.0,3,S
2018-04-23 22:44:47,13400.0,6,10560,4,13395.0,13,13405.0,4,S
2018-04-23 22:44:57,13405.0,10,10570,-2,13405.0,5,13410.0,15,B
2018-04-23 22:45:45,13405.0,2,10572,2,13405.0,1,13410.0,11,B
2018-04-23 22:45:46,13405.0,2,10574,0,13400.0,42,13410.0,11,B
2018-04-23 22:45:59,13405.0,6,10580,-6,13405.0,2,13410.0,12,B
2018-04-23 22:46:09,13405.0,6,10586,-6,13400.0,30,13410.0,9,B
2018-04-23 22:46:36,13405.0,2,10588,0,13405.0,4,13410.0,8,B
2018-04-23 22:46:44,13410.0,2,10590,0,13405.0,11,13410.0,4,B
2018-04-23 22:46:44,13410.0,8,10598,4,13410.0,7,13415.0,12,B
2018-04-23 22:46:53,13410.0,2,10600,2,13410.0,2,13415.0,11,B
2018-04-23 22:47:07,13410.0,4,10604,0,13405.0,18,13410.0,12,B
2018-04-23 22:47:20,13410.0,2,10606,0,13405.0,10,13410.0,4,B
2018-04-23 22:47:38,13405.0,2,10608,0,13405.0,6,13410.0,4,S
2018-04-23 22:47:46,13405.0,14,10622,-8,13400.0,26,13405.0,3,S
2018-04-23 22:47:47,13405.0,6,10628,-2,13405.0,1,13410.0,4,S
2018-04-23 22:47:49,13405.0,2,10630,2,13405.0,5,13410.0,4,S
2018-04-23 22:47:53,13410.0,10,10640,-8,13405.0,5,13410.0,1,B
2018-04-23 22:47:57,13410.0,2,10642,2,13405.0,9,13410.0,1,B
2018-04-23 22:48:10,13405.0,20,10662,-8,13400.0,37,13410.0,1,S
2018-04-23 22:48:25,13405.0,20,10682,0,13405.0,1,13410.0,1,S
2018-04-23 22:48:40,13405.0,2,10684,2,13405.0,5,13410.0,2,S
2018-04-23 22:49:49,13405.0,2,10686,0,13405.0,4,13410.0,2,S
2018-04-23 22:50:01,13410.0,2,10688,0,13405.0,11,13415.0,14,B
2018-04-23 22:50:04,13405.0,4,10692,4,13405.0,11,13415.0,13,S
2018-04-23 22:50:35,13415.0,2,10694,-2,13410.0,5,13415.0,8,B
2018-04-23 22:50:40,13415.0,2,10696,-2,13410.0,5,13415.0,7,B
2018-04-23 22:50:48,13415.0,2,10698,-2,13410.0,5,13415.0,6,B
2018-04-23 22:51:00,13415.0,12,10710,-8,13410.0,5,13420.0,6,B
2018-04-23 22:51:03,13420.0,6,10716,0,13420.0,2,13425.0,8,B
2018-04-23 22:51:04,13425.0,14,10730,0,13425.0,1,13430.0,9,B
2018-04-23 22:51:04,13430.0,2,10732,-2,13425.0,2,13430.0,8,B
2018-04-23 22:51:08,13430.0,10,10742,2,13425.0,3,13430.0,1,B
2018-04-23 22:51:08,13425.0,6,10748,-2,13420.0,12,13430.0,5,S
2018-04-23 22:51:10,13420.0,2,10750,-2,13420.0,8,13425.0,1,S
2018-04-23 22:51:11,13420.0,4,10754,-4,13420.0,2,13425.0,10,S
2018-04-23 22:51:12,13420.0,2,10756,0,13420.0,1,13425.0,13,S
2018-04-23 22:51:14,13420.0,2,10758,0,13415.0,5,13425.0,14,S
2018-04-23 22:51:17,13420.0,2,10760,0,13415.0,7,13425.0,14,S
2018-04-23 22:51:22,13425.0,28,10788,-18,13425.0,6,13430.0,32,B
2018-04-23 22:51:22,13425.0,12,10800,-8,13420.0,1,13425.0,7,B
2018-04-23 22:51:23,13420.0,2,10802,-2,13415.0,12,13425.0,3,S
2018-04-23 22:51:38,13425.0,4,10806,-2,13420.0,2,13425.0,7,B
2018-04-23 22:51:43,13425.0,12,10818,0,13420.0,11,13430.0,4,B
2018-04-23 22:52:02,13430.0,4,10822,0,13430.0,1,13435.0,8,B
2018-04-23 22:52:03,13435.0,16,10838,-2,13435.0,4,13440.0,9,B
2018-04-23 22:52:03,13450.0,18,10856,10,13440.0,1,13450.0,5,B
2018-04-23 22:52:04,13450.0,2,10858,0,13440.0,11,13450.0,4,B
2018-04-23 22:52:04,13440.0,2,10860,0,13440.0,8,13450.0,6,S
2018-04-23 22:52:05,13440.0,4,10864,4,13435.0,7,13445.0,4,S
2018-04-23 22:52:08,13440.0,2,10866,0,13435.0,7,13445.0,6,S
2018-04-23 22:52:09,13445.0,10,10876,4,13435.0,12,13445.0,1,B
2018-04-23 22:52:09,13445.0,4,10880,-2,13440.0,1,13445.0,1,B
2018-04-23 22:52:10,13440.0,2,10882,0,13435.0,7,13440.0,1,S
2018-04-23 22:52:14,13440.0,2,10884,2,13435.0,3,13440.0,1,S
2018-04-23 22:52:15,13435.0,6,10890,-2,13435.0,2,13445.0,18,S
2018-04-23 22:52:17,13435.0,18,10908,0,13430.0,8,13440.0,6,S
2018-04-23 22:52:19,13445.0,20,10928,12,13430.0,4,13440.0,1,B
2018-04-23 22:52:50,13445.0,2,10930,0,13440.0,4,13445.0,6,B
2018-04-23 22:52:57,13445.0,14,10944,12,13445.0,3,13450.0,21,B
2018-04-23 22:52:59,13450.0,10,10954,6,13445.0,3,13450.0,22,B
2018-04-23 22:53:00,13450.0,6,10960,-2,13445.0,3,13450.0,19,B
2018-04-23 22:53:02,13450.0,2,10962,2,13445.0,5,13450.0,19,B
2018-04-23 22:53:03,13445.0,10,10972,0,13445.0,5,13455.0,10,S
2018-04-23 22:53:03,13445.0,4,10976,0,13445.0,3,13455.0,14,S
2018-04-23 22:53:04,13445.0,2,10978,-2,13450.0,1,13455.0,12,S
2018-04-23 22:53:05,13455.0,10,10988,6,13450.0,4,13455.0,9,B
2018-04-23 22:53:06,13455.0,2,10990,0,13450.0,4,13455.0,8,B
2018-04-23 22:53:06,13450.0,2,10992,-2,13450.0,3,13455.0,8,S
2018-04-23 22:53:09,13455.0,4,10996,-4,13455.0,2,13460.0,5,B
2018-04-23 22:53:09,13450.0,16,11012,-10,13445.0,9,13455.0,6,S
2018-04-23 22:53:11,13445.0,2,11014,0,13445.0,8,13455.0,11,S
2018-04-23 22:53:15,13450.0,8,11022,-4,13450.0,3,13460.0,8,B
2018-04-23 22:53:19,13460.0,28,11050,18,13460.0,2,13465.0,3,B
2018-04-23 22:53:20,13460.0,10,11060,4,13460.0,2,13465.0,8,B
2018-04-23 22:53:20,13455.0,6,11066,-4,13450.0,19,13455.0,2,S
2018-04-23 22:53:21,13455.0,4,11070,-4,13455.0,2,13460.0,3,S
2018-04-23 22:53:24,13460.0,4,11074,-4,13455.0,3,13460.0,1,B
2018-04-23 22:53:25,13460.0,4,11078,-4,13460.0,1,13465.0,5,B
2018-04-23 22:53:26,13460.0,14,11092,-2,13450.0,21,13460.0,2,B
2018-04-23 22:53:27,13455.0,2,11094,0,13455.0,2,13460.0,3,S
2018-04-23 22:53:27,13460.0,8,11102,-4,13450.0,21,13465.0,5,B
2018-04-23 22:53:33,13455.0,2,11104,0,13455.0,1,13465.0,11,S
2018-04-23 22:53:38,13455.0,4,11108,0,13450.0,22,13455.0,3,S
2018-04-23 22:53:38,13450.0,4,11112,0,13450.0,19,13455.0,6,S
2018-04-23 22:53:39,13450.0,24,11136,16,13450.0,2,13455.0,9,S
2018-04-23 22:53:40,13450.0,2,11138,2,13450.0,1,13455.0,9,S
2018-04-23 22:53:40,13450.0,2,11140,0,13445.0,8,13455.0,9,S
2018-04-23 22:53:41,13450.0,6,11146,-4,13450.0,3,13455.0,3,S
2018-04-23 22:53:45,13455.0,4,11150,-4,13445.0,13,13450.0,1,B
2018-04-23 22:53:45,13450.0,2,11152,-2,13450.0,1,13455.0,2,S
2018-04-23 22:53:48,13450.0,6,11158,2,13445.0,6,13450.0,11,S
2018-04-23 22:53:51,13450.0,6,11164,-6,13445.0,3,13450.0,8,S
2018-04-23 22:53:52,13445.0,6,11170,4,13440.0,21,13445.0,7,S
2018-04-23 22:53:55,13440.0,8,11178,-6,13440.0,9,13445.0,1,S
2018-04-23 22:53:59,13445.0,2,11180,2,13440.0,6,13445.0,7,B
2018-04-23 22:54:00,13445.0,2,11182,0,13440.0,6,13445.0,7,B
2018-04-23 22:54:07,13440.0,2,11184,0,13440.0,5,13445.0,7,S
2018-04-23 22:54:14,13440.0,2,11186,0,13440.0,4,13445.0,7,S
2018-04-23 22:54:28,13440.0,12,11198,-2,13440.0,4,13445.0,3,S
2018-04-23 22:54:28,13440.0,8,11206,0,13435.0,6,13440.0,2,S
2018-04-23 22:54:29,13440.0,2,11208,-2,13435.0,6,13440.0,4,S
2018-04-23 22:54:30,13430.0,14,11222,-8,13420.0,14,13440.0,6,S
2018-04-23 22:54:40,13430.0,2,11224,0,13430.0,4,13435.0,2,S
2018-04-23 22:54:51,13435.0,4,11228,-2,13435.0,7,13440.0,4,B
2018-04-23 22:55:00,13440.0,2,11230,-2,13435.0,7,13440.0,1,B
2018-04-23 22:55:07,13430.0,24,11254,-22,13425.0,33,13430.0,16,S
2018-04-23 22:55:07,13430.0,32,11286,-32,13430.0,5,13440.0,1,S
2018-04-23 22:55:12,13430.0,4,11290,-2,13425.0,34,13430.0,26,S
2018-04-23 22:55:12,13430.0,22,11312,-14,13425.0,34,13430.0,15,S
2018-04-23 22:55:13,13430.0,6,11318,-6,13425.0,34,13430.0,12,S
2018-04-23 22:55:13,13430.0,4,11322,-2,13425.0,22,13430.0,10,S
2018-04-23 22:55:14,13430.0,2,11324,-2,13425.0,22,13430.0,9,S
2018-04-23 22:55:21,13430.0,2,11326,0,13425.0,22,13430.0,8,S
2018-04-23 22:55:23,13430.0,4,11330,-4,13425.0,22,13430.0,6,S
2018-04-23 22:55:27,13430.0,10,11340,-10,13425.0,22,13430.0,1,S
2018-04-23 22:55:27,13435.0,4,11344,-2,13430.0,5,13440.0,2,B
2018-04-23 22:55:32,13430.0,8,11352,-4,13425.0,10,13430.0,24,S
2018-04-23 22:55:32,13430.0,24,11376,0,13425.0,10,13430.0,12,S
2018-04-23 22:55:33,13430.0,2,11378,-2,13425.0,9,13430.0,11,S
2018-04-23 22:55:35,13430.0,4,11382,-4,13425.0,9,13430.0,9,S
2018-04-23 22:55:37,13430.0,2,11384,0,13425.0,14,13430.0,8,S
2018-04-23 22:55:41,13430.0,2,11386,-2,13425.0,14,13430.0,7,S
2018-04-23 22:55:42,13430.0,8,11394,-6,13425.0,14,13430.0,3,S
2018-04-23 22:55:45,13430.0,2,11396,-2,13425.0,19,13430.0,2,S
2018-04-23 22:55:45,13435.0,8,11404,-4,13430.0,10,13440.0,6,B
2018-04-23 22:55:47,13435.0,2,11406,2,13430.0,10,13440.0,7,B
2018-04-23 22:55:50,13430.0,22,11428,-22,13425.0,16,13430.0,17,S
2018-04-23 22:55:51,13430.0,4,11432,-4,13425.0,18,13430.0,15,S
2018-04-23 22:55:52,13430.0,30,11462,0,13430.0,5,13440.0,4,S
2018-04-23 22:55:57,13430.0,10,11472,0,13425.0,15,13430.0,23,S
2018-04-23 22:55:58,13430.0,2,11474,-2,13425.0,15,13430.0,23,S
2018-04-23 22:56:00,13430.0,6,11480,-6,13425.0,25,13430.0,20,S
2018-04-23 22:56:04,13430.0,2,11482,0,13425.0,27,13430.0,19,S
2018-04-23 22:56:05,13430.0,2,11484,0,13425.0,27,13430.0,18,S
2018-04-23 22:56:07,13430.0,2,11486,0,13425.0,40,13430.0,17,S
2018-04-23 22:56:08,13430.0,24,11510,-22,13425.0,40,13430.0,5,S
2018-04-23 22:56:08,13430.0,10,11520,-4,13425.0,40,13435.0,6,S
2018-04-23 22:56:09,13435.0,12,11532,-2,13435.0,14,13440.0,7,B
2018-04-23 22:56:13,13435.0,4,11536,-4,13430.0,2,13440.0,7,B
2018-04-23 22:56:15,13430.0,10,11546,-10,13425.0,28,13430.0,23,S
2018-04-23 22:56:15,13430.0,4,11550,-4,13425.0,29,13430.0,21,S
2018-04-23 22:56:16,13425.0,4,11554,-4,13425.0,27,13430.0,21,S
2018-04-23 22:56:19,13430.0,2,11556,-2,13425.0,15,13430.0,20,B
2018-04-23 22:56:20,13430.0,26,11582,-24,13425.0,15,13430.0,7,B
2018-04-23 22:56:20,13430.0,4,11586,0,13425.0,14,13430.0,5,B
2018-04-23 22:56:23,13430.0,2,11588,0,13425.0,19,13430.0,7,B
2018-04-23 22:56:25,13430.0,2,11590,0,13425.0,19,13430.0,6,B
2018-04-23 22:56:26,13435.0,10,11600,2,13430.0,3,13440.0,5,B
2018-04-23 22:56:26,13430.0,8,11608,-4,13430.0,4,13435.0,1,S
2018-04-23 22:56:31,13430.0,10,11618,-10,13425.0,17,13430.0,23,S
2018-04-23 22:56:31,13430.0,2,11620,-2,13425.0,18,13430.0,22,S
2018-04-23 22:56:39,13430.0,2,11622,0,13425.0,17,13430.0,21,S
2018-04-23 22:56:41,13430.0,4,11626,-4,13425.0,17,13430.0,19,S
2018-04-23 22:56:44,13430.0,2,11628,-2,13425.0,19,13430.0,18,S
2018-04-23 22:56:46,13430.0,4,11632,-4,13425.0,19,13430.0,16,S
2018-04-23 22:56:49,13430.0,2,11634,-2,13425.0,19,13430.0,15,S
2018-04-23 22:56:49,13430.0,2,11636,-2,13425.0,19,13430.0,14,S
2018-04-23 22:56:53,13425.0,12,11648,0,13425.0,11,13430.0,17,S
2018-04-23 22:56:54,13430.0,4,11652,-4,13425.0,9,13430.0,15,B
2018-04-23 22:57:00,13430.0,4,11656,-4,13425.0,9,13430.0,13,B
2018-04-23 22:57:05,13425.0,2,11658,2,13425.0,3,13430.0,14,S
2018-04-23 22:57:05,13425.0,6,11664,0,13420.0,3,13425.0,3,S
2018-04-23 22:57:11,13425.0,2,11666,-2,13420.0,19,13425.0,5,S
2018-04-23 22:57:13,13420.0,2,11668,0,13410.0,19,13420.0,1,S
2018-04-23 22:57:15,13425.0,4,11672,-2,13415.0,12,13425.0,1,B
2018-04-23 22:57:16,13425.0,2,11674,0,13420.0,1,13430.0,11,B
2018-04-23 22:57:23,13430.0,6,11680,-2,13425.0,25,13430.0,9,B
2018-04-23 22:57:24,13430.0,2,11682,0,13425.0,25,13430.0,8,B
2018-04-23 22:57:27,13430.0,16,11698,2,13425.0,23,13435.0,4,B
2018-04-23 22:57:33,13430.0,36,11734,-36,13425.0,5,13430.0,10,B
2018-04-23 22:57:37,13425.0,8,11742,-8,13420.0,4,13425.0,6,S
2018-04-23 22:57:37,13425.0,12,11754,-2,13420.0,25,13430.0,10,S
2018-04-23 22:58:01,13425.0,2,11756,-2,13425.0,12,13430.0,13,S
2018-04-23 22:58:12,13430.0,4,11760,-4,13425.0,15,13430.0,9,B
2018-04-23 22:58:14,13430.0,4,11764,-4,13425.0,15,13430.0,7,B
2018-04-23 22:58:16,13430.0,4,11768,-4,13425.0,15,13430.0,8,B
2018-04-23 22:58:18,13430.0,4,11772,-4,13425.0,15,13430.0,6,B
2018-04-23 22:58:19,13430.0,2,11774,-2,13425.0,15,13430.0,5,B
2018-04-23 22:58:20,13430.0,2,11776,-2,13425.0,15,13430.0,4,B
2018-04-23 22:58:25,13425.0,2,11778,0,13425.0,15,13430.0,5,S
2018-04-23 22:58:30,13430.0,10,11788,-8,13430.0,5,13435.0,2,B
2018-04-23 22:58:35,13430.0,14,11802,-14,13425.0,14,13430.0,21,B
2018-04-23 22:58:37,13430.0,4,11806,-4,13425.0,14,13430.0,19,B
2018-04-23 22:58:39,13430.0,4,11810,-4,13425.0,14,13430.0,17,B
2018-04-23 22:59:00,13430.0,4,11814,-4,13425.0,14,13430.0,15,B
2018-04-23 22:59:00,13425.0,4,11818,-4,13425.0,12,13430.0,15,S
2018-04-23 22:59:01,13430.0,2,11820,-2,13425.0,12,13430.0,14,B
2018-04-23 22:59:01,13425.0,4,11824,0,13425.0,10,13430.0,14,S
2018-04-23 22:59:12,13425.0,2,11826,0,13425.0,4,13430.0,14,S
2018-04-23 22:59:12,13425.0,2,11828,0,13425.0,3,13430.0,14,S
2018-04-23 22:59:18,13425.0,6,11834,-2,13420.0,25,13425.0,2,S
2018-04-23 22:59:22,13420.0,2,11836,-2,13420.0,13,13425.0,2,S
2018-04-23 22:59:26,13425.0,2,11838,-2,13420.0,13,13425.0,2,B
2018-04-23 22:59:40,13420.0,4,11842,-2,13415.0,2,13425.0,3,S
2018-04-23 22:59:42,13420.0,2,11844,-2,13420.0,5,13425.0,5,S
2018-04-23 22:59:54,13420.0,2,11846,-2,13420.0,4,13425.0,2,S
2018-04-23 22:59:55,13420.0,8,11854,-8,13415.0,2,13425.0,7,S
2018-04-23 22:59:59,13415.0,4,11858,0,13410.0,7,13425.0,7,S
2018-04-24 09:00:01,13425.0,14,11872,-14,13425.0,1,13430.0,15,B
2018-04-24 09:00:01,13420.0,16,11888,0,13415.0,5,13430.0,11,S
2018-04-24 09:00:02,13420.0,10,11898,10,13420.0,2,13425.0,4,S
2018-04-24 09:00:06,13430.0,22,11920,2,13430.0,1,13435.0,1,B
2018-04-24 09:00:06,13430.0,4,11924,2,13425.0,9,13430.0,1,B
2018-04-24 09:00:10,13440.0,10,11934,0,13440.0,8,13445.0,13,B
2018-04-24 09:00:11,13440.0,4,11938,-4,13440.0,6,13445.0,1,B
2018-04-24 09:00:12,13440.0,6,11944,0,13440.0,3,13445.0,1,B
2018-04-24 09:00:13,13440.0,4,11948,0,13440.0,1,13445.0,1,B
2018-04-24 09:00:18,13440.0,4,11952,2,13440.0,47,13445.0,2,B
2018-04-24 09:00:19,13445.0,4,11956,0,13440.0,47,13450.0,2,B
2018-04-24 09:00:20,13450.0,4,11960,-4,13450.0,4,13455.0,3,B
2018-04-24 09:00:20,13450.0,8,11968,-2,13445.0,1,13450.0,4,B
2018-04-24 09:00:21,13440.0,2,11970,0,13440.0,46,13450.0,5,S
2018-04-24 09:00:24,13450.0,10,11980,-10,13440.0,46,13450.0,2,B
2018-04-24 09:00:25,13440.0,2,11982,0,13440.0,45,13450.0,2,S
2018-04-24 09:00:29,13450.0,8,11990,-6,13440.0,45,13450.0,3,B
2018-04-24 09:00:35,13445.0,8,11998,6,13445.0,2,13450.0,3,S
2018-04-24 09:00:35,13445.0,4,12002,-4,13440.0,45,13445.0,2,S
2018-04-24 09:00:38,13450.0,6,12008,2,13440.0,45,13450.0,6,B
2018-04-24 09:00:39,13445.0,2,12010,0,13445.0,1,13450.0,5,S
2018-04-24 09:00:41,13450.0,2,12012,-2,13445.0,6,13450.0,3,B
2018-04-24 09:00:45,13445.0,6,12018,6,13440.0,45,13450.0,3,S
2018-04-24 09:00:46,13445.0,2,12020,0,13445.0,1,13450.0,10,S
2018-04-24 09:00:49,13450.0,2,12022,0,13445.0,2,13450.0,8,B
2018-04-24 09:00:52,13450.0,6,12028,-2,13445.0,10,13455.0,3,B
2018-04-24 09:00:58,13445.0,2,12030,-2,13440.0,45,13450.0,6,S
2018-04-24 09:00:59,13450.0,4,12034,-2,13445.0,1,13450.0,5,B
2018-04-24 09:01:03,13445.0,2,12036,0,13445.0,1,13450.0,13,S
2018-04-24 09:01:07,13445.0,2,12038,2,13445.0,1,13450.0,13,S
2018-04-24 09:01:07,13445.0,2,12040,2,13440.0,51,13450.0,13,S
2018-04-24 09:01:18,13445.0,4,12044,2,13440.0,53,13445.0,1,S
2018-04-24 09:01:19,13445.0,2,12046,0,13440.0,53,13450.0,8,S
2018-04-24 09:01:24,13445.0,22,12068,-12,13440.0,51,13450.0,23,S
2018-04-24 09:01:24,13450.0,2,12070,-2,13440.0,51,13450.0,11,B
2018-04-24 09:01:27,13445.0,6,12076,4,13440.0,51,13450.0,12,S
2018-04-24 09:01:28,13445.0,6,12082,-6,13440.0,51,13450.0,12,S
2018-04-24 09:01:30,13440.0,14,12096,0,13440.0,42,13445.0,12,S
2018-04-24 09:01:30,13445.0,2,12098,-2,13440.0,42,13445.0,13,B
2018-04-24 09:01:32,13445.0,2,12100,0,13440.0,42,13445.0,9,B
2018-04-24 09:01:33,13440.0,10,12110,0,13440.0,37,13445.0,8,S
2018-04-24 09:01:36,13440.0,4,12114,4,13440.0,35,13445.0,8,S
2018-04-24 09:01:37,13445.0,2,12116,0,13440.0,35,13445.0,7,B
2018-04-24 09:01:38,13440.0,10,12126,6,13440.0,30,13445.0,8,S
2018-04-24 09:01:38,13440.0,12,12138,12,13440.0,24,13445.0,8,S
2018-04-24 09:01:39,13440.0,38,12176,32,13440.0,5,13445.0,11,S
2018-04-24 09:01:39,13440.0,10,12186,2,13435.0,4,13440.0,4,S
2018-04-24 09:01:40,13440.0,12,12198,8,13440.0,1,13445.0,8,S
2018-04-24 09:01:42,13445.0,2,12200,0,13440.0,6,13445.0,6,B
2018-04-24 09:01:46,13445.0,2,12202,0,13440.0,5,13445.0,5,B
2018-04-24 09:01:51,13445.0,2,12204,0,13440.0,5,13445.0,4,B
2018-04-24 09:01:52,13445.0,8,12212,6,13440.0,8,13450.0,8,B
2018-04-24 09:02:03,13445.0,2,12214,0,13435.0,4,13440.0,2,B
2018-04-24 09:02:04,13440.0,2,12216,2,13435.0,11,13445.0,6,S
2018-04-24 09:02:13,13440.0,2,12218,2,13435.0,12,13445.0,4,S
2018-04-24 09:02:15,13435.0,4,12222,4,13435.0,8,13440.0,1,S
2018-04-24 09:02:22,13435.0,2,12224,2,13435.0,5,13440.0,1,S
2018-04-24 09:02:24,13435.0,6,12230,-4,13430.0,2,13440.0,5,S
2018-04-24 09:02:27,13430.0,6,12236,2,13430.0,7,13435.0,2,S
2018-04-24 09:02:29,13430.0,8,12244,-6,13425.0,1,13430.0,4,S
2018-04-24 09:02:29,13430.0,6,12250,-2,13425.0,2,13430.0,1,S
2018-04-24 09:02:30,13425.0,6,12256,-6,13425.0,2,13430.0,13,S
2018-04-24 09:02:31,13425.0,4,12260,0,13420.0,2,13430.0,13,S
2018-04-24 09:02:36,13430.0,10,12270,2,13420.0,7,13430.0,8,B
2018-04-24 09:02:42,13425.0,2,12272,2,13420.0,7,13425.0,1,S
2018-04-24 09:02:43,13425.0,2,12274,-2,13420.0,7,13430.0,10,S
2018-04-24 09:02:45,13430.0,4,12278,-4,13425.0,1,13430.0,7,B
2018-04-24 09:02:47,13425.0,2,12280,2,13425.0,2,13430.0,3,S
2018-04-24 09:02:47,13430.0,6,12286,-6,13425.0,4,13435.0,2,B
2018-04-24 09:02:55,13430.0,4,12290,-4,13425.0,6,13435.0,6,B
2018-04-24 09:02:57,13430.0,4,12294,-2,13425.0,6,13435.0,8,B
2018-04-24 09:03:02,13435.0,2,12296,0,13430.0,3,13435.0,5,B
2018-04-24 09:03:27,13435.0,4,12300,4,13430.0,3,13435.0,1,B
2018-04-24 09:03:30,13430.0,2,12302,0,13425.0,4,13435.0,23,S
2018-04-24 09:03:36,13430.0,6,12308,6,13430.0,4,13435.0,5,S
2018-04-24 09:03:40,13435.0,2,12310,-2,13430.0,4,13435.0,4,B
2018-04-24 09:03:40,13435.0,6,12316,-2,13430.0,4,13435.0,1,B
2018-04-24 09:03:47,13430.0,6,12322,-6,13425.0,7,13435.0,6,S
2018-04-24 09:04:01,13430.0,8,12330,6,13430.0,1,13435.0,22,S
2018-04-24 09:04:01,13430.0,10,12340,2,13430.0,1,13435.0,22,S
2018-04-24 09:04:02,13430.0,2,12342,2,13425.0,7,13430.0,2,S
2018-04-24 09:04:03,13430.0,4,12346,4,13430.0,3,13435.0,20,S
2018-04-24 09:04:04,13430.0,8,12354,8,13430.0,4,13435.0,19,S
2018-04-24 09:04:04,13430.0,8,12362,8,13425.0,2,13435.0,19,S
2018-04-24 09:04:11,13430.0,12,12374,0,13425.0,9,13430.0,4,S
2018-04-24 09:04:11,13430.0,8,12382,-8,13430.0,2,13435.0,1,S
2018-04-24 09:04:12,13430.0,2,12384,-2,13425.0,7,13430.0,1,S
2018-04-24 09:04:14,13425.0,2,12386,0,13425.0,2,13430.0,11,S
2018-04-24 09:04:16,13430.0,4,12390,-2,13425.0,4,13430.0,9,B
2018-04-24 09:04:20,13425.0,2,12392,0,13425.0,2,13430.0,9,S
2018-04-24 09:04:23,13425.0,2,12394,-2,13425.0,2,13430.0,9,S
2018-04-24 09:04:27,13425.0,2,12396,-2,13425.0,2,13430.0,9,S
2018-04-24 09:04:39,13430.0,16,12412,-6,13425.0,13,13430.0,1,B
2018-04-24 09:04:40,13430.0,2,12414,-2,13425.0,13,13435.0,4,B
2018-04-24 09:04:41,13430.0,2,12416,2,13430.0,3,13435.0,4,B
2018-04-24 09:04:42,13430.0,2,12418,0,13430.0,3,13435.0,1,B
2018-04-24 09:04:43,13430.0,6,12424,-4,13430.0,1,13435.0,1,B
2018-04-24 09:04:53,13430.0,4,12428,-4,13425.0,9,13430.0,9,B
2018-04-24 09:04:55,13430.0,8,12436,-8,13425.0,11,13430.0,5,B
2018-04-24 09:04:55,13430.0,10,12446,2,13430.0,1,13435.0,4,B
2018-04-24 09:04:57,13430.0,20,12466,-6,13425.0,7,13440.0,7,B
2018-04-24 09:04:59,13430.0,12,12478,-4,13425.0,8,13430.0,4,B
2018-04-24 09:05:00,13430.0,6,12484,-2,13425.0,7,13430.0,1,B
2018-04-24 09:05:12,13430.0,2,12486,0,13425.0,5,13435.0,4,B
2018-04-24 09:05:13,13430.0,2,12488,0,13425.0,5,13430.0,9,B
2018-04-24 09:05:18,13430.0,18,12506,-8,13425.0,6,13435.0,4,B
2018-04-24 09:05:19,13435.0,6,12512,6,13430.0,30,13440.0,12,B
2018-04-24 09:05:20,13430.0,20,12532,-12,13430.0,21,13440.0,10,S
2018-04-24 09:05:21,13430.0,20,12552,-8,13430.0,24,13445.0,4,S
2018-04-24 09:05:23,13430.0,20,12572,-8,13430.0,13,13440.0,8,S
2018-04-24 09:05:24,13430.0,20,12592,-6,13430.0,3,13440.0,17,S
2018-04-24 09:05:26,13430.0,8,12600,0,13425.0,9,13430.0,6,S
2018-04-24 09:05:26,13430.0,2,12602,0,13425.0,14,13430.0,5,S
2018-04-24 09:05:27,13435.0,12,12614,-4,13425.0,14,13435.0,3,B
2018-04-24 09:05:28,13430.0,2,12616,0,13425.0,12,13430.0,9,S
2018-04-24 09:05:29,13430.0,12,12628,-8,13425.0,12,13430.0,3,S
2018-04-24 09:05:29,13430.0,6,12634,-2,13430.0,3,13435.0,2,S
2018-04-24 09:05:30,13430.0,16,12650,0,13425.0,12,13430.0,2,S
2018-04-24 09:05:31,13435.0,6,12656,0,13430.0,4,13440.0,11,B
2018-04-24 09:05:32,13430.0,8,12664,-4,13425.0,11,13430.0,6,S
2018-04-24 09:05:32,13430.0,2,12666,-2,13425.0,12,13430.0,5,S
2018-04-24 09:05:33,13430.0,10,12676,-10,13425.0,11,13435.0,1,S
2018-04-24 09:05:34,13430.0,2,12678,2,13425.0,8,13430.0,10,S
2018-04-24 09:05:35,13435.0,22,12700,0,13430.0,1,13435.0,2,B
2018-04-24 09:05:36,13430.0,20,12720,0,13435.0,2,13440.0,6,S
2018-04-24 09:05:38,13430.0,8,12728,0,13425.0,7,13430.0,6,S
2018-04-24 09:05:38,13430.0,12,12740,-12,13430.0,7,13435.0,1,S
2018-04-24 09:05:39,13430.0,8,12748,-2,13425.0,9,13430.0,6,S
2018-04-24 09:05:40,13430.0,12,12760,-12,13425.0,9,13435.0,1,S
2018-04-24 09:05:41,13430.0,4,12764,0,13425.0,9,13430.0,8,S
2018-04-24 09:05:41,13430.0,16,12780,-4,13425.0,9,13435.0,4,S
2018-04-24 09:05:42,13430.0,4,12784,0,13425.0,9,13430.0,8,S
2018-04-24 09:05:43,13430.0,12,12796,-4,13425.0,9,13430.0,2,S
2018-04-24 09:05:43,13430.0,4,12800,-4,13425.0,9,13435.0,6,S
2018-04-24 09:05:47,13430.0,4,12804,-4,13425.0,9,13430.0,8,S
2018-04-24 09:05:50,13430.0,6,12810,-6,13425.0,9,13430.0,5,S
2018-04-24 09:05:51,13430.0,10,12820,0,13430.0,1,13435.0,6,S
2018-04-24 09:05:52,13430.0,4,12824,0,13425.0,9,13430.0,8,S
2018-04-24 09:05:53,13430.0,4,12828,0,13425.0,9,13430.0,6,S
2018-04-24 09:05:54,13430.0,2,12830,-2,13425.0,9,13430.0,15,S
2018-04-24 09:05:55,13430.0,24,12854,-24,13425.0,9,13430.0,3,S
2018-04-24 09:05:55,13430.0,2,12856,0,13425.0,9,13430.0,2,S
2018-04-24 09:05:56,13430.0,2,12858,0,13425.0,10,13430.0,11,S
2018-04-24 09:06:01,13430.0,8,12866,-8,13425.0,9,13430.0,10,S
2018-04-24 09:06:04,13425.0,22,12888,-4,13420.0,6,13425.0,1,S
2018-04-24 09:06:06,13425.0,6,12894,0,13420.0,4,13425.0,2,S
2018-04-24 09:06:08,13425.0,2,12896,2,13420.0,3,13425.0,1,S
2018-04-24 09:06:14,13425.0,2,12898,0,13420.0,3,13425.0,5,S
2018-04-24 09:06:16,13425.0,12,12910,0,13420.0,11,13430.0,16,S
2018-04-24 09:06:26,13430.0,10,12920,-10,13425.0,13,13430.0,4,B
2018-04-24 09:06:27,13425.0,8,12928,-4,13425.0,11,13430.0,2,S
2018-04-24 09:06:29,13430.0,42,12970,-2,13420.0,11,13430.0,8,B
2018-04-24 09:06:38,13430.0,2,12972,0,13425.0,3,13430.0,7,B
2018-04-24 09:06:44,13425.0,6,12978,6,13420.0,11,13425.0,8,S
2018-04-24 09:06:44,13425.0,16,12994,4,13420.0,11,13430.0,7,S
2018-04-24 09:06:47,13430.0,2,12996,-2,13420.0,10,13430.0,9,B
2018-04-24 09:06:57,13425.0,8,13004,-4,13420.0,10,13430.0,12,S
2018-04-24 09:07:05,13425.0,6,13010,-2,13425.0,3,13430.0,9,S
2018-04-24 09:07:09,13430.0,2,13012,-2,13425.0,3,13430.0,8,B
2018-04-24 09:07:11,13425.0,4,13016,4,13420.0,10,13425.0,2,S
2018-04-24 09:07:13,13425.0,4,13020,2,13420.0,10,13425.0,9,S
2018-04-24 09:07:15,13425.0,6,13026,0,13425.0,1,13430.0,14,S
2018-04-24 09:07:15,13425.0,2,13028,0,13420.0,10,13430.0,16,S
2018-04-24 09:07:19,13425.0,8,13036,8,13425.0,6,13430.0,17,S
2018-04-24 09:07:26,13425.0,6,13042,0,13425.0,4,13430.0,14,S
2018-04-24 09:07:27,13425.0,8,13050,8,13420.0,10,13430.0,14,S
2018-04-24 09:07:32,13425.0,2,13052,-2,13420.0,15,13430.0,15,S
2018-04-24 09:07:48,13420.0,28,13080,-22,13420.0,9,13425.0,20,S
2018-04-24 09:07:54,13425.0,2,13082,0,13420.0,6,13425.0,17,B
2018-04-24 09:08:04,13425.0,2,13084,0,13425.0,4,13430.0,21,B
2018-04-24 09:08:06,13430.0,8,13092,2,13420.0,26,13430.0,18,B
2018-04-24 09:08:07,13425.0,2,13094,2,13425.0,8,13430.0,18,S
2018-04-24 09:08:08,13430.0,10,13104,4,13425.0,3,13430.0,13,B
2018-04-24 09:08:16,13425.0,4,13108,0,13425.0,1,13430.0,13,S
2018-04-24 09:08:17,13425.0,2,13110,0,13420.0,21,13425.0,17,S
2018-04-24 09:08:35,13420.0,2,13112,2,13420.0,15,13430.0,8,S
2018-04-24 09:08:44,13425.0,2,13114,-2,13420.0,10,13430.0,13,B
2018-04-24 09:09:12,13420.0,2,13116,0,13420.0,21,13425.0,16,S
2018-04-24 09:09:20,13420.0,2,13118,0,13420.0,17,13425.0,16,S
2018-04-24 09:09:34,13425.0,2,13120,-2,13420.0,18,13425.0,12,B
2018-04-24 09:09:58,13425.0,10,13130,4,13420.0,10,13425.0,6,B
2018-04-24 09:10:17,13425.0,2,13132,0,13420.0,11,13425.0,5,B
2018-04-24 09:10:29,13420.0,2,13134,-2,13420.0,15,13425.0,13,S
2018-04-24 09:10:29,13420.0,26,13160,-4,13420.0,2,13425.0,13,S
2018-04-24 09:10:30,13420.0,4,13164,-4,13415.0,4,13425.0,27,S
2018-04-24 09:10:31,13415.0,8,13172,0,13410.0,2,13420.0,3,S
2018-04-24 09:11:08,13410.0,4,13176,-2,13410.0,5,13415.0,9,S
2018-04-24 09:11:11,13415.0,18,13194,8,13415.0,1,13420.0,17,B
2018-04-24 09:11:11,13415.0,6,13200,0,13415.0,8,13420.0,17,B
2018-04-24 09:11:27,13425.0,4,13204,4,13425.0,8,13430.0,10,B
2018-04-24 09:11:48,13425.0,2,13206,0,13425.0,8,13430.0,18,B
2018-04-24 09:12:01,13425.0,2,13208,0,13425.0,7,13430.0,18,B
2018-04-24 09:12:12,13425.0,2,13210,0,13425.0,6,13430.0,11,B
2018-04-24 09:12:13,13425.0,2,13212,0,13425.0,5,13430.0,13,B
2018-04-24 09:12:13,13425.0,8,13220,0,13425.0,1,13430.0,18,B
2018-04-24 09:12:14,13425.0,2,13222,0,13420.0,9,13425.0,4,B
2018-04-24 09:12:15,13420.0,2,13224,-2,13420.0,8,13425.0,6,S
2018-04-24 09:12:16,13420.0,2,13226,-2,13420.0,7,13425.0,6,S
2018-04-24 09:12:16,13420.0,2,13228,-2,13420.0,6,13425.0,6,S
2018-04-24 09:12:17,13420.0,2,13230,0,13420.0,5,13425.0,6,S
2018-04-24 09:12:38,13425.0,4,13234,-4,13420.0,5,13425.0,1,B
2018-04-24 09:12:39,13420.0,10,13244,0,13415.0,10,13420.0,5,S
2018-04-24 09:12:39,13420.0,2,13246,2,13415.0,14,13420.0,4,S
2018-04-24 09:12:41,13420.0,4,13250,0,13415.0,15,13420.0,2,S
2018-04-24 09:12:42,13420.0,4,13254,4,13415.0,15,13425.0,3,S
2018-04-24 09:12:42,13425.0,2,13256,-2,13420.0,9,13425.0,1,B
2018-04-24 09:12:49,13425.0,6,13262,0,13415.0,11,13420.0,10,B
2018-04-24 09:12:50,13420.0,2,13264,0,13415.0,15,13420.0,9,S
2018-04-24 09:12:58,13420.0,4,13268,0,13415.0,17,13420.0,7,S
2018-04-24 09:12:59,13420.0,14,13282,2,13415.0,17,13425.0,6,S
2018-04-24 09:13:02,13420.0,10,13292,0,13415.0,13,13420.0,5,S
2018-04-24 09:13:03,13420.0,10,13302,4,13420.0,14,13425.0,5,S
2018-04-24 09:13:04,13425.0,2,13304,0,13420.0,25,13430.0,16,B
2018-04-24 09:13:06,13420.0,2,13306,2,13420.0,24,13430.0,18,S
2018-04-24 09:13:11,13425.0,2,13308,2,13425.0,9,13430.0,18,B
2018-04-24 09:13:16,13430.0,8,13316,-4,13425.0,14,13435.0,7,B
2018-04-24 09:13:19,13430.0,2,13318,2,13425.0,14,13430.0,9,B
2018-04-24 09:13:21,13430.0,16,13334,16,13425.0,14,13430.0,1,B
2018-04-24 09:13:21,13430.0,2,13336,2,13425.0,14,13435.0,11,B
2018-04-24 09:13:28,13435.0,2,13338,0,13430.0,14,13440.0,6,B
2018-04-24 09:13:41,13430.0,12,13350,10,13425.0,12,13430.0,1,S
2018-04-24 09:13:49,13430.0,6,13356,0,13430.0,2,13435.0,13,S
2018-04-24 09:13:52,13430.0,2,13358,0,13430.0,4,13435.0,4,S
2018-04-24 09:13:56,13435.0,8,13366,6,13435.0,5,13440.0,13,B
2018-04-24 09:14:03,13440.0,28,13394,12,13440.0,1,13445.0,7,B
2018-04-24 09:14:10,13445.0,2,13396,-2,13440.0,4,13445.0,13,B
2018-04-24 09:14:10,13445.0,2,13398,-2,13440.0,4,13445.0,12,B
2018-04-24 09:14:11,13445.0,4,13402,2,13440.0,2,13445.0,10,B
2018-04-24 09:14:15,13445.0,32,13434,24,13435.0,14,13445.0,3,B
2018-04-24 09:14:16,13445.0,6,13440,0,13445.0,1,13450.0,15,B
2018-04-24 09:14:16,13450.0,24,13464,0,13445.0,21,13455.0,3,B
2018-04-24 09:14:21,13450.0,2,13466,-2,13445.0,9,13455.0,9,B
2018-04-24 09:14:23,13450.0,6,13472,4,13450.0,1,13455.0,18,B
2018-04-24 09:14:24,13450.0,2,13474,0,13445.0,8,13455.0,18,B
2018-04-24 09:14:31,13455.0,2,13476,0,13450.0,10,13460.0,5,B
2018-04-24 09:14:32,13460.0,2,13478,0,13460.0,1,13465.0,2,B
2018-04-24 09:14:33,13465.0,2,13480,0,13455.0,17,13465.0,1,B
2018-04-24 09:14:33,13465.0,4,13484,-4,13455.0,19,13465.0,2,B
2018-04-24 09:14:36,13465.0,4,13488,-4,13455.0,18,13470.0,8,B
2018-04-24 09:14:58,13465.0,2,13490,2,13460.0,9,13465.0,5,B
2018-04-24 09:15:01,13465.0,2,13492,0,13460.0,7,13465.0,8,B
2018-04-24 09:15:06,13460.0,2,13494,-2,13460.0,6,13465.0,20,S
2018-04-24 09:15:07,13460.0,10,13504,2,13455.0,13,13460.0,2,S
2018-04-24 09:15:12,13455.0,10,13514,0,13450.0,11,13455.0,3,S
2018-04-24 09:15:13,13455.0,10,13524,8,13450.0,3,13455.0,11,S
2018-04-24 09:15:14,13450.0,2,13526,0,13445.0,7,13450.0,15,S
2018-04-24 09:15:19,13450.0,2,13528,-2,13445.0,2,13450.0,14,S
2018-04-24 09:15:23,13450.0,2,13530,0,13445.0,2,13450.0,14,S
2018-04-24 09:15:29,13445.0,4,13534,2,13440.0,6,13445.0,8,S
2018-04-24 09:15:29,13445.0,14,13548,0,13440.0,7,13445.0,6,S
2018-04-24 09:15:32,13445.0,10,13558,10,13440.0,5,13445.0,1,S
2018-04-24 09:15:34,13445.0,2,13560,0,13445.0,4,13450.0,18,S
2018-04-24 09:15:36,13440.0,4,13564,-2,13440.0,9,13450.0,17,S
2018-04-24 09:15:49,13450.0,2,13566,0,13445.0,9,13450.0,15,B
2018-04-24 09:15:51,13450.0,8,13574,-4,13445.0,13,13450.0,10,B
2018-04-24 09:15:51,13450.0,20,13594,-4,13450.0,6,13455.0,15,B
2018-04-24 09:16:04,13450.0,6,13600,0,13445.0,13,13450.0,1,B
2018-04-24 09:16:09,13450.0,2,13602,0,13445.0,5,13450.0,3,B
2018-04-24 09:16:17,13445.0,8,13610,8,13445.0,5,13450.0,3,S
2018-04-24 09:16:27,13445.0,2,13612,2,13440.0,10,13445.0,2,S
2018-04-24 09:16:29,13445.0,16,13628,14,13445.0,2,13450.0,14,S
2018-04-24 09:16:34,13450.0,14,13642,10,13450.0,3,13455.0,16,B
2018-04-24 09:16:35,13450.0,6,13648,0,13445.0,7,13455.0,34,B
2018-04-24 09:17:09,13450.0,2,13650,0,13445.0,3,13450.0,3,B
2018-04-24 09:17:12,13450.0,6,13656,-6,13450.0,1,13455.0,19,B
2018-04-24 09:17:19,13450.0,2,13658,2,13445.0,8,13455.0,20,B
2018-04-24 09:17:25,13450.0,2,13660,0,13450.0,2,13455.0,20,B
2018-04-24 09:17:30,13445.0,2,13662,2,13445.0,7,13455.0,20,S
2018-04-24 09:17:37,13455.0,4,13666,0,13450.0,14,13455.0,10,B
2018-04-24 09:17:37,13455.0,8,13674,4,13450.0,14,13455.0,6,B
2018-04-24 09:17:38,13455.0,4,13678,4,13450.0,14,13455.0,4,B
2018-04-24 09:17:38,13455.0,8,13686,6,13450.0,14,13460.0,11,B
2018-04-24 09:17:39,13460.0,2,13688,0,13450.0,14,13460.0,15,B
2018-04-24 09:17:50,13460.0,20,13708,14,13450.0,14,13460.0,2,B
2018-04-24 09:18:00,13455.0,14,13722,6,13455.0,13,13460.0,25,S
2018-04-24 09:18:00,13455.0,6,13728,4,13455.0,10,13460.0,26,S
2018-04-24 09:18:04,13455.0,2,13730,2,13455.0,9,13460.0,10,S
2018-04-24 09:18:06,13455.0,2,13732,0,13455.0,8,13460.0,10,S
2018-04-24 09:18:07,13455.0,4,13736,0,13455.0,6,13460.0,10,S
2018-04-24 09:18:13,13455.0,2,13738,2,13455.0,5,13460.0,10,S
2018-04-24 09:18:16,13455.0,2,13740,0,13455.0,4,13460.0,12,S
2018-04-24 09:18:17,13455.0,2,13742,2,13455.0,3,13460.0,12,S
2018-04-24 09:18:17,13455.0,2,13744,2,13455.0,2,13460.0,12,S
2018-04-24 09:18:19,13460.0,2,13746,0,13455.0,2,13460.0,11,B
2018-04-24 09:18:20,13460.0,2,13748,0,13455.0,2,13460.0,10,B
2018-04-24 09:18:22,13460.0,2,13750,0,13455.0,2,13460.0,10,B
2018-04-24 09:18:23,13460.0,2,13752,0,13455.0,2,13460.0,9,B
2018-04-24 09:18:25,13455.0,4,13756,4,13450.0,4,13460.0,9,S
2018-04-24 09:18:26,13455.0,28,13784,8,13445.0,5,13455.0,10,S
2018-04-24 09:18:31,13455.0,2,13786,0,13445.0,9,13455.0,13,S
2018-04-24 09:18:34,13455.0,20,13806,6,13450.0,5,13455.0,3,S
2018-04-24 09:18:44,13455.0,2,13808,0,13450.0,5,13455.0,7,S
2018-04-24 09:18:47,13450.0,6,13814,6,13450.0,2,13455.0,9,S
2018-04-24 09:18:48,13450.0,4,13818,0,13445.0,9,13450.0,10,S
2018-04-24 09:18:48,13450.0,8,13826,0,13445.0,9,13450.0,7,S
2018-04-24 09:18:49,13445.0,2,13828,0,13445.0,8,13450.0,7,S
2018-04-24 09:19:10,13445.0,4,13832,0,13445.0,3,13450.0,19,S
2018-04-24 09:19:11,13445.0,6,13838,-4,13440.0,4,13450.0,19,S
2018-04-24 09:19:17,13445.0,12,13850,4,13440.0,11,13445.0,4,S
2018-04-24 09:19:28,13440.0,2,13852,2,13440.0,10,13445.0,4,S
2018-04-24 09:19:34,13440.0,2,13854,0,13440.0,9,13445.0,4,S
2018-04-24 09:19:34,13445.0,2,13856,0,13440.0,9,13445.0,4,B
2018-04-24 09:19:41,13440.0,6,13862,0,13435.0,2,13445.0,11,S
2018-04-24 09:19:51,13445.0,12,13874,2,13445.0,3,13450.0,21,B
2018-04-24 09:19:56,13445.0,6,13880,-2,13440.0,12,13450.0,21,B
2018-04-24 09:20:01,13450.0,4,13884,0,13440.0,6,13450.0,24,B
2018-04-24 09:20:06,13450.0,2,13886,0,13440.0,11,13450.0,22,B
2018-04-24 09:20:12,13450.0,30,13916,24,13445.0,12,13450.0,10,B
2018-04-24 09:20:13,13450.0,20,13936,18,13450.0,10,13455.0,4,B
2018-04-24 09:20:19,13455.0,2,13938,0,13455.0,5,13460.0,10,B
2018-04-24 09:20:29,13460.0,2,13940,2,13455.0,4,13460.0,7,B
2018-04-24 09:20:32,13460.0,4,13944,-2,13455.0,3,13460.0,11,B
2018-04-24 09:20:34,13460.0,2,13946,0,13455.0,4,13460.0,10,B
2018-04-24 09:20:40,13460.0,2,13948,0,13455.0,4,13460.0,5,B
2018-04-24 09:20:41,13460.0,2,13950,0,13455.0,4,13460.0,4,B
2018-04-24 09:20:47,13460.0,4,13954,-4,13460.0,1,13465.0,9,B
2018-04-24 09:20:52,13465.0,12,13966,6,13460.0,12,13470.0,7,B
2018-04-24 09:20:54,13470.0,14,13980,4,13470.0,1,13475.0,14,B
2018-04-24 09:20:55,13475.0,2,13982,2,13475.0,1,13480.0,17,B
2018-04-24 09:20:56,13475.0,2,13984,0,13470.0,19,13475.0,2,B
2018-04-24 09:20:57,13470.0,28,14012,2,13465.0,6,13470.0,2,S
2018-04-24 09:21:02,13470.0,2,14014,-2,13460.0,13,13470.0,21,S
2018-04-24 09:21:06,13465.0,10,14024,4,13460.0,10,13470.0,9,S
2018-04-24 09:21:07,13465.0,2,14026,0,13460.0,10,13470.0,11,S
2018-04-24 09:21:22,13460.0,18,14044,18,13455.0,9,13465.0,14,S
2018-04-24 09:21:34,13460.0,2,14046,0,13460.0,9,13465.0,19,S
2018-04-24 09:21:35,13460.0,6,14052,0,13460.0,6,13465.0,19,S
2018-04-24 09:21:35,13460.0,6,14058,6,13460.0,3,13465.0,19,S
2018-04-24 09:21:44,13460.0,6,14064,0,13455.0,4,13460.0,1,S
2018-04-24 09:21:48,13455.0,2,14066,0,13450.0,8,13460.0,13,S
2018-04-24 09:21:54,13450.0,12,14078,2,13445.0,4,13455.0,15,S
2018-04-24 09:22:06,13450.0,6,14084,0,13450.0,7,13455.0,20,S
2018-04-24 09:22:11,13450.0,2,14086,2,13450.0,6,13455.0,20,S
2018-04-24 09:22:11,13450.0,12,14098,10,13445.0,11,13455.0,20,S
2018-04-24 09:22:22,13445.0,4,14102,-4,13440.0,3,13450.0,16,S
2018-04-24 09:22:23,13445.0,4,14106,-4,13440.0,17,13450.0,9,S
2018-04-24 09:22:32,13450.0,12,14118,12,13445.0,13,13450.0,1,B
2018-04-24 09:22:33,13450.0,2,14120,2,13445.0,13,13455.0,18,B
2018-04-24 09:22:39,13445.0,2,14122,0,13445.0,12,13455.0,20,S
2018-04-24 09:22:39,13450.0,2,14124,2,13445.0,9,13450.0,1,B
2018-04-24 09:22:53,13450.0,16,14140,12,13450.0,2,13455.0,20,B
2018-04-24 09:22:53,13450.0,4,14144,2,13445.0,2,13450.0,1,B
2018-04-24 09:23:04,13445.0,6,14150,0,13445.0,6,13450.0,5,S
2018-04-24 09:23:07,13450.0,8,14158,8,13450.0,2,13455.0,13,B
2018-04-24 09:23:12,13450.0,6,14164,2,13450.0,1,13455.0,12,B
2018-04-24 09:23:46,13445.0,2,14166,2,13440.0,13,13450.0,8,S
2018-04-24 09:23:48,13450.0,14,14180,12,13450.0,13,13455.0,25,B
2018-04-24 09:23:51,13450.0,2,14182,0,13450.0,12,13455.0,15,B
2018-04-24 09:24:11,13450.0,6,14188,6,13450.0,10,13455.0,20,B
2018-04-24 09:24:14,13450.0,2,14190,0,13450.0,9,13455.0,20,B
2018-04-24 09:24:19,13455.0,16,14206,0,13450.0,12,13455.0,8,B
2018-04-24 09:24:19,13455.0,16,14222,-6,13450.0,14,13460.0,10,B
2018-04-24 09:24:24,13450.0,4,14226,0,13450.0,12,13460.0,17,S
2018-04-24 09:24:32,13455.0,2,14228,-2,13450.0,6,13460.0,19,B
2018-04-24 09:24:55,13455.0,6,14234,6,13455.0,7,13460.0,22,B
2018-04-24 09:24:55,13455.0,6,14240,6,13455.0,4,13460.0,22,B
2018-04-24 09:25:01,13455.0,2,14242,2,13455.0,3,13460.0,21,B
2018-04-24 09:25:05,13460.0,4,14246,4,13455.0,3,13460.0,16,B
2018-04-24 09:25:10,13455.0,2,14248,2,13455.0,2,13460.0,18,S
2018-04-24 09:25:11,13455.0,4,14252,4,13450.0,3,13460.0,18,S
2018-04-24 09:25:16,13455.0,2,14254,2,13450.0,7,13455.0,1,S
2018-04-24 09:25:16,13455.0,2,14256,0,13450.0,7,13460.0,18,S
2018-04-24 09:25:24,13460.0,2,14258,2,13450.0,7,13460.0,18,B
2018-04-24 09:25:40,13455.0,4,14262,0,13450.0,7,13455.0,8,S
2018-04-24 09:25:43,13455.0,2,14264,0,13450.0,7,13455.0,47,S
2018-04-24 09:25:49,13455.0,2,14266,2,13450.0,7,13455.0,46,S
2018-04-24 09:25:51,13450.0,2,14268,0,13450.0,4,13455.0,46,S
2018-04-24 09:25:54,13455.0,2,14270,2,13450.0,4,13455.0,45,B
2018-04-24 09:25:55,13450.0,6,14276,-2,13445.0,5,13455.0,45,S
2018-04-24 09:25:56,13450.0,4,14280,0,13445.0,6,13455.0,45,S
2018-04-24 09:26:07,13450.0,2,14282,0,13440.0,10,13450.0,9,S
2018-04-24 09:26:08,13450.0,2,14284,0,13440.0,13,13450.0,8,S
2018-04-24 09:26:13,13445.0,2,14286,0,13440.0,13,13450.0,12,S
2018-04-24 09:26:17,13440.0,4,14290,-2,13440.0,11,13445.0,1,S
2018-04-24 09:26:21,13440.0,16,14306,14,13435.0,16,13445.0,2,S
2018-04-24 09:26:24,13435.0,8,14314,6,13430.0,4,13435.0,2,S
2018-04-24 09:26:25,13435.0,6,14320,-2,13430.0,2,13440.0,9,S
2018-04-24 09:26:25,13430.0,4,14324,-2,13425.0,2,13435.0,9,S
2018-04-24 09:26:30,13435.0,2,14326,-2,13430.0,6,13435.0,2,B
2018-04-24 09:26:32,13435.0,2,14328,0,13430.0,10,13435.0,1,B
2018-04-24 09:26:35,13435.0,2,14330,2,13430.0,10,13440.0,7,B
2018-04-24 09:26:36,13435.0,2,14332,2,13430.0,10,13440.0,11,B
2018-04-24 09:26:39,13430.0,20,14352,-12,13425.0,18,13430.0,4,S
2018-04-24 09:26:40,13430.0,8,14360,-8,13430.0,10,13435.0,1,S
2018-04-24 09:26:46,13440.0,2,14362,2,13435.0,6,13440.0,1,B
2018-04-24 09:26:48,13435.0,4,14366,4,13435.0,4,13440.0,2,S
2018-04-24 09:26:51,13440.0,2,14368,0,13435.0,4,13440.0,1,B
2018-04-24 09:26:54,13440.0,2,14370,2,13435.0,4,13440.0,1,B
2018-04-24 09:27:04,13435.0,8,14378,0,13430.0,11,13435.0,7,S
2018-04-24 09:27:05,13435.0,2,14380,0,13430.0,11,13435.0,6,S
2018-04-24 09:27:22,13430.0,20,14400,20,13425.0,9,13430.0,12,S
2018-04-24 09:27:25,13425.0,8,14408,-4,13420.0,2,13430.0,12,S
2018-04-24 09:27:32,13430.0,20,14428,8,13425.0,14,13435.0,11,B
2018-04-24 09:27:32,13435.0,2,14430,2,13430.0,15,13435.0,8,B
2018-04-24 09:27:37,13430.0,10,14440,0,13430.0,6,13435.0,5,S
2018-04-24 09:27:41,13430.0,2,14442,0,13430.0,13,13440.0,13,S
2018-04-24 09:27:47,13440.0,6,14448,-4,13435.0,17,13445.0,10,B
2018-04-24 09:27:56,13435.0,14,14462,12,13430.0,4,13435.0,4,S
2018-04-24 09:28:01,13435.0,2,14464,-2,13425.0,12,13435.0,13,S
2018-04-24 09:28:07,13430.0,8,14472,0,13425.0,19,13430.0,2,S
2018-04-24 09:28:13,13425.0,32,14504,20,13425.0,1,13430.0,12,S
2018-04-24 09:28:14,13425.0,2,14506,2,13420.0,5,13430.0,13,S
2018-04-24 09:28:15,13420.0,22,14528,18,13420.0,12,13430.0,3,S
2018-04-24 09:28:15,13420.0,4,14532,-2,13420.0,10,13430.0,3,S
2018-04-24 09:28:16,13420.0,2,14534,0,13420.0,9,13430.0,3,S
2018-04-24 09:28:16,13420.0,2,14536,2,13420.0,10,13430.0,3,S
2018-04-24 09:28:17,13420.0,2,14538,2,13420.0,9,13430.0,8,S
2018-04-24 09:28:21,13425.0,6,14544,2,13420.0,9,13425.0,2,B
2018-04-24 09:28:22,13430.0,6,14550,6,13420.0,9,13430.0,12,B
2018-04-24 09:28:34,13425.0,4,14554,0,13420.0,9,13425.0,3,S
2018-04-24 09:28:39,13425.0,6,14560,0,13425.0,2,13430.0,17,S
2018-04-24 09:28:42,13430.0,20,14580,18,13425.0,5,13430.0,7,B
2018-04-24 09:28:49,13430.0,10,14590,0,13430.0,3,13435.0,5,B
2018-04-24 09:29:13,13430.0,2,14592,2,13430.0,4,13435.0,4,B
2018-04-24 09:29:18,13430.0,2,14594,2,13430.0,5,13435.0,4,B
2018-04-24 09:29:20,13435.0,4,14598,0,13430.0,14,13435.0,1,B
2018-04-24 09:29:20,13430.0,2,14600,0,13430.0,6,13435.0,2,S
2018-04-24 09:29:22,13435.0,4,14604,2,13435.0,1,13440.0,20,B
2018-04-24 09:29:22,13435.0,2,14606,0,13430.0,6,13440.0,21,B
2018-04-24 09:29:35,13435.0,6,14612,0,13430.0,24,13440.0,6,B
2018-04-24 09:29:40,13440.0,6,14618,-6,13430.0,24,13440.0,3,B
2018-04-24 09:29:56,13440.0,6,14624,0,13435.0,4,13445.0,11,B
2018-04-24 09:30:04,13435.0,2,14626,-2,13430.0,16,13435.0,11,S
2018-04-24 09:30:19,13430.0,4,14630,2,13430.0,2,13435.0,4,S
2018-04-24 09:30:24,13430.0,6,14636,-4,13425.0,13,13430.0,5,S
2018-04-24 09:30:31,13425.0,2,14638,0,13420.0,22,13430.0,8,S
2018-04-24 09:30:35,13430.0,20,14658,6,13420.0,23,13435.0,8,B
2018-04-24 09:30:39,13425.0,6,14664,0,13420.0,23,13425.0,1,S
2018-04-24 09:30:41,13420.0,30,14694,22,13415.0,2,13420.0,1,S
2018-04-24 09:30:42,13415.0,4,14698,0,13410.0,4,13420.0,11,S
2018-04-24 09:30:42,13410.0,10,14708,-2,13410.0,4,13415.0,3,S
2018-04-24 09:30:43,13410.0,2,14710,0,13410.0,3,13415.0,5,S
2018-04-24 09:30:57,13415.0,6,14716,6,13415.0,7,13420.0,15,B
2018-04-24 09:31:09,13420.0,2,14718,0,13415.0,8,13420.0,7,B
2018-04-24 09:31:10,13420.0,4,14722,0,13415.0,10,13420.0,4,B
2018-04-24 09:31:10,13420.0,2,14724,0,13415.0,13,13425.0,5,B
2018-04-24 09:31:20,13420.0,2,14726,0,13415.0,13,13420.0,4,B
2018-04-24 09:31:44,13420.0,2,14728,2,13415.0,9,13420.0,8,B
2018-04-24 09:31:45,13415.0,2,14730,2,13415.0,8,13420.0,8,S
2018-04-24 09:31:48,13420.0,6,14736,0,13415.0,8,13420.0,3,B
2018-04-24 09:31:51,13425.0,8,14744,2,13420.0,12,13425.0,4,B
2018-04-24 09:31:52,13425.0,2,14746,2,13420.0,6,13425.0,3,B
2018-04-24 09:31:59,13420.0,12,14758,-4,13415.0,11,13425.0,10,S
2018-04-24 09:32:11,13420.0,2,14760,0,13415.0,10,13420.0,2,S
2018-04-24 09:32:19,13415.0,8,14768,8,13415.0,7,13420.0,3,S
2018-04-24 09:32:20,13420.0,2,14770,-2,13415.0,7,13420.0,1,B
2018-04-24 09:32:22,13415.0,2,14772,2,13415.0,6,13420.0,10,S
2018-04-24 09:32:23,13415.0,12,14784,4,13410.0,2,13420.0,10,S
2018-04-24 09:32:28,13410.0,20,14804,0,13410.0,4,13420.0,6,S
2018-04-24 09:32:30,13415.0,2,14806,2,13410.0,5,13420.0,8,B
2018-04-24 09:32:39,13415.0,2,14808,2,13410.0,5,13415.0,1,B
2018-04-24 09:32:40,13415.0,2,14810,2,13410.0,5,13420.0,9,B
2018-04-24 09:32:42,13415.0,4,14814,0,13410.0,5,13420.0,9,B
2018-04-24 09:32:49,13415.0,2,14816,0,13410.0,5,13420.0,8,B
2018-04-24 09:32:50,13410.0,2,14818,-2,13410.0,4,13420.0,8,S
2018-04-24 09:32:55,13415.0,2,14820,0,13410.0,5,13420.0,7,B
2018-04-24 09:32:55,13420.0,2,14822,2,13410.0,5,13420.0,6,B
2018-04-24 09:32:56,13420.0,2,14824,2,13410.0,5,13420.0,5,B
2018-04-24 09:33:00,13420.0,4,14828,2,13410.0,5,13420.0,6,B
2018-04-24 09:33:01,13420.0,2,14830,2,13410.0,5,13420.0,5,B
2018-04-24 09:33:04,13410.0,2,14832,-2,13410.0,1,13415.0,6,S
2018-04-24 09:33:16,13410.0,2,14834,-2,13405.0,7,13415.0,6,S
2018-04-24 09:33:19,13415.0,2,14836,0,13410.0,5,13420.0,8,B
2018-04-24 09:33:19,13420.0,2,14838,2,13410.0,6,13420.0,7,B
2018-04-24 09:33:30,13415.0,2,14840,-2,13410.0,7,13420.0,5,S
2018-04-24 09:33:31,13420.0,2,14842,2,13410.0,7,13420.0,4,B
2018-04-24 09:33:33,13425.0,4,14846,4,13415.0,5,13425.0,8,B
2018-04-24 09:33:35,13425.0,2,14848,2,13415.0,10,13425.0,7,B
2018-04-24 09:33:45,13420.0,10,14858,2,13415.0,10,13425.0,7,S
2018-04-24 09:34:15,13425.0,8,14866,-8,13420.0,11,13430.0,9,B
2018-04-24 09:34:17,13430.0,4,14870,0,13430.0,8,13435.0,3,B
2018-04-24 09:34:17,13430.0,14,14884,4,13430.0,1,13435.0,3,B
2018-04-24 09:34:18,13425.0,4,14888,4,13425.0,3,13430.0,12,S
2018-04-24 09:34:26,13430.0,2,14890,-2,13425.0,2,13430.0,5,B
2018-04-24 09:34:34,13425.0,2,14892,-2,13420.0,8,13425.0,1,S
2018-04-24 09:34:38,13420.0,2,14894,2,13420.0,6,13425.0,4,S
2018-04-24 09:34:42,13425.0,2,14896,0,13420.0,6,13425.0,4,B
2018-04-24 09:34:43,13420.0,12,14908,0,13415.0,6,13420.0,1,S
2018-04-24 09:34:43,13415.0,12,14920,0,13410.0,4,13420.0,19,S
2018-04-24 09:34:44,13415.0,4,14924,-4,13410.0,6,13420.0,17,S
2018-04-24 09:34:53,13420.0,2,14926,-2,13410.0,5,13420.0,11,B
2018-04-24 09:34:55,13415.0,2,14928,-2,13410.0,5,13420.0,11,S
2018-04-24 09:35:11,13415.0,2,14930,2,13410.0,2,13415.0,8,S
2018-04-24 09:35:14,13415.0,8,14938,4,13410.0,3,13415.0,1,S
2018-04-24 09:36:08,13420.0,2,14940,-2,13415.0,8,13425.0,9,B
2018-04-24 09:36:17,13415.0,10,14950,-2,13410.0,6,13415.0,5,S
2018-04-24 09:36:19,13410.0,6,14956,4,13405.0,8,13415.0,10,S
2018-04-24 09:36:21,13415.0,4,14960,-4,13405.0,9,13415.0,11,B
2018-04-24 09:36:24,13410.0,2,14962,2,13405.0,9,13415.0,10,S
2018-04-24 09:36:27,13410.0,2,14964,0,13405.0,9,13415.0,8,S
2018-04-24 09:36:34,13415.0,2,14966,0,13410.0,4,13415.0,10,B
2018-04-24 09:36:37,13415.0,2,14968,2,13410.0,4,13415.0,9,B
2018-04-24 09:36:52,13415.0,2,14970,2,13410.0,4,13415.0,8,B
2018-04-24 09:36:59,13415.0,14,14984,10,13410.0,9,13415.0,1,B
2018-04-24 09:37:00,13420.0,4,14988,0,13410.0,12,13420.0,5,B
2018-04-24 09:37:15,13415.0,4,14992,2,13410.0,9,13415.0,8,S
2018-04-24 09:37:15,13415.0,2,14994,2,13410.0,12,13415.0,7,S
2018-04-24 09:37:18,13415.0,14,15008,12,13410.0,13,13420.0,14,S
2018-04-24 09:37:18,13425.0,30,15038,0,13415.0,19,13425.0,7,B
2018-04-24 09:37:53,13420.0,8,15046,0,13415.0,18,13425.0,7,S
2018-04-24 09:38:00,13425.0,6,15052,-2,13425.0,1,13430.0,7,B
2018-04-24 09:38:03,13425.0,2,15054,-2,13420.0,5,13430.0,14,B
2018-04-24 09:39:59,13425.0,6,15060,-4,13420.0,10,13430.0,20,B
2018-04-24 09:40:12,13425.0,2,15062,2,13420.0,10,13425.0,2,B
2018-04-24 09:40:31,13420.0,2,15064,0,13420.0,7,13425.0,2,S
2018-04-24 09:40:40,13420.0,8,15072,2,13415.0,8,13425.0,20,S
2018-04-24 09:40:47,13415.0,2,15074,-2,13415.0,6,13425.0,23,S
2018-04-24 09:41:06,13420.0,2,15076,2,13415.0,17,13420.0,4,B
2018-04-24 09:41:25,13420.0,8,15084,6,13420.0,1,13425.0,2,B
2018-04-24 09:41:33,13425.0,2,15086,2,13420.0,4,13425.0,2,B
2018-04-24 09:41:39,13420.0,4,15090,0,13420.0,2,13425.0,3,S
2018-04-24 09:42:00,13425.0,4,15094,-2,13420.0,3,13425.0,6,B
2018-04-24 09:42:22,13420.0,2,15096,0,13415.0,9,13425.0,11,S
2018-04-24 09:42:42,13420.0,2,15098,2,13415.0,9,13420.0,10,S
2018-04-24 09:42:47,13420.0,2,15100,2,13415.0,9,13420.0,9,S
2018-04-24 09:43:40,13420.0,18,15118,18,13420.0,11,13425.0,24,S
2018-04-24 09:43:40,13420.0,2,15120,2,13420.0,10,13425.0,24,S
2018-04-24 09:43:41,13420.0,20,15140,12,13415.0,7,13425.0,27,S
2018-04-24 09:43:45,13420.0,2,15142,0,13415.0,7,13420.0,1,S
2018-04-24 09:44:36,13415.0,18,15160,0,13410.0,16,13415.0,41,S
2018-04-24 09:44:39,13415.0,20,15180,20,13410.0,10,13415.0,31,S
2018-04-24 09:44:47,13405.0,62,15242,38,13410.0,1,13415.0,2,S
2018-04-24 09:44:47,13415.0,4,15246,4,13415.0,2,13420.0,5,B
2018-04-24 09:44:48,13415.0,6,15252,-2,13410.0,3,13415.0,1,B
2018-04-24 09:44:53,13415.0,2,15254,-2,13410.0,2,13415.0,3,B
2018-04-24 09:44:53,13415.0,2,15256,-2,13410.0,2,13415.0,2,B
2018-04-24 09:44:54,13415.0,2,15258,-2,13410.0,2,13415.0,1,B
2018-04-24 09:44:54,13415.0,2,15260,-2,13410.0,2,13420.0,5,B
2018-04-24 09:44:55,13420.0,2,15262,0,13415.0,1,13420.0,7,B
2018-04-24 09:44:55,13415.0,4,15266,0,13410.0,3,13415.0,1,S
2018-04-24 09:44:56,13415.0,2,15268,0,13410.0,2,13420.0,9,S
2018-04-24 09:44:56,13420.0,2,15270,0,13410.0,3,13420.0,8,B
2018-04-24 09:44:57,13420.0,2,15272,0,13415.0,1,13420.0,7,B
2018-04-24 09:44:57,13420.0,2,15274,0,13415.0,1,13420.0,6,B
2018-04-24 09:44:58,13420.0,2,15276,0,13415.0,1,13420.0,5,B
2018-04-24 09:44:58,13420.0,2,15278,-2,13410.0,5,13420.0,4,B
2018-04-24 09:44:59,13420.0,2,15280,-2,13410.0,5,13420.0,4,B
2018-04-24 09:44:59,13420.0,2,15282,-2,13410.0,5,13420.0,4,B
2018-04-24 09:45:00,13420.0,2,15284,-2,13410.0,6,13420.0,4,B
2018-04-24 09:45:00,13420.0,2,15286,-2,13410.0,6,13420.0,3,B
2018-04-24 09:45:01,13420.0,2,15288,-2,13415.0,1,13420.0,3,B
2018-04-24 09:45:01,13420.0,2,15290,0,13415.0,1,13420.0,2,B
2018-04-24 09:45:02,13420.0,2,15292,0,13415.0,2,13420.0,3,B
2018-04-24 09:45:02,13420.0,6,15298,2,13420.0,8,13425.0,14,B
2018-04-24 09:45:03,13420.0,18,15316,2,13415.0,1,13425.0,13,B
2018-04-24 09:45:03,13420.0,2,15318,0,13415.0,3,13425.0,17,B
2018-04-24 09:45:04,13425.0,2,15320,0,13415.0,3,13425.0,16,B
2018-04-24 09:45:04,13425.0,2,15322,0,13415.0,2,13425.0,15,B
2018-04-24 09:45:05,13425.0,2,15324,0,13415.0,2,13425.0,14,B
2018-04-24 09:45:05,13425.0,2,15326,0,13415.0,2,13420.0,7,B
2018-04-24 09:45:06,13425.0,2,15328,0,13415.0,2,13420.0,7,B
2018-04-24 09:45:06,13420.0,2,15330,-2,13415.0,2,13420.0,9,S
2018-04-24 09:45:07,13420.0,2,15332,-2,13415.0,2,13420.0,8,S
2018-04-24 09:45:07,13420.0,2,15334,-2,13415.0,2,13420.0,7,S
2018-04-24 09:45:08,13420.0,2,15336,0,13415.0,3,13420.0,6,S
2018-04-24 09:45:08,13420.0,2,15338,0,13415.0,3,13420.0,7,S
2018-04-24 09:45:09,13420.0,2,15340,0,13415.0,3,13420.0,6,S
2018-04-24 09:45:09,13420.0,2,15342,0,13415.0,3,13420.0,5,S
2018-04-24 09:45:10,13420.0,2,15344,-2,13415.0,3,13420.0,4,S
2018-04-24 09:45:10,13420.0,2,15346,-2,13415.0,3,13420.0,3,S
2018-04-24 09:45:11,13420.0,2,15348,-2,13415.0,3,13420.0,2,S
2018-04-24 09:45:11,13420.0,2,15350,-2,13415.0,3,13420.0,1,S
2018-04-24 09:45:12,13420.0,2,15352,-2,13415.0,3,13425.0,24,S
2018-04-24 09:45:12,13425.0,2,15354,0,13415.0,3,13425.0,23,B
2018-04-24 09:45:33,13415.0,6,15360,-4,13410.0,3,13415.0,8,S
2018-04-24 09:45:47,13415.0,2,15362,0,13410.0,7,13415.0,3,S
2018-04-24 09:46:08,13410.0,12,15374,2,13410.0,3,13415.0,11,S
2018-04-24 09:46:09,13410.0,2,15376,2,13410.0,1,13415.0,11,S
2018-04-24 09:46:09,13410.0,2,15378,0,13405.0,1,13410.0,1,S
2018-04-24 09:46:15,13410.0,2,15380,2,13405.0,3,13410.0,11,S
2018-04-24 09:46:23,13405.0,6,15386,2,13400.0,13,13405.0,7,S
2018-04-24 09:46:23,13405.0,14,15400,12,13405.0,6,13410.0,11,S
2018-04-24 09:47:03,13410.0,4,15404,0,13405.0,4,13410.0,11,B
2018-04-24 09:47:21,13410.0,2,15406,0,13405.0,5,13410.0,2,B
2018-04-24 09:47:36,13410.0,2,15408,0,13410.0,1,13415.0,19,B
2018-04-24 09:47:37,13410.0,2,15410,0,13410.0,1,13415.0,11,B
2018-04-24 09:47:46,13410.0,2,15412,-2,13405.0,5,13410.0,1,B
2018-04-24 09:47:46,13410.0,2,15414,-2,13410.0,4,13415.0,15,B
2018-04-24 09:47:57,13415.0,2,15416,2,13410.0,4,13415.0,15,B
2018-04-24 09:48:16,13415.0,20,15436,18,13410.0,9,13420.0,4,B
2018-04-24 09:48:42,13415.0,4,15440,0,13410.0,6,13415.0,8,B
2018-04-24 09:48:43,13415.0,16,15456,8,13410.0,6,13420.0,8,B
2018-04-24 09:49:00,13415.0,4,15460,4,13410.0,9,13415.0,4,B
2018-04-24 09:49:00,13415.0,26,15486,-4,13415.0,8,13425.0,21,B
2018-04-24 09:49:10,13420.0,6,15492,0,13415.0,9,13420.0,2,B
2018-04-24 09:49:11,13420.0,4,15496,4,13415.0,9,13425.0,7,B
2018-04-24 09:49:39,13420.0,4,15500,4,13415.0,6,13420.0,3,B
2018-04-24 09:49:40,13420.0,6,15506,0,13420.0,8,13425.0,10,B
2018-04-24 09:49:40,13420.0,16,15522,-8,13415.0,9,13425.0,12,B
2018-04-24 09:49:41,13415.0,6,15528,-6,13410.0,3,13415.0,2,S
2018-04-24 09:49:42,13410.0,6,15534,6,13405.0,2,13415.0,5,S
2018-04-24 09:49:51,13415.0,2,15536,0,13415.0,8,13420.0,8,B
2018-04-24 09:49:52,13415.0,8,15544,4,13410.0,7,13415.0,1,B
2018-04-24 09:49:56,13415.0,2,15546,0,13410.0,8,13420.0,11,B
2018-04-24 09:50:28,13415.0,2,15548,2,13415.0,4,13420.0,3,B
2018-04-24 09:50:42,13420.0,2,15550,2,13415.0,5,13420.0,4,B
2018-04-24 09:50:48,13420.0,2,15552,0,13415.0,5,13420.0,3,B
2018-04-24 09:50:55,13420.0,2,15554,0,13415.0,5,13420.0,2,B
2018-04-24 09:51:01,13420.0,4,15558,0,13415.0,6,13425.0,16,B
2018-04-24 09:52:11,13420.0,2,15560,-2,13415.0,13,13425.0,14,B
2018-04-24 09:52:29,13425.0,2,15562,2,13420.0,1,13425.0,13,B
2018-04-24 09:52:30,13425.0,2,15564,0,13420.0,1,13425.0,12,B
2018-04-24 09:52:34,13425.0,10,15574,-8,13420.0,8,13430.0,7,B
2018-04-24 09:52:56,13425.0,2,15576,0,13420.0,6,13425.0,1,B
2018-04-24 09:53:07,13430.0,2,15578,0,13420.0,9,13430.0,12,B
2018-04-24 09:53:09,13430.0,4,15582,2,13420.0,11,13430.0,10,B
2018-04-24 09:53:29,13430.0,4,15586,2,13420.0,11,13430.0,8,B
2018-04-24 09:54:15,13420.0,20,15606,12,13420.0,3,13425.0,11,S
2018-04-24 09:54:26,13425.0,20,15626,18,13420.0,4,13425.0,1,B
2018-04-24 09:54:27,13425.0,2,15628,0,13420.0,4,13430.0,27,B
2018-04-24 09:55:24,13430.0,2,15630,0,13425.0,4,13435.0,3,B
2018-04-24 09:55:35,13430.0,2,15632,2,13425.0,5,13430.0,5,B
2018-04-24 09:55:54,13430.0,10,15642,10,13430.0,9,13435.0,8,B
2018-04-24 09:55:55,13435.0,6,15648,0,13430.0,10,13435.0,1,B
2018-04-24 09:55:58,13430.0,18,15666,6,13425.0,13,13430.0,1,S
2018-04-24 09:55:59,13430.0,2,15668,0,13430.0,10,13435.0,2,S
2018-04-24 09:56:08,13435.0,4,15672,-4,13435.0,8,13440.0,34,B
2018-04-24 09:56:09,13435.0,8,15680,-4,13435.0,4,13440.0,37,B
2018-04-24 09:56:13,13435.0,8,15688,0,13430.0,8,13435.0,2,B
2018-04-24 09:56:19,13435.0,2,15690,2,13430.0,7,13435.0,11,B
2018-04-24 09:56:23,13435.0,2,15692,2,13430.0,8,13435.0,10,B
2018-04-24 09:56:24,13430.0,2,15694,0,13430.0,7,13435.0,10,S
2018-04-24 09:56:32,13435.0,2,15696,0,13430.0,7,13435.0,11,B
2018-04-24 09:56:33,13435.0,22,15718,18,13435.0,6,13440.0,31,B
2018-04-24 09:56:33,13440.0,20,15738,6,13435.0,9,13440.0,16,B
2018-04-24 09:56:35,13435.0,4,15742,0,13435.0,3,13440.0,25,S
2018-04-24 09:56:45,13435.0,8,15750,0,13435.0,1,13440.0,25,S
2018-04-24 09:56:45,13435.0,2,15752,0,13430.0,3,13435.0,27,S
2018-04-24 09:56:46,13435.0,2,15754,0,13430.0,4,13435.0,17,S
2018-04-24 09:56:47,13435.0,2,15756,0,13425.0,2,13435.0,23,S
2018-04-24 09:56:52,13430.0,2,15758,0,13425.0,5,13430.0,1,S
2018-04-24 09:56:52,13430.0,2,15760,0,13425.0,5,13435.0,19,S
2018-04-24 09:57:07,13430.0,2,15762,0,13425.0,7,13430.0,6,S
2018-04-24 09:58:16,13430.0,2,15764,0,13425.0,4,13435.0,19,S
2018-04-24 09:58:21,13430.0,4,15768,0,13425.0,4,13435.0,32,S
2018-04-24 09:58:32,13425.0,8,15776,2,13420.0,9,13425.0,16,S
2018-04-24 09:58:32,13425.0,32,15808,2,13425.0,10,13430.0,2,S
2018-04-24 09:58:48,13430.0,4,15812,-2,13425.0,14,13435.0,29,B
2018-04-24 09:58:58,13430.0,2,15814,-2,13430.0,2,13435.0,35,B
2018-04-24 09:58:58,13430.0,4,15818,0,13425.0,14,13435.0,35,B
2018-04-24 09:58:59,13435.0,18,15836,-12,13425.0,5,13435.0,25,B
2018-04-24 09:59:15,13435.0,26,15862,-16,13435.0,12,13440.0,16,B
2018-04-24 09:59:16,13435.0,18,15880,-12,13435.0,3,13440.0,15,B
2018-04-24 09:59:16,13435.0,6,15886,-6,13430.0,1,13435.0,4,B
2018-04-24 09:59:17,13430.0,2,15888,0,13430.0,1,13435.0,3,S
2018-04-24 09:59:18,13430.0,6,15894,-2,13430.0,1,13435.0,3,S
2018-04-24 09:59:19,13435.0,4,15898,-4,13430.0,10,13435.0,1,B
2018-04-24 09:59:19,13435.0,2,15900,-2,13430.0,10,13440.0,14,B
2018-04-24 09:59:34,13435.0,2,15902,2,13430.0,2,13435.0,8,B
2018-04-24 09:59:34,13435.0,4,15906,2,13430.0,2,13435.0,6,B
2018-04-24 09:59:35,13435.0,2,15908,0,13430.0,2,13435.0,5,B
2018-04-24 09:59:36,13435.0,4,15912,4,13430.0,2,13435.0,3,B
2018-04-24 09:59:36,13435.0,2,15914,0,13430.0,2,13435.0,2,B
2018-04-24 09:59:37,13435.0,2,15916,0,13430.0,2,13435.0,1,B
2018-04-24 09:59:38,13435.0,2,15918,0,13430.0,2,13440.0,20,B
2018-04-24 09:59:39,13440.0,2,15920,0,13430.0,2,13440.0,19,B
2018-04-24 09:59:52,13440.0,12,15932,4,13435.0,22,13440.0,1,B
2018-04-24 09:59:53,13440.0,2,15934,2,13435.0,20,13445.0,5,B
2018-04-24 09:59:58,13445.0,6,15940,-6,13440.0,6,13450.0,18,B
2018-04-24 10:00:01,13450.0,6,15946,-6,13445.0,11,13455.0,5,B
2018-04-24 10:00:03,13455.0,4,15950,2,13450.0,3,13460.0,5,B
2018-04-24 10:00:04,13455.0,2,15952,2,13455.0,14,13460.0,5,B
2018-04-24 10:00:06,13450.0,2,15954,0,13450.0,2,13455.0,10,S
2018-04-24 10:00:07,13455.0,2,15956,0,13450.0,4,13455.0,8,B
2018-04-24 10:00:13,13450.0,2,15958,0,13450.0,1,13455.0,6,S
2018-04-24 10:00:14,13455.0,2,15960,0,13450.0,2,13455.0,5,B
2018-04-24 10:00:15,13455.0,2,15962,0,13450.0,2,13455.0,8,B
2018-04-24 10:00:19,13450.0,2,15964,2,13450.0,8,13455.0,3,S
2018-04-24 10:00:24,13455.0,2,15966,2,13450.0,6,13455.0,8,B
2018-04-24 10:00:37,13455.0,8,15974,-2,13450.0,5,13460.0,26,B
2018-04-24 10:00:39,13460.0,4,15978,4,13450.0,5,13460.0,26,B
2018-04-24 10:00:44,13450.0,2,15980,0,13450.0,3,13455.0,2,S
2018-04-24 10:00:45,13450.0,6,15986,0,13445.0,8,13455.0,19,S
2018-04-24 10:00:47,13445.0,2,15988,-2,13445.0,2,13450.0,21,S
2018-04-24 10:00:47,13445.0,4,15992,0,13440.0,5,13450.0,22,S
2018-04-24 10:00:56,13450.0,2,15994,-2,13440.0,5,13450.0,26,B
2018-04-24 10:01:02,13440.0,6,16000,4,13435.0,3,13440.0,6,S
2018-04-24 10:01:02,13435.0,2,16002,2,13435.0,1,13440.0,18,S
2018-04-24 10:01:03,13435.0,2,16004,2,13430.0,2,13440.0,34,S
2018-04-24 10:01:09,13440.0,16,16020,16,13435.0,10,13445.0,20,B
2018-04-24 10:01:16,13440.0,2,16022,-2,13435.0,7,13445.0,26,B
2018-04-24 10:01:23,13435.0,4,16026,0,13435.0,5,13445.0,29,S
2018-04-24 10:01:37,13435.0,6,16032,-4,13430.0,8,13440.0,17,S
2018-04-24 10:01:46,13440.0,4,16036,0,13440.0,3,13445.0,13,B
2018-04-24 10:01:59,13445.0,30,16066,-10,13440.0,3,13445.0,1,B
2018-04-24 10:01:59,13445.0,2,16068,0,13445.0,8,13450.0,8,B
2018-04-24 10:02:07,13450.0,2,16070,0,13445.0,5,13450.0,6,B
2018-04-24 10:02:08,13445.0,10,16080,-10,13440.0,5,13445.0,2,S
2018-04-24 10:02:13,13445.0,10,16090,-2,13445.0,1,13450.0,10,S
2018-04-24 10:02:14,13445.0,8,16098,-6,13440.0,7,13450.0,5,S
2018-04-24 10:02:40,13445.0,2,16100,0,13440.0,8,13445.0,3,S
2018-04-24 10:02:53,13440.0,10,16110,8,13435.0,7,13445.0,11,S
2018-04-24 10:03:02,13440.0,2,16112,-2,13435.0,24,13445.0,9,S
2018-04-24 10:03:21,13445.0,2,16114,2,13435.0,12,13445.0,5,B
2018-04-24 10:04:57,13445.0,10,16124,-2,13440.0,4,13445.0,1,B
2018-04-24 10:05:04,13445.0,4,16128,-2,13440.0,5,13450.0,7,B
2018-04-24 10:05:09,13440.0,2,16130,2,13440.0,4,13445.0,1,S
2018-04-24 10:05:44,13440.0,6,16136,4,13435.0,11,13440.0,1,S
2018-04-24 10:05:49,13440.0,2,16138,2,13435.0,9,13445.0,18,S
2018-04-24 10:06:33,13440.0,4,16142,-2,13435.0,9,13440.0,4,S
2018-04-24 10:06:34,13440.0,8,16150,-6,13440.0,2,13445.0,4,S
2018-04-24 10:06:55,13440.0,2,16152,2,13440.0,3,13445.0,1,S
2018-04-24 10:07:09,13440.0,2,16154,2,13440.0,2,13445.0,1,S
2018-04-24 10:07:13,13445.0,2,16156,2,13440.0,12,13450.0,19,B
2018-04-24 10:07:22,13450.0,20,16176,8,13440.0,19,13450.0,11,B
2018-04-24 10:07:29,13450.0,4,16180,0,13445.0,7,13455.0,5,B
2018-04-24 10:07:30,13455.0,2,16182,0,13445.0,13,13455.0,2,B
2018-04-24 10:07:46,13455.0,2,16184,0,13455.0,4,13460.0,8,B
2018-04-24 10:07:47,13460.0,10,16194,-4,13450.0,6,13460.0,11,B
2018-04-24 10:07:47,13455.0,4,16198,0,13455.0,2,13460.0,10,S
2018-04-24 10:07:55,13455.0,4,16202,-2,13450.0,6,13460.0,9,S
2018-04-24 10:08:07,13455.0,2,16204,0,13450.0,18,13455.0,3,S
2018-04-24 10:08:15,13455.0,6,16210,6,13455.0,8,13460.0,4,S
2018-04-24 10:08:27,13455.0,2,16212,2,13455.0,9,13460.0,3,S
2018-04-24 10:08:48,13450.0,4,16216,0,13450.0,10,13455.0,8,S
2018-04-24 10:08:49,13450.0,20,16236,14,13445.0,9,13450.0,1,S
2018-04-24 10:08:50,13445.0,12,16248,-2,13440.0,7,13445.0,4,S
2018-04-24 10:08:51,13445.0,8,16256,-6,13445.0,1,13450.0,1,S
2018-04-24 10:09:03,13445.0,6,16262,0,13440.0,10,13445.0,6,S
2018-04-24 10:09:26,13445.0,2,16264,-2,13440.0,23,13450.0,9,S
2018-04-24 10:09:45,13445.0,2,16266,0,13440.0,24,13450.0,7,S
2018-04-24 10:10:00,13440.0,8,16274,6,13445.0,1,13450.0,8,S
2018-04-24 10:10:13,13450.0,14,16288,4,13450.0,1,13455.0,6,B
2018-04-24 10:10:20,13450.0,4,16292,2,13450.0,2,13455.0,6,B
2018-04-24 10:10:22,13450.0,2,16294,0,13445.0,26,13455.0,6,B
2018-04-24 10:10:45,13450.0,6,16300,0,13445.0,2,13450.0,3,B
2018-04-24 10:10:53,13450.0,2,16302,-2,13445.0,10,13455.0,12,B
2018-04-24 10:11:16,13455.0,2,16304,0,13450.0,7,13455.0,13,B
2018-04-24 10:11:18,13455.0,4,16308,-2,13450.0,5,13455.0,11,B
2018-04-24 10:11:32,13450.0,4,16312,0,13450.0,3,13455.0,18,S
2018-04-24 10:11:32,13450.0,6,16318,-2,13445.0,6,13450.0,2,S
2018-04-24 10:12:13,13450.0,10,16328,-4,13445.0,24,13455.0,16,S
2018-04-24 10:12:21,13445.0,2,16330,0,13445.0,10,13455.0,14,S
2018-04-24 10:13:04,13455.0,2,16332,-2,13450.0,18,13455.0,8,B
2018-04-24 10:13:09,13455.0,16,16348,-6,13455.0,19,13460.0,8,B
2018-04-24 10:13:10,13460.0,4,16352,0,13455.0,19,13460.0,3,B
2018-04-24 10:13:14,13460.0,6,16358,2,13460.0,1,13465.0,7,B
2018-04-24 10:13:15,13465.0,10,16368,4,13465.0,2,13470.0,4,B
2018-04-24 10:13:16,13470.0,4,16372,-2,13465.0,14,13470.0,2,B
2018-04-24 10:13:16,13470.0,4,16376,0,13465.0,7,13470.0,2,B
2018-04-24 10:13:17,13460.0,16,16392,2,13460.0,3,13465.0,12,S
2018-04-24 10:13:18,13465.0,2,16394,-2,13460.0,14,13470.0,8,B
2018-04-24 10:13:21,13470.0,4,16398,2,13465.0,14,13475.0,4,B
2018-04-24 10:13:23,13470.0,2,16400,2,13465.0,16,13475.0,5,B
2018-04-24 10:13:33,13460.0,6,16406,-2,13455.0,11,13465.0,9,S
2018-04-24 10:13:40,13455.0,2,16408,0,13455.0,13,13465.0,7,S
2018-04-24 10:13:44,13455.0,4,16412,-2,13455.0,11,13460.0,1,S
2018-04-24 10:13:49,13465.0,2,16414,0,13455.0,14,13465.0,5,B
2018-04-24 10:13:49,13465.0,2,16416,2,13455.0,14,13465.0,5,B
2018-04-24 10:13:50,13465.0,2,16418,2,13455.0,14,13465.0,4,B
2018-04-24 10:13:56,13455.0,12,16430,4,13455.0,8,13465.0,9,S
2018-04-24 10:13:57,13455.0,2,16432,-2,13455.0,9,13465.0,11,S
2018-04-24 10:14:04,13455.0,2,16434,-2,13455.0,1,13460.0,11,S
2018-04-24 10:14:04,13455.0,2,16436,-2,13450.0,3,13455.0,1,S
2018-04-24 10:14:30,13450.0,6,16442,-2,13450.0,5,13455.0,2,S
2018-04-24 10:14:30,13455.0,2,16444,-2,13450.0,5,13455.0,1,B
2018-04-24 10:14:56,13455.0,2,16446,2,13450.0,7,13455.0,1,B
2018-04-24 10:14:57,13455.0,2,16448,0,13455.0,7,13460.0,8,B
2018-04-24 10:14:58,13455.0,10,16458,4,13450.0,23,13455.0,1,B
2018-04-24 10:14:58,13455.0,4,16462,-4,13450.0,7,13455.0,3,B
2018-04-24 10:14:59,13455.0,4,16466,0,13450.0,21,13460.0,8,B
2018-04-24 10:30:00,13455.0,2,16468,2,13455.0,2,13460.0,6,B
2018-04-24 10:30:01,13460.0,6,16474,6,13460.0,2,13465.0,12,B
2018-04-24 10:30:01,13455.0,8,16482,4,13455.0,3,13465.0,13,S
2018-04-24 10:30:24,13455.0,2,16484,0,13455.0,5,13465.0,7,S
2018-04-24 10:30:38,13465.0,14,16498,10,13460.0,1,13470.0,10,B
2018-04-24 10:30:40,13465.0,2,16500,0,13460.0,4,13465.0,3,B
2018-04-24 10:30:40,13470.0,36,16536,-16,13470.0,82,13475.0,22,B
2018-04-24 10:30:41,13470.0,46,16582,-22,13470.0,59,13475.0,25,B
2018-04-24 10:30:41,13470.0,2,16584,-2,13470.0,58,13475.0,23,B
2018-04-24 10:30:42,13470.0,14,16598,-2,13470.0,51,13475.0,23,B
2018-04-24 10:30:45,13475.0,6,16604,0,13470.0,50,13475.0,23,B
2018-04-24 10:30:45,13475.0,34,16638,-16,13470.0,50,13475.0,6,B
2018-04-24 10:30:46,13475.0,6,16644,0,13470.0,50,13475.0,6,B
2018-04-24 10:30:46,13475.0,12,16656,0,13475.0,8,13480.0,14,B
2018-04-24 10:31:03,13475.0,14,16670,-2,13475.0,9,13480.0,20,B
2018-04-24 10:31:04,13470.0,80,16750,-56,13470.0,19,13475.0,6,S
2018-04-24 10:31:04,13470.0,36,16786,0,13470.0,1,13475.0,7,S
2018-04-24 10:31:05,13470.0,2,16788,0,13465.0,1,13475.0,7,S
2018-04-24 10:31:06,13475.0,4,16792,-2,13465.0,1,13475.0,8,B
2018-04-24 10:31:09,13465.0,2,16794,0,13465.0,4,13475.0,5,S
2018-04-24 10:31:10,13475.0,2,16796,2,13465.0,4,13475.0,5,B
2018-04-24 10:31:11,13475.0,6,16802,-2,13465.0,5,13475.0,2,B
2018-04-24 10:31:12,13475.0,2,16804,-2,13470.0,6,13475.0,1,B
2018-04-24 10:31:14,13475.0,2,16806,0,13470.0,10,13480.0,18,B
2018-04-24 10:31:20,13480.0,6,16812,-2,13470.0,8,13480.0,21,B
2018-04-24 10:31:20,13480.0,6,16818,-2,13470.0,8,13480.0,21,B
2018-04-24 10:31:39,13480.0,38,16856,24,13470.0,6,13480.0,4,B
2018-04-24 10:31:40,13475.0,2,16858,0,13465.0,6,13475.0,1,S
2018-04-24 10:31:42,13475.0,2,16860,-2,13475.0,4,13480.0,1,S
2018-04-24 10:31:45,13480.0,2,16862,0,13475.0,4,13485.0,10,B
2018-04-24 10:31:56,13485.0,14,16876,-6,13480.0,6,13490.0,7,B
2018-04-24 10:31:57,13485.0,2,16878,-2,13480.0,6,13490.0,9,B
2018-04-24 10:31:58,13490.0,8,16886,0,13485.0,8,13495.0,11,B
2018-04-24 10:32:00,13495.0,2,16888,0,13490.0,6,13495.0,8,B
2018-04-24 10:32:02,13495.0,16,16904,-4,13495.0,82,13500.0,10,B
2018-04-24 10:32:03,13495.0,4,16908,0,13495.0,82,13500.0,15,B
2018-04-24 10:32:06,13495.0,2,16910,-2,13495.0,80,13500.0,17,B
2018-04-24 10:32:06,13495.0,120,17030,-82,13495.0,20,13500.0,14,B
2018-04-24 10:32:07,13495.0,36,17066,0,13495.0,2,13500.0,16,B
2018-04-24 10:32:07,13495.0,4,17070,-2,13490.0,3,13495.0,5,B
2018-04-24 10:32:08,13495.0,10,17080,0,13495.0,2,13500.0,14,B
2018-04-24 10:32:08,13495.0,2,17082,-2,13495.0,1,13500.0,18,B
2018-04-24 10:32:09,13495.0,2,17084,0,13490.0,2,13500.0,19,B
2018-04-24 10:32:10,13495.0,2,17086,2,13490.0,2,13495.0,8,B
2018-04-24 10:32:12,13495.0,2,17088,2,13490.0,2,13495.0,7,B
2018-04-24 10:32:14,13490.0,4,17092,0,13490.0,1,13495.0,8,S
2018-04-24 10:32:15,13495.0,16,17108,-4,13490.0,2,13500.0,21,B
2018-04-24 10:32:16,13495.0,2,17110,-2,13495.0,4,13500.0,16,B
2018-04-24 10:32:20,13500.0,30,17140,-6,13495.0,13,13505.0,4,B
2018-04-24 10:32:20,13510.0,12,17152,-8,13505.0,1,13510.0,2,B
2018-04-24 10:32:21,13510.0,4,17156,0,13505.0,1,13510.0,2,B
2018-04-24 10:32:21,13510.0,4,17160,-2,13500.0,13,13510.0,7,B
2018-04-24 10:32:25,13500.0,2,17162,-2,13500.0,3,13510.0,11,S
2018-04-24 10:32:27,13505.0,4,17166,-4,13500.0,4,13510.0,11,B
2018-04-24 10:32:30,13505.0,2,17168,0,13500.0,4,13510.0,13,B
2018-04-24 10:32:30,13500.0,4,17172,-2,13500.0,2,13510.0,13,S
2018-04-24 10:32:33,13505.0,2,17174,-2,13500.0,5,13510.0,9,B
2018-04-24 10:32:37,13510.0,2,17176,2,13505.0,4,13510.0,6,B
2018-04-24 10:32:38,13505.0,2,17178,0,13505.0,3,13510.0,6,S
2018-04-24 10:32:39,13505.0,2,17180,2,13505.0,2,13510.0,6,S
2018-04-24 10:32:42,13510.0,8,17188,-2,13505.0,2,13510.0,2,B
2018-04-24 10:32:44,13510.0,2,17190,0,13505.0,2,13510.0,1,B
2018-04-24 10:32:45,13500.0,2,17192,0,13505.0,1,13510.0,2,S
2018-04-24 10:32:45,13505.0,2,17194,0,13500.0,3,13510.0,5,B
2018-04-24 10:32:46,13500.0,4,17198,-2,13495.0,8,13505.0,6,S
2018-04-24 10:32:47,13505.0,4,17202,0,13500.0,1,13505.0,4,B
2018-04-24 10:32:51,13505.0,2,17204,-2,13500.0,10,13510.0,10,B
2018-04-24 10:32:53,13510.0,4,17208,0,13505.0,4,13510.0,7,B
2018-04-24 10:32:54,13510.0,14,17222,0,13505.0,11,13515.0,6,B
2018-04-24 10:32:59,13515.0,10,17232,-6,13510.0,13,13520.0,25,B
2018-04-24 10:32:59,13520.0,2,17234,0,13515.0,4,13520.0,10,B
2018-04-24 10:33:00,13520.0,2,17236,0,13515.0,5,13520.0,9,B
2018-04-24 10:33:01,13515.0,2,17238,0,13515.0,3,13520.0,25,S
2018-04-24 10:33:02,13520.0,2,17240,2,13515.0,3,13520.0,25,B
2018-04-24 10:33:03,13520.0,14,17254,-4,13510.0,8,13520.0,23,B
2018-04-24 10:33:05,13520.0,2,17256,2,13510.0,9,13520.0,22,B
2018-04-24 10:33:10,13520.0,4,17260,0,13510.0,8,13520.0,20,B
2018-04-24 10:33:13,13510.0,4,17264,0,13510.0,6,13515.0,2,S
2018-04-24 10:33:13,13510.0,4,17268,-2,13505.0,7,13515.0,24,S
2018-04-24 10:33:21,13510.0,8,17276,-8,13505.0,7,13515.0,22,S
2018-04-24 10:33:24,13505.0,16,17292,-8,13500.0,9,13510.0,2,S
2018-04-24 10:33:26,13510.0,2,17294,0,13505.0,6,13510.0,2,B
2018-04-24 10:33:33,13510.0,2,17296,-2,13505.0,6,13510.0,5,B
2018-04-24 10:33:38,13505.0,10,17306,-8,13500.0,11,13510.0,5,S
2018-04-24 10:33:42,13510.0,2,17308,0,13505.0,4,13510.0,5,B
2018-04-24 10:33:45,13510.0,2,17310,0,13505.0,4,13510.0,4,B
2018-04-24 10:33:45,13510.0,2,17312,0,13505.0,4,13510.0,3,B
2018-04-24 10:33:46,13510.0,2,17314,0,13505.0,4,13510.0,2,B
2018-04-24 10:33:52,13505.0,4,17318,2,13505.0,1,13510.0,19,S
2018-04-24 10:33:52,13505.0,2,17320,2,13500.0,4,13510.0,19,S
2018-04-24 10:33:53,13500.0,2,17322,-2,13500.0,6,13510.0,19,S
2018-04-24 10:33:57,13505.0,2,17324,-2,13500.0,9,13505.0,4,B
2018-04-24 10:34:06,13500.0,2,17326,-2,13500.0,6,13505.0,9,S
2018-04-24 10:34:08,13500.0,2,17328,2,13500.0,3,13505.0,9,S
2018-04-24 10:34:09,13500.0,2,17330,0,13500.0,1,13505.0,9,S
2018-04-24 10:34:12,13500.0,2,17332,0,13495.0,14,13505.0,9,S
2018-04-24 10:34:13,13500.0,2,17334,0,13495.0,18,13500.0,1,S
2018-04-24 10:34:13,13500.0,2,17336,0,13495.0,6,13505.0,9,S
2018-04-24 10:34:14,13495.0,2,17338,0,13495.0,5,13505.0,9,S
2018-04-24 10:34:23,13500.0,2,17340,0,13495.0,9,13500.0,3,B
2018-04-24 10:34:25,13500.0,6,17346,-6,13495.0,9,13505.0,7,B
2018-04-24 10:34:27,13500.0,2,17348,0,13495.0,9,13505.0,7,B
2018-04-24 10:34:45,13495.0,4,17352,2,13495.0,11,13500.0,5,S
2018-04-24 10:35:08,13500.0,14,17366,-8,13495.0,5,13500.0,5,B
2018-04-24 10:35:15,13500.0,4,17370,0,13495.0,8,13500.0,3,B
2018-04-24 10:35:27,13495.0,2,17372,-2,13495.0,8,13500.0,3,S
2018-04-24 10:35:31,13500.0,2,17374,0,13495.0,8,13500.0,3,B
2018-04-24 10:35:31,13500.0,6,17380,-2,13500.0,6,13505.0,11,B
2018-04-24 10:35:44,13500.0,6,17386,-6,13500.0,4,13505.0,14,B
2018-04-24 10:35:45,13500.0,4,17390,-2,13500.0,2,13505.0,12,B
2018-04-24 10:35:47,13500.0,2,17392,0,13500.0,1,13505.0,7,B
2018-04-24 10:35:51,13500.0,2,17394,2,13495.0,7,13505.0,5,B
2018-04-24 10:35:55,13500.0,2,17396,0,13500.0,2,13505.0,5,B
2018-04-24 10:36:02,13505.0,10,17406,4,13500.0,2,13510.0,15,B
2018-04-24 10:36:07,13500.0,2,17408,0,13500.0,3,13510.0,17,S
2018-04-24 10:36:10,13500.0,2,17410,-2,13500.0,2,13510.0,17,S
2018-04-24 10:36:15,13505.0,2,17412,2,13505.0,7,13510.0,19,B
2018-04-24 10:36:20,13505.0,2,17414,-2,13505.0,4,13510.0,18,B
2018-04-24 10:36:22,13505.0,2,17416,0,13505.0,3,13510.0,18,B
2018-04-24 10:36:29,13505.0,2,17418,2,13505.0,1,13510.0,19,B
2018-04-24 10:36:32,13510.0,20,17438,16,13505.0,1,13510.0,9,B
2018-04-24 10:36:48,13510.0,6,17444,6,13505.0,4,13510.0,7,B
2018-04-24 10:36:49,13510.0,10,17454,10,13505.0,4,13510.0,2,B
2018-04-24 10:36:57,13510.0,4,17458,-2,13510.0,2,13515.0,7,B
2018-04-24 10:37:01,13510.0,2,17460,0,13510.0,1,13515.0,8,B
2018-04-24 10:37:01,13515.0,2,17462,0,13510.0,1,13515.0,7,B
2018-04-24 10:37:07,13515.0,8,17470,2,13510.0,1,13515.0,8,B
2018-04-24 10:37:08,13510.0,2,17472,2,13505.0,3,13510.0,2,S
2018-04-24 10:37:08,13515.0,8,17480,2,13510.0,11,13520.0,11,B
2018-04-24 10:37:14,13510.0,4,17484,0,13510.0,2,13515.0,3,S
2018-04-24 10:37:18,13510.0,22,17506,16,13505.0,4,13510.0,8,S
2018-04-24 10:37:18,13510.0,2,17508,2,13505.0,4,13510.0,7,S
2018-04-24 10:37:27,13505.0,2,17510,0,13505.0,3,13510.0,15,S
2018-04-24 10:37:31,13505.0,4,17514,4,13500.0,10,13510.0,15,S
2018-04-24 10:37:33,13500.0,4,17518,-4,13500.0,10,13510.0,17,S
2018-04-24 10:37:43,13510.0,4,17522,0,13505.0,10,13510.0,15,B
2018-04-24 10:37:59,13510.0,16,17538,-12,13505.0,10,13510.0,8,B
2018-04-24 10:38:05,13510.0,2,17540,-2,13505.0,10,13510.0,9,B
2018-04-24 10:38:06,13505.0,2,17542,0,13505.0,9,13510.0,10,S
2018-04-24 10:38:11,13510.0,2,17544,-2,13505.0,11,13510.0,5,B
2018-04-24 10:38:11,13510.0,2,17546,-2,13505.0,11,13510.0,4,B
2018-04-24 10:38:12,13510.0,8,17554,-2,13510.0,9,13515.0,14,B
2018-04-24 10:38:15,13505.0,2,17556,0,13505.0,8,13515.0,17,S
2018-04-24 10:38:43,13505.0,10,17566,0,13505.0,3,13510.0,7,S
2018-04-24 10:38:43,13505.0,2,17568,0,13505.0,2,13510.0,7,S
2018-04-24 10:39:03,13505.0,2,17570,0,13505.0,1,13510.0,7,S
2018-04-24 10:39:11,13505.0,2,17572,0,13500.0,25,13505.0,7,S
2018-04-24 10:39:11,13505.0,8,17580,-8,13500.0,12,13505.0,6,S
2018-04-24 10:39:15,13500.0,24,17604,6,13495.0,14,13505.0,5,S
2018-04-24 10:39:16,13495.0,4,17608,-2,13490.0,15,13500.0,6,S
2018-04-24 10:39:36,13500.0,6,17614,0,13500.0,2,13505.0,6,B
2018-04-24 10:39:36,13500.0,2,17616,0,13500.0,3,13505.0,3,B
2018-04-24 10:39:47,13500.0,2,17618,0,13500.0,2,13505.0,1,B
2018-04-24 10:39:48,13500.0,2,17620,2,13500.0,1,13505.0,1,B
2018-04-24 10:39:51,13500.0,2,17622,2,13495.0,10,13505.0,7,B
2018-04-24 10:39:56,13500.0,2,17624,0,13500.0,5,13505.0,11,B
2018-04-24 10:39:56,13505.0,4,17628,-4,13500.0,5,13505.0,9,B
2018-04-24 10:40:24,13505.0,12,17640,-10,13500.0,19,13510.0,8,B
2018-04-24 10:40:25,13510.0,6,17646,-4,13505.0,20,13515.0,14,B
2018-04-24 10:40:28,13510.0,2,17648,0,13505.0,4,13510.0,7,B
2018-04-24 10:40:35,13510.0,2,17650,0,13505.0,4,13510.0,1,B
2018-04-24 10:41:02,13515.0,6,17656,-2,13505.0,6,13515.0,6,B
2018-04-24 10:41:04,13515.0,6,17662,0,13505.0,16,13515.0,3,B
2018-04-24 10:41:09,13515.0,2,17664,-2,13505.0,10,13515.0,9,B
2018-04-24 10:41:11,13515.0,2,17666,-2,13505.0,10,13515.0,8,B
2018-04-24 10:41:16,13505.0,2,17668,2,13505.0,11,13515.0,6,S
2018-04-24 10:41:20,13515.0,2,17670,0,13505.0,11,13515.0,5,B
2018-04-24 10:41:24,13505.0,18,17688,2,13500.0,10,13510.0,7,S
2018-04-24 10:41:27,13510.0,4,17692,2,13500.0,10,13510.0,5,B
2018-04-24 10:41:35,13510.0,6,17698,0,13505.0,12,13515.0,5,B
2018-04-24 10:41:48,13515.0,12,17710,8,13515.0,4,13520.0,20,B
2018-04-24 10:41:48,13505.0,14,17724,4,13505.0,35,13515.0,1,S
2018-04-24 10:42:04,13510.0,2,17726,-2,13510.0,4,13515.0,2,B
2018-04-24 10:42:05,13510.0,2,17728,-2,13510.0,5,13515.0,2,B
2018-04-24 10:42:12,13510.0,20,17748,14,13510.0,5,13515.0,2,B
2018-04-24 10:42:13,13510.0,10,17758,6,13505.0,34,13515.0,6,B
2018-04-24 10:42:18,13505.0,14,17772,-4,13505.0,26,13510.0,1,S
2018-04-24 10:42:24,13510.0,2,17774,-2,13505.0,25,13515.0,21,B
2018-04-24 10:42:39,13510.0,2,17776,2,13505.0,27,13510.0,2,B
2018-04-24 10:43:17,13505.0,28,17804,0,13505.0,14,13510.0,1,S
2018-04-24 10:43:18,13505.0,28,17832,4,13500.0,29,13510.0,2,S
2018-04-24 10:43:18,13500.0,12,17844,0,13500.0,27,13510.0,3,S
2018-04-24 10:43:23,13500.0,2,17846,0,13500.0,27,13510.0,3,S
2018-04-24 10:43:25,13500.0,2,17848,0,13500.0,26,13510.0,5,S
2018-04-24 10:43:26,13500.0,2,17850,0,13500.0,25,13510.0,5,S
2018-04-24 10:43:27,13500.0,2,17852,2,13500.0,25,13510.0,5,S
2018-04-24 10:43:29,13500.0,2,17854,2,13500.0,25,13510.0,5,S
2018-04-24 10:43:31,13505.0,2,17856,0,13505.0,1,13510.0,5,B
2018-04-24 10:43:32,13505.0,2,17858,2,13500.0,25,13510.0,5,B
2018-04-24 10:43:32,13500.0,2,17860,0,13500.0,12,13510.0,5,S
2018-04-24 10:43:44,13505.0,2,17862,2,13500.0,5,13505.0,1,B
2018-04-24 10:43:46,13500.0,10,17872,4,13500.0,2,13505.0,7,S
2018-04-24 10:43:46,13500.0,4,17876,4,13495.0,18,13505.0,7,S
2018-04-24 10:43:47,13495.0,2,17878,0,13495.0,19,13505.0,7,S
2018-04-24 10:44:03,13495.0,10,17888,2,13500.0,7,13505.0,5,S
2018-04-24 10:44:04,13495.0,14,17902,12,13500.0,1,13505.0,5,S
2018-04-24 10:44:04,13495.0,4,17906,2,13495.0,19,13505.0,7,S
2018-04-24 10:44:32,13495.0,6,17912,4,13495.0,5,13505.0,12,S
2018-04-24 10:44:57,13495.0,2,17914,0,13495.0,4,13500.0,15,S
2018-04-24 10:45:03,13500.0,2,17916,0,13495.0,19,13500.0,21,B
2018-04-24 10:45:06,13495.0,14,17930,8,13495.0,5,13500.0,15,S
2018-04-24 10:45:11,13495.0,8,17938,-6,13490.0,3,13500.0,20,S
2018-04-24 10:45:14,13490.0,2,17940,-2,13490.0,5,13500.0,20,S
2018-04-24 10:45:24,13490.0,10,17950,0,13490.0,11,13495.0,10,S
2018-04-24 10:45:25,13490.0,22,17972,20,13485.0,4,13495.0,12,S
2018-04-24 10:45:29,13485.0,2,17974,0,13485.0,3,13495.0,12,S
2018-04-24 10:45:30,13495.0,2,17976,0,13485.0,3,13495.0,11,B
2018-04-24 10:45:36,13485.0,2,17978,0,13485.0,2,13495.0,9,S
2018-04-24 10:45:42,13485.0,4,17982,2,13485.0,3,13490.0,13,S
2018-04-24 10:45:44,13485.0,2,17984,-2,13485.0,2,13490.0,13,S
2018-04-24 10:45:44,13485.0,4,17988,-4,13480.0,13,13485.0,1,S
2018-04-24 10:45:52,13480.0,2,17990,-2,13480.0,12,13485.0,5,S
2018-04-24 10:45:59,13480.0,2,17992,-2,13480.0,11,13485.0,6,S
2018-04-24 10:46:03,13480.0,20,18012,0,13480.0,1,13485.0,8,S
2018-04-24 10:46:04,13480.0,2,18014,2,13475.0,3,13480.0,1,S
2018-04-24 10:46:04,13480.0,2,18016,0,13475.0,3,13480.0,4,S
2018-04-24 10:46:05,13475.0,2,18018,0,13475.0,2,13480.0,6,S
2018-04-24 10:46:05,13475.0,4,18022,0,13470.0,15,13480.0,6,S
2018-04-24 10:46:06,13470.0,2,18024,2,13470.0,16,13480.0,6,S
2018-04-24 10:46:06,13480.0,2,18026,0,13475.0,3,13480.0,5,B
2018-04-24 10:46:10,13475.0,6,18032,0,13470.0,2,13475.0,2,S
2018-04-24 10:46:10,13470.0,4,18036,2,13465.0,4,13470.0,10,S
2018-04-24 10:46:14,13470.0,4,18040,0,13465.0,4,13470.0,9,S
2018-04-24 10:46:15,13470.0,18,18058,-8,13465.0,4,13475.0,15,S
2018-04-24 10:46:15,13475.0,16,18074,0,13470.0,25,13475.0,1,B
2018-04-24 10:46:16,13480.0,4,18078,-2,13475.0,9,13480.0,7,B
2018-04-24 10:46:20,13475.0,8,18086,8,13470.0,13,13480.0,10,S
2018-04-24 10:46:33,13475.0,6,18092,0,13475.0,1,13480.0,11,S
2018-04-24 10:46:33,13475.0,2,18094,2,13470.0,12,13480.0,11,S
2018-04-24 10:47:09,13480.0,28,18122,14,13480.0,3,13485.0,7,B
2018-04-24 10:47:09,13485.0,8,18130,2,13480.0,13,13485.0,1,B
2018-04-24 10:47:10,13485.0,2,18132,2,13480.0,10,13490.0,8,B
2018-04-24 10:47:11,13480.0,2,18134,2,13475.0,13,13485.0,7,S
2018-04-24 10:47:30,13480.0,8,18142,8,13480.0,11,13485.0,9,S
2018-04-24 10:47:30,13480.0,2,18144,0,13480.0,15,13485.0,9,S
2018-04-24 10:47:36,13480.0,2,18146,0,13480.0,14,13485.0,6,S
2018-04-24 10:47:37,13480.0,2,18148,2,13480.0,13,13485.0,6,S
2018-04-24 10:47:39,13480.0,2,18150,2,13480.0,12,13485.0,6,S
2018-04-24 10:47:41,13480.0,2,18152,2,13480.0,11,13485.0,6,S
2018-04-24 10:47:41,13480.0,16,18168,12,13480.0,3,13485.0,6,S
2018-04-24 10:47:50,13480.0,2,18170,0,13480.0,6,13485.0,6,S
2018-04-24 10:47:51,13480.0,2,18172,2,13480.0,5,13485.0,6,S
2018-04-24 10:47:52,13480.0,10,18182,-4,13475.0,6,13480.0,1,S
2018-04-24 10:47:54,13480.0,4,18186,-4,13475.0,4,13480.0,10,S
2018-04-24 10:47:54,13475.0,2,18188,2,13475.0,3,13480.0,10,S
2018-04-24 10:47:59,13475.0,10,18198,0,13475.0,1,13480.0,1,S
2018-04-24 10:47:59,13470.0,10,18208,-4,13470.0,3,13475.0,8,S
2018-04-24 10:48:02,13475.0,4,18212,-4,13470.0,9,13480.0,13,B
2018-04-24 10:48:03,13470.0,10,18222,-2,13470.0,4,13480.0,13,S
2018-04-24 10:48:13,13470.0,6,18228,-4,13465.0,10,13470.0,9,S
2018-04-24 10:48:13,13470.0,2,18230,-2,13465.0,10,13470.0,8,S
2018-04-24 10:48:14,13470.0,2,18232,0,13465.0,10,13470.0,7,S
2018-04-24 10:48:16,13470.0,14,18246,0,13470.0,13,13475.0,11,S
2018-04-24 10:48:17,13470.0,10,18256,0,13470.0,9,13475.0,11,S
2018-04-24 10:48:19,13470.0,2,18258,0,13470.0,13,13475.0,6,S
2018-04-24 10:48:22,13475.0,4,18262,-2,13470.0,13,13475.0,4,B
2018-04-24 10:48:32,13470.0,2,18264,0,13470.0,6,13475.0,6,S
2018-04-24 10:48:47,13470.0,2,18266,2,13470.0,5,13475.0,6,S
2018-04-24 10:48:48,13470.0,4,18270,4,13470.0,3,13475.0,6,S
2018-04-24 10:48:48,13470.0,6,18276,0,13465.0,6,13470.0,6,S
2018-04-24 10:48:50,13465.0,8,18284,4,13460.0,5,13470.0,10,S
2018-04-24 10:48:53,13460.0,8,18292,0,13455.0,2,13465.0,8,S
2018-04-24 10:48:53,13455.0,2,18294,2,13455.0,1,13460.0,7,S
2018-04-24 10:48:55,13460.0,18,18312,2,13460.0,3,13465.0,10,B
2018-04-24 10:48:56,13465.0,8,18320,-2,13465.0,2,13470.0,4,B
2018-04-24 10:48:58,13465.0,14,18334,14,13460.0,8,13465.0,1,B
2018-04-24 10:49:00,13465.0,2,18336,2,13460.0,6,13465.0,2,B
2018-04-24 10:49:01,13465.0,2,18338,0,13460.0,6,13465.0,1,B
2018-04-24 10:49:03,13460.0,2,18340,-2,13455.0,10,13465.0,5,S
2018-04-24 10:49:06,13465.0,4,18344,-2,13460.0,1,13465.0,2,B
2018-04-24 10:49:09,13465.0,2,18346,0,13460.0,2,13465.0,2,B
2018-04-24 10:49:11,13465.0,2,18348,-2,13460.0,2,13465.0,1,B
2018-04-24 10:49:26,13460.0,4,18352,0,13460.0,2,13465.0,2,S
2018-04-24 10:49:33,13460.0,2,18354,2,13460.0,2,13465.0,3,S
2018-04-24 10:49:35,13465.0,6,18360,2,13465.0,7,13470.0,13,B
2018-04-24 10:49:36,13465.0,10,18370,4,13465.0,2,13470.0,13,B
2018-04-24 10:49:42,13465.0,6,18376,4,13460.0,4,13465.0,5,B
2018-04-24 10:49:43,13465.0,10,18386,6,13465.0,14,13470.0,3,B
2018-04-24 10:49:47,13475.0,2,18388,-2,13465.0,11,13475.0,13,B
2018-04-24 10:49:48,13470.0,2,18390,0,13465.0,10,13475.0,13,S
2018-04-24 10:49:53,13470.0,2,18392,2,13465.0,10,13475.0,12,S
2018-04-24 10:50:00,13470.0,2,18394,0,13470.0,2,13475.0,10,S
2018-04-24 10:50:03,13470.0,4,18398,0,13465.0,10,13475.0,8,S
2018-04-24 10:50:10,13470.0,2,18400,-2,13470.0,3,13475.0,6,S
2018-04-24 10:50:19,13470.0,16,18416,12,13465.0,11,13470.0,2,S
2018-04-24 10:50:20,13470.0,4,18420,4,13470.0,5,13475.0,4,S
2018-04-24 10:50:38,13470.0,4,18424,-2,13470.0,2,13475.0,7,S
2018-04-24 10:50:39,13470.0,4,18428,4,13465.0,10,13470.0,8,S
2018-04-24 10:50:48,13470.0,2,18430,-2,13465.0,9,13470.0,2,S
2018-04-24 10:51:02,13470.0,4,18434,-4,13465.0,12,13475.0,11,S
2018-04-24 10:51:19,13470.0,2,18436,0,13465.0,12,13475.0,11,S
2018-04-24 10:51:22,13465.0,8,18444,-4,13460.0,8,13465.0,7,S
2018-04-24 10:51:25,13460.0,2,18446,0,13460.0,3,13465.0,8,S
2018-04-24 10:51:35,13465.0,6,18452,-6,13460.0,20,13470.0,10,B
2018-04-24 10:51:59,13470.0,4,18456,-4,13465.0,3,13470.0,6,B
2018-04-24 10:52:12,13470.0,10,18466,4,13465.0,5,13475.0,8,B
2018-04-24 10:52:14,13470.0,2,18468,0,13470.0,6,13475.0,2,B
2018-04-24 10:52:20,13470.0,2,18470,-2,13470.0,5,13475.0,3,B
2018-04-24 10:52:25,13475.0,4,18474,-4,13470.0,5,13480.0,5,B
2018-04-24 10:52:38,13480.0,2,18476,0,13475.0,5,13480.0,5,B
2018-04-24 10:52:43,13480.0,6,18482,-4,13475.0,5,13480.0,2,B
2018-04-24 10:52:49,13480.0,6,18488,-2,13480.0,3,13485.0,10,B
2018-04-24 10:52:49,13480.0,2,18490,0,13480.0,2,13485.0,13,B
2018-04-24 10:52:55,13480.0,2,18492,0,13480.0,3,13485.0,10,B
2018-04-24 10:52:57,13485.0,2,18494,0,13480.0,3,13485.0,9,B
2018-04-24 10:53:06,13480.0,2,18496,-2,13480.0,2,13485.0,9,S
2018-04-24 10:53:10,13480.0,2,18498,-2,13480.0,1,13485.0,11,S
2018-04-24 10:53:11,13480.0,2,18500,-2,13475.0,6,13485.0,14,S
2018-04-24 10:53:20,13475.0,6,18506,0,13475.0,2,13480.0,2,S
2018-04-24 10:53:30,13470.0,10,18516,0,13465.0,11,13475.0,10,S
2018-04-24 10:53:31,13465.0,2,18518,-2,13465.0,4,13470.0,4,S
2018-04-24 10:53:32,13465.0,8,18526,-8,13460.0,4,13470.0,7,S
2018-04-24 10:53:36,13470.0,2,18528,0,13465.0,1,13470.0,1,B
2018-04-24 10:53:45,13470.0,6,18534,4,13465.0,7,13475.0,9,B
2018-04-24 10:54:08,13460.0,4,18538,0,13455.0,5,13465.0,8,S
2018-04-24 10:54:28,13465.0,2,18540,0,13460.0,2,13465.0,3,B
2018-04-24 10:54:53,13460.0,4,18544,2,13460.0,6,13470.0,11,S
2018-04-24 10:55:05,13460.0,2,18546,2,13460.0,7,13470.0,12,S
2018-04-24 10:55:14,13470.0,2,18548,0,13465.0,9,13470.0,2,B
2018-04-24 10:55:18,13465.0,6,18554,-6,13460.0,7,13470.0,8,S
2018-04-24 10:55:23,13460.0,6,18560,0,13460.0,4,13470.0,8,S
2018-04-24 10:55:46,13460.0,6,18566,2,13460.0,4,13470.0,8,S
2018-04-24 10:55:55,13470.0,2,18568,2,13460.0,4,13470.0,8,B
2018-04-24 10:56:04,13470.0,2,18570,2,13460.0,4,13470.0,7,B
2018-04-24 10:56:42,13470.0,2,18572,0,13465.0,4,13470.0,1,B
2018-04-24 10:56:51,13470.0,2,18574,0,13465.0,4,13475.0,6,B
2018-04-24 10:57:12,13470.0,2,18576,-2,13465.0,4,13475.0,8,B
2018-04-24 10:57:47,13470.0,4,18580,-4,13465.0,2,13475.0,7,B
2018-04-24 10:58:19,13470.0,2,18582,0,13470.0,3,13475.0,10,B
2018-04-24 10:58:37,13475.0,2,18584,2,13470.0,3,13475.0,9,B
2018-04-24 10:58:43,13470.0,2,18586,0,13470.0,2,13475.0,9,S
2018-04-24 10:58:46,13470.0,4,18590,0,13465.0,5,13475.0,6,S
2018-04-24 10:59:04,13470.0,2,18592,0,13465.0,5,13470.0,49,S
2018-04-24 10:59:26,13470.0,50,18642,26,13465.0,21,13470.0,24,S
2018-04-24 10:59:27,13470.0,48,18690,40,13470.0,6,13475.0,3,S
2018-04-24 10:59:27,13475.0,6,18696,4,13470.0,9,13480.0,4,B
2018-04-24 10:59:36,13470.0,2,18698,0,13470.0,3,13475.0,13,S
2018-04-24 10:59:36,13470.0,6,18704,4,13465.0,9,13475.0,13,S
2018-04-24 10:59:39,13465.0,18,18722,8,13460.0,26,13465.0,21,S
2018-04-24 10:59:39,13465.0,28,18750,8,13460.0,26,13465.0,7,S
2018-04-24 10:59:40,13465.0,18,18768,12,13465.0,2,13470.0,3,S
2018-04-24 10:59:42,13470.0,6,18774,0,13465.0,16,13475.0,8,B
2018-04-24 11:00:24,13470.0,2,18776,2,13470.0,4,13475.0,7,B
2018-04-24 11:00:26,13470.0,2,18778,2,13470.0,3,13475.0,7,B
2018-04-24 11:00:35,13470.0,6,18784,-2,13465.0,22,13475.0,3,B
2018-04-24 11:00:46,13470.0,2,18786,2,13470.0,2,13475.0,3,B
2018-04-24 11:01:05,13470.0,6,18792,4,13465.0,22,13470.0,17,B
2018-04-24 11:01:35,13470.0,20,18812,18,13465.0,9,13470.0,7,B
2018-04-24 11:01:35,13470.0,14,18826,0,13465.0,22,13475.0,4,B
2018-04-24 11:01:47,13475.0,2,18828,-2,13465.0,26,13475.0,3,B
2018-04-24 11:02:17,13465.0,2,18830,-2,13465.0,5,13470.0,13,S
2018-04-24 11:02:18,13465.0,10,18840,-6,13460.0,17,13470.0,18,S
2018-04-24 11:02:29,13460.0,28,18868,8,13460.0,3,13470.0,18,S
2018-04-24 11:02:30,13460.0,6,18874,2,13455.0,17,13465.0,4,S
2018-04-24 11:02:31,13460.0,4,18878,0,13455.0,19,13465.0,4,S
2018-04-24 11:02:42,13455.0,36,18914,18,13450.0,21,13460.0,15,S
2018-04-24 11:02:45,13450.0,2,18916,2,13450.0,7,13455.0,1,S
2018-04-24 11:02:45,13450.0,12,18928,2,13450.0,1,13455.0,1,S
2018-04-24 11:02:46,13450.0,2,18930,0,13445.0,2,13455.0,2,S
2018-04-24 11:03:20,13450.0,12,18942,12,13445.0,9,13455.0,8,S
2018-04-24 11:03:46,13455.0,6,18948,-2,13450.0,24,13460.0,11,B
2018-04-24 11:04:00,13455.0,14,18962,-4,13450.0,12,13460.0,10,B
2018-04-24 11:04:10,13450.0,8,18970,0,13450.0,7,13460.0,10,S
2018-04-24 11:04:18,13450.0,2,18972,-2,13450.0,8,13455.0,4,S
2018-04-24 11:04:19,13455.0,18,18990,8,13445.0,6,13455.0,9,B
2018-04-24 11:04:27,13450.0,4,18994,0,13445.0,3,13450.0,1,S
2018-04-24 11:04:33,13450.0,6,19000,0,13450.0,1,13455.0,12,S
2018-04-24 11:04:34,13450.0,2,19002,-2,13445.0,3,13455.0,12,S
2018-04-24 11:04:48,13445.0,2,19004,0,13445.0,1,13450.0,8,S
2018-04-24 11:04:48,13445.0,2,19006,2,13440.0,16,13450.0,8,S
2018-04-24 11:04:49,13440.0,2,19008,0,13440.0,12,13450.0,9,S
2018-04-24 11:04:49,13440.0,8,19016,8,13440.0,8,13450.0,9,S
2018-04-24 11:04:50,13440.0,2,19018,-2,13440.0,7,13450.0,9,S
2018-04-24 11:04:53,13450.0,14,19032,-10,13450.0,3,13455.0,10,B
2018-04-24 11:04:53,13450.0,6,19038,-6,13445.0,1,13450.0,10,B
2018-04-24 11:04:54,13440.0,6,19044,2,13440.0,7,13450.0,7,S
2018-04-24 11:05:01,13445.0,10,19054,6,13435.0,5,13445.0,6,B
2018-04-24 11:05:02,13445.0,6,19060,0,13435.0,7,13445.0,4,B
2018-04-24 11:05:04,13445.0,8,19068,-6,13435.0,6,13445.0,2,B
2018-04-24 11:05:07,13440.0,2,19070,0,13440.0,10,13445.0,3,S
2018-04-24 11:05:07,13445.0,6,19076,2,13440.0,10,13450.0,9,B
2018-04-24 11:05:09,13450.0,2,19078,2,13445.0,8,13455.0,6,B
2018-04-24 11:05:35,13450.0,2,19080,0,13450.0,4,13455.0,14,B
2018-04-24 11:05:51,13450.0,2,19082,2,13450.0,3,13455.0,11,B
2018-04-24 11:05:51,13450.0,2,19084,2,13450.0,2,13455.0,11,B
2018-04-24 11:06:00,13450.0,2,19086,2,13450.0,1,13455.0,11,B
2018-04-24 11:06:04,13455.0,4,19090,-4,13450.0,7,13455.0,3,B
2018-04-24 11:06:04,13455.0,6,19096,-2,13450.0,8,13460.0,3,B
2018-04-24 11:06:58,13450.0,2,19098,-2,13450.0,4,13455.0,11,S
2018-04-24 11:06:59,13455.0,2,19100,2,13450.0,4,13455.0,10,B
2018-04-24 11:07:04,13450.0,6,19106,-2,13445.0,8,13450.0,6,S
2018-04-24 11:07:17,13450.0,2,19108,-2,13450.0,2,13455.0,18,S
2018-04-24 11:07:18,13450.0,2,19110,-2,13450.0,2,13455.0,18,S
2018-04-24 11:07:19,13450.0,4,19114,2,13445.0,8,13455.0,18,S
2018-04-24 11:07:20,13445.0,4,19118,2,13445.0,6,13455.0,18,S
2018-04-24 11:07:59,13450.0,14,19132,10,13445.0,21,13450.0,3,B
2018-04-24 11:08:00,13450.0,6,19138,4,13450.0,6,13455.0,9,B
2018-04-24 11:08:11,13455.0,20,19158,20,13450.0,3,13460.0,4,B
2018-04-24 11:08:25,13450.0,4,19162,2,13445.0,10,13450.0,8,S
2018-04-24 11:08:26,13450.0,10,19172,10,13445.0,10,13450.0,3,S
2018-04-24 11:08:37,13450.0,2,19174,0,13445.0,19,13450.0,3,S
2018-04-24 11:08:39,13450.0,4,19178,4,13445.0,19,13450.0,1,S
2018-04-24 11:09:26,13450.0,10,19188,6,13445.0,14,13450.0,6,S
2018-04-24 11:09:27,13450.0,12,19200,12,13450.0,4,13455.0,13,S
2018-04-24 11:09:30,13455.0,14,19214,12,13450.0,7,13455.0,5,B
2018-04-24 11:09:41,13455.0,8,19222,6,13450.0,9,13460.0,5,B
2018-04-24 11:10:05,13455.0,2,19224,0,13450.0,6,13460.0,12,B
2018-04-24 11:10:06,13450.0,2,19226,2,13450.0,5,13460.0,12,S
2018-04-24 11:10:11,13460.0,2,19228,0,13450.0,6,13460.0,11,B
2018-04-24 11:10:24,13460.0,6,19234,0,13450.0,7,13460.0,8,B
2018-04-24 11:11:02,13455.0,2,19236,0,13450.0,8,13455.0,9,S
2018-04-24 11:11:06,13455.0,8,19244,4,13450.0,30,13455.0,5,S
2018-04-24 11:11:07,13455.0,10,19254,4,13450.0,32,13460.0,2,S
2018-04-24 11:11:52,13460.0,2,19256,2,13455.0,7,13460.0,11,B
2018-04-24 11:11:58,13460.0,2,19258,2,13455.0,7,13460.0,10,B
2018-04-24 11:12:02,13460.0,10,19268,10,13455.0,7,13460.0,5,B
2018-04-24 11:12:17,13455.0,14,19282,4,13450.0,9,13455.0,6,S
2018-04-24 11:13:15,13455.0,2,19284,-2,13450.0,7,13455.0,4,S
2018-04-24 11:13:23,13450.0,14,19298,12,13445.0,19,13450.0,6,S
2018-04-24 11:13:23,13450.0,10,19308,4,13445.0,25,13450.0,1,S
2018-04-24 11:13:24,13450.0,2,19310,0,13450.0,2,13455.0,4,S
2018-04-24 11:13:39,13455.0,2,19312,-2,13450.0,3,13455.0,3,B
2018-04-24 11:14:37,13455.0,10,19322,8,13455.0,5,13460.0,7,B
2018-04-24 11:14:38,13455.0,4,19326,0,13455.0,3,13460.0,7,B
2018-04-24 11:14:38,13455.0,6,19332,0,13450.0,4,13460.0,7,B
2018-04-24 11:14:40,13455.0,2,19334,0,13450.0,4,13455.0,1,B
2018-04-24 11:15:18,13450.0,6,19340,0,13445.0,7,13455.0,12,S
2018-04-24 11:15:19,13445.0,2,19342,0,13445.0,2,13450.0,4,S
2018-04-24 11:15:24,13445.0,2,19344,0,13445.0,1,13450.0,3,S
2018-04-24 11:15:24,13445.0,2,19346,2,13445.0,2,13450.0,3,S
2018-04-24 11:16:13,13445.0,2,19348,2,13440.0,10,13450.0,12,S
2018-04-24 11:16:18,13440.0,6,19354,-4,13440.0,5,13445.0,2,S
2018-04-24 11:16:25,13440.0,8,19362,2,13440.0,2,13445.0,8,S
2018-04-24 11:16:25,13440.0,4,19366,-2,13435.0,3,13440.0,1,S
2018-04-24 11:16:50,13440.0,2,19368,0,13435.0,10,13445.0,9,S
2018-04-24 11:17:19,13445.0,4,19372,2,13445.0,2,13450.0,9,B
2018-04-24 11:17:20,13445.0,4,19376,-4,13440.0,5,13450.0,12,B
2018-04-24 11:17:40,13445.0,2,19378,2,13440.0,3,13445.0,4,B
2018-04-24 11:18:05,13445.0,8,19386,8,13445.0,10,13450.0,5,B
2018-04-24 11:18:06,13450.0,8,19394,4,13445.0,12,13455.0,4,B
2018-04-24 11:18:07,13450.0,2,19396,2,13445.0,30,13455.0,5,B
2018-04-24 11:18:10,13455.0,2,19398,0,13445.0,30,13455.0,5,B
2018-04-24 11:18:13,13455.0,2,19400,0,13450.0,1,13455.0,3,B
2018-04-24 11:18:17,13450.0,6,19406,2,13445.0,6,13450.0,12,S
2018-04-24 11:18:18,13445.0,4,19410,0,13445.0,2,13450.0,15,S
2018-04-24 11:18:18,13445.0,4,19414,-2,13440.0,6,13450.0,11,S
2018-04-24 11:18:27,13445.0,4,19418,-4,13440.0,24,13450.0,13,S
2018-04-24 11:18:55,13450.0,16,19434,0,13450.0,2,13455.0,3,B
2018-04-24 11:19:03,13450.0,2,19436,2,13445.0,15,13455.0,6,B
2018-04-24 11:19:54,13455.0,8,19444,-8,13450.0,8,13460.0,4,B
2018-04-24 11:20:06,13455.0,2,19446,0,13450.0,5,13455.0,3,B
2018-04-24 11:20:25,13455.0,2,19448,0,13450.0,3,13455.0,5,B
2018-04-24 11:20:51,13455.0,8,19456,-6,13450.0,6,13455.0,3,B
2018-04-24 11:21:10,13455.0,2,19458,0,13450.0,4,13455.0,4,B
2018-04-24 11:21:22,13455.0,6,19464,0,13450.0,4,13460.0,29,B
2018-04-24 11:21:38,13455.0,2,19466,0,13450.0,18,13455.0,1,B
2018-04-24 11:22:03,13450.0,2,19468,2,13450.0,3,13455.0,2,S
2018-04-24 11:22:12,13450.0,2,19470,0,13450.0,2,13455.0,2,S
2018-04-24 11:22:20,13450.0,2,19472,2,13450.0,2,13455.0,2,S
2018-04-24 11:22:39,13455.0,2,19474,0,13450.0,7,13460.0,10,B
2018-04-24 11:22:56,13460.0,2,19476,2,13460.0,7,13465.0,7,B
2018-04-24 11:23:03,13460.0,2,19478,2,13460.0,1,13465.0,7,B
2018-04-24 11:23:21,13465.0,2,19480,0,13455.0,8,13465.0,12,B
2018-04-24 11:23:22,13465.0,2,19482,0,13455.0,8,13465.0,11,B
2018-04-24 11:24:11,13460.0,2,19484,2,13460.0,13,13465.0,13,S
2018-04-24 11:24:20,13460.0,4,19488,0,13455.0,6,13460.0,12,S
2018-04-24 11:24:24,13455.0,2,19490,0,13455.0,5,13460.0,12,S
2018-04-24 11:24:28,13460.0,2,19492,0,13455.0,7,13460.0,6,B
2018-04-24 11:24:36,13460.0,2,19494,0,13455.0,7,13460.0,15,B
2018-04-24 11:25:20,13460.0,6,19500,0,13455.0,17,13460.0,17,B
2018-04-24 11:25:28,13460.0,20,19520,0,13455.0,7,13460.0,7,B
2018-04-24 11:25:29,13460.0,2,19522,-2,13455.0,7,13460.0,6,B
2018-04-24 11:25:42,13460.0,14,19536,-4,13460.0,3,13465.0,10,B
2018-04-24 11:26:20,13460.0,4,19540,0,13455.0,11,13460.0,1,B
2018-04-24 11:26:40,13460.0,2,19542,-2,13455.0,11,13460.0,2,B
2018-04-24 11:27:02,13460.0,6,19548,2,13455.0,26,13465.0,15,B
2018-04-24 11:27:05,13455.0,10,19558,10,13460.0,1,13465.0,16,S
2018-04-24 11:27:08,13460.0,2,19560,2,13455.0,30,13460.0,2,B
2018-04-24 11:27:09,13460.0,4,19564,4,13455.0,30,13465.0,16,B
2018-04-24 11:27:36,13460.0,2,19566,0,13455.0,22,13465.0,11,B
2018-04-24 11:27:56,13460.0,2,19568,0,13455.0,5,13460.0,3,B
2018-04-24 11:28:05,13455.0,4,19572,-4,13455.0,8,13465.0,8,S
2018-04-24 11:28:11,13465.0,10,19582,-4,13460.0,27,13470.0,3,B
2018-04-24 11:28:14,13470.0,2,19584,0,13465.0,19,13470.0,1,B
2018-04-24 11:28:14,13470.0,2,19586,0,13470.0,3,13480.0,2,B
2018-04-24 11:28:22,13475.0,2,19588,0,13470.0,4,13475.0,2,B
2018-04-24 11:28:26,13475.0,4,19592,-2,13470.0,20,13480.0,10,B
2018-04-24 11:28:37,13480.0,2,19594,0,13475.0,5,13480.0,2,B
2018-04-24 11:28:43,13475.0,4,19598,0,13475.0,2,13480.0,5,S
2018-04-24 11:28:44,13475.0,4,19602,-2,13470.0,4,13475.0,4,S
2018-04-24 11:29:03,13475.0,2,19604,0,13470.0,10,13480.0,10,S
2018-04-24 11:29:14,13475.0,2,19606,-2,13470.0,10,13480.0,11,S
2018-04-24 11:29:24,13480.0,6,19612,-4,13470.0,10,13480.0,9,B
2018-04-24 11:29:30,13470.0,2,19614,0,13470.0,10,13480.0,9,S
2018-04-24 11:29:30,13470.0,2,19616,0,13470.0,9,13480.0,9,S
2018-04-24 11:29:40,13480.0,6,19622,-6,13480.0,2,13485.0,4,B
2018-04-24 11:29:54,13480.0,8,19630,0,13475.0,2,13485.0,10,B
2018-04-24 11:29:59,13470.0,6,19636,0,13470.0,6,13480.0,6,S
2018-04-24 13:30:01,13480.0,4,19640,0,13475.0,8,13480.0,1,B
2018-04-24 13:30:02,13480.0,2,19642,2,13480.0,5,13485.0,2,B
2018-04-24 13:30:05,13480.0,14,19656,6,13480.0,4,13485.0,1,B
2018-04-24 13:30:06,13480.0,4,19660,4,13480.0,2,13485.0,1,B
2018-04-24 13:30:10,13480.0,4,19664,0,13475.0,26,13485.0,1,B
2018-04-24 13:30:11,13480.0,6,19670,6,13480.0,4,13485.0,1,B
2018-04-24 13:30:12,13485.0,2,19672,0,13480.0,1,13485.0,1,B
2018-04-24 13:30:17,13490.0,2,19674,0,13485.0,5,13495.0,4,B
2018-04-24 13:30:19,13485.0,2,19676,0,13485.0,1,13490.0,20,S
2018-04-24 13:30:26,13485.0,2,19678,0,13485.0,1,13490.0,10,S
2018-04-24 13:30:35,13490.0,4,19682,0,13480.0,6,13490.0,8,B
2018-04-24 13:30:42,13490.0,2,19684,0,13480.0,6,13490.0,7,B
2018-04-24 13:30:43,13490.0,2,19686,0,13480.0,6,13490.0,7,B
2018-04-24 13:30:48,13490.0,2,19688,0,13480.0,9,13490.0,6,B
2018-04-24 13:30:50,13490.0,12,19700,6,13490.0,4,13495.0,14,B
2018-04-24 13:30:50,13490.0,8,19708,6,13485.0,5,13495.0,16,B
2018-04-24 13:31:25,13485.0,12,19720,2,13485.0,2,13490.0,7,S
2018-04-24 13:31:28,13485.0,2,19722,0,13485.0,1,13490.0,7,S
2018-04-24 13:31:28,13485.0,2,19724,-2,13480.0,12,13490.0,7,S
2018-04-24 13:31:40,13485.0,8,19732,4,13480.0,9,13485.0,21,S
2018-04-24 13:32:02,13485.0,10,19742,-6,13480.0,7,13490.0,7,S
2018-04-24 13:32:05,13485.0,2,19744,0,13485.0,2,13490.0,7,S
2018-04-24 13:32:10,13490.0,2,19746,2,13485.0,3,13490.0,6,B
2018-04-24 13:32:13,13490.0,2,19748,2,13490.0,1,13495.0,7,B
2018-04-24 13:32:27,13490.0,2,19750,2,13490.0,4,13495.0,5,B
2018-04-24 13:32:31,13495.0,4,19754,4,13490.0,6,13495.0,6,B
2018-04-24 13:32:32,13495.0,4,19758,4,13490.0,6,13495.0,4,B
2018-04-24 13:32:38,13495.0,6,19764,6,13490.0,20,13500.0,29,B
2018-04-24 13:32:39,13490.0,4,19768,0,13490.0,18,13500.0,31,S
2018-04-24 13:32:44,13495.0,2,19770,0,13495.0,5,13500.0,31,B
2018-04-24 13:33:04,13500.0,2,19772,2,13495.0,10,13500.0,27,B
2018-04-24 13:33:04,13500.0,10,19782,4,13495.0,15,13500.0,22,B
2018-04-24 13:33:05,13505.0,54,19836,-2,13505.0,15,13510.0,4,B
2018-04-24 13:33:05,13505.0,8,19844,6,13505.0,21,13510.0,6,B
2018-04-24 13:33:07,13510.0,2,19846,0,13505.0,21,13510.0,7,B
2018-04-24 13:33:09,13510.0,2,19848,2,13505.0,21,13510.0,6,B
2018-04-24 13:33:12,13505.0,16,19864,12,13505.0,13,13510.0,15,S
2018-04-24 13:33:12,13505.0,26,19890,20,13500.0,2,13510.0,15,S
2018-04-24 13:33:20,13500.0,4,19894,-2,13500.0,6,13505.0,22,S
2018-04-24 13:33:20,13500.0,12,19906,0,13495.0,5,13500.0,1,S
2018-04-24 13:33:21,13505.0,10,19916,4,13500.0,3,13505.0,5,B
2018-04-24 13:33:25,13500.0,2,19918,2,13495.0,5,13500.0,9,S
2018-04-24 13:33:26,13500.0,8,19926,6,13500.0,2,13505.0,13,S
2018-04-24 13:33:26,13500.0,4,19930,4,13495.0,2,13500.0,18,S
2018-04-24 13:33:27,13500.0,4,19934,0,13495.0,5,13500.0,3,S
2018-04-24 13:33:37,13505.0,2,19936,0,13500.0,16,13505.0,7,B
2018-04-24 13:33:47,13505.0,2,19938,-2,13500.0,22,13505.0,1,B
2018-04-24 13:33:48,13505.0,2,19940,2,13500.0,22,13510.0,14,B
2018-04-24 13:33:49,13505.0,2,19942,0,13500.0,19,13510.0,15,B
2018-04-24 13:34:01,13505.0,8,19950,-8,13500.0,13,13510.0,22,B
2018-04-24 13:34:06,13505.0,2,19952,0,13500.0,13,13505.0,5,B
2018-04-24 13:34:14,13500.0,20,19972,12,13500.0,1,13505.0,8,S
2018-04-24 13:34:14,13500.0,2,19974,2,13495.0,7,13500.0,3,S
2018-04-24 13:34:19,13500.0,2,19976,2,13495.0,6,13500.0,2,S
2018-04-24 13:34:21,13500.0,4,19980,4,13500.0,3,13505.0,12,S
2018-04-24 13:34:22,13500.0,2,19982,-2,13500.0,2,13505.0,15,S
2018-04-24 13:34:22,13500.0,4,19986,-4,13495.0,8,13505.0,15,S
2018-04-24 13:34:30,13500.0,2,19988,-2,13500.0,2,13505.0,18,S
2018-04-24 13:34:32,13500.0,2,19990,0,13495.0,9,13505.0,18,S
2018-04-24 13:34:37,13505.0,2,19992,-2,13500.0,2,13505.0,15,B
2018-04-24 13:34:53,13500.0,2,19994,2,13495.0,4,13500.0,4,S
2018-04-24 13:34:54,13500.0,2,19996,2,13495.0,4,13500.0,2,S
2018-04-24 13:34:58,13500.0,2,19998,2,13495.0,4,13500.0,4,S
2018-04-24 13:35:32,13495.0,4,20002,0,13495.0,2,13500.0,6,S
2018-04-24 13:35:47,13495.0,2,20004,0,13490.0,13,13495.0,2,S
2018-04-24 13:36:07,13490.0,8,20012,4,13490.0,4,13495.0,4,S
2018-04-24 13:36:10,13490.0,2,20014,0,13490.0,3,13495.0,3,S
2018-04-24 13:36:13,13490.0,6,20020,0,13485.0,7,13490.0,1,S
2018-04-24 13:36:16,13485.0,6,20026,4,13480.0,2,13490.0,8,S
2018-04-24 13:36:35,13485.0,2,20028,0,13485.0,3,13490.0,2,S
2018-04-24 13:36:47,13485.0,2,20030,-2,13485.0,6,13490.0,2,S
2018-04-24 13:36:48,13490.0,6,20036,6,13490.0,7,13495.0,24,B
2018-04-24 13:36:54,13490.0,4,20040,0,13490.0,5,13495.0,10,B
2018-04-24 13:36:55,13490.0,2,20042,2,13490.0,4,13495.0,10,B
2018-04-24 13:37:06,13490.0,2,20044,2,13490.0,3,13495.0,10,B
2018-04-24 13:37:11,13495.0,4,20048,4,13490.0,3,13495.0,8,B
2018-04-24 13:37:28,13490.0,6,20054,0,13485.0,9,13495.0,8,S
2018-04-24 13:37:36,13485.0,2,20056,-2,13485.0,10,13495.0,8,S
2018-04-24 13:37:43,13485.0,2,20058,0,13485.0,14,13495.0,8,S
2018-04-24 13:37:44,13495.0,2,20060,2,13485.0,14,13495.0,7,B
2018-04-24 13:37:57,13490.0,4,20064,2,13485.0,14,13490.0,1,S
2018-04-24 13:38:04,13485.0,2,20066,-2,13485.0,13,13490.0,1,S
2018-04-24 13:38:07,13485.0,20,20086,-16,13485.0,3,13490.0,1,S
2018-04-24 13:38:13,13485.0,6,20092,0,13480.0,6,13485.0,4,S
2018-04-24 13:38:15,13480.0,6,20098,2,13475.0,17,13480.0,1,S
2018-04-24 13:38:28,13475.0,8,20106,-2,13470.0,17,13475.0,5,S
2018-04-24 13:38:28,13475.0,8,20114,-4,13470.0,19,13475.0,2,S
2018-04-24 13:38:29,13475.0,4,20118,-2,13470.0,24,13480.0,4,S
2018-04-24 13:38:36,13475.0,2,20120,0,13475.0,1,13480.0,6,S
2018-04-24 13:38:39,13475.0,2,20122,0,13475.0,1,13480.0,5,S
2018-04-24 13:38:47,13475.0,2,20124,0,13475.0,1,13480.0,4,S
2018-04-24 13:38:54,13475.0,2,20126,2,13470.0,28,13475.0,1,S
2018-04-24 13:38:55,13475.0,2,20128,0,13475.0,1,13480.0,4,S
2018-04-24 13:38:57,13475.0,2,20130,0,13475.0,1,13480.0,2,S
2018-04-24 13:39:15,13475.0,2,20132,0,13470.0,22,13480.0,8,S
2018-04-24 13:39:42,13475.0,16,20148,14,13470.0,22,13480.0,4,S
2018-04-24 13:39:47,13480.0,8,20156,-8,13480.0,5,13485.0,18,B
2018-04-24 13:39:48,13480.0,12,20168,-8,13475.0,2,13480.0,1,B
2018-04-24 13:39:49,13475.0,2,20170,2,13475.0,2,13480.0,1,S
2018-04-24 13:40:03,13475.0,2,20172,-2,13475.0,1,13480.0,4,S
2018-04-24 13:40:11,13480.0,4,20176,-4,13475.0,1,13480.0,2,B
2018-04-24 13:40:13,13480.0,4,20180,-4,13480.0,2,13485.0,5,B
2018-04-24 13:40:45,13485.0,8,20188,-4,13480.0,6,13490.0,10,B
2018-04-24 13:40:46,13485.0,16,20204,-16,13480.0,8,13490.0,14,B
2018-04-24 13:40:47,13485.0,8,20212,-4,13485.0,19,13495.0,4,B
2018-04-24 13:40:48,13490.0,2,20214,0,13485.0,19,13490.0,1,B
2018-04-24 13:40:48,13490.0,2,20216,2,13485.0,19,13495.0,12,B
2018-04-24 13:41:04,13485.0,4,20220,0,13485.0,17,13495.0,11,S
2018-04-24 13:41:06,13490.0,2,20222,0,13485.0,17,13495.0,11,B
2018-04-24 13:41:25,13495.0,4,20226,-4,13485.0,19,13495.0,9,B
2018-04-24 13:41:43,13495.0,10,20236,6,13485.0,19,13495.0,4,B
2018-04-24 13:41:50,13495.0,2,20238,-2,13495.0,5,13500.0,10,B
2018-04-24 13:41:52,13495.0,2,20240,2,13495.0,6,13500.0,10,B
2018-04-24 13:41:53,13495.0,12,20252,6,13490.0,9,13495.0,1,B
2018-04-24 13:41:55,13490.0,4,20256,0,13485.0,10,13490.0,1,S
2018-04-24 13:41:56,13490.0,2,20258,-2,13485.0,10,13495.0,15,S
2018-04-24 13:42:04,13485.0,2,20260,0,13485.0,11,13495.0,15,S
2018-04-24 13:42:06,13490.0,2,20262,2,13485.0,11,13495.0,15,B
2018-04-24 13:42:15,13495.0,16,20278,-10,13485.0,11,13495.0,7,B
2018-04-24 13:42:52,13495.0,2,20280,0,13490.0,5,13495.0,4,B
2018-04-24 13:43:51,13490.0,2,20282,0,13490.0,4,13495.0,6,S
2018-04-24 13:43:53,13490.0,4,20286,-4,13485.0,10,13495.0,22,S
2018-04-24 13:44:01,13490.0,2,20288,-2,13490.0,2,13495.0,8,S
2018-04-24 13:44:06,13490.0,2,20290,0,13490.0,2,13495.0,8,S
2018-04-24 13:44:47,13495.0,14,20304,4,13495.0,6,13500.0,8,B
2018-04-24 13:44:57,13495.0,12,20316,6,13490.0,24,13495.0,4,B
2018-04-24 13:44:57,13495.0,8,20324,0,13495.0,2,13500.0,7,B
2018-04-24 13:45:09,13495.0,2,20326,0,13495.0,2,13500.0,9,B
2018-04-24 13:45:10,13495.0,4,20330,2,13490.0,8,13495.0,12,B
2018-04-24 13:45:28,13495.0,2,20332,2,13490.0,5,13495.0,4,B
2018-04-24 13:45:29,13490.0,8,20340,0,13485.0,11,13490.0,1,S
2018-04-24 13:45:32,13490.0,10,20350,0,13485.0,12,13495.0,37,S
2018-04-24 13:46:11,13485.0,2,20352,0,13485.0,5,13490.0,4,S
2018-04-24 13:46:14,13490.0,8,20360,8,13490.0,2,13495.0,34,B
2018-04-24 13:46:14,13490.0,4,20364,4,13485.0,10,13495.0,36,B
2018-04-24 13:46:25,13485.0,2,20366,2,13485.0,9,13490.0,4,S
2018-04-24 13:46:29,13490.0,6,20372,-6,13485.0,24,13495.0,13,B
2018-04-24 13:46:31,13485.0,2,20374,2,13485.0,26,13495.0,5,S
2018-04-24 13:46:46,13490.0,2,20376,-2,13490.0,3,13495.0,5,B
2018-04-24 13:47:02,13495.0,8,20384,-2,13490.0,22,13495.0,1,B
2018-04-24 13:47:02,13495.0,2,20386,0,13490.0,12,13500.0,8,B
2018-04-24 13:47:17,13495.0,4,20390,-2,13495.0,2,13500.0,13,B
2018-04-24 13:48:14,13500.0,4,20394,-2,13495.0,4,13500.0,9,B
2018-04-24 13:48:18,13495.0,2,20396,2,13495.0,3,13500.0,9,S
2018-04-24 13:48:27,13500.0,14,20410,10,13500.0,1,13505.0,29,B
2018-04-24 13:48:28,13500.0,2,20412,0,13500.0,3,13505.0,14,B
2018-04-24 13:48:28,13500.0,2,20414,0,13500.0,3,13505.0,14,B
2018-04-24 13:48:30,13500.0,2,20416,0,13500.0,2,13505.0,14,B
2018-04-24 13:48:43,13505.0,4,20420,-2,13500.0,32,13505.0,12,B
2018-04-24 13:48:44,13505.0,10,20430,-2,13500.0,34,13505.0,7,B
2018-04-24 13:48:45,13505.0,14,20444,-8,13500.0,36,13510.0,21,B
2018-04-24 13:48:47,13505.0,2,20446,2,13500.0,47,13510.0,23,B
2018-04-24 13:48:51,13510.0,2,20448,-2,13505.0,32,13510.0,18,B
2018-04-24 13:48:51,13505.0,10,20458,0,13505.0,27,13510.0,18,S
2018-04-24 13:48:55,13510.0,34,20492,8,13505.0,42,13515.0,9,B
2018-04-24 13:48:57,13510.0,2,20494,0,13505.0,26,13515.0,38,B
2018-04-24 13:49:02,13515.0,12,20506,-2,13515.0,1,13520.0,28,B
2018-04-24 13:49:04,13515.0,4,20510,2,13510.0,24,13520.0,29,B
2018-04-24 13:49:05,13520.0,2,20512,2,13510.0,22,13520.0,32,B
2018-04-24 13:49:09,13515.0,16,20528,-8,13510.0,12,13520.0,47,S
2018-04-24 13:49:09,13510.0,2,20530,0,13510.0,11,13520.0,47,S
2018-04-24 13:49:10,13520.0,22,20552,0,13510.0,11,13520.0,36,B
2018-04-24 13:49:11,13520.0,50,20602,40,13510.0,12,13520.0,6,B
2018-04-24 13:49:12,13515.0,2,20604,-2,13510.0,12,13520.0,1,S
2018-04-24 13:49:15,13515.0,10,20614,0,13510.0,11,13520.0,17,S
2018-04-24 13:49:18,13515.0,10,20624,0,13515.0,5,13520.0,10,S
2018-04-24 13:49:20,13515.0,2,20626,2,13515.0,3,13520.0,7,S
2018-04-24 13:49:26,13515.0,2,20628,2,13515.0,5,13520.0,7,S
2018-04-24 13:49:30,13520.0,14,20642,2,13520.0,1,13525.0,18,B
2018-04-24 13:49:31,13525.0,28,20670,26,13525.0,2,13530.0,6,B
2018-04-24 13:49:32,13520.0,6,20676,-2,13520.0,4,13530.0,6,S
2018-04-24 13:49:36,13530.0,6,20682,6,13525.0,3,13535.0,10,B
2018-04-24 13:49:39,13530.0,2,20684,0,13525.0,7,13535.0,10,B
2018-04-24 13:49:40,13530.0,4,20688,4,13530.0,2,13535.0,10,B
2018-04-24 13:49:41,13530.0,2,20690,0,13530.0,1,13535.0,11,B
2018-04-24 13:49:47,13535.0,2,20692,0,13530.0,2,13535.0,6,B
2018-04-24 13:49:48,13535.0,2,20694,2,13530.0,2,13535.0,6,B
2018-04-24 13:49:53,13535.0,2,20696,0,13530.0,5,13535.0,5,B
2018-04-24 13:49:54,13535.0,10,20706,4,13535.0,1,13540.0,8,B
2018-04-24 13:49:55,13535.0,4,20710,-2,13530.0,5,13540.0,8,B
2018-04-24 13:49:57,13535.0,2,20712,2,13530.0,1,13535.0,19,B
2018-04-24 13:49:58,13530.0,2,20714,0,13525.0,5,13535.0,22,S
2018-04-24 13:49:59,13530.0,2,20716,0,13530.0,3,13535.0,13,S
2018-04-24 13:50:01,13535.0,4,20720,2,13530.0,6,13540.0,14,B
2018-04-24 13:50:06,13530.0,6,20726,4,13525.0,5,13535.0,11,S
2018-04-24 13:50:06,13535.0,4,20730,0,13525.0,5,13535.0,12,B
2018-04-24 13:50:08,13525.0,2,20732,2,13525.0,4,13535.0,16,S
2018-04-24 13:50:09,13525.0,2,20734,2,13525.0,3,13535.0,16,S
2018-04-24 13:50:13,13530.0,2,20736,2,13525.0,6,13530.0,1,B
2018-04-24 13:50:14,13525.0,2,20738,2,13525.0,4,13530.0,1,S
2018-04-24 13:50:16,13525.0,8,20746,6,13520.0,7,13530.0,8,S
2018-04-24 13:50:19,13525.0,6,20752,0,13520.0,6,13530.0,13,S
2018-04-24 13:50:21,13530.0,2,20754,2,13520.0,6,13530.0,15,B
2018-04-24 13:50:24,13530.0,2,20756,0,13520.0,6,13530.0,16,B
2018-04-24 13:50:37,13520.0,12,20768,10,13515.0,16,13525.0,1,S
2018-04-24 13:50:37,13525.0,2,20770,0,13520.0,8,13525.0,5,B
2018-04-24 13:50:40,13525.0,6,20776,2,13520.0,4,13525.0,5,B
2018-04-24 13:50:41,13520.0,2,20778,0,13520.0,1,13525.0,5,S
2018-04-24 13:50:53,13515.0,8,20786,4,13510.0,18,13515.0,5,S
2018-04-24 13:50:54,13515.0,10,20796,0,13515.0,1,13520.0,9,S
2018-04-24 13:50:55,13520.0,10,20806,0,13515.0,12,13520.0,4,B
2018-04-24 13:50:59,13520.0,2,20808,-2,13515.0,12,13520.0,3,B
2018-04-24 13:51:00,13520.0,2,20810,-2,13515.0,12,13520.0,2,B
2018-04-24 13:51:14,13520.0,2,20812,0,13515.0,12,13520.0,1,B
2018-04-24 13:51:15,13520.0,2,20814,-2,13520.0,4,13525.0,8,B
2018-04-24 13:51:25,13525.0,2,20816,-2,13520.0,3,13525.0,3,B
2018-04-24 13:51:40,13520.0,6,20822,0,13515.0,7,13520.0,1,S
2018-04-24 13:51:43,13520.0,8,20830,0,13520.0,2,13525.0,9,S
2018-04-24 13:51:48,13520.0,4,20834,2,13520.0,1,13525.0,6,S
2018-04-24 13:51:48,13520.0,4,20838,0,13520.0,1,13525.0,6,S
2018-04-24 13:51:51,13520.0,2,20840,2,13515.0,35,13520.0,2,S
2018-04-24 13:51:52,13515.0,6,20846,0,13515.0,33,13525.0,6,S
2018-04-24 13:52:00,13515.0,2,20848,-2,13515.0,22,13525.0,8,S
2018-04-24 13:52:07,13520.0,2,20850,2,13520.0,1,13525.0,9,B
2018-04-24 13:52:07,13520.0,2,20852,2,13515.0,22,13525.0,7,B
2018-04-24 13:52:12,13515.0,22,20874,18,13510.0,21,13520.0,8,S
2018-04-24 13:52:13,13520.0,2,20876,0,13510.0,21,13520.0,7,B
2018-04-24 13:52:24,13515.0,2,20878,2,13510.0,21,13520.0,7,S
2018-04-24 13:52:34,13510.0,2,20880,-2,13510.0,4,13515.0,3,S
2018-04-24 13:52:35,13510.0,10,20890,-6,13510.0,4,13515.0,5,S
2018-04-24 13:52:35,13510.0,8,20898,0,13505.0,5,13515.0,10,S
2018-04-24 13:52:42,13505.0,2,20900,-2,13505.0,3,13515.0,10,S
2018-04-24 13:52:43,13505.0,2,20902,0,13505.0,2,13515.0,10,S
2018-04-24 13:52:47,13510.0,8,20910,-4,13505.0,3,13515.0,14,B
2018-04-24 13:52:49,13510.0,2,20912,2,13505.0,19,13515.0,6,B
2018-04-24 13:52:52,13515.0,2,20914,-2,13505.0,22,13515.0,5,B
2018-04-24 13:53:03,13515.0,2,20916,0,13510.0,6,13520.0,8,B
2018-04-24 13:53:09,13520.0,6,20922,4,13515.0,16,13525.0,7,B
2018-04-24 13:53:23,13520.0,2,20924,0,13515.0,4,13525.0,15,B
2018-04-24 13:53:28,13520.0,10,20934,0,13515.0,4,13520.0,15,B
2018-04-24 13:53:46,13515.0,2,20936,0,13515.0,12,13520.0,16,S
2018-04-24 13:53:47,13520.0,2,20938,2,13515.0,12,13520.0,15,B
2018-04-24 13:54:11,13515.0,14,20952,0,13515.0,9,13520.0,40,S
2018-04-24 13:54:12,13515.0,18,20970,-10,13510.0,6,13520.0,40,S
2018-04-24 13:54:19,13510.0,4,20974,2,13505.0,1,13515.0,12,S
2018-04-24 13:54:25,13510.0,12,20986,4,13505.0,21,13515.0,5,S
2018-04-24 13:54:26,13510.0,2,20988,-2,13505.0,6,13510.0,1,S
2018-04-24 13:54:33,13510.0,2,20990,0,13510.0,8,13515.0,9,S
2018-04-24 13:54:35,13510.0,16,21006,-2,13505.0,20,13515.0,4,S
2018-04-24 13:54:41,13505.0,2,21008,-2,13505.0,2,13510.0,13,S
2018-04-24 13:54:46,13505.0,4,21012,4,13500.0,14,13510.0,13,S
2018-04-24 13:54:48,13505.0,20,21032,12,13505.0,1,13510.0,17,S
2018-04-24 13:54:48,13510.0,10,21042,10,13505.0,14,13510.0,10,B
2018-04-24 13:54:54,13500.0,2,21044,2,13500.0,8,13505.0,1,S
2018-04-24 13:54:58,13500.0,2,21046,2,13500.0,7,13505.0,11,S
2018-04-24 13:55:16,13500.0,2,21048,2,13500.0,9,13505.0,13,S
2018-04-24 13:55:25,13505.0,22,21070,22,13500.0,9,13510.0,14,B
2018-04-24 13:55:26,13510.0,10,21080,10,13500.0,19,13510.0,7,B
2018-04-24 13:55:48,13510.0,12,21092,10,13510.0,1,13515.0,9,B
2018-04-24 13:55:48,13515.0,10,21102,4,13510.0,4,13515.0,2,B
2018-04-24 13:55:53,13510.0,8,21110,-6,13505.0,14,13515.0,6,S
2018-04-24 13:56:01,13510.0,20,21130,20,13505.0,13,13515.0,7,S
2018-04-24 13:56:08,13510.0,2,21132,-2,13505.0,14,13510.0,16,S
2018-04-24 13:56:10,13510.0,20,21152,18,13505.0,36,13510.0,2,S
2018-04-24 13:56:10,13515.0,14,21166,2,13505.0,48,13515.0,1,B
2018-04-24 13:56:19,13510.0,2,21168,0,13510.0,6,13515.0,15,S
2018-04-24 13:56:26,13510.0,2,21170,0,13510.0,1,13515.0,15,S
2018-04-24 13:56:28,13510.0,2,21172,0,13510.0,1,13515.0,15,S
2018-04-24 13:56:39,13510.0,2,21174,2,13505.0,35,13515.0,16,S
2018-04-24 13:56:58,13510.0,2,21176,0,13510.0,6,13515.0,16,S
2018-04-24 13:57:06,13510.0,12,21188,12,13505.0,26,13510.0,4,S
2018-04-24 13:57:07,13510.0,10,21198,8,13505.0,27,13510.0,4,S
2018-04-24 13:57:07,13505.0,18,21216,0,13505.0,5,13510.0,5,S
2018-04-24 13:57:08,13505.0,4,21220,4,13505.0,3,13510.0,5,S
2018-04-24 13:57:28,13505.0,6,21226,4,13500.0,26,13505.0,7,S
2018-04-24 13:57:29,13505.0,10,21236,10,13500.0,33,13505.0,2,S
2018-04-24 13:57:29,13510.0,10,21246,6,13500.0,33,13510.0,10,B
2018-04-24 13:57:32,13505.0,2,21248,-2,13500.0,13,13505.0,2,S
2018-04-24 13:57:45,13505.0,2,21250,2,13500.0,13,13505.0,14,S
2018-04-24 13:57:50,13500.0,6,21256,-2,13500.0,9,13505.0,30,S
2018-04-24 13:57:50,13500.0,18,21274,6,13495.0,5,13500.0,5,S
2018-04-24 13:57:52,13495.0,2,21276,2,13495.0,4,13500.0,5,S
2018-04-24 13:57:54,13495.0,4,21280,2,13495.0,2,13500.0,5,S
2018-04-24 13:57:55,13495.0,2,21282,0,13490.0,16,13500.0,10,S
2018-04-24 13:58:18,13500.0,2,21284,2,13495.0,17,13500.0,17,B
2018-04-24 13:58:23,13495.0,2,21286,0,13495.0,11,13500.0,19,S
2018-04-24 13:58:24,13495.0,22,21308,16,13490.0,17,13500.0,35,S
2018-04-24 13:58:29,13495.0,2,21310,0,13490.0,9,13495.0,1,S
2018-04-24 13:58:40,13490.0,16,21326,6,13485.0,15,13490.0,2,S
2018-04-24 13:58:40,13490.0,4,21330,0,13485.0,23,13495.0,10,S
2018-04-24 13:58:42,13490.0,2,21332,2,13485.0,26,13490.0,3,S
2018-04-24 13:58:44,13490.0,10,21342,10,13485.0,14,13490.0,2,S
2018-04-24 13:58:45,13495.0,10,21352,8,13485.0,14,13495.0,11,B
2018-04-24 13:58:46,13490.0,4,21356,2,13485.0,11,13490.0,2,S
2018-04-24 13:58:47,13490.0,2,21358,0,13485.0,11,13490.0,1,S
2018-04-24 13:58:56,13490.0,2,21360,0,13485.0,6,13490.0,8,S
2018-04-24 13:58:57,13485.0,10,21370,10,13485.0,1,13490.0,8,S
2018-04-24 13:58:58,13485.0,2,21372,0,13480.0,4,13485.0,3,S
2018-04-24 13:59:04,13485.0,2,21374,-2,13480.0,15,13485.0,2,S
2018-04-24 13:59:05,13485.0,2,21376,-2,13480.0,15,13485.0,1,S
2018-04-24 13:59:06,13480.0,2,21378,-2,13480.0,15,13485.0,1,S
2018-04-24 13:59:08,13485.0,2,21380,-2,13480.0,15,13490.0,10,B
2018-04-24 13:59:10,13490.0,10,21390,8,13480.0,15,13490.0,12,B
2018-04-24 13:59:12,13485.0,2,21392,0,13480.0,12,13490.0,12,S
2018-04-24 13:59:24,13480.0,10,21402,-2,13480.0,12,13490.0,12,S
2018-04-24 13:59:25,13485.0,2,21404,0,13485.0,1,13490.0,12,B
2018-04-24 13:59:26,13485.0,2,21406,0,13480.0,5,13485.0,19,B
2018-04-24 13:59:30,13490.0,22,21428,4,13480.0,19,13490.0,4,B
2018-04-24 13:59:30,13490.0,10,21438,2,13480.0,23,13490.0,1,B
2018-04-24 13:59:36,13485.0,2,21440,0,13480.0,23,13490.0,5,S
2018-04-24 13:59:39,13480.0,10,21450,-8,13475.0,3,13485.0,8,S
2018-04-24 13:59:40,13480.0,6,21456,-4,13470.0,9,13480.0,10,S
2018-04-24 13:59:40,13480.0,2,21458,0,13470.0,9,13475.0,4,S
2018-04-24 13:59:41,13470.0,18,21476,8,13460.0,2,13470.0,1,S
2018-04-24 13:59:41,13470.0,2,21478,2,13465.0,2,13470.0,1,S
2018-04-24 13:59:42,13470.0,2,21480,0,13470.0,1,13475.0,6,S
2018-04-24 13:59:42,13465.0,6,21486,4,13465.0,16,13475.0,5,S
2018-04-24 13:59:44,13480.0,22,21508,22,13470.0,14,13485.0,17,B
2018-04-24 13:59:44,13480.0,10,21518,6,13475.0,1,13480.0,1,B
2018-04-24 13:59:47,13470.0,2,21520,-2,13470.0,8,13475.0,1,S
2018-04-24 13:59:51,13475.0,2,21522,0,13470.0,15,13475.0,3,B
2018-04-24 13:59:51,13475.0,4,21526,2,13470.0,13,13475.0,1,B
2018-04-24 13:59:52,13475.0,2,21528,0,13470.0,13,13480.0,6,B
2018-04-24 13:59:56,13475.0,2,21530,0,13470.0,10,13475.0,3,B
2018-04-24 13:59:57,13475.0,2,21532,0,13470.0,13,13475.0,2,B
2018-04-24 13:59:59,13475.0,10,21542,10,13470.0,13,13475.0,1,B
2018-04-24 13:59:59,13480.0,12,21554,6,13470.0,13,13480.0,1,B
2018-04-24 14:00:00,13480.0,4,21558,-2,13475.0,1,13480.0,4,B
2018-04-24 14:00:01,13475.0,2,21560,0,13475.0,1,13480.0,4,S
2018-04-24 14:00:01,13475.0,2,21562,0,13470.0,3,13480.0,4,S
2018-04-24 14:00:05,13475.0,10,21572,10,13470.0,16,13475.0,5,S
2018-04-24 14:00:05,13480.0,26,21598,10,13480.0,2,13485.0,17,B
2018-04-24 14:00:06,13480.0,4,21602,0,13475.0,1,13480.0,3,B
2018-04-24 14:00:23,13480.0,20,21622,2,13480.0,4,13485.0,5,B
2018-04-24 14:00:27,13485.0,10,21632,-2,13480.0,21,13490.0,5,B
2018-04-24 14:00:29,13485.0,2,21634,0,13480.0,11,13490.0,4,B
2018-04-24 14:00:33,13485.0,2,21636,0,13485.0,1,13490.0,6,B
2018-04-24 14:00:34,13485.0,2,21638,0,13480.0,11,13485.0,2,B
2018-04-24 14:00:37,13485.0,2,21640,0,13480.0,12,13485.0,1,B
2018-04-24 14:00:38,13485.0,2,21642,0,13480.0,12,13490.0,9,B
2018-04-24 14:00:47,13480.0,6,21648,2,13475.0,12,13480.0,4,S
2018-04-24 14:00:57,13475.0,2,21650,-2,13475.0,14,13480.0,12,S
2018-04-24 14:01:03,13480.0,2,21652,0,13475.0,14,13480.0,11,B
2018-04-24 14:01:07,13475.0,10,21662,-2,13470.0,12,13480.0,12,S
2018-04-24 14:01:12,13470.0,4,21666,-2,13470.0,2,13475.0,5,S
2018-04-24 14:01:13,13470.0,6,21672,-4,13465.0,8,13475.0,5,S
2018-04-24 14:01:14,13470.0,6,21678,-6,13470.0,1,13475.0,5,S
2018-04-24 14:01:15,13470.0,2,21680,2,13465.0,1,13470.0,9,S
2018-04-24 14:01:16,13470.0,2,21682,2,13465.0,2,13470.0,6,S
2018-04-24 14:01:21,13470.0,26,21708,24,13465.0,15,13475.0,5,S
2018-04-24 14:01:23,13465.0,34,21742,16,13460.0,34,13465.0,3,S
2018-04-24 14:01:24,13465.0,14,21756,0,13465.0,8,13470.0,1,S
2018-04-24 14:01:24,13465.0,2,21758,2,13465.0,8,13475.0,6,S
2018-04-24 14:01:27,13465.0,4,21762,0,13460.0,12,13465.0,9,S
2018-04-24 14:01:28,13465.0,2,21764,-2,13460.0,12,13465.0,8,S
2018-04-24 14:01:29,13465.0,2,21766,0,13460.0,15,13465.0,7,S
2018-04-24 14:01:30,13465.0,8,21774,-4,13460.0,17,13465.0,3,S
2018-04-24 14:01:30,13470.0,8,21782,-6,13465.0,7,13470.0,4,B
2018-04-24 14:01:38,13465.0,2,21784,2,13465.0,8,13470.0,2,S
2018-04-24 14:01:52,13470.0,14,21798,14,13465.0,11,13475.0,13,B
2018-04-24 14:01:53,13470.0,2,21800,0,13465.0,6,13475.0,16,B
2018-04-24 14:02:12,13475.0,4,21804,4,13470.0,13,13475.0,10,B
2018-04-24 14:02:22,13475.0,18,21822,18,13470.0,21,13475.0,1,B
2018-04-24 14:02:22,13475.0,2,21824,0,13475.0,1,13480.0,10,B
2018-04-24 14:02:23,13475.0,2,21826,0,13475.0,10,13480.0,12,B
2018-04-24 14:02:28,13480.0,28,21854,24,13480.0,36,13485.0,15,B
2018-04-24 14:02:29,13480.0,12,21866,4,13480.0,30,13485.0,17,B
2018-04-24 14:02:29,13485.0,62,21928,42,13480.0,9,13485.0,5,B
2018-04-24 14:02:30,13480.0,18,21946,10,13475.0,2,13485.0,8,S
2018-04-24 14:02:34,13475.0,4,21950,4,13475.0,1,13480.0,5,S
2018-04-24 14:02:36,13480.0,2,21952,-2,13475.0,2,13480.0,10,B
2018-04-24 14:02:37,13480.0,2,21954,0,13475.0,4,13480.0,6,B
2018-04-24 14:02:38,13480.0,12,21966,12,13475.0,4,13485.0,14,B
2018-04-24 14:02:39,13480.0,2,21968,2,13475.0,6,13480.0,1,B
2018-04-24 14:03:11,13480.0,2,21970,-2,13475.0,9,13480.0,4,B
2018-04-24 14:03:15,13480.0,2,21972,2,13475.0,9,13480.0,3,B
2018-04-24 14:03:34,13480.0,14,21986,4,13480.0,5,13485.0,13,B
2018-04-24 14:03:46,13480.0,10,21996,10,13475.0,13,13485.0,11,B
2018-04-24 14:04:16,13480.0,14,22010,-2,13475.0,10,13480.0,1,B
2018-04-24 14:04:25,13475.0,2,22012,2,13475.0,4,13480.0,10,S
2018-04-24 14:04:26,13475.0,8,22020,4,13470.0,11,13475.0,1,S
2018-04-24 14:04:31,13475.0,2,22022,2,13470.0,11,13480.0,10,S
2018-04-24 14:04:38,13475.0,8,22030,8,13470.0,6,13475.0,12,S
2018-04-24 14:04:58,13475.0,2,22032,0,13470.0,6,13475.0,5,S
2018-04-24 14:05:08,13470.0,10,22042,-10,13470.0,1,13475.0,5,S
2018-04-24 14:05:24,13470.0,8,22050,-2,13470.0,1,13475.0,10,S
2018-04-24 14:05:25,13470.0,2,22052,0,13465.0,14,13475.0,10,S
2018-04-24 14:05:28,13465.0,4,22056,0,13465.0,15,13475.0,10,S
2018-04-24 14:05:34,13470.0,2,22058,-2,13465.0,9,13470.0,5,B
2018-04-24 14:05:39,13465.0,18,22076,0,13460.0,15,13465.0,1,S
2018-04-24 14:05:40,13460.0,6,22082,-6,13460.0,12,13465.0,5,S
2018-04-24 14:05:41,13460.0,2,22084,0,13460.0,11,13465.0,5,S
2018-04-24 14:05:41,13460.0,22,22106,0,13455.0,4,13460.0,3,S
2018-04-24 14:05:42,13450.0,14,22120,8,13450.0,8,13455.0,16,S
2018-04-24 14:05:43,13450.0,16,22136,14,13445.0,1,13450.0,1,S
2018-04-24 14:05:43,13450.0,8,22144,0,13450.0,4,13455.0,11,S
2018-04-24 14:05:44,13450.0,2,22146,-2,13450.0,9,13455.0,7,S
2018-04-24 14:05:47,13455.0,4,22150,0,13455.0,20,13460.0,3,B
2018-04-24 14:05:56,13460.0,20,22170,14,13455.0,10,13465.0,12,B
2018-04-24 14:05:58,13455.0,2,22172,-2,13450.0,7,13460.0,13,S
2018-04-24 14:05:58,13455.0,6,22178,0,13455.0,1,13460.0,13,S
2018-04-24 14:06:04,13455.0,6,22184,0,13455.0,1,13460.0,11,S
2018-04-24 14:06:06,13455.0,2,22186,-2,13450.0,10,13455.0,5,S
2018-04-24 14:06:08,13455.0,14,22200,12,13450.0,4,13455.0,10,S
2018-04-24 14:06:10,13455.0,22,22222,-10,13450.0,5,13460.0,11,S
2018-04-24 14:06:11,13460.0,16,22238,4,13460.0,2,13465.0,7,B
2018-04-24 14:06:11,13465.0,4,22242,4,13460.0,3,13465.0,5,B
2018-04-24 14:06:13,13460.0,8,22250,0,13455.0,14,13465.0,4,S
2018-04-24 14:06:14,13460.0,2,22252,2,13460.0,3,13465.0,2,S
2018-04-24 14:06:16,13460.0,2,22254,0,13455.0,15,13460.0,4,S
2018-04-24 14:06:23,13460.0,16,22270,16,13455.0,15,13460.0,1,S
2018-04-24 14:06:24,13460.0,2,22272,0,13460.0,23,13465.0,2,S
2018-04-24 14:06:24,13460.0,8,22280,8,13460.0,8,13465.0,2,S
2018-04-24 14:06:25,13460.0,4,22284,4,13460.0,9,13465.0,2,S
2018-04-24 14:06:26,13465.0,2,22286,0,13460.0,9,13465.0,1,B
2018-04-24 14:06:27,13470.0,6,22292,2,13460.0,6,13470.0,5,B
2018-04-24 14:06:28,13460.0,4,22296,-4,13460.0,1,13465.0,20,S
2018-04-24 14:06:38,13460.0,2,22298,0,13455.0,9,13460.0,2,S
2018-04-24 14:06:40,13460.0,2,22300,0,13455.0,15,13460.0,4,S
2018-04-24 14:06:40,13460.0,8,22308,4,13455.0,15,13465.0,13,S
2018-04-24 14:06:46,13460.0,2,22310,0,13460.0,1,13465.0,13,S
2018-04-24 14:06:51,13460.0,2,22312,-2,13455.0,15,13465.0,13,S
2018-04-24 14:07:25,13460.0,2,22314,2,13455.0,8,13460.0,4,S
2018-04-24 14:07:29,13455.0,4,22318,4,13455.0,5,13460.0,8,S
2018-04-24 14:07:29,13455.0,6,22324,2,13455.0,2,13460.0,11,S
2018-04-24 14:07:38,13455.0,2,22326,-2,13455.0,1,13460.0,13,S
2018-04-24 14:07:40,13455.0,2,22328,0,13450.0,3,13460.0,13,S
2018-04-24 14:07:50,13450.0,4,22332,2,13450.0,6,13460.0,17,S
2018-04-24 14:07:56,13455.0,4,22336,0,13455.0,2,13460.0,15,B
2018-04-24 14:07:57,13455.0,4,22340,0,13450.0,9,13460.0,17,B
2018-04-24 14:07:58,13450.0,2,22342,-2,13450.0,7,13455.0,1,S
2018-04-24 14:08:06,13450.0,6,22348,2,13445.0,5,13455.0,8,S
2018-04-24 14:08:16,13450.0,4,22352,-4,13445.0,6,13450.0,3,S
2018-04-24 14:08:17,13450.0,8,22360,6,13450.0,1,13455.0,10,S
2018-04-24 14:08:24,13455.0,12,22372,8,13455.0,3,13460.0,9,B
2018-04-24 14:08:33,13460.0,4,22376,-2,13455.0,6,13460.0,4,B
2018-04-24 14:08:36,13460.0,2,22378,-2,13455.0,8,13460.0,3,B
2018-04-24 14:08:38,13455.0,2,22380,-2,13455.0,5,13460.0,10,S
2018-04-24 14:08:46,13460.0,6,22386,-4,13455.0,11,13460.0,1,B
2018-04-24 14:08:47,13460.0,2,22388,-2,13460.0,5,13465.0,7,B
2018-04-24 14:08:55,13460.0,4,22392,-4,13460.0,3,13465.0,9,B
2018-04-24 14:08:55,13460.0,6,22398,-6,13455.0,13,13460.0,2,B
2018-04-24 14:09:00,13460.0,6,22404,-6,13455.0,9,13460.0,1,B
2018-04-24 14:09:42,13460.0,8,22412,2,13455.0,17,13465.0,10,B
2018-04-24 14:09:49,13460.0,2,22414,0,13455.0,17,13465.0,6,B
2018-04-24 14:09:54,13460.0,6,22420,4,13455.0,7,13465.0,9,B
2018-04-24 14:10:14,13460.0,2,22422,0,13455.0,6,13460.0,1,B
2018-04-24 14:10:27,13460.0,4,22426,2,13460.0,1,13465.0,10,B
2018-04-24 14:10:42,13460.0,2,22428,2,13460.0,13,13465.0,5,B
2018-04-24 14:10:45,13460.0,2,22430,0,13460.0,12,13465.0,5,B
2018-04-24 14:10:48,13465.0,10,22440,-2,13465.0,1,13470.0,4,B
2018-04-24 14:11:00,13475.0,2,22442,-2,13465.0,24,13475.0,6,B
2018-04-24 14:11:11,13475.0,2,22444,-2,13465.0,25,13475.0,3,B
2018-04-24 14:11:15,13475.0,2,22446,0,13465.0,13,13470.0,6,B
2018-04-24 14:11:16,13470.0,8,22454,-2,13470.0,1,13475.0,7,S
2018-04-24 14:11:34,13470.0,14,22468,10,13470.0,1,13475.0,8,S
2018-04-24 14:11:39,13475.0,4,22472,0,13470.0,10,13475.0,3,B
2018-04-24 14:12:13,13475.0,2,22474,0,13470.0,11,13480.0,9,B
2018-04-24 14:13:02,13475.0,6,22480,0,13470.0,16,13480.0,11,B
2018-04-24 14:13:30,13470.0,10,22490,6,13470.0,8,13480.0,12,S
2018-04-24 14:13:49,13475.0,2,22492,-2,13475.0,3,13480.0,3,B
2018-04-24 14:13:55,13475.0,4,22496,0,13475.0,1,13480.0,3,B
2018-04-24 14:13:56,13475.0,2,22498,0,13475.0,1,13480.0,5,B
2018-04-24 14:14:03,13475.0,2,22500,2,13470.0,8,13475.0,6,B
2018-04-24 14:14:03,13470.0,6,22506,2,13470.0,5,13475.0,6,S
2018-04-24 14:14:04,13470.0,4,22510,0,13470.0,3,13475.0,7,S
2018-04-24 14:14:05,13470.0,6,22516,0,13465.0,13,13475.0,7,S
2018-04-24 14:14:17,13465.0,4,22520,4,13465.0,11,13475.0,8,S
2018-04-24 14:14:54,13475.0,12,22532,6,13470.0,12,13480.0,9,B
2018-04-24 14:15:17,13470.0,20,22552,20,13465.0,5,13475.0,7,S
2018-04-24 14:15:24,13465.0,16,22568,4,13460.0,4,13465.0,2,S
2018-04-24 14:15:25,13465.0,4,22572,2,13465.0,3,13470.0,2,S
2018-04-24 14:15:33,13470.0,4,22576,0,13465.0,9,13475.0,7,B
2018-04-24 14:15:45,13470.0,2,22578,0,13465.0,8,13475.0,13,B
2018-04-24 14:15:50,13470.0,2,22580,0,13470.0,2,13475.0,4,B
2018-04-24 14:15:52,13470.0,6,22586,6,13465.0,8,13470.0,4,B
2018-04-24 14:15:52,13470.0,8,22594,0,13465.0,5,13475.0,4,B
2018-04-24 14:16:07,13470.0,4,22598,2,13470.0,1,13475.0,8,B
2018-04-24 14:16:09,13475.0,2,22600,2,13470.0,1,13475.0,7,B
2018-04-24 14:16:18,13475.0,2,22602,-2,13470.0,2,13475.0,3,B
2018-04-24 14:16:26,13475.0,2,22604,0,13470.0,6,13475.0,3,B
2018-04-24 14:16:29,13475.0,2,22606,-2,13470.0,5,13475.0,2,B
2018-04-24 14:17:05,13475.0,2,22608,-2,13470.0,16,13475.0,1,B
2018-04-24 14:18:25,13470.0,22,22630,8,13470.0,3,13475.0,9,S
2018-04-24 14:18:25,13470.0,6,22636,0,13470.0,1,13475.0,9,S
2018-04-24 14:18:26,13470.0,2,22638,0,13465.0,2,13475.0,9,S
2018-04-24 14:20:04,13460.0,2,22640,0,13460.0,3,13465.0,10,S
2018-04-24 14:20:05,13460.0,2,22642,0,13460.0,2,13465.0,10,S
2018-04-24 14:20:05,13460.0,4,22646,2,13455.0,2,13465.0,8,S
2018-04-24 14:20:24,13455.0,2,22648,0,13455.0,2,13460.0,5,S
2018-04-24 14:20:25,13460.0,10,22658,10,13460.0,1,13465.0,9,B
2018-04-24 14:20:29,13465.0,4,22662,2,13465.0,1,13470.0,7,B
2018-04-24 14:20:31,13465.0,2,22664,0,13465.0,3,13470.0,6,B
2018-04-24 14:20:32,13465.0,2,22666,-2,13465.0,2,13470.0,10,B
2018-04-24 14:20:33,13465.0,4,22670,-4,13460.0,10,13465.0,1,B
2018-04-24 14:20:34,13465.0,2,22672,0,13460.0,9,13465.0,1,B
2018-04-24 14:20:49,13460.0,2,22674,0,13460.0,3,13465.0,1,S
2018-04-24 14:21:02,13465.0,2,22676,-2,13460.0,11,13465.0,10,B
2018-04-24 14:21:04,13465.0,4,22680,0,13460.0,11,13465.0,8,B
2018-04-24 14:21:14,13460.0,2,22682,-2,13460.0,3,13465.0,20,S
2018-04-24 14:21:14,13460.0,6,22688,2,13455.0,5,13465.0,23,S
2018-04-24 14:21:16,13465.0,2,22690,0,13460.0,16,13465.0,17,B
2018-04-24 14:21:35,13465.0,34,22724,14,13465.0,2,13470.0,4,B
2018-04-24 14:21:36,13470.0,8,22732,-2,13465.0,18,13475.0,11,B
2018-04-24 14:21:37,13470.0,8,22740,-4,13465.0,17,13475.0,12,B
2018-04-24 14:22:01,13465.0,12,22752,8,13465.0,1,13470.0,12,S
2018-04-24 14:22:33,13465.0,14,22766,2,13460.0,6,13465.0,3,S
2018-04-24 14:22:36,13465.0,6,22772,6,13460.0,13,13465.0,3,S
2018-04-24 14:22:39,13460.0,20,22792,14,13460.0,5,13465.0,3,S
2018-04-24 14:22:41,13465.0,6,22798,2,13465.0,16,13470.0,15,B
2018-04-24 14:22:42,13470.0,6,22804,4,13465.0,10,13470.0,10,B
2018-04-24 14:22:43,13465.0,20,22824,16,13460.0,7,13470.0,10,S
2018-04-24 14:22:48,13465.0,2,22826,2,13460.0,9,13465.0,9,S
2018-04-24 14:22:49,13465.0,6,22832,6,13460.0,12,13465.0,6,S
2018-04-24 14:22:51,13465.0,2,22834,2,13460.0,4,13465.0,9,S
2018-04-24 14:23:19,13465.0,4,22838,0,13460.0,5,13465.0,7,S
2018-04-24 14:23:46,13465.0,2,22840,2,13460.0,6,13465.0,3,S
2018-04-24 14:24:01,13465.0,2,22842,2,13460.0,5,13465.0,1,S
2018-04-24 14:24:07,13465.0,2,22844,2,13460.0,5,13470.0,12,S
2018-04-24 14:24:09,13460.0,10,22854,0,13455.0,5,13465.0,7,S
2018-04-24 14:24:11,13455.0,6,22860,6,13450.0,8,13455.0,7,S
2018-04-24 14:24:11,13455.0,4,22864,4,13450.0,12,13455.0,5,S
2018-04-24 14:24:12,13455.0,4,22868,4,13450.0,12,13455.0,3,S
2018-04-24 14:24:12,13455.0,6,22874,0,13455.0,1,13460.0,9,S
2018-04-24 14:24:15,13455.0,2,22876,2,13450.0,9,13455.0,9,S
2018-04-24 14:24:16,13455.0,4,22880,4,13450.0,12,13455.0,7,S
2018-04-24 14:24:21,13455.0,6,22886,6,13450.0,12,13455.0,4,S
2018-04-24 14:24:47,13450.0,20,22906,14,13450.0,9,13455.0,4,S
2018-04-24 14:24:52,13450.0,12,22918,8,13450.0,1,13460.0,5,S
2018-04-24 14:25:19,13450.0,2,22920,0,13450.0,4,13455.0,9,S
2018-04-24 14:25:23,13455.0,4,22924,-4,13450.0,6,13455.0,7,B
2018-04-24 14:25:27,13455.0,2,22926,0,13450.0,7,13455.0,6,B
2018-04-24 14:25:55,13450.0,14,22940,14,13445.0,4,13450.0,23,S
2018-04-24 14:25:56,13450.0,4,22944,4,13445.0,6,13450.0,21,S
2018-04-24 14:25:57,13450.0,2,22946,2,13445.0,18,13450.0,20,S
2018-04-24 14:25:57,13450.0,10,22956,10,13445.0,18,13450.0,15,S
2018-04-24 14:25:58,13450.0,2,22958,0,13445.0,12,13450.0,14,S
2018-04-24 14:26:01,13450.0,2,22960,2,13445.0,4,13450.0,13,S
2018-04-24 14:26:12,13450.0,2,22962,0,13445.0,5,13450.0,12,S
2018-04-24 14:26:19,13450.0,24,22986,14,13445.0,16,13455.0,8,S
2018-04-24 14:26:29,13450.0,6,22992,4,13445.0,8,13450.0,7,S
2018-04-24 14:26:36,13450.0,2,22994,0,13445.0,8,13450.0,6,S
2018-04-24 14:26:41,13450.0,2,22996,2,13445.0,12,13450.0,5,S
2018-04-24 14:27:03,13455.0,4,23000,4,13450.0,14,13460.0,7,B
2018-04-24 14:27:26,13455.0,20,23020,20,13450.0,13,13455.0,1,B
2018-04-24 14:27:27,13455.0,8,23028,0,13450.0,17,13460.0,8,B
2018-04-24 14:28:13,13455.0,2,23030,2,13450.0,17,13455.0,3,B
2018-04-24 14:28:13,13455.0,6,23036,6,13450.0,20,13460.0,7,B
2018-04-24 14:28:27,13460.0,2,23038,0,13455.0,3,13460.0,7,B
2018-04-24 14:28:38,13460.0,6,23044,-2,13455.0,1,13460.0,4,B
2018-04-24 14:28:53,13455.0,2,23046,-2,13450.0,15,13460.0,5,S
2018-04-24 14:28:55,13460.0,6,23052,-2,13455.0,17,13460.0,3,B
2018-04-24 14:28:55,13460.0,6,23058,0,13455.0,19,13465.0,7,B
2018-04-24 14:28:58,13460.0,2,23060,0,13460.0,3,13465.0,9,B
2018-04-24 14:29:24,13465.0,14,23074,-14,13465.0,1,13470.0,4,B
2018-04-24 14:29:24,13465.0,2,23076,-2,13460.0,4,13465.0,5,B
2018-04-24 14:29:35,13465.0,2,23078,0,13460.0,4,13465.0,4,B
2018-04-24 14:29:41,13465.0,2,23080,0,13460.0,4,13465.0,5,B
2018-04-24 14:29:45,13460.0,2,23082,0,13460.0,6,13465.0,6,S
2018-04-24 14:30:03,13460.0,4,23086,2,13460.0,1,13465.0,9,S
2018-04-24 14:30:03,13460.0,2,23088,0,13455.0,8,13465.0,9,S
2018-04-24 14:30:10,13455.0,2,23090,0,13455.0,8,13460.0,1,S
2018-04-24 14:30:18,13460.0,2,23092,0,13455.0,8,13460.0,3,B
2018-04-24 14:31:06,13455.0,8,23100,6,13450.0,8,13455.0,1,S
2018-04-24 14:31:12,13455.0,4,23104,0,13450.0,7,13460.0,7,S
2018-04-24 14:31:15,13455.0,4,23108,-4,13455.0,1,13460.0,10,S
2018-04-24 14:31:20,13455.0,2,23110,0,13455.0,2,13460.0,6,S
2018-04-24 14:31:21,13455.0,2,23112,-2,13450.0,12,13460.0,9,S
2018-04-24 14:31:48,13455.0,4,23116,-2,13455.0,7,13460.0,3,S
2018-04-24 14:32:00,13455.0,4,23120,-2,13455.0,5,13460.0,3,S
2018-04-24 14:32:04,13455.0,6,23126,-4,13455.0,2,13460.0,3,S
2018-04-24 14:32:05,13460.0,2,23128,2,13455.0,3,13460.0,4,B
2018-04-24 14:32:10,13455.0,2,23130,0,13455.0,2,13460.0,2,S
2018-04-24 14:32:10,13455.0,2,23132,0,13455.0,1,13460.0,2,S
2018-04-24 14:32:18,13455.0,2,23134,-2,13450.0,10,13460.0,4,S
2018-04-24 14:32:19,13455.0,2,23136,0,13450.0,11,13460.0,4,S
2018-04-24 14:32:27,13450.0,4,23140,0,13450.0,8,13460.0,6,S
2018-04-24 14:32:30,13455.0,2,23142,-2,13450.0,8,13460.0,6,B
2018-04-24 14:32:40,13460.0,2,23144,0,13450.0,8,13460.0,6,B
2018-04-24 14:32:50,13450.0,4,23148,2,13450.0,7,13460.0,6,S
2018-04-24 14:32:59,13450.0,4,23152,-2,13450.0,6,13460.0,6,S
2018-04-24 14:33:10,13455.0,2,23154,-2,13450.0,6,13455.0,3,B
2018-04-24 14:33:24,13455.0,2,23156,0,13450.0,6,13455.0,2,B
2018-04-24 14:33:29,13455.0,2,23158,-2,13450.0,6,13455.0,1,B
2018-04-24 14:33:36,13450.0,4,23162,-2,13450.0,2,13455.0,7,S
2018-04-24 14:33:37,13450.0,4,23166,2,13445.0,7,13455.0,8,S
2018-04-24 14:33:39,13455.0,2,23168,0,13445.0,8,13455.0,7,B
2018-04-24 14:33:52,13455.0,2,23170,2,13450.0,1,13455.0,6,B
2018-04-24 14:33:59,13455.0,4,23174,0,13450.0,1,13455.0,5,B
2018-04-24 14:34:01,13450.0,2,23176,2,13445.0,8,13455.0,5,S
2018-04-24 14:34:18,13445.0,6,23182,2,13440.0,7,13450.0,5,S
2018-04-24 14:34:19,13445.0,2,23184,-2,13440.0,19,13450.0,4,S
2018-04-24 14:34:23,13450.0,10,23194,4,13450.0,5,13455.0,9,B
2018-04-24 14:34:24,13450.0,10,23204,4,13445.0,10,13450.0,2,B
2018-04-24 14:34:34,13445.0,2,23206,0,13445.0,11,13450.0,5,S
2018-04-24 14:34:35,13445.0,2,23208,2,13445.0,10,13450.0,6,S
2018-04-24 14:34:37,13445.0,6,23214,6,13445.0,7,13450.0,6,S
2018-04-24 14:34:40,13445.0,6,23220,6,13445.0,2,13450.0,9,S
2018-04-24 14:34:40,13445.0,2,23222,2,13445.0,1,13450.0,9,S
2018-04-24 14:34:41,13445.0,2,23224,2,13440.0,12,13450.0,9,S
2018-04-24 14:34:44,13445.0,2,23226,0,13445.0,3,13450.0,9,S
2018-04-24 14:34:48,13445.0,2,23228,0,13445.0,2,13450.0,9,S
2018-04-24 14:34:49,13445.0,2,23230,0,13445.0,1,13450.0,9,S
2018-04-24 14:34:50,13445.0,2,23232,2,13440.0,16,13450.0,9,S
2018-04-24 14:35:04,13440.0,12,23244,0,13435.0,8,13440.0,1,S
2018-04-24 14:35:04,13440.0,2,23246,2,13435.0,6,13440.0,7,S
2018-04-24 14:35:06,13440.0,14,23260,-6,13440.0,5,13445.0,8,S
2018-04-24 14:36:05,13445.0,10,23270,0,13445.0,3,13450.0,11,B
2018-04-24 14:36:26,13445.0,2,23272,0,13445.0,2,13450.0,10,B
2018-04-24 14:36:28,13445.0,2,23274,0,13445.0,1,13450.0,10,B
2018-04-24 14:36:55,13450.0,2,23276,-2,13445.0,13,13450.0,8,B
2018-04-24 14:37:09,13445.0,4,23280,-4,13445.0,11,13450.0,15,S
2018-04-24 14:37:10,13445.0,22,23302,14,13440.0,13,13450.0,15,S
2018-04-24 14:37:50,13445.0,2,23304,0,13445.0,11,13450.0,5,S
2018-04-24 14:37:55,13445.0,2,23306,0,13440.0,15,13450.0,7,S
2018-04-24 14:38:04,13445.0,2,23308,2,13440.0,15,13445.0,1,S
2018-04-24 14:38:11,13445.0,2,23310,0,13440.0,7,13445.0,2,S
2018-04-24 14:38:14,13445.0,4,23314,0,13440.0,7,13450.0,6,S
2018-04-24 14:38:17,13445.0,2,23316,0,13440.0,6,13445.0,5,S
2018-04-24 14:38:19,13440.0,12,23328,2,13435.0,11,13445.0,7,S
2018-04-24 14:38:26,13435.0,2,23330,0,13435.0,6,13440.0,5,S
2018-04-24 14:38:26,13435.0,12,23342,-10,13430.0,11,13440.0,7,S
2018-04-24 14:38:30,13435.0,2,23344,-2,13430.0,11,13440.0,8,S
2018-04-24 14:38:31,13430.0,2,23346,0,13430.0,11,13440.0,12,S
2018-04-24 14:38:32,13430.0,14,23360,-4,13430.0,4,13440.0,12,S
2018-04-24 14:38:37,13435.0,10,23370,10,13435.0,5,13440.0,12,B
2018-04-24 14:38:40,13440.0,20,23390,8,13435.0,18,13440.0,3,B
2018-04-24 14:38:41,13440.0,6,23396,-6,13440.0,3,13445.0,5,B
2018-04-24 14:38:42,13435.0,40,23436,10,13435.0,1,13445.0,5,S
2018-04-24 14:38:43,13435.0,2,23438,-2,13435.0,1,13440.0,5,S
2018-04-24 14:38:48,13440.0,8,23446,-2,13440.0,7,13445.0,7,B
2018-04-24 14:38:51,13440.0,4,23450,4,13440.0,8,13445.0,3,B
2018-04-24 14:38:53,13445.0,4,23454,-4,13440.0,7,13445.0,2,B
2018-04-24 14:38:54,13445.0,2,23456,-2,13440.0,7,13445.0,1,B
2018-04-24 14:39:01,13445.0,2,23458,2,13440.0,4,13445.0,2,B
2018-04-24 14:39:06,13445.0,4,23462,4,13445.0,8,13450.0,4,B
2018-04-24 14:39:10,13445.0,16,23478,16,13440.0,5,13450.0,5,B
2018-04-24 14:39:31,13445.0,20,23498,20,13440.0,9,13450.0,5,B
2018-04-24 14:39:47,13445.0,2,23500,2,13440.0,13,13450.0,9,B
2018-04-24 14:40:01,13450.0,18,23518,-2,13450.0,11,13455.0,6,B
2018-04-24 14:40:01,13450.0,22,23540,-18,13445.0,1,13450.0,7,B
2018-04-24 14:40:27,13445.0,8,23548,8,13440.0,16,13445.0,9,S
2018-04-24 14:40:27,13445.0,2,23550,0,13440.0,16,13445.0,8,S
2018-04-24 14:40:38,13445.0,36,23586,32,13445.0,7,13450.0,5,S
2018-04-24 14:40:48,13450.0,2,23588,0,13445.0,8,13450.0,4,B
2018-04-24 14:40:55,13445.0,2,23590,0,13445.0,7,13450.0,4,S
2018-04-24 14:41:14,13445.0,2,23592,0,13445.0,6,13450.0,4,S
2018-04-24 14:41:39,13445.0,2,23594,-2,13445.0,6,13450.0,3,S
2018-04-24 14:41:53,13445.0,2,23596,2,13445.0,3,13450.0,5,S
2018-04-24 14:41:54,13445.0,6,23602,2,13440.0,14,13445.0,8,S
2018-04-24 14:41:55,13440.0,2,23604,0,13440.0,5,13445.0,11,S
2018-04-24 14:42:11,13440.0,4,23608,-2,13435.0,7,13445.0,14,S
2018-04-24 14:42:11,13440.0,2,23610,0,13435.0,5,13445.0,14,S
2018-04-24 14:42:12,13435.0,6,23616,-4,13430.0,14,13440.0,5,S
2018-04-24 14:42:15,13435.0,6,23622,0,13430.0,15,13440.0,11,S
2018-04-24 14:42:24,13430.0,2,23624,-2,13430.0,14,13440.0,15,S
2018-04-24 14:42:29,13430.0,2,23626,-2,13430.0,15,13440.0,15,S
2018-04-24 14:42:47,13430.0,6,23632,-6,13430.0,12,13440.0,17,S
2018-04-24 14:42:50,13430.0,2,23634,-2,13430.0,11,13440.0,18,S
2018-04-24 14:42:51,13430.0,22,23656,-22,13425.0,5,13430.0,17,S
2018-04-24 14:42:53,13430.0,2,23658,0,13425.0,4,13430.0,23,S
2018-04-24 14:42:53,13430.0,2,23660,0,13425.0,4,13430.0,23,S
2018-04-24 14:42:54,13430.0,2,23662,-2,13425.0,4,13430.0,22,S
2018-04-24 14:42:58,13425.0,10,23672,-6,13420.0,45,13425.0,3,S
2018-04-24 14:42:58,13425.0,8,23680,-4,13425.0,9,13430.0,16,S
2018-04-24 14:43:04,13425.0,6,23686,0,13425.0,11,13430.0,16,S
2018-04-24 14:43:05,13425.0,2,23688,0,13425.0,10,13430.0,18,S
2018-04-24 14:43:05,13425.0,4,23692,0,13425.0,8,13430.0,18,S
2018-04-24 14:43:06,13425.0,16,23708,-8,13420.0,44,13425.0,1,S
2018-04-24 14:43:08,13425.0,2,23710,0,13420.0,44,13430.0,18,S
2018-04-24 14:43:09,13425.0,2,23712,-2,13420.0,47,13430.0,18,S
2018-04-24 14:43:10,13420.0,2,23714,0,13420.0,48,13430.0,18,S
2018-04-24 14:43:16,13425.0,2,23716,0,13420.0,44,13430.0,22,B
2018-04-24 14:43:17,13420.0,6,23722,0,13420.0,42,13430.0,22,S
2018-04-24 14:43:19,13430.0,44,23766,-12,13425.0,8,13435.0,2,B
2018-04-24 14:43:20,13430.0,2,23768,0,13425.0,15,13430.0,1,B
2018-04-24 14:43:20,13425.0,4,23772,2,13425.0,14,13435.0,5,S
2018-04-24 14:43:35,13435.0,8,23780,0,13430.0,14,13440.0,15,B
2018-04-24 14:43:45,13435.0,4,23784,-2,13435.0,8,13440.0,11,B
2018-04-24 14:43:57,13435.0,2,23786,0,13435.0,6,13440.0,10,B
2018-04-24 14:44:02,13435.0,6,23792,4,13430.0,22,13435.0,7,B
2018-04-24 14:44:17,13435.0,8,23800,4,13430.0,19,13440.0,15,B
2018-04-24 14:44:18,13435.0,6,23806,-2,13430.0,24,13440.0,10,B
2018-04-24 14:44:26,13435.0,2,23808,0,13430.0,14,13435.0,5,B
2018-04-24 14:44:32,13435.0,2,23810,0,13430.0,17,13435.0,1,B
2018-04-24 14:45:10,13435.0,2,23812,0,13430.0,23,13435.0,1,B
2018-04-24 14:46:20,13435.0,2,23814,-2,13430.0,19,13435.0,6,B
2018-04-24 14:46:27,13430.0,8,23822,0,13430.0,15,13435.0,4,S
2018-04-24 14:46:36,13435.0,8,23830,4,13435.0,11,13440.0,11,B
2018-04-24 14:46:37,13435.0,10,23840,4,13435.0,6,13440.0,11,B
2018-04-24 14:46:45,13430.0,36,23876,-24,13430.0,6,13440.0,15,S
2018-04-24 14:47:26,13430.0,2,23878,0,13430.0,5,13435.0,12,S
2018-04-24 14:47:27,13430.0,10,23888,4,13425.0,8,13430.0,45,S
2018-04-24 14:47:27,13430.0,2,23890,0,13425.0,8,13430.0,44,S
2018-04-24 14:47:38,13425.0,2,23892,-2,13425.0,2,13430.0,49,S
2018-04-24 14:47:39,13425.0,2,23894,-2,13425.0,1,13430.0,49,S
2018-04-24 14:47:40,13425.0,2,23896,2,13420.0,50,13430.0,48,S
2018-04-24 14:47:46,13420.0,2,23898,0,13420.0,48,13425.0,5,S
2018-04-24 14:47:51,13420.0,20,23918,4,13420.0,33,13425.0,2,S
2018-04-24 14:47:58,13425.0,2,23920,-2,13425.0,8,13430.0,50,B
2018-04-24 14:48:01,13425.0,4,23924,4,13425.0,1,13430.0,48,B
2018-04-24 14:48:07,13430.0,4,23928,0,13425.0,5,13430.0,46,B
2018-04-24 14:48:07,13430.0,12,23940,0,13425.0,9,13430.0,40,B
2018-04-24 14:48:14,13420.0,18,23958,18,13420.0,32,13430.0,44,S
2018-04-24 14:48:20,13430.0,2,23960,2,13425.0,1,13430.0,39,B
2018-04-24 14:48:24,13425.0,2,23962,-2,13425.0,2,13430.0,43,S
2018-04-24 14:48:25,13425.0,4,23966,2,13420.0,34,13430.0,44,S
2018-04-24 14:48:59,13425.0,14,23980,-10,13420.0,35,13430.0,46,S
2018-04-24 14:49:08,13425.0,28,24008,-4,13425.0,19,13430.0,42,S
2018-04-24 14:49:09,13430.0,4,24012,0,13425.0,18,13430.0,41,B
2018-04-24 14:49:17,13420.0,4,24016,4,13420.0,32,13430.0,39,S
2018-04-24 14:49:22,13420.0,2,24018,0,13420.0,31,13430.0,47,S
2018-04-24 14:49:32,13425.0,2,24020,0,13420.0,31,13425.0,2,B
2018-04-24 14:49:53,13425.0,2,24022,-2,13420.0,27,13425.0,6,B
2018-04-24 14:50:01,13420.0,6,24028,2,13420.0,24,13430.0,41,S
2018-04-24 14:50:15,13420.0,2,24030,0,13425.0,1,13430.0,44,S
2018-04-24 14:50:21,13425.0,2,24032,-2,13420.0,28,13430.0,44,B
2018-04-24 14:50:22,13430.0,54,24086,54,13420.0,28,13430.0,17,B
2018-04-24 14:50:29,13430.0,14,24100,14,13425.0,9,13430.0,4,B
2018-04-24 14:50:30,13430.0,8,24108,2,13425.0,9,13435.0,4,B
2018-04-24 14:50:33,13425.0,4,24112,-4,13425.0,9,13435.0,10,S
2018-04-24 14:50:36,13430.0,2,24114,-2,13425.0,9,13435.0,10,B
2018-04-24 14:50:38,13430.0,2,24116,0,13420.0,26,13430.0,9,B
2018-04-24 14:50:52,13430.0,2,24118,2,13425.0,7,13430.0,5,B
2018-04-24 14:51:15,13430.0,2,24120,-2,13425.0,8,13430.0,3,B
2018-04-24 14:51:16,13425.0,2,24122,-2,13425.0,7,13430.0,3,S
2018-04-24 14:51:27,13435.0,18,24140,14,13435.0,5,13440.0,11,B
2018-04-24 14:51:28,13430.0,16,24156,4,13425.0,13,13435.0,5,S
2018-04-24 14:51:42,13435.0,2,24158,0,13430.0,10,13435.0,8,B
2018-04-24 14:51:49,13435.0,6,24164,0,13435.0,2,13440.0,11,B
2018-04-24 14:51:52,13435.0,2,24166,-2,13430.0,12,13435.0,4,B
2018-04-24 14:51:53,13435.0,4,24170,0,13430.0,12,13440.0,26,B
2018-04-24 14:51:55,13430.0,2,24172,2,13430.0,11,13440.0,28,S
2018-04-24 14:52:10,13435.0,4,24176,-4,13430.0,9,13440.0,23,B
2018-04-24 14:52:13,13435.0,2,24178,-2,13435.0,1,13440.0,25,B
2018-04-24 14:52:16,13435.0,2,24180,0,13430.0,9,13440.0,25,B
2018-04-24 14:52:43,13435.0,2,24182,-2,13435.0,10,13440.0,20,B
2018-04-24 14:52:52,13435.0,2,24184,0,13435.0,9,13440.0,20,B
2018-04-24 14:52:57,13440.0,6,24190,4,13435.0,7,13440.0,17,B
2018-04-24 14:53:04,13435.0,8,24198,0,13430.0,11,13440.0,21,S
2018-04-24 14:53:05,13435.0,2,24200,-2,13430.0,12,13440.0,21,S
2018-04-24 14:53:19,13435.0,2,24202,-2,13430.0,5,13435.0,3,S
2018-04-24 14:53:26,13430.0,2,24204,0,13430.0,4,13435.0,3,S
2018-04-24 14:54:01,13430.0,12,24216,6,13430.0,1,13435.0,2,S
2018-04-24 14:54:02,13430.0,6,24222,2,13425.0,10,13430.0,1,S
2018-04-24 14:54:08,13430.0,2,24224,0,13425.0,7,13435.0,11,S
2018-04-24 14:54:11,13430.0,2,24226,0,13425.0,7,13435.0,9,S
2018-04-24 14:54:32,13425.0,6,24232,-4,13420.0,27,13430.0,12,S
2018-04-24 14:54:37,13430.0,24,24256,-14,13425.0,5,13435.0,10,B
2018-04-24 14:54:39,13435.0,2,24258,2,13425.0,7,13435.0,6,B
2018-04-24 14:54:42,13430.0,2,24260,-2,13430.0,2,13435.0,6,S
2018-04-24 14:54:46,13435.0,4,24264,0,13430.0,1,13435.0,5,B
2018-04-24 14:55:01,13435.0,6,24270,0,13430.0,9,13440.0,23,B
2018-04-24 14:55:02,13430.0,2,24272,2,13430.0,8,13440.0,23,S
2018-04-24 14:55:07,13430.0,2,24274,2,13425.0,13,13430.0,1,S
2018-04-24 14:55:15,13435.0,2,24276,-2,13430.0,8,13435.0,1,B
2018-04-24 14:55:17,13430.0,10,24286,-6,13430.0,8,13435.0,1,S
2018-04-24 14:55:24,13430.0,10,24296,4,13430.0,3,13435.0,1,S
2018-04-24 14:55:38,13430.0,4,24300,0,13425.0,12,13435.0,8,S
2018-04-24 14:55:45,13425.0,16,24316,0,13425.0,3,13435.0,9,S
2018-04-24 14:55:53,13425.0,2,24318,0,13425.0,2,13430.0,3,S
2018-04-24 14:55:58,13430.0,2,24320,0,13425.0,2,13430.0,3,B
2018-04-24 14:56:02,13430.0,6,24326,6,13430.0,7,13435.0,11,B
2018-04-24 14:56:02,13430.0,4,24330,0,13430.0,5,13435.0,11,B
2018-04-24 14:56:04,13430.0,2,24332,0,13430.0,4,13435.0,11,B
2018-04-24 14:56:04,13430.0,8,24340,8,13425.0,3,13435.0,11,B
2018-04-24 14:56:08,13425.0,2,24342,0,13425.0,2,13430.0,9,S
2018-04-24 14:56:09,13430.0,18,24360,6,13430.0,1,13435.0,8,B
2018-04-24 14:56:09,13430.0,2,24362,0,13425.0,2,13430.0,3,B
2018-04-24 14:56:11,13425.0,4,24366,-2,13420.0,28,13425.0,12,S
2018-04-24 14:56:13,13425.0,2,24368,-2,13420.0,32,13425.0,11,S
2018-04-24 14:56:16,13420.0,50,24418,14,13420.0,22,13430.0,3,S
2018-04-24 14:56:20,13425.0,4,24422,-4,13425.0,2,13430.0,4,B
2018-04-24 14:56:24,13430.0,12,24434,0,13430.0,8,13435.0,7,B
2018-04-24 14:56:24,13430.0,2,24436,-2,13430.0,7,13435.0,11,B
2018-04-24 14:56:37,13430.0,2,24438,-2,13430.0,6,13435.0,9,B
2018-04-24 14:57:06,13430.0,2,24440,2,13425.0,55,13430.0,5,B
2018-04-24 14:57:09,13425.0,2,24442,2,13425.0,54,13430.0,5,S
2018-04-24 14:57:14,13425.0,4,24446,4,13425.0,52,13430.0,5,S
2018-04-24 14:57:14,13420.0,106,24552,88,13420.0,13,13425.0,1,S
2018-04-24 14:57:15,13420.0,26,24578,6,13415.0,9,13425.0,6,S
2018-04-24 14:57:16,13415.0,8,24586,-6,13415.0,1,13420.0,9,S
2018-04-24 14:57:17,13410.0,6,24592,-4,13410.0,21,13415.0,1,S
2018-04-24 14:57:17,13410.0,2,24594,-2,13410.0,20,13415.0,6,S
2018-04-24 14:57:19,13415.0,8,24602,-4,13410.0,26,13415.0,2,B
2018-04-24 14:57:21,13410.0,40,24642,-12,13405.0,10,13410.0,37,S
2018-04-24 14:57:23,13410.0,2,24644,-2,13405.0,6,13410.0,36,S
2018-04-24 14:57:32,13405.0,2,24646,-2,13405.0,6,13410.0,38,S
2018-04-24 14:57:32,13410.0,20,24666,6,13400.0,19,13410.0,36,B
2018-04-24 14:57:35,13400.0,20,24686,-2,13400.0,8,13405.0,9,S
2018-04-24 14:57:36,13395.0,18,24704,-4,13395.0,1,13400.0,1,S
2018-04-24 14:57:36,13400.0,12,24716,-2,13400.0,2,13405.0,10,B
2018-04-24 14:57:37,13400.0,4,24720,0,13395.0,6,13405.0,12,B
2018-04-24 14:57:38,13395.0,6,24726,0,13395.0,7,13400.0,1,S
2018-04-24 14:57:39,13400.0,2,24728,-2,13395.0,11,13405.0,12,B
2018-04-24 14:57:40,13395.0,2,24730,-2,13395.0,10,13400.0,2,S
2018-04-24 14:57:41,13400.0,4,24734,-2,13395.0,14,13405.0,12,B
2018-04-24 14:57:42,13395.0,2,24736,0,13395.0,1,13405.0,12,S
2018-04-24 14:57:43,13400.0,2,24738,2,13395.0,10,13405.0,12,B
2018-04-24 14:57:57,13400.0,8,24746,8,13400.0,8,13405.0,11,B
2018-04-24 14:57:57,13400.0,2,24748,2,13400.0,7,13405.0,10,B
2018-04-24 14:57:58,13400.0,2,24750,2,13400.0,6,13405.0,10,B
2018-04-24 14:57:58,13405.0,18,24768,8,13400.0,12,13410.0,38,B
2018-04-24 14:57:59,13400.0,2,24770,2,13400.0,15,13410.0,36,S
2018-04-24 14:58:00,13410.0,52,24822,-34,13400.0,16,13405.0,1,B
2018-04-24 14:58:01,13405.0,2,24824,-2,13405.0,1,13410.0,17,S
2018-04-24 14:58:01,13410.0,8,24832,-8,13405.0,1,13410.0,13,B
2018-04-24 14:58:03,13410.0,4,24836,-4,13405.0,3,13410.0,9,B
2018-04-24 14:58:04,13410.0,18,24854,-16,13410.0,2,13415.0,5,B
2018-04-24 14:58:04,13415.0,8,24862,4,13410.0,11,13415.0,1,B
2018-04-24 14:58:05,13415.0,2,24864,0,13410.0,15,13420.0,3,B
2018-04-24 14:58:06,13415.0,2,24866,2,13410.0,7,13420.0,4,B
2018-04-24 14:58:08,13415.0,2,24868,0,13415.0,2,13420.0,4,B
2018-04-24 14:58:09,13415.0,2,24870,0,13410.0,13,13415.0,1,B
2018-04-24 14:58:11,13415.0,4,24874,-2,13410.0,13,13420.0,3,B
2018-04-24 14:58:11,13415.0,2,24876,0,13415.0,9,13420.0,6,B
2018-04-24 14:58:12,13415.0,18,24894,14,13410.0,7,13420.0,4,B
2018-04-24 14:58:14,13415.0,4,24898,2,13410.0,9,13420.0,5,B
2018-04-24 14:58:15,13420.0,2,24900,2,13410.0,9,13420.0,4,B
2018-04-24 14:58:17,13415.0,4,24904,2,13415.0,1,13420.0,4,S
2018-04-24 14:58:19,13415.0,2,24906,2,13410.0,9,13420.0,10,S
2018-04-24 14:58:25,13415.0,2,24908,0,13415.0,1,13420.0,10,S
2018-04-24 14:58:26,13415.0,2,24910,2,13415.0,1,13420.0,10,S
2018-04-24 14:58:27,13415.0,2,24912,0,13410.0,9,13420.0,10,S
2018-04-24 14:58:30,13415.0,2,24914,0,13410.0,9,13420.0,11,S
2018-04-24 14:58:31,13420.0,12,24926,-6,13410.0,9,13420.0,5,B
2018-04-24 14:58:33,13420.0,6,24932,0,13410.0,9,13420.0,2,B
2018-04-24 14:58:34,13410.0,2,24934,-2,13410.0,6,13420.0,4,S
2018-04-24 14:58:35,13410.0,6,24940,-6,13405.0,3,13410.0,7,S
2018-04-24 14:58:36,13410.0,14,24954,-14,13405.0,3,13415.0,1,S
2018-04-24 14:58:39,13410.0,6,24960,0,13410.0,4,13420.0,5,S
2018-04-24 14:58:50,13410.0,2,24962,0,13410.0,4,13415.0,2,S
2018-04-24 14:58:51,13410.0,8,24970,6,13405.0,5,13410.0,1,S
2018-04-24 14:58:52,13410.0,2,24972,0,13410.0,1,13415.0,5,S
2018-04-24 14:58:55,13410.0,2,24974,-2,13410.0,2,13415.0,5,S
2018-04-24 14:58:57,13410.0,8,24982,-4,13405.0,9,13415.0,5,S
2018-04-24 14:58:58,13415.0,4,24986,0,13405.0,11,13415.0,6,B
2018-04-24 14:59:00,13415.0,8,24994,-2,13405.0,11,13415.0,5,B
2018-04-24 14:59:00,13405.0,8,25002,-8,13405.0,6,13415.0,6,S
2018-04-24 14:59:01,13415.0,20,25022,-16,13410.0,2,13415.0,2,B
2018-04-24 14:59:01,13410.0,4,25026,-4,13410.0,2,13415.0,4,S
2018-04-24 14:59:02,13410.0,4,25030,-4,13405.0,1,13410.0,1,S
2018-04-24 14:59:04,13405.0,6,25036,-2,13405.0,1,13410.0,2,S
2018-04-24 14:59:09,13405.0,2,25038,0,13400.0,13,13410.0,13,S
2018-04-24 14:59:13,13405.0,6,25044,2,13405.0,2,13410.0,13,S
2018-04-24 14:59:19,13410.0,2,25046,0,13405.0,2,13410.0,12,B
2018-04-24 14:59:20,13410.0,2,25048,0,13405.0,2,13410.0,11,B
2018-04-24 14:59:21,13410.0,2,25050,0,13405.0,2,13410.0,10,B
2018-04-24 14:59:22,13405.0,6,25056,-6,13400.0,14,13405.0,1,S
2018-04-24 14:59:23,13405.0,2,25058,-2,13400.0,14,13405.0,2,S
2018-04-24 14:59:30,13410.0,2,25060,-2,13400.0,17,13410.0,9,B
2018-04-24 14:59:31,13405.0,2,25062,0,13400.0,17,13405.0,2,S
2018-04-24 14:59:31,13405.0,4,25066,0,13400.0,17,13410.0,9,S
2018-04-24 14:59:32,13410.0,18,25084,-18,13400.0,17,13410.0,1,B
2018-04-24 14:59:32,13410.0,2,25086,-2,13405.0,2,13410.0,3,B
2018-04-24 14:59:33,13410.0,6,25092,-6,13405.0,2,13415.0,3,B
2018-04-24 14:59:42,13415.0,2,25094,-2,13405.0,1,13415.0,10,B
2018-04-24 14:59:43,13415.0,2,25096,-2,13405.0,1,13415.0,9,B
2018-04-24 14:59:43,13415.0,12,25108,-12,13405.0,1,13415.0,3,B
2018-04-24 14:59:45,13405.0,2,25110,0,13400.0,16,13405.0,1,S
2018-04-24 14:59:46,13405.0,2,25112,2,13400.0,16,13415.0,5,S
2018-04-24 14:59:48,13415.0,2,25114,0,13400.0,19,13415.0,2,B
2018-04-24 14:59:54,13415.0,2,25116,0,13405.0,1,13420.0,8,B
2018-04-24 14:59:58,13415.0,2,25118,0,13410.0,1,13415.0,1,B
2018-04-24 14:59:58,13420.0,4,25122,-2,13405.0,1,13420.0,7,B
2018-04-24 14:59:59,13420.0,2,25124,0,13405.0,1,13420.0,6,B
2018-04-24 20:59:00,13435.0,38,38,81390,0.0,0,0.0,0,B
2018-04-24 21:00:00,13450.0,8,46,2,13445.0,3,13450.0,1,B
2018-04-24 21:00:01,13445.0,8,54,4,13445.0,3,13450.0,2,S
2018-04-24 21:00:01,13445.0,8,62,6,13440.0,5,13445.0,6,S
2018-04-24 21:00:03,13450.0,20,82,-6,13440.0,3,13455.0,18,B
2018-04-24 21:00:04,13440.0,30,112,-18,13435.0,5,13450.0,5,S
2018-04-24 21:00:05,13440.0,4,116,4,13435.0,5,13445.0,4,S
2018-04-24 21:00:06,13445.0,2,118,-2,13435.0,5,13445.0,3,B
2018-04-24 21:00:07,13435.0,4,122,2,13435.0,7,13445.0,4,S
2018-04-24 21:00:08,13445.0,2,124,-2,13445.0,7,13450.0,3,B
2018-04-24 21:00:10,13450.0,2,126,0,13445.0,9,13450.0,5,B
2018-04-24 21:00:11,13445.0,20,146,2,13440.0,2,13445.0,1,S
2018-04-24 21:00:12,13445.0,2,148,0,13440.0,4,13445.0,6,S
2018-04-24 21:00:12,13445.0,6,154,0,13440.0,7,13445.0,3,S
2018-04-24 21:00:13,13440.0,8,162,0,13435.0,4,13445.0,43,S
2018-04-24 21:00:14,13440.0,2,164,0,13435.0,7,13445.0,43,S
2018-04-24 21:00:17,13440.0,2,166,-2,13435.0,8,13440.0,1,S
2018-04-24 21:00:17,13435.0,2,168,0,13435.0,7,13440.0,15,S
2018-04-24 21:00:18,13440.0,30,198,16,13435.0,7,13445.0,44,B
2018-04-24 21:00:19,13445.0,2,200,0,13435.0,10,13445.0,43,B
2018-04-24 21:00:22,13440.0,2,202,0,13435.0,10,13445.0,43,S
2018-04-24 21:00:23,13445.0,20,222,0,13435.0,8,13440.0,10,B
2018-04-24 21:00:24,13435.0,4,226,2,13435.0,6,13440.0,10,S
2018-04-24 21:00:27,13440.0,2,228,2,13435.0,7,13440.0,10,B
2018-04-24 21:00:30,13435.0,4,232,-2,13435.0,6,13440.0,12,S
2018-04-24 21:00:31,13435.0,6,238,0,13435.0,2,13440.0,12,S
2018-04-24 21:00:31,13440.0,36,274,22,13440.0,38,13445.0,34,B
2018-04-24 21:00:32,13440.0,32,306,12,13440.0,22,13445.0,34,B
2018-04-24 21:00:32,13440.0,44,350,44,13430.0,3,13445.0,34,B
2018-04-24 21:00:35,13440.0,6,356,0,13435.0,2,13445.0,35,B
2018-04-24 21:00:35,13435.0,4,360,0,13430.0,17,13435.0,8,S
2018-04-24 21:00:36,13435.0,16,376,4,13430.0,15,13445.0,35,S
2018-04-24 21:00:37,13440.0,6,382,0,13435.0,14,13445.0,35,B
2018-04-24 21:00:39,13435.0,4,386,4,13435.0,10,13440.0,2,S
2018-04-24 21:00:40,13440.0,4,390,-4,13430.0,11,13440.0,2,B
2018-04-24 21:00:43,13425.0,8,398,2,13420.0,4,13435.0,2,S
2018-04-24 21:00:47,13435.0,4,402,0,13425.0,2,13435.0,10,B
2018-04-24 21:00:47,13435.0,6,408,2,13425.0,2,13435.0,9,B
2018-04-24 21:00:50,13435.0,2,410,2,13425.0,5,13435.0,10,B
2018-04-24 21:00:56,13425.0,2,412,2,13425.0,16,13435.0,11,S
2018-04-24 21:00:59,13430.0,2,414,-2,13425.0,6,13430.0,1,B
2018-04-24 21:00:59,13430.0,2,416,0,13425.0,5,13435.0,11,B
2018-04-24 21:01:03,13435.0,4,420,0,13425.0,12,13435.0,10,B
2018-04-24 21:01:12,13435.0,12,432,8,13430.0,11,13435.0,3,B
2018-04-24 21:01:12,13435.0,6,438,-6,13435.0,6,13440.0,2,B
2018-04-24 21:01:13,13440.0,2,440,-2,13435.0,5,13440.0,1,B
2018-04-24 21:01:14,13440.0,2,442,0,13435.0,5,13445.0,35,B
2018-04-24 21:01:21,13445.0,24,466,0,13440.0,3,13445.0,23,B
2018-04-24 21:01:21,13445.0,46,512,-16,13445.0,3,13450.0,2,B
2018-04-24 21:01:23,13445.0,6,518,6,13440.0,3,13450.0,5,B
2018-04-24 21:01:24,13450.0,2,520,0,13440.0,5,13450.0,3,B
2018-04-24 21:01:24,13450.0,2,522,2,13440.0,5,13450.0,6,B
2018-04-24 21:01:25,13450.0,2,524,2,13440.0,5,13450.0,5,B
2018-04-24 21:01:26,13450.0,2,526,2,13440.0,5,13450.0,4,B
2018-04-24 21:01:27,13445.0,6,532,-2,13440.0,2,13445.0,9,S
2018-04-24 21:01:28,13440.0,4,536,2,13435.0,5,13445.0,12,S
2018-04-24 21:01:31,13445.0,6,542,6,13440.0,3,13445.0,6,B
2018-04-24 21:01:33,13445.0,2,544,2,13440.0,3,13445.0,5,B
2018-04-24 21:01:36,13445.0,4,548,0,13440.0,12,13445.0,3,B
2018-04-24 21:01:36,13445.0,6,554,0,13440.0,13,13450.0,3,B
2018-04-24 21:01:37,13450.0,6,560,2,13445.0,3,13455.0,3,B
2018-04-24 21:01:39,13450.0,6,566,4,13445.0,4,13450.0,2,B
2018-04-24 21:01:42,13445.0,2,568,0,13445.0,2,13450.0,2,S
2018-04-24 21:01:42,13450.0,4,572,0,13450.0,3,13455.0,5,B
2018-04-24 21:01:43,13450.0,6,578,0,13445.0,2,13450.0,1,B
2018-04-24 21:01:44,13445.0,2,580,-2,13440.0,22,13445.0,1,S
2018-04-24 21:01:44,13445.0,2,582,0,13440.0,15,13450.0,5,S
2018-04-24 21:01:45,13445.0,2,584,0,13440.0,3,13450.0,6,S
2018-04-24 21:01:46,13440.0,4,588,-4,13440.0,3,13450.0,6,S
2018-04-24 21:01:47,13440.0,6,594,6,13435.0,3,13445.0,8,S
2018-04-24 21:01:49,13445.0,8,602,4,13435.0,4,13445.0,4,B
2018-04-24 21:01:52,13445.0,4,606,2,13440.0,3,13445.0,2,B
2018-04-24 21:01:54,13445.0,4,610,0,13445.0,1,13450.0,5,B
2018-04-24 21:01:57,13445.0,2,612,0,13440.0,5,13445.0,1,B
2018-04-24 21:01:58,13440.0,4,616,0,13440.0,4,13450.0,18,S
2018-04-24 21:02:01,13445.0,4,620,-2,13440.0,11,13450.0,7,B
2018-04-24 21:02:10,13440.0,2,622,-2,13440.0,11,13450.0,6,S
2018-04-24 21:02:11,13440.0,2,624,0,13440.0,10,13450.0,6,S
2018-04-24 21:02:15,13450.0,8,632,4,13445.0,12,13455.0,6,B
2018-04-24 21:02:18,13450.0,2,634,-2,13450.0,4,13455.0,3,B
2018-04-24 21:02:19,13455.0,6,640,0,13455.0,3,13460.0,14,B
2018-04-24 21:02:19,13450.0,8,648,-2,13450.0,12,13455.0,1,S
2018-04-24 21:02:20,13455.0,2,650,0,13455.0,1,13460.0,14,B
2018-04-24 21:02:20,13450.0,2,652,-2,13450.0,9,13455.0,1,S
2018-04-24 21:02:25,13455.0,6,658,0,13450.0,11,13460.0,15,B
2018-04-24 21:02:29,13460.0,12,670,6,13455.0,20,13460.0,9,B
2018-04-24 21:02:30,13460.0,2,672,0,13455.0,20,13460.0,8,B
2018-04-24 21:02:31,13460.0,6,678,0,13455.0,14,13460.0,5,B
2018-04-24 21:02:32,13460.0,2,680,2,13455.0,14,13460.0,6,B
2018-04-24 21:02:34,13460.0,12,692,8,13460.0,1,13465.0,3,B
2018-04-24 21:02:36,13465.0,6,698,0,13460.0,4,13470.0,7,B
2018-04-24 21:02:37,13465.0,2,700,0,13465.0,2,13470.0,4,B
2018-04-24 21:02:38,13465.0,2,702,0,13465.0,2,13470.0,4,B
2018-04-24 21:02:40,13470.0,2,704,0,13465.0,2,13470.0,4,B
2018-04-24 21:02:42,13465.0,2,706,-2,13465.0,2,13470.0,7,S
2018-04-24 21:02:43,13465.0,2,708,2,13465.0,1,13470.0,8,S
2018-04-24 21:02:47,13470.0,16,724,10,13465.0,2,13470.0,1,B
2018-04-24 21:02:49,13470.0,2,726,0,13465.0,5,13470.0,1,B
2018-04-24 21:02:50,13470.0,2,728,0,13465.0,5,13475.0,4,B
2018-04-24 21:02:53,13470.0,2,730,-2,13465.0,3,13470.0,2,B
2018-04-24 21:02:55,13470.0,4,734,0,13470.0,1,13475.0,4,B
2018-04-24 21:02:59,13470.0,6,740,0,13470.0,1,13475.0,4,B
2018-04-24 21:02:59,13470.0,2,742,2,13465.0,5,13475.0,4,B
2018-04-24 21:03:04,13470.0,6,748,0,13470.0,3,13475.0,2,B
2018-04-24 21:03:07,13475.0,4,752,4,13470.0,5,13480.0,4,B
2018-04-24 21:03:10,13480.0,6,758,-2,13475.0,8,13485.0,4,B
2018-04-24 21:03:15,13480.0,2,760,0,13480.0,1,13485.0,4,B
2018-04-24 21:03:16,13485.0,4,764,0,13480.0,2,13485.0,2,B
2018-04-24 21:03:19,13480.0,4,768,-2,13480.0,1,13485.0,3,S
2018-04-24 21:03:20,13480.0,2,770,-2,13475.0,8,13485.0,5,S
2018-04-24 21:03:23,13480.0,2,772,-2,13475.0,14,13480.0,1,S
2018-04-24 21:03:24,13480.0,4,776,0,13475.0,13,13485.0,6,S
2018-04-24 21:03:24,13485.0,4,780,2,13475.0,13,13485.0,4,B
2018-04-24 21:03:25,13485.0,2,782,0,13475.0,13,13480.0,1,B
2018-04-24 21:03:25,13480.0,8,790,-6,13475.0,13,13480.0,1,S
2018-04-24 21:03:26,13480.0,2,792,-2,13475.0,13,13485.0,5,S
2018-04-24 21:03:30,13475.0,10,802,4,13470.0,3,13480.0,9,S
2018-04-24 21:03:30,13475.0,2,804,0,13470.0,11,13475.0,1,S
2018-04-24 21:03:31,13475.0,2,806,-2,13475.0,4,13480.0,9,S
2018-04-24 21:03:39,13480.0,2,808,0,13475.0,4,13480.0,8,B
2018-04-24 21:03:43,13475.0,4,812,-4,13475.0,2,13480.0,14,S
2018-04-24 21:03:43,13475.0,4,816,0,13470.0,7,13475.0,8,S
2018-04-24 21:03:48,13470.0,2,818,0,13470.0,5,13475.0,5,S
2018-04-24 21:03:53,13470.0,2,820,2,13470.0,4,13475.0,4,S
2018-04-24 21:03:57,13475.0,2,822,-2,13470.0,4,13475.0,3,B
2018-04-24 21:04:00,13470.0,2,824,2,13470.0,4,13475.0,10,S
2018-04-24 21:04:00,13475.0,28,852,-8,13465.0,4,13475.0,8,B
2018-04-24 21:04:02,13465.0,12,864,-2,13465.0,5,13470.0,8,S
2018-04-24 21:04:02,13465.0,10,874,0,13460.0,2,13465.0,8,S
2018-04-24 21:04:03,13460.0,2,876,-2,13455.0,14,13465.0,9,S
2018-04-24 21:04:12,13455.0,2,878,0,13455.0,20,13465.0,6,S
2018-04-24 21:04:12,13455.0,2,880,2,13455.0,19,13465.0,6,S
2018-04-24 21:04:29,13465.0,4,884,4,13465.0,15,13470.0,4,B
2018-04-24 21:04:30,13470.0,8,892,0,13465.0,7,13475.0,6,B
2018-04-24 21:04:35,13465.0,2,894,2,13465.0,1,13470.0,4,S
2018-04-24 21:04:36,13465.0,2,896,0,13465.0,1,13470.0,4,S
2018-04-24 21:04:43,13465.0,2,898,2,13460.0,11,13470.0,9,S
2018-04-24 21:04:54,13465.0,12,910,-8,13460.0,6,13470.0,12,S
2018-04-24 21:05:01,13460.0,10,920,2,13460.0,2,13470.0,18,S
2018-04-24 21:05:04,13460.0,4,924,0,13455.0,14,13465.0,7,S
2018-04-24 21:05:20,13455.0,2,926,0,13455.0,14,13465.0,14,S
2018-04-24 21:05:21,13455.0,26,952,14,13450.0,5,13460.0,12,S
2018-04-24 21:05:22,13450.0,10,962,0,13435.0,4,13455.0,15,S
2018-04-24 21:05:23,13450.0,2,964,-2,13445.0,2,13450.0,4,S
2018-04-24 21:05:29,13450.0,2,966,0,13445.0,2,13450.0,3,S
2018-04-24 21:05:29,13445.0,2,968,-2,13445.0,3,13450.0,3,S
2018-04-24 21:05:50,13450.0,12,980,-2,13445.0,5,13455.0,12,B
2018-04-24 21:05:53,13455.0,4,984,-2,13455.0,3,13460.0,8,B
2018-04-24 21:05:59,13455.0,2,986,0,13455.0,2,13460.0,12,B
2018-04-24 21:06:00,13455.0,2,988,0,13455.0,1,13460.0,11,B
2018-04-24 21:06:01,13455.0,2,990,-2,13450.0,12,13460.0,10,B
2018-04-24 21:06:04,13455.0,2,992,-2,13450.0,8,13460.0,12,B
2018-04-24 21:06:12,13455.0,2,994,2,13450.0,8,13460.0,12,B
2018-04-24 21:06:15,13450.0,2,996,2,13450.0,7,13460.0,13,S
2018-04-24 21:06:20,13460.0,6,1002,-2,13455.0,8,13465.0,5,B
2018-04-24 21:06:21,13465.0,4,1006,-2,13455.0,8,13465.0,9,B
2018-04-24 21:06:31,13465.0,2,1008,2,13460.0,4,13470.0,9,B
2018-04-24 21:07:12,13465.0,4,1012,4,13465.0,1,13470.0,12,B
2018-04-24 21:07:12,13465.0,2,1014,0,13460.0,5,13470.0,12,B
2018-04-24 21:07:13,13470.0,2,1016,0,13460.0,5,13470.0,11,B
2018-04-24 21:07:24,13465.0,2,1018,-2,13460.0,5,13470.0,11,S
2018-04-24 21:07:30,13470.0,2,1020,0,13465.0,1,13470.0,9,B
2018-04-24 21:07:33,13470.0,2,1022,0,13465.0,4,13470.0,2,B
2018-04-24 21:07:35,13465.0,2,1024,2,13465.0,3,13470.0,2,S
2018-04-24 21:07:39,13470.0,2,1026,-2,13465.0,3,13470.0,1,B
2018-04-24 21:07:40,13470.0,2,1028,0,13470.0,4,13475.0,5,B
2018-04-24 21:07:43,13470.0,2,1030,2,13470.0,3,13475.0,7,B
2018-04-24 21:07:56,13470.0,10,1040,10,13465.0,5,13470.0,5,B
2018-04-24 21:07:58,13470.0,4,1044,4,13465.0,3,13470.0,4,B
2018-04-24 21:08:16,13465.0,2,1046,0,13460.0,5,13470.0,13,S
2018-04-24 21:08:25,13460.0,2,1048,0,13460.0,4,13470.0,13,S
2018-04-24 21:08:43,13470.0,6,1054,6,13470.0,9,13475.0,9,B
2018-04-24 21:08:43,13470.0,18,1072,16,13465.0,3,13470.0,2,B
2018-04-24 21:08:52,13470.0,4,1076,-4,13470.0,1,13475.0,20,B
2018-04-24 21:08:54,13470.0,2,1078,0,13470.0,3,13475.0,15,B
2018-04-24 21:08:58,13475.0,30,1108,14,13475.0,15,13480.0,22,B
2018-04-24 21:08:59,13475.0,10,1118,0,13475.0,10,13480.0,26,B
2018-04-24 21:09:02,13480.0,20,1138,-10,13475.0,10,13485.0,21,B
2018-04-24 21:09:12,13475.0,2,1140,0,13470.0,8,13480.0,8,S
2018-04-24 21:09:20,13480.0,12,1152,-8,13475.0,9,13480.0,1,B
2018-04-24 21:09:22,13480.0,2,1154,-2,13475.0,7,13485.0,10,B
2018-04-24 21:09:27,13480.0,2,1156,2,13475.0,6,13485.0,13,B
2018-04-24 21:09:30,13485.0,2,1158,2,13480.0,2,13485.0,12,B
2018-04-24 21:09:30,13485.0,28,1186,8,13485.0,7,13490.0,19,B
2018-04-24 21:09:31,13485.0,14,1200,14,13485.0,1,13490.0,24,B
2018-04-24 21:09:31,13485.0,2,1202,0,13480.0,4,13490.0,23,B
2018-04-24 21:09:35,13490.0,4,1206,4,13485.0,6,13495.0,23,B
2018-04-24 21:09:36,13495.0,2,1208,0,13485.0,6,13495.0,22,B
2018-04-24 21:09:39,13495.0,8,1216,-4,13485.0,6,13495.0,19,B
2018-04-24 21:09:40,13485.0,4,1220,-2,13485.0,4,13495.0,6,S
2018-04-24 21:09:45,13485.0,2,1222,-2,13485.0,2,13490.0,4,S
2018-04-24 21:09:46,13485.0,2,1224,0,13480.0,6,13490.0,14,S
2018-04-24 21:09:47,13490.0,2,1226,0,13480.0,6,13490.0,14,B
2018-04-24 21:09:51,13490.0,2,1228,0,13480.0,6,13490.0,11,B
2018-04-24 21:09:52,13480.0,4,1232,0,13480.0,5,13490.0,10,S
2018-04-24 21:09:58,13480.0,10,1242,4,13475.0,5,13485.0,12,S
2018-04-24 21:10:04,13480.0,2,1244,-2,13475.0,6,13485.0,17,S
2018-04-24 21:10:07,13475.0,2,1246,-2,13475.0,1,13480.0,17,S
2018-04-24 21:10:08,13475.0,2,1248,0,13470.0,14,13480.0,17,S
2018-04-24 21:10:15,13480.0,18,1266,-2,13475.0,10,13480.0,3,B
2018-04-24 21:10:16,13480.0,6,1272,4,13480.0,2,13485.0,12,B
2018-04-24 21:10:20,13480.0,4,1276,2,13480.0,3,13485.0,13,B
2018-04-24 21:10:24,13480.0,2,1278,0,13480.0,2,13485.0,12,B
2018-04-24 21:10:28,13480.0,2,1280,2,13480.0,1,13485.0,11,B
2018-04-24 21:10:29,13485.0,8,1288,8,13485.0,6,13490.0,13,B
2018-04-24 21:10:32,13485.0,2,1290,0,13485.0,7,13490.0,5,B
2018-04-24 21:10:34,13485.0,2,1292,0,13485.0,6,13490.0,5,B
2018-04-24 21:10:38,13485.0,2,1294,0,13485.0,5,13490.0,6,B
2018-04-24 21:10:41,13485.0,2,1296,2,13485.0,4,13490.0,6,B
2018-04-24 21:10:48,13490.0,6,1302,-2,13485.0,4,13490.0,5,B
2018-04-24 21:10:58,13485.0,6,1308,6,13485.0,4,13490.0,5,S
2018-04-24 21:10:59,13485.0,2,1310,0,13485.0,3,13490.0,5,S
2018-04-24 21:11:00,13490.0,2,1312,0,13485.0,3,13490.0,14,B
2018-04-24 21:11:00,13485.0,4,1316,0,13485.0,1,13490.0,14,S
2018-04-24 21:11:01,13485.0,2,1318,-2,13480.0,11,13490.0,14,S
2018-04-24 21:11:09,13480.0,6,1324,0,13475.0,6,13485.0,5,S
2018-04-24 21:11:09,13475.0,2,1326,-2,13475.0,12,13485.0,5,S
2018-04-24 21:11:11,13480.0,2,1328,-2,13480.0,3,13485.0,5,B
2018-04-24 21:11:17,13480.0,6,1334,-6,13475.0,14,13485.0,2,B
2018-04-24 21:11:26,13475.0,2,1336,0,13475.0,14,13485.0,7,S
2018-04-24 21:11:30,13480.0,12,1348,-6,13475.0,8,13480.0,11,B
2018-04-24 21:11:37,13475.0,10,1358,4,13470.0,12,13480.0,21,S
2018-04-24 21:11:42,13475.0,2,1360,0,13475.0,4,13480.0,11,S
2018-04-24 21:11:51,13475.0,6,1366,0,13470.0,16,13480.0,24,S
2018-04-24 21:12:01,13475.0,6,1372,-4,13470.0,16,13475.0,3,S
2018-04-24 21:12:04,13475.0,6,1378,6,13470.0,13,13475.0,3,S
2018-04-24 21:12:07,13470.0,16,1394,-8,13470.0,4,13475.0,3,S
2018-04-24 21:12:10,13475.0,2,1396,-2,13470.0,6,13475.0,2,B
2018-04-24 21:12:12,13475.0,2,1398,-2,13470.0,6,13475.0,1,B
2018-04-24 21:12:42,13475.0,4,1402,-4,13475.0,1,13480.0,16,B
2018-04-24 21:12:55,13475.0,2,1404,0,13470.0,9,13480.0,7,B
2018-04-24 21:13:01,13475.0,2,1406,2,13470.0,9,13480.0,9,B
2018-04-24 21:13:02,13470.0,10,1416,0,13470.0,4,13480.0,9,S
2018-04-24 21:13:15,13470.0,12,1428,-8,13470.0,5,13480.0,10,S
2018-04-24 21:13:20,13475.0,2,1430,0,13470.0,7,13475.0,10,B
2018-04-24 21:13:25,13475.0,2,1432,2,13475.0,3,13480.0,30,B
2018-04-24 21:14:00,13475.0,2,1434,2,13470.0,7,13475.0,3,B
2018-04-24 21:14:14,13480.0,66,1500,48,13470.0,3,13485.0,21,B
2018-04-24 21:14:15,13475.0,2,1502,0,13470.0,10,13480.0,6,S
2018-04-24 21:14:35,13475.0,2,1504,2,13470.0,10,13475.0,1,S
2018-04-24 21:14:46,13470.0,4,1508,0,13470.0,5,13475.0,5,S
2018-04-24 21:15:35,13470.0,2,1510,-2,13470.0,5,13475.0,9,S
2018-04-24 21:15:38,13470.0,8,1518,-4,13470.0,1,13475.0,9,S
2018-04-24 21:15:38,13470.0,2,1520,0,13465.0,8,13470.0,12,S
2018-04-24 21:15:42,13470.0,12,1532,-12,13465.0,26,13470.0,1,S
2018-04-24 21:15:42,13470.0,2,1534,0,13470.0,1,13475.0,13,S
2018-04-24 21:15:45,13470.0,2,1536,2,13465.0,29,13475.0,13,S
2018-04-24 21:15:57,13470.0,2,1538,-2,13470.0,3,13475.0,14,S
2018-04-24 21:16:00,13470.0,2,1540,-2,13470.0,1,13475.0,15,S
2018-04-24 21:16:13,13470.0,4,1544,0,13465.0,29,13475.0,15,S
2018-04-24 21:16:25,13470.0,2,1546,-2,13465.0,17,13475.0,14,S
2018-04-24 21:16:56,13470.0,2,1548,2,13465.0,29,13475.0,15,S
2018-04-24 21:17:00,13470.0,2,1550,-2,13465.0,29,13475.0,15,S
2018-04-24 21:17:26,13470.0,2,1552,0,13470.0,2,13475.0,16,S
2018-04-24 21:17:26,13470.0,2,1554,2,13470.0,1,13475.0,16,S
2018-04-24 21:17:38,13475.0,24,1578,10,13475.0,6,13480.0,7,B
2018-04-24 21:17:39,13480.0,4,1582,4,13475.0,9,13480.0,2,B
2018-04-24 21:18:00,13480.0,4,1586,2,13480.0,3,13485.0,16,B
2018-04-24 21:18:01,13480.0,2,1588,2,13475.0,17,13485.0,11,B
2018-04-24 21:18:10,13480.0,6,1594,-6,13475.0,32,13485.0,14,B
2018-04-24 21:18:18,13480.0,2,1596,0,13475.0,5,13480.0,1,B
2018-04-24 21:18:38,13480.0,2,1598,2,13475.0,8,13480.0,3,B
2018-04-24 21:18:45,13475.0,12,1610,4,13470.0,21,13475.0,4,S
2018-04-24 21:19:19,13470.0,2,1612,0,13470.0,7,13475.0,7,S
2018-04-24 21:19:27,13475.0,16,1628,0,13475.0,4,13480.0,12,B
2018-04-24 21:19:36,13475.0,4,1632,0,13475.0,1,13480.0,14,B
2018-04-24 21:19:37,13475.0,2,1634,0,13470.0,23,13475.0,1,B
2018-04-24 21:19:37,13475.0,2,1636,-2,13470.0,23,13480.0,22,B
2018-04-24 21:19:51,13475.0,4,1640,-2,13475.0,3,13480.0,14,B
2018-04-24 21:19:59,13475.0,2,1642,-2,13475.0,3,13480.0,10,B
2018-04-24 21:20:03,13475.0,2,1644,0,13475.0,2,13480.0,10,B
2018-04-24 21:20:04,13475.0,2,1646,-2,13475.0,1,13480.0,11,B
2018-04-24 21:20:07,13480.0,2,1648,2,13470.0,35,13480.0,10,B
2018-04-24 21:20:13,13475.0,2,1650,0,13470.0,36,13475.0,1,S
2018-04-24 21:20:17,13475.0,2,1652,0,13470.0,24,13480.0,13,S
2018-04-24 21:20:31,13475.0,2,1654,0,13475.0,1,13480.0,13,S
2018-04-24 21:20:34,13475.0,2,1656,2,13470.0,25,13480.0,16,S
2018-04-24 21:20:55,13470.0,4,1660,-4,13470.0,20,13475.0,5,S
2018-04-24 21:21:30,13475.0,2,1662,0,13470.0,21,13475.0,6,B
2018-04-24 21:22:19,13475.0,2,1664,-2,13470.0,20,13475.0,8,B
2018-04-24 21:23:28,13475.0,2,1666,-2,13470.0,19,13475.0,7,B
2018-04-24 21:24:01,13470.0,28,1694,-2,13465.0,11,13470.0,1,S
2018-04-24 21:24:21,13470.0,2,1696,2,13465.0,6,13470.0,1,S
2018-04-24 21:24:30,13470.0,2,1698,2,13465.0,4,13470.0,5,S
2018-04-24 21:24:32,13465.0,6,1704,-2,13460.0,9,13470.0,18,S
2018-04-24 21:24:45,13460.0,12,1716,10,13455.0,34,13465.0,1,S
2018-04-24 21:24:45,13460.0,2,1718,0,13460.0,1,13465.0,34,S
2018-04-24 21:24:46,13455.0,4,1722,2,13455.0,3,13460.0,3,S
2018-04-24 21:24:46,13455.0,4,1726,-2,13450.0,23,13460.0,13,S
2018-04-24 21:24:48,13455.0,10,1736,10,13450.0,6,13460.0,35,S
2018-04-24 21:24:50,13450.0,10,1746,4,13450.0,1,13455.0,17,S
2018-04-24 21:24:50,13450.0,2,1748,-2,13445.0,12,13450.0,6,S
2018-04-24 21:24:51,13450.0,12,1760,-2,13445.0,10,13455.0,17,S
2018-04-24 21:24:53,13450.0,6,1766,0,13450.0,3,13455.0,3,S
2018-04-24 21:24:54,13450.0,2,1768,-2,13450.0,2,13455.0,3,S
2018-04-24 21:24:58,13455.0,2,1770,-2,13450.0,2,13455.0,4,B
2018-04-24 21:25:05,13450.0,8,1778,0,13445.0,12,13455.0,18,S
2018-04-24 21:25:08,13445.0,2,1780,2,13445.0,7,13450.0,12,S
2018-04-24 21:25:08,13445.0,14,1794,-4,13440.0,5,13450.0,15,S
2018-04-24 21:25:10,13440.0,2,1796,2,13435.0,6,13445.0,20,S
2018-04-24 21:25:10,13435.0,2,1798,-2,13435.0,5,13440.0,2,S
2018-04-24 21:25:13,13440.0,10,1808,10,13435.0,9,13445.0,23,B
2018-04-24 21:25:15,13440.0,4,1812,0,13435.0,14,13440.0,1,B
2018-04-24 21:25:16,13440.0,4,1816,4,13435.0,13,13445.0,20,B
2018-04-24 21:25:17,13440.0,2,1818,0,13435.0,12,13445.0,20,B
2018-04-24 21:25:20,13440.0,6,1824,-2,13435.0,9,13445.0,20,B
2018-04-24 21:25:24,13445.0,2,1826,0,13440.0,8,13450.0,14,B
2018-04-24 21:25:29,13435.0,20,1846,4,13435.0,24,13440.0,1,S
2018-04-24 21:25:29,13440.0,2,1848,-2,13440.0,6,13445.0,3,B
2018-04-24 21:25:31,13445.0,2,1850,0,13440.0,4,13445.0,4,B
2018-04-24 21:25:31,13445.0,6,1856,0,13440.0,9,13450.0,14,B
2018-04-24 21:25:40,13450.0,2,1858,0,13445.0,9,13455.0,14,B
2018-04-24 21:25:41,13445.0,2,1860,0,13445.0,8,13455.0,14,S
2018-04-24 21:25:46,13445.0,4,1864,0,13445.0,25,13455.0,6,S
2018-04-24 21:25:50,13455.0,2,1866,0,13450.0,11,13455.0,3,B
2018-04-24 21:25:51,13455.0,2,1868,0,13450.0,11,13455.0,2,B
2018-04-24 21:25:53,13455.0,2,1870,2,13450.0,11,13460.0,15,B
2018-04-24 21:26:01,13460.0,2,1872,-2,13450.0,12,13460.0,22,B
2018-04-24 21:26:02,13455.0,2,1874,-2,13450.0,12,13460.0,22,S
2018-04-24 21:26:06,13450.0,2,1876,2,13450.0,10,13455.0,17,S
2018-04-24 21:26:11,13455.0,2,1878,-2,13450.0,10,13455.0,13,B
2018-04-24 21:26:12,13455.0,2,1880,0,13450.0,10,13455.0,12,B
2018-04-24 21:26:16,13450.0,4,1884,2,13450.0,8,13455.0,19,S
2018-04-24 21:26:16,13450.0,16,1900,12,13445.0,8,13455.0,19,S
2018-04-24 21:26:33,13445.0,2,1902,2,13445.0,5,13450.0,3,S
2018-04-24 21:26:55,13450.0,2,1904,0,13450.0,5,13455.0,4,B
2018-04-24 21:26:58,13455.0,8,1912,0,13450.0,8,13460.0,20,B
2018-04-24 21:27:02,13455.0,2,1914,0,13455.0,3,13460.0,23,B
2018-04-24 21:27:02,13455.0,6,1920,4,13450.0,12,13460.0,26,B
2018-04-24 21:27:19,13455.0,2,1922,0,13450.0,9,13455.0,1,B
2018-04-24 21:27:20,13450.0,2,1924,0,13450.0,8,13455.0,1,S
2018-04-24 21:27:32,13455.0,2,1926,-2,13450.0,8,13460.0,38,B
2018-04-24 21:28:03,13460.0,2,1928,0,13450.0,12,13460.0,25,B
2018-04-24 21:28:09,13455.0,2,1930,0,13450.0,12,13460.0,25,S
2018-04-24 21:28:14,13455.0,6,1936,-4,13450.0,2,13455.0,11,S
2018-04-24 21:28:21,13455.0,2,1938,2,13450.0,2,13455.0,10,S
2018-04-24 21:28:21,13455.0,20,1958,8,13450.0,2,13460.0,37,S
2018-04-24 21:28:30,13460.0,2,1960,-2,13450.0,18,13460.0,15,B
2018-04-24 21:28:34,13455.0,2,1962,2,13450.0,18,13460.0,15,S
2018-04-24 21:28:49,13455.0,2,1964,0,13455.0,3,13460.0,19,S
2018-04-24 21:29:01,13450.0,2,1966,0,13450.0,19,13460.0,14,S
2018-04-24 21:29:16,13455.0,2,1968,0,13450.0,20,13460.0,14,B
2018-04-24 21:29:27,13455.0,6,1974,6,13450.0,20,13455.0,7,B
2018-04-24 21:29:27,13455.0,2,1976,0,13450.0,19,13455.0,6,B
2018-04-24 21:29:45,13455.0,2,1978,2,13450.0,16,13455.0,5,B
2018-04-24 21:30:02,13455.0,10,1988,4,13455.0,1,13460.0,19,B
2018-04-24 21:30:02,13455.0,2,1990,2,13450.0,13,13460.0,20,B
2018-04-24 21:30:11,13450.0,2,1992,2,13450.0,10,13455.0,13,S
2018-04-24 21:30:12,13450.0,8,2000,-2,13445.0,9,13455.0,17,S
2018-04-24 21:30:17,13455.0,2,2002,2,13450.0,7,13455.0,14,B
2018-04-24 21:30:24,13450.0,2,2004,-2,13450.0,6,13455.0,9,S
2018-04-24 21:30:28,13450.0,8,2012,4,13445.0,12,13455.0,22,S
2018-04-24 21:30:42,13445.0,6,2018,2,13440.0,6,13445.0,2,S
2018-04-24 21:30:46,13445.0,2,2020,2,13440.0,7,13445.0,4,S
2018-04-24 21:30:54,13440.0,2,2022,2,13435.0,10,13440.0,8,S
2018-04-24 21:30:55,13435.0,4,2026,-4,13430.0,11,13435.0,2,S
2018-04-24 21:30:57,13435.0,6,2032,-6,13430.0,6,13440.0,18,S
2018-04-24 21:30:58,13435.0,2,2034,0,13430.0,24,13440.0,13,S
2018-04-24 21:31:02,13430.0,2,2036,2,13430.0,11,13440.0,17,S
2018-04-24 21:31:02,13430.0,10,2046,-2,13430.0,28,13440.0,6,S
2018-04-24 21:31:03,13430.0,4,2050,-2,13435.0,1,13445.0,17,S
2018-04-24 21:31:04,13440.0,4,2054,-4,13435.0,21,13445.0,17,B
2018-04-24 21:31:30,13440.0,2,2056,-2,13440.0,6,13450.0,19,B
2018-04-24 21:31:34,13450.0,2,2058,2,13440.0,7,13450.0,18,B
2018-04-24 21:31:39,13440.0,12,2070,12,13435.0,23,13440.0,4,S
2018-04-24 21:31:39,13440.0,8,2078,8,13440.0,2,13450.0,18,S
2018-04-24 21:31:41,13445.0,2,2080,0,13440.0,3,13450.0,18,B
2018-04-24 21:31:55,13440.0,2,2082,0,13435.0,6,13440.0,1,S
2018-04-24 21:31:58,13440.0,2,2084,0,13435.0,6,13445.0,16,S
2018-04-24 21:32:02,13440.0,2,2086,-2,13435.0,8,13445.0,10,S
2018-04-24 21:32:06,13440.0,2,2088,0,13435.0,8,13445.0,16,S
2018-04-24 21:32:08,13440.0,2,2090,2,13440.0,1,13445.0,4,S
2018-04-24 21:32:22,13445.0,2,2092,-2,13440.0,6,13445.0,3,B
2018-04-24 21:32:42,13440.0,2,2094,0,13440.0,5,13445.0,12,S
2018-04-24 21:32:43,13440.0,10,2104,0,13435.0,7,13445.0,12,S
2018-04-24 21:32:56,13440.0,2,2106,2,13440.0,4,13445.0,3,S
2018-04-24 21:32:57,13440.0,8,2114,2,13435.0,35,13445.0,3,S
2018-04-24 21:33:02,13445.0,2,2116,0,13440.0,3,13445.0,2,B
2018-04-24 21:33:07,13445.0,2,2118,2,13440.0,4,13450.0,12,B
2018-04-24 21:33:17,13450.0,12,2130,4,13445.0,16,13450.0,1,B
2018-04-24 21:33:18,13450.0,2,2132,0,13450.0,1,13455.0,13,B
2018-04-24 21:33:20,13450.0,2,2134,2,13450.0,1,13455.0,13,B
2018-04-24 21:33:54,13455.0,2,2136,0,13450.0,2,13455.0,12,B
2018-04-24 21:34:14,13450.0,2,2138,2,13450.0,2,13455.0,19,S
2018-04-24 21:34:32,13450.0,2,2140,0,13445.0,21,13455.0,16,S
2018-04-24 21:34:52,13445.0,2,2142,0,13440.0,20,13445.0,3,S
2018-04-24 21:34:52,13445.0,4,2146,2,13440.0,25,13445.0,1,S
2018-04-24 21:34:53,13445.0,2,2148,2,13445.0,1,13450.0,13,S
2018-04-24 21:35:03,13450.0,2,2150,-2,13445.0,1,13450.0,12,B
2018-04-24 21:35:08,13445.0,10,2160,2,13440.0,37,13445.0,2,S
2018-04-24 21:35:09,13450.0,8,2168,0,13445.0,23,13455.0,24,B
2018-04-24 21:36:26,13455.0,20,2188,16,13445.0,23,13455.0,18,B
2018-04-24 21:37:07,13450.0,12,2200,0,13445.0,14,13455.0,15,S
2018-04-24 21:37:11,13455.0,14,2214,-12,13445.0,19,13455.0,12,B
2018-04-24 21:37:21,13455.0,4,2218,0,13450.0,6,13455.0,5,B
2018-04-24 21:37:22,13455.0,10,2228,-2,13450.0,6,13460.0,24,B
2018-04-24 21:38:03,13460.0,10,2238,-4,13455.0,6,13465.0,21,B
2018-04-24 21:39:04,13465.0,2,2240,0,13460.0,8,13465.0,3,B
2018-04-24 21:39:08,13465.0,2,2242,0,13460.0,8,13465.0,2,B
2018-04-24 21:39:12,13460.0,2,2244,0,13460.0,6,13465.0,9,S
2018-04-24 21:39:13,13460.0,12,2256,0,13455.0,6,13460.0,16,S
2018-04-24 21:39:14,13455.0,4,2260,4,13455.0,2,13460.0,12,S
2018-04-24 21:39:14,13455.0,4,2264,0,13450.0,10,13455.0,2,S
2018-04-24 21:39:22,13460.0,2,2266,2,13450.0,12,13460.0,11,B
2018-04-24 21:39:40,13455.0,2,2268,0,13455.0,1,13460.0,3,S
2018-04-24 21:39:42,13460.0,4,2272,-2,13455.0,3,13460.0,2,B
2018-04-24 21:39:46,13455.0,2,2274,2,13455.0,1,13460.0,6,S
2018-04-24 21:40:15,13460.0,12,2286,-2,13455.0,6,13465.0,11,B
2018-04-24 21:40:44,13465.0,4,2290,-2,13460.0,21,13470.0,9,B
2018-04-24 21:40:52,13465.0,2,2292,0,13460.0,5,13465.0,1,B
2018-04-24 21:40:57,13465.0,2,2294,0,13460.0,4,13465.0,1,B
2018-04-24 21:41:09,13460.0,2,2296,-2,13460.0,3,13465.0,5,S
2018-04-24 21:41:51,13460.0,2,2298,2,13460.0,3,13465.0,5,S
2018-04-24 21:42:02,13460.0,2,2300,0,13460.0,2,13465.0,5,S
2018-04-24 21:42:06,13465.0,10,2310,2,13460.0,25,13470.0,12,B
2018-04-24 21:42:14,13465.0,6,2316,6,13465.0,2,13470.0,12,B
2018-04-24 21:42:39,13465.0,4,2320,4,13460.0,5,13465.0,4,B
2018-04-24 21:43:30,13465.0,2,2322,-2,13460.0,19,13470.0,12,B
2018-04-24 21:43:50,13470.0,10,2332,-10,13465.0,8,13475.0,21,B
2018-04-24 21:43:51,13475.0,2,2334,0,13465.0,16,13475.0,8,B
2018-04-24 21:43:51,13475.0,10,2344,0,13465.0,28,13475.0,4,B
2018-04-24 21:43:52,13470.0,6,2350,0,13470.0,1,13475.0,5,S
2018-04-24 21:44:05,13470.0,2,2352,-2,13470.0,5,13475.0,10,S
2018-04-24 21:44:11,13475.0,12,2364,-8,13470.0,2,13475.0,12,B
2018-04-24 21:44:15,13475.0,4,2368,2,13470.0,10,13475.0,2,B
2018-04-24 21:44:20,13480.0,2,2370,2,13470.0,5,13480.0,29,B
2018-04-24 21:44:27,13480.0,2,2372,2,13470.0,10,13480.0,21,B
2018-04-24 21:44:39,13470.0,2,2374,2,13470.0,5,13475.0,4,S
2018-04-24 21:44:41,13480.0,90,2464,-18,13480.0,5,13485.0,36,B
2018-04-24 21:44:42,13475.0,14,2478,-12,13475.0,1,13480.0,10,S
2018-04-24 21:44:43,13475.0,2,2480,0,13470.0,9,13480.0,11,S
2018-04-24 21:44:45,13475.0,2,2482,-2,13470.0,10,13480.0,16,S
2018-04-24 21:45:05,13475.0,2,2484,0,13470.0,10,13475.0,2,S
2018-04-24 21:45:15,13475.0,2,2486,2,13470.0,9,13475.0,3,S
2018-04-24 21:45:21,13470.0,2,2488,0,13470.0,6,13475.0,3,S
2018-04-24 21:45:21,13470.0,2,2490,0,13470.0,8,13475.0,3,S
2018-04-24 21:45:31,13470.0,4,2494,0,13470.0,8,13475.0,3,S
2018-04-24 21:45:39,13475.0,2,2496,2,13470.0,11,13475.0,4,B
2018-04-24 21:45:40,13475.0,4,2500,0,13470.0,17,13475.0,2,B
2018-04-24 21:45:40,13475.0,4,2504,4,13475.0,6,13480.0,49,B
2018-04-24 21:45:44,13475.0,2,2506,-2,13475.0,7,13480.0,48,B
2018-04-24 21:46:09,13475.0,14,2520,6,13475.0,1,13480.0,52,B
2018-04-24 21:46:09,13475.0,2,2522,0,13470.0,9,13475.0,22,B
2018-04-24 21:46:25,13475.0,2,2524,0,13470.0,8,13475.0,7,B
2018-04-24 21:47:06,13475.0,18,2542,16,13475.0,1,13480.0,57,B
2018-04-24 21:47:06,13475.0,2,2544,0,13470.0,7,13480.0,57,B
2018-04-24 21:47:25,13470.0,8,2552,-4,13465.0,8,13470.0,4,S
2018-04-24 21:47:54,13465.0,10,2562,-6,13460.0,7,13465.0,3,S
2018-04-24 21:47:55,13465.0,6,2568,0,13465.0,3,13470.0,1,S
2018-04-24 21:47:56,13475.0,2,2570,0,13470.0,7,13475.0,4,B
2018-04-24 21:47:57,13475.0,2,2572,0,13470.0,18,13475.0,3,B
2018-04-24 21:47:57,13475.0,2,2574,0,13470.0,19,13480.0,59,B
2018-04-24 21:48:54,13475.0,2,2576,0,13470.0,1,13475.0,11,B
2018-04-24 21:48:54,13470.0,2,2578,0,13465.0,15,13475.0,14,S
2018-04-24 21:49:11,13470.0,2,2580,0,13470.0,5,13475.0,15,S
2018-04-24 21:49:12,13470.0,2,2582,0,13470.0,4,13475.0,15,S
2018-04-24 21:49:31,13470.0,4,2586,0,13465.0,23,13470.0,4,S
2018-04-24 21:49:31,13470.0,8,2594,0,13465.0,23,13475.0,11,S
2018-04-24 21:49:36,13470.0,2,2596,-2,13470.0,15,13475.0,8,S
2018-04-24 21:50:03,13475.0,2,2598,0,13470.0,15,13475.0,10,B
2018-04-24 21:50:15,13475.0,2,2600,2,13470.0,15,13475.0,9,B
2018-04-24 21:50:18,13475.0,4,2604,4,13470.0,13,13475.0,7,B
2018-04-24 21:50:19,13475.0,4,2608,2,13470.0,13,13475.0,4,B
2018-04-24 21:50:26,13475.0,4,2612,2,13470.0,18,13475.0,2,B
2018-04-24 21:50:26,13475.0,4,2616,2,13475.0,12,13480.0,57,B
2018-04-24 21:50:31,13475.0,10,2626,4,13470.0,14,13475.0,1,B
2018-04-24 21:51:05,13470.0,8,2634,0,13465.0,9,13475.0,12,S
2018-04-24 21:51:05,13470.0,2,2636,2,13465.0,7,13470.0,6,S
2018-04-24 21:52:02,13470.0,2,2638,2,13460.0,19,13470.0,7,S
2018-04-24 21:52:07,13470.0,2,2640,0,13460.0,6,13470.0,13,S
2018-04-24 21:53:12,13470.0,4,2644,0,13465.0,3,13470.0,1,S
2018-04-24 21:53:24,13470.0,2,2646,-2,13465.0,9,13475.0,11,S
2018-04-24 21:54:20,13465.0,4,2650,2,13465.0,5,13470.0,4,S
2018-04-24 21:54:21,13465.0,10,2660,8,13460.0,8,13470.0,11,S
2018-04-24 21:54:28,13465.0,2,2662,0,13460.0,26,13470.0,5,S
2018-04-24 21:55:48,13470.0,2,2664,0,13465.0,1,13470.0,7,B
2018-04-24 21:56:02,13470.0,4,2668,-2,13465.0,19,13470.0,2,B
2018-04-24 21:56:06,13470.0,2,2670,-2,13465.0,19,13470.0,1,B
2018-04-24 21:56:20,13470.0,2,2672,0,13465.0,20,13475.0,9,B
2018-04-24 21:56:21,13475.0,4,2676,-2,13475.0,2,13480.0,56,B
2018-04-24 21:56:21,13475.0,4,2680,4,13475.0,2,13480.0,56,B
2018-04-24 21:56:23,13475.0,4,2684,4,13475.0,2,13480.0,53,B
2018-04-24 21:56:39,13475.0,2,2686,0,13470.0,10,13475.0,4,B
2018-04-24 21:56:41,13475.0,6,2692,-4,13470.0,17,13475.0,1,B
2018-04-24 21:56:42,13475.0,2,2694,-2,13475.0,2,13480.0,56,B
2018-04-24 21:56:50,13480.0,4,2698,0,13475.0,23,13480.0,48,B
2018-04-24 21:56:51,13480.0,2,2700,0,13475.0,23,13480.0,45,B
2018-04-24 21:56:51,13480.0,10,2710,-10,13475.0,18,13480.0,40,B
2018-04-24 21:56:54,13480.0,80,2790,6,13480.0,1,13485.0,18,B
2018-04-24 21:56:56,13485.0,30,2820,-14,13485.0,1,13490.0,24,B
2018-04-24 21:56:58,13485.0,6,2826,-6,13480.0,19,13490.0,28,B
2018-04-24 21:57:01,13485.0,2,2828,0,13480.0,14,13485.0,3,B
2018-04-24 21:57:01,13485.0,6,2834,0,13480.0,18,13490.0,29,B
2018-04-24 21:57:04,13490.0,10,2844,0,13485.0,15,13490.0,17,B
2018-04-24 21:57:04,13490.0,34,2878,16,13490.0,10,13495.0,10,B
2018-04-24 21:57:05,13495.0,12,2890,-2,13490.0,12,13495.0,1,B
2018-04-24 21:57:05,13500.0,4,2894,-2,13495.0,1,13500.0,19,B
2018-04-24 21:57:06,13500.0,4,2898,-2,13495.0,2,13500.0,20,B
2018-04-24 21:57:06,13500.0,16,2914,-2,13495.0,2,13500.0,12,B
2018-04-24 21:57:07,13500.0,16,2930,10,13495.0,4,13500.0,4,B
2018-04-24 21:57:10,13495.0,2,2932,-2,13495.0,2,13500.0,6,S
2018-04-24 21:57:11,13495.0,4,2936,0,13490.0,14,13500.0,6,S
2018-04-24 21:57:12,13500.0,2,2938,2,13490.0,15,13500.0,8,B
2018-04-24 21:57:16,13490.0,4,2942,-2,13490.0,24,13495.0,4,S
2018-04-24 21:57:17,13490.0,4,2946,4,13490.0,22,13495.0,4,S
2018-04-24 21:57:19,13495.0,2,2948,2,13490.0,22,13495.0,6,B
2018-04-24 21:57:22,13495.0,18,2966,4,13495.0,2,13500.0,11,B
2018-04-24 21:57:23,13495.0,4,2970,4,13490.0,22,13495.0,1,B
2018-04-24 21:57:31,13495.0,2,2972,0,13490.0,23,13495.0,2,B
2018-04-24 21:57:32,13495.0,2,2974,-2,13490.0,22,13495.0,1,B
2018-04-24 21:57:32,13495.0,2,2976,-2,13495.0,2,13500.0,11,B
2018-04-24 21:57:37,13495.0,2,2978,-2,13495.0,1,13500.0,14,B
2018-04-24 21:57:38,13495.0,2,2980,0,13490.0,25,13495.0,2,B
2018-04-24 21:57:43,13495.0,2,2982,0,13490.0,21,13495.0,1,B
2018-04-24 21:57:43,13495.0,2,2984,2,13490.0,21,13500.0,15,B
2018-04-24 21:57:44,13495.0,2,2986,2,13495.0,3,13500.0,11,B
2018-04-24 21:57:45,13495.0,4,2990,0,13495.0,1,13500.0,11,B
2018-04-24 21:57:50,13495.0,2,2992,0,13490.0,31,13495.0,1,B
2018-04-24 21:57:50,13495.0,2,2994,0,13495.0,2,13500.0,13,B
2018-04-24 21:57:52,13495.0,2,2996,-2,13490.0,25,13495.0,1,B
2018-04-24 21:57:59,13495.0,2,2998,-2,13490.0,31,13500.0,13,B
2018-04-24 21:58:11,13495.0,2,3000,0,13495.0,2,13500.0,12,B
2018-04-24 21:58:27,13490.0,6,3006,4,13490.0,13,13495.0,2,S
2018-04-24 21:58:33,13495.0,4,3010,2,13490.0,13,13500.0,13,B
2018-04-24 21:58:40,13495.0,2,3012,0,13495.0,2,13500.0,13,B
2018-04-24 21:58:51,13500.0,8,3020,4,13495.0,17,13500.0,2,B
2018-04-24 21:58:52,13500.0,4,3024,-4,13495.0,17,13505.0,10,B
2018-04-24 21:58:52,13500.0,2,3026,0,13495.0,17,13505.0,8,B
2018-04-24 21:58:53,13500.0,2,3028,2,13495.0,17,13505.0,8,B
2018-04-24 21:58:54,13500.0,2,3030,2,13500.0,3,13505.0,8,B
2018-04-24 21:59:04,13500.0,6,3036,4,13495.0,9,13500.0,3,B
2018-04-24 21:59:08,13500.0,4,3040,0,13500.0,1,13505.0,16,B
2018-04-24 21:59:09,13500.0,2,3042,2,13495.0,4,13500.0,2,B
2018-04-24 21:59:13,13495.0,2,3044,0,13495.0,2,13500.0,7,S
2018-04-24 21:59:13,13495.0,2,3046,0,13495.0,1,13500.0,7,S
2018-04-24 21:59:14,13495.0,2,3048,0,13490.0,7,13495.0,4,S
2018-04-24 21:59:23,13495.0,2,3050,0,13490.0,15,13495.0,3,S
2018-04-24 21:59:28,13490.0,2,3052,0,13485.0,11,13495.0,12,S
2018-04-24 21:59:43,13500.0,8,3060,-4,13495.0,10,13500.0,4,B
2018-04-24 21:59:51,13500.0,4,3064,0,13490.0,17,13500.0,15,B
2018-04-24 21:59:53,13495.0,8,3072,8,13490.0,17,13495.0,1,S
2018-04-24 21:59:53,13495.0,2,3074,2,13495.0,4,13500.0,10,S
2018-04-24 21:59:56,13500.0,2,3076,0,13495.0,2,13500.0,6,B
2018-04-24 21:59:58,13500.0,2,3078,0,13495.0,2,13500.0,5,B
2018-04-24 22:00:03,13500.0,6,3084,4,13495.0,3,13500.0,7,B
2018-04-24 22:00:08,13495.0,2,3086,-2,13495.0,2,13500.0,16,S
2018-04-24 22:00:11,13495.0,4,3090,-4,13490.0,18,13500.0,16,S
2018-04-24 22:00:13,13495.0,2,3092,2,13490.0,6,13495.0,1,S
2018-04-24 22:00:21,13490.0,6,3098,-6,13490.0,1,13495.0,11,S
2018-04-24 22:00:21,13490.0,2,3100,-2,13490.0,1,13495.0,11,S
2018-04-24 22:00:22,13490.0,2,3102,0,13485.0,10,13495.0,11,S
2018-04-24 22:00:44,13490.0,2,3104,0,13485.0,20,13495.0,22,S
2018-04-24 22:00:47,13495.0,2,3106,0,13490.0,17,13495.0,7,B
2018-04-24 22:00:47,13495.0,8,3114,0,13490.0,17,13495.0,3,B
2018-04-24 22:00:49,13495.0,6,3120,6,13495.0,11,13500.0,19,B
2018-04-24 22:00:59,13495.0,2,3122,0,13495.0,15,13500.0,14,B
2018-04-24 22:01:02,13500.0,2,3124,0,13495.0,15,13500.0,12,B
2018-04-24 22:01:03,13500.0,14,3138,8,13495.0,25,13500.0,5,B
2018-04-24 22:01:03,13500.0,10,3148,0,13500.0,1,13505.0,14,B
2018-04-24 22:01:07,13505.0,2,3150,2,13500.0,3,13505.0,3,B
2018-04-24 22:01:11,13505.0,2,3152,2,13500.0,5,13505.0,1,B
2018-04-24 22:01:17,13505.0,6,3158,2,13500.0,8,13505.0,12,B
2018-04-24 22:01:18,13500.0,4,3162,2,13500.0,2,13505.0,11,S
2018-04-24 22:01:22,13505.0,6,3168,4,13500.0,1,13505.0,5,B
2018-04-24 22:01:30,13500.0,10,3178,2,13495.0,37,13500.0,3,S
2018-04-24 22:01:31,13500.0,2,3180,0,13495.0,39,13500.0,2,S
2018-04-24 22:01:31,13500.0,2,3182,2,13495.0,10,13500.0,1,S
2018-04-24 22:01:32,13500.0,2,3184,0,13495.0,24,13505.0,14,S
2018-04-24 22:01:37,13505.0,42,3226,-14,13505.0,29,13510.0,22,B
2018-04-24 22:01:37,13505.0,28,3254,-8,13505.0,16,13510.0,9,B
2018-04-24 22:01:40,13505.0,2,3256,-2,13505.0,15,13510.0,7,B
2018-04-24 22:01:41,13505.0,2,3258,-2,13505.0,13,13510.0,6,B
2018-04-24 22:01:41,13505.0,2,3260,-2,13505.0,12,13510.0,6,B
2018-04-24 22:01:45,13505.0,2,3262,-2,13505.0,11,13510.0,8,B
2018-04-24 22:01:50,13505.0,2,3264,-2,13505.0,10,13510.0,10,B
2018-04-24 22:01:55,13505.0,2,3266,0,13505.0,10,13510.0,10,B
2018-04-24 22:02:08,13510.0,2,3268,2,13505.0,13,13510.0,7,B
2018-04-24 22:02:08,13505.0,2,3270,-2,13505.0,12,13510.0,7,S
2018-04-24 22:02:09,13510.0,14,3284,2,13505.0,19,13515.0,14,B
2018-04-24 22:02:10,13515.0,2,3286,-2,13505.0,19,13515.0,13,B
2018-04-24 22:02:10,13505.0,2,3288,0,13505.0,18,13515.0,13,S
2018-04-24 22:02:12,13515.0,2,3290,0,13505.0,18,13515.0,12,B
2018-04-24 22:02:13,13510.0,2,3292,-2,13510.0,3,13515.0,12,S
2018-04-24 22:02:14,13510.0,2,3294,0,13510.0,2,13515.0,11,S
2018-04-24 22:02:26,13510.0,4,3298,2,13505.0,18,13515.0,8,S
2018-04-24 22:02:29,13510.0,4,3302,-4,13505.0,18,13515.0,12,S
2018-04-24 22:02:31,13505.0,2,3304,-2,13505.0,17,13510.0,1,S
2018-04-24 22:02:39,13510.0,2,3306,2,13505.0,19,13510.0,3,B
2018-04-24 22:02:39,13510.0,6,3312,-4,13510.0,10,13515.0,12,B
2018-04-24 22:02:40,13510.0,2,3314,0,13510.0,11,13515.0,12,B
2018-04-24 22:02:47,13510.0,2,3316,-2,13510.0,13,13515.0,2,B
2018-04-24 22:02:48,13515.0,4,3320,4,13515.0,4,13520.0,12,B
2018-04-24 22:03:00,13510.0,20,3340,8,13505.0,35,13515.0,3,S
2018-04-24 22:03:03,13515.0,6,3346,4,13515.0,1,13520.0,22,B
2018-04-24 22:03:04,13515.0,2,3348,2,13510.0,2,13515.0,4,B
2018-04-24 22:03:07,13515.0,2,3350,2,13510.0,2,13515.0,6,B
2018-04-24 22:03:08,13510.0,4,3354,0,13505.0,12,13510.0,3,S
2018-04-24 22:03:25,13505.0,20,3374,-6,13500.0,9,13505.0,2,S
2018-04-24 22:03:28,13500.0,2,3376,0,13500.0,5,13505.0,2,S
2018-04-24 22:03:30,13500.0,2,3378,-2,13500.0,3,13505.0,2,S
2018-04-24 22:03:34,13505.0,4,3382,0,13500.0,28,13510.0,14,B
2018-04-24 22:03:36,13505.0,2,3384,2,13505.0,2,13510.0,7,B
2018-04-24 22:03:36,13505.0,2,3386,0,13505.0,1,13510.0,7,B
2018-04-24 22:03:37,13505.0,2,3388,2,13505.0,1,13510.0,10,B
2018-04-24 22:03:37,13505.0,2,3390,2,13500.0,44,13505.0,1,B
2018-04-24 22:03:41,13505.0,2,3392,0,13505.0,2,13510.0,14,B
2018-04-24 22:03:42,13505.0,2,3394,-2,13505.0,1,13510.0,14,B
2018-04-24 22:03:54,13505.0,2,3396,-2,13505.0,12,13510.0,11,B
2018-04-24 22:04:20,13505.0,4,3400,2,13505.0,12,13510.0,6,B
2018-04-24 22:04:40,13510.0,2,3402,2,13505.0,2,13510.0,7,B
2018-04-24 22:04:46,13510.0,4,3406,0,13505.0,2,13510.0,5,B
2018-04-24 22:04:54,13510.0,10,3416,6,13505.0,3,13515.0,25,B
2018-04-24 22:05:17,13505.0,2,3418,2,13505.0,4,13510.0,9,S
2018-04-24 22:05:25,13510.0,10,3428,0,13505.0,7,13510.0,3,B
2018-04-24 22:05:33,13510.0,8,3436,2,13510.0,1,13515.0,31,B
2018-04-24 22:05:34,13510.0,2,3438,2,13505.0,4,13510.0,3,B
2018-04-24 22:05:50,13510.0,4,3442,-4,13505.0,7,13510.0,1,B
2018-04-24 22:05:51,13510.0,2,3444,0,13510.0,3,13515.0,24,B
2018-04-24 22:05:56,13510.0,6,3450,2,13510.0,62,13515.0,18,B
2018-04-24 22:05:56,13510.0,2,3452,2,13510.0,61,13515.0,18,B
2018-04-24 22:05:58,13510.0,2,3454,2,13510.0,60,13515.0,18,B
2018-04-24 22:05:59,13510.0,2,3456,0,13510.0,59,13515.0,18,B
2018-04-24 22:06:07,13515.0,2,3458,0,13510.0,59,13515.0,17,B
2018-04-24 22:06:07,13515.0,2,3460,2,13510.0,59,13515.0,16,B
2018-04-24 22:06:08,13515.0,4,3464,-2,13510.0,59,13515.0,14,B
2018-04-24 22:06:08,13510.0,6,3470,-6,13510.0,56,13515.0,27,S
2018-04-24 22:06:09,13515.0,2,3472,2,13510.0,56,13515.0,26,B
2018-04-24 22:06:15,13510.0,2,3474,-2,13510.0,55,13515.0,23,S
2018-04-24 22:06:24,13510.0,18,3492,-12,13510.0,47,13515.0,23,S
2018-04-24 22:06:25,13510.0,4,3496,-2,13510.0,45,13515.0,23,S
2018-04-24 22:06:26,13510.0,2,3498,0,13510.0,44,13515.0,25,S
2018-04-24 22:06:29,13510.0,2,3500,-2,13510.0,43,13515.0,19,S
2018-04-24 22:06:39,13510.0,2,3502,0,13510.0,52,13515.0,25,S
2018-04-24 22:06:43,13510.0,2,3504,0,13510.0,51,13515.0,31,S
2018-04-24 22:06:49,13510.0,8,3512,-8,13510.0,47,13515.0,35,S
2018-04-24 22:06:57,13510.0,6,3518,-6,13510.0,44,13515.0,35,S
2018-04-24 22:06:59,13510.0,4,3522,0,13510.0,42,13515.0,43,S
2018-04-24 22:06:59,13510.0,4,3526,0,13510.0,40,13515.0,43,S
2018-04-24 22:07:00,13510.0,2,3528,0,13510.0,39,13515.0,43,S
2018-04-24 22:07:02,13510.0,2,3530,-2,13510.0,38,13515.0,40,S
2018-04-24 22:07:04,13510.0,2,3532,0,13510.0,37,13515.0,43,S
2018-04-24 22:07:08,13510.0,4,3536,0,13510.0,35,13515.0,41,S
2018-04-24 22:07:09,13510.0,2,3538,-2,13510.0,34,13515.0,41,S
2018-04-24 22:07:11,13510.0,2,3540,0,13510.0,33,13515.0,41,S
2018-04-24 22:07:14,13510.0,2,3542,-2,13510.0,32,13515.0,41,S
2018-04-24 22:07:16,13515.0,2,3544,0,13510.0,32,13515.0,40,B
2018-04-24 22:07:16,13510.0,10,3554,0,13510.0,27,13515.0,40,S
2018-04-24 22:07:18,13510.0,2,3556,0,13510.0,26,13515.0,41,S
2018-04-24 22:07:19,13510.0,52,3608,-26,13505.0,6,13510.0,1,S
2018-04-24 22:07:19,13505.0,6,3614,4,13500.0,5,13505.0,1,S
2018-04-24 22:07:33,13500.0,2,3616,-2,13500.0,9,13505.0,7,S
2018-04-24 22:07:37,13500.0,18,3634,2,13495.0,2,13505.0,7,S
2018-04-24 22:07:38,13500.0,2,3636,0,13495.0,6,13500.0,3,S
2018-04-24 22:07:41,13500.0,2,3638,-2,13495.0,10,13505.0,11,S
2018-04-24 22:07:46,13500.0,2,3640,-2,13495.0,9,13505.0,14,S
2018-04-24 22:07:57,13500.0,4,3644,-4,13500.0,1,13505.0,14,S
2018-04-24 22:07:57,13500.0,2,3646,0,13495.0,8,13505.0,14,S
2018-04-24 22:07:59,13495.0,6,3652,2,13495.0,1,13500.0,4,S
2018-04-24 22:08:00,13495.0,2,3654,0,13495.0,1,13500.0,4,S
2018-04-24 22:08:00,13495.0,2,3656,0,13490.0,5,13500.0,4,S
2018-04-24 22:08:09,13500.0,2,3658,2,13490.0,10,13500.0,11,B
2018-04-24 22:08:15,13495.0,2,3660,0,13490.0,4,13495.0,3,S
2018-04-24 22:08:19,13495.0,2,3662,2,13490.0,4,13495.0,4,S
2018-04-24 22:08:26,13490.0,4,3666,-4,13490.0,7,13495.0,4,S
2018-04-24 22:08:28,13490.0,2,3668,0,13490.0,3,13495.0,12,S
2018-04-24 22:08:30,13490.0,6,3674,-2,13490.0,1,13495.0,13,S
2018-04-24 22:08:31,13490.0,2,3676,0,13490.0,1,13495.0,13,S
2018-04-24 22:08:31,13490.0,2,3678,2,13490.0,1,13495.0,13,S
2018-04-24 22:08:32,13490.0,2,3680,0,13490.0,1,13495.0,12,S
2018-04-24 22:08:32,13490.0,2,3682,0,13485.0,18,13495.0,12,S
2018-04-24 22:08:55,13490.0,2,3684,0,13485.0,4,13490.0,4,S
2018-04-24 22:08:56,13485.0,2,3686,2,13485.0,3,13490.0,7,S
2018-04-24 22:09:10,13485.0,8,3694,-8,13480.0,20,13485.0,7,S
2018-04-24 22:09:11,13485.0,2,3696,0,13480.0,20,13485.0,6,S
2018-04-24 22:09:12,13485.0,12,3708,-2,13480.0,20,13490.0,10,S
2018-04-24 22:09:13,13490.0,8,3716,-2,13485.0,7,13490.0,1,B
2018-04-24 22:09:13,13490.0,2,3718,0,13490.0,1,13495.0,18,B
2018-04-24 22:09:18,13495.0,2,3720,0,13490.0,3,13495.0,15,B
2018-04-24 22:09:18,13495.0,6,3726,4,13490.0,10,13495.0,6,B
2018-04-24 22:09:19,13495.0,12,3738,6,13490.0,10,13500.0,7,B
2018-04-24 22:09:42,13500.0,2,3740,0,13495.0,1,13500.0,11,B
2018-04-24 22:09:47,13500.0,4,3744,2,13495.0,9,13505.0,13,B
2018-04-24 22:10:05,13495.0,8,3752,-4,13490.0,9,13495.0,6,S
2018-04-24 22:10:06,13490.0,2,3754,0,13485.0,10,13495.0,10,S
2018-04-24 22:10:54,13490.0,2,3756,0,13485.0,10,13490.0,8,S
2018-04-24 22:10:55,13490.0,12,3768,-2,13485.0,14,13495.0,28,S
2018-04-24 22:11:12,13490.0,2,3770,-2,13485.0,17,13495.0,11,S
2018-04-24 22:11:24,13490.0,10,3780,4,13485.0,20,13495.0,9,S
2018-04-24 22:11:47,13495.0,12,3792,-10,13490.0,6,13500.0,13,B
2018-04-24 22:12:12,13490.0,14,3806,0,13485.0,23,13495.0,11,S
2018-04-24 22:12:25,13495.0,2,3808,0,13485.0,23,13495.0,15,B
2018-04-24 22:12:35,13490.0,20,3828,-20,13485.0,24,13495.0,16,S
2018-04-24 22:12:43,13495.0,2,3830,0,13485.0,24,13495.0,15,B
2018-04-24 22:12:47,13490.0,2,3832,0,13485.0,25,13495.0,15,S
2018-04-24 22:12:55,13490.0,14,3846,-2,13490.0,3,13495.0,17,S
2018-04-24 22:12:55,13490.0,6,3852,-2,13485.0,22,13490.0,1,S
2018-04-24 22:13:11,13485.0,6,3858,-6,13485.0,7,13490.0,15,S
2018-04-24 22:13:17,13485.0,2,3860,0,13485.0,6,13490.0,12,S
2018-04-24 22:13:19,13485.0,2,3862,0,13485.0,5,13490.0,15,S
2018-04-24 22:13:19,13485.0,2,3864,0,13485.0,4,13490.0,15,S
2018-04-24 22:13:21,13485.0,2,3866,0,13485.0,3,13490.0,15,S
2018-04-24 22:13:33,13485.0,6,3872,-6,13480.0,44,13490.0,11,S
2018-04-24 22:13:50,13495.0,36,3908,-22,13495.0,32,13500.0,19,B
2018-04-24 22:13:50,13495.0,10,3918,-2,13495.0,27,13500.0,11,B
2018-04-24 22:13:51,13495.0,2,3920,0,13495.0,26,13500.0,13,B
2018-04-24 22:14:03,13495.0,12,3932,0,13495.0,20,13500.0,13,B
2018-04-24 22:14:04,13495.0,2,3934,0,13495.0,21,13500.0,12,B
2018-04-24 22:14:16,13500.0,2,3936,0,13495.0,21,13500.0,11,B
2018-04-24 22:14:38,13495.0,20,3956,-20,13495.0,14,13500.0,11,S
2018-04-24 22:14:49,13500.0,20,3976,18,13500.0,2,13505.0,21,B
2018-04-24 22:14:55,13500.0,2,3978,0,13500.0,4,13505.0,5,B
2018-04-24 22:14:58,13505.0,4,3982,0,13500.0,3,13505.0,4,B
2018-04-24 22:15:07,13500.0,2,3984,0,13495.0,21,13505.0,5,S
2018-04-24 22:15:13,13500.0,2,3986,2,13495.0,40,13505.0,5,S
2018-04-24 22:15:38,13500.0,2,3988,2,13495.0,28,13500.0,1,S
2018-04-24 22:15:39,13500.0,2,3990,0,13495.0,28,13505.0,7,S
2018-04-24 22:15:57,13500.0,2,3992,0,13495.0,10,13500.0,7,S
2018-04-24 22:15:58,13495.0,18,4010,-18,13495.0,3,13500.0,7,S
2018-04-24 22:15:59,13495.0,6,4016,0,13490.0,8,13500.0,10,S
2018-04-24 22:16:49,13490.0,4,4020,0,13485.0,35,13495.0,6,S
2018-04-24 22:17:02,13485.0,24,4044,-18,13480.0,31,13485.0,1,S
2018-04-24 22:17:02,13480.0,12,4056,4,13480.0,21,13485.0,18,S
2018-04-24 22:17:03,13480.0,42,4098,0,13475.0,8,13480.0,1,S
2018-04-24 22:17:03,13475.0,2,4100,2,13475.0,4,13480.0,16,S
2018-04-24 22:17:05,13475.0,8,4108,4,13470.0,14,13480.0,19,S
2018-04-24 22:17:06,13475.0,2,4110,-2,13470.0,18,13475.0,1,S
2018-04-24 22:17:07,13475.0,2,4112,-2,13470.0,18,13480.0,19,S
2018-04-24 22:17:08,13475.0,8,4120,0,13470.0,14,13480.0,19,S
2018-04-24 22:17:11,13475.0,2,4122,-2,13475.0,12,13480.0,8,S
2018-04-24 22:17:17,13480.0,16,4138,2,13475.0,14,13485.0,12,B
2018-04-24 22:17:28,13485.0,14,4152,-4,13480.0,18,13490.0,4,B
2018-04-24 22:17:32,13490.0,2,4154,0,13480.0,17,13490.0,18,B
2018-04-24 22:17:36,13485.0,2,4156,2,13480.0,17,13490.0,18,S
2018-04-24 22:17:51,13480.0,2,4158,-2,13480.0,3,13485.0,10,S
2018-04-24 22:17:52,13480.0,2,4160,-2,13480.0,2,13485.0,10,S
2018-04-24 22:17:53,13480.0,4,4164,-2,13475.0,11,13485.0,10,S
2018-04-24 22:17:54,13475.0,2,4166,0,13475.0,3,13480.0,11,S
2018-04-24 22:18:00,13480.0,14,4180,-4,13480.0,1,13485.0,8,B
2018-04-24 22:18:01,13485.0,10,4190,-6,13480.0,23,13490.0,11,B
2018-04-24 22:18:14,13490.0,2,4192,0,13485.0,22,13495.0,8,B
2018-04-24 22:18:20,13490.0,2,4194,2,13490.0,2,13495.0,17,B
2018-04-24 22:18:21,13490.0,4,4198,0,13485.0,23,13495.0,17,B
2018-04-24 22:18:23,13485.0,4,4202,4,13485.0,4,13490.0,17,S
2018-04-24 22:18:46,13490.0,2,4204,-2,13485.0,14,13490.0,9,B
2018-04-24 22:18:46,13490.0,24,4228,22,13490.0,2,13495.0,8,B
2018-04-24 22:19:03,13495.0,10,4238,-6,13490.0,10,13500.0,8,B
2018-04-24 22:19:04,13495.0,4,4242,4,13490.0,12,13500.0,15,B
2018-04-24 22:19:05,13495.0,2,4244,0,13490.0,12,13495.0,4,B
2018-04-24 22:19:06,13495.0,2,4246,-2,13490.0,12,13500.0,14,B
2018-04-24 22:19:12,13500.0,4,4250,0,13490.0,15,13500.0,17,B
2018-04-24 22:19:34,13490.0,12,4262,-4,13490.0,1,13495.0,8,S
2018-04-24 22:19:35,13490.0,2,4264,2,13485.0,16,13490.0,1,S
2018-04-24 22:19:42,13490.0,2,4266,0,13485.0,16,13495.0,10,S
2018-04-24 22:19:56,13490.0,2,4268,2,13485.0,18,13490.0,1,S
2018-04-24 22:19:57,13490.0,2,4270,-2,13485.0,18,13495.0,12,S
2018-04-24 22:20:12,13490.0,2,4272,2,13485.0,18,13495.0,14,S
2018-04-24 22:20:44,13495.0,2,4274,2,13490.0,12,13495.0,1,B
2018-04-24 22:21:01,13495.0,2,4276,2,13490.0,13,13500.0,21,B
2018-04-24 22:21:25,13500.0,10,4286,0,13495.0,19,13500.0,14,B
2018-04-24 22:21:25,13500.0,16,4302,4,13495.0,19,13500.0,5,B
2018-04-24 22:21:26,13500.0,10,4312,0,13495.0,19,13505.0,7,B
2018-04-24 22:21:42,13500.0,2,4314,0,13495.0,20,13500.0,3,B
2018-04-24 22:22:00,13500.0,6,4320,-2,13495.0,20,13505.0,12,B
2018-04-24 22:22:03,13505.0,12,4332,8,13505.0,4,13510.0,14,B
2018-04-24 22:22:04,13505.0,8,4340,6,13500.0,15,13505.0,1,B
2018-04-24 22:22:04,13505.0,2,4342,0,13500.0,17,13510.0,16,B
2018-04-24 22:22:06,13505.0,2,4344,-2,13500.0,16,13505.0,2,B
2018-04-24 22:22:07,13505.0,4,4348,-4,13500.0,16,13510.0,16,B
2018-04-24 22:22:20,13510.0,2,4350,0,13500.0,13,13510.0,22,B
2018-04-24 22:22:25,13500.0,4,4354,0,13500.0,3,13505.0,13,S
2018-04-24 22:22:25,13500.0,4,4358,-2,13500.0,1,13505.0,16,S
2018-04-24 22:22:39,13500.0,2,4360,2,13495.0,15,13505.0,17,S
2018-04-24 22:22:48,13505.0,2,4362,0,13495.0,21,13505.0,20,B
2018-04-24 22:23:04,13495.0,4,4366,0,13490.0,10,13500.0,15,S
2018-04-24 22:23:18,13500.0,2,4368,-2,13495.0,12,13505.0,14,B
2018-04-24 22:23:38,13500.0,6,4374,0,13495.0,15,13500.0,7,B
2018-04-24 22:24:45,13495.0,22,4396,-4,13490.0,15,13500.0,12,S
2018-04-24 22:24:51,13490.0,2,4398,-2,13490.0,8,13495.0,5,S
2018-04-24 22:25:34,13495.0,10,4408,2,13495.0,1,13500.0,20,B
2018-04-24 22:25:35,13500.0,4,4412,4,13495.0,11,13500.0,5,B
2018-04-24 22:25:36,13500.0,2,4414,2,13495.0,11,13500.0,4,B
2018-04-24 22:25:52,13500.0,8,4422,6,13500.0,16,13505.0,17,B
2018-04-24 22:26:02,13505.0,2,4424,2,13500.0,24,13505.0,8,B
2018-04-24 22:26:02,13505.0,4,4428,0,13500.0,24,13505.0,6,B
2018-04-24 22:26:08,13500.0,8,4436,0,13500.0,12,13505.0,16,S
2018-04-24 22:26:09,13500.0,24,4460,24,13495.0,13,13500.0,2,S
2018-04-24 22:26:20,13500.0,12,4472,12,13495.0,13,13505.0,19,S
2018-04-24 22:26:38,13500.0,2,4474,0,13500.0,6,13505.0,11,S
2018-04-24 22:26:45,13500.0,6,4480,-6,13495.0,13,13505.0,18,S
2018-04-24 22:26:47,13495.0,14,4494,-12,13495.0,2,13500.0,3,S
2018-04-24 22:27:24,13500.0,2,4496,0,13500.0,5,13505.0,11,B
2018-04-24 22:27:33,13500.0,2,4498,-2,13495.0,22,13505.0,12,B
2018-04-24 22:28:19,13500.0,10,4508,0,13500.0,6,13505.0,22,B
2018-04-24 22:28:19,13500.0,8,4516,4,13500.0,2,13505.0,22,B
2018-04-24 22:28:20,13500.0,4,4520,2,13495.0,10,13505.0,22,B
2018-04-24 22:28:40,13495.0,2,4522,0,13495.0,8,13505.0,23,S
2018-04-24 22:28:56,13495.0,2,4524,0,13495.0,4,13500.0,4,S
2018-04-24 22:29:03,13495.0,2,4526,0,13495.0,2,13500.0,6,S
2018-04-24 22:29:06,13495.0,4,4530,2,13495.0,1,13500.0,6,S
2018-04-24 22:29:55,13495.0,8,4538,0,13490.0,14,13500.0,19,S
2018-04-24 22:30:27,13500.0,8,4546,6,13495.0,15,13505.0,13,B
2018-04-24 22:30:41,13500.0,2,4548,2,13495.0,15,13500.0,2,B
2018-04-24 22:31:12,13505.0,20,4568,6,13495.0,15,13505.0,9,B
2018-04-24 22:31:21,13505.0,4,4572,-4,13500.0,19,13510.0,25,B
2018-04-24 22:31:28,13510.0,24,4596,4,13505.0,11,13510.0,3,B
2018-04-24 22:31:28,13510.0,6,4602,0,13510.0,3,13515.0,17,B
2018-04-24 22:31:29,13510.0,2,4604,2,13510.0,2,13515.0,22,B
2018-04-24 22:31:33,13510.0,8,4612,0,13505.0,7,13515.0,19,B
2018-04-24 22:31:37,13510.0,2,4614,0,13505.0,21,13510.0,2,B
2018-04-24 22:31:37,13510.0,4,4618,2,13510.0,3,13515.0,11,B
2018-04-24 22:31:39,13510.0,4,4622,-4,13505.0,9,13515.0,18,B
2018-04-24 22:31:46,13510.0,2,4624,0,13505.0,9,13510.0,5,B
2018-04-24 22:32:04,13505.0,2,4626,2,13505.0,8,13510.0,7,S
2018-04-24 22:32:24,13505.0,8,4634,-6,13500.0,42,13505.0,1,S
2018-04-24 22:32:25,13505.0,2,4636,-2,13500.0,41,13510.0,2,S
2018-04-24 22:32:42,13505.0,10,4646,-10,13500.0,20,13505.0,12,S
2018-04-24 22:33:00,13500.0,2,4648,0,13500.0,8,13505.0,10,S
2018-04-24 22:33:06,13505.0,2,4650,2,13500.0,8,13505.0,9,B
2018-04-24 22:33:38,13505.0,10,4660,10,13500.0,9,13505.0,4,B
2018-04-24 22:33:42,13500.0,2,4662,0,13500.0,7,13505.0,15,S
2018-04-24 22:33:42,13500.0,14,4676,-2,13495.0,8,13505.0,16,S
2018-04-24 22:34:24,13495.0,4,4680,4,13490.0,5,13500.0,17,S
2018-04-24 22:34:36,13490.0,2,4682,-2,13490.0,5,13495.0,4,S
2018-04-24 22:34:51,13490.0,8,4690,8,13490.0,9,13495.0,9,S
2018-04-24 22:34:55,13490.0,2,4692,-2,13490.0,10,13495.0,4,S
2018-04-24 22:35:12,13490.0,2,4694,0,13490.0,18,13495.0,4,S
2018-04-24 22:35:41,13490.0,28,4722,-4,13485.0,15,13490.0,1,S
2018-04-24 22:35:58,13490.0,2,4724,-2,13485.0,15,13495.0,24,S
2018-04-24 22:36:14,13490.0,2,4726,0,13490.0,19,13495.0,23,S
2018-04-24 22:36:36,13490.0,2,4728,2,13490.0,23,13495.0,21,S
2018-04-24 22:36:40,13490.0,16,4744,6,13490.0,13,13495.0,20,S
2018-04-24 22:36:41,13490.0,20,4764,16,13490.0,3,13495.0,23,S
2018-04-24 22:36:41,13490.0,6,4770,-6,13485.0,15,13495.0,23,S
2018-04-24 22:36:42,13490.0,2,4772,0,13485.0,15,13490.0,1,S
2018-04-24 22:36:44,13490.0,2,4774,0,13490.0,4,13495.0,22,S
2018-04-24 22:37:40,13490.0,2,4776,0,13490.0,11,13495.0,20,S
2018-04-24 22:37:40,13490.0,8,4784,-4,13490.0,7,13495.0,20,S
2018-04-24 22:37:46,13490.0,2,4786,2,13490.0,6,13495.0,20,S
2018-04-24 22:37:53,13490.0,2,4788,0,13490.0,5,13495.0,17,S
2018-04-24 22:38:36,13490.0,2,4790,-2,13490.0,6,13495.0,17,S
2018-04-24 22:38:48,13490.0,12,4802,8,13485.0,18,13490.0,49,S
2018-04-24 22:39:00,13485.0,2,4804,0,13485.0,16,13490.0,50,S
2018-04-24 22:39:19,13485.0,2,4806,-2,13485.0,15,13490.0,50,S
2018-04-24 22:39:26,13485.0,2,4808,0,13485.0,15,13490.0,2,S
2018-04-24 22:39:56,13490.0,2,4810,0,13485.0,12,13490.0,3,B
2018-04-24 22:40:01,13490.0,4,4814,0,13485.0,12,13490.0,1,B
2018-04-24 22:40:15,13485.0,20,4834,2,13485.0,3,13490.0,6,S
2018-04-24 22:40:16,13490.0,12,4846,-4,13480.0,14,13490.0,9,B
2018-04-24 22:40:34,13480.0,48,4894,-30,13475.0,27,13480.0,1,S
2018-04-24 22:40:35,13480.0,2,4896,0,13480.0,5,13485.0,6,S
2018-04-24 22:40:35,13480.0,2,4898,-2,13480.0,4,13485.0,4,S
2018-04-24 22:40:53,13480.0,4,4902,-4,13480.0,1,13485.0,12,S
2018-04-24 22:40:53,13480.0,2,4904,-2,13475.0,16,13480.0,13,S
2018-04-24 22:40:54,13480.0,6,4910,0,13475.0,16,13480.0,4,S
2018-04-24 22:40:58,13475.0,30,4940,0,13470.0,19,13475.0,1,S
2018-04-24 22:40:59,13475.0,2,4942,2,13470.0,6,13475.0,4,S
2018-04-24 22:41:00,13475.0,4,4946,0,13475.0,3,13480.0,13,S
2018-04-24 22:41:07,13475.0,4,4950,-4,13470.0,10,13480.0,11,S
2018-04-24 22:41:10,13480.0,8,4958,6,13480.0,3,13485.0,8,B
2018-04-24 22:41:22,13485.0,8,4966,0,13485.0,6,13490.0,6,B
2018-04-24 22:41:35,13485.0,2,4968,0,13485.0,5,13490.0,15,B
2018-04-24 22:41:36,13485.0,4,4972,-2,13485.0,3,13490.0,15,B
2018-04-24 22:41:36,13485.0,6,4978,0,13480.0,12,13490.0,15,B
2018-04-24 22:41:38,13485.0,2,4980,-2,13480.0,12,13490.0,17,B
2018-04-24 22:41:53,13490.0,6,4986,2,13490.0,7,13495.0,10,B
2018-04-24 22:41:53,13490.0,14,5000,8,13485.0,5,13495.0,18,B
2018-04-24 22:42:09,13490.0,2,5002,0,13485.0,12,13495.0,20,B
2018-04-24 22:42:17,13490.0,2,5004,0,13485.0,4,13490.0,8,B
2018-04-24 22:42:21,13490.0,16,5020,10,13490.0,8,13495.0,18,B
2018-04-24 22:42:22,13490.0,2,5022,2,13490.0,11,13495.0,19,B
2018-04-24 22:42:26,13490.0,4,5026,0,13490.0,9,13495.0,8,B
2018-04-24 22:42:44,13495.0,10,5036,6,13490.0,4,13495.0,10,B
2018-04-24 22:42:54,13500.0,24,5060,6,13490.0,4,13500.0,30,B
2018-04-24 22:43:28,13490.0,2,5062,0,13490.0,9,13500.0,42,S
2018-04-24 22:43:35,13500.0,4,5066,4,13490.0,9,13500.0,40,B
2018-04-24 22:43:45,13500.0,4,5070,0,13495.0,9,13500.0,22,B
2018-04-24 22:43:46,13500.0,44,5114,18,13500.0,6,13505.0,16,B
2018-04-24 22:43:57,13500.0,2,5116,0,13500.0,3,13505.0,13,B
2018-04-24 22:44:03,13505.0,22,5138,16,13500.0,28,13510.0,54,B
2018-04-24 22:44:06,13510.0,6,5144,0,13505.0,17,13510.0,45,B
2018-04-24 22:44:06,13510.0,90,5234,48,13510.0,2,13515.0,17,B
2018-04-24 22:44:07,13510.0,2,5236,0,13510.0,9,13515.0,13,B
2018-04-24 22:44:10,13510.0,2,5238,-2,13510.0,3,13515.0,16,B
2018-04-24 22:44:10,13510.0,6,5244,0,13505.0,18,13515.0,19,B
2018-04-24 22:44:24,13510.0,6,5250,0,13505.0,17,13515.0,28,B
2018-04-24 22:44:26,13515.0,10,5260,0,13510.0,18,13515.0,11,B
2018-04-24 22:44:31,13515.0,4,5264,4,13510.0,17,13515.0,8,B
2018-04-24 22:44:49,13515.0,2,5266,0,13510.0,3,13515.0,10,B
2018-04-24 22:44:56,13510.0,2,5268,-2,13505.0,21,13515.0,13,S
2018-04-24 22:45:04,13510.0,2,5270,-2,13510.0,7,13515.0,6,S
2018-04-24 22:45:08,13510.0,2,5272,0,13510.0,1,13515.0,16,S
2018-04-24 22:45:08,13510.0,2,5274,0,13505.0,15,13515.0,16,S
2018-04-24 22:45:12,13510.0,2,5276,-2,13510.0,1,13515.0,12,S
2018-04-24 22:45:33,13510.0,6,5282,0,13505.0,15,13510.0,2,S
2018-04-24 22:45:53,13510.0,4,5286,4,13505.0,21,13510.0,8,S
2018-04-24 22:45:54,13510.0,12,5298,6,13505.0,27,13510.0,2,S
2018-04-24 22:45:55,13510.0,4,5302,0,13505.0,15,13515.0,29,S
2018-04-24 22:45:57,13510.0,2,5304,-2,13510.0,6,13515.0,28,S
2018-04-24 22:45:59,13510.0,12,5316,0,13505.0,15,13515.0,35,S
2018-04-24 22:46:05,13510.0,8,5324,2,13510.0,21,13515.0,36,S
2018-04-24 22:46:10,13510.0,2,5326,2,13510.0,20,13515.0,34,S
2018-04-24 22:46:37,13510.0,8,5334,0,13510.0,16,13515.0,34,S
2018-04-24 22:47:33,13510.0,26,5360,10,13510.0,6,13515.0,31,S
2018-04-24 22:47:33,13510.0,12,5372,6,13505.0,9,13510.0,7,S
2018-04-24 22:48:03,13510.0,8,5380,-6,13510.0,2,13515.0,33,S
2018-04-24 22:48:04,13510.0,2,5382,0,13510.0,1,13515.0,34,S
2018-04-24 22:48:20,13510.0,2,5384,0,13510.0,1,13515.0,31,S
2018-04-24 22:48:24,13510.0,2,5386,0,13505.0,31,13510.0,1,S
2018-04-24 22:49:19,13510.0,2,5388,0,13505.0,19,13510.0,2,S
2018-04-24 22:49:23,13505.0,30,5418,-16,13505.0,1,13510.0,2,S
2018-04-24 22:49:30,13510.0,4,5422,0,13510.0,8,13515.0,28,B
2018-04-24 22:49:45,13515.0,6,5428,-4,13510.0,5,13515.0,23,B
2018-04-24 22:50:09,13515.0,2,5430,2,13510.0,9,13515.0,22,B
2018-04-24 22:50:25,13510.0,4,5434,-2,13510.0,3,13515.0,27,S
2018-04-24 22:50:25,13510.0,6,5440,-2,13505.0,13,13515.0,33,S
2018-04-24 22:51:44,13505.0,4,5444,-2,13500.0,11,13505.0,1,S
2018-04-24 22:52:04,13505.0,2,5446,0,13505.0,17,13510.0,13,S
2018-04-24 22:52:46,13510.0,2,5448,0,13505.0,5,13510.0,8,B
2018-04-24 22:53:03,13510.0,4,5452,4,13505.0,5,13510.0,8,B
2018-04-24 22:53:07,13510.0,12,5464,-10,13505.0,5,13510.0,2,B
2018-04-24 22:53:07,13510.0,2,5466,-2,13505.0,5,13510.0,1,B
2018-04-24 22:53:39,13510.0,12,5478,-12,13510.0,1,13515.0,24,B
2018-04-24 22:53:43,13510.0,4,5482,-2,13510.0,5,13515.0,19,B
2018-04-24 22:54:13,13510.0,10,5492,-6,13505.0,16,13515.0,19,B
2018-04-24 22:54:22,13510.0,2,5494,-2,13505.0,17,13515.0,24,B
2018-04-24 22:54:23,13515.0,2,5496,-2,13505.0,29,13515.0,23,B
2018-04-24 22:54:30,13515.0,40,5536,-18,13505.0,29,13515.0,3,B
2018-04-24 22:54:31,13515.0,2,5538,2,13510.0,3,13515.0,3,B
2018-04-24 22:54:32,13515.0,2,5540,-2,13510.0,10,13515.0,1,B
2018-04-24 22:54:33,13515.0,2,5542,-2,13510.0,10,13520.0,24,B
2018-04-24 22:54:34,13520.0,6,5548,0,13510.0,15,13520.0,20,B
2018-04-24 22:54:41,13520.0,4,5552,4,13510.0,27,13515.0,7,B
2018-04-24 22:54:41,13515.0,2,5554,0,13510.0,27,13515.0,6,S
2018-04-24 22:54:47,13515.0,2,5556,0,13510.0,16,13515.0,7,S
2018-04-24 22:54:57,13515.0,2,5558,2,13510.0,16,13515.0,4,S
2018-04-24 22:54:58,13510.0,20,5578,-10,13510.0,6,13515.0,5,S
2018-04-24 22:55:45,13510.0,4,5582,-4,13510.0,5,13515.0,5,S
2018-04-24 22:56:42,13515.0,4,5586,0,13510.0,7,13515.0,12,B
2018-04-24 22:56:43,13515.0,4,5590,4,13510.0,7,13515.0,10,B
2018-04-24 22:56:45,13515.0,6,5596,-4,13515.0,3,13520.0,17,B
2018-04-24 22:57:11,13520.0,28,5624,16,13515.0,6,13520.0,6,B
2018-04-24 22:57:11,13520.0,4,5628,2,13520.0,1,13525.0,5,B
2018-04-24 22:57:12,13520.0,4,5632,-2,13515.0,3,13520.0,5,B
2018-04-24 22:57:18,13515.0,2,5634,0,13515.0,2,13520.0,5,S
2018-04-24 22:57:37,13520.0,6,5640,-4,13515.0,2,13520.0,3,B
2018-04-24 22:57:57,13515.0,2,5642,0,13510.0,8,13520.0,5,S
2018-04-24 22:58:00,13510.0,26,5668,-16,13510.0,13,13520.0,7,S
2018-04-24 22:58:15,13515.0,2,5670,0,13515.0,9,13520.0,17,B
2018-04-24 22:58:15,13515.0,8,5678,0,13515.0,5,13520.0,17,B
2018-04-24 22:58:16,13515.0,10,5688,0,13510.0,2,13520.0,17,B
2018-04-24 22:58:27,13515.0,2,5690,2,13510.0,2,13515.0,2,B
2018-04-24 22:59:00,13515.0,2,5692,-2,13510.0,3,13515.0,1,B
2018-04-24 22:59:00,13510.0,2,5694,0,13510.0,4,13515.0,1,S
2018-04-24 22:59:01,13510.0,6,5700,0,13510.0,1,13515.0,3,S
2018-04-24 22:59:06,13510.0,2,5702,0,13505.0,17,13515.0,3,S
2018-04-24 22:59:09,13510.0,2,5704,0,13510.0,2,13515.0,2,S
2018-04-24 22:59:13,13510.0,2,5706,-2,13510.0,3,13515.0,2,S
2018-04-24 22:59:15,13515.0,4,5710,0,13510.0,15,13520.0,13,B
2018-04-24 22:59:15,13520.0,2,5712,2,13510.0,15,13520.0,12,B
2018-04-24 22:59:25,13510.0,2,5714,-2,13510.0,14,13515.0,1,S
2018-04-24 22:59:31,13515.0,2,5716,-2,13510.0,6,13520.0,12,B
2018-04-24 22:59:40,13510.0,4,5720,-2,13510.0,6,13520.0,13,S
2018-04-24 22:59:42,13520.0,2,5722,-2,13510.0,6,13520.0,12,B
2018-04-24 22:59:42,13510.0,6,5728,-6,13510.0,3,13520.0,12,S
2018-04-24 22:59:43,13515.0,2,5730,0,13510.0,3,13520.0,12,B
2018-04-24 22:59:43,13520.0,2,5732,-2,13510.0,3,13520.0,11,B
2018-04-24 22:59:44,13520.0,2,5734,0,13510.0,3,13520.0,10,B
2018-04-24 22:59:45,13520.0,2,5736,-2,13510.0,3,13520.0,9,B
2018-04-24 22:59:46,13520.0,2,5738,-2,13510.0,5,13520.0,8,B
2018-04-24 22:59:47,13520.0,2,5740,0,13510.0,6,13520.0,7,B
2018-04-24 22:59:47,13520.0,2,5742,-2,13510.0,6,13520.0,6,B
2018-04-24 22:59:49,13520.0,2,5744,-2,13510.0,6,13520.0,5,B
2018-04-24 22:59:54,13520.0,8,5752,-8,13515.0,2,13520.0,1,B
2018-04-24 22:59:57,13515.0,4,5756,-4,13510.0,3,13520.0,1,S
2018-04-24 22:59:57,13515.0,2,5758,-2,13510.0,3,13520.0,1,S
2018-04-24 22:59:59,13515.0,4,5762,-4,13510.0,3,13520.0,1,S
2018-04-25 09:00:00,13520.0,34,5796,18,13485.0,2,13500.0,1,B
2018-04-25 09:00:02,13490.0,10,5806,0,13485.0,7,13490.0,3,S
2018-04-25 09:00:02,13480.0,22,5828,14,13475.0,18,13490.0,5,S
2018-04-25 09:00:03,13485.0,4,5832,0,13480.0,22,13485.0,2,B
2018-04-25 09:00:04,13480.0,8,5840,0,13480.0,29,13485.0,10,S
2018-04-25 09:00:04,13485.0,20,5860,-20,13480.0,29,13490.0,1,B
2018-04-25 09:00:06,13500.0,18,5878,-2,13490.0,3,13500.0,15,B
2018-04-25 09:00:11,13500.0,2,5880,-2,13495.0,24,13505.0,2,B
2018-04-25 09:00:14,13500.0,2,5882,-2,13500.0,4,13510.0,32,B
2018-04-25 09:00:15,13500.0,6,5888,0,13500.0,4,13505.0,2,B
2018-04-25 09:00:16,13500.0,2,5890,-2,13500.0,3,13505.0,2,B
2018-04-25 09:00:20,13495.0,10,5900,10,13490.0,8,13500.0,3,S
2018-04-25 09:00:23,13495.0,4,5904,-2,13495.0,1,13500.0,5,S
2018-04-25 09:00:24,13495.0,2,5906,-2,13490.0,6,13495.0,4,S
2018-04-25 09:00:28,13490.0,2,5908,-2,13490.0,5,13500.0,6,S
2018-04-25 09:00:30,13495.0,2,5910,0,13490.0,5,13500.0,6,B
2018-04-25 09:00:31,13490.0,4,5914,0,13490.0,4,13500.0,3,S
2018-04-25 09:00:34,13495.0,2,5916,-2,13490.0,24,13500.0,18,B
2018-04-25 09:00:38,13490.0,10,5926,-8,13490.0,25,13500.0,18,S
2018-04-25 09:00:42,13495.0,2,5928,0,13490.0,26,13495.0,1,B
2018-04-25 09:00:44,13490.0,4,5932,4,13490.0,5,13495.0,1,S
2018-04-25 09:00:48,13495.0,2,5934,2,13490.0,5,13500.0,19,B
2018-04-25 09:00:55,13495.0,2,5936,2,13495.0,1,13500.0,19,B
2018-04-25 09:00:59,13490.0,2,5938,0,13490.0,27,13495.0,20,S
2018-04-25 09:01:01,13495.0,34,5972,-20,13490.0,24,13495.0,4,B
2018-04-25 09:01:02,13500.0,60,6032,-34,13495.0,25,13505.0,2,B
2018-04-25 09:01:02,13500.0,2,6034,0,13500.0,1,13505.0,2,B
2018-04-25 09:01:03,13495.0,6,6040,-4,13495.0,10,13500.0,8,S
2018-04-25 09:01:04,13495.0,18,6058,0,13490.0,26,13500.0,6,S
2018-04-25 09:01:07,13495.0,2,6060,2,13490.0,7,13495.0,1,S
2018-04-25 09:01:07,13495.0,2,6062,2,13495.0,3,13500.0,5,S
2018-04-25 09:01:10,13495.0,2,6064,-2,13495.0,2,13500.0,3,S
2018-04-25 09:01:11,13495.0,4,6068,0,13490.0,23,13495.0,2,S
2018-04-25 09:01:17,13495.0,4,6072,4,13490.0,9,13500.0,4,S
2018-04-25 09:01:19,13490.0,14,6086,4,13485.0,16,13490.0,4,S
2018-04-25 09:01:20,13485.0,2,6088,-2,13480.0,20,13490.0,8,S
2018-04-25 09:01:21,13480.0,10,6098,2,13480.0,2,13485.0,7,S
2018-04-25 09:01:22,13485.0,6,6104,4,13480.0,3,13485.0,3,B
2018-04-25 09:01:23,13485.0,6,6110,0,13485.0,2,13490.0,5,B
2018-04-25 09:01:29,13490.0,2,6112,2,13480.0,6,13490.0,3,B
2018-04-25 09:01:31,13490.0,2,6114,2,13480.0,4,13490.0,7,B
2018-04-25 09:01:32,13480.0,6,6120,-6,13480.0,2,13490.0,8,S
2018-04-25 09:01:35,13480.0,2,6122,0,13475.0,19,13485.0,5,S
2018-04-25 09:01:42,13485.0,2,6124,0,13480.0,13,13490.0,2,B
2018-04-25 09:01:50,13480.0,22,6146,-2,13475.0,25,13490.0,9,S
2018-04-25 09:01:51,13480.0,8,6154,0,13475.0,25,13485.0,8,S
2018-04-25 09:01:57,13480.0,10,6164,0,13475.0,26,13480.0,2,S
2018-04-25 09:02:00,13480.0,8,6172,0,13480.0,6,13485.0,2,S
2018-04-25 09:02:02,13480.0,12,6184,0,13475.0,24,13480.0,1,S
2018-04-25 09:02:17,13485.0,2,6186,2,13475.0,21,13485.0,12,B
2018-04-25 09:02:17,13475.0,6,6192,-6,13475.0,18,13485.0,7,S
2018-04-25 09:02:18,13475.0,12,6204,-2,13475.0,18,13485.0,4,S
2018-04-25 09:02:18,13485.0,4,6208,2,13480.0,3,13485.0,2,B
2018-04-25 09:02:19,13485.0,4,6212,4,13480.0,14,13490.0,4,B
2018-04-25 09:02:19,13480.0,6,6218,4,13480.0,12,13490.0,4,S
2018-04-25 09:02:27,13490.0,4,6222,-2,13480.0,13,13490.0,4,B
2018-04-25 09:02:29,13485.0,2,6224,0,13485.0,6,13490.0,3,S
2018-04-25 09:02:34,13490.0,2,6226,-2,13485.0,6,13490.0,2,B
2018-04-25 09:02:35,13490.0,6,6232,-2,13485.0,4,13490.0,1,B
2018-04-25 09:02:36,13490.0,2,6234,-2,13485.0,4,13490.0,2,B
2018-04-25 09:02:37,13490.0,2,6236,-2,13485.0,4,13490.0,4,B
2018-04-25 09:02:38,13490.0,2,6238,-2,13485.0,4,13490.0,4,B
2018-04-25 09:02:40,13485.0,2,6240,2,13485.0,3,13490.0,1,S
2018-04-25 09:02:55,13485.0,6,6246,-2,13485.0,1,13490.0,3,S
2018-04-25 09:02:57,13480.0,12,6258,8,13475.0,32,13480.0,1,S
2018-04-25 09:02:57,13480.0,6,6264,-2,13475.0,17,13480.0,1,S
2018-04-25 09:03:00,13480.0,4,6268,0,13475.0,21,13480.0,1,S
2018-04-25 09:03:06,13480.0,2,6270,0,13475.0,19,13480.0,3,S
2018-04-25 09:03:10,13480.0,2,6272,0,13475.0,19,13480.0,1,S
2018-04-25 09:03:10,13480.0,2,6274,2,13480.0,3,13485.0,9,S
2018-04-25 09:03:14,13485.0,4,6278,2,13480.0,4,13485.0,4,B
2018-04-25 09:03:14,13480.0,16,6294,2,13480.0,3,13485.0,13,S
2018-04-25 09:03:32,13485.0,12,6306,8,13480.0,11,13490.0,12,B
2018-04-25 09:03:37,13480.0,4,6310,0,13480.0,13,13490.0,15,S
2018-04-25 09:03:45,13485.0,2,6312,-2,13485.0,1,13490.0,15,B
2018-04-25 09:03:58,13485.0,2,6314,2,13480.0,10,13485.0,24,B
2018-04-25 09:04:04,13480.0,4,6318,2,13480.0,1,13485.0,16,S
2018-04-25 09:04:04,13480.0,2,6320,0,13475.0,21,13480.0,2,S
2018-04-25 09:04:10,13475.0,32,6352,2,13470.0,9,13475.0,1,S
2018-04-25 09:04:11,13470.0,2,6354,-2,13470.0,5,13475.0,8,S
2018-04-25 09:04:19,13470.0,2,6356,-2,13470.0,5,13475.0,4,S
2018-04-25 09:04:30,13480.0,4,6360,0,13475.0,3,13485.0,7,B
2018-04-25 09:04:31,13475.0,2,6362,-2,13475.0,17,13485.0,5,S
2018-04-25 09:04:37,13480.0,2,6364,0,13475.0,12,13480.0,1,B
2018-04-25 09:04:42,13475.0,2,6366,0,13470.0,26,13475.0,2,S
2018-04-25 09:04:49,13470.0,10,6376,-6,13470.0,18,13475.0,3,S
2018-04-25 09:04:49,13475.0,2,6378,0,13475.0,1,13480.0,6,B
2018-04-25 09:04:59,13470.0,2,6380,-2,13470.0,12,13480.0,6,S
2018-04-25 09:05:04,13480.0,2,6382,0,13475.0,2,13480.0,6,B
2018-04-25 09:05:07,13480.0,10,6392,0,13475.0,19,13485.0,5,B
2018-04-25 09:05:26,13485.0,6,6398,6,13485.0,1,13490.0,6,B
2018-04-25 09:05:31,13485.0,2,6400,2,13480.0,19,13490.0,8,B
2018-04-25 09:05:43,13485.0,6,6406,-2,13480.0,7,13485.0,2,B
2018-04-25 09:05:52,13485.0,2,6408,0,13480.0,27,13490.0,12,B
2018-04-25 09:06:15,13490.0,2,6410,2,13485.0,13,13490.0,8,B
2018-04-25 09:06:17,13490.0,2,6412,0,13485.0,13,13490.0,5,B
2018-04-25 09:06:23,13485.0,16,6428,2,13485.0,2,13490.0,19,S
2018-04-25 09:06:24,13485.0,4,6432,0,13480.0,13,13485.0,2,S
2018-04-25 09:07:16,13485.0,2,6434,0,13480.0,14,13485.0,1,S
2018-04-25 09:07:23,13485.0,6,6440,6,13480.0,34,13490.0,18,S
2018-04-25 09:07:24,13485.0,2,6442,0,13480.0,36,13485.0,5,S
2018-04-25 09:07:24,13485.0,10,6452,4,13480.0,36,13490.0,9,S
2018-04-25 09:07:27,13485.0,2,6454,-2,13480.0,22,13485.0,2,S
2018-04-25 09:07:52,13480.0,4,6458,0,13480.0,20,13490.0,25,S
2018-04-25 09:08:19,13485.0,2,6460,0,13485.0,4,13490.0,17,B
2018-04-25 09:08:27,13490.0,4,6464,0,13485.0,4,13490.0,16,B
2018-04-25 09:08:31,13490.0,20,6484,-6,13485.0,13,13495.0,11,B
2018-04-25 09:08:33,13485.0,4,6488,-2,13485.0,28,13495.0,9,S
2018-04-25 09:09:15,13490.0,2,6490,0,13485.0,16,13495.0,18,B
2018-04-25 09:09:34,13490.0,2,6492,0,13485.0,14,13490.0,5,B
2018-04-25 09:09:44,13490.0,4,6496,0,13485.0,16,13495.0,14,B
2018-04-25 09:09:50,13490.0,2,6498,0,13485.0,22,13490.0,1,B
2018-04-25 09:10:04,13485.0,10,6508,8,13485.0,9,13490.0,3,S
2018-04-25 09:10:05,13485.0,18,6526,18,13480.0,20,13490.0,20,S
2018-04-25 09:10:12,13490.0,12,6538,-6,13485.0,15,13490.0,8,B
2018-04-25 09:10:13,13490.0,16,6554,12,13490.0,4,13495.0,14,B
2018-04-25 09:10:14,13490.0,4,6558,0,13490.0,1,13495.0,17,B
2018-04-25 09:10:15,13490.0,16,6574,10,13485.0,8,13495.0,20,B
2018-04-25 09:10:47,13485.0,2,6576,2,13485.0,5,13490.0,2,S
2018-04-25 09:11:14,13485.0,2,6578,2,13485.0,3,13490.0,5,S
2018-04-25 09:11:19,13485.0,4,6582,0,13480.0,21,13485.0,1,S
2018-04-25 09:11:38,13490.0,2,6584,2,13485.0,3,13490.0,8,B
2018-04-25 09:11:39,13485.0,4,6588,2,13485.0,3,13490.0,7,S
2018-04-25 09:11:39,13490.0,2,6590,2,13485.0,3,13490.0,6,B
2018-04-25 09:11:40,13490.0,2,6592,2,13485.0,3,13490.0,5,B
2018-04-25 09:11:40,13485.0,2,6594,-2,13485.0,2,13490.0,5,S
2018-04-25 09:11:43,13490.0,14,6608,-10,13485.0,1,13495.0,17,B
2018-04-25 09:11:44,13490.0,4,6612,0,13490.0,4,13495.0,11,B
2018-04-25 09:11:59,13490.0,2,6614,0,13485.0,9,13490.0,3,B
2018-04-25 09:12:00,13490.0,4,6618,0,13485.0,9,13490.0,1,B
2018-04-25 09:12:01,13490.0,2,6620,0,13485.0,9,13490.0,1,B
2018-04-25 09:12:03,13490.0,4,6624,0,13485.0,6,13495.0,19,B
2018-04-25 09:12:03,13490.0,2,6626,2,13490.0,1,13495.0,19,B
2018-04-25 09:12:04,13490.0,4,6630,2,13485.0,6,13490.0,1,B
2018-04-25 09:12:08,13490.0,2,6632,2,13485.0,6,13490.0,2,B
2018-04-25 09:12:15,13485.0,10,6642,-10,13480.0,16,13490.0,9,S
2018-04-25 09:12:16,13490.0,4,6646,0,13480.0,16,13490.0,12,B
2018-04-25 09:12:53,13490.0,2,6648,2,13480.0,17,13490.0,14,B
2018-04-25 09:12:55,13490.0,2,6650,0,13480.0,17,13490.0,13,B
2018-04-25 09:12:55,13490.0,4,6654,0,13480.0,17,13490.0,15,B
2018-04-25 09:12:56,13490.0,2,6656,2,13480.0,17,13490.0,14,B
2018-04-25 09:13:05,13490.0,4,6660,4,13485.0,1,13490.0,12,B
2018-04-25 09:13:06,13490.0,4,6664,0,13485.0,1,13490.0,10,B
2018-04-25 09:13:06,13490.0,6,6670,2,13485.0,1,13490.0,7,B
2018-04-25 09:13:08,13485.0,2,6672,-2,13480.0,14,13490.0,23,S
2018-04-25 09:13:37,13490.0,4,6676,0,13485.0,5,13490.0,8,B
2018-04-25 09:13:37,13490.0,4,6680,0,13485.0,5,13490.0,6,B
2018-04-25 09:13:38,13490.0,2,6682,0,13485.0,5,13490.0,5,B
2018-04-25 09:14:03,13485.0,4,6686,0,13485.0,3,13490.0,5,S
2018-04-25 09:14:09,13485.0,2,6688,-2,13485.0,2,13490.0,5,S
2018-04-25 09:14:21,13485.0,4,6692,-4,13480.0,17,13490.0,9,S
2018-04-25 09:14:24,13485.0,4,6696,4,13480.0,17,13490.0,13,S
2018-04-25 09:14:25,13490.0,4,6700,0,13480.0,16,13490.0,16,B
2018-04-25 09:14:31,13480.0,4,6704,0,13480.0,9,13485.0,14,S
2018-04-25 09:14:31,13485.0,4,6708,4,13480.0,9,13485.0,15,B
2018-04-25 09:14:32,13485.0,4,6712,0,13480.0,9,13485.0,18,B
2018-04-25 09:14:33,13485.0,4,6716,2,13480.0,9,13485.0,16,B
2018-04-25 09:14:35,13485.0,4,6720,4,13480.0,9,13485.0,14,B
2018-04-25 09:14:36,13485.0,4,6724,2,13480.0,9,13485.0,12,B
2018-04-25 09:14:36,13480.0,18,6742,14,13475.0,7,13480.0,2,S
2018-04-25 09:14:37,13475.0,8,6750,4,13470.0,4,13475.0,3,S
2018-04-25 09:14:38,13475.0,6,6756,4,13465.0,9,13475.0,10,S
2018-04-25 09:14:39,13475.0,2,6758,2,13465.0,9,13470.0,1,S
2018-04-25 09:14:39,13470.0,26,6784,6,13465.0,6,13475.0,16,S
2018-04-25 09:14:40,13470.0,4,6788,2,13465.0,6,13475.0,28,S
2018-04-25 09:14:41,13470.0,2,6790,2,13465.0,6,13470.0,2,S
2018-04-25 09:14:41,13470.0,12,6802,-8,13465.0,1,13470.0,4,S
2018-04-25 09:14:42,13470.0,4,6806,0,13460.0,16,13470.0,8,S
2018-04-25 09:14:43,13470.0,2,6808,2,13460.0,24,13470.0,4,S
2018-04-25 09:14:44,13460.0,2,6810,0,13460.0,23,13470.0,4,S
2018-04-25 09:14:48,13460.0,36,6846,8,13455.0,2,13465.0,3,S
2018-04-25 09:14:48,13460.0,2,6848,-2,13460.0,1,13465.0,6,S
2018-04-25 09:14:49,13460.0,2,6850,-2,13455.0,9,13465.0,8,S
2018-04-25 09:14:49,13455.0,2,6852,0,13455.0,6,13465.0,11,S
2018-04-25 09:14:50,13455.0,12,6864,-2,13450.0,19,13460.0,55,S
2018-04-25 09:14:52,13455.0,2,6866,2,13455.0,1,13460.0,58,S
2018-04-25 09:14:52,13455.0,2,6868,-2,13450.0,23,13460.0,58,S
2018-04-25 09:14:54,13455.0,2,6870,2,13450.0,23,13460.0,58,S
2018-04-25 09:14:59,13455.0,4,6874,0,13450.0,29,13455.0,3,S
2018-04-25 09:14:59,13455.0,2,6876,0,13450.0,23,13460.0,56,S
2018-04-25 09:15:00,13460.0,2,6878,0,13450.0,23,13460.0,56,B
2018-04-25 09:15:02,13450.0,4,6882,4,13450.0,17,13455.0,5,S
2018-04-25 09:15:03,13450.0,10,6892,6,13450.0,23,13460.0,63,S
2018-04-25 09:15:03,13450.0,2,6894,0,13450.0,23,13460.0,60,S
2018-04-25 09:15:04,13450.0,2,6896,2,13450.0,22,13460.0,58,S
2018-04-25 09:15:07,13455.0,2,6898,0,13450.0,16,13455.0,10,B
2018-04-25 09:15:08,13455.0,2,6900,2,13450.0,15,13455.0,9,B
2018-04-25 09:15:08,13455.0,2,6902,0,13450.0,15,13455.0,9,B
2018-04-25 09:15:12,13455.0,18,6920,10,13450.0,20,13460.0,59,B
2018-04-25 09:15:15,13455.0,2,6922,-2,13450.0,20,13460.0,61,B
2018-04-25 09:15:16,13450.0,4,6926,2,13450.0,16,13455.0,2,S
2018-04-25 09:15:17,13450.0,10,6936,0,13450.0,8,13455.0,8,S
2018-04-25 09:15:17,13450.0,16,6952,4,13445.0,12,13455.0,10,S
2018-04-25 09:15:21,13445.0,22,6974,0,13440.0,2,13450.0,14,S
2018-04-25 09:15:22,13440.0,16,6990,-2,13430.0,27,13440.0,21,S
2018-04-25 09:15:22,13430.0,46,7036,18,13430.0,4,13435.0,6,S
2018-04-25 09:15:23,13430.0,20,7056,0,13425.0,8,13430.0,3,S
2018-04-25 09:15:23,13430.0,14,7070,6,13430.0,2,13435.0,3,S
2018-04-25 09:15:24,13435.0,4,7074,0,13435.0,7,13440.0,7,B
2018-04-25 09:15:27,13435.0,4,7078,0,13430.0,11,13435.0,4,B
2018-04-25 09:15:28,13435.0,16,7094,8,13435.0,1,13440.0,2,B
2018-04-25 09:15:28,13435.0,6,7100,-4,13430.0,13,13440.0,4,B
2018-04-25 09:15:30,13435.0,2,7102,-2,13435.0,5,13440.0,9,B
2018-04-25 09:15:35,13435.0,18,7120,0,13435.0,10,13445.0,5,B
2018-04-25 09:15:36,13440.0,2,7122,-2,13435.0,9,13445.0,8,B
2018-04-25 09:15:41,13435.0,4,7126,-2,13435.0,8,13445.0,10,S
2018-04-25 09:15:43,13440.0,4,7130,4,13435.0,3,13440.0,2,B
2018-04-25 09:15:43,13440.0,2,7132,0,13435.0,3,13440.0,2,B
2018-04-25 09:15:44,13445.0,10,7142,0,13440.0,6,13445.0,8,B
2018-04-25 09:15:46,13445.0,10,7152,-8,13440.0,14,13450.0,6,B
2018-04-25 09:15:48,13445.0,6,7158,2,13440.0,18,13450.0,5,B
2018-04-25 09:15:48,13440.0,32,7190,-32,13435.0,14,13440.0,34,S
2018-04-25 09:15:51,13440.0,2,7192,0,13435.0,15,13440.0,33,S
2018-04-25 09:15:52,13440.0,66,7258,-26,13440.0,2,13445.0,7,S
2018-04-25 09:15:52,13440.0,6,7264,0,13435.0,13,13445.0,5,S
2018-04-25 09:15:58,13445.0,12,7276,-2,13440.0,2,13450.0,18,B
2018-04-25 09:15:58,13445.0,10,7286,-2,13445.0,3,13450.0,7,B
2018-04-25 09:16:00,13445.0,8,7294,-2,13445.0,2,13450.0,14,B
2018-04-25 09:16:00,13445.0,4,7298,-4,13440.0,12,13445.0,1,B
2018-04-25 09:16:01,13445.0,2,7300,-2,13440.0,9,13445.0,2,B
2018-04-25 09:16:11,13445.0,6,7306,0,13440.0,23,13445.0,3,B
2018-04-25 09:16:12,13445.0,12,7318,4,13440.0,21,13450.0,15,B
2018-04-25 09:16:16,13440.0,2,7320,0,13440.0,30,13450.0,9,S
2018-04-25 09:16:24,13450.0,2,7322,0,13445.0,15,13450.0,7,B
2018-04-25 09:16:24,13450.0,4,7326,0,13445.0,6,13450.0,5,B
2018-04-25 09:16:25,13450.0,4,7330,0,13440.0,30,13450.0,8,B
2018-04-25 09:16:26,13450.0,6,7336,2,13440.0,32,13450.0,2,B
2018-04-25 09:16:26,13450.0,6,7342,6,13445.0,2,13450.0,1,B
2018-04-25 09:16:27,13450.0,2,7344,2,13450.0,1,13455.0,6,B
2018-04-25 09:16:27,13450.0,6,7350,4,13445.0,2,13450.0,1,B
2018-04-25 09:16:28,13450.0,6,7356,6,13445.0,2,13455.0,8,B
2018-04-25 09:16:28,13450.0,6,7362,4,13445.0,3,13450.0,1,B
2018-04-25 09:16:29,13450.0,2,7364,2,13450.0,2,13455.0,14,B
2018-04-25 09:16:29,13450.0,6,7370,0,13445.0,3,13450.0,1,B
2018-04-25 09:16:30,13450.0,4,7374,2,13450.0,1,13455.0,14,B
2018-04-25 09:16:30,13450.0,6,7380,0,13445.0,4,13455.0,19,B
2018-04-25 09:16:46,13445.0,2,7382,-2,13445.0,3,13450.0,6,S
2018-04-25 09:16:47,13445.0,2,7384,-2,13445.0,2,13450.0,6,S
2018-04-25 09:16:50,13450.0,2,7386,2,13450.0,1,13455.0,14,B
2018-04-25 09:16:51,13450.0,2,7388,0,13445.0,2,13455.0,14,B
2018-04-25 09:16:52,13450.0,4,7392,4,13445.0,2,13450.0,21,B
2018-04-25 09:16:54,13450.0,4,7396,2,13445.0,3,13450.0,24,B
2018-04-25 09:16:56,13445.0,10,7406,4,13440.0,22,13445.0,9,S
2018-04-25 09:16:57,13445.0,4,7410,4,13440.0,17,13445.0,18,S
2018-04-25 09:16:57,13445.0,8,7418,6,13440.0,17,13445.0,19,S
2018-04-25 09:16:58,13445.0,6,7424,6,13440.0,17,13445.0,16,S
2018-04-25 09:16:59,13445.0,2,7426,2,13440.0,17,13445.0,15,S
2018-04-25 09:17:00,13445.0,10,7436,2,13440.0,17,13445.0,10,S
2018-04-25 09:17:00,13445.0,2,7438,2,13440.0,23,13445.0,7,S
2018-04-25 09:17:01,13445.0,2,7440,0,13440.0,17,13445.0,1,S
2018-04-25 09:17:01,13445.0,2,7442,0,13440.0,17,13445.0,7,S
2018-04-25 09:17:02,13445.0,4,7446,0,13440.0,25,13445.0,5,S
2018-04-25 09:17:02,13445.0,10,7456,2,13440.0,25,13450.0,6,S
2018-04-25 09:17:04,13450.0,8,7464,0,13445.0,17,13455.0,7,B
2018-04-25 09:17:06,13455.0,4,7468,0,13450.0,19,13460.0,7,B
2018-04-25 09:17:10,13455.0,2,7470,2,13450.0,13,13455.0,1,B
2018-04-25 09:17:10,13455.0,2,7472,2,13455.0,1,13460.0,7,B
2018-04-25 09:17:11,13460.0,2,7474,2,13450.0,13,13460.0,6,B
2018-04-25 09:17:13,13455.0,2,7476,-2,13450.0,13,13460.0,6,S
2018-04-25 09:17:17,13455.0,4,7480,4,13450.0,17,13460.0,12,S
2018-04-25 09:17:18,13460.0,20,7500,12,13460.0,3,13465.0,5,B
2018-04-25 09:17:20,13460.0,2,7502,0,13460.0,1,13465.0,2,B
2018-04-25 09:17:26,13460.0,6,7508,4,13455.0,15,13460.0,1,B
2018-04-25 09:17:31,13460.0,2,7510,0,13455.0,4,13460.0,7,B
2018-04-25 09:17:38,13460.0,2,7512,2,13455.0,10,13460.0,6,B
2018-04-25 09:17:39,13460.0,12,7524,-4,13455.0,13,13465.0,4,B
2018-04-25 09:17:40,13460.0,2,7526,-2,13460.0,1,13465.0,4,B
2018-04-25 09:17:49,13460.0,4,7530,0,13455.0,14,13460.0,12,B
2018-04-25 09:17:51,13460.0,2,7532,2,13455.0,9,13460.0,3,B
2018-04-25 09:18:02,13455.0,10,7542,0,13450.0,18,13455.0,5,S
2018-04-25 09:18:03,13450.0,28,7570,12,13450.0,3,13455.0,14,S
2018-04-25 09:18:03,13450.0,12,7582,-6,13445.0,4,13450.0,4,S
2018-04-25 09:18:04,13445.0,2,7584,-2,13440.0,20,13445.0,4,S
2018-04-25 09:18:04,13445.0,8,7592,-8,13440.0,22,13450.0,1,S
2018-04-25 09:18:06,13455.0,6,7598,6,13445.0,1,13455.0,10,B
2018-04-25 09:18:10,13450.0,2,7600,-2,13445.0,2,13450.0,5,S
2018-04-25 09:18:15,13445.0,4,7604,-4,13440.0,20,13445.0,1,S
2018-04-25 09:18:16,13445.0,6,7610,-2,13440.0,17,13450.0,13,S
2018-04-25 09:18:21,13445.0,2,7612,-2,13445.0,4,13450.0,5,S
2018-04-25 09:18:26,13450.0,2,7614,-2,13445.0,5,13450.0,6,B
2018-04-25 09:18:42,13450.0,10,7624,4,13445.0,9,13455.0,3,B
2018-04-25 09:18:43,13450.0,4,7628,-4,13445.0,9,13455.0,6,B
2018-04-25 09:18:44,13445.0,4,7632,0,13445.0,7,13455.0,7,S
2018-04-25 09:18:48,13445.0,20,7652,-12,13440.0,43,13455.0,7,S
2018-04-25 09:18:52,13450.0,6,7658,2,13450.0,1,13455.0,6,B
2018-04-25 09:18:55,13455.0,2,7660,-2,13445.0,5,13455.0,16,B
2018-04-25 09:18:56,13450.0,8,7668,4,13445.0,10,13450.0,6,S
2018-04-25 09:18:57,13450.0,2,7670,0,13445.0,10,13450.0,5,S
2018-04-25 09:19:01,13445.0,8,7678,0,13440.0,32,13450.0,11,S
2018-04-25 09:19:05,13445.0,2,7680,2,13440.0,25,13445.0,8,S
2018-04-25 09:19:06,13445.0,6,7686,0,13440.0,25,13445.0,15,S
2018-04-25 09:19:06,13445.0,2,7688,0,13440.0,23,13445.0,14,S
2018-04-25 09:19:07,13445.0,2,7690,0,13440.0,23,13445.0,12,S
2018-04-25 09:19:08,13445.0,2,7692,-2,13440.0,23,13445.0,11,S
2018-04-25 09:19:08,13445.0,2,7694,0,13440.0,23,13445.0,10,S
2018-04-25 09:19:11,13445.0,14,7708,0,13440.0,27,13445.0,1,S
2018-04-25 09:19:11,13445.0,2,7710,-2,13440.0,27,13450.0,13,S
2018-04-25 09:19:19,13445.0,20,7730,6,13440.0,32,13455.0,5,S
2018-04-25 09:19:21,13450.0,4,7734,0,13445.0,10,13455.0,10,B
2018-04-25 09:19:23,13445.0,2,7736,-2,13445.0,9,13455.0,10,S
2018-04-25 09:19:27,13450.0,2,7738,0,13450.0,2,13455.0,10,B
2018-04-25 09:19:37,13450.0,2,7740,0,13450.0,2,13455.0,7,B
2018-04-25 09:19:51,13455.0,10,7750,0,13450.0,3,13455.0,2,B
2018-04-25 09:20:03,13450.0,8,7758,-6,13445.0,12,13455.0,15,S
2018-04-25 09:20:20,13445.0,4,7762,0,13440.0,25,13450.0,16,S
2018-04-25 09:20:26,13440.0,2,7764,0,13440.0,26,13450.0,12,S
2018-04-25 09:20:30,13440.0,2,7766,-2,13440.0,25,13450.0,10,S
2018-04-25 09:20:56,13445.0,6,7772,2,13445.0,2,13450.0,7,B
2018-04-25 09:21:20,13440.0,44,7816,10,13435.0,6,13445.0,22,S
2018-04-25 09:21:21,13440.0,2,7818,-2,13435.0,23,13445.0,16,S
2018-04-25 09:21:34,13435.0,16,7834,-2,13435.0,10,13440.0,5,S
2018-04-25 09:21:34,13435.0,20,7854,-20,13430.0,4,13440.0,23,S
2018-04-25 09:21:40,13430.0,4,7858,2,13425.0,9,13435.0,14,S
2018-04-25 09:21:44,13425.0,14,7872,-2,13420.0,2,13430.0,19,S
2018-04-25 09:21:44,13425.0,14,7886,-2,13415.0,10,13420.0,1,S
2018-04-25 09:21:45,13420.0,2,7888,-2,13415.0,22,13425.0,2,S
2018-04-25 09:21:47,13425.0,6,7894,0,13420.0,2,13430.0,25,B
2018-04-25 09:21:47,13425.0,16,7910,6,13425.0,10,13430.0,6,B
2018-04-25 09:21:48,13430.0,12,7922,4,13430.0,3,13435.0,6,B
2018-04-25 09:21:51,13430.0,2,7924,0,13430.0,3,13435.0,6,B
2018-04-25 09:21:57,13430.0,2,7926,0,13430.0,8,13435.0,7,B
2018-04-25 09:22:01,13430.0,2,7928,0,13425.0,15,13430.0,1,B
2018-04-25 09:22:03,13425.0,2,7930,0,13420.0,4,13425.0,1,S
2018-04-25 09:22:04,13420.0,6,7936,-6,13415.0,12,13425.0,10,S
2018-04-25 09:22:05,13415.0,24,7960,16,13410.0,3,13415.0,4,S
2018-04-25 09:22:05,13415.0,22,7982,6,13405.0,11,13415.0,3,S
2018-04-25 09:22:06,13410.0,2,7984,0,13410.0,1,13415.0,17,S
2018-04-25 09:22:06,13415.0,6,7990,-4,13410.0,10,13415.0,2,B
2018-04-25 09:22:07,13415.0,4,7994,0,13415.0,5,13420.0,5,B
2018-04-25 09:22:07,13420.0,4,7998,2,13415.0,17,13425.0,5,B
2018-04-25 09:22:08,13420.0,2,8000,0,13415.0,15,13425.0,4,B
2018-04-25 09:22:11,13420.0,4,8004,2,13415.0,7,13425.0,17,B
2018-04-25 09:22:14,13415.0,12,8016,-12,13415.0,7,13425.0,6,S
2018-04-25 09:22:24,13420.0,2,8018,0,13420.0,14,13425.0,2,B
2018-04-25 09:22:24,13425.0,2,8020,0,13420.0,16,13430.0,10,B
2018-04-25 09:22:31,13420.0,20,8040,6,13420.0,1,13425.0,2,S
2018-04-25 09:22:31,13425.0,2,8042,0,13420.0,4,13425.0,3,B
2018-04-25 09:22:35,13425.0,2,8044,0,13420.0,4,13430.0,6,B
2018-04-25 09:22:35,13420.0,8,8052,0,13415.0,13,13420.0,3,S
2018-04-25 09:22:36,13425.0,10,8062,0,13420.0,2,13425.0,1,B
2018-04-25 09:22:36,13425.0,2,8064,2,13420.0,5,13425.0,1,B
2018-04-25 09:22:37,13420.0,4,8068,4,13420.0,3,13425.0,1,S
2018-04-25 09:22:40,13425.0,2,8070,0,13425.0,77,13430.0,10,B
2018-04-25 09:22:42,13425.0,2,8072,0,13425.0,76,13430.0,4,B
2018-04-25 09:22:43,13430.0,2,8074,-2,13425.0,76,13430.0,3,B
2018-04-25 09:22:43,13430.0,8,8082,-6,13425.0,76,13435.0,16,B
2018-04-25 09:22:46,13430.0,18,8100,10,13430.0,1,13435.0,5,B
2018-04-25 09:22:53,13430.0,2,8102,-2,13430.0,4,13435.0,17,B
2018-04-25 09:23:01,13430.0,2,8104,0,13430.0,3,13435.0,10,B
2018-04-25 09:23:01,13430.0,6,8110,-2,13425.0,79,13430.0,5,B
2018-04-25 09:23:02,13430.0,2,8112,0,13425.0,76,13430.0,12,B
2018-04-25 09:23:06,13430.0,2,8114,-2,13425.0,77,13430.0,3,B
2018-04-25 09:23:07,13430.0,2,8116,-2,13425.0,79,13430.0,1,B
2018-04-25 09:23:08,13430.0,2,8118,0,13425.0,79,13430.0,10,B
2018-04-25 09:23:12,13425.0,2,8120,-2,13425.0,78,13430.0,7,S
2018-04-25 09:23:16,13425.0,2,8122,-2,13425.0,76,13435.0,19,S
2018-04-25 09:23:18,13425.0,10,8132,-10,13425.0,71,13435.0,19,S
2018-04-25 09:23:19,13435.0,2,8134,-2,13425.0,71,13435.0,18,B
2018-04-25 09:23:20,13430.0,20,8154,0,13425.0,72,13435.0,14,S
2018-04-25 09:23:24,13435.0,2,8156,-2,13430.0,6,13435.0,5,B
2018-04-25 09:23:26,13430.0,2,8158,-2,13430.0,2,13435.0,5,S
2018-04-25 09:23:29,13430.0,4,8162,-2,13425.0,73,13430.0,11,S
2018-04-25 09:23:30,13425.0,12,8174,-6,13425.0,64,13430.0,17,S
2018-04-25 09:23:31,13425.0,2,8176,0,13425.0,63,13430.0,17,S
2018-04-25 09:23:39,13430.0,16,8192,0,13425.0,73,13435.0,8,B
2018-04-25 09:23:55,13430.0,2,8194,-2,13430.0,3,13435.0,7,B
2018-04-25 09:23:56,13430.0,2,8196,-2,13430.0,2,13435.0,7,B
2018-04-25 09:23:56,13430.0,4,8200,-4,13425.0,73,13430.0,2,B
2018-04-25 09:24:01,13425.0,10,8210,-2,13425.0,59,13430.0,7,S
2018-04-25 09:24:02,13425.0,86,8296,-24,13425.0,16,13430.0,38,S
2018-04-25 09:24:02,13425.0,32,8328,4,13420.0,67,13425.0,10,S
2018-04-25 09:24:03,13420.0,4,8332,0,13420.0,61,13425.0,10,S
2018-04-25 09:24:07,13425.0,28,8360,22,13420.0,68,13430.0,50,B
2018-04-25 09:24:08,13430.0,4,8364,0,13425.0,14,13430.0,27,B
2018-04-25 09:24:09,13425.0,2,8366,0,13425.0,5,13430.0,27,S
2018-04-25 09:24:10,13425.0,6,8372,-2,13420.0,68,13430.0,26,S
2018-04-25 09:24:11,13425.0,2,8374,-2,13425.0,1,13430.0,28,S
2018-04-25 09:24:14,13425.0,2,8376,2,13420.0,68,13425.0,10,S
2018-04-25 09:24:15,13420.0,2,8378,-2,13420.0,61,13425.0,13,S
2018-04-25 09:24:17,13425.0,28,8406,-2,13420.0,61,13430.0,32,B
2018-04-25 09:24:17,13420.0,2,8408,-2,13420.0,64,13430.0,37,S
2018-04-25 09:24:19,13430.0,8,8416,0,13420.0,67,13430.0,24,B
2018-04-25 09:24:24,13430.0,32,8448,0,13425.0,6,13435.0,31,B
2018-04-25 09:24:29,13430.0,2,8450,-2,13425.0,11,13435.0,8,B
2018-04-25 09:24:35,13425.0,2,8452,-2,13425.0,13,13435.0,8,S
2018-04-25 09:24:40,13435.0,12,8464,0,13430.0,12,13440.0,10,B
2018-04-25 09:24:45,13435.0,4,8468,-2,13430.0,4,13435.0,5,B
2018-04-25 09:24:48,13435.0,6,8474,-6,13435.0,3,13440.0,10,B
2018-04-25 09:24:51,13440.0,10,8484,6,13435.0,8,13445.0,4,B
2018-04-25 09:25:00,13445.0,2,8486,0,13435.0,12,13445.0,10,B
2018-04-25 09:25:00,13445.0,2,8488,0,13435.0,13,13445.0,9,B
2018-04-25 09:25:03,13445.0,2,8490,2,13435.0,6,13440.0,8,B
2018-04-25 09:25:06,13435.0,2,8492,2,13435.0,5,13440.0,8,S
2018-04-25 09:25:08,13440.0,2,8494,0,13435.0,5,13440.0,6,B
2018-04-25 09:25:19,13440.0,2,8496,0,13435.0,8,13440.0,5,B
2018-04-25 09:25:24,13435.0,14,8510,-12,13430.0,7,13435.0,3,S
2018-04-25 09:25:24,13440.0,8,8518,-2,13435.0,5,13440.0,1,B
2018-04-25 09:25:28,13440.0,18,8536,18,13440.0,21,13445.0,9,B
2018-04-25 09:25:29,13440.0,2,8538,0,13440.0,21,13445.0,6,B
2018-04-25 09:25:29,13440.0,2,8540,2,13440.0,20,13445.0,6,B
2018-04-25 09:25:30,13440.0,2,8542,0,13440.0,19,13445.0,4,B
2018-04-25 09:25:31,13440.0,4,8546,4,13440.0,17,13445.0,4,B
2018-04-25 09:25:32,13440.0,2,8548,0,13440.0,16,13445.0,4,B
2018-04-25 09:25:37,13445.0,8,8556,-2,13445.0,34,13450.0,7,B
2018-04-25 09:25:38,13445.0,6,8562,-6,13445.0,32,13450.0,7,B
2018-04-25 09:25:38,13440.0,96,8658,6,13435.0,5,13445.0,6,S
2018-04-25 09:25:39,13440.0,2,8660,-2,13435.0,7,13445.0,7,S
2018-04-25 09:25:39,13445.0,14,8674,6,13445.0,3,13450.0,8,B
2018-04-25 09:25:40,13445.0,14,8688,-6,13445.0,5,13450.0,6,B
2018-04-25 09:25:44,13450.0,2,8690,0,13445.0,12,13455.0,4,B
2018-04-25 09:25:57,13450.0,2,8692,-2,13450.0,7,13455.0,1,B
2018-04-25 09:26:00,13455.0,2,8694,-2,13450.0,6,13460.0,7,B
2018-04-25 09:26:03,13450.0,2,8696,-2,13450.0,1,13460.0,11,S
2018-04-25 09:26:04,13450.0,2,8698,-2,13450.0,2,13455.0,3,S
2018-04-25 09:26:05,13445.0,2,8700,2,13445.0,9,13450.0,1,S
2018-04-25 09:26:05,13455.0,4,8704,-2,13445.0,11,13455.0,4,B
2018-04-25 09:26:06,13455.0,2,8706,2,13450.0,1,13455.0,5,B
2018-04-25 09:26:12,13455.0,4,8710,2,13450.0,4,13460.0,10,B
2018-04-25 09:26:15,13450.0,2,8712,0,13450.0,11,13460.0,7,S
2018-04-25 09:26:16,13450.0,4,8716,-4,13450.0,5,13460.0,7,S
2018-04-25 09:26:16,13450.0,6,8722,-4,13450.0,2,13460.0,7,S
2018-04-25 09:26:22,13450.0,10,8732,-8,13445.0,13,13455.0,6,S
2018-04-25 09:26:39,13450.0,2,8734,0,13445.0,13,13455.0,11,S
2018-04-25 09:26:43,13455.0,2,8736,0,13450.0,9,13455.0,1,B
2018-04-25 09:26:44,13455.0,2,8738,0,13455.0,1,13460.0,8,B
2018-04-25 09:26:49,13450.0,14,8752,14,13445.0,25,13450.0,3,S
2018-04-25 09:26:49,13455.0,8,8760,-2,13450.0,6,13460.0,9,B
2018-04-25 09:26:57,13450.0,2,8762,0,13450.0,15,13455.0,1,S
2018-04-25 09:26:57,13450.0,2,8764,0,13450.0,11,13455.0,6,S
2018-04-25 09:26:58,13450.0,6,8770,-2,13450.0,8,13455.0,8,S
2018-04-25 09:26:58,13450.0,10,8780,-10,13450.0,3,13455.0,22,S
2018-04-25 09:26:59,13450.0,6,8786,-6,13445.0,14,13450.0,1,S
2018-04-25 09:27:00,13455.0,2,8788,-2,13445.0,14,13455.0,21,B
2018-04-25 09:27:05,13455.0,12,8800,-8,13450.0,4,13455.0,10,B
2018-04-25 09:27:23,13450.0,2,8802,-2,13450.0,5,13455.0,6,S
2018-04-25 09:27:44,13455.0,16,8818,8,13450.0,8,13460.0,13,B
2018-04-25 09:27:44,13460.0,2,8820,-2,13455.0,1,13460.0,10,B
2018-04-25 09:27:48,13455.0,10,8830,6,13450.0,23,13455.0,31,S
2018-04-25 09:27:48,13455.0,4,8834,4,13450.0,23,13455.0,29,S
2018-04-25 09:28:13,13450.0,2,8836,2,13450.0,5,13455.0,35,S
2018-04-25 09:28:13,13450.0,10,8846,-2,13445.0,10,13450.0,5,S
2018-04-25 09:28:14,13445.0,2,8848,0,13445.0,4,13450.0,10,S
2018-04-25 09:28:17,13445.0,2,8850,2,13445.0,3,13450.0,13,S
2018-04-25 09:28:25,13450.0,10,8860,4,13450.0,3,13455.0,35,B
2018-04-25 09:28:26,13450.0,2,8862,2,13450.0,2,13455.0,35,B
2018-04-25 09:28:41,13450.0,2,8864,2,13450.0,3,13455.0,37,B
2018-04-25 09:28:45,13450.0,4,8868,4,13445.0,12,13450.0,12,B
2018-04-25 09:28:46,13450.0,2,8870,2,13445.0,14,13450.0,11,B
2018-04-25 09:28:46,13450.0,2,8872,2,13445.0,14,13450.0,10,B
2018-04-25 09:29:03,13445.0,4,8876,2,13445.0,1,13450.0,23,S
2018-04-25 09:29:04,13445.0,2,8878,-2,13440.0,6,13450.0,23,S
2018-04-25 09:29:05,13445.0,2,8880,2,13440.0,9,13450.0,23,S
2018-04-25 09:29:16,13450.0,2,8882,0,13440.0,27,13450.0,27,B
2018-04-25 09:29:28,13445.0,6,8888,-6,13440.0,16,13450.0,19,S
2018-04-25 09:29:34,13445.0,4,8892,4,13440.0,11,13445.0,27,S
2018-04-25 09:29:45,13445.0,2,8894,2,13440.0,11,13445.0,26,S
2018-04-25 09:29:52,13440.0,14,8908,-10,13435.0,8,13440.0,5,S
2018-04-25 09:30:06,13445.0,62,8970,54,13445.0,5,13450.0,19,B
2018-04-25 09:30:07,13450.0,6,8976,0,13445.0,12,13450.0,11,B
2018-04-25 09:30:07,13450.0,2,8978,2,13445.0,16,13450.0,10,B
2018-04-25 09:30:09,13445.0,10,8988,10,13445.0,21,13450.0,10,S
2018-04-25 09:30:17,13445.0,10,8998,-2,13440.0,20,13445.0,15,S
2018-04-25 09:30:18,13445.0,6,9004,-6,13440.0,25,13445.0,12,S
2018-04-25 09:30:18,13445.0,22,9026,-2,13440.0,25,13445.0,1,S
2018-04-25 09:30:19,13445.0,2,9028,0,13440.0,25,13450.0,13,S
2018-04-25 09:30:34,13450.0,120,9148,116,13450.0,4,13455.0,12,B
2018-04-25 09:30:35,13455.0,18,9166,6,13450.0,6,13455.0,2,B
2018-04-25 09:30:42,13460.0,4,9170,4,13450.0,10,13460.0,13,B
2018-04-25 09:30:49,13460.0,10,9180,0,13455.0,8,13465.0,12,B
2018-04-25 09:30:52,13465.0,20,9200,16,13465.0,1,13470.0,5,B
2018-04-25 09:30:52,13470.0,2,9202,2,13465.0,4,13470.0,4,B
2018-04-25 09:30:54,13465.0,2,9204,0,13465.0,5,13470.0,5,S
2018-04-25 09:30:54,13465.0,2,9206,2,13465.0,4,13470.0,5,S
2018-04-25 09:30:56,13470.0,2,9208,2,13465.0,4,13470.0,4,B
2018-04-25 09:30:57,13465.0,2,9210,2,13465.0,1,13470.0,12,S
2018-04-25 09:30:57,13465.0,2,9212,0,13460.0,3,13465.0,3,S
2018-04-25 09:31:13,13465.0,2,9214,0,13465.0,13,13470.0,3,S
2018-04-25 09:31:13,13470.0,2,9216,0,13465.0,13,13470.0,2,B
2018-04-25 09:31:20,13465.0,6,9222,6,13460.0,32,13465.0,13,S
2018-04-25 09:31:22,13465.0,2,9224,2,13460.0,21,13465.0,12,S
2018-04-25 09:31:26,13465.0,2,9226,2,13460.0,24,13465.0,11,S
2018-04-25 09:31:32,13460.0,2,9228,0,13460.0,21,13465.0,27,S
2018-04-25 09:31:38,13465.0,28,9256,22,13460.0,21,13465.0,13,B
2018-04-25 09:31:42,13465.0,20,9276,0,13465.0,44,13470.0,8,B
2018-04-25 09:31:47,13470.0,2,9278,0,13465.0,46,13470.0,5,B
2018-04-25 09:31:47,13470.0,2,9280,0,13465.0,46,13470.0,4,B
2018-04-25 09:31:50,13470.0,2,9282,2,13465.0,46,13470.0,4,B
2018-04-25 09:31:52,13470.0,2,9284,2,13465.0,44,13470.0,6,B
2018-04-25 09:31:54,13465.0,10,9294,10,13465.0,39,13470.0,16,S
2018-04-25 09:31:55,13470.0,12,9306,-8,13465.0,39,13470.0,10,B
2018-04-25 09:31:58,13470.0,2,9308,0,13465.0,45,13470.0,5,B
2018-04-25 09:31:59,13470.0,4,9312,4,13465.0,45,13470.0,3,B
2018-04-25 09:32:04,13470.0,2,9314,0,13465.0,45,13470.0,2,B
2018-04-25 09:32:04,13470.0,4,9318,2,13465.0,45,13475.0,9,B
2018-04-25 09:32:18,13470.0,2,9320,2,13465.0,45,13475.0,16,B
2018-04-25 09:32:25,13465.0,2,9322,0,13465.0,40,13470.0,17,S
2018-04-25 09:32:25,13465.0,2,9324,2,13465.0,39,13470.0,17,S
2018-04-25 09:32:27,13465.0,2,9326,0,13465.0,38,13470.0,17,S
2018-04-25 09:32:34,13470.0,2,9328,2,13465.0,40,13470.0,16,B
2018-04-25 09:32:42,13470.0,2,9330,2,13465.0,40,13470.0,15,B
2018-04-25 09:32:47,13470.0,2,9332,2,13465.0,40,13470.0,14,B
2018-04-25 09:32:49,13465.0,4,9336,0,13465.0,38,13470.0,13,S
2018-04-25 09:33:15,13465.0,6,9342,0,13465.0,40,13470.0,6,S
2018-04-25 09:33:30,13470.0,10,9352,8,13465.0,40,13470.0,1,B
2018-04-25 09:33:31,13475.0,4,9356,0,13470.0,10,13475.0,15,B
2018-04-25 09:33:34,13470.0,2,9358,-2,13470.0,8,13475.0,12,S
2018-04-25 09:33:55,13475.0,2,9360,2,13470.0,11,13475.0,9,B
2018-04-25 09:34:02,13475.0,2,9362,2,13470.0,23,13475.0,8,B
2018-04-25 09:34:03,13470.0,26,9388,12,13465.0,49,13470.0,12,S
2018-04-25 09:34:04,13465.0,2,9390,2,13465.0,44,13470.0,16,S
2018-04-25 09:34:04,13465.0,26,9416,10,13465.0,20,13470.0,17,S
2018-04-25 09:34:05,13465.0,10,9426,0,13465.0,15,13470.0,17,S
2018-04-25 09:34:05,13465.0,8,9434,0,13465.0,11,13470.0,16,S
2018-04-25 09:34:06,13465.0,22,9456,0,13460.0,3,13470.0,16,S
2018-04-25 09:34:12,13465.0,4,9460,-2,13460.0,23,13465.0,2,S
2018-04-25 09:34:12,13465.0,4,9464,0,13460.0,21,13470.0,17,S
2018-04-25 09:34:17,13465.0,2,9466,0,13460.0,20,13470.0,17,S
2018-04-25 09:34:25,13470.0,4,9470,0,13465.0,6,13475.0,17,B
2018-04-25 09:34:26,13465.0,4,9474,0,13460.0,22,13470.0,8,S
2018-04-25 09:34:35,13465.0,2,9476,0,13460.0,23,13470.0,16,S
2018-04-25 09:34:42,13460.0,28,9504,-18,13460.0,3,13465.0,23,S
2018-04-25 09:34:43,13460.0,6,9510,0,13455.0,6,13465.0,24,S
2018-04-25 09:35:00,13460.0,2,9512,0,13460.0,2,13465.0,14,S
2018-04-25 09:35:13,13460.0,4,9516,2,13460.0,1,13465.0,14,S
2018-04-25 09:35:17,13460.0,2,9518,2,13455.0,24,13460.0,1,S
2018-04-25 09:35:18,13460.0,2,9520,0,13460.0,1,13465.0,20,S
2018-04-25 09:35:21,13460.0,2,9522,0,13460.0,1,13465.0,20,S
2018-04-25 09:35:23,13460.0,2,9524,2,13455.0,13,13460.0,1,S
2018-04-25 09:35:30,13460.0,8,9532,8,13460.0,2,13465.0,15,S
2018-04-25 09:35:31,13465.0,26,9558,8,13460.0,9,13470.0,15,B
2018-04-25 09:35:33,13475.0,4,9562,0,13470.0,10,13475.0,13,B
2018-04-25 09:35:33,13470.0,6,9568,0,13470.0,11,13475.0,8,S
2018-04-25 09:35:35,13470.0,4,9572,-4,13465.0,9,13475.0,13,S
2018-04-25 09:35:41,13470.0,4,9576,-2,13465.0,6,13475.0,18,S
2018-04-25 09:35:42,13470.0,2,9578,2,13470.0,7,13475.0,9,S
2018-04-25 09:35:44,13470.0,2,9580,0,13470.0,6,13475.0,10,S
2018-04-25 09:35:47,13470.0,2,9582,-2,13470.0,5,13475.0,10,S
2018-04-25 09:35:52,13470.0,2,9584,-2,13470.0,3,13475.0,15,S
2018-04-25 09:35:58,13470.0,2,9586,-2,13470.0,2,13475.0,15,S
2018-04-25 09:35:58,13470.0,4,9590,0,13465.0,5,13475.0,15,S
2018-04-25 09:36:09,13470.0,2,9592,0,13465.0,3,13470.0,10,S
2018-04-25 09:36:15,13470.0,2,9594,-2,13465.0,7,13475.0,19,S
2018-04-25 09:36:27,13465.0,4,9598,0,13465.0,1,13470.0,6,S
2018-04-25 09:36:28,13470.0,6,9604,-6,13465.0,5,13475.0,19,B
2018-04-25 09:36:29,13470.0,2,9606,-2,13465.0,17,13470.0,6,B
2018-04-25 09:36:33,13470.0,4,9610,4,13465.0,6,13470.0,2,B
2018-04-25 09:36:47,13470.0,2,9612,-2,13465.0,6,13475.0,22,B
2018-04-25 09:37:01,13470.0,2,9614,0,13465.0,6,13475.0,22,B
2018-04-25 09:37:08,13470.0,2,9616,2,13470.0,2,13475.0,23,B
2018-04-25 09:37:09,13470.0,4,9620,4,13465.0,6,13475.0,23,B
2018-04-25 09:37:24,13470.0,2,9622,2,13470.0,9,13475.0,20,B
2018-04-25 09:37:28,13475.0,2,9624,2,13470.0,9,13475.0,19,B
2018-04-25 09:37:33,13470.0,2,9626,2,13470.0,8,13475.0,19,S
2018-04-25 09:37:50,13470.0,16,9642,16,13465.0,8,13470.0,2,S
2018-04-25 09:38:01,13470.0,12,9654,6,13465.0,8,13475.0,19,S
2018-04-25 09:38:36,13465.0,10,9664,6,13465.0,48,13470.0,9,S
2018-04-25 09:38:36,13465.0,64,9728,-46,13465.0,16,13470.0,12,S
2018-04-25 09:38:37,13465.0,32,9760,-4,13460.0,22,13465.0,2,S
2018-04-25 09:38:53,13465.0,2,9762,-2,13465.0,2,13470.0,11,S
2018-04-25 09:38:58,13465.0,22,9784,-10,13460.0,18,13465.0,9,S
2018-04-25 09:38:59,13465.0,14,9798,-10,13460.0,18,13465.0,2,S
2018-04-25 09:38:59,13465.0,4,9802,-4,13460.0,18,13470.0,3,S
2018-04-25 09:39:16,13465.0,2,9804,-2,13465.0,2,13470.0,10,S
2018-04-25 09:39:19,13470.0,4,9808,-4,13465.0,11,13470.0,4,B
2018-04-25 09:39:20,13470.0,8,9816,-2,13465.0,12,13475.0,19,B
2018-04-25 09:39:39,13470.0,2,9818,0,13470.0,4,13475.0,21,B
2018-04-25 09:39:52,13470.0,2,9820,0,13470.0,3,13475.0,19,B
2018-04-25 09:39:56,13470.0,2,9822,2,13465.0,5,13475.0,23,B
2018-04-25 09:40:01,13470.0,4,9826,0,13465.0,12,13475.0,21,B
2018-04-25 09:40:13,13470.0,2,9828,0,13465.0,17,13475.0,21,B
2018-04-25 09:40:59,13475.0,6,9834,6,13470.0,11,13475.0,11,B
2018-04-25 09:41:21,13475.0,2,9836,2,13470.0,14,13475.0,10,B
2018-04-25 09:41:22,13470.0,12,9848,0,13470.0,8,13475.0,16,S
2018-04-25 09:41:25,13470.0,16,9864,6,13465.0,5,13475.0,19,S
2018-04-25 09:41:31,13470.0,2,9866,0,13470.0,3,13475.0,19,S
2018-04-25 09:41:46,13475.0,16,9882,8,13470.0,13,13480.0,23,B
2018-04-25 09:41:51,13475.0,10,9892,4,13470.0,11,13480.0,17,B
2018-04-25 09:41:58,13475.0,2,9894,0,13470.0,6,13475.0,15,B
2018-04-25 09:42:02,13470.0,6,9900,4,13465.0,7,13470.0,3,S
2018-04-25 09:42:06,13470.0,10,9910,-2,13465.0,14,13475.0,27,S
2018-04-25 09:42:22,13470.0,2,9912,2,13470.0,4,13475.0,10,S
2018-04-25 09:42:26,13475.0,2,9914,-2,13470.0,4,13475.0,9,B
2018-04-25 09:42:26,13470.0,2,9916,-2,13470.0,3,13475.0,9,S
2018-04-25 09:43:21,13470.0,2,9918,0,13470.0,2,13475.0,10,S
2018-04-25 09:43:28,13470.0,2,9920,2,13465.0,15,13470.0,3,S
2018-04-25 09:43:28,13470.0,6,9926,0,13465.0,15,13475.0,10,S
2018-04-25 09:43:50,13470.0,2,9928,2,13470.0,12,13475.0,8,S
2018-04-25 09:44:31,13475.0,10,9938,8,13470.0,32,13480.0,32,B
2018-04-25 09:44:42,13480.0,2,9940,2,13475.0,1,13480.0,16,B
2018-04-25 09:44:46,13480.0,2,9942,2,13475.0,1,13480.0,15,B
2018-04-25 09:44:47,13475.0,2,9944,0,13470.0,32,13480.0,15,S
2018-04-25 09:45:29,13475.0,2,9946,2,13475.0,4,13480.0,17,S
2018-04-25 09:45:33,13480.0,10,9956,4,13475.0,14,13480.0,7,B
2018-04-25 09:45:33,13480.0,14,9970,10,13475.0,14,13485.0,10,B
2018-04-25 09:45:41,13485.0,8,9978,4,13480.0,7,13485.0,7,B
2018-04-25 09:46:11,13480.0,2,9980,0,13480.0,7,13485.0,4,S
2018-04-25 09:46:15,13485.0,10,9990,8,13480.0,9,13490.0,19,B
2018-04-25 09:46:21,13490.0,4,9994,0,13480.0,10,13490.0,23,B
2018-04-25 09:46:22,13480.0,2,9996,0,13480.0,9,13490.0,23,S
2018-04-25 09:46:36,13480.0,6,10002,-2,13480.0,23,13490.0,25,S
2018-04-25 09:46:37,13480.0,4,10006,-2,13480.0,23,13490.0,25,S
2018-04-25 09:46:55,13485.0,8,10014,-8,13480.0,11,13485.0,1,B
2018-04-25 09:47:03,13485.0,4,10018,0,13485.0,7,13490.0,28,B
2018-04-25 09:47:03,13485.0,2,10020,0,13485.0,8,13490.0,29,B
2018-04-25 09:47:08,13485.0,16,10036,-4,13480.0,10,13490.0,29,B
2018-04-25 09:47:08,13480.0,20,10056,8,13475.0,8,13485.0,14,S
2018-04-25 09:47:25,13480.0,4,10060,-4,13475.0,9,13485.0,21,S
2018-04-25 09:47:36,13475.0,10,10070,8,13475.0,4,13485.0,21,S
2018-04-25 09:47:55,13475.0,6,10076,2,13470.0,4,13475.0,1,S
2018-04-25 09:47:59,13475.0,6,10082,-6,13475.0,2,13480.0,5,S
2018-04-25 09:48:18,13475.0,2,10084,2,13470.0,5,13475.0,8,S
2018-04-25 09:48:54,13470.0,8,10092,-8,13465.0,7,13475.0,14,S
2018-04-25 09:49:01,13475.0,2,10094,2,13470.0,3,13475.0,9,B
2018-04-25 09:49:10,13470.0,2,10096,2,13470.0,14,13475.0,7,S
2018-04-25 09:49:13,13475.0,14,10110,14,13475.0,3,13480.0,9,B
2018-04-25 09:49:14,13475.0,4,10114,0,13475.0,1,13480.0,11,B
2018-04-25 09:49:15,13475.0,2,10116,0,13470.0,3,13480.0,11,B
2018-04-25 09:49:28,13475.0,2,10118,0,13470.0,4,13475.0,2,B
2018-04-25 09:49:47,13475.0,4,10122,0,13475.0,3,13480.0,11,B
2018-04-25 09:50:44,13475.0,4,10126,0,13470.0,5,13475.0,3,B
2018-04-25 09:50:44,13475.0,2,10128,2,13470.0,5,13475.0,2,B
2018-04-25 09:50:45,13475.0,4,10132,0,13470.0,33,13480.0,9,B
2018-04-25 09:50:48,13475.0,2,10134,-2,13475.0,1,13480.0,11,B
2018-04-25 09:51:01,13480.0,6,10140,0,13475.0,23,13480.0,12,B
2018-04-25 09:51:24,13480.0,20,10160,20,13475.0,22,13480.0,2,B
2018-04-25 09:51:24,13480.0,4,10164,0,13475.0,22,13485.0,14,B
2018-04-25 09:51:37,13480.0,2,10166,2,13480.0,4,13485.0,13,B
2018-04-25 09:51:41,13480.0,6,10172,0,13475.0,19,13480.0,2,B
2018-04-25 09:51:41,13480.0,4,10176,4,13475.0,22,13485.0,13,B
2018-04-25 09:52:18,13480.0,2,10178,-2,13480.0,1,13485.0,17,B
2018-04-25 09:52:18,13480.0,2,10180,-2,13475.0,1,13480.0,3,B
2018-04-25 09:52:45,13480.0,2,10182,0,13475.0,18,13485.0,20,B
2018-04-25 09:53:24,13475.0,2,10184,2,13475.0,18,13480.0,8,S
2018-04-25 09:53:25,13475.0,2,10186,2,13475.0,17,13480.0,8,S
2018-04-25 09:53:27,13480.0,8,10194,0,13475.0,20,13480.0,4,B
2018-04-25 09:53:28,13480.0,8,10202,0,13480.0,1,13485.0,21,B
2018-04-25 09:53:28,13480.0,2,10204,0,13475.0,16,13485.0,23,B
2018-04-25 09:53:46,13475.0,2,10206,-2,13475.0,17,13485.0,27,S
2018-04-25 09:53:48,13475.0,2,10208,0,13475.0,16,13485.0,27,S
2018-04-25 09:54:15,13475.0,4,10212,-4,13475.0,11,13480.0,2,S
2018-04-25 09:54:21,13480.0,4,10216,0,13480.0,2,13485.0,23,B
2018-04-25 09:54:21,13480.0,6,10222,2,13475.0,23,13485.0,16,B
2018-04-25 09:54:34,13480.0,2,10224,0,13475.0,11,13480.0,4,B
2018-04-25 09:54:35,13475.0,10,10234,0,13475.0,20,13480.0,4,S
2018-04-25 09:54:36,13480.0,8,10242,0,13480.0,7,13485.0,20,B
2018-04-25 09:54:44,13480.0,2,10244,0,13480.0,7,13485.0,19,B
2018-04-25 09:55:32,13480.0,18,10262,0,13475.0,6,13480.0,5,B
2018-04-25 09:55:36,13480.0,18,10280,8,13480.0,1,13485.0,23,B
2018-04-25 09:55:36,13480.0,2,10282,2,13475.0,3,13480.0,2,B
2018-04-25 09:55:54,13475.0,6,10288,2,13470.0,2,13480.0,16,S
2018-04-25 09:56:03,13480.0,4,10292,0,13475.0,18,13480.0,2,B
2018-04-25 09:56:28,13475.0,6,10298,0,13470.0,16,13480.0,12,S
2018-04-25 09:56:57,13470.0,24,10322,0,13465.0,6,13475.0,16,S
2018-04-25 09:57:01,13465.0,6,10328,-2,13460.0,23,13470.0,14,S
2018-04-25 09:57:08,13465.0,2,10330,-2,13460.0,23,13465.0,2,S
2018-04-25 09:57:11,13465.0,2,10332,-2,13460.0,23,13465.0,2,S
2018-04-25 09:57:14,13465.0,2,10334,0,13460.0,23,13465.0,2,S
2018-04-25 09:57:18,13460.0,2,10336,0,13460.0,22,13465.0,4,S
2018-04-25 09:57:25,13460.0,4,10340,0,13460.0,20,13465.0,7,S
2018-04-25 09:57:29,13465.0,16,10356,0,13465.0,2,13470.0,11,B
2018-04-25 09:57:47,13470.0,2,10358,2,13465.0,6,13470.0,6,B
2018-04-25 09:57:54,13470.0,2,10360,0,13465.0,6,13470.0,3,B
2018-04-25 09:57:54,13470.0,2,10362,2,13465.0,6,13470.0,3,B
2018-04-25 09:58:05,13465.0,10,10372,-8,13460.0,22,13465.0,8,S
2018-04-25 09:58:14,13465.0,6,10378,2,13460.0,19,13465.0,3,S
2018-04-25 09:58:19,13465.0,4,10382,-4,13460.0,29,13470.0,12,S
2018-04-25 09:58:35,13460.0,2,10384,-2,13460.0,30,13470.0,12,S
2018-04-25 09:58:40,13465.0,2,10386,0,13460.0,20,13470.0,12,B
2018-04-25 09:58:57,13470.0,20,10406,10,13460.0,20,13470.0,2,B
2018-04-25 09:58:57,13465.0,4,10410,0,13460.0,20,13470.0,5,S
2018-04-25 09:59:05,13470.0,12,10422,8,13470.0,4,13475.0,8,B
2018-04-25 09:59:06,13470.0,8,10430,8,13465.0,11,13470.0,2,B
2018-04-25 09:59:08,13470.0,6,10436,6,13470.0,6,13475.0,7,B
2018-04-25 09:59:26,13475.0,8,10444,6,13475.0,2,13480.0,28,B
2018-04-25 09:59:26,13475.0,4,10448,0,13470.0,3,13480.0,27,B
2018-04-25 10:00:04,13470.0,10,10458,8,13465.0,20,13470.0,1,S
2018-04-25 10:00:04,13470.0,2,10460,2,13465.0,20,13475.0,14,S
2018-04-25 10:00:21,13465.0,44,10504,22,13460.0,32,13465.0,1,S
2018-04-25 10:00:22,13460.0,6,10510,0,13460.0,15,13465.0,5,S
2018-04-25 10:00:40,13460.0,2,10512,-2,13460.0,16,13465.0,4,S
2018-04-25 10:00:42,13465.0,8,10520,6,13465.0,6,13470.0,18,B
2018-04-25 10:00:48,13465.0,2,10522,0,13465.0,5,13470.0,22,B
2018-04-25 10:00:49,13465.0,2,10524,2,13465.0,4,13470.0,22,B
2018-04-25 10:00:50,13465.0,6,10530,4,13465.0,1,13470.0,20,B
2018-04-25 10:00:51,13465.0,2,10532,2,13460.0,14,13465.0,20,B
2018-04-25 10:00:53,13460.0,2,10534,-2,13460.0,13,13465.0,18,S
2018-04-25 10:00:53,13460.0,4,10538,0,13460.0,11,13465.0,23,S
2018-04-25 10:01:00,13460.0,10,10548,0,13460.0,6,13465.0,10,S
2018-04-25 10:01:07,13460.0,12,10560,0,13455.0,6,13460.0,2,S
2018-04-25 10:01:12,13455.0,2,10562,0,13455.0,6,13460.0,5,S
2018-04-25 10:01:14,13460.0,10,10572,-10,13460.0,7,13465.0,16,B
2018-04-25 10:01:14,13460.0,2,10574,-2,13460.0,9,13465.0,14,B
2018-04-25 10:01:16,13460.0,4,10578,-4,13460.0,1,13465.0,16,B
2018-04-25 10:01:16,13460.0,2,10580,0,13455.0,8,13465.0,19,B
2018-04-25 10:01:18,13460.0,2,10582,0,13460.0,3,13465.0,15,B
2018-04-25 10:01:19,13460.0,4,10586,0,13455.0,10,13460.0,2,B
2018-04-25 10:01:20,13460.0,4,10590,0,13460.0,1,13465.0,14,B
2018-04-25 10:01:22,13460.0,2,10592,0,13460.0,4,13465.0,14,B
2018-04-25 10:01:32,13460.0,10,10602,8,13455.0,11,13460.0,1,B
2018-04-25 10:01:33,13460.0,2,10604,0,13455.0,12,13465.0,14,B
2018-04-25 10:01:41,13465.0,2,10606,2,13460.0,2,13465.0,8,B
2018-04-25 10:02:21,13460.0,8,10614,-4,13460.0,2,13465.0,9,S
2018-04-25 10:02:22,13460.0,4,10618,2,13455.0,8,13460.0,12,S
2018-04-25 10:02:38,13460.0,32,10650,-2,13455.0,12,13465.0,15,S
2018-04-25 10:02:54,13465.0,2,10652,2,13455.0,17,13465.0,10,B
2018-04-25 10:02:54,13465.0,2,10654,2,13455.0,17,13465.0,10,B
2018-04-25 10:02:58,13465.0,10,10664,10,13455.0,17,13465.0,5,B
2018-04-25 10:03:08,13465.0,2,10666,0,13460.0,10,13470.0,15,B
2018-04-25 10:03:33,13465.0,2,10668,0,13460.0,19,13465.0,5,B
2018-04-25 10:03:43,13460.0,28,10696,-2,13455.0,13,13465.0,21,S
2018-04-25 10:03:47,13455.0,2,10698,-2,13455.0,12,13465.0,22,S
2018-04-25 10:03:52,13455.0,2,10700,-2,13455.0,11,13465.0,22,S
2018-04-25 10:03:59,13455.0,14,10714,-4,13450.0,22,13455.0,13,S
2018-04-25 10:04:00,13455.0,18,10732,-14,13450.0,23,13455.0,4,S
2018-04-25 10:04:00,13455.0,8,10740,-8,13450.0,16,13460.0,8,S
2018-04-25 10:04:25,13460.0,2,10742,0,13455.0,19,13460.0,6,B
2018-04-25 10:04:31,13460.0,2,10744,0,13455.0,20,13460.0,5,B
2018-04-25 10:04:37,13460.0,2,10746,0,13455.0,20,13460.0,4,B
2018-04-25 10:04:40,13455.0,2,10748,0,13455.0,19,13460.0,4,S
2018-04-25 10:04:40,13460.0,2,10750,0,13455.0,19,13460.0,3,B
2018-04-25 10:04:56,13460.0,2,10752,2,13455.0,18,13460.0,2,B
2018-04-25 10:04:56,13460.0,4,10756,0,13455.0,18,13465.0,8,B
2018-04-25 10:05:00,13460.0,18,10774,8,13455.0,26,13460.0,41,B
2018-04-25 10:05:04,13460.0,4,10778,0,13455.0,25,13460.0,39,B
2018-04-25 10:05:05,13460.0,2,10780,0,13455.0,25,13460.0,38,B
2018-04-25 10:05:20,13455.0,2,10782,-2,13455.0,21,13460.0,38,S
2018-04-25 10:05:21,13460.0,6,10788,4,13455.0,36,13460.0,35,B
2018-04-25 10:05:31,13460.0,2,10790,2,13455.0,32,13460.0,34,B
2018-04-25 10:05:34,13460.0,20,10810,20,13455.0,32,13460.0,24,B
2018-04-25 10:05:43,13455.0,2,10812,-2,13455.0,31,13460.0,24,S
2018-04-25 10:05:51,13455.0,64,10876,-38,13450.0,30,13455.0,18,S
2018-04-25 10:05:52,13455.0,36,10912,-10,13455.0,7,13460.0,26,S
2018-04-25 10:06:56,13460.0,4,10916,4,13455.0,28,13460.0,22,B
2018-04-25 10:06:57,13460.0,44,10960,44,13455.0,42,13465.0,9,B
2018-04-25 10:06:57,13465.0,10,10970,-10,13460.0,8,13465.0,4,B
2018-04-25 10:06:58,13465.0,4,10974,-4,13460.0,8,13465.0,2,B
2018-04-25 10:06:58,13465.0,4,10978,-2,13460.0,11,13470.0,11,B
2018-04-25 10:06:59,13460.0,2,10980,2,13460.0,15,13470.0,13,S
2018-04-25 10:07:04,13470.0,2,10982,0,13460.0,25,13470.0,16,B
2018-04-25 10:07:14,13465.0,2,10984,-2,13460.0,22,13470.0,13,S
2018-04-25 10:07:17,13470.0,30,11014,12,13470.0,35,13475.0,5,B
2018-04-25 10:07:17,13470.0,10,11024,4,13470.0,30,13475.0,7,B
2018-04-25 10:07:22,13470.0,2,11026,2,13470.0,30,13475.0,6,B
2018-04-25 10:07:22,13475.0,8,11034,0,13470.0,36,13475.0,2,B
2018-04-25 10:07:23,13475.0,4,11038,2,13470.0,36,13480.0,6,B
2018-04-25 10:07:30,13475.0,6,11044,4,13475.0,8,13480.0,10,B
2018-04-25 10:07:30,13475.0,16,11060,-4,13470.0,33,13475.0,6,B
2018-04-25 10:07:31,13480.0,36,11096,-12,13480.0,32,13485.0,28,B
2018-04-25 10:07:31,13480.0,56,11152,-42,13480.0,4,13485.0,20,B
2018-04-25 10:07:32,13480.0,10,11162,-2,13475.0,3,13480.0,2,B
2018-04-25 10:07:32,13480.0,2,11164,-2,13475.0,4,13480.0,3,B
2018-04-25 10:07:33,13480.0,2,11166,0,13480.0,4,13485.0,19,B
2018-04-25 10:07:33,13485.0,4,11170,-2,13480.0,3,13485.0,18,B
2018-04-25 10:07:34,13480.0,2,11172,-2,13480.0,2,13485.0,18,S
2018-04-25 10:07:37,13480.0,2,11174,-2,13480.0,3,13485.0,18,S
2018-04-25 10:07:41,13480.0,4,11178,0,13480.0,1,13485.0,18,S
2018-04-25 10:07:43,13480.0,2,11180,0,13475.0,2,13485.0,18,S
2018-04-25 10:08:02,13475.0,6,11186,4,13470.0,34,13475.0,2,S
2018-04-25 10:08:03,13475.0,4,11190,0,13475.0,3,13480.0,13,S
2018-04-25 10:08:08,13475.0,2,11192,0,13475.0,3,13480.0,13,S
2018-04-25 10:08:18,13480.0,26,11218,14,13475.0,2,13485.0,20,B
2018-04-25 10:08:34,13485.0,38,11256,-14,13485.0,1,13490.0,38,B
2018-04-25 10:08:34,13485.0,6,11262,2,13480.0,1,13485.0,27,B
2018-04-25 10:08:35,13480.0,2,11264,0,13475.0,5,13480.0,1,S
2018-04-25 10:08:47,13485.0,22,11286,20,13485.0,18,13490.0,38,B
2018-04-25 10:08:48,13485.0,2,11288,0,13485.0,17,13490.0,41,B
2018-04-25 10:08:48,13485.0,30,11318,12,13485.0,2,13490.0,42,B
2018-04-25 10:08:49,13485.0,4,11322,4,13480.0,13,13485.0,8,B
2018-04-25 10:09:01,13480.0,2,11324,2,13480.0,13,13485.0,11,S
2018-04-25 10:09:08,13480.0,2,11326,2,13480.0,12,13485.0,12,S
2018-04-25 10:09:43,13480.0,10,11336,0,13480.0,6,13485.0,13,S
2018-04-25 10:09:54,13480.0,2,11338,0,13480.0,15,13485.0,14,S
2018-04-25 10:10:10,13480.0,2,11340,-2,13480.0,14,13485.0,14,S
2018-04-25 10:10:12,13480.0,2,11342,0,13480.0,13,13485.0,14,S
2018-04-25 10:10:17,13485.0,22,11364,2,13480.0,19,13490.0,38,B
2018-04-25 10:10:34,13485.0,10,11374,6,13485.0,1,13490.0,45,B
2018-04-25 10:10:57,13490.0,2,11376,0,13485.0,34,13490.0,33,B
2018-04-25 10:10:57,13490.0,56,11432,-8,13485.0,35,13490.0,5,B
2018-04-25 10:10:58,13495.0,18,11450,14,13490.0,3,13495.0,11,B
2018-04-25 10:10:58,13495.0,8,11458,-8,13490.0,6,13495.0,13,B
2018-04-25 10:11:10,13495.0,2,11460,0,13490.0,10,13495.0,9,B
2018-04-25 10:11:15,13495.0,2,11462,2,13490.0,8,13495.0,12,B
2018-04-25 10:11:15,13490.0,12,11474,12,13485.0,17,13490.0,10,S
2018-04-25 10:11:16,13485.0,4,11478,2,13485.0,12,13490.0,17,S
2018-04-25 10:11:16,13485.0,26,11504,18,13480.0,5,13490.0,16,S
2018-04-25 10:11:17,13485.0,2,11506,0,13480.0,5,13485.0,2,S
2018-04-25 10:11:18,13485.0,2,11508,0,13480.0,9,13490.0,16,S
2018-04-25 10:11:43,13485.0,34,11542,14,13485.0,3,13490.0,16,S
2018-04-25 10:11:44,13485.0,6,11548,0,13480.0,9,13485.0,1,S
2018-04-25 10:11:50,13480.0,2,11550,-2,13480.0,8,13490.0,21,S
2018-04-25 10:12:05,13485.0,6,11556,-4,13480.0,9,13490.0,17,B
2018-04-25 10:12:14,13485.0,2,11558,0,13485.0,2,13490.0,5,B
2018-04-25 10:12:15,13490.0,10,11568,8,13490.0,1,13495.0,7,B
2018-04-25 10:12:15,13490.0,2,11570,0,13485.0,3,13490.0,1,B
2018-04-25 10:12:40,13485.0,2,11572,0,13485.0,10,13495.0,8,S
2018-04-25 10:12:45,13490.0,2,11574,0,13485.0,9,13490.0,1,B
2018-04-25 10:13:18,13485.0,2,11576,-2,13485.0,4,13490.0,10,S
2018-04-25 10:13:22,13485.0,16,11592,-10,13480.0,25,13485.0,2,S
2018-04-25 10:13:22,13485.0,4,11596,-4,13485.0,4,13490.0,1,S
2018-04-25 10:13:24,13495.0,10,11606,-8,13485.0,7,13495.0,8,B
2018-04-25 10:13:30,13485.0,2,11608,0,13485.0,5,13490.0,3,S
2018-04-25 10:13:31,13485.0,16,11624,2,13480.0,10,13490.0,13,S
2018-04-25 10:13:57,13480.0,12,11636,-8,13480.0,9,13490.0,21,S
2018-04-25 10:14:03,13480.0,8,11644,-4,13480.0,3,13485.0,4,S
2018-04-25 10:14:03,13480.0,6,11650,-6,13475.0,5,13480.0,1,S
2018-04-25 10:14:26,13480.0,4,11654,-2,13480.0,1,13485.0,11,S
2018-04-25 10:14:30,13485.0,6,11660,-6,13480.0,4,13485.0,2,B
2018-04-25 10:30:00,13485.0,4,11664,4,13475.0,13,13485.0,7,B
2018-04-25 10:30:08,13475.0,2,11666,0,13475.0,6,13480.0,8,S
2018-04-25 10:30:08,13475.0,12,11678,0,13470.0,9,13475.0,4,S
2018-04-25 10:30:09,13475.0,4,11682,0,13470.0,9,13475.0,2,S
2018-04-25 10:30:10,13475.0,4,11686,4,13475.0,3,13480.0,9,S
2018-04-25 10:30:17,13475.0,4,11690,-4,13475.0,4,13480.0,8,S
2018-04-25 10:31:00,13475.0,2,11692,-2,13475.0,11,13480.0,5,S
2018-04-25 10:31:08,13475.0,2,11694,0,13470.0,9,13475.0,1,S
2018-04-25 10:31:16,13475.0,2,11696,0,13475.0,8,13480.0,12,S
2018-04-25 10:31:39,13475.0,2,11698,-2,13475.0,9,13480.0,5,S
2018-04-25 10:31:54,13475.0,10,11708,2,13475.0,4,13480.0,5,S
2018-04-25 10:32:43,13475.0,10,11718,6,13475.0,7,13480.0,40,S
2018-04-25 10:32:48,13475.0,6,11724,0,13475.0,4,13480.0,40,S
2018-04-25 10:32:49,13475.0,2,11726,-2,13475.0,4,13480.0,40,S
2018-04-25 10:33:18,13475.0,6,11732,-6,13470.0,13,13480.0,45,S
2018-04-25 10:33:21,13475.0,4,11736,-2,13470.0,13,13475.0,4,S
2018-04-25 10:33:22,13475.0,8,11744,0,13470.0,13,13480.0,45,S
2018-04-25 10:33:28,13475.0,2,11746,2,13470.0,13,13480.0,45,S
2018-04-25 10:33:32,13475.0,2,11748,2,13475.0,3,13480.0,45,S
2018-04-25 10:33:34,13475.0,2,11750,0,13475.0,1,13480.0,45,S
2018-04-25 10:33:34,13470.0,4,11754,4,13470.0,25,13480.0,45,S
2018-04-25 10:33:35,13470.0,2,11756,0,13470.0,24,13480.0,45,S
2018-04-25 10:33:42,13475.0,2,11758,0,13470.0,11,13480.0,45,B
2018-04-25 10:34:08,13480.0,2,11760,2,13470.0,10,13480.0,46,B
2018-04-25 10:34:33,13480.0,8,11768,8,13475.0,11,13480.0,38,B
2018-04-25 10:34:34,13480.0,70,11838,50,13480.0,6,13485.0,7,B
2018-04-25 10:35:03,13485.0,2,11840,2,13480.0,10,13490.0,11,B
2018-04-25 10:35:09,13485.0,2,11842,-2,13480.0,10,13485.0,1,B
2018-04-25 10:35:15,13485.0,4,11846,0,13480.0,10,13485.0,1,B
2018-04-25 10:35:24,13485.0,2,11848,0,13480.0,10,13490.0,18,B
2018-04-25 10:35:33,13485.0,2,11850,-2,13480.0,10,13490.0,20,B
2018-04-25 10:37:28,13485.0,8,11858,8,13480.0,11,13490.0,18,B
2018-04-25 10:37:34,13485.0,10,11868,0,13485.0,5,13490.0,18,B
2018-04-25 10:37:37,13485.0,2,11870,0,13485.0,4,13490.0,19,B
2018-04-25 10:38:08,13485.0,10,11880,-2,13480.0,1,13490.0,18,B
2018-04-25 10:38:09,13480.0,2,11882,-2,13480.0,2,13485.0,16,S
2018-04-25 10:38:21,13485.0,4,11886,2,13480.0,3,13485.0,5,B
2018-04-25 10:38:21,13485.0,6,11892,0,13485.0,1,13490.0,15,B
2018-04-25 10:38:49,13485.0,6,11898,6,13480.0,11,13485.0,2,B
2018-04-25 10:39:00,13485.0,4,11902,4,13480.0,8,13490.0,17,B
2018-04-25 10:39:20,13480.0,4,11906,4,13475.0,9,13485.0,15,S
2018-04-25 10:40:34,13480.0,6,11912,0,13475.0,14,13480.0,2,S
2018-04-25 10:40:35,13480.0,4,11916,0,13480.0,3,13485.0,19,S
2018-04-25 10:40:56,13480.0,2,11918,-2,13480.0,5,13485.0,11,S
2018-04-25 10:41:30,13480.0,8,11926,0,13475.0,10,13480.0,4,S
2018-04-25 10:41:31,13475.0,18,11944,-14,13470.0,7,13480.0,3,S
2018-04-25 10:42:21,13485.0,2,11946,0,13475.0,6,13485.0,16,B
2018-04-25 10:42:57,13480.0,8,11954,-6,13475.0,10,13485.0,8,S
2018-04-25 10:43:07,13480.0,14,11968,-2,13475.0,4,13480.0,2,S
2018-04-25 10:43:09,13475.0,2,11970,-2,13475.0,1,13480.0,10,S
2018-04-25 10:43:19,13480.0,10,11980,0,13480.0,1,13485.0,10,B
2018-04-25 10:43:23,13480.0,2,11982,2,13475.0,5,13485.0,16,B
2018-04-25 10:45:28,13480.0,2,11984,2,13475.0,6,13480.0,5,B
2018-04-25 10:45:34,13480.0,12,11996,10,13480.0,4,13485.0,17,B
2018-04-25 10:45:34,13480.0,4,12000,0,13480.0,2,13485.0,17,B
2018-04-25 10:45:39,13480.0,2,12002,2,13480.0,1,13485.0,17,B
2018-04-25 10:46:01,13480.0,2,12004,2,13480.0,1,13485.0,12,B
2018-04-25 10:46:09,13480.0,2,12006,-2,13475.0,4,13480.0,1,B
2018-04-25 10:46:42,13475.0,6,12012,-6,13470.0,7,13480.0,13,S
2018-04-25 10:46:57,13475.0,6,12018,2,13475.0,9,13480.0,1,S
2018-04-25 10:46:57,13480.0,2,12020,-2,13475.0,9,13485.0,9,B
2018-04-25 10:47:00,13480.0,2,12022,2,13475.0,9,13480.0,1,B
2018-04-25 10:47:04,13480.0,2,12024,-2,13475.0,11,13485.0,16,B
2018-04-25 10:47:07,13475.0,22,12046,-12,13470.0,37,13475.0,2,S
2018-04-25 10:47:08,13475.0,4,12050,-4,13475.0,1,13480.0,3,S
2018-04-25 10:47:29,13480.0,2,12052,0,13475.0,19,13480.0,1,B
2018-04-25 10:47:46,13480.0,6,12058,0,13475.0,16,13480.0,2,B
2018-04-25 10:47:53,13475.0,22,12080,-4,13475.0,4,13480.0,19,S
2018-04-25 10:47:53,13475.0,8,12088,-8,13470.0,6,13475.0,1,S
2018-04-25 10:48:11,13475.0,8,12096,8,13475.0,6,13480.0,18,S
2018-04-25 10:48:45,13480.0,14,12110,4,13475.0,10,13480.0,1,B
2018-04-25 10:48:46,13480.0,4,12114,2,13480.0,1,13485.0,10,B
2018-04-25 10:49:08,13480.0,2,12116,2,13475.0,22,13480.0,1,B
2018-04-25 10:49:24,13480.0,2,12118,-2,13475.0,18,13485.0,14,B
2018-04-25 10:50:11,13475.0,2,12120,0,13475.0,21,13485.0,18,S
2018-04-25 10:51:24,13480.0,4,12124,0,13475.0,23,13480.0,7,B
2018-04-25 10:51:33,13480.0,4,12128,0,13475.0,23,13485.0,23,B
2018-04-25 10:52:13,13480.0,14,12142,-2,13475.0,23,13485.0,24,B
2018-04-25 10:52:47,13475.0,12,12154,4,13475.0,11,13480.0,25,S
2018-04-25 10:52:47,13475.0,2,12156,0,13475.0,10,13480.0,25,S
2018-04-25 10:52:55,13475.0,2,12158,0,13475.0,9,13480.0,26,S
2018-04-25 10:53:02,13475.0,4,12162,4,13475.0,6,13480.0,24,S
2018-04-25 10:53:13,13475.0,10,12172,10,13475.0,1,13480.0,20,S
2018-04-25 10:53:13,13475.0,2,12174,2,13470.0,7,13475.0,13,S
2018-04-25 10:53:18,13475.0,2,12176,-2,13470.0,10,13475.0,2,S
2018-04-25 10:53:18,13475.0,4,12180,2,13470.0,10,13480.0,15,S
2018-04-25 10:54:06,13475.0,2,12182,-2,13475.0,2,13480.0,24,S
2018-04-25 10:54:06,13475.0,4,12186,-4,13470.0,11,13480.0,24,S
2018-04-25 10:54:42,13475.0,4,12190,0,13475.0,2,13480.0,18,S
2018-04-25 10:55:08,13480.0,10,12200,8,13475.0,22,13485.0,10,B
2018-04-25 10:55:10,13475.0,4,12204,2,13475.0,7,13485.0,21,S
2018-04-25 10:55:26,13480.0,6,12210,4,13480.0,2,13485.0,15,B
2018-04-25 10:55:32,13485.0,16,12226,4,13480.0,11,13490.0,16,B
2018-04-25 10:55:57,13485.0,4,12230,0,13480.0,4,13485.0,1,B
2018-04-25 10:56:24,13480.0,8,12238,6,13475.0,21,13485.0,2,S
2018-04-25 10:56:30,13475.0,8,12246,-2,13470.0,12,13480.0,13,S
2018-04-25 10:56:57,13480.0,10,12256,10,13475.0,4,13480.0,1,B
2018-04-25 10:57:40,13475.0,4,12260,-4,13470.0,13,13480.0,12,S
2018-04-25 10:57:57,13470.0,2,12262,0,13470.0,13,13480.0,13,S
2018-04-25 10:58:12,13470.0,2,12264,-2,13470.0,10,13480.0,13,S
2018-04-25 10:59:49,13480.0,2,12266,-2,13475.0,12,13480.0,10,B
2018-04-25 10:59:50,13480.0,2,12268,-2,13475.0,12,13480.0,9,B
2018-04-25 11:00:46,13475.0,6,12274,0,13470.0,14,13475.0,1,S
2018-04-25 11:01:18,13475.0,4,12278,4,13470.0,10,13480.0,18,S
2018-04-25 11:01:20,13470.0,2,12280,0,13470.0,9,13480.0,18,S
2018-04-25 11:01:47,13470.0,2,12282,-2,13470.0,8,13475.0,1,S
2018-04-25 11:02:17,13475.0,2,12284,2,13470.0,8,13475.0,1,B
2018-04-25 11:03:27,13470.0,6,12290,-6,13470.0,5,13475.0,2,S
2018-04-25 11:03:47,13475.0,2,12292,0,13475.0,2,13480.0,21,B
2018-04-25 11:03:47,13475.0,4,12296,2,13470.0,14,13480.0,21,B
2018-04-25 11:04:05,13475.0,2,12298,0,13475.0,1,13480.0,18,B
2018-04-25 11:06:12,13475.0,4,12302,0,13475.0,3,13480.0,13,B
2018-04-25 11:06:18,13480.0,2,12304,-2,13475.0,3,13480.0,12,B
2018-04-25 11:07:29,13475.0,10,12314,10,13475.0,6,13480.0,6,S
2018-04-25 11:07:59,13480.0,6,12320,6,13475.0,6,13480.0,3,B
2018-04-25 11:08:03,13475.0,10,12330,10,13475.0,1,13480.0,6,S
2018-04-25 11:08:51,13480.0,10,12340,2,13480.0,1,13485.0,13,B
2018-04-25 11:08:51,13485.0,14,12354,0,13485.0,1,13490.0,22,B
2018-04-25 11:08:52,13485.0,2,12356,0,13485.0,5,13490.0,20,B
2018-04-25 11:08:57,13490.0,2,12358,0,13485.0,10,13490.0,14,B
2018-04-25 11:08:58,13490.0,28,12386,16,13490.0,1,13495.0,15,B
2018-04-25 11:08:59,13495.0,28,12414,-4,13495.0,1,13500.0,36,B
2018-04-25 11:08:59,13500.0,4,12418,-2,13495.0,5,13500.0,33,B
2018-04-25 11:09:00,13500.0,60,12478,42,13500.0,1,13505.0,19,B
2018-04-25 11:09:01,13500.0,6,12484,0,13500.0,7,13505.0,16,B
2018-04-25 11:09:01,13500.0,14,12498,2,13495.0,10,13505.0,26,B
2018-04-25 11:09:04,13495.0,4,12502,-4,13490.0,8,13500.0,9,S
2018-04-25 11:09:05,13495.0,8,12510,-4,13490.0,4,13495.0,5,S
2018-04-25 11:09:05,13495.0,10,12520,4,13495.0,6,13500.0,7,S
2018-04-25 11:09:09,13495.0,4,12524,2,13490.0,20,13500.0,6,S
2018-04-25 11:09:17,13500.0,16,12540,0,13495.0,14,13505.0,20,B
2018-04-25 11:09:20,13505.0,32,12572,30,13505.0,1,13510.0,37,B
2018-04-25 11:09:20,13510.0,2,12574,0,13505.0,7,13510.0,33,B
2018-04-25 11:09:21,13505.0,4,12578,0,13500.0,16,13510.0,34,S
2018-04-25 11:09:22,13505.0,2,12580,0,13505.0,2,13510.0,33,S
2018-04-25 11:09:23,13510.0,4,12584,2,13505.0,5,13510.0,31,B
2018-04-25 11:09:24,13505.0,6,12590,4,13505.0,2,13510.0,31,S
2018-04-25 11:09:24,13505.0,2,12592,0,13505.0,5,13510.0,31,S
2018-04-25 11:09:28,13510.0,4,12596,0,13505.0,7,13510.0,29,B
2018-04-25 11:09:31,13505.0,2,12598,2,13500.0,29,13505.0,3,S
2018-04-25 11:09:35,13505.0,4,12602,-2,13505.0,1,13510.0,34,S
2018-04-25 11:09:38,13510.0,2,12604,0,13505.0,9,13510.0,31,B
2018-04-25 11:09:40,13510.0,2,12606,2,13505.0,9,13510.0,30,B
2018-04-25 11:09:44,13510.0,8,12614,4,13505.0,11,13510.0,26,B
2018-04-25 11:09:45,13510.0,52,12666,30,13510.0,2,13515.0,17,B
2018-04-25 11:09:45,13515.0,18,12684,-8,13510.0,6,13515.0,7,B
2018-04-25 11:09:46,13515.0,12,12696,2,13515.0,8,13520.0,29,B
2018-04-25 11:09:46,13520.0,2,12698,0,13515.0,11,13520.0,27,B
2018-04-25 11:09:47,13520.0,30,12728,6,13515.0,20,13520.0,10,B
2018-04-25 11:09:47,13520.0,2,12730,0,13515.0,34,13520.0,9,B
2018-04-25 11:09:50,13520.0,16,12746,4,13515.0,21,13520.0,2,B
2018-04-25 11:09:51,13520.0,6,12752,2,13520.0,2,13525.0,8,B
2018-04-25 11:09:51,13520.0,4,12756,0,13515.0,21,13520.0,5,B
2018-04-25 11:09:53,13520.0,2,12758,-2,13515.0,20,13520.0,3,B
2018-04-25 11:09:56,13520.0,2,12760,2,13515.0,9,13520.0,5,B
2018-04-25 11:09:56,13515.0,20,12780,-8,13510.0,24,13520.0,14,S
2018-04-25 11:09:57,13515.0,10,12790,2,13510.0,3,13515.0,5,S
2018-04-25 11:09:58,13520.0,16,12806,6,13510.0,4,13520.0,14,B
2018-04-25 11:09:59,13515.0,2,12808,0,13510.0,7,13520.0,14,S
2018-04-25 11:10:01,13515.0,4,12812,-4,13515.0,3,13520.0,5,S
2018-04-25 11:10:01,13520.0,4,12816,-2,13515.0,7,13520.0,1,B
2018-04-25 11:10:09,13520.0,6,12822,-4,13515.0,11,13525.0,26,B
2018-04-25 11:10:10,13520.0,2,12824,0,13515.0,17,13520.0,4,B
2018-04-25 11:10:10,13515.0,28,12852,-18,13510.0,28,13515.0,1,S
2018-04-25 11:10:11,13515.0,32,12884,20,13505.0,21,13515.0,5,S
2018-04-25 11:10:12,13510.0,6,12890,6,13510.0,4,13515.0,7,S
2018-04-25 11:10:12,13510.0,4,12894,0,13505.0,31,13510.0,1,S
2018-04-25 11:10:17,13505.0,4,12898,-2,13510.0,1,13515.0,8,S
2018-04-25 11:10:25,13510.0,2,12900,2,13510.0,5,13515.0,5,B
2018-04-25 11:10:33,13515.0,2,12902,2,13510.0,5,13515.0,1,B
2018-04-25 11:10:40,13510.0,4,12906,-4,13505.0,30,13515.0,8,S
2018-04-25 11:10:47,13510.0,2,12908,-2,13505.0,43,13515.0,8,S
2018-04-25 11:10:49,13515.0,2,12910,-2,13510.0,43,13515.0,3,B
2018-04-25 11:10:57,13515.0,2,12912,0,13510.0,32,13515.0,3,B
2018-04-25 11:11:01,13515.0,2,12914,0,13510.0,20,13515.0,2,B
2018-04-25 11:11:03,13515.0,2,12916,2,13510.0,20,13515.0,1,B
2018-04-25 11:11:03,13515.0,2,12918,2,13510.0,20,13520.0,15,B
2018-04-25 11:11:08,13515.0,2,12920,0,13510.0,15,13515.0,1,B
2018-04-25 11:11:09,13515.0,2,12922,2,13510.0,17,13520.0,18,B
2018-04-25 11:11:10,13515.0,2,12924,0,13510.0,16,13520.0,17,B
2018-04-25 11:11:12,13520.0,16,12940,10,13510.0,19,13520.0,9,B
2018-04-25 11:11:13,13510.0,2,12942,0,13510.0,18,13520.0,9,S
2018-04-25 11:11:22,13510.0,2,12944,-2,13510.0,7,13515.0,2,S
2018-04-25 11:11:29,13510.0,2,12946,0,13510.0,4,13515.0,4,S
2018-04-25 11:11:34,13510.0,6,12952,0,13505.0,9,13510.0,10,S
2018-04-25 11:11:35,13505.0,6,12958,2,13500.0,35,13510.0,10,S
2018-04-25 11:11:36,13505.0,4,12962,-4,13500.0,45,13510.0,8,S
2018-04-25 11:11:37,13515.0,36,12998,16,13505.0,1,13520.0,23,B
2018-04-25 11:11:38,13510.0,2,13000,0,13505.0,11,13510.0,3,S
2018-04-25 11:11:51,13510.0,2,13002,0,13510.0,10,13515.0,7,S
2018-04-25 11:12:09,13510.0,2,13004,0,13510.0,10,13515.0,8,S
2018-04-25 11:12:31,13515.0,16,13020,-4,13510.0,1,13515.0,2,B
2018-04-25 11:12:37,13515.0,4,13024,-4,13510.0,25,13520.0,13,B
2018-04-25 11:12:42,13515.0,2,13026,2,13510.0,3,13515.0,1,B
2018-04-25 11:12:52,13510.0,2,13028,2,13510.0,1,13515.0,9,S
2018-04-25 11:13:06,13510.0,2,13030,0,13505.0,14,13515.0,23,S
2018-04-25 11:13:08,13505.0,2,13032,0,13505.0,13,13515.0,23,S
2018-04-25 11:13:11,13515.0,46,13078,14,13510.0,14,13520.0,10,B
2018-04-25 11:13:11,13515.0,2,13080,2,13515.0,2,13520.0,10,B
2018-04-25 11:13:12,13520.0,2,13082,0,13515.0,14,13520.0,6,B
2018-04-25 11:13:13,13515.0,2,13084,0,13515.0,13,13520.0,6,S
2018-04-25 11:13:17,13515.0,2,13086,2,13510.0,12,13515.0,13,S
2018-04-25 11:13:18,13515.0,4,13090,4,13510.0,14,13515.0,11,S
2018-04-25 11:13:24,13510.0,8,13098,4,13510.0,8,13515.0,11,S
2018-04-25 11:13:30,13510.0,10,13108,0,13510.0,8,13515.0,11,S
2018-04-25 11:13:31,13515.0,2,13110,2,13510.0,29,13515.0,10,B
2018-04-25 11:13:33,13515.0,2,13112,2,13510.0,17,13515.0,9,B
2018-04-25 11:13:34,13515.0,10,13122,0,13510.0,11,13515.0,4,B
2018-04-25 11:13:34,13515.0,8,13130,0,13510.0,12,13520.0,13,B
2018-04-25 11:13:38,13515.0,8,13138,0,13515.0,1,13520.0,8,B
2018-04-25 11:13:39,13515.0,4,13142,-2,13510.0,14,13520.0,8,B
2018-04-25 11:13:46,13520.0,2,13144,2,13515.0,3,13520.0,7,B
2018-04-25 11:13:48,13515.0,2,13146,2,13515.0,3,13520.0,7,S
2018-04-25 11:13:55,13515.0,6,13152,0,13515.0,1,13520.0,12,S
2018-04-25 11:13:55,13515.0,2,13154,-2,13510.0,12,13515.0,4,S
2018-04-25 11:14:09,13515.0,2,13156,2,13510.0,5,13515.0,3,S
2018-04-25 11:14:10,13510.0,10,13166,-2,13505.0,9,13515.0,15,S
2018-04-25 11:14:20,13510.0,4,13170,4,13505.0,13,13515.0,15,S
2018-04-25 11:14:49,13515.0,14,13184,8,13515.0,1,13520.0,11,B
2018-04-25 11:14:51,13520.0,2,13186,0,13515.0,6,13520.0,4,B
2018-04-25 11:14:52,13520.0,4,13190,4,13515.0,6,13520.0,2,B
2018-04-25 11:14:52,13520.0,4,13194,4,13520.0,4,13525.0,11,B
2018-04-25 11:15:00,13525.0,2,13196,2,13520.0,5,13525.0,4,B
2018-04-25 11:15:01,13525.0,8,13204,2,13525.0,4,13530.0,18,B
2018-04-25 11:15:05,13525.0,14,13218,-6,13520.0,15,13525.0,1,B
2018-04-25 11:15:06,13520.0,4,13222,0,13515.0,27,13520.0,2,S
2018-04-25 11:15:09,13520.0,2,13224,0,13515.0,4,13525.0,20,S
2018-04-25 11:15:11,13520.0,2,13226,0,13515.0,12,13525.0,20,S
2018-04-25 11:15:14,13520.0,2,13228,-2,13515.0,2,13520.0,6,S
2018-04-25 11:15:14,13515.0,4,13232,0,13510.0,2,13520.0,9,S
2018-04-25 11:15:15,13515.0,2,13234,-2,13510.0,6,13520.0,11,S
2018-04-25 11:15:22,13515.0,2,13236,0,13510.0,32,13520.0,8,S
2018-04-25 11:15:34,13510.0,2,13238,2,13510.0,22,13515.0,1,S
2018-04-25 11:15:39,13515.0,2,13240,0,13515.0,3,13520.0,8,B
2018-04-25 11:15:45,13515.0,2,13242,-2,13515.0,11,13520.0,1,B
2018-04-25 11:15:50,13515.0,2,13244,0,13515.0,11,13520.0,3,B
2018-04-25 11:15:59,13515.0,2,13246,0,13515.0,10,13520.0,3,B
2018-04-25 11:16:08,13515.0,2,13248,0,13510.0,17,13520.0,6,B
2018-04-25 11:17:01,13515.0,2,13250,0,13510.0,28,13515.0,6,B
2018-04-25 11:17:02,13515.0,2,13252,0,13510.0,28,13515.0,5,B
2018-04-25 11:17:05,13510.0,2,13254,0,13510.0,17,13515.0,5,S
2018-04-25 11:17:21,13515.0,12,13266,-8,13510.0,11,13520.0,12,B
2018-04-25 11:17:28,13515.0,2,13268,2,13515.0,4,13520.0,4,B
2018-04-25 11:17:33,13515.0,2,13270,0,13515.0,13,13520.0,4,B
2018-04-25 11:17:34,13520.0,4,13274,2,13515.0,13,13520.0,2,B
2018-04-25 11:17:43,13515.0,6,13280,0,13510.0,13,13515.0,7,S
2018-04-25 11:17:43,13515.0,14,13294,8,13515.0,9,13520.0,2,S
2018-04-25 11:17:54,13515.0,2,13296,2,13515.0,12,13520.0,8,S
2018-04-25 11:17:57,13520.0,2,13298,0,13515.0,12,13520.0,6,B
2018-04-25 11:18:03,13520.0,2,13300,2,13515.0,14,13520.0,3,B
2018-04-25 11:18:08,13515.0,10,13310,-2,13515.0,7,13520.0,10,S
2018-04-25 11:18:08,13515.0,14,13324,0,13510.0,7,13515.0,12,S
2018-04-25 11:18:18,13515.0,2,13326,2,13510.0,5,13515.0,10,S
2018-04-25 11:18:20,13510.0,2,13328,-2,13510.0,4,13515.0,10,S
2018-04-25 11:18:56,13515.0,2,13330,2,13510.0,4,13515.0,7,B
2018-04-25 11:19:03,13515.0,14,13344,10,13515.0,3,13520.0,12,B
2018-04-25 11:19:03,13515.0,6,13350,0,13510.0,8,13515.0,1,B
2018-04-25 11:19:15,13515.0,4,13354,4,13515.0,1,13520.0,14,B
2018-04-25 11:19:16,13515.0,2,13356,0,13510.0,6,13520.0,14,B
2018-04-25 11:19:31,13510.0,2,13358,0,13510.0,2,13515.0,3,S
2018-04-25 11:19:38,13505.0,2,13360,2,13505.0,4,13510.0,4,S
2018-04-25 11:19:45,13510.0,8,13368,8,13510.0,6,13515.0,22,B
2018-04-25 11:19:45,13510.0,10,13378,6,13510.0,1,13515.0,22,B
2018-04-25 11:19:46,13510.0,2,13380,2,13505.0,5,13515.0,22,B
2018-04-25 11:19:50,13510.0,2,13382,2,13510.0,1,13515.0,22,B
2018-04-25 11:19:50,13510.0,2,13384,0,13505.0,5,13510.0,1,B
2018-04-25 11:20:01,13515.0,10,13394,2,13505.0,5,13515.0,17,B
2018-04-25 11:20:04,13510.0,2,13396,2,13510.0,2,13515.0,17,S
2018-04-25 11:20:05,13515.0,16,13412,-8,13515.0,1,13520.0,12,B
2018-04-25 11:20:14,13520.0,8,13420,2,13520.0,1,13525.0,15,B
2018-04-25 11:20:19,13520.0,2,13422,2,13515.0,9,13520.0,4,B
2018-04-25 11:20:25,13520.0,8,13430,8,13520.0,1,13525.0,18,B
2018-04-25 11:20:25,13520.0,2,13432,0,13515.0,7,13525.0,18,B
2018-04-25 11:20:37,13525.0,10,13442,0,13515.0,11,13525.0,13,B
2018-04-25 11:21:05,13515.0,2,13444,2,13515.0,8,13520.0,10,S
2018-04-25 11:21:08,13520.0,2,13446,2,13515.0,8,13520.0,9,B
2018-04-25 11:21:25,13520.0,10,13456,10,13515.0,8,13520.0,5,B
2018-04-25 11:21:46,13515.0,8,13464,8,13510.0,12,13515.0,2,S
2018-04-25 11:21:46,13515.0,2,13466,0,13510.0,14,13515.0,1,S
2018-04-25 11:21:47,13515.0,2,13468,0,13515.0,2,13520.0,10,S
2018-04-25 11:21:52,13515.0,2,13470,0,13515.0,1,13520.0,9,S
2018-04-25 11:21:56,13515.0,2,13472,-2,13515.0,1,13520.0,9,S
2018-04-25 11:22:28,13515.0,8,13480,0,13510.0,25,13515.0,1,S
2018-04-25 11:23:00,13510.0,2,13482,0,13510.0,3,13515.0,3,S
2018-04-25 11:23:11,13510.0,2,13484,0,13510.0,3,13515.0,3,S
2018-04-25 11:23:33,13515.0,8,13492,-6,13515.0,1,13520.0,16,B
2018-04-25 11:23:33,13515.0,2,13494,-2,13510.0,3,13515.0,1,B
2018-04-25 11:24:01,13515.0,2,13496,0,13515.0,6,13520.0,9,B
2018-04-25 11:24:02,13515.0,12,13508,4,13510.0,29,13515.0,6,B
2018-04-25 11:24:27,13515.0,16,13524,6,13510.0,21,13515.0,2,B
2018-04-25 11:24:33,13515.0,4,13528,2,13515.0,4,13520.0,12,B
2018-04-25 11:24:49,13515.0,8,13536,2,13510.0,5,13515.0,1,B
2018-04-25 11:24:50,13510.0,10,13546,4,13505.0,17,13515.0,4,S
2018-04-25 11:25:02,13510.0,12,13558,12,13505.0,5,13515.0,8,S
2018-04-25 11:25:14,13515.0,2,13560,0,13510.0,11,13520.0,15,B
2018-04-25 11:25:23,13515.0,8,13568,4,13510.0,7,13520.0,17,B
2018-04-25 11:25:28,13510.0,2,13570,0,13510.0,6,13520.0,17,S
2018-04-25 11:25:36,13515.0,2,13572,-2,13515.0,2,13520.0,11,B
2018-04-25 11:25:38,13515.0,2,13574,0,13515.0,1,13520.0,11,B
2018-04-25 11:25:54,13520.0,2,13576,0,13515.0,1,13520.0,12,B
2018-04-25 11:25:58,13520.0,16,13592,6,13520.0,5,13525.0,10,B
2018-04-25 11:26:01,13525.0,8,13600,8,13520.0,12,13525.0,2,B
2018-04-25 11:26:01,13525.0,4,13604,2,13525.0,3,13530.0,19,B
2018-04-25 11:26:04,13530.0,16,13620,0,13525.0,6,13530.0,8,B
2018-04-25 11:26:05,13530.0,16,13636,12,13530.0,2,13535.0,7,B
2018-04-25 11:26:05,13535.0,6,13642,0,13530.0,13,13535.0,3,B
2018-04-25 11:26:06,13535.0,2,13644,0,13530.0,3,13535.0,3,B
2018-04-25 11:26:06,13530.0,6,13650,0,13525.0,8,13535.0,13,S
2018-04-25 11:26:15,13525.0,2,13652,2,13525.0,19,13535.0,4,S
2018-04-25 11:26:18,13540.0,10,13662,8,13525.0,20,13540.0,12,B
2018-04-25 11:26:19,13540.0,14,13676,4,13530.0,3,13540.0,18,B
2018-04-25 11:26:24,13530.0,8,13684,0,13525.0,5,13535.0,11,S
2018-04-25 11:26:25,13535.0,2,13686,-2,13525.0,6,13535.0,11,B
2018-04-25 11:26:32,13530.0,10,13696,2,13530.0,2,13535.0,2,S
2018-04-25 11:26:36,13530.0,2,13698,0,13525.0,20,13535.0,5,S
2018-04-25 11:26:42,13535.0,4,13702,0,13530.0,3,13540.0,20,B
2018-04-25 11:26:44,13535.0,8,13710,-6,13530.0,26,13540.0,16,B
2018-04-25 11:26:47,13530.0,38,13748,20,13525.0,22,13535.0,5,S
2018-04-25 11:26:49,13535.0,2,13750,2,13525.0,6,13535.0,15,B
2018-04-25 11:26:56,13530.0,6,13756,-4,13525.0,5,13530.0,3,S
2018-04-25 11:27:00,13530.0,12,13768,2,13530.0,24,13535.0,16,S
2018-04-25 11:27:02,13530.0,2,13770,2,13530.0,23,13535.0,17,S
2018-04-25 11:27:06,13530.0,2,13772,2,13530.0,22,13535.0,24,S
2018-04-25 11:27:11,13535.0,34,13806,-2,13535.0,2,13540.0,21,B
2018-04-25 11:27:13,13540.0,2,13808,2,13535.0,5,13540.0,22,B
2018-04-25 11:27:14,13535.0,2,13810,0,13535.0,4,13540.0,22,S
2018-04-25 11:27:27,13535.0,2,13812,-2,13535.0,7,13540.0,24,S
2018-04-25 11:27:33,13535.0,2,13814,0,13535.0,12,13540.0,12,S
2018-04-25 11:27:42,13540.0,6,13820,6,13535.0,9,13540.0,9,B
2018-04-25 11:27:45,13540.0,20,13840,-4,13540.0,5,13545.0,19,B
2018-04-25 11:27:46,13540.0,2,13842,0,13540.0,10,13545.0,7,B
2018-04-25 11:27:54,13540.0,6,13848,-6,13540.0,16,13545.0,15,B
2018-04-25 11:27:54,13545.0,34,13882,-20,13535.0,9,13545.0,18,B
2018-04-25 11:27:55,13535.0,22,13904,2,13535.0,9,13545.0,5,S
2018-04-25 11:28:10,13545.0,2,13906,0,13535.0,9,13545.0,5,B
2018-04-25 11:28:15,13545.0,2,13908,2,13535.0,9,13545.0,5,B
2018-04-25 11:28:15,13550.0,4,13912,2,13535.0,9,13545.0,5,B
2018-04-25 11:28:16,13550.0,4,13916,-4,13535.0,9,13545.0,5,B
2018-04-25 11:28:17,13545.0,2,13918,0,13535.0,9,13545.0,5,S
2018-04-25 11:28:17,13545.0,2,13920,2,13535.0,9,13545.0,5,S
2018-04-25 11:28:18,13545.0,2,13922,2,13535.0,9,13545.0,5,S
2018-04-25 11:28:19,13545.0,2,13924,2,13535.0,9,13545.0,5,S
2018-04-25 11:28:20,13545.0,2,13926,0,13535.0,9,13545.0,5,S
2018-04-25 11:28:21,13545.0,4,13930,-4,13535.0,9,13545.0,5,S
2018-04-25 11:28:21,13545.0,2,13932,2,13535.0,9,13545.0,5,S
2018-04-25 11:28:22,13545.0,4,13936,-4,13535.0,9,13545.0,5,S
2018-04-25 11:28:22,13545.0,2,13938,0,13535.0,9,13545.0,5,S
2018-04-25 11:28:25,13550.0,2,13940,2,13535.0,9,13545.0,5,B
2018-04-25 11:28:26,13545.0,2,13942,2,13535.0,9,13545.0,5,S
2018-04-25 11:28:27,13545.0,10,13952,10,13535.0,9,13545.0,5,S
2018-04-25 11:28:28,13545.0,2,13954,-2,13535.0,9,13545.0,5,S
2018-04-25 11:28:33,13545.0,2,13956,2,13535.0,9,13545.0,5,S
2018-04-25 11:28:40,13545.0,2,13958,0,13535.0,9,13545.0,5,S
2018-04-25 11:28:42,13545.0,12,13970,8,13535.0,9,13545.0,5,S
2018-04-25 11:28:45,13545.0,2,13972,0,13535.0,9,13545.0,5,S
2018-04-25 11:28:47,13545.0,2,13974,2,13535.0,9,13545.0,5,S
2018-04-25 11:28:48,13545.0,2,13976,2,13535.0,9,13545.0,5,S
2018-04-25 11:28:53,13540.0,4,13980,4,13535.0,9,13545.0,5,S
2018-04-25 11:29:04,13540.0,2,13982,0,13535.0,9,13545.0,5,S
2018-04-25 11:29:04,13540.0,4,13986,0,13535.0,9,13545.0,5,S
2018-04-25 11:29:05,13540.0,2,13988,0,13535.0,9,13545.0,5,S
2018-04-25 11:29:06,13545.0,2,13990,0,13535.0,9,13545.0,5,B
2018-04-25 11:29:10,13540.0,2,13992,2,13535.0,9,13545.0,5,S
2018-04-25 11:29:19,13545.0,2,13994,0,13535.0,9,13545.0,5,B
2018-04-25 11:29:23,13545.0,12,14006,0,13535.0,9,13545.0,5,B
2018-04-25 11:29:25,13545.0,6,14012,6,13535.0,9,13545.0,5,B
2018-04-25 11:29:26,13545.0,2,14014,2,13535.0,9,13545.0,5,B
2018-04-25 11:29:26,13545.0,2,14016,-2,13535.0,9,13545.0,5,B
2018-04-25 11:29:27,13550.0,2,14018,0,13535.0,9,13545.0,5,B
2018-04-25 11:29:30,13540.0,6,14024,0,13535.0,9,13545.0,5,S
2018-04-25 11:29:31,13545.0,2,14026,0,13535.0,9,13545.0,5,B
2018-04-25 11:29:31,13550.0,2,14028,2,13535.0,9,13545.0,5,B
2018-04-25 11:29:33,13550.0,10,14038,-4,13535.0,9,13545.0,5,B
2018-04-25 11:29:33,13550.0,12,14050,0,13535.0,9,13545.0,5,B
2018-04-25 11:29:37,13550.0,4,14054,4,13535.0,9,13545.0,5,B
2018-04-25 11:29:37,13550.0,2,14056,0,13535.0,9,13545.0,5,B
2018-04-25 11:29:38,13545.0,2,14058,2,13535.0,9,13545.0,5,S
2018-04-25 11:29:39,13545.0,4,14062,4,13535.0,9,13545.0,5,S
2018-04-25 11:29:54,13550.0,4,14066,0,13545.0,35,13550.0,13,B
2018-04-25 11:29:54,13550.0,62,14128,40,13550.0,9,13560.0,19,B
2018-04-25 13:30:00,13555.0,38,14166,2,13545.0,8,13555.0,2,B
2018-04-25 13:30:01,13560.0,54,14220,-22,13560.0,6,13565.0,4,B
2018-04-25 13:30:01,13555.0,18,14238,-12,13555.0,2,13560.0,12,S
2018-04-25 13:30:02,13555.0,4,14242,2,13550.0,5,13555.0,1,S
2018-04-25 13:30:02,13550.0,10,14252,10,13545.0,8,13555.0,8,S
2018-04-25 13:30:03,13545.0,12,14264,10,13540.0,5,13545.0,1,S
2018-04-25 13:30:03,13545.0,4,14268,-2,13545.0,1,13550.0,3,S
2018-04-25 13:30:04,13545.0,6,14274,2,13540.0,19,13545.0,5,S
2018-04-25 13:30:04,13550.0,22,14296,8,13545.0,2,13550.0,6,B
2018-04-25 13:30:06,13550.0,14,14310,12,13545.0,2,13550.0,1,B
2018-04-25 13:30:09,13555.0,4,14314,0,13545.0,5,13555.0,9,B
2018-04-25 13:30:10,13545.0,6,14320,6,13545.0,2,13550.0,3,S
2018-04-25 13:30:11,13545.0,4,14324,0,13540.0,5,13550.0,7,S
2018-04-25 13:30:13,13545.0,6,14330,4,13540.0,3,13545.0,2,S
2018-04-25 13:30:14,13550.0,10,14340,-4,13540.0,5,13550.0,5,B
2018-04-25 13:30:15,13540.0,10,14350,-4,13535.0,14,13540.0,10,S
2018-04-25 13:30:15,13540.0,12,14362,-12,13535.0,16,13540.0,4,S
2018-04-25 13:30:16,13540.0,8,14370,-8,13535.0,17,13545.0,3,S
2018-04-25 13:30:18,13545.0,2,14372,0,13535.0,24,13545.0,4,B
2018-04-25 13:30:21,13545.0,4,14376,0,13545.0,1,13550.0,2,B
2018-04-25 13:30:21,13545.0,2,14378,-2,13545.0,7,13550.0,4,B
2018-04-25 13:30:23,13550.0,2,14380,0,13545.0,9,13550.0,4,B
2018-04-25 13:30:28,13555.0,22,14402,6,13550.0,2,13555.0,17,B
2018-04-25 13:30:28,13550.0,4,14406,0,13545.0,3,13550.0,10,S
2018-04-25 13:30:35,13545.0,6,14412,6,13540.0,4,13550.0,8,S
2018-04-25 13:30:37,13545.0,2,14414,2,13540.0,5,13545.0,3,S
2018-04-25 13:30:41,13540.0,6,14420,0,13540.0,3,13545.0,3,S
2018-04-25 13:30:41,13540.0,6,14426,-4,13535.0,4,13545.0,3,S
2018-04-25 13:30:49,13540.0,4,14430,0,13540.0,3,13545.0,3,S
2018-04-25 13:30:51,13545.0,4,14434,0,13540.0,5,13545.0,1,B
2018-04-25 13:30:52,13545.0,2,14436,0,13545.0,6,13550.0,6,B
2018-04-25 13:30:53,13545.0,6,14442,2,13540.0,6,13550.0,5,B
2018-04-25 13:31:03,13545.0,6,14448,0,13540.0,5,13545.0,1,B
2018-04-25 13:31:03,13545.0,2,14450,-2,13540.0,5,13550.0,7,B
2018-04-25 13:31:10,13545.0,2,14452,0,13545.0,1,13550.0,8,B
2018-04-25 13:31:10,13545.0,2,14454,0,13545.0,4,13550.0,6,B
2018-04-25 13:31:12,13550.0,14,14468,4,13550.0,5,13555.0,4,B
2018-04-25 13:31:14,13550.0,2,14470,2,13550.0,7,13555.0,2,B
2018-04-25 13:31:17,13555.0,6,14476,2,13555.0,2,13560.0,9,B
2018-04-25 13:31:18,13555.0,4,14480,0,13550.0,3,13555.0,13,B
2018-04-25 13:31:19,13555.0,12,14492,0,13550.0,7,13555.0,1,B
2018-04-25 13:31:20,13555.0,2,14494,0,13555.0,4,13560.0,11,B
2018-04-25 13:31:20,13555.0,8,14502,-4,13550.0,14,13555.0,3,B
2018-04-25 13:31:21,13555.0,6,14508,0,13550.0,14,13555.0,3,B
2018-04-25 13:31:22,13555.0,6,14514,4,13555.0,2,13560.0,7,B
2018-04-25 13:31:23,13560.0,4,14518,0,13555.0,9,13565.0,5,B
2018-04-25 13:31:25,13560.0,4,14522,4,13555.0,17,13565.0,4,B
2018-04-25 13:31:26,13565.0,6,14528,-2,13565.0,2,13570.0,7,B
2018-04-25 13:31:26,13565.0,12,14540,0,13560.0,13,13570.0,7,B
2018-04-25 13:31:31,13570.0,2,14542,2,13560.0,18,13565.0,2,B
2018-04-25 13:31:31,13570.0,2,14544,0,13560.0,15,13565.0,2,B
2018-04-25 13:31:33,13565.0,4,14548,2,13560.0,10,13570.0,10,S
2018-04-25 13:31:37,13560.0,6,14554,2,13555.0,5,13560.0,1,S
2018-04-25 13:31:38,13560.0,4,14558,0,13560.0,1,13565.0,8,S
2018-04-25 13:31:38,13560.0,2,14560,0,13555.0,6,13560.0,2,S
2018-04-25 13:31:44,13565.0,2,14562,0,13560.0,10,13565.0,10,B
2018-04-25 13:31:45,13560.0,12,14574,2,13560.0,6,13565.0,10,S
2018-04-25 13:31:45,13560.0,12,14586,12,13555.0,6,13565.0,10,S
2018-04-25 13:31:46,13560.0,2,14588,0,13555.0,6,13565.0,10,S
2018-04-25 13:31:48,13560.0,2,14590,-2,13560.0,1,13565.0,12,S
2018-04-25 13:31:52,13565.0,2,14592,2,13560.0,7,13565.0,1,B
2018-04-25 13:31:53,13565.0,2,14594,0,13560.0,7,13570.0,9,B
2018-04-25 13:31:54,13560.0,2,14596,2,13560.0,6,13570.0,11,S
2018-04-25 13:31:56,13560.0,4,14600,4,13560.0,4,13570.0,17,S
2018-04-25 13:31:58,13565.0,2,14602,2,13560.0,5,13565.0,9,B
2018-04-25 13:31:58,13565.0,18,14620,12,13560.0,8,13570.0,6,B
2018-04-25 13:32:01,13570.0,14,14634,-6,13570.0,1,13575.0,3,B
2018-04-25 13:32:02,13575.0,6,14640,0,13575.0,11,13580.0,8,B
2018-04-25 13:32:02,13580.0,26,14666,12,13580.0,15,13590.0,6,B
2018-04-25 13:32:03,13580.0,4,14670,0,13580.0,5,13590.0,7,B
2018-04-25 13:32:03,13580.0,10,14680,-4,13575.0,11,13585.0,2,B
2018-04-25 13:32:04,13580.0,26,14706,6,13570.0,8,13580.0,7,B
2018-04-25 13:32:05,13575.0,10,14716,8,13575.0,2,13580.0,20,S
2018-04-25 13:32:07,13580.0,4,14720,2,13575.0,5,13580.0,6,B
2018-04-25 13:32:08,13575.0,4,14724,2,13575.0,3,13580.0,3,S
2018-04-25 13:32:10,13580.0,2,14726,0,13575.0,3,13580.0,3,B
2018-04-25 13:32:12,13575.0,4,14730,4,13570.0,8,13580.0,15,S
2018-04-25 13:32:13,13575.0,8,14738,4,13570.0,8,13575.0,1,S
2018-04-25 13:32:14,13570.0,16,14754,12,13565.0,42,13570.0,2,S
2018-04-25 13:32:15,13570.0,4,14758,0,13570.0,6,13575.0,2,S
2018-04-25 13:32:17,13580.0,4,14762,2,13575.0,2,13580.0,3,B
2018-04-25 13:32:17,13570.0,8,14770,0,13570.0,9,13575.0,5,S
2018-04-25 13:32:18,13570.0,6,14776,0,13570.0,6,13575.0,2,S
2018-04-25 13:32:20,13575.0,2,14778,-2,13570.0,6,13580.0,11,B
2018-04-25 13:32:21,13575.0,22,14800,-14,13575.0,3,13580.0,1,B
2018-04-25 13:32:21,13575.0,2,14802,2,13575.0,2,13580.0,3,B
2018-04-25 13:32:22,13575.0,2,14804,0,13575.0,1,13580.0,5,B
2018-04-25 13:32:24,13575.0,2,14806,0,13575.0,1,13580.0,4,B
2018-04-25 13:32:25,13580.0,2,14808,0,13570.0,13,13575.0,2,B
2018-04-25 13:32:26,13575.0,4,14812,0,13570.0,14,13580.0,7,S
2018-04-25 13:32:28,13575.0,2,14814,2,13575.0,1,13580.0,6,S
2018-04-25 13:32:31,13575.0,2,14816,-2,13575.0,1,13580.0,9,S
2018-04-25 13:32:33,13575.0,2,14818,-2,13570.0,14,13575.0,1,S
2018-04-25 13:32:34,13575.0,2,14820,0,13575.0,2,13580.0,17,S
2018-04-25 13:32:34,13575.0,4,14824,0,13570.0,14,13575.0,1,S
2018-04-25 13:32:35,13575.0,2,14826,0,13570.0,14,13580.0,20,S
2018-04-25 13:32:35,13575.0,2,14828,2,13570.0,14,13580.0,20,S
2018-04-25 13:32:36,13570.0,2,14830,0,13570.0,13,13580.0,20,S
2018-04-25 13:32:37,13575.0,6,14836,0,13570.0,12,13575.0,1,B
2018-04-25 13:32:37,13570.0,4,14840,4,13570.0,9,13575.0,1,S
2018-04-25 13:32:38,13570.0,18,14858,14,13565.0,35,13570.0,1,S
2018-04-25 13:32:39,13570.0,2,14860,2,13565.0,8,13570.0,4,S
2018-04-25 13:32:40,13570.0,8,14868,-8,13570.0,1,13575.0,4,S
2018-04-25 13:32:42,13570.0,2,14870,-2,13570.0,3,13575.0,1,S
2018-04-25 13:32:52,13580.0,16,14886,16,13575.0,11,13580.0,5,B
2018-04-25 13:32:53,13580.0,10,14896,8,13575.0,23,13580.0,1,B
2018-04-25 13:32:54,13575.0,4,14900,2,13575.0,3,13580.0,1,S
2018-04-25 13:32:54,13575.0,4,14904,0,13575.0,2,13580.0,2,S
2018-04-25 13:32:58,13580.0,2,14906,0,13575.0,4,13580.0,2,B
2018-04-25 13:32:59,13580.0,2,14908,0,13575.0,11,13580.0,1,B
2018-04-25 13:32:59,13580.0,4,14912,2,13575.0,23,13580.0,9,B
2018-04-25 13:33:00,13585.0,22,14934,10,13580.0,18,13585.0,9,B
2018-04-25 13:33:00,13590.0,24,14958,0,13585.0,9,13590.0,3,B
2018-04-25 13:33:01,13595.0,10,14968,-6,13585.0,8,13595.0,8,B
2018-04-25 13:33:01,13595.0,2,14970,-2,13590.0,5,13595.0,7,B
2018-04-25 13:33:02,13600.0,18,14988,6,13595.0,1,13600.0,12,B
2018-04-25 13:33:02,13600.0,8,14996,0,13595.0,6,13600.0,8,B
2018-04-25 13:33:03,13595.0,4,15000,2,13595.0,4,13600.0,8,S
2018-04-25 13:33:04,13600.0,4,15004,0,13595.0,12,13600.0,6,B
2018-04-25 13:33:04,13600.0,10,15014,8,13595.0,26,13600.0,1,B
2018-04-25 13:33:05,13595.0,2,15016,0,13595.0,7,13600.0,1,S
2018-04-25 13:33:06,13595.0,2,15018,0,13595.0,24,13600.0,1,S
2018-04-25 13:33:07,13600.0,6,15024,4,13595.0,22,13610.0,2,B
2018-04-25 13:33:08,13605.0,6,15030,6,13605.0,2,13610.0,4,B
2018-04-25 13:33:08,13600.0,8,15038,0,13600.0,21,13605.0,12,S
2018-04-25 13:33:09,13605.0,2,15040,0,13600.0,1,13605.0,20,B
2018-04-25 13:33:09,13600.0,2,15042,0,13595.0,16,13600.0,1,S
2018-04-25 13:33:11,13605.0,20,15062,18,13590.0,25,13605.0,3,B
2018-04-25 13:33:12,13595.0,6,15068,4,13590.0,5,13595.0,5,S
2018-04-25 13:33:14,13595.0,4,15072,-4,13590.0,3,13595.0,7,S
2018-04-25 13:33:14,13595.0,6,15078,0,13590.0,2,13595.0,4,S
2018-04-25 13:33:15,13595.0,4,15082,2,13590.0,2,13595.0,2,S
2018-04-25 13:33:17,13590.0,16,15098,4,13585.0,21,13595.0,7,S
2018-04-25 13:33:18,13600.0,2,15100,-2,13595.0,3,13600.0,2,B
2018-04-25 13:33:19,13600.0,2,15102,0,13595.0,10,13605.0,9,B
2018-04-25 13:33:21,13600.0,16,15118,0,13600.0,9,13610.0,26,B
2018-04-25 13:33:22,13610.0,8,15126,4,13605.0,11,13610.0,19,B
2018-04-25 13:33:23,13605.0,22,15148,18,13600.0,15,13605.0,9,S
2018-04-25 13:33:23,13600.0,10,15158,10,13600.0,14,13605.0,2,S
2018-04-25 13:33:24,13600.0,2,15160,-2,13600.0,3,13605.0,2,S
2018-04-25 13:33:25,13610.0,8,15168,2,13605.0,17,13610.0,25,B
2018-04-25 13:33:26,13610.0,4,15172,-4,13605.0,22,13610.0,18,B
2018-04-25 13:33:27,13605.0,16,15188,12,13605.0,9,13610.0,21,S
2018-04-25 13:33:27,13610.0,20,15208,8,13600.0,8,13610.0,22,B
2018-04-25 13:33:28,13605.0,10,15218,8,13600.0,13,13610.0,16,S
2018-04-25 13:33:30,13605.0,20,15238,-20,13605.0,2,13610.0,23,S
2018-04-25 13:33:30,13605.0,4,15242,-4,13600.0,12,13605.0,5,S
2018-04-25 13:33:32,13600.0,10,15252,-2,13595.0,9,13605.0,9,S
2018-04-25 13:33:36,13600.0,2,15254,0,13595.0,7,13605.0,9,S
2018-04-25 13:33:40,13600.0,8,15262,-2,13595.0,9,13605.0,10,S
2018-04-25 13:33:41,13600.0,2,15264,0,13600.0,2,13605.0,4,S
2018-04-25 13:33:45,13605.0,42,15306,24,13605.0,9,13610.0,25,B
2018-04-25 13:33:46,13600.0,22,15328,16,13600.0,2,13605.0,16,S
2018-04-25 13:33:47,13600.0,2,15330,0,13600.0,1,13605.0,27,S
2018-04-25 13:33:47,13600.0,2,15332,2,13595.0,4,13605.0,27,S
2018-04-25 13:33:50,13600.0,2,15334,-2,13595.0,11,13605.0,11,S
2018-04-25 13:33:53,13605.0,24,15358,18,13605.0,18,13610.0,34,B
2018-04-25 13:33:53,13600.0,38,15396,6,13600.0,1,13605.0,2,S
2018-04-25 13:33:54,13605.0,18,15414,6,13605.0,3,13610.0,50,B
2018-04-25 13:33:54,13595.0,26,15440,-12,13595.0,2,13600.0,2,S
2018-04-25 13:33:55,13595.0,4,15444,0,13590.0,7,13595.0,5,S
2018-04-25 13:33:56,13595.0,2,15446,-2,13590.0,5,13595.0,1,S
2018-04-25 13:33:57,13600.0,6,15452,-6,13590.0,5,13600.0,8,B
2018-04-25 13:33:58,13600.0,12,15464,4,13600.0,4,13605.0,5,B
2018-04-25 13:33:59,13600.0,8,15472,6,13595.0,56,13605.0,11,B
2018-04-25 13:33:59,13595.0,4,15476,0,13595.0,54,13600.0,11,S
2018-04-25 13:34:02,13595.0,2,15478,0,13595.0,54,13600.0,15,S
2018-04-25 13:34:02,13600.0,16,15494,-14,13595.0,53,13600.0,8,B
2018-04-25 13:34:05,13595.0,2,15496,0,13595.0,52,13600.0,10,S
2018-04-25 13:34:06,13595.0,4,15500,0,13595.0,49,13600.0,13,S
2018-04-25 13:34:07,13595.0,98,15598,-52,13590.0,9,13595.0,1,S
2018-04-25 13:34:07,13595.0,4,15602,-2,13590.0,8,13600.0,17,S
2018-04-25 13:34:09,13595.0,2,15604,-2,13590.0,5,13595.0,10,S
2018-04-25 13:34:10,13595.0,2,15606,0,13590.0,54,13595.0,10,S
2018-04-25 13:34:12,13595.0,20,15626,-20,13595.0,20,13600.0,11,S
2018-04-25 13:34:13,13595.0,40,15666,-14,13590.0,58,13600.0,12,S
2018-04-25 13:34:16,13590.0,10,15676,-2,13590.0,58,13600.0,17,S
2018-04-25 13:34:21,13595.0,2,15678,0,13590.0,55,13600.0,20,B
2018-04-25 13:34:25,13595.0,2,15680,-2,13590.0,56,13600.0,22,B
2018-04-25 13:34:30,13595.0,2,15682,-2,13590.0,57,13595.0,5,B
2018-04-25 13:34:31,13595.0,6,15688,-6,13590.0,58,13595.0,3,B
2018-04-25 13:34:32,13595.0,6,15694,-4,13595.0,2,13600.0,17,B
2018-04-25 13:34:49,13595.0,2,15696,0,13595.0,6,13600.0,25,B
2018-04-25 13:34:50,13595.0,4,15700,2,13595.0,4,13600.0,26,B
2018-04-25 13:34:54,13595.0,2,15702,0,13595.0,5,13600.0,27,B
2018-04-25 13:34:54,13595.0,10,15712,2,13590.0,58,13600.0,27,B
2018-04-25 13:34:55,13595.0,4,15716,-4,13590.0,60,13600.0,27,B
2018-04-25 13:34:58,13590.0,2,15718,0,13590.0,59,13600.0,46,S
2018-04-25 13:34:58,13590.0,2,15720,2,13590.0,58,13595.0,1,S
2018-04-25 13:35:04,13590.0,2,15722,2,13590.0,51,13595.0,9,S
2018-04-25 13:35:05,13590.0,10,15732,10,13590.0,46,13595.0,5,S
2018-04-25 13:35:06,13590.0,2,15734,2,13590.0,45,13595.0,5,S
2018-04-25 13:35:09,13590.0,2,15736,0,13590.0,44,13595.0,20,S
2018-04-25 13:35:11,13590.0,4,15740,4,13590.0,42,13595.0,11,S
2018-04-25 13:35:13,13590.0,2,15742,2,13590.0,41,13595.0,11,S
2018-04-25 13:35:14,13595.0,2,15744,0,13590.0,41,13595.0,10,B
2018-04-25 13:35:17,13590.0,2,15746,0,13590.0,40,13595.0,15,S
2018-04-25 13:35:18,13590.0,18,15764,18,13590.0,31,13595.0,20,S
2018-04-25 13:35:19,13590.0,10,15774,0,13590.0,26,13595.0,21,S
2018-04-25 13:35:19,13590.0,52,15826,38,13585.0,6,13590.0,1,S
2018-04-25 13:35:20,13590.0,2,15828,0,13590.0,6,13595.0,18,S
2018-04-25 13:35:26,13590.0,2,15830,0,13590.0,5,13595.0,48,S
2018-04-25 13:35:27,13590.0,10,15840,4,13585.0,13,13590.0,1,S
2018-04-25 13:35:31,13585.0,10,15850,6,13585.0,6,13590.0,5,S
2018-04-25 13:35:31,13585.0,2,15852,-2,13585.0,6,13590.0,5,S
2018-04-25 13:35:33,13590.0,6,15858,-2,13585.0,7,13590.0,2,B
2018-04-25 13:35:34,13590.0,4,15862,0,13590.0,1,13595.0,53,B
2018-04-25 13:35:39,13595.0,2,15864,2,13590.0,4,13595.0,42,B
2018-04-25 13:35:39,13590.0,8,15872,4,13585.0,31,13590.0,5,S
2018-04-25 13:35:44,13590.0,2,15874,0,13585.0,26,13590.0,3,S
2018-04-25 13:36:01,13590.0,2,15876,0,13585.0,50,13590.0,16,S
2018-04-25 13:36:01,13585.0,50,15926,-10,13585.0,25,13590.0,17,S
2018-04-25 13:36:03,13585.0,2,15928,0,13585.0,24,13590.0,16,S
2018-04-25 13:36:06,13585.0,2,15930,0,13585.0,23,13590.0,16,S
2018-04-25 13:36:07,13585.0,2,15932,-2,13585.0,22,13590.0,16,S
2018-04-25 13:36:11,13590.0,2,15934,0,13585.0,27,13590.0,15,B
2018-04-25 13:36:14,13585.0,4,15938,-4,13585.0,25,13590.0,15,S
2018-04-25 13:36:17,13585.0,2,15940,-2,13585.0,24,13590.0,18,S
2018-04-25 13:36:22,13585.0,6,15946,-4,13585.0,21,13590.0,20,S
2018-04-25 13:36:23,13585.0,42,15988,10,13580.0,31,13585.0,13,S
2018-04-25 13:36:24,13585.0,26,16014,6,13580.0,31,13590.0,20,S
2018-04-25 13:36:25,13580.0,2,16016,-2,13580.0,35,13585.0,1,S
2018-04-25 13:36:26,13585.0,2,16018,0,13585.0,1,13590.0,20,B
2018-04-25 13:36:27,13580.0,6,16024,0,13580.0,34,13585.0,2,S
2018-04-25 13:36:27,13585.0,4,16028,-2,13585.0,2,13590.0,19,B
2018-04-25 13:36:32,13585.0,16,16044,14,13585.0,5,13590.0,8,B
2018-04-25 13:36:33,13585.0,4,16048,-4,13585.0,3,13590.0,8,B
2018-04-25 13:36:36,13590.0,2,16050,0,13585.0,3,13590.0,7,B
2018-04-25 13:36:40,13585.0,2,16052,0,13585.0,3,13590.0,8,S
2018-04-25 13:36:42,13585.0,2,16054,-2,13585.0,2,13590.0,9,S
2018-04-25 13:36:44,13585.0,2,16056,0,13585.0,1,13590.0,9,S
2018-04-25 13:36:45,13585.0,2,16058,-2,13585.0,3,13590.0,9,S
2018-04-25 13:36:53,13585.0,2,16060,0,13585.0,4,13590.0,9,S
2018-04-25 13:36:53,13590.0,2,16062,0,13585.0,4,13590.0,8,B
2018-04-25 13:36:55,13590.0,2,16064,2,13585.0,3,13590.0,8,B
2018-04-25 13:36:57,13585.0,2,16066,-2,13580.0,35,13585.0,2,S
2018-04-25 13:37:00,13585.0,4,16070,0,13580.0,32,13585.0,1,S
2018-04-25 13:37:02,13585.0,2,16072,0,13580.0,32,13590.0,16,S
2018-04-25 13:37:13,13580.0,2,16074,2,13580.0,31,13585.0,4,S
2018-04-25 13:37:14,13580.0,14,16088,10,13580.0,24,13585.0,8,S
2018-04-25 13:37:14,13580.0,32,16120,18,13580.0,7,13585.0,17,S
2018-04-25 13:37:15,13580.0,14,16134,14,13575.0,8,13580.0,1,S
2018-04-25 13:37:18,13575.0,16,16150,2,13570.0,17,13580.0,19,S
2018-04-25 13:37:22,13570.0,4,16154,4,13570.0,10,13575.0,13,S
2018-04-25 13:37:25,13575.0,12,16166,10,13575.0,2,13580.0,22,B
2018-04-25 13:37:26,13575.0,2,16168,-2,13575.0,1,13580.0,22,B
2018-04-25 13:37:27,13575.0,2,16170,-2,13570.0,19,13575.0,5,B
2018-04-25 13:37:27,13575.0,10,16180,-2,13570.0,19,13580.0,25,B
2018-04-25 13:37:29,13575.0,6,16186,4,13575.0,2,13580.0,37,B
2018-04-25 13:37:30,13575.0,4,16190,0,13570.0,11,13575.0,4,B
2018-04-25 13:37:31,13575.0,10,16200,6,13570.0,21,13580.0,38,B
2018-04-25 13:37:38,13575.0,4,16204,2,13575.0,1,13580.0,32,B
2018-04-25 13:37:39,13575.0,14,16218,8,13575.0,12,13580.0,9,B
2018-04-25 13:37:39,13580.0,12,16230,0,13575.0,13,13580.0,3,B
2018-04-25 13:37:40,13580.0,4,16234,0,13575.0,13,13580.0,1,B
2018-04-25 13:37:51,13580.0,2,16236,2,13575.0,8,13585.0,7,B
2018-04-25 13:38:07,13580.0,2,16238,0,13580.0,7,13585.0,17,B
2018-04-25 13:38:08,13580.0,4,16242,0,13580.0,5,13585.0,17,B
2018-04-25 13:38:08,13580.0,4,16246,2,13580.0,3,13585.0,17,B
2018-04-25 13:38:17,13580.0,4,16250,-2,13580.0,1,13585.0,18,B
2018-04-25 13:38:17,13580.0,2,16252,0,13575.0,9,13580.0,13,B
2018-04-25 13:38:19,13575.0,2,16254,-2,13570.0,39,13580.0,34,S
2018-04-25 13:38:34,13570.0,2,16256,0,13570.0,28,13575.0,18,S
2018-04-25 13:38:35,13570.0,2,16258,0,13570.0,27,13575.0,18,S
2018-04-25 13:38:42,13575.0,12,16270,0,13570.0,39,13575.0,6,B
2018-04-25 13:39:03,13575.0,10,16280,0,13570.0,40,13575.0,2,B
2018-04-25 13:39:09,13575.0,2,16282,2,13570.0,40,13575.0,1,B
2018-04-25 13:39:09,13575.0,2,16284,-2,13570.0,40,13580.0,17,B
2018-04-25 13:39:30,13570.0,8,16292,-6,13570.0,24,13575.0,4,S
2018-04-25 13:39:34,13570.0,2,16294,-2,13570.0,23,13575.0,17,S
2018-04-25 13:39:34,13570.0,46,16340,-10,13565.0,11,13570.0,5,S
2018-04-25 13:39:35,13565.0,10,16350,0,13565.0,5,13570.0,8,S
2018-04-25 13:39:36,13565.0,4,16354,0,13565.0,1,13570.0,13,S
2018-04-25 13:39:38,13565.0,2,16356,-2,13560.0,6,13565.0,1,S
2018-04-25 13:39:39,13565.0,8,16364,-2,13565.0,3,13570.0,11,S
2018-04-25 13:39:45,13560.0,4,16368,0,13560.0,13,13565.0,12,S
2018-04-25 13:39:47,13565.0,2,16370,2,13560.0,13,13565.0,11,B
2018-04-25 13:39:47,13560.0,6,16376,0,13560.0,10,13565.0,11,S
2018-04-25 13:39:50,13560.0,2,16378,-2,13560.0,2,13565.0,12,S
2018-04-25 13:39:51,13560.0,2,16380,0,13560.0,2,13565.0,12,S
2018-04-25 13:39:53,13560.0,2,16382,0,13560.0,1,13565.0,12,S
2018-04-25 13:39:54,13560.0,4,16386,0,13555.0,25,13565.0,12,S
2018-04-25 13:39:56,13560.0,2,16388,2,13560.0,13,13565.0,13,S
2018-04-25 13:40:00,13560.0,10,16398,0,13560.0,5,13565.0,15,S
2018-04-25 13:40:03,13560.0,2,16400,-2,13555.0,17,13565.0,14,S
2018-04-25 13:40:05,13555.0,10,16410,8,13555.0,7,13560.0,2,S
2018-04-25 13:40:06,13555.0,6,16416,-4,13555.0,3,13560.0,2,S
2018-04-25 13:40:08,13560.0,4,16420,4,13560.0,7,13565.0,22,B
2018-04-25 13:40:18,13560.0,4,16424,-4,13560.0,7,13565.0,16,B
2018-04-25 13:40:21,13560.0,2,16426,-2,13560.0,2,13565.0,20,B
2018-04-25 13:40:24,13565.0,8,16434,-4,13560.0,12,13570.0,12,B
2018-04-25 13:40:26,13570.0,12,16446,0,13565.0,8,13570.0,8,B
2018-04-25 13:40:27,13570.0,16,16462,4,13570.0,3,13575.0,12,B
2018-04-25 13:40:28,13575.0,12,16474,4,13570.0,15,13580.0,25,B
2018-04-25 13:40:30,13575.0,2,16476,2,13570.0,10,13575.0,6,B
2018-04-25 13:40:35,13570.0,6,16482,0,13570.0,7,13575.0,13,S
2018-04-25 13:40:35,13575.0,26,16508,2,13570.0,10,13580.0,20,B
2018-04-25 13:40:40,13580.0,2,16510,0,13570.0,14,13580.0,19,B
2018-04-25 13:40:42,13575.0,2,16512,0,13570.0,14,13580.0,19,S
2018-04-25 13:40:45,13570.0,6,16518,-2,13565.0,14,13575.0,7,S
2018-04-25 13:40:46,13570.0,2,16520,-2,13565.0,15,13575.0,11,S
2018-04-25 13:40:56,13575.0,4,16524,-2,13570.0,19,13580.0,24,B
2018-04-25 13:41:13,13575.0,14,16538,4,13570.0,5,13580.0,49,B
2018-04-25 13:41:20,13570.0,4,16542,0,13570.0,1,13575.0,12,S
2018-04-25 13:41:21,13570.0,2,16544,-2,13565.0,15,13570.0,4,S
2018-04-25 13:41:27,13575.0,2,16546,2,13565.0,8,13575.0,27,B
2018-04-25 13:41:33,13570.0,2,16548,0,13565.0,9,13570.0,3,S
2018-04-25 13:41:42,13565.0,4,16552,4,13565.0,5,13570.0,2,S
2018-04-25 13:41:43,13565.0,10,16562,-6,13560.0,24,13565.0,2,S
2018-04-25 13:41:43,13560.0,2,16564,-2,13560.0,15,13565.0,2,S
2018-04-25 13:41:44,13560.0,2,16566,0,13560.0,10,13565.0,2,S
2018-04-25 13:41:50,13560.0,18,16584,-16,13555.0,12,13560.0,3,S
2018-04-25 13:42:07,13555.0,2,16586,-2,13555.0,4,13560.0,5,S
2018-04-25 13:42:09,13560.0,2,16588,2,13555.0,4,13560.0,4,B
2018-04-25 13:42:11,13560.0,8,16596,2,13560.0,16,13565.0,8,B
2018-04-25 13:42:12,13560.0,2,16598,0,13560.0,18,13565.0,4,B
2018-04-25 13:42:13,13560.0,2,16600,2,13560.0,17,13565.0,5,B
2018-04-25 13:42:19,13560.0,4,16604,0,13560.0,15,13565.0,5,B
2018-04-25 13:42:19,13560.0,14,16618,12,13560.0,6,13565.0,6,B
2018-04-25 13:42:21,13560.0,2,16620,0,13560.0,1,13565.0,7,B
2018-04-25 13:42:28,13560.0,2,16622,0,13555.0,16,13560.0,2,B
2018-04-25 13:42:33,13555.0,16,16638,4,13550.0,10,13555.0,7,S
2018-04-25 13:42:35,13555.0,2,16640,0,13550.0,6,13555.0,6,S
2018-04-25 13:42:39,13555.0,6,16646,0,13550.0,14,13560.0,24,S
2018-04-25 13:42:43,13550.0,2,16648,-2,13550.0,9,13555.0,5,S
2018-04-25 13:42:43,13550.0,8,16656,-2,13550.0,26,13555.0,1,S
2018-04-25 13:42:49,13550.0,4,16660,4,13550.0,9,13555.0,2,S
2018-04-25 13:42:59,13550.0,2,16662,0,13550.0,5,13555.0,4,S
2018-04-25 13:43:02,13550.0,2,16664,0,13550.0,15,13555.0,4,S
2018-04-25 13:43:07,13550.0,2,16666,-2,13550.0,14,13555.0,6,S
2018-04-25 13:43:15,13555.0,2,16668,0,13550.0,15,13555.0,4,B
2018-04-25 13:43:18,13555.0,8,16676,4,13550.0,18,13560.0,13,B
2018-04-25 13:43:33,13555.0,14,16690,-12,13550.0,19,13555.0,7,B
2018-04-25 13:43:36,13555.0,2,16692,-2,13550.0,15,13555.0,9,B
2018-04-25 13:43:38,13555.0,14,16706,2,13550.0,15,13555.0,2,B
2018-04-25 13:43:38,13555.0,4,16710,4,13555.0,14,13560.0,8,B
2018-04-25 13:43:50,13555.0,4,16714,0,13555.0,9,13560.0,8,B
2018-04-25 13:43:55,13560.0,4,16718,-2,13555.0,9,13560.0,6,B
2018-04-25 13:44:03,13560.0,12,16730,-2,13555.0,28,13565.0,7,B
2018-04-25 13:44:08,13560.0,4,16734,0,13560.0,1,13565.0,19,B
2018-04-25 13:44:10,13555.0,2,16736,-2,13550.0,16,13560.0,10,S
2018-04-25 13:44:16,13560.0,2,16738,2,13555.0,1,13560.0,7,B
2018-04-25 13:44:18,13555.0,2,16740,0,13555.0,3,13560.0,7,S
2018-04-25 13:44:20,13555.0,2,16742,0,13555.0,1,13560.0,7,S
2018-04-25 13:44:37,13555.0,2,16744,-2,13550.0,42,13555.0,2,S
2018-04-25 13:44:38,13550.0,2,16746,-2,13550.0,16,13555.0,1,S
2018-04-25 13:44:44,13555.0,2,16748,0,13550.0,16,13560.0,18,B
2018-04-25 13:44:57,13555.0,2,16750,-2,13555.0,1,13560.0,7,B
2018-04-25 13:45:04,13555.0,6,16756,-6,13550.0,27,13560.0,8,B
2018-04-25 13:45:14,13555.0,14,16770,14,13550.0,8,13555.0,2,B
2018-04-25 13:45:17,13555.0,2,16772,2,13555.0,1,13560.0,9,B
2018-04-25 13:45:17,13555.0,4,16776,2,13555.0,2,13560.0,11,B
2018-04-25 13:45:20,13555.0,2,16778,0,13555.0,1,13560.0,11,B
2018-04-25 13:45:21,13555.0,2,16780,-2,13550.0,18,13555.0,2,B
2018-04-25 13:45:34,13550.0,2,16782,0,13550.0,7,13555.0,5,S
2018-04-25 13:45:35,13550.0,8,16790,2,13550.0,3,13555.0,5,S
2018-04-25 13:45:36,13550.0,6,16796,0,13545.0,10,13550.0,15,S
2018-04-25 13:45:37,13550.0,6,16802,-6,13545.0,15,13555.0,13,S
2018-04-25 13:45:53,13550.0,2,16804,0,13545.0,12,13555.0,18,S
2018-04-25 13:45:54,13545.0,6,16810,-6,13545.0,4,13550.0,10,S
2018-04-25 13:45:55,13545.0,8,16818,-2,13540.0,6,13545.0,1,S
2018-04-25 13:46:04,13540.0,8,16826,0,13535.0,6,13545.0,5,S
2018-04-25 13:46:04,13540.0,2,16828,-2,13540.0,1,13545.0,4,S
2018-04-25 13:46:08,13540.0,2,16830,2,13535.0,16,13545.0,6,S
2018-04-25 13:46:13,13535.0,4,16834,-2,13530.0,20,13540.0,6,S
2018-04-25 13:46:16,13535.0,12,16846,12,13530.0,22,13535.0,2,S
2018-04-25 13:46:16,13535.0,6,16852,4,13535.0,7,13540.0,12,S
2018-04-25 13:46:19,13530.0,2,16854,0,13530.0,34,13535.0,2,S
2018-04-25 13:46:20,13535.0,4,16858,-4,13530.0,35,13535.0,3,B
2018-04-25 13:46:20,13535.0,4,16862,4,13530.0,30,13535.0,1,B
2018-04-25 13:46:21,13535.0,2,16864,0,13530.0,30,13540.0,12,B
2018-04-25 13:46:23,13535.0,2,16866,-2,13535.0,1,13540.0,7,B
2018-04-25 13:46:26,13540.0,2,16868,-2,13535.0,2,13540.0,5,B
2018-04-25 13:46:26,13540.0,6,16874,-6,13535.0,3,13540.0,2,B
2018-04-25 13:46:27,13540.0,2,16876,-2,13535.0,5,13545.0,3,B
2018-04-25 13:46:31,13540.0,2,16878,0,13535.0,12,13545.0,9,B
2018-04-25 13:46:35,13540.0,2,16880,-2,13535.0,12,13540.0,1,B
2018-04-25 13:46:41,13535.0,14,16894,4,13530.0,46,13540.0,4,S
2018-04-25 13:46:44,13535.0,2,16896,0,13530.0,37,13540.0,13,S
2018-04-25 13:46:47,13535.0,2,16898,-2,13530.0,56,13540.0,9,S
2018-04-25 13:46:54,13540.0,2,16900,0,13530.0,37,13540.0,10,B
2018-04-25 13:47:00,13530.0,2,16902,2,13530.0,31,13535.0,1,S
2018-04-25 13:47:02,13530.0,16,16918,-12,13530.0,14,13535.0,11,S
2018-04-25 13:47:05,13530.0,4,16922,0,13530.0,12,13535.0,13,S
2018-04-25 13:47:05,13530.0,2,16924,0,13530.0,11,13535.0,13,S
2018-04-25 13:47:06,13530.0,2,16926,-2,13530.0,10,13535.0,13,S
2018-04-25 13:47:08,13535.0,2,16928,-2,13530.0,10,13535.0,10,B
2018-04-25 13:47:09,13530.0,6,16934,0,13530.0,7,13535.0,10,S
2018-04-25 13:47:19,13530.0,2,16936,0,13530.0,5,13535.0,10,S
2018-04-25 13:47:21,13535.0,16,16952,6,13535.0,13,13540.0,7,B
2018-04-25 13:47:21,13540.0,4,16956,-4,13535.0,21,13540.0,4,B
2018-04-25 13:47:22,13540.0,8,16964,4,13540.0,1,13545.0,8,B
2018-04-25 13:47:27,13535.0,2,16966,0,13535.0,7,13540.0,1,S
2018-04-25 13:47:35,13540.0,2,16968,0,13535.0,8,13545.0,26,B
2018-04-25 13:47:49,13535.0,2,16970,2,13535.0,14,13540.0,1,S
2018-04-25 13:47:54,13540.0,2,16972,0,13535.0,9,13545.0,35,B
2018-04-25 13:48:07,13535.0,8,16980,4,13535.0,4,13540.0,12,S
2018-04-25 13:48:07,13535.0,8,16988,2,13530.0,16,13535.0,2,S
2018-04-25 13:48:09,13535.0,2,16990,0,13530.0,16,13535.0,1,S
2018-04-25 13:48:11,13535.0,4,16994,0,13535.0,18,13540.0,14,S
2018-04-25 13:48:14,13535.0,2,16996,0,13535.0,53,13540.0,21,S
2018-04-25 13:48:22,13535.0,8,17004,6,13535.0,49,13540.0,19,S
2018-04-25 13:48:24,13535.0,2,17006,2,13535.0,48,13540.0,19,S
2018-04-25 13:48:29,13535.0,2,17008,0,13535.0,47,13540.0,19,S
2018-04-25 13:48:30,13535.0,2,17010,0,13535.0,46,13540.0,19,S
2018-04-25 13:48:41,13540.0,2,17012,0,13535.0,46,13540.0,18,B
2018-04-25 13:48:54,13540.0,20,17032,12,13535.0,54,13545.0,20,B
2018-04-25 13:48:55,13545.0,2,17034,-2,13535.0,54,13545.0,23,B
2018-04-25 13:48:58,13540.0,2,17036,-2,13535.0,56,13545.0,25,S
2018-04-25 13:49:06,13540.0,4,17040,4,13535.0,55,13545.0,25,S
2018-04-25 13:49:08,13545.0,4,17044,0,13540.0,3,13545.0,22,B
2018-04-25 13:49:08,13545.0,2,17046,0,13540.0,4,13545.0,21,B
2018-04-25 13:49:18,13545.0,10,17056,-4,13540.0,6,13545.0,20,B
2018-04-25 13:49:20,13545.0,6,17062,0,13540.0,6,13545.0,17,B
2018-04-25 13:49:22,13545.0,34,17096,-14,13540.0,18,13550.0,14,B
2018-04-25 13:49:25,13540.0,10,17106,-8,13540.0,14,13545.0,21,S
2018-04-25 13:49:40,13545.0,36,17142,18,13540.0,14,13545.0,4,B
2018-04-25 13:49:41,13545.0,8,17150,6,13545.0,16,13550.0,16,B
2018-04-25 13:49:47,13540.0,10,17160,0,13540.0,16,13550.0,41,S
2018-04-25 13:49:47,13540.0,2,17162,0,13540.0,11,13550.0,47,S
2018-04-25 13:49:51,13545.0,2,17164,-2,13540.0,9,13545.0,3,B
2018-04-25 13:50:20,13545.0,10,17174,10,13545.0,9,13550.0,19,B
2018-04-25 13:50:21,13550.0,2,17176,0,13545.0,7,13550.0,13,B
2018-04-25 13:50:21,13545.0,8,17184,6,13545.0,7,13550.0,10,S
2018-04-25 13:50:25,13545.0,6,17190,0,13545.0,4,13550.0,8,S
2018-04-25 13:50:28,13550.0,18,17208,-6,13550.0,6,13555.0,32,B
2018-04-25 13:50:29,13550.0,12,17220,-2,13545.0,4,13555.0,45,B
2018-04-25 13:50:30,13555.0,10,17230,0,13545.0,7,13555.0,44,B
2018-04-25 13:51:04,13555.0,2,17232,0,13545.0,22,13555.0,30,B
2018-04-25 13:51:35,13555.0,2,17234,0,13545.0,18,13555.0,31,B
2018-04-25 13:51:40,13550.0,6,17240,0,13550.0,2,13555.0,24,S
2018-04-25 13:51:41,13550.0,4,17244,0,13545.0,17,13555.0,27,S
2018-04-25 13:51:52,13545.0,6,17250,-6,13545.0,11,13555.0,30,S
2018-04-25 13:51:57,13545.0,4,17254,0,13545.0,11,13555.0,29,S
2018-04-25 13:51:57,13545.0,4,17258,0,13545.0,9,13555.0,27,S
2018-04-25 13:51:58,13545.0,4,17262,-4,13545.0,9,13555.0,29,S
2018-04-25 13:51:58,13545.0,4,17266,0,13545.0,7,13555.0,30,S
2018-04-25 13:51:59,13545.0,4,17270,-4,13545.0,6,13555.0,31,S
2018-04-25 13:51:59,13545.0,2,17272,0,13545.0,6,13555.0,32,S
2018-04-25 13:52:03,13545.0,4,17276,4,13540.0,15,13555.0,31,S
2018-04-25 13:52:03,13545.0,4,17280,4,13540.0,8,13545.0,5,S
2018-04-25 13:52:21,13545.0,2,17282,0,13540.0,7,13550.0,25,S
2018-04-25 13:52:21,13540.0,6,17288,2,13540.0,4,13550.0,29,S
2018-04-25 13:52:22,13540.0,2,17290,-2,13540.0,3,13545.0,6,S
2018-04-25 13:52:23,13540.0,2,17292,-2,13540.0,10,13545.0,5,S
2018-04-25 13:52:24,13545.0,10,17302,4,13540.0,6,13550.0,17,B
2018-04-25 13:52:25,13540.0,4,17306,-4,13540.0,4,13550.0,26,S
2018-04-25 13:52:33,13540.0,2,17308,0,13540.0,6,13545.0,4,S
2018-04-25 13:52:39,13545.0,2,17310,0,13540.0,6,13545.0,3,B
2018-04-25 13:52:40,13540.0,2,17312,0,13540.0,5,13545.0,3,S
2018-04-25 13:52:41,13540.0,2,17314,-2,13540.0,4,13545.0,3,S
2018-04-25 13:52:44,13540.0,8,17322,-2,13535.0,66,13545.0,9,S
2018-04-25 13:52:48,13535.0,6,17328,2,13535.0,45,13540.0,4,S
2018-04-25 13:53:07,13540.0,4,17332,0,13535.0,48,13540.0,5,B
2018-04-25 13:53:07,13540.0,10,17342,-2,13540.0,12,13545.0,11,B
2018-04-25 13:53:11,13540.0,20,17362,-8,13540.0,2,13545.0,6,B
2018-04-25 13:53:13,13540.0,2,17364,-2,13535.0,50,13540.0,4,B
2018-04-25 13:53:18,13540.0,8,17372,6,13535.0,53,13545.0,8,B
2018-04-25 13:53:23,13540.0,10,17382,-6,13540.0,2,13545.0,6,B
2018-04-25 13:53:27,13540.0,6,17388,-4,13535.0,53,13540.0,2,B
2018-04-25 13:53:27,13540.0,4,17392,0,13535.0,53,13545.0,10,B
2018-04-25 13:53:59,13540.0,2,17394,0,13540.0,16,13545.0,5,B
2018-04-25 13:54:18,13545.0,10,17404,-2,13540.0,16,13550.0,10,B
2018-04-25 13:54:40,13550.0,2,17406,0,13545.0,4,13550.0,7,B
2018-04-25 13:55:02,13550.0,2,17408,0,13545.0,4,13550.0,8,B
2018-04-25 13:55:13,13545.0,6,17414,0,13540.0,21,13545.0,1,S
2018-04-25 13:55:14,13545.0,8,17422,-8,13540.0,18,13545.0,2,S
2018-04-25 13:55:17,13545.0,2,17424,0,13540.0,15,13545.0,2,S
2018-04-25 13:55:23,13545.0,2,17426,0,13540.0,8,13545.0,3,S
2018-04-25 13:55:33,13540.0,2,17428,0,13540.0,8,13545.0,4,S
2018-04-25 13:56:07,13540.0,2,17430,-2,13540.0,9,13545.0,5,S
2018-04-25 13:56:07,13545.0,2,17432,0,13540.0,9,13545.0,4,B
2018-04-25 13:56:14,13540.0,2,17434,0,13540.0,8,13545.0,4,S
2018-04-25 13:56:20,13540.0,2,17436,2,13540.0,9,13545.0,4,S
2018-04-25 13:56:30,13540.0,2,17438,0,13540.0,10,13545.0,5,S
2018-04-25 13:56:33,13540.0,2,17440,0,13540.0,8,13545.0,8,S
2018-04-25 13:56:34,13540.0,2,17442,2,13540.0,7,13545.0,8,S
2018-04-25 13:56:39,13540.0,2,17444,0,13540.0,6,13545.0,8,S
2018-04-25 13:57:03,13540.0,12,17456,-8,13535.0,42,13540.0,9,S
2018-04-25 13:57:20,13540.0,2,17458,-2,13535.0,38,13540.0,7,S
2018-04-25 13:57:45,13540.0,8,17466,0,13535.0,38,13540.0,3,S
2018-04-25 13:57:56,13540.0,4,17470,0,13535.0,40,13545.0,16,S
2018-04-25 13:58:17,13545.0,2,17472,0,13540.0,6,13545.0,6,B
2018-04-25 13:58:27,13545.0,2,17474,2,13540.0,6,13545.0,3,B
2018-04-25 13:58:32,13545.0,2,17476,0,13540.0,10,13550.0,21,B
2018-04-25 13:58:59,13540.0,4,17480,-2,13540.0,11,13550.0,24,S
2018-04-25 13:59:36,13540.0,6,17486,0,13540.0,3,13545.0,2,S
2018-04-25 13:59:58,13545.0,6,17492,0,13540.0,20,13550.0,16,B
2018-04-25 14:00:41,13540.0,2,17494,2,13535.0,69,13545.0,6,S
2018-04-25 14:01:42,13540.0,2,17496,-2,13540.0,19,13545.0,1,S
2018-04-25 14:01:48,13545.0,2,17498,0,13540.0,8,13550.0,15,B
2018-04-25 14:02:15,13545.0,2,17500,-2,13545.0,17,13550.0,5,B
2018-04-25 14:02:16,13550.0,10,17510,6,13545.0,17,13555.0,26,B
2018-04-25 14:02:19,13550.0,4,17514,0,13545.0,18,13550.0,2,B
2018-04-25 14:02:20,13550.0,4,17518,-4,13545.0,20,13555.0,29,B
2018-04-25 14:02:29,13550.0,2,17520,0,13545.0,18,13550.0,1,B
2018-04-25 14:02:29,13550.0,2,17522,0,13545.0,20,13555.0,31,B
2018-04-25 14:02:33,13555.0,2,17524,0,13545.0,20,13555.0,30,B
2018-04-25 14:02:43,13555.0,2,17526,0,13545.0,21,13555.0,26,B
2018-04-25 14:02:50,13550.0,2,17528,-2,13545.0,25,13555.0,20,S
2018-04-25 14:03:00,13550.0,6,17534,-2,13550.0,1,13555.0,24,S
2018-04-25 14:03:11,13550.0,4,17538,4,13550.0,5,13555.0,23,S
2018-04-25 14:03:19,13550.0,14,17552,10,13545.0,24,13550.0,3,S
2018-04-25 14:03:34,13550.0,8,17560,2,13550.0,2,13555.0,23,S
2018-04-25 14:03:35,13550.0,4,17564,-4,13545.0,23,13555.0,18,S
2018-04-25 14:03:42,13550.0,10,17574,-4,13545.0,23,13550.0,1,S
2018-04-25 14:03:52,13550.0,10,17584,0,13545.0,27,13555.0,25,S
2018-04-25 14:04:22,13550.0,6,17590,4,13545.0,28,13550.0,1,S
2018-04-25 14:04:50,13545.0,2,17592,-2,13545.0,21,13555.0,30,S
2018-04-25 14:05:15,13545.0,2,17594,-2,13545.0,10,13550.0,14,S
2018-04-25 14:05:40,13545.0,2,17596,-2,13545.0,9,13550.0,10,S
2018-04-25 14:05:44,13550.0,8,17604,-8,13545.0,10,13550.0,1,B
2018-04-25 14:05:45,13550.0,2,17606,0,13550.0,1,13555.0,30,B
2018-04-25 14:05:48,13550.0,8,17614,8,13545.0,13,13550.0,6,B
2018-04-25 14:05:53,13550.0,10,17624,10,13545.0,13,13550.0,1,B
2018-04-25 14:05:56,13550.0,2,17626,0,13545.0,13,13555.0,30,B
2018-04-25 14:07:04,13555.0,2,17628,0,13545.0,17,13555.0,30,B
2018-04-25 14:07:46,13550.0,4,17632,-2,13545.0,44,13555.0,42,S
2018-04-25 14:08:05,13550.0,6,17638,0,13545.0,20,13550.0,4,S
2018-04-25 14:08:14,13550.0,2,17640,-2,13545.0,20,13550.0,2,S
2018-04-25 14:08:26,13550.0,2,17642,0,13545.0,19,13550.0,1,S
2018-04-25 14:08:34,13550.0,2,17644,0,13545.0,19,13555.0,63,S
2018-04-25 14:09:26,13550.0,2,17646,2,13545.0,29,13550.0,77,S
2018-04-25 14:09:26,13550.0,2,17648,0,13545.0,17,13550.0,76,S
2018-04-25 14:09:37,13545.0,6,17654,-6,13545.0,15,13550.0,76,S
2018-04-25 14:09:39,13545.0,10,17664,2,13545.0,10,13550.0,76,S
2018-04-25 14:09:49,13545.0,2,17666,0,13545.0,9,13550.0,80,S
2018-04-25 14:09:56,13545.0,4,17670,-4,13545.0,7,13550.0,78,S
2018-04-25 14:10:04,13545.0,16,17686,6,13540.0,24,13545.0,2,S
2018-04-25 14:10:10,13545.0,4,17690,-4,13545.0,7,13550.0,85,S
2018-04-25 14:10:17,13545.0,14,17704,0,13540.0,37,13545.0,13,S
2018-04-25 14:10:18,13545.0,26,17730,-14,13540.0,36,13550.0,81,S
2018-04-25 14:11:13,13550.0,12,17742,-6,13540.0,34,13550.0,80,B
2018-04-25 14:11:27,13545.0,2,17744,0,13540.0,3,13545.0,4,S
2018-04-25 14:12:06,13540.0,12,17756,2,13535.0,64,13545.0,48,S
2018-04-25 14:12:36,13535.0,10,17766,0,13535.0,53,13545.0,54,S
2018-04-25 14:12:43,13535.0,2,17768,0,13535.0,52,13545.0,54,S
2018-04-25 14:12:52,13545.0,12,17780,-6,13540.0,16,13545.0,37,B
2018-04-25 14:12:57,13540.0,2,17782,0,13540.0,28,13545.0,42,S
2018-04-25 14:13:03,13540.0,2,17784,0,13540.0,18,13545.0,42,S
2018-04-25 14:13:07,13545.0,2,17786,2,13540.0,18,13545.0,41,B
2018-04-25 14:13:15,13545.0,2,17788,0,13540.0,18,13545.0,40,B
2018-04-25 14:13:45,13545.0,14,17802,14,13540.0,21,13545.0,33,B
2018-04-25 14:14:00,13545.0,44,17846,4,13540.0,27,13545.0,12,B
2018-04-25 14:14:00,13545.0,24,17870,-10,13540.0,30,13550.0,120,B
2018-04-25 14:14:09,13545.0,2,17872,0,13540.0,51,13545.0,1,B
2018-04-25 14:14:23,13545.0,2,17874,2,13545.0,1,13550.0,121,B
2018-04-25 14:14:27,13550.0,6,17880,-6,13540.0,47,13550.0,120,B
2018-04-25 14:14:28,13545.0,2,17882,-2,13540.0,42,13545.0,2,S
2018-04-25 14:14:28,13545.0,2,17884,0,13540.0,30,13545.0,1,S
2018-04-25 14:14:32,13545.0,2,17886,0,13540.0,31,13550.0,121,S
2018-04-25 14:14:37,13545.0,2,17888,0,13545.0,4,13550.0,121,S
2018-04-25 14:14:38,13545.0,8,17896,0,13540.0,31,13545.0,1,S
2018-04-25 14:14:39,13545.0,2,17898,0,13540.0,34,13550.0,121,S
2018-04-25 14:15:43,13540.0,4,17902,0,13540.0,8,13545.0,4,S
2018-04-25 14:16:18,13540.0,4,17906,-2,13540.0,48,13545.0,3,S
2018-04-25 14:16:33,13540.0,2,17908,-2,13540.0,47,13545.0,3,S
2018-04-25 14:17:03,13540.0,4,17912,2,13540.0,5,13545.0,3,S
2018-04-25 14:17:18,13540.0,2,17914,0,13540.0,4,13545.0,1,S
2018-04-25 14:17:24,13545.0,2,17916,0,13540.0,6,13550.0,14,B
2018-04-25 14:17:36,13540.0,4,17920,2,13540.0,2,13545.0,7,S
2018-04-25 14:17:37,13540.0,4,17924,4,13535.0,38,13540.0,4,S
2018-04-25 14:17:37,13540.0,2,17926,0,13535.0,35,13540.0,3,S
2018-04-25 14:17:44,13540.0,2,17928,-2,13535.0,35,13545.0,15,S
2018-04-25 14:18:20,13540.0,2,17930,-2,13540.0,3,13545.0,13,S
2018-04-25 14:18:25,13540.0,4,17934,0,13540.0,1,13545.0,13,S
2018-04-25 14:18:30,13540.0,2,17936,0,13535.0,46,13545.0,13,S
2018-04-25 14:19:05,13540.0,2,17938,0,13535.0,46,13545.0,15,S
2018-04-25 14:19:33,13535.0,2,17940,2,13535.0,43,13540.0,9,S
2018-04-25 14:20:07,13535.0,24,17964,14,13535.0,31,13540.0,27,S
2018-04-25 14:20:07,13535.0,62,18026,24,13530.0,14,13540.0,27,S
2018-04-25 14:20:11,13530.0,8,18034,-2,13530.0,7,13535.0,6,S
2018-04-25 14:20:16,13525.0,28,18062,-22,13525.0,19,13535.0,6,S
2018-04-25 14:20:17,13525.0,52,18114,-44,13520.0,8,13525.0,4,S
2018-04-25 14:20:17,13530.0,14,18128,-6,13525.0,12,13530.0,2,B
2018-04-25 14:20:22,13530.0,6,18134,-2,13525.0,15,13535.0,9,B
2018-04-25 14:20:23,13530.0,4,18138,4,13530.0,8,13535.0,12,B
2018-04-25 14:20:51,13530.0,2,18140,0,13530.0,4,13535.0,15,B
2018-04-25 14:20:55,13530.0,2,18142,0,13530.0,4,13535.0,15,B
2018-04-25 14:21:08,13530.0,8,18150,-2,13525.0,22,13530.0,5,B
2018-04-25 14:21:08,13530.0,10,18160,-8,13525.0,25,13535.0,15,B
2018-04-25 14:21:22,13525.0,20,18180,-10,13525.0,15,13535.0,16,S
2018-04-25 14:21:46,13525.0,2,18182,-2,13525.0,5,13530.0,9,S
2018-04-25 14:21:48,13525.0,2,18184,0,13525.0,4,13530.0,9,S
2018-04-25 14:21:52,13525.0,6,18190,2,13520.0,23,13525.0,6,S
2018-04-25 14:21:53,13525.0,4,18194,-4,13520.0,26,13525.0,5,S
2018-04-25 14:21:54,13525.0,10,18204,8,13525.0,2,13530.0,15,S
2018-04-25 14:21:56,13525.0,2,18206,0,13525.0,2,13530.0,15,S
2018-04-25 14:22:07,13525.0,2,18208,0,13525.0,2,13530.0,14,S
2018-04-25 14:22:17,13530.0,12,18220,-10,13525.0,5,13530.0,8,B
2018-04-25 14:22:17,13530.0,16,18236,0,13525.0,5,13535.0,26,B
2018-04-25 14:22:18,13525.0,14,18250,10,13525.0,3,13530.0,2,S
2018-04-25 14:22:18,13530.0,8,18258,4,13530.0,18,13535.0,8,B
2018-04-25 14:22:21,13535.0,2,18260,2,13530.0,9,13535.0,4,B
2018-04-25 14:22:26,13535.0,2,18262,0,13530.0,9,13535.0,3,B
2018-04-25 14:22:57,13535.0,4,18266,0,13535.0,8,13540.0,10,B
2018-04-25 14:23:11,13540.0,12,18278,-8,13535.0,8,13540.0,2,B
2018-04-25 14:23:11,13540.0,4,18282,2,13540.0,1,13545.0,21,B
2018-04-25 14:23:12,13545.0,6,18288,-4,13535.0,9,13545.0,21,B
2018-04-25 14:24:13,13545.0,8,18296,-4,13540.0,6,13545.0,2,B
2018-04-25 14:24:14,13545.0,4,18300,-2,13540.0,7,13550.0,9,B
2018-04-25 14:24:22,13545.0,2,18302,0,13540.0,10,13550.0,31,B
2018-04-25 14:25:03,13550.0,40,18342,-14,13545.0,3,13550.0,28,B
2018-04-25 14:25:05,13550.0,4,18346,4,13545.0,3,13550.0,26,B
2018-04-25 14:25:12,13545.0,6,18352,-4,13540.0,17,13550.0,28,S
2018-04-25 14:25:30,13545.0,2,18354,-2,13540.0,18,13550.0,30,S
2018-04-25 14:26:04,13545.0,2,18356,0,13545.0,2,13550.0,32,S
2018-04-25 14:26:04,13545.0,4,18360,0,13540.0,17,13550.0,32,S
2018-04-25 14:26:31,13550.0,8,18368,8,13540.0,20,13550.0,29,B
2018-04-25 14:26:35,13550.0,2,18370,2,13545.0,1,13550.0,27,B
2018-04-25 14:26:58,13545.0,4,18374,0,13540.0,21,13550.0,27,S
2018-04-25 14:27:03,13550.0,2,18376,2,13545.0,10,13550.0,24,B
2018-04-25 14:27:08,13550.0,2,18378,0,13545.0,10,13550.0,22,B
2018-04-25 14:27:08,13550.0,2,18380,2,13545.0,11,13550.0,21,B
2018-04-25 14:27:11,13545.0,4,18384,-2,13545.0,2,13550.0,23,S
2018-04-25 14:27:12,13545.0,4,18388,0,13540.0,22,13550.0,23,S
2018-04-25 14:27:14,13550.0,4,18392,0,13540.0,24,13550.0,22,B
2018-04-25 14:27:15,13545.0,2,18394,-2,13540.0,23,13550.0,24,S
2018-04-25 14:27:21,13550.0,2,18396,2,13540.0,23,13550.0,25,B
2018-04-25 14:27:34,13550.0,14,18410,0,13540.0,23,13550.0,18,B
2018-04-25 14:27:39,13545.0,12,18422,12,13545.0,4,13550.0,18,S
2018-04-25 14:27:40,13545.0,8,18430,0,13540.0,22,13550.0,19,S
2018-04-25 14:27:46,13540.0,18,18448,6,13535.0,8,13540.0,1,S
2018-04-25 14:28:26,13535.0,2,18450,0,13535.0,3,13540.0,10,S
2018-04-25 14:28:55,13540.0,14,18464,4,13535.0,3,13540.0,3,B
2018-04-25 14:29:19,13535.0,6,18470,0,13530.0,10,13540.0,9,S
2018-04-25 14:29:53,13535.0,2,18472,0,13530.0,13,13540.0,17,S
2018-04-25 14:30:17,13530.0,8,18480,4,13530.0,2,13535.0,13,S
2018-04-25 14:30:30,13530.0,4,18484,0,13530.0,3,13535.0,12,S
2018-04-25 14:30:34,13530.0,4,18488,-4,13530.0,1,13535.0,8,S
2018-04-25 14:30:37,13530.0,2,18490,-2,13525.0,9,13535.0,9,S
2018-04-25 14:30:47,13535.0,2,18492,0,13530.0,15,13535.0,1,B
2018-04-25 14:30:57,13530.0,4,18496,0,13530.0,13,13535.0,5,S
2018-04-25 14:31:07,13530.0,2,18498,0,13530.0,12,13535.0,5,S
2018-04-25 14:31:24,13535.0,12,18510,-4,13535.0,6,13540.0,87,B
2018-04-25 14:31:29,13535.0,2,18512,0,13535.0,9,13540.0,83,B
2018-04-25 14:31:30,13535.0,2,18514,2,13535.0,8,13540.0,83,B
2018-04-25 14:31:39,13540.0,2,18516,2,13535.0,6,13540.0,82,B
2018-04-25 14:31:42,13535.0,2,18518,-2,13535.0,8,13540.0,82,S
2018-04-25 14:31:52,13535.0,2,18520,0,13535.0,5,13540.0,82,S
2018-04-25 14:32:20,13535.0,8,18528,0,13530.0,14,13535.0,1,S
2018-04-25 14:32:21,13530.0,6,18534,-2,13525.0,8,13535.0,19,S
2018-04-25 14:32:29,13530.0,2,18536,-2,13525.0,11,13535.0,8,S
2018-04-25 14:32:33,13525.0,4,18540,-2,13525.0,10,13535.0,8,S
2018-04-25 14:32:34,13530.0,2,18542,-2,13525.0,10,13535.0,7,B
2018-04-25 14:32:39,13535.0,2,18544,2,13530.0,2,13535.0,3,B
2018-04-25 14:33:22,13530.0,8,18552,-6,13530.0,2,13535.0,2,S
2018-04-25 14:33:33,13530.0,2,18554,0,13530.0,1,13535.0,2,S
2018-04-25 14:34:57,13535.0,4,18558,-2,13535.0,11,13540.0,84,B
2018-04-25 14:35:02,13535.0,2,18560,0,13535.0,5,13540.0,84,B
2018-04-25 14:35:05,13535.0,2,18562,0,13535.0,4,13540.0,84,B
2018-04-25 14:35:06,13535.0,2,18564,-2,13535.0,3,13540.0,84,B
2018-04-25 14:35:10,13535.0,6,18570,6,13530.0,13,13535.0,1,B
2018-04-25 14:35:25,13535.0,4,18574,2,13530.0,7,13535.0,3,B
2018-04-25 14:35:25,13530.0,2,18576,0,13530.0,6,13535.0,3,S
2018-04-25 14:35:40,13535.0,2,18578,0,13530.0,5,13535.0,2,B
2018-04-25 14:35:51,13535.0,4,18582,2,13535.0,1,13540.0,89,B
2018-04-25 14:35:51,13535.0,2,18584,2,13530.0,5,13535.0,1,B
2018-04-25 14:36:31,13535.0,2,18586,2,13530.0,3,13535.0,3,B
2018-04-25 14:37:41,13535.0,6,18592,0,13535.0,2,13540.0,89,B
2018-04-25 14:38:39,13535.0,14,18606,12,13535.0,2,13540.0,87,B
2018-04-25 14:39:12,13540.0,4,18610,-4,13535.0,2,13540.0,85,B
2018-04-25 14:39:12,13535.0,4,18614,-2,13530.0,14,13540.0,85,S
2018-04-25 14:39:16,13535.0,4,18618,2,13530.0,14,13540.0,85,S
2018-04-25 14:39:23,13535.0,2,18620,-2,13530.0,14,13535.0,2,S
2018-04-25 14:39:44,13535.0,2,18622,0,13530.0,14,13535.0,2,S
2018-04-25 14:40:05,13530.0,14,18636,0,13530.0,5,13535.0,5,S
2018-04-25 14:40:05,13530.0,10,18646,6,13525.0,9,13530.0,4,S
2018-04-25 14:40:14,13530.0,6,18652,0,13530.0,4,13535.0,11,S
2018-04-25 14:40:24,13530.0,2,18654,-2,13530.0,8,13535.0,4,S
2018-04-25 14:40:26,13535.0,2,18656,-2,13530.0,8,13535.0,3,B
2018-04-25 14:40:28,13530.0,8,18664,-2,13530.0,2,13535.0,82,S
2018-04-25 14:40:29,13530.0,4,18668,-4,13525.0,13,13530.0,2,S
2018-04-25 14:41:12,13525.0,4,18672,-4,13525.0,6,13530.0,6,S
2018-04-25 14:41:14,13525.0,6,18678,-4,13525.0,6,13530.0,6,S
2018-04-25 14:41:18,13530.0,2,18680,0,13525.0,6,13530.0,5,B
2018-04-25 14:41:22,13525.0,2,18682,0,13525.0,2,13530.0,25,S
2018-04-25 14:41:22,13525.0,4,18686,0,13520.0,20,13525.0,2,S
2018-04-25 14:41:26,13525.0,2,18688,2,13520.0,20,13525.0,2,S
2018-04-25 14:41:31,13525.0,4,18692,0,13520.0,20,13530.0,27,S
2018-04-25 14:41:41,13520.0,4,18696,0,13520.0,15,13525.0,24,S
2018-04-25 14:41:42,13515.0,32,18728,-24,13515.0,7,13520.0,38,S
2018-04-25 14:41:42,13515.0,20,18748,0,13510.0,13,13515.0,4,S
2018-04-25 14:41:44,13505.0,28,18776,10,13505.0,16,13510.0,15,S
2018-04-25 14:41:44,13500.0,36,18812,10,13500.0,27,13505.0,23,S
2018-04-25 14:41:45,13500.0,14,18826,0,13500.0,20,13505.0,27,S
2018-04-25 14:41:45,13500.0,32,18858,14,13500.0,4,13505.0,29,S
2018-04-25 14:41:46,13500.0,2,18860,0,13500.0,3,13505.0,28,S
2018-04-25 14:41:46,13500.0,4,18864,0,13500.0,8,13505.0,25,S
2018-04-25 14:41:47,13505.0,50,18914,-8,13505.0,4,13510.0,11,B
2018-04-25 14:41:47,13510.0,4,18918,-2,13510.0,4,13515.0,7,B
2018-04-25 14:41:48,13510.0,2,18920,2,13505.0,11,13515.0,5,B
2018-04-25 14:41:53,13510.0,4,18924,0,13510.0,1,13515.0,15,B
2018-04-25 14:41:55,13505.0,8,18932,-8,13505.0,3,13510.0,2,S
2018-04-25 14:41:56,13510.0,4,18936,0,13510.0,2,13515.0,8,B
2018-04-25 14:41:57,13510.0,4,18940,0,13505.0,4,13515.0,72,B
2018-04-25 14:42:01,13505.0,8,18948,-2,13500.0,11,13510.0,6,S
2018-04-25 14:42:09,13500.0,2,18950,0,13500.0,4,13505.0,12,S
2018-04-25 14:42:09,13500.0,2,18952,2,13500.0,3,13505.0,14,S
2018-04-25 14:42:10,13500.0,6,18958,2,13495.0,9,13505.0,17,S
2018-04-25 14:42:10,13505.0,2,18960,2,13495.0,9,13505.0,16,B
2018-04-25 14:42:13,13505.0,6,18966,-2,13500.0,11,13505.0,3,B
2018-04-25 14:42:14,13505.0,6,18972,2,13505.0,2,13510.0,12,B
2018-04-25 14:42:14,13505.0,4,18976,0,13500.0,8,13510.0,14,B
2018-04-25 14:42:19,13510.0,6,18982,2,13510.0,4,13515.0,74,B
2018-04-25 14:42:22,13510.0,2,18984,0,13510.0,17,13515.0,65,B
2018-04-25 14:42:22,13510.0,14,18998,-4,13510.0,1,13515.0,75,B
2018-04-25 14:42:23,13510.0,2,19000,0,13505.0,8,13510.0,2,B
2018-04-25 14:42:25,13505.0,6,19006,-4,13505.0,5,13515.0,79,S
2018-04-25 14:42:31,13510.0,4,19010,-2,13510.0,3,13515.0,75,B
2018-04-25 14:42:31,13510.0,6,19016,-6,13505.0,11,13515.0,79,B
2018-04-25 14:42:35,13505.0,4,19020,-2,13505.0,7,13510.0,16,S
2018-04-25 14:42:37,13505.0,4,19024,0,13505.0,5,13510.0,20,S
2018-04-25 14:42:38,13505.0,2,19026,-2,13505.0,4,13510.0,19,S
2018-04-25 14:42:48,13510.0,2,19028,0,13505.0,16,13515.0,90,B
2018-04-25 14:42:49,13510.0,2,19030,2,13505.0,16,13515.0,95,B
2018-04-25 14:42:50,13510.0,2,19032,0,13505.0,15,13515.0,95,B
2018-04-25 14:42:52,13510.0,2,19034,2,13505.0,15,13515.0,100,B
2018-04-25 14:42:53,13505.0,2,19036,0,13505.0,14,13515.0,100,S
2018-04-25 14:42:56,13510.0,2,19038,0,13510.0,2,13515.0,100,B
2018-04-25 14:43:04,13510.0,2,19040,2,13505.0,14,13510.0,5,B
2018-04-25 14:43:14,13505.0,4,19044,-2,13505.0,11,13510.0,16,S
2018-04-25 14:43:14,13505.0,22,19066,-6,13500.0,6,13505.0,3,S
2018-04-25 14:43:17,13505.0,12,19078,10,13505.0,9,13510.0,14,S
2018-04-25 14:43:21,13505.0,2,19080,-2,13505.0,5,13510.0,12,S
2018-04-25 14:43:23,13510.0,2,19082,-2,13505.0,10,13515.0,8,B
2018-04-25 14:43:40,13510.0,4,19086,-2,13510.0,8,13515.0,80,B
2018-04-25 14:43:42,13510.0,4,19090,-4,13505.0,11,13510.0,2,B
2018-04-25 14:43:47,13510.0,2,19092,2,13510.0,1,13515.0,101,B
2018-04-25 14:43:54,13510.0,2,19094,2,13505.0,10,13515.0,98,B
2018-04-25 14:43:56,13505.0,2,19096,-2,13505.0,9,13510.0,1,S
2018-04-25 14:43:59,13515.0,40,19136,-24,13505.0,7,13515.0,80,B
2018-04-25 14:44:07,13510.0,10,19146,-2,13505.0,11,13510.0,15,S
2018-04-25 14:44:07,13510.0,2,19148,-2,13505.0,12,13510.0,14,S
2018-04-25 14:44:12,13505.0,4,19152,4,13505.0,8,13510.0,14,S
2018-04-25 14:44:18,13505.0,2,19154,2,13505.0,7,13510.0,14,S
2018-04-25 14:44:20,13510.0,28,19182,-22,13505.0,9,13515.0,79,B
2018-04-25 14:44:30,13510.0,10,19192,-4,13505.0,14,13510.0,1,B
2018-04-25 14:44:51,13510.0,2,19194,0,13505.0,10,13510.0,3,B
2018-04-25 14:44:53,13505.0,8,19202,4,13500.0,16,13510.0,8,S
2018-04-25 14:44:57,13500.0,2,19204,0,13500.0,13,13505.0,3,S
2018-04-25 14:45:00,13500.0,2,19206,0,13500.0,13,13505.0,3,S
2018-04-25 14:45:02,13500.0,4,19210,-4,13500.0,11,13505.0,4,S
2018-04-25 14:45:04,13505.0,2,19212,0,13500.0,11,13505.0,2,B
2018-04-25 14:45:05,13505.0,4,19216,0,13505.0,8,13510.0,9,B
2018-04-25 14:45:10,13505.0,2,19218,0,13500.0,14,13510.0,9,B
2018-04-25 14:45:11,13510.0,14,19232,-6,13500.0,14,13510.0,2,B
2018-04-25 14:45:17,13510.0,6,19238,0,13505.0,3,13510.0,57,B
2018-04-25 14:45:31,13505.0,8,19246,-4,13500.0,13,13505.0,5,S
2018-04-25 14:45:31,13500.0,10,19256,0,13500.0,7,13505.0,6,S
2018-04-25 14:45:35,13500.0,2,19258,0,13500.0,6,13505.0,6,S
2018-04-25 14:45:42,13505.0,2,19260,-2,13500.0,12,13510.0,80,B
2018-04-25 14:45:50,13500.0,10,19270,6,13500.0,7,13510.0,80,S
2018-04-25 14:46:01,13500.0,2,19272,2,13500.0,8,13505.0,2,S
2018-04-25 14:46:03,13505.0,4,19276,0,13505.0,13,13510.0,26,B
2018-04-25 14:46:03,13505.0,6,19282,-6,13505.0,10,13510.0,26,B
2018-04-25 14:46:17,13505.0,2,19284,-2,13505.0,12,13510.0,74,B
2018-04-25 14:46:22,13510.0,64,19348,20,13505.0,20,13510.0,42,B
2018-04-25 14:46:22,13515.0,112,19460,-10,13515.0,1,13520.0,8,B
2018-04-25 14:46:23,13520.0,2,19462,0,13515.0,10,13520.0,4,B
2018-04-25 14:46:23,13520.0,8,19470,4,13515.0,12,13520.0,1,B
2018-04-25 14:46:24,13525.0,4,19474,0,13515.0,15,13525.0,9,B
2018-04-25 14:46:26,13520.0,2,19476,0,13515.0,15,13525.0,9,S
2018-04-25 14:46:27,13520.0,2,19478,2,13520.0,1,13525.0,12,S
2018-04-25 14:46:29,13525.0,2,19480,-2,13520.0,9,13530.0,6,B
2018-04-25 14:46:31,13525.0,2,19482,0,13525.0,1,13530.0,8,B
2018-04-25 14:46:34,13525.0,6,19488,-4,13520.0,9,13530.0,12,B
2018-04-25 14:46:38,13530.0,2,19490,2,13520.0,11,13530.0,12,B
2018-04-25 14:46:47,13530.0,2,19492,0,13525.0,3,13530.0,10,B
2018-04-25 14:46:48,13530.0,8,19500,-4,13525.0,7,13535.0,6,B
2018-04-25 14:46:59,13535.0,4,19504,0,13525.0,8,13535.0,8,B
2018-04-25 14:47:11,13535.0,4,19508,-4,13525.0,11,13535.0,6,B
2018-04-25 14:47:21,13535.0,10,19518,-2,13530.0,7,13540.0,11,B
2018-04-25 14:47:24,13540.0,6,19524,-2,13535.0,12,13540.0,4,B
2018-04-25 14:47:24,13540.0,8,19532,0,13535.0,13,13545.0,8,B
2018-04-25 14:47:34,13535.0,4,19536,4,13535.0,4,13540.0,16,S
2018-04-25 14:47:34,13535.0,2,19538,0,13535.0,3,13540.0,16,S
2018-04-25 14:47:45,13535.0,2,19540,0,13535.0,4,13540.0,10,S
2018-04-25 14:47:48,13540.0,6,19546,-4,13540.0,5,13545.0,14,B
2018-04-25 14:47:48,13540.0,12,19558,-2,13535.0,9,13545.0,11,B
2018-04-25 14:47:50,13545.0,6,19564,2,13540.0,2,13545.0,8,B
2018-04-25 14:47:54,13545.0,14,19578,2,13545.0,3,13550.0,38,B
2018-04-25 14:47:54,13545.0,6,19584,0,13545.0,1,13550.0,40,B
2018-04-25 14:47:55,13545.0,2,19586,0,13540.0,4,13545.0,1,B
2018-04-25 14:48:02,13545.0,4,19590,0,13540.0,7,13545.0,1,B
2018-04-25 14:48:04,13545.0,4,19594,0,13540.0,6,13545.0,2,B
2018-04-25 14:48:05,13540.0,2,19596,0,13540.0,1,13545.0,8,S
2018-04-25 14:48:05,13540.0,2,19598,2,13535.0,8,13540.0,21,S
2018-04-25 14:48:10,13540.0,2,19600,2,13540.0,3,13545.0,13,S
2018-04-25 14:48:14,13540.0,2,19602,2,13540.0,5,13545.0,1,S
2018-04-25 14:48:36,13545.0,2,19604,2,13545.0,9,13550.0,35,B
2018-04-25 14:48:39,13545.0,4,19608,4,13545.0,4,13550.0,42,B
2018-04-25 14:48:40,13545.0,8,19616,6,13540.0,3,13545.0,12,B
2018-04-25 14:48:45,13545.0,2,19618,0,13540.0,6,13545.0,1,B
2018-04-25 14:48:46,13545.0,2,19620,2,13545.0,2,13550.0,46,B
2018-04-25 14:48:48,13545.0,10,19630,6,13545.0,6,13550.0,35,B
2018-04-25 14:48:54,13545.0,8,19638,0,13540.0,11,13545.0,6,B
2018-04-25 14:48:55,13545.0,4,19642,-4,13540.0,10,13550.0,48,B
2018-04-25 14:48:57,13545.0,6,19648,-6,13545.0,4,13550.0,37,B
2018-04-25 14:48:59,13545.0,8,19656,-2,13540.0,15,13550.0,38,B
2018-04-25 14:49:04,13550.0,12,19668,4,13545.0,2,13550.0,38,B
2018-04-25 14:49:12,13545.0,4,19672,0,13540.0,10,13550.0,44,S
2018-04-25 14:49:24,13540.0,10,19682,0,13535.0,7,13545.0,13,S
2018-04-25 14:49:33,13545.0,4,19686,0,13545.0,3,13550.0,44,B
2018-04-25 14:49:33,13545.0,6,19692,4,13545.0,1,13550.0,41,B
2018-04-25 14:49:34,13545.0,2,19694,0,13540.0,11,13550.0,40,B
2018-04-25 14:49:40,13545.0,6,19700,-6,13545.0,2,13550.0,46,B
2018-04-25 14:49:47,13545.0,2,19702,0,13545.0,1,13550.0,45,B
2018-04-25 14:49:48,13545.0,2,19704,-2,13540.0,8,13550.0,45,B
2018-04-25 14:49:49,13550.0,10,19714,0,13540.0,9,13550.0,40,B
2018-04-25 14:50:03,13545.0,2,19716,0,13540.0,11,13550.0,37,S
2018-04-25 14:50:17,13540.0,2,19718,2,13540.0,7,13545.0,3,S
2018-04-25 14:50:35,13540.0,6,19724,-2,13535.0,7,13545.0,10,S
2018-04-25 14:50:41,13540.0,2,19726,-2,13535.0,12,13545.0,15,S
2018-04-25 14:50:48,13535.0,20,19746,-2,13530.0,8,13540.0,11,S
2018-04-25 14:50:53,13535.0,2,19748,2,13535.0,3,13540.0,6,S
2018-04-25 14:50:57,13540.0,2,19750,-2,13535.0,3,13540.0,5,B
2018-04-25 14:51:00,13535.0,2,19752,0,13535.0,2,13540.0,5,S
2018-04-25 14:51:03,13540.0,2,19754,2,13535.0,2,13540.0,4,B
2018-04-25 14:51:08,13535.0,4,19758,-2,13530.0,13,13540.0,4,S
2018-04-25 14:51:11,13540.0,2,19760,2,13530.0,12,13540.0,7,B
2018-04-25 14:51:43,13540.0,2,19762,2,13535.0,2,13540.0,9,B
2018-04-25 14:51:49,13540.0,12,19774,0,13535.0,14,13545.0,17,B
2018-04-25 14:51:54,13540.0,2,19776,2,13535.0,14,13545.0,17,B
2018-04-25 14:51:59,13540.0,2,19778,0,13535.0,5,13540.0,4,B
2018-04-25 14:52:01,13540.0,2,19780,0,13535.0,5,13540.0,4,B
2018-04-25 14:52:22,13535.0,10,19790,8,13530.0,6,13535.0,12,S
2018-04-25 14:52:32,13535.0,2,19792,-2,13530.0,7,13535.0,4,S
2018-04-25 14:52:37,13535.0,2,19794,2,13530.0,4,13535.0,6,S
2018-04-25 14:53:22,13530.0,6,19800,0,13525.0,7,13535.0,8,S
2018-04-25 14:53:37,13530.0,2,19802,-2,13530.0,1,13535.0,10,S
2018-04-25 14:53:49,13530.0,4,19806,4,13525.0,15,13535.0,13,S
2018-04-25 14:54:02,13530.0,2,19808,-2,13525.0,3,13530.0,4,S
2018-04-25 14:54:36,13530.0,2,19810,2,13525.0,4,13530.0,4,S
2018-04-25 14:54:53,13525.0,2,19812,0,13525.0,3,13530.0,4,S
2018-04-25 14:54:54,13525.0,22,19834,-16,13525.0,4,13530.0,1,S
2018-04-25 14:54:56,13525.0,14,19848,4,13520.0,7,13525.0,27,S
2018-04-25 14:54:56,13530.0,62,19910,8,13520.0,10,13525.0,3,B
2018-04-25 14:54:57,13525.0,8,19918,-6,13520.0,5,13525.0,2,S
2018-04-25 14:54:57,13525.0,4,19922,-4,13525.0,1,13530.0,4,S
2018-04-25 14:54:58,13525.0,2,19924,-2,13520.0,10,13530.0,6,S
2018-04-25 14:54:59,13530.0,2,19926,0,13525.0,2,13530.0,5,B
2018-04-25 14:55:04,13530.0,2,19928,-2,13525.0,20,13535.0,14,B
2018-04-25 14:55:10,13525.0,4,19932,0,13525.0,1,13530.0,4,S
2018-04-25 14:55:13,13525.0,2,19934,-2,13520.0,9,13525.0,4,S
2018-04-25 14:55:18,13525.0,2,19936,-2,13520.0,9,13525.0,1,S
2018-04-25 14:55:18,13525.0,2,19938,-2,13525.0,1,13530.0,11,S
2018-04-25 14:55:19,13525.0,2,19940,0,13525.0,3,13530.0,10,S
2018-04-25 14:55:23,13530.0,2,19942,0,13525.0,11,13530.0,3,B
2018-04-25 14:55:25,13525.0,2,19944,0,13525.0,10,13530.0,4,S
2018-04-25 14:56:07,13525.0,2,19946,2,13525.0,5,13530.0,8,S
2018-04-25 14:56:07,13525.0,2,19948,-2,13520.0,9,13530.0,8,S
2018-04-25 14:56:18,13525.0,2,19950,0,13525.0,1,13530.0,11,S
2018-04-25 14:56:21,13525.0,2,19952,0,13520.0,10,13530.0,11,S
2018-04-25 14:56:57,13525.0,4,19956,-4,13525.0,2,13530.0,11,S
2018-04-25 14:56:57,13525.0,4,19960,0,13520.0,10,13530.0,11,S
2018-04-25 14:57:11,13520.0,14,19974,8,13520.0,3,13530.0,11,S
2018-04-25 14:57:18,13520.0,10,19984,6,13520.0,1,13525.0,3,S
2018-04-25 14:57:22,13520.0,2,19986,-2,13515.0,7,13525.0,6,S
2018-04-25 14:57:24,13515.0,4,19990,0,13510.0,11,13520.0,7,S
2018-04-25 14:57:26,13510.0,4,19994,-4,13510.0,10,13520.0,12,S
2018-04-25 14:57:27,13515.0,2,19996,0,13510.0,10,13520.0,12,B
2018-04-25 14:57:29,13510.0,2,19998,-2,13510.0,9,13520.0,12,S
2018-04-25 14:57:30,13510.0,18,20016,8,13505.0,24,13510.0,1,S
2018-04-25 14:57:30,13520.0,8,20024,0,13510.0,23,13520.0,11,B
2018-04-25 14:57:33,13510.0,20,20044,2,13510.0,13,13520.0,11,S
2018-04-25 14:57:36,13510.0,20,20064,6,13510.0,3,13520.0,10,S
2018-04-25 14:57:39,13515.0,20,20084,20,13510.0,2,13520.0,11,B
2018-04-25 14:57:42,13510.0,4,20088,2,13505.0,33,13510.0,8,S
2018-04-25 14:57:42,13515.0,18,20106,12,13510.0,4,13520.0,12,B
2018-04-25 14:57:45,13510.0,20,20126,16,13510.0,1,13520.0,12,S
2018-04-25 14:57:45,13510.0,2,20128,0,13510.0,1,13515.0,2,S
2018-04-25 14:57:48,13510.0,4,20132,-2,13510.0,19,13515.0,3,S
2018-04-25 14:57:49,13515.0,2,20134,-2,13505.0,32,13515.0,1,B
2018-04-25 14:57:51,13510.0,2,20136,2,13510.0,4,13515.0,2,S
2018-04-25 14:57:59,13510.0,2,20138,2,13510.0,5,13515.0,3,S
2018-04-25 14:58:00,13520.0,28,20166,-10,13510.0,6,13515.0,1,B
2018-04-25 14:58:02,13510.0,2,20168,0,13510.0,6,13515.0,1,S
2018-04-25 14:58:02,13515.0,2,20170,-2,13510.0,5,13515.0,2,B
2018-04-25 14:58:07,13515.0,4,20174,0,13515.0,8,13520.0,4,B
2018-04-25 14:58:15,13515.0,2,20176,0,13515.0,8,13520.0,2,B
2018-04-25 14:58:19,13515.0,2,20178,0,13515.0,9,13520.0,2,B
2018-04-25 14:58:24,13520.0,2,20180,2,13515.0,10,13520.0,2,B
2018-04-25 14:58:25,13520.0,2,20182,-2,13515.0,10,13520.0,1,B
2018-04-25 14:58:29,13515.0,2,20184,0,13515.0,9,13520.0,1,S
2018-04-25 14:58:31,13520.0,2,20186,0,13520.0,8,13525.0,10,B
2018-04-25 14:58:37,13525.0,8,20194,-6,13525.0,1,13530.0,10,B
2018-04-25 14:58:38,13525.0,2,20196,-2,13520.0,10,13525.0,4,B
2018-04-25 14:58:42,13525.0,2,20198,0,13520.0,15,13525.0,2,B
2018-04-25 14:58:43,13530.0,6,20204,-2,13520.0,17,13530.0,9,B
2018-04-25 14:58:45,13530.0,4,20208,0,13520.0,17,13530.0,7,B
2018-04-25 14:58:49,13525.0,2,20210,-2,13525.0,3,13530.0,7,S
2018-04-25 14:58:51,13530.0,8,20218,6,13530.0,1,13535.0,9,B
2018-04-25 14:58:52,13530.0,2,20220,0,13525.0,3,13530.0,3,B
2018-04-25 14:58:53,13530.0,4,20224,-4,13525.0,4,13530.0,1,B
2018-04-25 14:58:53,13530.0,2,20226,-2,13525.0,6,13530.0,1,B
2018-04-25 14:58:54,13530.0,2,20228,0,13525.0,6,13535.0,8,B
2018-04-25 14:58:55,13530.0,2,20230,-2,13525.0,4,13530.0,5,B
2018-04-25 14:58:58,13530.0,2,20232,0,13525.0,6,13535.0,8,B
2018-04-25 14:58:59,13530.0,2,20234,-2,13525.0,4,13530.0,6,B
2018-04-25 14:59:01,13525.0,14,20248,-8,13520.0,11,13535.0,8,S
2018-04-25 14:59:02,13530.0,2,20250,-2,13525.0,4,13530.0,1,B
2018-04-25 14:59:02,13530.0,2,20252,-2,13525.0,4,13535.0,8,B
2018-04-25 14:59:09,13530.0,4,20256,-4,13525.0,2,13535.0,12,B
2018-04-25 14:59:12,13530.0,2,20258,-2,13525.0,5,13535.0,13,B
2018-04-25 14:59:17,13530.0,2,20260,-2,13525.0,6,13535.0,13,B
2018-04-25 14:59:21,13530.0,2,20262,-2,13530.0,1,13535.0,13,B
2018-04-25 14:59:21,13530.0,2,20264,0,13525.0,4,13535.0,13,B
2018-04-25 14:59:26,13525.0,2,20266,-2,13525.0,5,13530.0,6,S
2018-04-25 14:59:29,13530.0,12,20278,-10,13530.0,11,13535.0,9,B
2018-04-25 14:59:30,13535.0,2,20280,0,13530.0,11,13535.0,6,B
2018-04-25 14:59:30,13535.0,12,20292,-8,13530.0,11,13540.0,5,B
2018-04-25 14:59:31,13540.0,14,20306,-2,13530.0,11,13535.0,2,B
2018-04-25 14:59:32,13530.0,4,20310,-4,13530.0,9,13535.0,1,S
2018-04-25 14:59:33,13535.0,2,20312,0,13525.0,5,13535.0,2,B
2018-04-25 14:59:34,13540.0,16,20328,-8,13540.0,1,13545.0,3,B
2018-04-25 14:59:34,13540.0,2,20330,0,13535.0,2,13540.0,15,B
2018-04-25 14:59:35,13540.0,10,20340,0,13535.0,2,13540.0,3,B
2018-04-25 14:59:35,13535.0,2,20342,-2,13535.0,1,13545.0,11,S
2018-04-25 14:59:37,13535.0,2,20344,-2,13530.0,2,13540.0,20,S
2018-04-25 14:59:41,13540.0,6,20350,0,13530.0,1,13540.0,23,B
2018-04-25 14:59:44,13540.0,2,20352,0,13530.0,1,13540.0,23,B
2018-04-25 14:59:55,13535.0,2,20354,0,13535.0,1,13540.0,12,S
2018-04-25 14:59:55,13540.0,4,20358,0,13530.0,2,13540.0,11,B
2018-04-25 14:59:56,13530.0,4,20362,-2,13525.0,2,13535.0,1,S
2018-04-25 14:59:59,13530.0,4,20366,-4,13525.0,2,13535.0,2,S
2018-04-25 20:59:00,13535.0,6,6,82650,0.0,0,0.0,0,B
2018-04-25 21:00:00,13540.0,6,12,-4,13535.0,4,13545.0,2,B
2018-04-25 21:00:01,13535.0,4,16,-4,13535.0,2,13545.0,3,S
2018-04-25 21:00:01,13535.0,2,18,0,13535.0,1,13540.0,3,S
2018-04-25 21:00:02,13535.0,2,20,2,13530.0,14,13540.0,5,S
2018-04-25 21:00:04,13535.0,4,24,4,13530.0,12,13535.0,1,S
2018-04-25 21:00:05,13535.0,2,26,2,13530.0,12,13540.0,10,S
2018-04-25 21:00:05,13530.0,20,46,-20,13530.0,2,13540.0,23,S
2018-04-25 21:00:06,13530.0,4,50,-2,13525.0,2,13535.0,2,S
2018-04-25 21:00:06,13530.0,2,52,0,13525.0,2,13530.0,1,S
2018-04-25 21:00:07,13525.0,4,56,0,13515.0,1,13525.0,1,S
2018-04-25 21:00:09,13525.0,2,58,2,13515.0,3,13520.0,1,S
2018-04-25 21:00:09,13515.0,8,66,4,13510.0,1,13520.0,4,S
2018-04-25 21:00:12,13515.0,2,68,2,13510.0,6,13515.0,1,S
2018-04-25 21:00:12,13520.0,4,72,2,13515.0,2,13520.0,1,B
2018-04-25 21:00:17,13520.0,6,78,0,13515.0,7,13520.0,2,B
2018-04-25 21:00:18,13520.0,4,82,4,13520.0,1,13525.0,3,B
2018-04-25 21:00:19,13520.0,2,84,-2,13515.0,8,13525.0,5,B
2018-04-25 21:00:22,13520.0,2,86,0,13515.0,8,13525.0,7,B
2018-04-25 21:00:24,13515.0,2,88,0,13515.0,7,13525.0,3,S
2018-04-25 21:00:26,13525.0,6,94,0,13520.0,11,13530.0,7,B
2018-04-25 21:00:26,13520.0,2,96,0,13520.0,10,13530.0,8,S
2018-04-25 21:00:30,13520.0,20,116,0,13520.0,5,13525.0,2,S
2018-04-25 21:00:30,13525.0,4,120,4,13520.0,5,13530.0,3,B
2018-04-25 21:00:37,13525.0,4,124,-4,13525.0,2,13530.0,11,B
2018-04-25 21:00:38,13530.0,2,126,2,13520.0,6,13530.0,10,B
2018-04-25 21:00:42,13525.0,4,130,2,13520.0,8,13525.0,8,S
2018-04-25 21:00:49,13525.0,2,132,2,13520.0,10,13525.0,7,S
2018-04-25 21:00:57,13525.0,2,134,2,13520.0,6,13525.0,7,S
2018-04-25 21:00:58,13525.0,2,136,2,13520.0,6,13525.0,6,S
2018-04-25 21:00:59,13520.0,12,148,8,13515.0,10,13520.0,11,S
2018-04-25 21:00:59,13520.0,6,154,2,13515.0,9,13520.0,8,S
2018-04-25 21:01:00,13525.0,28,182,10,13525.0,2,13530.0,15,B
2018-04-25 21:01:00,13530.0,18,200,6,13520.0,2,13530.0,15,B
2018-04-25 21:01:03,13525.0,4,204,0,13525.0,1,13530.0,13,S
2018-04-25 21:01:04,13525.0,2,206,0,13520.0,3,13530.0,13,S
2018-04-25 21:01:05,13520.0,4,210,-4,13525.0,5,13530.0,16,S
2018-04-25 21:01:08,13525.0,46,256,16,13525.0,6,13535.0,3,B
2018-04-25 21:01:09,13535.0,6,262,-6,13535.0,1,13540.0,5,B
2018-04-25 21:01:09,13535.0,8,270,-8,13535.0,5,13545.0,2,B
2018-04-25 21:01:11,13540.0,18,288,10,13535.0,4,13545.0,4,B
2018-04-25 21:01:12,13535.0,6,294,-6,13530.0,9,13540.0,2,S
2018-04-25 21:01:13,13540.0,4,298,2,13530.0,9,13540.0,5,B
2018-04-25 21:01:14,13540.0,10,308,6,13540.0,5,13545.0,10,B
2018-04-25 21:01:14,13540.0,10,318,6,13530.0,12,13545.0,10,B
2018-04-25 21:01:16,13535.0,4,322,0,13530.0,13,13540.0,5,S
2018-04-25 21:01:16,13540.0,10,332,2,13540.0,5,13545.0,7,B
2018-04-25 21:01:17,13540.0,10,342,6,13530.0,13,13545.0,5,B
2018-04-25 21:01:17,13535.0,4,346,0,13530.0,11,13540.0,2,S
2018-04-25 21:01:19,13540.0,12,358,6,13540.0,4,13545.0,17,B
2018-04-25 21:01:20,13540.0,8,366,4,13530.0,7,13535.0,1,B
2018-04-25 21:01:20,13535.0,2,368,-2,13530.0,7,13540.0,4,S
2018-04-25 21:01:35,13530.0,6,374,-2,13530.0,40,13535.0,12,S
2018-04-25 21:01:36,13530.0,2,376,2,13530.0,39,13535.0,12,S
2018-04-25 21:01:36,13530.0,8,384,8,13530.0,35,13535.0,12,S
2018-04-25 21:01:40,13530.0,2,386,2,13530.0,35,13535.0,11,S
2018-04-25 21:01:40,13535.0,6,392,6,13530.0,35,13535.0,8,B
2018-04-25 21:01:43,13535.0,2,394,2,13530.0,35,13535.0,7,B
2018-04-25 21:01:44,13535.0,14,408,12,13535.0,5,13540.0,14,B
2018-04-25 21:01:45,13535.0,6,414,0,13535.0,1,13540.0,16,B
2018-04-25 21:01:45,13535.0,2,416,0,13530.0,38,13540.0,16,B
2018-04-25 21:01:47,13535.0,12,428,6,13530.0,35,13535.0,5,B
2018-04-25 21:01:51,13535.0,2,430,-2,13530.0,35,13535.0,18,B
2018-04-25 21:01:55,13535.0,10,440,-2,13530.0,35,13535.0,13,B
2018-04-25 21:01:55,13535.0,20,460,4,13530.0,38,13540.0,18,B
2018-04-25 21:01:59,13535.0,4,464,0,13530.0,40,13540.0,16,B
2018-04-25 21:02:27,13535.0,6,470,2,13530.0,41,13535.0,2,B
2018-04-25 21:02:27,13535.0,2,472,0,13530.0,41,13535.0,1,B
2018-04-25 21:02:28,13535.0,2,474,2,13530.0,41,13540.0,27,B
2018-04-25 21:02:37,13535.0,8,482,4,13530.0,38,13535.0,9,B
2018-04-25 21:02:43,13530.0,2,484,2,13530.0,37,13535.0,19,S
2018-04-25 21:02:53,13535.0,2,486,2,13530.0,37,13535.0,18,B
2018-04-25 21:02:59,13535.0,36,522,36,13530.0,35,13540.0,28,B
2018-04-25 21:03:03,13540.0,10,532,-4,13535.0,2,13540.0,26,B
2018-04-25 21:03:04,13540.0,2,534,2,13535.0,2,13540.0,25,B
2018-04-25 21:03:09,13540.0,4,538,2,13535.0,1,13540.0,24,B
2018-04-25 21:03:09,13535.0,2,540,2,13530.0,36,13535.0,12,S
2018-04-25 21:03:13,13535.0,2,542,0,13530.0,35,13535.0,18,S
2018-04-25 21:03:20,13530.0,56,598,56,13530.0,7,13535.0,20,S
2018-04-25 21:03:21,13530.0,14,612,4,13525.0,11,13530.0,24,S
2018-04-25 21:03:21,13525.0,22,634,2,13520.0,5,13530.0,20,S
2018-04-25 21:03:22,13525.0,2,636,2,13520.0,7,13525.0,2,S
2018-04-25 21:03:22,13525.0,4,640,0,13520.0,6,13530.0,17,S
2018-04-25 21:03:26,13520.0,12,652,-6,13510.0,3,13520.0,5,S
2018-04-25 21:03:27,13520.0,12,664,-6,13515.0,3,13520.0,2,S
2018-04-25 21:03:35,13515.0,2,666,0,13515.0,9,13520.0,13,S
2018-04-25 21:03:35,13520.0,26,692,-4,13515.0,9,13525.0,8,B
2018-04-25 21:03:37,13525.0,4,696,-4,13520.0,16,13530.0,4,B
2018-04-25 21:03:39,13525.0,2,698,0,13520.0,13,13525.0,9,B
2018-04-25 21:03:42,13525.0,2,700,2,13515.0,11,13525.0,9,B
2018-04-25 21:04:03,13515.0,2,702,-2,13510.0,5,13520.0,8,S
2018-04-25 21:04:04,13520.0,16,718,14,13510.0,10,13520.0,5,B
2018-04-25 21:04:11,13510.0,20,738,6,13510.0,2,13515.0,2,S
2018-04-25 21:04:12,13510.0,2,740,0,13505.0,3,13515.0,11,S
2018-04-25 21:04:13,13510.0,2,742,2,13505.0,5,13510.0,2,S
2018-04-25 21:04:14,13510.0,2,744,0,13505.0,5,13510.0,1,S
2018-04-25 21:04:15,13505.0,4,748,4,13505.0,1,13510.0,9,S
2018-04-25 21:04:15,13500.0,4,752,0,13500.0,55,13505.0,1,S
2018-04-25 21:04:16,13500.0,4,756,-2,13500.0,53,13505.0,1,S
2018-04-25 21:04:17,13510.0,6,762,-2,13505.0,1,13510.0,9,B
2018-04-25 21:04:17,13505.0,2,764,-2,13500.0,53,13510.0,9,S
2018-04-25 21:04:24,13510.0,12,776,6,13505.0,7,13510.0,6,B
2018-04-25 21:04:29,13510.0,10,786,10,13505.0,7,13510.0,2,B
2018-04-25 21:04:35,13510.0,32,818,-8,13510.0,1,13515.0,12,B
2018-04-25 21:04:35,13510.0,2,820,2,13510.0,1,13515.0,11,B
2018-04-25 21:04:41,13510.0,2,822,0,13505.0,10,13515.0,15,B
2018-04-25 21:04:43,13510.0,4,826,2,13505.0,7,13510.0,5,B
2018-04-25 21:04:44,13510.0,2,828,-2,13505.0,7,13510.0,4,B
2018-04-25 21:05:01,13505.0,4,832,-4,13505.0,4,13510.0,13,S
2018-04-25 21:05:01,13505.0,8,840,6,13500.0,7,13505.0,1,S
2018-04-25 21:05:02,13500.0,8,848,-6,13500.0,6,13505.0,1,S
2018-04-25 21:05:07,13500.0,18,866,14,13490.0,11,13500.0,2,S
2018-04-25 21:05:08,13500.0,8,874,4,13500.0,1,13505.0,11,S
2018-04-25 21:05:09,13505.0,20,894,10,13500.0,9,13505.0,1,B
2018-04-25 21:05:10,13505.0,2,896,0,13500.0,9,13510.0,12,B
2018-04-25 21:05:11,13505.0,2,898,0,13500.0,8,13505.0,9,B
2018-04-25 21:05:13,13505.0,6,904,2,13505.0,2,13510.0,13,B
2018-04-25 21:05:13,13500.0,10,914,6,13500.0,9,13510.0,13,S
2018-04-25 21:05:14,13510.0,2,916,0,13505.0,1,13510.0,12,B
2018-04-25 21:05:15,13510.0,2,918,2,13505.0,1,13510.0,11,B
2018-04-25 21:05:17,13505.0,2,920,2,13505.0,1,13510.0,11,S
2018-04-25 21:05:26,13505.0,6,926,6,13500.0,9,13505.0,2,S
2018-04-25 21:05:27,13505.0,4,930,4,13505.0,5,13510.0,11,S
2018-04-25 21:05:29,13510.0,16,946,0,13505.0,8,13510.0,1,B
2018-04-25 21:05:29,13510.0,4,950,0,13510.0,1,13515.0,8,B
2018-04-25 21:05:31,13510.0,4,954,0,13510.0,5,13515.0,2,B
2018-04-25 21:05:32,13510.0,2,956,0,13510.0,4,13515.0,2,B
2018-04-25 21:05:35,13515.0,4,960,4,13510.0,5,13520.0,17,B
2018-04-25 21:05:35,13510.0,2,962,-2,13510.0,2,13515.0,1,S
2018-04-25 21:05:36,13510.0,2,964,0,13510.0,1,13515.0,4,S
2018-04-25 21:05:37,13510.0,2,966,0,13505.0,9,13515.0,8,S
2018-04-25 21:05:41,13515.0,2,968,-2,13505.0,9,13515.0,6,B
2018-04-25 21:05:53,13505.0,4,972,4,13505.0,10,13510.0,10,S
2018-04-25 21:05:57,13510.0,10,982,10,13505.0,13,13510.0,5,B
2018-04-25 21:06:00,13510.0,10,992,10,13505.0,13,13515.0,8,B
2018-04-25 21:06:10,13505.0,16,1008,0,13500.0,7,13510.0,15,S
2018-04-25 21:06:43,13500.0,2,1010,0,13500.0,18,13505.0,10,S
2018-04-25 21:06:45,13500.0,20,1030,14,13500.0,8,13505.0,10,S
2018-04-25 21:06:48,13500.0,16,1046,16,13495.0,5,13500.0,2,S
2018-04-25 21:06:49,13500.0,4,1050,4,13495.0,4,13505.0,12,S
2018-04-25 21:07:03,13500.0,10,1060,0,13495.0,5,13500.0,8,S
2018-04-25 21:07:06,13500.0,2,1062,2,13495.0,5,13500.0,7,S
2018-04-25 21:07:10,13500.0,14,1076,0,13495.0,8,13505.0,14,S
2018-04-25 21:07:12,13505.0,2,1078,0,13500.0,8,13505.0,11,B
2018-04-25 21:07:12,13505.0,2,1080,0,13500.0,13,13505.0,10,B
2018-04-25 21:07:21,13505.0,4,1084,0,13500.0,13,13505.0,6,B
2018-04-25 21:07:25,13505.0,4,1088,4,13500.0,14,13505.0,4,B
2018-04-25 21:07:25,13505.0,8,1096,4,13505.0,8,13510.0,13,B
2018-04-25 21:07:40,13510.0,10,1106,10,13505.0,8,13510.0,5,B
2018-04-25 21:07:41,13510.0,2,1108,2,13505.0,8,13510.0,4,B
2018-04-25 21:07:49,13510.0,2,1110,0,13505.0,9,13510.0,6,B
2018-04-25 21:07:51,13510.0,4,1114,2,13505.0,15,13510.0,4,B
2018-04-25 21:07:52,13510.0,8,1122,6,13510.0,1,13515.0,5,B
2018-04-25 21:07:56,13510.0,2,1124,2,13510.0,2,13515.0,13,B
2018-04-25 21:08:02,13515.0,10,1134,4,13510.0,4,13515.0,8,B
2018-04-25 21:08:02,13515.0,6,1140,0,13510.0,12,13520.0,7,B
2018-04-25 21:08:09,13515.0,2,1142,-2,13510.0,17,13520.0,10,B
2018-04-25 21:08:11,13510.0,12,1154,2,13505.0,15,13515.0,16,S
2018-04-25 21:08:13,13505.0,2,1156,0,13505.0,12,13510.0,8,S
2018-04-25 21:08:14,13510.0,10,1166,6,13505.0,7,13510.0,7,B
2018-04-25 21:08:18,13510.0,8,1174,4,13510.0,21,13515.0,14,B
2018-04-25 21:08:23,13515.0,4,1178,0,13510.0,24,13515.0,5,B
2018-04-25 21:08:24,13515.0,2,1180,2,13510.0,24,13515.0,3,B
2018-04-25 21:08:24,13515.0,6,1186,2,13510.0,24,13520.0,8,B
2018-04-25 21:08:58,13515.0,2,1188,0,13510.0,25,13515.0,6,B
2018-04-25 21:09:05,13510.0,2,1190,2,13510.0,23,13515.0,22,S
2018-04-25 21:09:06,13510.0,2,1192,0,13510.0,22,13515.0,22,S
2018-04-25 21:09:19,13510.0,2,1194,2,13510.0,21,13515.0,10,S
2018-04-25 21:09:20,13510.0,18,1212,12,13510.0,12,13515.0,10,S
2018-04-25 21:09:22,13510.0,6,1218,0,13510.0,9,13515.0,10,S
2018-04-25 21:09:22,13510.0,18,1236,16,13505.0,7,13515.0,10,S
2018-04-25 21:09:42,13505.0,2,1238,0,13500.0,11,13505.0,2,S
2018-04-25 21:09:50,13510.0,2,1240,0,13500.0,17,13510.0,8,B
2018-04-25 21:09:59,13505.0,2,1242,-2,13500.0,17,13510.0,8,S
2018-04-25 21:10:15,13510.0,2,1244,0,13505.0,16,13515.0,12,B
2018-04-25 21:10:24,13505.0,4,1248,-2,13500.0,12,13505.0,2,S
2018-04-25 21:10:25,13505.0,2,1250,-2,13500.0,18,13505.0,1,S
2018-04-25 21:10:25,13505.0,2,1252,0,13505.0,3,13510.0,6,S
2018-04-25 21:10:27,13510.0,2,1254,0,13505.0,21,13515.0,15,B
2018-04-25 21:10:30,13515.0,2,1256,0,13505.0,19,13515.0,14,B
2018-04-25 21:10:31,13505.0,10,1266,0,13505.0,14,13515.0,14,S
2018-04-25 21:10:46,13505.0,6,1272,-6,13505.0,11,13515.0,14,S
2018-04-25 21:10:59,13510.0,2,1274,2,13505.0,12,13515.0,14,B
2018-04-25 21:11:10,13505.0,2,1276,-2,13505.0,19,13515.0,14,S
2018-04-25 21:11:11,13515.0,4,1280,0,13505.0,19,13515.0,13,B
2018-04-25 21:11:36,13510.0,8,1288,4,13510.0,5,13515.0,7,S
2018-04-25 21:11:46,13510.0,14,1302,0,13505.0,20,13515.0,22,S
2018-04-25 21:11:57,13510.0,4,1306,0,13505.0,17,13510.0,10,S
2018-04-25 21:11:58,13510.0,10,1316,0,13505.0,22,13510.0,5,S
2018-04-25 21:11:58,13510.0,10,1326,-10,13510.0,2,13515.0,9,S
2018-04-25 21:12:01,13510.0,4,1330,0,13505.0,22,13515.0,9,S
2018-04-25 21:12:13,13510.0,2,1332,-2,13505.0,12,13515.0,18,S
2018-04-25 21:12:44,13505.0,2,1334,-2,13505.0,9,13515.0,18,S
2018-04-25 21:12:46,13515.0,2,1336,0,13505.0,9,13515.0,17,B
2018-04-25 21:13:37,13500.0,18,1354,-2,13500.0,9,13510.0,10,S
2018-04-25 21:13:38,13505.0,4,1358,0,13500.0,13,13505.0,1,B
2018-04-25 21:13:49,13505.0,2,1360,2,13500.0,12,13505.0,4,B
2018-04-25 21:13:49,13500.0,8,1368,2,13500.0,5,13505.0,6,S
2018-04-25 21:13:50,13500.0,6,1374,-2,13500.0,1,13505.0,6,S
2018-04-25 21:13:50,13500.0,4,1378,-2,13495.0,5,13500.0,3,S
2018-04-25 21:13:51,13500.0,2,1380,-2,13495.0,5,13500.0,2,S
2018-04-25 21:13:53,13500.0,2,1382,-2,13495.0,16,13500.0,1,S
2018-04-25 21:13:56,13500.0,2,1384,2,13500.0,21,13505.0,8,S
2018-04-25 21:14:12,13500.0,44,1428,44,13495.0,16,13505.0,7,S
2018-04-25 21:14:13,13495.0,6,1434,4,13490.0,14,13495.0,5,S
2018-04-25 21:14:14,13490.0,4,1438,2,13490.0,10,13495.0,6,S
2018-04-25 21:14:14,13490.0,14,1452,-4,13490.0,3,13495.0,8,S
2018-04-25 21:14:15,13490.0,6,1458,-6,13485.0,15,13490.0,2,S
2018-04-25 21:14:16,13485.0,28,1486,8,13480.0,9,13485.0,1,S
2018-04-25 21:14:16,13485.0,18,1504,0,13480.0,14,13485.0,1,S
2018-04-25 21:14:17,13485.0,2,1506,0,13485.0,2,13490.0,7,S
2018-04-25 21:14:18,13485.0,6,1512,0,13480.0,17,13485.0,5,S
2018-04-25 21:14:19,13485.0,10,1522,-10,13480.0,17,13490.0,6,S
2018-04-25 21:14:20,13490.0,2,1524,0,13480.0,20,13490.0,6,B
2018-04-25 21:14:20,13480.0,2,1526,0,13480.0,19,13490.0,6,S
2018-04-25 21:14:22,13485.0,4,1530,-4,13480.0,19,13490.0,7,B
2018-04-25 21:14:24,13480.0,8,1538,-2,13480.0,15,13490.0,8,S
2018-04-25 21:14:31,13480.0,2,1540,0,13480.0,14,13490.0,10,S
2018-04-25 21:14:31,13490.0,22,1562,-6,13490.0,4,13495.0,10,B
2018-04-25 21:14:32,13490.0,8,1570,-2,13485.0,1,13490.0,5,B
2018-04-25 21:14:32,13485.0,2,1572,-2,13480.0,12,13490.0,23,S
2018-04-25 21:14:33,13485.0,2,1574,-2,13485.0,7,13490.0,9,S
2018-04-25 21:14:38,13490.0,8,1582,0,13485.0,13,13495.0,11,B
2018-04-25 21:14:39,13490.0,4,1586,0,13485.0,15,13495.0,7,B
2018-04-25 21:14:44,13490.0,2,1588,-2,13485.0,7,13490.0,3,B
2018-04-25 21:14:46,13490.0,2,1590,0,13485.0,2,13490.0,4,B
2018-04-25 21:14:50,13490.0,2,1592,0,13485.0,3,13490.0,4,B
2018-04-25 21:14:51,13485.0,6,1598,-6,13480.0,19,13490.0,4,S
2018-04-25 21:15:00,13485.0,2,1600,0,13480.0,4,13485.0,5,S
2018-04-25 21:15:03,13485.0,10,1610,4,13485.0,2,13490.0,11,S
2018-04-25 21:15:03,13485.0,4,1614,0,13480.0,13,13485.0,1,S
2018-04-25 21:15:04,13485.0,6,1620,2,13480.0,6,13485.0,3,S
2018-04-25 21:15:08,13480.0,22,1642,-2,13475.0,6,13480.0,39,S
2018-04-25 21:15:09,13480.0,2,1644,0,13475.0,7,13480.0,38,S
2018-04-25 21:15:09,13480.0,50,1694,-32,13475.0,20,13480.0,13,S
2018-04-25 21:15:10,13480.0,26,1720,-24,13480.0,10,13485.0,8,S
2018-04-25 21:15:13,13480.0,4,1724,0,13480.0,6,13485.0,1,S
2018-04-25 21:15:14,13485.0,2,1726,2,13480.0,6,13490.0,8,B
2018-04-25 21:15:18,13490.0,4,1730,4,13485.0,11,13495.0,8,B
2018-04-25 21:15:19,13490.0,2,1732,-2,13485.0,11,13495.0,15,B
2018-04-25 21:15:20,13490.0,2,1734,2,13485.0,11,13495.0,15,B
2018-04-25 21:15:23,13490.0,4,1738,2,13485.0,9,13495.0,15,B
2018-04-25 21:15:25,13485.0,6,1744,4,13485.0,6,13495.0,15,S
2018-04-25 21:15:31,13495.0,2,1746,2,13485.0,6,13495.0,14,B
2018-04-25 21:15:34,13485.0,12,1758,-8,13480.0,7,13490.0,14,S
2018-04-25 21:15:35,13485.0,18,1776,0,13480.0,7,13490.0,14,S
2018-04-25 21:16:01,13490.0,2,1778,0,13485.0,11,13490.0,3,B
2018-04-25 21:16:02,13490.0,2,1780,2,13485.0,11,13490.0,3,B
2018-04-25 21:16:03,13485.0,2,1782,0,13485.0,10,13490.0,3,S
2018-04-25 21:16:04,13490.0,2,1784,2,13490.0,4,13495.0,10,B
2018-04-25 21:16:10,13490.0,2,1786,-2,13490.0,2,13495.0,20,B
2018-04-25 21:16:25,13495.0,8,1794,0,13495.0,9,13500.0,7,B
2018-04-25 21:16:31,13495.0,4,1798,0,13495.0,15,13500.0,12,B
2018-04-25 21:16:33,13500.0,2,1800,0,13495.0,15,13500.0,26,B
2018-04-25 21:16:33,13495.0,2,1802,0,13495.0,11,13500.0,26,S
2018-04-25 21:16:34,13500.0,28,1830,8,13500.0,6,13505.0,17,B
2018-04-25 21:16:35,13500.0,12,1842,8,13500.0,1,13505.0,15,B
2018-04-25 21:16:35,13500.0,2,1844,2,13495.0,14,13505.0,17,B
2018-04-25 21:16:36,13500.0,2,1846,2,13500.0,1,13505.0,5,B
2018-04-25 21:16:41,13505.0,6,1852,2,13505.0,12,13510.0,18,B
2018-04-25 21:16:46,13505.0,2,1854,0,13505.0,11,13510.0,6,B
2018-04-25 21:16:47,13510.0,4,1858,2,13505.0,11,13510.0,3,B
2018-04-25 21:16:52,13510.0,4,1862,4,13500.0,8,13510.0,3,B
2018-04-25 21:16:56,13510.0,4,1866,4,13505.0,3,13510.0,3,B
2018-04-25 21:16:57,13510.0,6,1872,2,13505.0,9,13515.0,4,B
2018-04-25 21:16:59,13510.0,2,1874,0,13505.0,9,13515.0,4,B
2018-04-25 21:17:02,13515.0,2,1876,0,13510.0,4,13515.0,6,B
2018-04-25 21:17:07,13510.0,6,1882,0,13505.0,9,13515.0,11,S
2018-04-25 21:17:11,13505.0,2,1884,-2,13505.0,5,13510.0,13,S
2018-04-25 21:17:12,13505.0,2,1886,0,13505.0,3,13510.0,13,S
2018-04-25 21:17:23,13505.0,4,1890,-4,13505.0,6,13510.0,21,S
2018-04-25 21:17:24,13505.0,12,1902,-2,13500.0,7,13505.0,1,S
2018-04-25 21:17:37,13505.0,2,1904,0,13500.0,4,13505.0,8,S
2018-04-25 21:17:53,13505.0,2,1906,2,13500.0,1,13505.0,7,S
2018-04-25 21:17:54,13495.0,4,1910,0,13495.0,19,13505.0,7,S
2018-04-25 21:18:04,13495.0,2,1912,-2,13495.0,25,13505.0,11,S
2018-04-25 21:18:08,13500.0,6,1918,0,13495.0,23,13500.0,3,B
2018-04-25 21:18:09,13495.0,36,1954,-16,13495.0,4,13500.0,13,S
2018-04-25 21:18:09,13495.0,8,1962,-2,13490.0,11,13495.0,5,S
2018-04-25 21:18:11,13490.0,6,1968,2,13485.0,7,13495.0,11,S
2018-04-25 21:18:16,13495.0,2,1970,2,13490.0,9,13495.0,1,B
2018-04-25 21:18:28,13495.0,2,1972,2,13495.0,5,13500.0,23,B
2018-04-25 21:18:28,13495.0,10,1982,2,13490.0,12,13500.0,23,B
2018-04-25 21:18:33,13490.0,6,1988,6,13490.0,1,13495.0,9,S
2018-04-25 21:18:33,13490.0,2,1990,0,13485.0,11,13495.0,15,S
2018-04-25 21:18:37,13495.0,2,1992,0,13485.0,11,13495.0,17,B
2018-04-25 21:18:45,13490.0,10,2002,0,13490.0,15,13495.0,13,S
2018-04-25 21:18:46,13490.0,18,2020,8,13490.0,6,13495.0,32,S
2018-04-25 21:18:47,13485.0,16,2036,8,13485.0,4,13495.0,33,S
2018-04-25 21:18:48,13485.0,6,2042,-2,13485.0,1,13490.0,35,S
2018-04-25 21:18:48,13485.0,2,2044,2,13480.0,10,13490.0,28,S
2018-04-25 21:18:50,13485.0,2,2046,2,13480.0,12,13490.0,30,S
2018-04-25 21:18:51,13485.0,2,2048,2,13480.0,10,13485.0,3,S
2018-04-25 21:18:58,13485.0,4,2052,4,13480.0,23,13485.0,5,S
2018-04-25 21:18:58,13485.0,10,2062,4,13480.0,23,13490.0,18,S
2018-04-25 21:19:00,13485.0,2,2064,0,13480.0,8,13485.0,5,S
2018-04-25 21:19:04,13485.0,2,2066,0,13480.0,25,13485.0,1,S
2018-04-25 21:19:05,13485.0,2,2068,0,13480.0,25,13485.0,4,S
2018-04-25 21:19:05,13485.0,8,2076,-6,13485.0,4,13490.0,7,S
2018-04-25 21:19:06,13485.0,4,2080,-4,13485.0,2,13490.0,8,S
2018-04-25 21:19:07,13485.0,4,2084,-4,13480.0,12,13490.0,14,S
2018-04-25 21:19:11,13480.0,2,2086,0,13480.0,27,13485.0,7,S
2018-04-25 21:19:14,13485.0,2,2088,2,13480.0,33,13490.0,20,B
2018-04-25 21:19:20,13485.0,12,2100,-10,13480.0,32,13485.0,4,B
2018-04-25 21:19:21,13485.0,6,2106,-6,13480.0,32,13490.0,27,B
2018-04-25 21:19:22,13490.0,2,2108,0,13480.0,31,13490.0,21,B
2018-04-25 21:19:23,13480.0,10,2118,10,13480.0,26,13485.0,27,S
2018-04-25 21:19:24,13485.0,2,2120,2,13480.0,26,13485.0,26,B
2018-04-25 21:19:25,13480.0,12,2132,4,13480.0,20,13485.0,24,S
2018-04-25 21:19:26,13480.0,32,2164,-4,13480.0,4,13485.0,24,S
2018-04-25 21:19:26,13480.0,8,2172,8,13475.0,9,13480.0,4,S
2018-04-25 21:19:27,13475.0,12,2184,8,13475.0,2,13480.0,22,S
2018-04-25 21:19:28,13470.0,14,2198,2,13470.0,31,13475.0,3,S
2018-04-25 21:19:28,13470.0,4,2202,0,13470.0,36,13475.0,3,S
2018-04-25 21:19:29,13470.0,44,2246,0,13470.0,6,13475.0,19,S
2018-04-25 21:19:30,13470.0,12,2258,2,13465.0,10,13470.0,1,S
2018-04-25 21:19:30,13470.0,2,2260,0,13465.0,16,13470.0,2,S
2018-04-25 21:19:31,13470.0,4,2264,4,13470.0,4,13475.0,21,S
2018-04-25 21:19:32,13475.0,8,2272,6,13470.0,24,13475.0,9,B
2018-04-25 21:19:32,13475.0,10,2282,2,13470.0,24,13475.0,2,B
2018-04-25 21:19:33,13475.0,4,2286,-4,13470.0,24,13480.0,11,B
2018-04-25 21:19:37,13475.0,8,2294,2,13470.0,10,13480.0,12,B
2018-04-25 21:19:37,13470.0,12,2306,-12,13470.0,20,13480.0,8,S
2018-04-25 21:19:48,13475.0,10,2316,8,13475.0,22,13480.0,6,B
2018-04-25 21:19:49,13480.0,2,2318,-2,13475.0,28,13480.0,5,B
2018-04-25 21:19:49,13485.0,12,2330,-6,13480.0,5,13485.0,3,B
2018-04-25 21:19:56,13480.0,2,2332,0,13480.0,7,13485.0,2,S
2018-04-25 21:19:56,13480.0,2,2334,2,13480.0,13,13485.0,1,S
2018-04-25 21:19:57,13485.0,2,2336,2,13480.0,14,13490.0,34,B
2018-04-25 21:20:04,13485.0,4,2340,-2,13480.0,12,13485.0,23,B
2018-04-25 21:20:04,13480.0,4,2344,4,13480.0,1,13485.0,27,S
2018-04-25 21:20:06,13475.0,4,2348,2,13475.0,29,13480.0,16,S
2018-04-25 21:20:07,13475.0,12,2360,0,13475.0,16,13480.0,21,S
2018-04-25 21:20:10,13480.0,6,2366,-2,13475.0,16,13480.0,18,B
2018-04-25 21:20:12,13475.0,2,2368,0,13475.0,15,13480.0,19,S
2018-04-25 21:20:16,13480.0,14,2382,6,13475.0,38,13480.0,1,B
2018-04-25 21:20:16,13480.0,2,2384,2,13480.0,1,13485.0,8,B
2018-04-25 21:20:33,13480.0,2,2386,2,13475.0,25,13480.0,13,B
2018-04-25 21:20:34,13480.0,6,2392,6,13480.0,1,13485.0,14,B
2018-04-25 21:20:42,13485.0,12,2404,-8,13480.0,12,13485.0,2,B
2018-04-25 21:20:42,13485.0,4,2408,-2,13485.0,2,13490.0,9,B
2018-04-25 21:20:50,13490.0,6,2414,-4,13490.0,2,13495.0,22,B
2018-04-25 21:20:51,13490.0,4,2418,-4,13485.0,4,13490.0,8,B
2018-04-25 21:21:04,13490.0,2,2420,0,13485.0,7,13490.0,7,B
2018-04-25 21:21:06,13490.0,8,2428,4,13485.0,2,13490.0,5,B
2018-04-25 21:21:12,13490.0,10,2438,0,13490.0,8,13495.0,20,B
2018-04-25 21:21:12,13490.0,2,2440,-2,13490.0,7,13495.0,23,B
2018-04-25 21:21:13,13490.0,2,2442,0,13490.0,6,13495.0,23,B
2018-04-25 21:21:15,13495.0,8,2450,-2,13490.0,6,13495.0,5,B
2018-04-25 21:21:43,13490.0,22,2472,-10,13490.0,6,13495.0,15,S
2018-04-25 21:21:49,13495.0,16,2488,8,13490.0,18,13495.0,3,B
2018-04-25 21:21:49,13495.0,6,2494,0,13495.0,8,13500.0,4,B
2018-04-25 21:21:50,13505.0,2,2496,2,13500.0,2,13505.0,7,B
2018-04-25 21:21:52,13500.0,4,2500,-4,13495.0,11,13500.0,8,S
2018-04-25 21:22:02,13500.0,16,2516,0,13500.0,12,13505.0,7,S
2018-04-25 21:22:04,13505.0,10,2526,10,13500.0,15,13510.0,31,B
2018-04-25 21:22:04,13505.0,2,2528,2,13505.0,3,13510.0,21,B
2018-04-25 21:22:14,13510.0,8,2536,-6,13505.0,12,13510.0,15,B
2018-04-25 21:22:15,13510.0,6,2542,-2,13505.0,12,13515.0,11,B
2018-04-25 21:22:15,13505.0,6,2548,6,13505.0,10,13515.0,20,S
2018-04-25 21:22:16,13510.0,2,2550,2,13505.0,11,13515.0,14,B
2018-04-25 21:22:22,13510.0,4,2554,0,13505.0,11,13515.0,16,B
2018-04-25 21:22:24,13515.0,22,2576,-2,13510.0,8,13520.0,6,B
2018-04-25 21:22:33,13520.0,6,2582,0,13510.0,7,13520.0,9,B
2018-04-25 21:22:36,13515.0,2,2584,0,13515.0,7,13520.0,1,S
2018-04-25 21:22:40,13515.0,2,2586,-2,13515.0,6,13520.0,1,S
2018-04-25 21:22:48,13520.0,2,2588,-2,13520.0,7,13525.0,16,B
2018-04-25 21:22:48,13515.0,28,2616,-20,13510.0,7,13520.0,2,S
2018-04-25 21:22:51,13520.0,2,2618,-2,13515.0,4,13525.0,20,B
2018-04-25 21:23:01,13520.0,2,2620,0,13515.0,9,13520.0,2,B
2018-04-25 21:23:02,13520.0,4,2624,-4,13515.0,16,13525.0,28,B
2018-04-25 21:23:23,13520.0,4,2628,4,13510.0,17,13515.0,3,B
2018-04-25 21:23:23,13515.0,2,2630,-2,13510.0,17,13515.0,2,S
2018-04-25 21:23:38,13510.0,2,2632,0,13510.0,15,13515.0,3,S
2018-04-25 21:23:43,13510.0,2,2634,-2,13510.0,12,13515.0,11,S
2018-04-25 21:23:43,13510.0,24,2658,2,13505.0,6,13510.0,6,S
2018-04-25 21:23:44,13505.0,4,2662,0,13505.0,1,13510.0,20,S
2018-04-25 21:23:44,13505.0,6,2668,-2,13505.0,1,13510.0,21,S
2018-04-25 21:23:45,13505.0,2,2670,0,13505.0,3,13510.0,13,S
2018-04-25 21:23:47,13505.0,6,2676,4,13500.0,20,13510.0,13,S
2018-04-25 21:23:49,13505.0,2,2678,-2,13500.0,19,13510.0,14,S
2018-04-25 21:23:52,13505.0,2,2680,-2,13500.0,19,13510.0,14,S
2018-04-25 21:24:12,13510.0,8,2688,0,13505.0,8,13515.0,20,B
2018-04-25 21:24:23,13515.0,2,2690,0,13510.0,6,13515.0,15,B
2018-04-25 21:24:28,13515.0,2,2692,-2,13510.0,6,13515.0,10,B
2018-04-25 21:24:43,13510.0,2,2694,0,13510.0,6,13515.0,10,S
2018-04-25 21:24:53,13515.0,8,2702,4,13510.0,5,13515.0,7,B
2018-04-25 21:25:13,13510.0,4,2706,0,13510.0,2,13515.0,28,S
2018-04-25 21:25:14,13510.0,4,2710,0,13505.0,10,13510.0,13,S
2018-04-25 21:25:32,13510.0,2,2712,0,13505.0,8,13510.0,2,S
2018-04-25 21:25:38,13505.0,10,2722,4,13505.0,2,13510.0,3,S
2018-04-25 21:25:54,13510.0,2,2724,-2,13505.0,5,13510.0,4,B
2018-04-25 21:25:55,13510.0,4,2728,2,13505.0,7,13515.0,24,B
2018-04-25 21:26:05,13510.0,2,2730,2,13510.0,1,13515.0,24,B
2018-04-25 21:26:06,13510.0,2,2732,2,13505.0,7,13515.0,24,B
2018-04-25 21:26:37,13510.0,2,2734,-2,13510.0,5,13515.0,24,B
2018-04-25 21:26:38,13510.0,10,2744,10,13505.0,7,13510.0,1,B
2018-04-25 21:28:00,13510.0,2,2746,0,13505.0,9,13515.0,25,B
2018-04-25 21:28:01,13505.0,10,2756,-4,13500.0,20,13510.0,18,S
2018-04-25 21:28:13,13505.0,4,2760,0,13500.0,17,13510.0,23,S
2018-04-25 21:28:22,13505.0,2,2762,0,13505.0,3,13510.0,22,S
2018-04-25 21:28:23,13505.0,6,2768,6,13500.0,21,13505.0,3,S
2018-04-25 21:28:29,13505.0,8,2776,-4,13505.0,2,13510.0,34,S
2018-04-25 21:28:29,13505.0,2,2778,0,13505.0,1,13510.0,12,S
2018-04-25 21:28:38,13510.0,4,2782,2,13505.0,8,13515.0,25,B
2018-04-25 21:28:48,13510.0,2,2784,2,13510.0,3,13515.0,25,B
2018-04-25 21:28:50,13510.0,6,2790,0,13505.0,12,13510.0,7,B
2018-04-25 21:28:51,13510.0,2,2792,-2,13505.0,11,13510.0,6,B
2018-04-25 21:28:51,13510.0,6,2798,-6,13505.0,11,13510.0,3,B
2018-04-25 21:28:52,13510.0,6,2804,-4,13505.0,11,13515.0,21,B
2018-04-25 21:29:12,13515.0,2,2806,2,13510.0,1,13515.0,11,B
2018-04-25 21:29:14,13515.0,22,2828,20,13510.0,6,13520.0,13,B
2018-04-25 21:29:15,13515.0,6,2834,-4,13510.0,7,13515.0,1,B
2018-04-25 21:29:24,13515.0,2,2836,0,13515.0,2,13520.0,18,B
2018-04-25 21:29:30,13515.0,4,2840,4,13510.0,8,13515.0,1,B
2018-04-25 21:29:35,13515.0,2,2842,2,13510.0,6,13515.0,3,B
2018-04-25 21:29:36,13515.0,2,2844,0,13510.0,6,13515.0,2,B
2018-04-25 21:29:42,13510.0,2,2846,2,13510.0,5,13515.0,2,S
2018-04-25 21:29:46,13515.0,2,2848,0,13510.0,8,13515.0,1,B
2018-04-25 21:30:08,13515.0,2,2850,0,13510.0,7,13515.0,2,B
2018-04-25 21:30:28,13515.0,2,2852,0,13510.0,7,13520.0,20,B
2018-04-25 21:30:31,13520.0,6,2858,4,13515.0,9,13520.0,2,B
2018-04-25 21:30:32,13520.0,4,2862,-2,13515.0,12,13525.0,37,B
2018-04-25 21:30:37,13525.0,6,2868,4,13515.0,12,13525.0,53,B
2018-04-25 21:30:53,13520.0,8,2876,-8,13515.0,12,13525.0,54,S
2018-04-25 21:30:56,13515.0,14,2890,0,13510.0,11,13520.0,26,S
2018-04-25 21:30:57,13515.0,8,2898,2,13510.0,4,13515.0,9,S
2018-04-25 21:30:58,13510.0,4,2902,4,13505.0,9,13515.0,30,S
2018-04-25 21:30:59,13510.0,2,2904,0,13505.0,9,13515.0,26,S
2018-04-25 21:31:09,13510.0,2,2906,0,13505.0,14,13515.0,25,S
2018-04-25 21:31:12,13510.0,2,2908,2,13510.0,3,13515.0,7,S
2018-04-25 21:31:37,13510.0,4,2912,0,13510.0,6,13515.0,7,S
2018-04-25 21:32:01,13510.0,2,2914,2,13505.0,18,13515.0,13,S
2018-04-25 21:32:32,13510.0,4,2918,4,13510.0,51,13515.0,15,S
2018-04-25 21:32:37,13515.0,30,2948,-14,13510.0,51,13520.0,20,B
2018-04-25 21:32:41,13515.0,2,2950,-2,13510.0,59,13520.0,29,B
2018-04-25 21:32:42,13515.0,4,2954,-2,13510.0,60,13515.0,2,B
2018-04-25 21:32:46,13515.0,2,2956,-2,13515.0,2,13520.0,29,B
2018-04-25 21:32:46,13515.0,4,2960,-4,13510.0,58,13520.0,17,B
2018-04-25 21:32:48,13515.0,2,2962,-2,13510.0,61,13520.0,17,B
2018-04-25 21:33:14,13520.0,4,2966,-4,13520.0,3,13525.0,43,B
2018-04-25 21:33:14,13520.0,6,2972,-6,13515.0,8,13525.0,49,B
2018-04-25 21:33:35,13520.0,2,2974,-2,13520.0,5,13525.0,28,B
2018-04-25 21:33:54,13520.0,2,2976,2,13520.0,5,13525.0,17,B
2018-04-25 21:34:01,13525.0,32,3008,32,13525.0,29,13530.0,41,B
2018-04-25 21:34:01,13525.0,4,3012,0,13525.0,27,13530.0,45,B
2018-04-25 21:34:03,13530.0,2,3014,2,13525.0,27,13530.0,45,B
2018-04-25 21:34:03,13530.0,10,3024,-4,13525.0,27,13530.0,28,B
2018-04-25 21:34:05,13530.0,2,3026,2,13525.0,27,13530.0,27,B
2018-04-25 21:34:08,13530.0,2,3028,2,13525.0,27,13530.0,27,B
2018-04-25 21:34:12,13530.0,4,3032,0,13525.0,27,13530.0,24,B
2018-04-25 21:34:13,13530.0,4,3036,0,13525.0,28,13530.0,21,B
2018-04-25 21:34:14,13530.0,42,3078,16,13530.0,3,13535.0,16,B
2018-04-25 21:34:16,13530.0,2,3080,2,13530.0,2,13535.0,17,B
2018-04-25 21:34:21,13530.0,2,3082,0,13530.0,2,13535.0,16,B
2018-04-25 21:34:29,13530.0,4,3086,4,13530.0,1,13535.0,15,B
2018-04-25 21:34:30,13535.0,4,3090,-2,13530.0,1,13535.0,13,B
2018-04-25 21:34:33,13530.0,2,3092,-2,13525.0,39,13535.0,13,S
2018-04-25 21:34:39,13530.0,2,3094,0,13530.0,2,13535.0,16,S
2018-04-25 21:34:44,13530.0,2,3096,0,13525.0,40,13535.0,17,S
2018-04-25 21:35:11,13525.0,6,3102,2,13525.0,25,13530.0,28,S
2018-04-25 21:35:12,13525.0,50,3152,32,13520.0,31,13530.0,31,S
2018-04-25 21:35:15,13520.0,2,3154,2,13520.0,26,13525.0,1,S
2018-04-25 21:35:17,13520.0,2,3156,0,13520.0,25,13525.0,2,S
2018-04-25 21:35:18,13520.0,2,3158,2,13520.0,24,13525.0,2,S
2018-04-25 21:35:20,13525.0,2,3160,-2,13520.0,29,13525.0,1,B
2018-04-25 21:35:28,13525.0,2,3162,0,13520.0,29,13525.0,3,B
2018-04-25 21:35:36,13525.0,2,3164,0,13520.0,30,13525.0,1,B
2018-04-25 21:35:44,13525.0,2,3166,0,13520.0,31,13530.0,18,B
2018-04-25 21:35:56,13525.0,6,3172,6,13520.0,32,13525.0,2,B
2018-04-25 21:36:11,13525.0,4,3176,-4,13520.0,32,13530.0,29,B
2018-04-25 21:36:36,13525.0,4,3180,0,13520.0,26,13530.0,24,B
2018-04-25 21:36:48,13520.0,4,3184,4,13520.0,22,13530.0,29,S
2018-04-25 21:36:52,13520.0,2,3186,0,13520.0,19,13525.0,22,S
2018-04-25 21:36:53,13520.0,20,3206,0,13520.0,9,13525.0,22,S
2018-04-25 21:36:53,13520.0,12,3218,0,13520.0,3,13525.0,22,S
2018-04-25 21:37:07,13520.0,8,3226,-2,13515.0,12,13525.0,14,S
2018-04-25 21:37:18,13515.0,32,3258,-14,13515.0,5,13525.0,19,S
2018-04-25 21:37:19,13515.0,4,3262,-2,13515.0,7,13520.0,1,S
2018-04-25 21:37:19,13515.0,18,3280,-6,13510.0,15,13515.0,4,S
2018-04-25 21:37:20,13515.0,8,3288,-2,13515.0,8,13520.0,5,S
2018-04-25 21:37:20,13515.0,20,3308,-8,13515.0,2,13520.0,4,S
2018-04-25 21:37:21,13515.0,6,3314,-6,13515.0,4,13520.0,4,S
2018-04-25 21:37:21,13515.0,10,3324,-10,13510.0,15,13515.0,1,S
2018-04-25 21:37:22,13515.0,2,3326,0,13515.0,1,13520.0,5,S
2018-04-25 21:37:23,13515.0,4,3330,0,13510.0,17,13520.0,6,S
2018-04-25 21:37:24,13515.0,2,3332,0,13510.0,17,13520.0,8,S
2018-04-25 21:37:37,13520.0,6,3338,6,13515.0,1,13520.0,8,B
2018-04-25 21:37:42,13515.0,6,3344,4,13510.0,17,13515.0,2,S
2018-04-25 21:37:42,13515.0,2,3346,0,13510.0,17,13515.0,1,S
2018-04-25 21:37:43,13515.0,2,3348,2,13510.0,17,13520.0,8,S
2018-04-25 21:37:47,13510.0,34,3382,-28,13505.0,20,13510.0,33,S
2018-04-25 21:37:47,13510.0,6,3388,0,13505.0,23,13510.0,30,S
2018-04-25 21:37:48,13510.0,6,3394,0,13505.0,21,13510.0,27,S
2018-04-25 21:38:06,13505.0,12,3406,-2,13505.0,2,13510.0,31,S
2018-04-25 21:38:06,13505.0,8,3414,-4,13505.0,1,13510.0,31,S
2018-04-25 21:38:09,13510.0,2,3416,0,13505.0,3,13510.0,28,B
2018-04-25 21:38:10,13505.0,2,3418,2,13505.0,5,13510.0,28,S
2018-04-25 21:38:13,13505.0,2,3420,0,13505.0,4,13510.0,28,S
2018-04-25 21:38:13,13505.0,8,3428,0,13500.0,49,13510.0,29,S
2018-04-25 21:38:27,13505.0,2,3430,-2,13505.0,1,13510.0,31,S
2018-04-25 21:39:21,13510.0,6,3436,-4,13505.0,26,13510.0,25,B
2018-04-25 21:39:22,13510.0,50,3486,2,13505.0,26,13515.0,8,B
2018-04-25 21:39:27,13510.0,2,3488,-2,13505.0,26,13510.0,2,B
2018-04-25 21:39:27,13510.0,4,3492,0,13505.0,26,13515.0,13,B
2018-04-25 21:39:31,13505.0,4,3496,-4,13505.0,22,13510.0,5,S
2018-04-25 21:39:34,13510.0,4,3500,-4,13505.0,22,13515.0,15,B
2018-04-25 21:39:52,13505.0,20,3520,6,13505.0,13,13515.0,22,S
2018-04-25 21:39:59,13505.0,2,3522,2,13505.0,18,13515.0,22,S
2018-04-25 21:40:18,13505.0,2,3524,2,13505.0,15,13510.0,12,S
2018-04-25 21:40:25,13510.0,14,3538,2,13505.0,16,13515.0,26,B
2018-04-25 21:40:38,13510.0,14,3552,4,13505.0,20,13510.0,13,B
2018-04-25 21:41:13,13505.0,2,3554,0,13505.0,26,13510.0,14,S
2018-04-25 21:41:32,13510.0,10,3564,0,13505.0,21,13510.0,9,B
2018-04-25 21:41:32,13510.0,18,3582,14,13510.0,9,13515.0,4,B
2018-04-25 21:41:43,13510.0,6,3588,-2,13510.0,7,13515.0,3,B
2018-04-25 21:42:09,13515.0,2,3590,0,13510.0,10,13520.0,12,B
2018-04-25 21:42:15,13515.0,2,3592,0,13510.0,8,13515.0,3,B
2018-04-25 21:42:39,13510.0,14,3606,4,13510.0,1,13515.0,31,S
2018-04-25 21:42:40,13510.0,2,3608,0,13505.0,16,13510.0,1,S
2018-04-25 21:43:15,13510.0,6,3614,0,13505.0,19,13515.0,16,S
2018-04-25 21:45:08,13505.0,2,3616,0,13505.0,13,13510.0,11,S
2018-04-25 21:46:16,13505.0,24,3640,-2,13500.0,38,13505.0,8,S
2018-04-25 21:46:21,13500.0,4,3644,0,13500.0,32,13505.0,26,S
2018-04-25 21:46:22,13500.0,16,3660,0,13500.0,24,13505.0,24,S
2018-04-25 21:46:45,13500.0,2,3662,0,13500.0,23,13505.0,15,S
2018-04-25 21:46:52,13500.0,10,3672,10,13500.0,18,13505.0,11,S
2018-04-25 21:46:59,13500.0,2,3674,0,13500.0,20,13505.0,10,S
2018-04-25 21:47:16,13505.0,6,3680,-4,13500.0,18,13505.0,6,B
2018-04-25 21:47:17,13500.0,2,3682,2,13500.0,17,13505.0,7,S
2018-04-25 21:47:33,13500.0,32,3714,10,13495.0,10,13505.0,16,S
2018-04-25 21:47:49,13500.0,2,3716,2,13495.0,9,13500.0,8,S
2018-04-25 21:47:54,13495.0,2,3718,-2,13495.0,8,13500.0,9,S
2018-04-25 21:48:06,13500.0,4,3722,0,13495.0,8,13500.0,8,B
2018-04-25 21:48:15,13495.0,4,3726,0,13495.0,5,13500.0,25,S
2018-04-25 21:48:15,13495.0,10,3736,2,13490.0,11,13495.0,1,S
2018-04-25 21:48:16,13495.0,2,3738,2,13490.0,11,13500.0,37,S
2018-04-25 21:48:21,13495.0,2,3740,0,13490.0,17,13500.0,17,S
2018-04-25 21:48:30,13495.0,2,3742,0,13495.0,3,13500.0,13,S
2018-04-25 21:48:32,13495.0,2,3744,0,13495.0,2,13500.0,11,S
2018-04-25 21:48:41,13495.0,6,3750,-4,13490.0,19,13495.0,44,S
2018-04-25 21:48:41,13495.0,2,3752,-2,13490.0,17,13495.0,43,S
2018-04-25 21:48:54,13495.0,86,3838,-40,13495.0,4,13500.0,4,S
2018-04-25 21:48:55,13500.0,8,3846,-2,13495.0,12,13505.0,12,B
2018-04-25 21:48:55,13495.0,2,3848,0,13495.0,13,13505.0,11,S
2018-04-25 21:48:56,13495.0,2,3850,0,13495.0,13,13505.0,11,S
2018-04-25 21:49:00,13505.0,10,3860,8,13495.0,13,13505.0,9,B
2018-04-25 21:49:25,13505.0,4,3864,0,13495.0,13,13505.0,9,B
2018-04-25 21:49:28,13500.0,2,3866,0,13495.0,13,13505.0,9,S
2018-04-25 21:49:43,13495.0,4,3870,-4,13495.0,10,13505.0,11,S
2018-04-25 21:50:07,13495.0,6,3876,-4,13490.0,17,13500.0,8,S
2018-04-25 21:50:12,13495.0,2,3878,0,13495.0,19,13500.0,13,S
2018-04-25 21:50:12,13495.0,38,3916,22,13490.0,13,13495.0,32,S
2018-04-25 21:50:13,13490.0,26,3942,0,13485.0,17,13490.0,4,S
2018-04-25 21:50:13,13490.0,2,3944,0,13485.0,15,13490.0,3,S
2018-04-25 21:50:20,13490.0,6,3950,-6,13485.0,15,13495.0,23,S
2018-04-25 21:50:23,13495.0,4,3954,0,13485.0,16,13495.0,18,B
2018-04-25 21:50:32,13495.0,18,3972,6,13495.0,2,13500.0,18,B
2018-04-25 21:50:40,13495.0,2,3974,0,13495.0,1,13500.0,16,B
2018-04-25 21:50:41,13495.0,2,3976,0,13490.0,15,13495.0,1,B
2018-04-25 21:50:43,13490.0,4,3980,0,13485.0,15,13495.0,11,S
2018-04-25 21:50:49,13485.0,4,3984,-2,13485.0,19,13490.0,1,S
2018-04-25 21:50:50,13485.0,10,3994,4,13485.0,14,13490.0,1,S
2018-04-25 21:50:59,13485.0,2,3996,0,13485.0,15,13490.0,2,S
2018-04-25 21:51:00,13490.0,4,4000,2,13485.0,15,13495.0,12,B
2018-04-25 21:51:20,13495.0,2,4002,-2,13490.0,9,13495.0,3,B
2018-04-25 21:51:20,13495.0,2,4004,-2,13490.0,9,13495.0,2,B
2018-04-25 21:51:28,13500.0,4,4008,-4,13495.0,14,13500.0,5,B
2018-04-25 21:51:37,13495.0,4,4012,-4,13495.0,12,13500.0,5,S
2018-04-25 21:52:07,13500.0,2,4014,0,13495.0,11,13500.0,6,B
2018-04-25 21:52:11,13495.0,4,4018,0,13495.0,10,13500.0,6,S
2018-04-25 21:52:18,13495.0,16,4034,2,13490.0,6,13495.0,9,S
2018-04-25 21:52:21,13495.0,4,4038,0,13490.0,4,13495.0,2,S
2018-04-25 21:52:53,13490.0,2,4040,-2,13490.0,9,13495.0,2,S
2018-04-25 21:53:07,13495.0,2,4042,-2,13490.0,19,13495.0,1,B
2018-04-25 21:53:08,13495.0,2,4044,0,13490.0,19,13500.0,18,B
2018-04-25 21:53:12,13490.0,2,4046,-2,13490.0,18,13500.0,18,S
2018-04-25 21:53:25,13495.0,2,4048,0,13490.0,18,13500.0,35,B
2018-04-25 21:53:38,13490.0,4,4052,0,13490.0,19,13495.0,1,S
2018-04-25 21:53:45,13490.0,10,4062,0,13490.0,14,13495.0,3,S
2018-04-25 21:53:49,13495.0,4,4066,0,13490.0,14,13495.0,1,B
2018-04-25 21:53:56,13490.0,6,4072,0,13490.0,9,13495.0,2,S
2018-04-25 21:54:10,13495.0,2,4074,2,13495.0,1,13500.0,35,B
2018-04-25 21:54:11,13495.0,2,4076,0,13490.0,12,13500.0,35,B
2018-04-25 21:54:16,13495.0,10,4086,4,13490.0,31,13500.0,6,B
2018-04-25 21:54:24,13495.0,10,4096,6,13495.0,1,13500.0,8,B
2018-04-25 21:54:39,13495.0,2,4098,0,13490.0,15,13500.0,25,B
2018-04-25 21:54:43,13495.0,2,4100,0,13490.0,11,13495.0,4,B
2018-04-25 21:55:07,13490.0,4,4104,-4,13490.0,9,13495.0,7,S
2018-04-25 21:55:27,13490.0,2,4106,0,13490.0,10,13495.0,5,S
2018-04-25 21:56:02,13490.0,14,4120,-2,13485.0,20,13490.0,9,S
2018-04-25 21:56:15,13490.0,4,4124,-2,13490.0,1,13495.0,21,S
2018-04-25 21:56:15,13490.0,2,4126,-2,13485.0,20,13495.0,21,S
2018-04-25 21:56:35,13490.0,4,4130,0,13485.0,22,13490.0,5,S
2018-04-25 21:56:35,13490.0,4,4134,-4,13485.0,22,13495.0,37,S
2018-04-25 21:57:03,13495.0,2,4136,-2,13490.0,10,13495.0,2,B
2018-04-25 21:57:46,13495.0,2,4138,0,13490.0,6,13495.0,3,B
2018-04-25 21:58:00,13490.0,6,4144,-2,13490.0,7,13495.0,10,S
2018-04-25 21:58:05,13490.0,4,4148,-2,13490.0,5,13495.0,14,S
2018-04-25 21:58:21,13490.0,12,4160,-10,13485.0,21,13490.0,1,S
2018-04-25 21:58:26,13485.0,2,4162,2,13485.0,17,13490.0,18,S
2018-04-25 21:58:27,13485.0,12,4174,2,13485.0,9,13490.0,22,S
2018-04-25 21:58:27,13485.0,16,4190,-10,13485.0,1,13490.0,22,S
2018-04-25 21:58:28,13485.0,2,4192,0,13480.0,14,13485.0,2,S
2018-04-25 21:58:31,13485.0,2,4194,-2,13485.0,1,13490.0,22,S
2018-04-25 21:58:52,13480.0,2,4196,2,13480.0,12,13485.0,25,S
2018-04-25 21:58:52,13480.0,24,4220,-20,13475.0,44,13480.0,11,S
2018-04-25 21:59:03,13480.0,4,4224,0,13475.0,52,13480.0,9,S
2018-04-25 21:59:04,13480.0,18,4242,0,13480.0,2,13485.0,22,S
2018-04-25 21:59:10,13485.0,34,4276,-18,13480.0,16,13490.0,6,B
2018-04-25 21:59:32,13490.0,2,4278,2,13485.0,7,13490.0,10,B
2018-04-25 21:59:42,13490.0,2,4280,0,13485.0,7,13490.0,7,B
2018-04-25 21:59:43,13485.0,2,4282,-2,13485.0,6,13490.0,6,S
2018-04-25 21:59:45,13490.0,2,4284,2,13485.0,7,13490.0,5,B
2018-04-25 21:59:48,13490.0,2,4286,0,13485.0,7,13490.0,7,B
2018-04-25 22:00:01,13485.0,2,4288,-2,13485.0,7,13490.0,13,S
2018-04-25 22:00:02,13485.0,12,4300,-6,13480.0,14,13485.0,10,S
2018-04-25 22:00:04,13480.0,6,4306,4,13475.0,51,13480.0,2,S
2018-04-25 22:00:04,13480.0,2,4308,2,13475.0,45,13480.0,6,S
2018-04-25 22:00:08,13480.0,10,4318,0,13475.0,45,13480.0,1,S
2018-04-25 22:00:09,13480.0,2,4320,2,13480.0,1,13485.0,23,S
2018-04-25 22:00:13,13485.0,4,4324,0,13480.0,6,13485.0,12,B
2018-04-25 22:00:23,13485.0,4,4328,0,13480.0,12,13485.0,1,B
2018-04-25 22:00:24,13485.0,2,4330,0,13485.0,3,13490.0,10,B
2018-04-25 22:00:30,13480.0,6,4336,0,13480.0,2,13485.0,17,S
2018-04-25 22:00:31,13485.0,16,4352,-2,13480.0,11,13485.0,4,B
2018-04-25 22:00:31,13485.0,8,4360,8,13485.0,8,13490.0,11,B
2018-04-25 22:00:41,13485.0,2,4362,-2,13480.0,17,13485.0,1,B
2018-04-25 22:00:41,13485.0,2,4364,0,13480.0,17,13490.0,19,B
2018-04-25 22:00:53,13485.0,6,4370,0,13485.0,1,13490.0,19,B
2018-04-25 22:01:21,13485.0,2,4372,0,13485.0,5,13490.0,20,B
2018-04-25 22:01:34,13490.0,22,4394,-14,13485.0,10,13490.0,8,B
2018-04-25 22:01:34,13490.0,16,4410,2,13490.0,11,13495.0,8,B
2018-04-25 22:01:45,13495.0,2,4412,0,13490.0,10,13495.0,2,B
2018-04-25 22:01:58,13495.0,2,4414,0,13495.0,2,13500.0,13,B
2018-04-25 22:02:00,13495.0,2,4416,0,13495.0,6,13500.0,10,B
2018-04-25 22:02:06,13500.0,4,4420,0,13495.0,7,13500.0,4,B
2018-04-25 22:02:07,13500.0,2,4422,0,13495.0,7,13500.0,3,B
2018-04-25 22:02:22,13495.0,12,4434,10,13490.0,16,13495.0,1,S
2018-04-25 22:02:23,13495.0,2,4436,0,13490.0,7,13495.0,5,S
2018-04-25 22:02:31,13495.0,12,4448,0,13495.0,1,13500.0,12,S
2018-04-25 22:03:19,13495.0,4,4452,-4,13495.0,5,13500.0,9,S
2018-04-25 22:03:19,13495.0,4,4456,2,13495.0,3,13500.0,9,S
2018-04-25 22:03:24,13500.0,2,4458,-2,13495.0,3,13500.0,8,B
2018-04-25 22:03:35,13500.0,14,4472,6,13500.0,4,13505.0,11,B
2018-04-25 22:03:37,13500.0,2,4474,2,13500.0,3,13505.0,8,B
2018-04-25 22:03:39,13505.0,8,4482,4,13500.0,4,13505.0,4,B
2018-04-25 22:03:42,13500.0,2,4484,2,13500.0,3,13505.0,5,S
2018-04-25 22:03:46,13505.0,2,4486,-2,13500.0,8,13505.0,4,B
2018-04-25 22:03:52,13505.0,2,4488,-2,13500.0,6,13505.0,3,B
2018-04-25 22:04:13,13505.0,2,4490,-2,13500.0,12,13505.0,2,B
2018-04-25 22:04:18,13505.0,4,4494,2,13505.0,1,13510.0,13,B
2018-04-25 22:04:19,13505.0,2,4496,0,13500.0,12,13505.0,6,B
2018-04-25 22:04:19,13505.0,2,4498,0,13500.0,12,13505.0,5,B
2018-04-25 22:04:24,13505.0,10,4508,4,13500.0,11,13505.0,1,B
2018-04-25 22:04:27,13505.0,2,4510,0,13500.0,11,13510.0,15,B
2018-04-25 22:04:29,13505.0,2,4512,-2,13500.0,12,13505.0,1,B
2018-04-25 22:04:30,13510.0,2,4514,0,13500.0,12,13510.0,26,B
2018-04-25 22:04:57,13510.0,2,4516,-2,13500.0,17,13510.0,21,B
2018-04-25 22:04:58,13510.0,4,4520,0,13505.0,2,13510.0,19,B
2018-04-25 22:05:21,13505.0,2,4522,0,13505.0,1,13510.0,14,S
2018-04-25 22:05:28,13510.0,18,4540,-10,13505.0,11,13510.0,5,B
2018-04-25 22:05:29,13510.0,10,4550,4,13510.0,5,13515.0,5,B
2018-04-25 22:05:39,13515.0,2,4552,2,13510.0,6,13515.0,2,B
2018-04-25 22:05:39,13515.0,2,4554,-2,13510.0,6,13515.0,1,B
2018-04-25 22:05:43,13510.0,4,4558,4,13510.0,4,13515.0,7,S
2018-04-25 22:05:43,13510.0,8,4566,-6,13505.0,14,13510.0,5,S
2018-04-25 22:05:54,13510.0,4,4570,0,13505.0,20,13510.0,3,S
2018-04-25 22:05:55,13510.0,2,4572,2,13505.0,20,13515.0,16,S
2018-04-25 22:05:57,13510.0,2,4574,2,13505.0,20,13515.0,15,S
2018-04-25 22:06:00,13515.0,4,4578,2,13505.0,20,13515.0,13,B
2018-04-25 22:06:15,13515.0,22,4600,18,13515.0,34,13520.0,45,B
2018-04-25 22:06:16,13515.0,12,4612,4,13515.0,28,13520.0,55,B
2018-04-25 22:06:16,13515.0,2,4614,2,13515.0,27,13520.0,42,B
2018-04-25 22:06:34,13520.0,2,4616,-2,13515.0,28,13520.0,29,B
2018-04-25 22:06:37,13515.0,16,4632,16,13515.0,20,13520.0,30,S
2018-04-25 22:06:37,13515.0,40,4672,18,13510.0,8,13515.0,30,S
2018-04-25 22:07:22,13515.0,2,4674,2,13510.0,15,13515.0,3,S
2018-04-25 22:07:25,13510.0,2,4676,2,13510.0,14,13515.0,4,S
2018-04-25 22:07:36,13515.0,8,4684,6,13510.0,16,13520.0,39,B
2018-04-25 22:07:40,13510.0,2,4686,0,13510.0,16,13520.0,33,S
2018-04-25 22:07:45,13520.0,2,4688,0,13510.0,16,13520.0,32,B
2018-04-25 22:07:48,13515.0,2,4690,0,13510.0,16,13520.0,27,S
2018-04-25 22:08:09,13520.0,4,4694,2,13510.0,17,13520.0,31,B
2018-04-25 22:08:22,13515.0,6,4700,6,13510.0,11,13520.0,26,S
2018-04-25 22:08:30,13510.0,2,4702,2,13510.0,13,13520.0,32,S
2018-04-25 22:09:34,13510.0,2,4704,0,13505.0,22,13515.0,16,S
2018-04-25 22:09:42,13505.0,10,4714,2,13505.0,17,13515.0,21,S
2018-04-25 22:09:55,13505.0,2,4716,2,13505.0,16,13515.0,25,S
2018-04-25 22:10:43,13505.0,6,4722,0,13505.0,11,13510.0,4,S
2018-04-25 22:10:59,13510.0,2,4724,-2,13505.0,12,13510.0,2,B
2018-04-25 22:11:05,13505.0,14,4738,8,13500.0,18,13505.0,1,S
2018-04-25 22:11:05,13505.0,2,4740,-2,13500.0,12,13505.0,2,S
2018-04-25 22:11:30,13505.0,4,4744,4,13500.0,17,13505.0,1,S
2018-04-25 22:11:31,13505.0,2,4746,2,13505.0,3,13510.0,8,S
2018-04-25 22:11:44,13510.0,2,4748,0,13505.0,4,13510.0,7,B
2018-04-25 22:11:52,13505.0,8,4756,-2,13500.0,19,13505.0,1,S
2018-04-25 22:13:39,13505.0,2,4758,0,13500.0,23,13505.0,3,S
2018-04-25 22:13:40,13505.0,6,4764,0,13505.0,2,13510.0,9,S
2018-04-25 22:13:53,13505.0,2,4766,2,13505.0,2,13510.0,8,S
2018-04-25 22:14:05,13510.0,8,4774,4,13510.0,4,13515.0,11,B
2018-04-25 22:14:15,13510.0,2,4776,-2,13505.0,14,13510.0,4,B
2018-04-25 22:16:30,13505.0,6,4782,-2,13500.0,18,13510.0,23,S
2018-04-25 22:16:34,13500.0,2,4784,0,13500.0,16,13505.0,6,S
2018-04-25 22:16:45,13500.0,4,4788,0,13500.0,10,13505.0,5,S
2018-04-25 22:16:54,13500.0,20,4808,-16,13495.0,12,13500.0,35,S
2018-04-25 22:16:54,13500.0,2,4810,-2,13495.0,12,13500.0,34,S
2018-04-25 22:16:55,13500.0,6,4816,-6,13495.0,14,13500.0,31,S
2018-04-25 22:17:06,13495.0,2,4818,2,13495.0,10,13500.0,32,S
2018-04-25 22:17:17,13495.0,2,4820,2,13495.0,9,13500.0,32,S
2018-04-25 22:17:26,13495.0,12,4832,-6,13495.0,2,13500.0,31,S
2018-04-25 22:18:14,13495.0,10,4842,2,13495.0,1,13500.0,31,S
2018-04-25 22:18:14,13495.0,4,4846,0,13490.0,26,13500.0,31,S
2018-04-25 22:18:15,13495.0,4,4850,0,13490.0,29,13500.0,32,S
2018-04-25 22:18:19,13500.0,2,4852,-2,13490.0,29,13500.0,33,B
2018-04-25 22:18:22,13490.0,2,4854,-2,13490.0,32,13500.0,33,S
2018-04-25 22:18:23,13490.0,2,4856,2,13490.0,31,13500.0,33,S
2018-04-25 22:18:25,13500.0,8,4864,0,13495.0,16,13500.0,26,B
2018-04-25 22:18:32,13495.0,10,4874,2,13495.0,43,13500.0,26,S
2018-04-25 22:18:41,13495.0,10,4884,6,13495.0,26,13500.0,26,S
2018-04-25 22:18:48,13495.0,10,4894,4,13495.0,21,13500.0,26,S
2018-04-25 22:18:52,13500.0,2,4896,-2,13495.0,22,13500.0,25,B
2018-04-25 22:18:53,13500.0,2,4898,-2,13495.0,31,13500.0,24,B
2018-04-25 22:18:53,13500.0,40,4938,-28,13495.0,52,13500.0,4,B
2018-04-25 22:18:54,13500.0,8,4946,-8,13500.0,5,13505.0,11,B
2018-04-25 22:18:55,13505.0,10,4956,-10,13495.0,48,13505.0,4,B
2018-04-25 22:18:56,13495.0,10,4966,10,13495.0,44,13505.0,5,S
2018-04-25 22:19:08,13500.0,4,4970,2,13500.0,1,13505.0,5,B
2018-04-25 22:19:28,13505.0,6,4976,-2,13505.0,1,13510.0,24,B
2018-04-25 22:19:29,13505.0,2,4978,0,13500.0,23,13510.0,10,B
2018-04-25 22:19:44,13510.0,8,4986,6,13505.0,8,13515.0,20,B
2018-04-25 22:19:46,13515.0,8,4994,4,13510.0,5,13520.0,37,B
2018-04-25 22:19:47,13515.0,6,5000,0,13510.0,8,13515.0,10,B
2018-04-25 22:20:13,13515.0,2,5002,0,13510.0,8,13515.0,5,B
2018-04-25 22:20:17,13510.0,18,5020,14,13505.0,12,13510.0,1,S
2018-04-25 22:20:17,13505.0,26,5046,10,13500.0,12,13510.0,9,S
2018-04-25 22:20:18,13510.0,2,5048,0,13505.0,2,13510.0,9,B
2018-04-25 22:20:18,13505.0,2,5050,0,13505.0,1,13510.0,10,S
2018-04-25 22:20:37,13510.0,2,5052,0,13505.0,6,13510.0,3,B
2018-04-25 22:20:37,13510.0,6,5058,-2,13510.0,3,13515.0,8,B
2018-04-25 22:20:39,13510.0,2,5060,0,13505.0,6,13510.0,4,B
2018-04-25 22:20:47,13510.0,2,5062,0,13505.0,8,13510.0,5,B
2018-04-25 22:20:47,13510.0,10,5072,-10,13505.0,11,13515.0,9,B
2018-04-25 22:20:49,13515.0,2,5074,0,13505.0,11,13515.0,8,B
2018-04-25 22:21:01,13510.0,4,5078,-4,13510.0,2,13515.0,10,S
2018-04-25 22:21:02,13510.0,2,5080,0,13510.0,6,13515.0,8,S
2018-04-25 22:21:51,13515.0,12,5092,2,13515.0,14,13520.0,33,B
2018-04-25 22:21:51,13515.0,8,5100,2,13515.0,10,13520.0,37,B
2018-04-25 22:21:52,13515.0,20,5120,12,13510.0,5,13520.0,37,B
2018-04-25 22:21:56,13510.0,4,5124,0,13505.0,10,13515.0,27,S
2018-04-25 22:22:08,13515.0,2,5126,-2,13515.0,2,13520.0,43,B
2018-04-25 22:22:10,13515.0,4,5130,0,13510.0,26,13515.0,1,B
2018-04-25 22:22:11,13515.0,2,5132,2,13510.0,26,13520.0,36,B
2018-04-25 22:22:12,13520.0,86,5218,64,13520.0,2,13525.0,16,B
2018-04-25 22:22:13,13520.0,10,5228,6,13515.0,4,13520.0,1,B
2018-04-25 22:22:22,13520.0,18,5246,-8,13515.0,14,13525.0,7,B
2018-04-25 22:22:26,13520.0,2,5248,0,13515.0,19,13525.0,10,B
2018-04-25 22:22:31,13520.0,2,5250,0,13515.0,18,13525.0,8,B
2018-04-25 22:22:35,13520.0,2,5252,2,13515.0,18,13525.0,9,B
2018-04-25 22:22:37,13515.0,2,5254,-2,13515.0,17,13525.0,10,S
2018-04-25 22:23:04,13520.0,2,5256,0,13515.0,19,13520.0,1,B
2018-04-25 22:23:04,13520.0,4,5260,0,13520.0,1,13525.0,14,B
2018-04-25 22:23:07,13520.0,4,5264,0,13515.0,19,13525.0,13,B
2018-04-25 22:23:22,13525.0,10,5274,-2,13515.0,8,13525.0,11,B
2018-04-25 22:23:34,13525.0,18,5292,4,13525.0,1,13530.0,17,B
2018-04-25 22:23:45,13525.0,4,5296,-2,13520.0,6,13525.0,6,B
2018-04-25 22:23:48,13520.0,2,5298,-2,13520.0,5,13525.0,6,S
2018-04-25 22:24:00,13525.0,2,5300,0,13520.0,7,13525.0,11,B
2018-04-25 22:24:10,13520.0,10,5310,-6,13520.0,2,13525.0,13,S
2018-04-25 22:24:10,13520.0,4,5314,-4,13515.0,8,13525.0,14,S
2018-04-25 22:24:21,13520.0,2,5316,0,13520.0,1,13525.0,14,S
2018-04-25 22:24:27,13520.0,2,5318,0,13515.0,9,13520.0,1,S
2018-04-25 22:24:33,13515.0,2,5320,0,13515.0,8,13525.0,10,S
2018-04-25 22:25:11,13515.0,12,5332,6,13515.0,4,13520.0,15,S
2018-04-25 22:25:21,13515.0,2,5334,0,13515.0,9,13520.0,10,S
2018-04-25 22:27:04,13515.0,16,5350,2,13510.0,158,13515.0,12,S
2018-04-25 22:27:05,13515.0,24,5374,16,13515.0,2,13520.0,3,S
2018-04-25 22:27:18,13520.0,6,5380,-2,13515.0,15,13525.0,12,B
2018-04-25 22:27:28,13525.0,2,5382,0,13520.0,2,13525.0,11,B
2018-04-25 22:27:28,13520.0,6,5388,0,13515.0,17,13520.0,2,S
2018-04-25 22:27:29,13520.0,4,5392,0,13520.0,2,13525.0,9,S
2018-04-25 22:27:46,13525.0,10,5402,0,13520.0,2,13525.0,3,B
2018-04-25 22:28:02,13525.0,8,5410,-2,13525.0,5,13530.0,13,B
2018-04-25 22:28:03,13530.0,4,5414,-2,13525.0,5,13530.0,9,B
2018-04-25 22:28:03,13530.0,14,5428,0,13525.0,2,13530.0,1,B
2018-04-25 22:28:11,13530.0,2,5430,0,13525.0,9,13530.0,2,B
2018-04-25 22:28:11,13530.0,2,5432,0,13525.0,9,13530.0,2,B
2018-04-25 22:28:12,13530.0,4,5436,0,13530.0,1,13535.0,26,B
2018-04-25 22:28:12,13535.0,18,5454,12,13530.0,5,13535.0,4,B
2018-04-25 22:28:13,13535.0,8,5462,-2,13530.0,8,13540.0,28,B
2018-04-25 22:28:13,13530.0,2,5464,0,13530.0,8,13540.0,31,S
2018-04-25 22:28:17,13530.0,2,5466,0,13525.0,9,13530.0,6,S
2018-04-25 22:28:20,13530.0,2,5468,0,13530.0,7,13535.0,2,S
2018-04-25 22:28:21,13535.0,4,5472,-2,13530.0,12,13540.0,30,B
2018-04-25 22:28:22,13535.0,2,5474,0,13535.0,2,13540.0,32,B
2018-04-25 22:28:23,13535.0,32,5506,8,13530.0,11,13540.0,30,B
2018-04-25 22:28:24,13530.0,4,5510,0,13530.0,10,13540.0,20,S
2018-04-25 22:28:24,13535.0,54,5564,38,13535.0,1,13540.0,6,B
2018-04-25 22:28:25,13535.0,2,5566,2,13530.0,4,13535.0,11,B
2018-04-25 22:28:25,13530.0,8,5574,0,13525.0,7,13535.0,26,S
2018-04-25 22:28:32,13530.0,8,5582,-8,13530.0,1,13535.0,25,S
2018-04-25 22:28:33,13535.0,24,5606,8,13535.0,5,13540.0,8,B
2018-04-25 22:28:34,13540.0,2,5608,2,13540.0,3,13545.0,9,B
2018-04-25 22:28:35,13545.0,8,5616,-6,13535.0,8,13545.0,4,B
2018-04-25 22:28:38,13535.0,2,5618,0,13535.0,8,13545.0,10,S
2018-04-25 22:28:44,13535.0,2,5620,0,13540.0,16,13545.0,11,S
2018-04-25 22:28:45,13540.0,26,5646,16,13540.0,3,13545.0,13,B
2018-04-25 22:28:45,13540.0,6,5652,0,13535.0,2,13540.0,13,B
2018-04-25 22:28:47,13540.0,2,5654,-2,13540.0,2,13545.0,15,B
2018-04-25 22:28:51,13540.0,4,5658,-2,13540.0,2,13545.0,16,B
2018-04-25 22:28:53,13540.0,12,5670,6,13535.0,7,13540.0,1,B
2018-04-25 22:28:56,13540.0,2,5672,0,13540.0,3,13545.0,19,B
2018-04-25 22:29:05,13540.0,2,5674,2,13540.0,6,13545.0,14,B
2018-04-25 22:29:06,13540.0,12,5686,8,13540.0,1,13545.0,9,B
2018-04-25 22:29:09,13540.0,2,5688,0,13540.0,14,13545.0,9,B
2018-04-25 22:29:10,13540.0,10,5698,-6,13540.0,2,13545.0,11,B
2018-04-25 22:29:11,13540.0,2,5700,0,13535.0,12,13545.0,10,B
2018-04-25 22:29:21,13540.0,2,5702,0,13540.0,3,13545.0,10,B
2018-04-25 22:29:28,13540.0,2,5704,0,13540.0,2,13545.0,11,B
2018-04-25 22:29:30,13545.0,12,5716,-8,13540.0,12,13550.0,60,B
2018-04-25 22:29:31,13540.0,16,5732,-2,13540.0,6,13550.0,64,S
2018-04-25 22:29:32,13545.0,4,5736,4,13545.0,3,13550.0,65,B
2018-04-25 22:29:32,13545.0,6,5742,6,13540.0,5,13545.0,4,B
2018-04-25 22:29:41,13540.0,10,5752,6,13535.0,8,13545.0,16,S
2018-04-25 22:29:44,13540.0,2,5754,0,13535.0,8,13545.0,15,S
2018-04-25 22:29:47,13535.0,4,5758,-4,13535.0,6,13545.0,16,S
2018-04-25 22:29:48,13545.0,12,5770,-4,13540.0,9,13545.0,1,B
2018-04-25 22:29:49,13545.0,2,5772,-2,13540.0,13,13550.0,63,B
2018-04-25 22:29:51,13550.0,4,5776,4,13545.0,4,13550.0,56,B
2018-04-25 22:29:52,13550.0,2,5778,0,13545.0,4,13550.0,55,B
2018-04-25 22:29:52,13550.0,10,5788,10,13545.0,4,13550.0,50,B
2018-04-25 22:29:53,13550.0,4,5792,0,13545.0,4,13550.0,47,B
2018-04-25 22:29:54,13550.0,20,5812,20,13545.0,4,13550.0,37,B
2018-04-25 22:29:55,13550.0,6,5818,4,13545.0,4,13550.0,34,B
2018-04-25 22:29:57,13550.0,4,5822,4,13545.0,4,13550.0,32,B
2018-04-25 22:29:58,13550.0,2,5824,0,13545.0,4,13550.0,31,B
2018-04-25 22:30:02,13545.0,2,5826,0,13540.0,15,13550.0,34,S
2018-04-25 22:30:02,13550.0,10,5836,-4,13545.0,2,13550.0,29,B
2018-04-25 22:30:03,13545.0,2,5838,0,13540.0,15,13550.0,29,S
2018-04-25 22:30:05,13540.0,4,5842,0,13535.0,7,13540.0,4,S
2018-04-25 22:30:08,13540.0,6,5848,0,13535.0,4,13545.0,21,S
2018-04-25 22:30:11,13540.0,2,5850,2,13540.0,2,13545.0,14,S
2018-04-25 22:30:11,13540.0,4,5854,4,13535.0,14,13545.0,21,S
2018-04-25 22:30:17,13540.0,8,5862,-6,13535.0,7,13540.0,1,S
2018-04-25 22:30:24,13535.0,12,5874,-8,13530.0,11,13540.0,15,S
2018-04-25 22:30:28,13535.0,6,5880,0,13530.0,7,13535.0,3,S
2018-04-25 22:30:46,13535.0,4,5884,2,13535.0,1,13540.0,17,S
2018-04-25 22:30:47,13540.0,2,5886,-2,13540.0,3,13545.0,18,B
2018-04-25 22:30:48,13540.0,2,5888,2,13540.0,1,13545.0,23,B
2018-04-25 22:30:49,13540.0,2,5890,2,13535.0,16,13545.0,23,B
2018-04-25 22:30:57,13535.0,10,5900,0,13535.0,2,13540.0,3,S
2018-04-25 22:31:26,13540.0,12,5912,-4,13535.0,10,13540.0,2,B
2018-04-25 22:31:26,13540.0,4,5916,-2,13535.0,24,13545.0,23,B
2018-04-25 22:31:37,13540.0,8,5924,-2,13535.0,10,13540.0,17,B
2018-04-25 22:31:39,13535.0,4,5928,4,13535.0,2,13540.0,12,S
2018-04-25 22:31:39,13535.0,4,5932,2,13530.0,28,13540.0,16,S
2018-04-25 22:31:47,13535.0,6,5938,4,13535.0,2,13540.0,16,S
2018-04-25 22:31:47,13535.0,6,5944,0,13530.0,30,13540.0,14,S
2018-04-25 22:32:18,13540.0,12,5956,0,13535.0,25,13540.0,4,B
2018-04-25 22:32:19,13540.0,8,5964,6,13540.0,4,13545.0,21,B
2018-04-25 22:32:19,13540.0,8,5972,-2,13535.0,13,13540.0,1,B
2018-04-25 22:32:20,13540.0,4,5976,4,13535.0,25,13545.0,21,B
2018-04-25 22:32:36,13530.0,2,5978,0,13530.0,17,13535.0,2,S
2018-04-25 22:32:42,13530.0,8,5986,-2,13530.0,5,13535.0,15,S
2018-04-25 22:32:42,13530.0,4,5990,0,13530.0,3,13535.0,15,S
2018-04-25 22:32:43,13530.0,6,5996,-2,13530.0,1,13535.0,15,S
2018-04-25 22:32:43,13530.0,2,5998,0,13525.0,13,13535.0,15,S
2018-04-25 22:32:44,13530.0,2,6000,0,13525.0,20,13535.0,15,S
2018-04-25 22:33:06,13535.0,2,6002,0,13530.0,11,13535.0,6,B
2018-04-25 22:34:17,13530.0,18,6020,2,13525.0,22,13535.0,12,S
2018-04-25 22:34:46,13525.0,20,6040,-12,13525.0,8,13530.0,2,S
2018-04-25 22:34:47,13525.0,4,6044,4,13525.0,6,13530.0,2,S
2018-04-25 22:34:48,13525.0,12,6056,-4,13520.0,20,13530.0,2,S
2018-04-25 22:34:49,13520.0,6,6062,-4,13515.0,38,13525.0,10,S
2018-04-25 22:34:50,13525.0,10,6072,2,13515.0,42,13520.0,5,B
2018-04-25 22:34:50,13515.0,20,6092,-20,13515.0,15,13520.0,5,S
2018-04-25 22:34:51,13520.0,2,6094,-2,13515.0,20,13520.0,4,B
2018-04-25 22:34:54,13520.0,2,6096,-2,13515.0,17,13520.0,4,B
2018-04-25 22:35:02,13520.0,6,6102,-2,13515.0,18,13520.0,7,B
2018-04-25 22:35:03,13515.0,2,6104,0,13515.0,13,13520.0,9,S
2018-04-25 22:35:03,13515.0,26,6130,-4,13510.0,144,13515.0,8,S
2018-04-25 22:35:04,13515.0,16,6146,2,13510.0,131,13515.0,3,S
2018-04-25 22:35:04,13515.0,6,6152,-6,13510.0,131,13520.0,21,S
2018-04-25 22:35:05,13515.0,4,6156,0,13510.0,131,13520.0,21,S
2018-04-25 22:35:06,13515.0,8,6164,0,13510.0,132,13520.0,21,S
2018-04-25 22:35:07,13515.0,2,6166,0,13510.0,132,13520.0,21,S
2018-04-25 22:35:08,13515.0,2,6168,0,13510.0,132,13520.0,21,S
2018-04-25 22:35:10,13515.0,6,6174,2,13510.0,133,13515.0,27,S
2018-04-25 22:35:11,13510.0,2,6176,2,13510.0,132,13515.0,26,S
2018-04-25 22:35:11,13510.0,10,6186,10,13510.0,127,13515.0,23,S
2018-04-25 22:35:12,13510.0,30,6216,22,13510.0,112,13515.0,31,S
2018-04-25 22:35:12,13510.0,8,6224,8,13510.0,108,13515.0,28,S
2018-04-25 22:35:13,13510.0,12,6236,0,13510.0,102,13515.0,15,S
2018-04-25 22:35:15,13515.0,4,6240,2,13510.0,103,13515.0,8,B
2018-04-25 22:35:16,13515.0,4,6244,-4,13510.0,108,13515.0,4,B
2018-04-25 22:35:16,13510.0,10,6254,0,13510.0,108,13515.0,1,S
2018-04-25 22:35:18,13515.0,2,6256,2,13510.0,102,13515.0,12,B
2018-04-25 22:35:18,13510.0,10,6266,0,13510.0,97,13515.0,12,S
2018-04-25 22:35:19,13510.0,2,6268,2,13510.0,96,13515.0,12,S
2018-04-25 22:35:19,13510.0,2,6270,2,13510.0,95,13515.0,13,S
2018-04-25 22:35:20,13510.0,6,6276,6,13510.0,92,13515.0,13,S
2018-04-25 22:35:21,13510.0,34,6310,14,13510.0,75,13515.0,27,S
2018-04-25 22:35:22,13510.0,10,6320,2,13510.0,70,13515.0,39,S
2018-04-25 22:35:22,13510.0,30,6350,0,13510.0,55,13515.0,39,S
2018-04-25 22:35:23,13510.0,50,6400,-20,13510.0,30,13515.0,39,S
2018-04-25 22:35:23,13510.0,60,6460,2,13505.0,6,13510.0,5,S
2018-04-25 22:35:24,13505.0,2,6462,0,13505.0,2,13510.0,7,S
2018-04-25 22:35:29,13510.0,14,6476,8,13505.0,15,13515.0,9,B
2018-04-25 22:35:30,13505.0,14,6490,0,13500.0,33,13510.0,9,S
2018-04-25 22:35:31,13505.0,2,6492,-2,13500.0,29,13510.0,34,S
2018-04-25 22:35:32,13500.0,4,6496,-2,13500.0,28,13510.0,38,S
2018-04-25 22:35:33,13500.0,10,6506,0,13500.0,23,13505.0,1,S
2018-04-25 22:35:34,13500.0,20,6526,-8,13500.0,15,13505.0,38,S
2018-04-25 22:35:34,13505.0,8,6534,2,13500.0,16,13505.0,4,B
2018-04-25 22:35:35,13500.0,8,6542,2,13500.0,18,13505.0,1,S
2018-04-25 22:35:35,13505.0,12,6554,-8,13505.0,4,13510.0,6,B
2018-04-25 22:35:37,13500.0,10,6564,0,13500.0,22,13505.0,4,S
2018-04-25 22:35:40,13500.0,2,6566,-2,13500.0,12,13505.0,11,S
2018-04-25 22:35:46,13505.0,12,6578,-2,13500.0,25,13510.0,8,B
2018-04-25 22:35:53,13500.0,10,6588,-10,13500.0,10,13510.0,32,S
2018-04-25 22:35:56,13505.0,2,6590,0,13500.0,10,13505.0,2,B
2018-04-25 22:36:01,13500.0,14,6604,8,13495.0,6,13500.0,4,S
2018-04-25 22:36:03,13495.0,4,6608,-4,13490.0,14,13495.0,2,S
2018-04-25 22:36:07,13490.0,10,6618,2,13490.0,3,13495.0,15,S
2018-04-25 22:36:08,13490.0,2,6620,0,13490.0,2,13495.0,29,S
2018-04-25 22:36:08,13490.0,2,6622,0,13490.0,1,13495.0,29,S
2018-04-25 22:36:09,13490.0,2,6624,-2,13485.0,6,13495.0,29,S
2018-04-25 22:36:13,13485.0,4,6628,-4,13480.0,14,13485.0,43,S
2018-04-25 22:36:14,13485.0,6,6634,-6,13480.0,21,13485.0,41,S
2018-04-25 22:36:14,13485.0,2,6636,-2,13480.0,19,13485.0,40,S
2018-04-25 22:36:15,13480.0,2,6638,-2,13480.0,12,13485.0,42,S
2018-04-25 22:36:15,13475.0,22,6660,12,13475.0,30,13480.0,10,S
2018-04-25 22:36:16,13475.0,52,6712,42,13475.0,2,13480.0,26,S
2018-04-25 22:36:16,13465.0,28,6740,10,13465.0,6,13475.0,21,S
2018-04-25 22:36:17,13465.0,14,6754,-12,13460.0,12,13465.0,17,S
2018-04-25 22:36:17,13465.0,40,6794,-28,13465.0,23,13470.0,11,S
2018-04-25 22:36:18,13470.0,16,6810,-4,13470.0,10,13475.0,13,B
2018-04-25 22:36:19,13475.0,18,6828,8,13470.0,6,13480.0,11,B
2018-04-25 22:36:21,13475.0,4,6832,-4,13475.0,8,13480.0,13,B
2018-04-25 22:36:24,13475.0,18,6850,-12,13470.0,7,13475.0,19,B
2018-04-25 22:36:25,13470.0,2,6852,0,13465.0,6,13475.0,19,S
2018-04-25 22:36:26,13470.0,2,6854,-2,13470.0,6,13475.0,25,S
2018-04-25 22:36:30,13475.0,2,6856,2,13470.0,11,13475.0,24,B
2018-04-25 22:36:32,13475.0,4,6860,-2,13470.0,37,13475.0,22,B
2018-04-25 22:36:33,13470.0,122,6982,10,13465.0,11,13480.0,15,S
2018-04-25 22:36:34,13470.0,6,6988,2,13470.0,4,13475.0,1,S
2018-04-25 22:36:34,13480.0,16,7004,-4,13475.0,23,13485.0,7,B
2018-04-25 22:36:35,13480.0,4,7008,0,13480.0,2,13485.0,13,B
2018-04-25 22:36:36,13500.0,80,7088,-28,13480.0,5,13495.0,2,B
2018-04-25 22:36:36,13490.0,2,7090,0,13485.0,5,13490.0,1,S
2018-04-25 22:36:37,13490.0,6,7096,-4,13485.0,8,13495.0,16,S
2018-04-25 22:36:38,13490.0,2,7098,0,13485.0,12,13490.0,1,S
2018-04-25 22:36:38,13490.0,2,7100,0,13490.0,7,13495.0,10,S
2018-04-25 22:36:40,13485.0,6,7106,2,13485.0,7,13495.0,13,S
2018-04-25 22:36:41,13485.0,12,7118,2,13480.0,7,13490.0,7,S
2018-04-25 22:36:49,13490.0,2,7120,0,13480.0,35,13490.0,16,B
2018-04-25 22:36:50,13490.0,4,7124,0,13485.0,2,13490.0,20,B
2018-04-25 22:36:51,13480.0,24,7148,-16,13480.0,23,13485.0,1,S
2018-04-25 22:36:51,13485.0,6,7154,2,13480.0,23,13490.0,22,B
2018-04-25 22:36:57,13480.0,4,7158,0,13480.0,33,13490.0,12,S
2018-04-25 22:36:58,13485.0,2,7160,-2,13480.0,33,13490.0,11,B
2018-04-25 22:37:02,13480.0,20,7180,0,13480.0,10,13490.0,34,S
2018-04-25 22:37:03,13490.0,14,7194,-8,13485.0,1,13490.0,30,B
2018-04-25 22:37:03,13485.0,2,7196,0,13480.0,11,13485.0,2,S
2018-04-25 22:37:04,13480.0,2,7198,0,13480.0,10,13485.0,3,S
2018-04-25 22:37:05,13485.0,4,7202,0,13480.0,14,13485.0,1,B
2018-04-25 22:37:06,13485.0,2,7204,0,13485.0,7,13490.0,19,B
2018-04-25 22:37:07,13485.0,4,7208,0,13485.0,8,13490.0,11,B
2018-04-25 22:37:09,13485.0,8,7216,-6,13485.0,4,13490.0,11,B
2018-04-25 22:37:10,13490.0,2,7218,2,13485.0,4,13490.0,10,B
2018-04-25 22:37:11,13490.0,2,7220,2,13485.0,6,13490.0,9,B
2018-04-25 22:37:12,13485.0,12,7232,6,13480.0,23,13485.0,14,S
2018-04-25 22:37:12,13485.0,18,7250,18,13480.0,23,13485.0,6,S
2018-04-25 22:37:13,13485.0,12,7262,-2,13485.0,2,13490.0,10,S
2018-04-25 22:37:14,13490.0,18,7280,18,13490.0,6,13495.0,8,B
2018-04-25 22:37:15,13490.0,2,7282,-2,13490.0,5,13495.0,4,B
2018-04-25 22:37:25,13495.0,8,7290,-4,13495.0,2,13500.0,29,B
2018-04-25 22:37:51,13500.0,2,7292,-2,13490.0,26,13500.0,24,B
2018-04-25 22:37:51,13500.0,4,7296,0,13495.0,2,13500.0,22,B
2018-04-25 22:37:57,13500.0,12,7308,-2,13500.0,4,13505.0,24,B
2018-04-25 22:38:01,13500.0,6,7314,-6,13500.0,1,13505.0,9,B
2018-04-25 22:38:01,13500.0,2,7316,-2,13495.0,14,13500.0,2,B
2018-04-25 22:38:02,13500.0,2,7318,0,13495.0,16,13505.0,14,B
2018-04-25 22:38:06,13495.0,6,7324,-6,13495.0,3,13500.0,23,S
2018-04-25 22:38:13,13500.0,12,7336,6,13500.0,4,13505.0,28,B
2018-04-25 22:38:16,13500.0,10,7346,-10,13495.0,28,13500.0,1,B
2018-04-25 22:38:24,13495.0,18,7364,2,13495.0,6,13500.0,5,S
2018-04-25 22:38:25,13495.0,12,7376,0,13490.0,21,13500.0,11,S
2018-04-25 22:38:42,13495.0,10,7386,-10,13490.0,28,13500.0,15,S
2018-04-25 22:38:50,13490.0,26,7412,-12,13490.0,6,13495.0,26,S
2018-04-25 22:38:51,13490.0,12,7424,2,13485.0,21,13490.0,1,S
2018-04-25 22:38:52,13485.0,16,7440,-16,13485.0,8,13490.0,10,S
2018-04-25 22:38:53,13485.0,6,7446,0,13485.0,2,13490.0,15,S
2018-04-25 22:38:53,13485.0,4,7450,2,13480.0,15,13490.0,16,S
2018-04-25 22:38:55,13490.0,4,7454,0,13485.0,5,13490.0,5,B
2018-04-25 22:38:55,13490.0,10,7464,-4,13485.0,12,13495.0,43,B
2018-04-25 22:38:58,13490.0,2,7466,0,13485.0,12,13490.0,7,B
2018-04-25 22:39:01,13485.0,6,7472,4,13480.0,23,13490.0,12,S
2018-04-25 22:39:03,13485.0,2,7474,-2,13480.0,17,13490.0,11,S
2018-04-25 22:39:18,13490.0,26,7500,-6,13490.0,1,13495.0,10,B
2018-04-25 22:39:32,13495.0,14,7514,2,13490.0,27,13500.0,10,B
2018-04-25 22:39:38,13495.0,2,7516,0,13490.0,15,13500.0,18,B
2018-04-25 22:39:45,13495.0,2,7518,0,13490.0,9,13500.0,18,B
2018-04-25 22:39:48,13490.0,8,7526,4,13485.0,10,13490.0,4,S
2018-04-25 22:39:48,13485.0,14,7540,-6,13480.0,19,13485.0,1,S
2018-04-25 22:39:49,13485.0,2,7542,0,13480.0,14,13485.0,1,S
2018-04-25 22:39:49,13485.0,2,7544,-2,13480.0,14,13490.0,21,S
2018-04-25 22:39:52,13485.0,2,7546,0,13480.0,14,13490.0,20,S
2018-04-25 22:40:02,13480.0,16,7562,0,13480.0,6,13485.0,10,S
2018-04-25 22:40:05,13485.0,2,7564,0,13480.0,9,13490.0,20,B
2018-04-25 22:40:19,13485.0,2,7566,0,13480.0,12,13490.0,20,B
2018-04-25 22:40:25,13490.0,12,7578,6,13490.0,3,13495.0,10,B
2018-04-25 22:40:49,13495.0,2,7580,0,13490.0,9,13495.0,4,B
2018-04-25 22:41:05,13495.0,2,7582,0,13490.0,10,13495.0,3,B
2018-04-25 22:41:06,13495.0,2,7584,-2,13490.0,10,13500.0,25,B
2018-04-25 22:41:19,13495.0,6,7590,-6,13490.0,17,13495.0,7,B
2018-04-25 22:41:20,13495.0,14,7604,-2,13490.0,17,13500.0,19,B
2018-04-25 22:41:23,13495.0,2,7606,-2,13495.0,4,13500.0,10,B
2018-04-25 22:41:28,13500.0,2,7608,0,13495.0,5,13500.0,8,B
2018-04-25 22:41:28,13500.0,2,7610,0,13495.0,5,13500.0,7,B
2018-04-25 22:41:33,13500.0,12,7622,-8,13500.0,4,13505.0,7,B
2018-04-25 22:41:38,13500.0,2,7624,0,13500.0,3,13505.0,13,B
2018-04-25 22:41:42,13500.0,2,7626,-2,13500.0,2,13505.0,13,B
2018-04-25 22:41:42,13500.0,2,7628,-2,13500.0,1,13505.0,13,B
2018-04-25 22:41:43,13500.0,2,7630,-2,13500.0,3,13505.0,13,B
2018-04-25 22:41:46,13500.0,2,7632,0,13500.0,2,13505.0,12,B
2018-04-25 22:41:47,13500.0,2,7634,0,13500.0,1,13505.0,12,B
2018-04-25 22:41:47,13500.0,2,7636,0,13495.0,8,13500.0,12,B
2018-04-25 22:41:58,13495.0,6,7642,-6,13490.0,7,13500.0,15,S
2018-04-25 22:42:14,13495.0,2,7644,0,13490.0,9,13500.0,15,S
2018-04-25 22:42:28,13490.0,8,7652,-4,13490.0,9,13495.0,3,S
2018-04-25 22:42:48,13495.0,6,7658,-4,13495.0,2,13500.0,31,B
2018-04-25 22:42:48,13495.0,4,7662,-2,13490.0,7,13500.0,31,B
2018-04-25 22:42:50,13500.0,2,7664,2,13490.0,7,13500.0,30,B
2018-04-25 22:42:56,13500.0,6,7670,-6,13495.0,15,13500.0,2,B
2018-04-25 22:42:56,13500.0,4,7674,0,13495.0,15,13505.0,17,B
2018-04-25 22:43:35,13500.0,2,7676,0,13495.0,8,13505.0,20,B
2018-04-25 22:43:36,13500.0,2,7678,0,13495.0,9,13505.0,27,B
2018-04-25 22:44:08,13500.0,12,7690,-4,13500.0,2,13505.0,23,B
2018-04-25 22:44:08,13500.0,2,7692,2,13500.0,1,13505.0,24,B
2018-04-25 22:44:09,13500.0,2,7694,0,13495.0,11,13500.0,9,B
2018-04-25 22:44:12,13500.0,6,7700,-2,13500.0,3,13505.0,19,B
2018-04-25 22:44:27,13505.0,48,7748,-38,13505.0,16,13510.0,26,B
2018-04-25 22:44:27,13505.0,8,7756,-2,13505.0,12,13510.0,34,B
2018-04-25 22:44:39,13505.0,2,7758,0,13505.0,11,13510.0,36,B
2018-04-25 22:44:44,13510.0,10,7768,2,13505.0,11,13510.0,31,B
2018-04-25 22:44:44,13510.0,2,7770,0,13505.0,11,13510.0,12,B
2018-04-25 22:44:48,13505.0,2,7772,0,13505.0,10,13510.0,10,S
2018-04-25 22:44:57,13505.0,2,7774,0,13505.0,10,13510.0,10,S
2018-04-25 22:45:01,13500.0,24,7798,-18,13500.0,7,13505.0,4,S
2018-04-25 22:45:02,13500.0,2,7800,0,13500.0,4,13505.0,7,S
2018-04-25 22:45:07,13500.0,2,7802,2,13495.0,8,13505.0,11,S
2018-04-25 22:45:48,13495.0,10,7812,-4,13495.0,8,13500.0,1,S
2018-04-25 22:45:50,13500.0,2,7814,2,13490.0,17,13500.0,11,B
2018-04-25 22:45:59,13500.0,2,7816,-2,13490.0,17,13500.0,11,B
2018-04-25 22:46:55,13500.0,8,7824,-4,13495.0,14,13505.0,9,B
2018-04-25 22:47:03,13495.0,2,7826,0,13490.0,22,13500.0,13,S
2018-04-25 22:48:36,13500.0,2,7828,0,13495.0,15,13500.0,5,B
2018-04-25 22:48:37,13500.0,4,7832,0,13495.0,15,13500.0,3,B
2018-04-25 22:48:41,13500.0,2,7834,0,13495.0,15,13500.0,6,B
2018-04-25 22:49:17,13495.0,20,7854,-8,13490.0,23,13495.0,5,S
2018-04-25 22:49:26,13490.0,6,7860,6,13490.0,9,13495.0,23,S
2018-04-25 22:49:27,13495.0,4,7864,4,13490.0,9,13495.0,33,B
2018-04-25 22:49:29,13490.0,4,7868,0,13490.0,7,13495.0,23,S
2018-04-25 22:49:32,13490.0,2,7870,0,13490.0,6,13495.0,21,S
2018-04-25 22:49:33,13490.0,2,7872,0,13490.0,5,13495.0,23,S
2018-04-25 22:49:44,13490.0,10,7882,0,13485.0,9,13495.0,20,S
2018-04-25 22:49:51,13485.0,2,7884,2,13485.0,9,13495.0,20,S
2018-04-25 22:50:00,13485.0,4,7888,0,13485.0,8,13490.0,4,S
2018-04-25 22:50:01,13485.0,10,7898,-2,13480.0,25,13485.0,3,S
2018-04-25 22:50:01,13485.0,2,7900,0,13480.0,12,13485.0,3,S
2018-04-25 22:50:05,13480.0,16,7916,-14,13480.0,5,13485.0,5,S
2018-04-25 22:50:07,13485.0,10,7926,10,13485.0,1,13490.0,16,B
2018-04-25 22:50:08,13485.0,2,7928,0,13480.0,9,13490.0,24,B
2018-04-25 22:50:18,13485.0,4,7932,0,13485.0,2,13490.0,26,B
2018-04-25 22:50:22,13485.0,2,7934,0,13485.0,1,13490.0,26,B
2018-04-25 22:50:23,13485.0,2,7936,0,13480.0,13,13485.0,1,B
2018-04-25 22:50:34,13480.0,2,7938,0,13480.0,9,13485.0,4,S
2018-04-25 22:50:38,13480.0,2,7940,0,13480.0,12,13485.0,2,S
2018-04-25 22:50:48,13480.0,2,7942,-2,13480.0,11,13485.0,4,S
2018-04-25 22:50:51,13480.0,6,7948,2,13480.0,7,13485.0,19,S
2018-04-25 22:50:54,13480.0,6,7954,-6,13480.0,4,13485.0,6,S
2018-04-25 22:50:55,13480.0,2,7956,-2,13480.0,4,13485.0,6,S
2018-04-25 22:51:10,13480.0,2,7958,2,13480.0,3,13485.0,16,S
2018-04-25 22:51:10,13485.0,8,7966,-6,13480.0,6,13485.0,12,B
2018-04-25 22:51:11,13485.0,2,7968,0,13480.0,15,13485.0,1,B
2018-04-25 22:51:11,13485.0,2,7970,0,13480.0,15,13490.0,12,B
2018-04-25 22:51:17,13490.0,2,7972,0,13490.0,3,13495.0,12,B
2018-04-25 22:51:23,13490.0,2,7974,2,13490.0,5,13495.0,23,B
2018-04-25 22:51:23,13490.0,4,7978,0,13485.0,17,13495.0,23,B
2018-04-25 22:51:24,13490.0,4,7982,4,13485.0,17,13495.0,16,B
2018-04-25 22:51:32,13485.0,2,7984,0,13480.0,13,13490.0,8,S
2018-04-25 22:51:41,13490.0,2,7986,0,13485.0,14,13490.0,5,B
2018-04-25 22:51:41,13490.0,4,7990,0,13485.0,14,13490.0,3,B
2018-04-25 22:51:43,13490.0,2,7992,0,13485.0,14,13490.0,2,B
2018-04-25 22:51:43,13490.0,4,7996,0,13485.0,14,13495.0,14,B
2018-04-25 22:52:03,13495.0,2,7998,0,13485.0,15,13495.0,23,B
2018-04-25 22:52:04,13495.0,2,8000,-2,13485.0,15,13495.0,22,B
2018-04-25 22:52:07,13485.0,2,8002,-2,13485.0,14,13495.0,21,S
2018-04-25 22:52:08,13485.0,2,8004,0,13490.0,3,13495.0,10,S
2018-04-25 22:52:09,13490.0,6,8010,0,13485.0,13,13495.0,22,B
2018-04-25 22:52:18,13495.0,22,8032,2,13490.0,8,13500.0,8,B
2018-04-25 22:53:22,13495.0,4,8036,0,13490.0,26,13495.0,2,B
2018-04-25 22:53:22,13490.0,2,8038,0,13490.0,5,13495.0,12,S
2018-04-25 22:53:48,13490.0,4,8042,2,13485.0,15,13495.0,77,S
2018-04-25 22:53:51,13485.0,10,8052,4,13485.0,12,13495.0,81,S
2018-04-25 22:54:02,13485.0,6,8058,-2,13480.0,20,13490.0,21,S
2018-04-25 22:54:13,13485.0,2,8060,0,13485.0,2,13490.0,18,S
2018-04-25 22:54:16,13490.0,8,8068,-6,13485.0,3,13490.0,10,B
2018-04-25 22:54:17,13490.0,4,8072,-2,13485.0,13,13495.0,69,B
2018-04-25 22:54:31,13490.0,26,8098,-10,13485.0,11,13495.0,66,B
2018-04-25 22:54:32,13490.0,2,8100,-2,13485.0,13,13495.0,66,B
2018-04-25 22:54:51,13490.0,2,8102,0,13490.0,9,13495.0,66,B
2018-04-25 22:54:51,13490.0,18,8120,-18,13485.0,13,13495.0,67,B
2018-04-25 22:54:52,13485.0,2,8122,-2,13485.0,10,13490.0,4,S
2018-04-25 22:54:55,13490.0,2,8124,2,13485.0,4,13490.0,3,B
2018-04-25 22:54:56,13490.0,6,8130,-2,13485.0,4,13495.0,69,B
2018-04-25 22:55:38,13485.0,2,8132,-2,13480.0,33,13490.0,12,S
2018-04-25 22:55:38,13490.0,2,8134,-2,13480.0,35,13490.0,11,B
2018-04-25 22:55:51,13475.0,22,8156,-4,13475.0,19,13480.0,7,S
2018-04-25 22:55:52,13475.0,2,8158,-2,13475.0,17,13480.0,8,S
2018-04-25 22:55:52,13480.0,6,8164,0,13475.0,36,13480.0,4,B
2018-04-25 22:55:53,13480.0,8,8172,0,13480.0,2,13485.0,4,B
2018-04-25 22:56:00,13480.0,2,8174,2,13475.0,25,13485.0,6,B
2018-04-25 22:56:08,13480.0,10,8184,-6,13480.0,5,13485.0,11,B
2018-04-25 22:56:08,13480.0,10,8194,-4,13475.0,14,13485.0,11,B
2018-04-25 22:56:09,13475.0,2,8196,0,13475.0,14,13485.0,13,S
2018-04-25 22:56:18,13480.0,2,8198,-2,13475.0,14,13480.0,49,B
2018-04-25 22:56:37,13475.0,2,8200,0,13475.0,15,13480.0,75,S
2018-04-25 22:56:37,13475.0,6,8206,0,13475.0,12,13480.0,75,S
2018-04-25 22:56:40,13475.0,2,8208,0,13475.0,11,13480.0,76,S
2018-04-25 22:56:41,13475.0,10,8218,-6,13475.0,6,13480.0,82,S
2018-04-25 22:56:41,13475.0,4,8222,0,13475.0,4,13480.0,82,S
2018-04-25 22:56:42,13470.0,14,8236,0,13465.0,8,13475.0,1,S
2018-04-25 22:56:43,13465.0,6,8242,-4,13465.0,7,13475.0,9,S
2018-04-25 22:56:44,13465.0,4,8246,-4,13465.0,14,13475.0,2,S
2018-04-25 22:56:45,13475.0,4,8250,2,13470.0,15,13480.0,79,B
2018-04-25 22:56:50,13470.0,12,8262,0,13470.0,2,13475.0,2,S
2018-04-25 22:56:56,13470.0,4,8266,-4,13470.0,5,13475.0,11,S
2018-04-25 22:56:56,13470.0,8,8274,-2,13470.0,4,13475.0,9,S
2018-04-25 22:56:57,13470.0,4,8278,-4,13470.0,2,13475.0,9,S
2018-04-25 22:56:58,13470.0,2,8280,-2,13470.0,1,13475.0,9,S
2018-04-25 22:56:58,13465.0,8,8288,-6,13465.0,13,13470.0,2,S
2018-04-25 22:56:59,13470.0,12,8300,-8,13465.0,8,13470.0,1,B
2018-04-25 22:56:59,13470.0,14,8314,-6,13470.0,3,13475.0,17,B
2018-04-25 22:57:00,13470.0,6,8320,-2,13465.0,1,13470.0,1,B
2018-04-25 22:57:00,13465.0,6,8326,-6,13460.0,27,13470.0,2,S
2018-04-25 22:57:01,13470.0,4,8330,0,13460.0,27,13470.0,4,B
2018-04-25 22:57:01,13460.0,4,8334,-4,13460.0,30,13470.0,3,S
2018-04-25 22:57:02,13460.0,36,8370,-12,13460.0,12,13470.0,2,S
2018-04-25 22:57:02,13460.0,4,8374,-4,13460.0,12,13470.0,2,S
2018-04-25 22:57:06,13465.0,32,8406,14,13465.0,1,13470.0,2,B
2018-04-25 22:57:07,13465.0,2,8408,-2,13460.0,9,13465.0,8,B
2018-04-25 22:57:08,13465.0,4,8412,-4,13460.0,7,13465.0,6,B
2018-04-25 22:57:14,13460.0,2,8414,-2,13460.0,4,13465.0,6,S
2018-04-25 22:57:18,13460.0,8,8422,-2,13455.0,40,13460.0,1,S
2018-04-25 22:57:19,13460.0,2,8424,-2,13460.0,2,13465.0,66,S
2018-04-25 22:57:27,13460.0,2,8426,-2,13460.0,10,13465.0,66,S
2018-04-25 22:57:27,13460.0,2,8428,0,13460.0,10,13465.0,66,S
2018-04-25 22:57:33,13465.0,6,8434,0,13460.0,10,13465.0,69,B
2018-04-25 22:57:33,13460.0,10,8444,2,13460.0,5,13465.0,70,S
2018-04-25 22:57:37,13460.0,4,8448,-2,13460.0,4,13465.0,70,S
2018-04-25 22:57:40,13460.0,6,8454,2,13460.0,1,13465.0,75,S
2018-04-25 22:57:40,13455.0,6,8460,-4,13455.0,13,13460.0,51,S
2018-04-25 22:57:41,13455.0,2,8462,-2,13455.0,11,13460.0,57,S
2018-04-25 22:57:41,13445.0,68,8530,-10,13445.0,6,13450.0,3,S
2018-04-25 22:57:42,13430.0,24,8554,0,13430.0,5,13440.0,4,S
2018-04-25 22:57:42,13435.0,14,8568,0,13430.0,9,13440.0,7,B
2018-04-25 22:57:43,13440.0,6,8574,-6,13435.0,4,13440.0,2,B
2018-04-25 22:57:43,13440.0,4,8578,-4,13440.0,2,13445.0,5,B
2018-04-25 22:57:44,13435.0,8,8586,-4,13435.0,6,13440.0,2,S
2018-04-25 22:57:44,13440.0,6,8592,0,13435.0,6,13440.0,1,B
2018-04-25 22:57:46,13435.0,4,8596,4,13435.0,2,13440.0,8,S
2018-04-25 22:57:50,13430.0,8,8604,-8,13425.0,1,13430.0,57,S
2018-04-25 22:57:51,13430.0,4,8608,0,13420.0,13,13430.0,55,S
2018-04-25 22:57:52,13420.0,2,8610,-2,13420.0,10,13425.0,2,S
2018-04-25 22:57:52,13425.0,10,8620,0,13420.0,7,13425.0,4,B
2018-04-25 22:57:53,13420.0,12,8632,-12,13420.0,1,13425.0,7,S
2018-04-25 22:57:53,13420.0,2,8634,0,13410.0,8,13420.0,13,S
2018-04-25 22:57:55,13420.0,2,8636,2,13410.0,14,13420.0,18,S
2018-04-25 22:57:56,13410.0,38,8674,-34,13405.0,12,13410.0,29,S
2018-04-25 22:57:56,13410.0,4,8678,-2,13405.0,14,13410.0,33,S
2018-04-25 22:57:58,13410.0,2,8680,0,13405.0,12,13410.0,38,S
2018-04-25 22:57:59,13410.0,6,8686,-6,13405.0,12,13410.0,36,S
2018-04-25 22:57:59,13405.0,8,8694,-8,13405.0,12,13410.0,33,S
2018-04-25 22:58:00,13410.0,24,8718,-22,13405.0,8,13410.0,25,B
2018-04-25 22:58:01,13410.0,2,8720,0,13405.0,11,13410.0,20,B
2018-04-25 22:58:01,13405.0,8,8728,-2,13400.0,103,13405.0,3,S
2018-04-25 22:58:02,13405.0,4,8732,-4,13400.0,106,13405.0,6,S
2018-04-25 22:58:02,13400.0,2,8734,2,13400.0,105,13405.0,7,S
2018-04-25 22:58:03,13405.0,8,8742,-2,13400.0,102,13405.0,6,B
2018-04-25 22:58:03,13405.0,2,8744,0,13400.0,102,13405.0,5,B
2018-04-25 22:58:04,13400.0,2,8746,0,13400.0,101,13405.0,5,S
2018-04-25 22:58:05,13400.0,10,8756,0,13400.0,96,13405.0,11,S
2018-04-25 22:58:05,13405.0,2,8758,2,13400.0,96,13405.0,4,B
2018-04-25 22:58:06,13400.0,10,8768,-6,13400.0,100,13410.0,18,S
2018-04-25 22:58:07,13400.0,50,8818,-44,13400.0,78,13410.0,16,S
2018-04-25 22:58:07,13405.0,2,8820,-2,13405.0,1,13410.0,17,B
2018-04-25 22:58:10,13405.0,8,8828,4,13405.0,2,13410.0,16,B
2018-04-25 22:58:10,13405.0,6,8834,-6,13400.0,76,13405.0,2,B
2018-04-25 22:58:11,13405.0,4,8838,-4,13405.0,4,13410.0,14,B
2018-04-25 22:58:11,13405.0,6,8844,2,13400.0,71,13405.0,1,B
2018-04-25 22:58:12,13405.0,2,8846,0,13405.0,6,13410.0,11,B
2018-04-25 22:58:15,13410.0,10,8856,0,13405.0,13,13410.0,7,B
2018-04-25 22:58:18,13410.0,6,8862,0,13405.0,10,13410.0,10,B
2018-04-25 22:58:19,13410.0,2,8864,-2,13405.0,11,13410.0,5,B
2018-04-25 22:58:19,13410.0,8,8872,-8,13405.0,11,13410.0,1,B
2018-04-25 22:58:21,13410.0,4,8876,-4,13405.0,11,13415.0,4,B
2018-04-25 22:58:22,13415.0,2,8878,0,13410.0,2,13415.0,11,B
2018-04-25 22:58:26,13410.0,4,8882,-4,13405.0,10,13410.0,33,S
2018-04-25 22:58:28,13410.0,16,8898,-16,13405.0,10,13410.0,32,S
2018-04-25 22:58:29,13405.0,14,8912,-14,13405.0,3,13410.0,27,S
2018-04-25 22:58:29,13410.0,8,8920,-4,13400.0,78,13405.0,3,B
2018-04-25 22:58:30,13400.0,6,8926,-4,13400.0,72,13405.0,66,S
2018-04-25 22:58:31,13405.0,2,8928,-2,13400.0,75,13405.0,56,B
2018-04-25 22:58:31,13405.0,18,8946,-6,13400.0,71,13405.0,47,B
2018-04-25 22:58:32,13405.0,2,8948,0,13400.0,71,13405.0,46,B
2018-04-25 22:58:32,13405.0,34,8982,-28,13400.0,78,13405.0,29,B
2018-04-25 22:58:35,13405.0,2,8984,-2,13400.0,78,13405.0,28,B
2018-04-25 22:58:36,13405.0,4,8988,-4,13400.0,78,13405.0,26,B
2018-04-25 22:58:39,13405.0,10,8998,-8,13400.0,71,13405.0,32,B
2018-04-25 22:58:40,13405.0,2,9000,0,13400.0,71,13405.0,31,B
2018-04-25 22:58:40,13400.0,2,9002,-2,13400.0,70,13405.0,31,S
2018-04-25 22:58:41,13405.0,18,9020,-4,13400.0,71,13405.0,20,B
2018-04-25 22:58:42,13405.0,2,9022,0,13400.0,70,13405.0,14,B
2018-04-25 22:58:45,13405.0,28,9050,-28,13400.0,70,13405.0,12,B
2018-04-25 22:58:45,13405.0,12,9062,0,13400.0,70,13405.0,6,B
2018-04-25 22:58:46,13405.0,12,9074,0,13405.0,2,13410.0,24,B
2018-04-25 22:58:46,13410.0,2,9076,-2,13405.0,3,13410.0,23,B
2018-04-25 22:58:52,13405.0,4,9080,0,13405.0,4,13410.0,30,S
2018-04-25 22:58:53,13410.0,4,9084,-2,13405.0,5,13410.0,28,B
2018-04-25 22:58:55,13410.0,12,9096,6,13405.0,12,13410.0,21,B
2018-04-25 22:58:58,13410.0,2,9098,0,13405.0,15,13410.0,16,B
2018-04-25 22:59:00,13405.0,2,9100,0,13405.0,19,13410.0,18,S
2018-04-25 22:59:01,13405.0,10,9110,2,13405.0,14,13410.0,21,S
2018-04-25 22:59:01,13410.0,4,9114,-4,13405.0,14,13410.0,21,B
2018-04-25 22:59:02,13410.0,8,9122,-8,13405.0,15,13410.0,10,B
2018-04-25 22:59:03,13410.0,6,9128,-6,13405.0,18,13410.0,7,B
2018-04-25 22:59:03,13410.0,2,9130,-2,13405.0,18,13410.0,6,B
2018-04-25 22:59:05,13410.0,22,9152,0,13405.0,18,13415.0,3,B
2018-04-25 22:59:06,13405.0,2,9154,0,13405.0,42,13410.0,8,S
2018-04-25 22:59:07,13410.0,6,9160,4,13405.0,42,13410.0,1,B
2018-04-25 22:59:07,13410.0,2,9162,-2,13410.0,1,13415.0,4,B
2018-04-25 22:59:08,13410.0,10,9172,8,13410.0,16,13415.0,3,B
2018-04-25 22:59:08,13415.0,4,9176,-2,13410.0,3,13420.0,1,B
2018-04-25 22:59:09,13420.0,2,9178,0,13410.0,6,13420.0,2,B
2018-04-25 22:59:11,13445.0,16,9194,-2,13435.0,1,13450.0,2,B
2018-04-25 22:59:12,13435.0,4,9198,0,13425.0,4,13445.0,3,S
2018-04-25 22:59:14,13440.0,6,9204,0,13435.0,3,13440.0,1,B
2018-04-25 22:59:14,13435.0,10,9214,2,13430.0,2,13440.0,3,S
2018-04-25 22:59:21,13435.0,8,9222,-8,13425.0,11,13435.0,6,S
2018-04-25 22:59:22,13430.0,2,9224,0,13425.0,8,13435.0,7,S
2018-04-25 22:59:27,13430.0,4,9228,-4,13425.0,4,13430.0,2,S
2018-04-25 22:59:28,13430.0,2,9230,-2,13425.0,6,13435.0,6,S
2018-04-25 22:59:30,13425.0,2,9232,-2,13425.0,3,13435.0,6,S
2018-04-25 22:59:31,13430.0,2,9234,-2,13430.0,49,13435.0,5,B
2018-04-25 22:59:32,13435.0,2,9236,-2,13430.0,49,13435.0,4,B
2018-04-25 22:59:33,13430.0,2,9238,-2,13430.0,48,13435.0,4,S
2018-04-25 22:59:36,13435.0,2,9240,-2,13430.0,48,13435.0,3,B
2018-04-25 22:59:40,13435.0,2,9242,-2,13430.0,48,13435.0,2,B
2018-04-25 22:59:41,13430.0,4,9246,-4,13430.0,47,13435.0,2,S
2018-04-25 22:59:41,13435.0,4,9250,-4,13435.0,38,13440.0,2,B
2018-04-25 22:59:42,13435.0,52,9302,-22,13435.0,12,13440.0,3,B
2018-04-25 22:59:42,13435.0,24,9326,-16,13430.0,47,13435.0,2,B
2018-04-25 22:59:46,13435.0,6,9332,0,13430.0,47,13435.0,7,B
2018-04-25 22:59:48,13435.0,2,9334,2,13430.0,46,13435.0,7,B
2018-04-25 22:59:50,13430.0,4,9338,-2,13430.0,44,13435.0,8,S
2018-04-25 22:59:51,13435.0,2,9340,0,13430.0,44,13435.0,7,B
2018-04-25 22:59:54,13435.0,14,9354,-2,13435.0,4,13445.0,2,B
2018-04-25 22:59:54,13435.0,6,9360,-4,13435.0,1,13440.0,5,B
2018-04-25 22:59:55,13435.0,2,9362,-2,13430.0,45,13435.0,4,B
2018-04-25 22:59:55,13430.0,8,9370,-8,13430.0,41,13435.0,4,S
2018-04-25 22:59:56,13430.0,12,9382,-4,13430.0,35,13440.0,5,S
2018-04-25 22:59:59,13430.0,4,9386,0,13430.0,33,13440.0,5,S
2018-04-25 22:59:59,13430.0,2,9388,-2,13430.0,32,13440.0,5,S
2018-04-26 09:00:00,13445.0,22,9410,20,13450.0,13,13460.0,1,B
2018-04-26 09:00:01,13460.0,2,9412,0,13455.0,3,13460.0,2,B
2018-04-26 09:00:01,13465.0,34,9446,-24,13450.0,2,13455.0,2,B
2018-04-26 09:00:02,13465.0,2,9448,0,13450.0,4,13465.0,1,B
2018-04-26 09:00:05,13470.0,2,9450,2,13460.0,3,13470.0,4,B
2018-04-26 09:00:07,13465.0,18,9468,-2,13460.0,14,13465.0,5,S
2018-04-26 09:00:09,13465.0,2,9470,-2,13460.0,12,13465.0,4,S
2018-04-26 09:00:09,13460.0,2,9472,-2,13460.0,14,13465.0,4,S
2018-04-26 09:00:10,13465.0,2,9474,0,13460.0,14,13465.0,3,B
2018-04-26 09:00:11,13465.0,8,9482,2,13465.0,6,13470.0,6,B
2018-04-26 09:00:12,13465.0,2,9484,0,13465.0,5,13470.0,6,B
2018-04-26 09:00:13,13465.0,2,9486,0,13465.0,4,13470.0,6,B
2018-04-26 09:00:14,13465.0,4,9490,0,13465.0,7,13470.0,6,B
2018-04-26 09:00:15,13470.0,4,9494,2,13465.0,8,13470.0,4,B
2018-04-26 09:00:15,13470.0,2,9496,0,13465.0,14,13470.0,3,B
2018-04-26 09:00:17,13465.0,6,9502,6,13460.0,1,13470.0,3,S
2018-04-26 09:00:19,13470.0,6,9508,4,13470.0,4,13475.0,5,B
2018-04-26 09:00:19,13470.0,6,9514,6,13470.0,1,13475.0,2,B
2018-04-26 09:00:20,13470.0,6,9520,6,13465.0,4,13475.0,4,B
2018-04-26 09:00:23,13465.0,8,9528,8,13460.0,3,13465.0,8,S
2018-04-26 09:00:24,13455.0,10,9538,10,13455.0,2,13460.0,9,S
2018-04-26 09:00:24,13465.0,12,9550,6,13450.0,5,13465.0,12,B
2018-04-26 09:00:25,13460.0,8,9558,0,13455.0,1,13460.0,2,S
2018-04-26 09:00:25,13460.0,10,9568,2,13460.0,3,13465.0,12,S
2018-04-26 09:00:26,13465.0,2,9570,-2,13460.0,8,13465.0,11,B
2018-04-26 09:00:26,13460.0,16,9586,0,13455.0,3,13465.0,11,S
2018-04-26 09:00:27,13460.0,2,9588,2,13460.0,1,13465.0,11,S
2018-04-26 09:00:28,13460.0,4,9592,-2,13455.0,3,13465.0,11,S
2018-04-26 09:00:31,13465.0,20,9612,-16,13460.0,1,13465.0,3,B
2018-04-26 09:00:32,13465.0,2,9614,-2,13460.0,2,13465.0,3,B
2018-04-26 09:00:34,13465.0,8,9622,-4,13455.0,3,13470.0,6,B
2018-04-26 09:00:36,13470.0,14,9636,2,13465.0,10,13475.0,6,B
2018-04-26 09:00:38,13465.0,2,9638,2,13465.0,14,13475.0,6,S
2018-04-26 09:00:39,13475.0,10,9648,-8,13470.0,2,13475.0,3,B
2018-04-26 09:00:40,13470.0,6,9654,-2,13465.0,12,13475.0,2,S
2018-04-26 09:00:41,13475.0,2,9656,0,13470.0,5,13475.0,1,B
2018-04-26 09:00:42,13475.0,4,9660,-2,13475.0,2,13480.0,5,B
2018-04-26 09:00:44,13480.0,6,9666,-6,13480.0,1,13485.0,7,B
2018-04-26 09:00:44,13485.0,8,9674,-2,13480.0,2,13485.0,4,B
2018-04-26 09:00:45,13480.0,4,9678,4,13475.0,3,13480.0,1,S
2018-04-26 09:00:45,13480.0,2,9680,2,13475.0,3,13480.0,1,S
2018-04-26 09:00:47,13480.0,8,9688,2,13480.0,2,13485.0,6,S
2018-04-26 09:00:47,13475.0,6,9694,2,13475.0,4,13485.0,6,S
2018-04-26 09:00:51,13485.0,2,9696,-2,13480.0,10,13485.0,3,B
2018-04-26 09:00:54,13485.0,6,9702,-6,13485.0,1,13490.0,26,B
2018-04-26 09:00:54,13490.0,12,9714,2,13485.0,9,13490.0,19,B
2018-04-26 09:00:55,13495.0,40,9754,38,13485.0,14,13495.0,12,B
2018-04-26 09:00:57,13490.0,14,9768,8,13485.0,4,13490.0,5,S
2018-04-26 09:01:00,13490.0,6,9774,0,13490.0,12,13495.0,14,S
2018-04-26 09:01:01,13495.0,28,9802,0,13495.0,1,13500.0,10,B
2018-04-26 09:01:01,13495.0,18,9820,-12,13495.0,2,13500.0,2,B
2018-04-26 09:01:02,13495.0,4,9824,4,13490.0,10,13495.0,7,B
2018-04-26 09:01:04,13490.0,6,9830,0,13490.0,3,13495.0,7,S
2018-04-26 09:01:04,13490.0,6,9836,0,13485.0,2,13490.0,2,S
2018-04-26 09:01:06,13485.0,6,9842,-2,13485.0,2,13490.0,5,S
2018-04-26 09:01:06,13485.0,4,9846,0,13480.0,7,13490.0,12,S
2018-04-26 09:01:07,13490.0,28,9874,12,13490.0,31,13495.0,6,B
2018-04-26 09:01:12,13490.0,2,9876,2,13490.0,30,13495.0,18,B
2018-04-26 09:01:13,13490.0,60,9936,52,13485.0,2,13490.0,1,B
2018-04-26 09:01:13,13485.0,4,9940,-2,13485.0,1,13490.0,7,S
2018-04-26 09:01:14,13485.0,2,9942,2,13480.0,8,13485.0,4,S
2018-04-26 09:01:14,13480.0,16,9958,10,13475.0,4,13485.0,15,S
2018-04-26 09:01:15,13475.0,10,9968,8,13470.0,5,13480.0,2,S
2018-04-26 09:01:16,13475.0,2,9970,0,13470.0,6,13475.0,2,S
2018-04-26 09:01:17,13475.0,10,9980,4,13470.0,6,13475.0,1,S
2018-04-26 09:01:18,13475.0,2,9982,-2,13470.0,6,13480.0,9,S
2018-04-26 09:01:21,13475.0,6,9988,0,13470.0,6,13475.0,2,S
2018-04-26 09:01:24,13475.0,4,9992,0,13470.0,8,13480.0,9,S
2018-04-26 09:01:26,13475.0,4,9996,4,13470.0,5,13475.0,1,S
2018-04-26 09:01:28,13470.0,6,10002,-6,13470.0,2,13480.0,11,S
2018-04-26 09:01:29,13470.0,4,10006,0,13470.0,3,13480.0,9,S
2018-04-26 09:01:31,13470.0,2,10008,0,13470.0,5,13475.0,1,S
2018-04-26 09:01:31,13475.0,2,10010,-2,13470.0,3,13480.0,9,B
2018-04-26 09:01:33,13475.0,2,10012,0,13475.0,1,13480.0,9,B
2018-04-26 09:01:34,13475.0,2,10014,2,13470.0,5,13475.0,2,B
2018-04-26 09:01:35,13475.0,4,10018,-4,13475.0,1,13480.0,7,B
2018-04-26 09:01:35,13475.0,2,10020,-2,13470.0,6,13475.0,2,B
2018-04-26 09:01:38,13475.0,4,10024,0,13475.0,2,13480.0,8,B
2018-04-26 09:01:39,13475.0,6,10030,-4,13470.0,7,13480.0,8,B
2018-04-26 09:01:40,13470.0,8,10038,-6,13470.0,3,13480.0,8,S
2018-04-26 09:01:44,13475.0,4,10042,0,13470.0,3,13475.0,1,B
2018-04-26 09:01:44,13480.0,4,10046,-2,13475.0,23,13480.0,5,B
2018-04-26 09:01:47,13475.0,50,10096,-4,13470.0,4,13475.0,1,S
2018-04-26 09:01:49,13475.0,10,10106,0,13475.0,3,13480.0,10,S
2018-04-26 09:01:49,13475.0,2,10108,2,13475.0,7,13480.0,7,S
2018-04-26 09:01:52,13475.0,2,10110,-2,13475.0,4,13480.0,5,S
2018-04-26 09:01:54,13475.0,6,10116,-6,13470.0,12,13480.0,11,S
2018-04-26 09:02:02,13475.0,2,10118,-2,13475.0,5,13480.0,12,S
2018-04-26 09:02:02,13475.0,2,10120,0,13475.0,4,13480.0,12,S
2018-04-26 09:02:05,13480.0,2,10122,-2,13475.0,4,13480.0,11,B
2018-04-26 09:02:13,13475.0,4,10126,-4,13475.0,2,13480.0,13,S
2018-04-26 09:02:15,13475.0,4,10130,-4,13470.0,13,13480.0,13,S
2018-04-26 09:02:20,13470.0,4,10134,-2,13470.0,9,13475.0,1,S
2018-04-26 09:02:21,13475.0,2,10136,-2,13470.0,5,13480.0,10,B
2018-04-26 09:02:24,13475.0,2,10138,2,13470.0,3,13475.0,18,B
2018-04-26 09:02:34,13475.0,2,10140,-2,13470.0,5,13475.0,7,B
2018-04-26 09:02:45,13475.0,6,10146,-4,13475.0,2,13480.0,23,B
2018-04-26 09:02:46,13475.0,4,10150,0,13470.0,6,13480.0,21,B
2018-04-26 09:02:53,13475.0,6,10156,6,13470.0,11,13480.0,9,B
2018-04-26 09:02:58,13475.0,2,10158,-2,13470.0,11,13480.0,9,B
2018-04-26 09:03:02,13480.0,8,10166,-2,13470.0,11,13480.0,5,B
2018-04-26 09:03:06,13480.0,4,10170,0,13470.0,6,13475.0,10,B
2018-04-26 09:03:08,13475.0,4,10174,2,13470.0,8,13475.0,8,S
2018-04-26 09:03:11,13475.0,2,10176,-2,13470.0,8,13475.0,5,S
2018-04-26 09:03:11,13475.0,6,10182,0,13475.0,3,13480.0,11,S
2018-04-26 09:03:12,13475.0,2,10184,-2,13475.0,2,13480.0,21,S
2018-04-26 09:03:12,13475.0,4,10188,0,13470.0,8,13475.0,1,S
2018-04-26 09:03:18,13470.0,8,10196,-4,13470.0,6,13475.0,4,S
2018-04-26 09:03:18,13470.0,4,10200,0,13470.0,2,13475.0,5,S
2018-04-26 09:03:19,13470.0,4,10204,-4,13465.0,12,13470.0,2,S
2018-04-26 09:03:22,13465.0,4,10208,0,13465.0,8,13470.0,7,S
2018-04-26 09:03:28,13465.0,4,10212,0,13465.0,6,13470.0,8,S
2018-04-26 09:03:38,13465.0,4,10216,0,13465.0,4,13470.0,8,S
2018-04-26 09:03:39,13465.0,4,10220,0,13465.0,2,13470.0,8,S
2018-04-26 09:03:43,13465.0,2,10222,0,13465.0,3,13470.0,8,S
2018-04-26 09:03:43,13470.0,16,10238,8,13465.0,7,13475.0,21,B
2018-04-26 09:03:45,13470.0,2,10240,-2,13470.0,14,13475.0,4,B
2018-04-26 09:04:10,13475.0,12,10252,-8,13470.0,13,13480.0,12,B
2018-04-26 09:04:16,13475.0,4,10256,4,13465.0,10,13475.0,1,B
2018-04-26 09:04:19,13475.0,6,10262,0,13475.0,2,13480.0,24,B
2018-04-26 09:04:21,13475.0,4,10266,0,13470.0,8,13480.0,12,B
2018-04-26 09:04:21,13475.0,2,10268,-2,13475.0,1,13480.0,12,B
2018-04-26 09:04:23,13475.0,2,10270,0,13475.0,5,13480.0,9,B
2018-04-26 09:04:25,13480.0,2,10272,0,13475.0,4,13480.0,20,B
2018-04-26 09:04:33,13475.0,4,10276,-4,13475.0,8,13480.0,8,S
2018-04-26 09:04:34,13475.0,12,10288,-2,13475.0,2,13480.0,9,S
2018-04-26 09:04:34,13475.0,4,10292,0,13470.0,9,13480.0,9,S
2018-04-26 09:04:38,13475.0,2,10294,2,13470.0,9,13475.0,1,S
2018-04-26 09:04:45,13480.0,2,10296,0,13470.0,11,13480.0,9,B
2018-04-26 09:04:53,13475.0,4,10300,0,13470.0,11,13475.0,1,S
2018-04-26 09:04:57,13480.0,2,10302,0,13470.0,11,13480.0,11,B
2018-04-26 09:05:09,13470.0,4,10306,-4,13470.0,5,13475.0,4,S
2018-04-26 09:05:13,13470.0,4,10310,0,13465.0,7,13470.0,2,S
2018-04-26 09:05:16,13465.0,4,10314,0,13465.0,5,13470.0,3,S
2018-04-26 09:05:28,13470.0,6,10320,0,13470.0,2,13475.0,11,B
2018-04-26 09:05:31,13470.0,2,10322,-2,13470.0,2,13475.0,11,B
2018-04-26 09:05:36,13465.0,6,10328,0,13465.0,3,13475.0,13,S
2018-04-26 09:05:38,13465.0,2,10330,-2,13460.0,4,13470.0,10,S
2018-04-26 09:05:40,13460.0,12,10342,-8,13455.0,2,13460.0,1,S
2018-04-26 09:05:41,13455.0,4,10346,0,13455.0,1,13460.0,15,S
2018-04-26 09:05:41,13455.0,4,10350,0,13450.0,3,13455.0,2,S
2018-04-26 09:05:42,13455.0,16,10366,0,13450.0,7,13460.0,11,S
2018-04-26 09:05:42,13450.0,8,10374,4,13450.0,7,13460.0,11,S
2018-04-26 09:05:44,13460.0,12,10386,8,13455.0,15,13460.0,1,B
2018-04-26 09:05:44,13460.0,4,10390,-2,13455.0,9,13460.0,1,B
2018-04-26 09:05:46,13455.0,10,10400,-2,13455.0,4,13460.0,1,S
2018-04-26 09:05:48,13455.0,2,10402,-2,13455.0,5,13460.0,2,S
2018-04-26 09:05:48,13455.0,10,10412,-2,13450.0,5,13455.0,2,S
2018-04-26 09:05:49,13455.0,10,10422,2,13450.0,2,13455.0,4,S
2018-04-26 09:05:51,13455.0,2,10424,2,13450.0,2,13460.0,15,S
2018-04-26 09:05:51,13455.0,2,10426,0,13450.0,2,13455.0,3,S
2018-04-26 09:05:58,13450.0,2,10428,0,13450.0,3,13455.0,9,S
2018-04-26 09:06:01,13455.0,18,10446,-2,13455.0,2,13460.0,17,B
2018-04-26 09:06:01,13460.0,30,10476,14,13460.0,1,13465.0,10,B
2018-04-26 09:06:02,13460.0,2,10478,0,13460.0,12,13465.0,2,B
2018-04-26 09:06:10,13465.0,4,10482,-4,13460.0,8,13465.0,1,B
2018-04-26 09:06:11,13465.0,2,10484,0,13460.0,8,13465.0,1,B
2018-04-26 09:06:13,13465.0,2,10486,0,13460.0,8,13465.0,1,B
2018-04-26 09:06:16,13465.0,4,10490,0,13460.0,10,13470.0,12,B
2018-04-26 09:06:26,13465.0,2,10492,0,13460.0,8,13470.0,10,B
2018-04-26 09:06:34,13465.0,2,10494,-2,13465.0,1,13470.0,38,B
2018-04-26 09:06:35,13465.0,2,10496,0,13460.0,8,13470.0,38,B
2018-04-26 09:06:37,13465.0,10,10506,-4,13460.0,10,13470.0,36,B
2018-04-26 09:06:45,13465.0,2,10508,2,13460.0,15,13470.0,36,B
2018-04-26 09:06:46,13465.0,4,10512,0,13460.0,15,13470.0,36,B
2018-04-26 09:07:01,13465.0,2,10514,0,13460.0,15,13465.0,2,B
2018-04-26 09:07:19,13465.0,10,10524,10,13460.0,16,13465.0,18,B
2018-04-26 09:07:20,13460.0,32,10556,-12,13455.0,13,13460.0,29,S
2018-04-26 09:07:21,13460.0,2,10558,-2,13455.0,10,13460.0,31,S
2018-04-26 09:07:21,13460.0,6,10564,-6,13455.0,12,13460.0,28,S
2018-04-26 09:07:44,13460.0,4,10568,0,13455.0,17,13460.0,26,S
2018-04-26 09:08:02,13460.0,2,10570,-2,13455.0,14,13460.0,30,S
2018-04-26 09:08:13,13455.0,2,10572,0,13455.0,13,13460.0,30,S
2018-04-26 09:08:14,13460.0,2,10574,-2,13455.0,13,13460.0,29,B
2018-04-26 09:08:21,13460.0,10,10584,-10,13455.0,13,13460.0,24,B
2018-04-26 09:08:27,13460.0,10,10594,-10,13455.0,13,13460.0,19,B
2018-04-26 09:08:30,13460.0,2,10596,-2,13455.0,14,13460.0,18,B
2018-04-26 09:08:30,13460.0,36,10632,12,13455.0,17,13465.0,20,B
2018-04-26 09:08:32,13465.0,6,10638,0,13460.0,12,13465.0,17,B
2018-04-26 09:08:33,13465.0,10,10648,0,13460.0,12,13465.0,12,B
2018-04-26 09:08:35,13460.0,4,10652,0,13460.0,5,13465.0,18,S
2018-04-26 09:08:42,13460.0,2,10654,-2,13460.0,16,13465.0,9,S
2018-04-26 09:08:42,13465.0,10,10664,0,13460.0,17,13465.0,4,B
2018-04-26 09:08:45,13465.0,8,10672,0,13460.0,17,13470.0,50,B
2018-04-26 09:08:46,13470.0,2,10674,-2,13460.0,17,13470.0,52,B
2018-04-26 09:08:48,13470.0,6,10680,0,13465.0,25,13470.0,27,B
2018-04-26 09:08:49,13470.0,6,10686,0,13465.0,25,13470.0,24,B
2018-04-26 09:08:50,13470.0,12,10698,2,13465.0,25,13470.0,18,B
2018-04-26 09:08:50,13470.0,26,10724,18,13465.0,25,13470.0,5,B
2018-04-26 09:08:51,13470.0,10,10734,2,13470.0,2,13475.0,21,B
2018-04-26 09:08:51,13470.0,4,10738,-4,13465.0,13,13475.0,25,B
2018-04-26 09:08:57,13470.0,6,10744,0,13465.0,9,13470.0,4,B
2018-04-26 09:08:58,13465.0,2,10746,2,13460.0,5,13470.0,22,S
2018-04-26 09:08:59,13470.0,10,10756,-2,13460.0,9,13470.0,17,B
2018-04-26 09:09:02,13470.0,4,10760,2,13460.0,9,13470.0,15,B
2018-04-26 09:09:03,13470.0,2,10762,0,13465.0,1,13470.0,14,B
2018-04-26 09:09:05,13470.0,10,10772,-8,13465.0,1,13470.0,9,B
2018-04-26 09:09:09,13470.0,10,10782,-10,13465.0,3,13470.0,1,B
2018-04-26 09:09:17,13470.0,4,10786,0,13465.0,25,13470.0,2,B
2018-04-26 09:09:17,13470.0,8,10794,4,13470.0,5,13475.0,14,B
2018-04-26 09:09:18,13470.0,2,10796,0,13470.0,5,13475.0,9,B
2018-04-26 09:09:23,13475.0,2,10798,2,13470.0,3,13475.0,8,B
2018-04-26 09:09:24,13475.0,10,10808,-4,13470.0,3,13475.0,3,B
2018-04-26 09:09:25,13470.0,2,10810,0,13470.0,2,13475.0,3,S
2018-04-26 09:09:34,13470.0,6,10816,2,13465.0,28,13470.0,5,S
2018-04-26 09:09:34,13470.0,10,10826,10,13465.0,24,13475.0,10,S
2018-04-26 09:09:38,13470.0,2,10828,0,13465.0,26,13475.0,12,S
2018-04-26 09:09:56,13475.0,2,10830,0,13475.0,1,13480.0,11,B
2018-04-26 09:09:56,13475.0,2,10832,0,13470.0,21,13480.0,13,B
2018-04-26 09:10:09,13475.0,6,10838,6,13475.0,1,13480.0,13,B
2018-04-26 09:10:10,13475.0,10,10848,0,13475.0,1,13480.0,13,B
2018-04-26 09:10:10,13475.0,2,10850,0,13470.0,22,13475.0,5,B
2018-04-26 09:10:11,13475.0,4,10854,0,13470.0,22,13475.0,3,B
2018-04-26 09:10:11,13475.0,2,10856,0,13470.0,22,13475.0,2,B
2018-04-26 09:10:13,13470.0,4,10860,4,13470.0,20,13480.0,14,S
2018-04-26 09:10:19,13475.0,2,10862,-2,13470.0,18,13475.0,1,B
2018-04-26 09:10:28,13475.0,4,10866,0,13470.0,20,13480.0,15,B
2018-04-26 09:10:36,13475.0,2,10868,-2,13475.0,1,13480.0,15,B
2018-04-26 09:10:40,13475.0,2,10870,0,13475.0,3,13480.0,14,B
2018-04-26 09:10:45,13475.0,10,10880,0,13470.0,23,13480.0,19,B
2018-04-26 09:11:02,13475.0,2,10882,0,13470.0,27,13475.0,4,B
2018-04-26 09:11:05,13470.0,6,10888,0,13470.0,20,13475.0,1,S
2018-04-26 09:11:07,13475.0,2,10890,0,13470.0,24,13480.0,16,B
2018-04-26 09:11:11,13480.0,10,10900,4,13470.0,24,13480.0,11,B
2018-04-26 09:11:11,13480.0,2,10902,-2,13470.0,24,13480.0,10,B
2018-04-26 09:11:17,13475.0,2,10904,-2,13475.0,3,13480.0,10,S
2018-04-26 09:11:21,13475.0,4,10908,0,13475.0,1,13480.0,10,S
2018-04-26 09:11:22,13475.0,2,10910,-2,13470.0,24,13475.0,8,S
2018-04-26 09:11:25,13470.0,10,10920,10,13470.0,5,13475.0,13,S
2018-04-26 09:11:25,13470.0,10,10930,6,13465.0,28,13475.0,13,S
2018-04-26 09:11:43,13470.0,2,10932,0,13470.0,1,13475.0,7,S
2018-04-26 09:11:50,13475.0,14,10946,-2,13470.0,1,13480.0,27,B
2018-04-26 09:12:03,13470.0,16,10962,4,13465.0,34,13470.0,1,S
2018-04-26 09:12:03,13470.0,14,10976,0,13465.0,26,13475.0,22,S
2018-04-26 09:12:14,13475.0,12,10988,-6,13470.0,2,13475.0,17,B
2018-04-26 09:12:15,13470.0,4,10992,-4,13465.0,28,13475.0,21,S
2018-04-26 09:12:41,13465.0,2,10994,0,13465.0,7,13470.0,3,S
2018-04-26 09:12:41,13465.0,14,11008,6,13460.0,8,13465.0,3,S
2018-04-26 09:12:42,13460.0,10,11018,4,13460.0,6,13465.0,1,S
2018-04-26 09:13:03,13460.0,8,11026,-2,13455.0,6,13460.0,5,S
2018-04-26 09:13:04,13455.0,4,11030,0,13455.0,1,13460.0,19,S
2018-04-26 09:13:05,13455.0,2,11032,0,13450.0,11,13460.0,13,S
2018-04-26 09:13:06,13455.0,2,11034,0,13455.0,1,13460.0,12,S
2018-04-26 09:13:06,13455.0,6,11040,4,13450.0,13,13455.0,1,S
2018-04-26 09:13:11,13450.0,2,11042,0,13450.0,10,13455.0,3,S
2018-04-26 09:13:12,13450.0,2,11044,0,13450.0,9,13455.0,3,S
2018-04-26 09:13:12,13455.0,2,11046,2,13450.0,9,13455.0,2,B
2018-04-26 09:13:13,13455.0,4,11050,0,13455.0,5,13460.0,9,B
2018-04-26 09:13:14,13455.0,8,11058,-8,13450.0,16,13460.0,8,B
2018-04-26 09:13:20,13455.0,4,11062,4,13450.0,15,13460.0,9,B
2018-04-26 09:13:24,13450.0,4,11066,2,13450.0,8,13460.0,11,S
2018-04-26 09:13:25,13450.0,4,11070,0,13450.0,6,13460.0,11,S
2018-04-26 09:13:47,13460.0,12,11082,10,13455.0,10,13460.0,49,B
2018-04-26 09:13:55,13455.0,8,11090,-6,13450.0,11,13460.0,53,S
2018-04-26 09:14:04,13450.0,2,11092,2,13450.0,16,13455.0,4,S
2018-04-26 09:14:49,13455.0,4,11096,4,13450.0,37,13460.0,54,B
2018-04-26 09:15:01,13455.0,18,11114,-12,13450.0,23,13455.0,5,B
2018-04-26 09:15:03,13455.0,24,11138,-12,13450.0,21,13455.0,19,B
2018-04-26 09:15:05,13450.0,2,11140,-2,13450.0,20,13455.0,19,S
2018-04-26 09:15:05,13450.0,12,11152,-12,13450.0,14,13455.0,7,S
2018-04-26 09:15:06,13450.0,28,11180,16,13445.0,9,13455.0,7,S
2018-04-26 09:15:10,13445.0,10,11190,-8,13445.0,2,13450.0,53,S
2018-04-26 09:15:10,13445.0,6,11196,6,13440.0,5,13450.0,54,S
2018-04-26 09:15:11,13445.0,4,11200,-2,13445.0,3,13450.0,54,S
2018-04-26 09:15:12,13440.0,10,11210,-6,13440.0,1,13450.0,54,S
2018-04-26 09:15:15,13440.0,8,11218,0,13440.0,2,13445.0,4,S
2018-04-26 09:15:15,13440.0,4,11222,2,13435.0,2,13445.0,12,S
2018-04-26 09:15:22,13440.0,4,11226,0,13435.0,14,13445.0,11,S
2018-04-26 09:15:33,13440.0,2,11228,0,13440.0,29,13450.0,57,S
2018-04-26 09:15:37,13440.0,2,11230,0,13440.0,28,13450.0,59,S
2018-04-26 09:15:54,13445.0,10,11240,-6,13445.0,1,13450.0,57,B
2018-04-26 09:15:54,13445.0,2,11242,0,13440.0,22,13445.0,3,B
2018-04-26 09:16:07,13445.0,10,11252,-2,13440.0,17,13450.0,57,B
2018-04-26 09:16:21,13450.0,12,11264,10,13445.0,19,13450.0,47,B
2018-04-26 09:16:22,13450.0,94,11358,50,13445.0,17,13450.0,2,B
2018-04-26 09:16:22,13455.0,6,11364,2,13450.0,17,13455.0,53,B
2018-04-26 09:16:24,13450.0,6,11370,-6,13450.0,5,13455.0,57,S
2018-04-26 09:16:24,13450.0,6,11376,-2,13450.0,4,13455.0,57,S
2018-04-26 09:16:26,13450.0,4,11380,4,13445.0,11,13450.0,8,S
2018-04-26 09:16:27,13450.0,2,11382,0,13445.0,13,13450.0,7,S
2018-04-26 09:16:29,13450.0,2,11384,2,13445.0,24,13450.0,6,S
2018-04-26 09:16:30,13445.0,4,11388,-2,13445.0,22,13450.0,6,S
2018-04-26 09:16:34,13450.0,12,11400,12,13450.0,4,13455.0,57,B
2018-04-26 09:16:37,13450.0,2,11402,0,13450.0,20,13455.0,51,B
2018-04-26 09:16:47,13450.0,2,11404,2,13450.0,21,13455.0,51,B
2018-04-26 09:16:49,13455.0,6,11410,4,13450.0,43,13455.0,48,B
2018-04-26 09:16:50,13455.0,58,11468,4,13450.0,21,13455.0,19,B
2018-04-26 09:16:50,13455.0,16,11484,2,13450.0,21,13455.0,11,B
2018-04-26 09:16:51,13455.0,4,11488,4,13450.0,21,13455.0,9,B
2018-04-26 09:16:51,13455.0,4,11492,0,13450.0,21,13455.0,7,B
2018-04-26 09:16:52,13455.0,4,11496,0,13450.0,22,13455.0,5,B
2018-04-26 09:16:53,13455.0,2,11498,0,13450.0,23,13455.0,4,B
2018-04-26 09:16:58,13455.0,8,11506,0,13450.0,26,13460.0,56,B
2018-04-26 09:17:09,13455.0,10,11516,-4,13450.0,18,13460.0,59,B
2018-04-26 09:17:38,13455.0,2,11518,0,13450.0,23,13460.0,61,B
2018-04-26 09:17:42,13455.0,12,11530,8,13450.0,22,13455.0,1,B
2018-04-26 09:18:00,13450.0,18,11548,6,13445.0,11,13450.0,1,S
2018-04-26 09:18:01,13450.0,8,11556,0,13445.0,10,13450.0,2,S
2018-04-26 09:18:01,13450.0,4,11560,2,13445.0,7,13450.0,1,S
2018-04-26 09:18:04,13450.0,2,11562,2,13445.0,19,13455.0,13,S
2018-04-26 09:18:11,13450.0,2,11564,0,13445.0,10,13450.0,4,S
2018-04-26 09:18:15,13450.0,4,11568,0,13445.0,8,13450.0,2,S
2018-04-26 09:18:15,13450.0,2,11570,-2,13445.0,8,13450.0,1,S
2018-04-26 09:18:19,13445.0,4,11574,-2,13445.0,5,13450.0,23,S
2018-04-26 09:18:19,13445.0,10,11584,2,13440.0,10,13450.0,26,S
2018-04-26 09:18:28,13440.0,10,11594,4,13435.0,6,13445.0,54,S
2018-04-26 09:18:29,13445.0,26,11620,14,13435.0,16,13445.0,49,B
2018-04-26 09:18:49,13435.0,2,11622,0,13435.0,37,13445.0,50,S
2018-04-26 09:18:51,13445.0,20,11642,20,13435.0,37,13445.0,40,B
2018-04-26 09:18:56,13445.0,20,11662,20,13435.0,37,13445.0,35,B
2018-04-26 09:18:58,13435.0,4,11666,2,13435.0,19,13440.0,15,S
2018-04-26 09:18:58,13435.0,38,11704,22,13430.0,3,13440.0,15,S
2018-04-26 09:18:59,13440.0,20,11724,18,13430.0,13,13440.0,12,B
2018-04-26 09:19:01,13435.0,2,11726,0,13435.0,1,13440.0,10,S
2018-04-26 09:19:01,13435.0,2,11728,0,13430.0,13,13440.0,13,S
2018-04-26 09:19:08,13435.0,8,11736,6,13430.0,16,13440.0,14,S
2018-04-26 09:19:08,13440.0,20,11756,12,13435.0,5,13440.0,1,B
2018-04-26 09:19:09,13440.0,2,11758,2,13440.0,4,13445.0,33,B
2018-04-26 09:19:10,13445.0,8,11766,0,13440.0,10,13445.0,25,B
2018-04-26 09:19:12,13440.0,4,11770,0,13440.0,16,13445.0,25,S
2018-04-26 09:19:26,13445.0,2,11772,0,13440.0,16,13445.0,24,B
2018-04-26 09:19:31,13445.0,2,11774,0,13440.0,5,13445.0,23,B
2018-04-26 09:19:32,13445.0,20,11794,20,13440.0,5,13445.0,13,B
2018-04-26 09:19:35,13445.0,18,11812,18,13440.0,25,13445.0,4,B
2018-04-26 09:19:36,13445.0,8,11820,-2,13440.0,23,13450.0,8,B
2018-04-26 09:19:44,13445.0,6,11826,0,13440.0,23,13450.0,12,B
2018-04-26 09:19:56,13445.0,6,11832,6,13440.0,23,13445.0,2,B
2018-04-26 09:19:57,13445.0,2,11834,0,13440.0,24,13445.0,4,B
2018-04-26 09:19:57,13445.0,8,11842,6,13440.0,24,13450.0,11,B
2018-04-26 09:20:03,13440.0,2,11844,0,13440.0,23,13450.0,16,S
2018-04-26 09:20:04,13440.0,10,11854,2,13440.0,18,13450.0,18,S
2018-04-26 09:20:16,13445.0,2,11856,2,13440.0,17,13445.0,4,B
2018-04-26 09:20:33,13440.0,4,11860,4,13440.0,18,13445.0,35,S
2018-04-26 09:20:34,13445.0,4,11864,0,13440.0,12,13445.0,38,B
2018-04-26 09:20:40,13440.0,2,11866,0,13440.0,14,13445.0,34,S
2018-04-26 09:21:00,13440.0,4,11870,0,13440.0,13,13445.0,31,S
2018-04-26 09:21:07,13445.0,2,11872,0,13440.0,14,13445.0,30,B
2018-04-26 09:21:17,13445.0,2,11874,0,13440.0,13,13445.0,33,B
2018-04-26 09:21:20,13440.0,2,11876,0,13440.0,12,13445.0,33,S
2018-04-26 09:21:30,13440.0,20,11896,-16,13435.0,8,13440.0,3,S
2018-04-26 09:21:37,13440.0,4,11900,4,13435.0,10,13440.0,4,S
2018-04-26 09:21:39,13440.0,2,11902,-2,13435.0,10,13440.0,3,S
2018-04-26 09:22:04,13435.0,8,11910,0,13430.0,13,13435.0,1,S
2018-04-26 09:22:13,13430.0,2,11912,-2,13430.0,10,13435.0,4,S
2018-04-26 09:22:18,13435.0,2,11914,0,13430.0,10,13435.0,3,B
2018-04-26 09:22:19,13430.0,2,11916,-2,13430.0,9,13435.0,3,S
2018-04-26 09:22:29,13435.0,2,11918,0,13430.0,11,13435.0,2,B
2018-04-26 09:22:33,13435.0,2,11920,2,13430.0,11,13435.0,1,B
2018-04-26 09:22:37,13435.0,6,11926,0,13430.0,11,13435.0,1,B
2018-04-26 09:22:42,13435.0,4,11930,4,13435.0,8,13440.0,40,B
2018-04-26 09:22:43,13435.0,16,11946,16,13430.0,11,13440.0,40,B
2018-04-26 09:22:45,13435.0,2,11948,2,13430.0,11,13440.0,40,B
2018-04-26 09:22:49,13440.0,20,11968,10,13430.0,12,13440.0,43,B
2018-04-26 09:22:55,13435.0,6,11974,2,13435.0,4,13440.0,21,S
2018-04-26 09:22:55,13440.0,20,11994,20,13435.0,4,13440.0,11,B
2018-04-26 09:23:01,13440.0,2,11996,2,13435.0,4,13440.0,10,B
2018-04-26 09:23:02,13440.0,20,12016,20,13435.0,4,13445.0,49,B
2018-04-26 09:23:09,13440.0,2,12018,2,13440.0,12,13445.0,42,B
2018-04-26 09:23:12,13445.0,2,12020,0,13440.0,12,13445.0,41,B
2018-04-26 09:23:23,13445.0,6,12026,0,13440.0,5,13445.0,27,B
2018-04-26 09:23:23,13445.0,4,12030,0,13440.0,6,13445.0,23,B
2018-04-26 09:23:28,13440.0,12,12042,2,13435.0,14,13445.0,23,S
2018-04-26 09:23:31,13445.0,18,12060,18,13440.0,3,13445.0,18,B
2018-04-26 09:23:35,13440.0,6,12066,2,13435.0,18,13445.0,18,S
2018-04-26 09:23:38,13435.0,8,12074,4,13435.0,6,13440.0,1,S
2018-04-26 09:23:39,13440.0,2,12076,-2,13435.0,10,13440.0,1,B
2018-04-26 09:23:45,13435.0,4,12080,4,13435.0,16,13445.0,44,S
2018-04-26 09:23:46,13445.0,2,12082,2,13435.0,6,13445.0,47,B
2018-04-26 09:23:49,13440.0,4,12086,-2,13435.0,4,13445.0,47,S
2018-04-26 09:24:03,13435.0,6,12092,-4,13430.0,16,13440.0,13,S
2018-04-26 09:24:08,13430.0,2,12094,-2,13430.0,22,13440.0,14,S
2018-04-26 09:24:10,13435.0,2,12096,0,13430.0,18,13435.0,9,B
2018-04-26 09:24:11,13435.0,4,12100,0,13430.0,18,13435.0,10,B
2018-04-26 09:24:15,13430.0,6,12106,0,13430.0,20,13435.0,10,S
2018-04-26 09:24:22,13430.0,16,12122,8,13425.0,2,13435.0,19,S
2018-04-26 09:24:32,13435.0,2,12124,0,13425.0,12,13435.0,19,B
2018-04-26 09:24:45,13430.0,2,12126,2,13430.0,1,13435.0,19,S
2018-04-26 09:24:45,13425.0,4,12130,-2,13425.0,6,13430.0,14,S
2018-04-26 09:24:54,13430.0,2,12132,0,13425.0,5,13430.0,8,B
2018-04-26 09:24:54,13425.0,2,12134,0,13425.0,4,13430.0,8,S
2018-04-26 09:24:56,13430.0,2,12136,0,13425.0,17,13430.0,1,B
2018-04-26 09:25:04,13430.0,16,12152,12,13430.0,2,13435.0,31,B
2018-04-26 09:25:04,13430.0,4,12156,2,13425.0,5,13435.0,31,B
2018-04-26 09:25:13,13430.0,12,12168,12,13430.0,4,13435.0,19,B
2018-04-26 09:25:13,13430.0,10,12178,10,13425.0,6,13430.0,4,B
2018-04-26 09:25:16,13430.0,2,12180,0,13425.0,7,13430.0,3,B
2018-04-26 09:25:21,13425.0,14,12194,-10,13420.0,7,13425.0,3,S
2018-04-26 09:25:21,13425.0,6,12200,0,13425.0,2,13430.0,3,S
2018-04-26 09:25:25,13425.0,10,12210,2,13420.0,11,13430.0,6,S
2018-04-26 09:25:30,13430.0,16,12226,6,13430.0,2,13435.0,18,B
2018-04-26 09:25:30,13430.0,4,12230,4,13425.0,5,13435.0,18,B
2018-04-26 09:25:32,13430.0,2,12232,0,13425.0,10,13430.0,6,B
2018-04-26 09:25:34,13430.0,12,12244,12,13430.0,4,13435.0,18,B
2018-04-26 09:25:34,13430.0,8,12252,8,13425.0,10,13435.0,18,B
2018-04-26 09:25:37,13430.0,2,12254,2,13430.0,9,13435.0,19,B
2018-04-26 09:25:37,13430.0,2,12256,2,13430.0,8,13435.0,19,B
2018-04-26 09:25:50,13435.0,16,12272,0,13430.0,11,13440.0,8,B
2018-04-26 09:25:56,13435.0,2,12274,-2,13430.0,19,13440.0,9,B
2018-04-26 09:25:57,13440.0,16,12290,10,13430.0,24,13440.0,1,B
2018-04-26 09:26:04,13440.0,2,12292,0,13435.0,3,13440.0,10,B
2018-04-26 09:26:06,13440.0,2,12294,0,13435.0,3,13440.0,9,B
2018-04-26 09:26:09,13440.0,26,12320,14,13430.0,16,13440.0,6,B
2018-04-26 09:26:13,13440.0,12,12332,0,13440.0,4,13445.0,51,B
2018-04-26 09:26:14,13440.0,10,12342,6,13435.0,1,13440.0,3,B
2018-04-26 09:26:34,13430.0,6,12348,-4,13430.0,6,13435.0,6,S
2018-04-26 09:26:35,13430.0,6,12354,2,13430.0,3,13435.0,6,S
2018-04-26 09:26:35,13430.0,6,12360,2,13425.0,16,13430.0,1,S
2018-04-26 09:26:36,13430.0,2,12362,2,13425.0,7,13430.0,6,S
2018-04-26 09:26:37,13425.0,12,12374,2,13420.0,6,13425.0,2,S
2018-04-26 09:26:38,13425.0,6,12380,2,13425.0,5,13430.0,9,S
2018-04-26 09:26:40,13425.0,8,12388,-8,13420.0,14,13425.0,4,S
2018-04-26 09:26:41,13425.0,8,12396,0,13420.0,12,13430.0,4,S
2018-04-26 09:26:43,13430.0,2,12398,2,13420.0,12,13430.0,8,B
2018-04-26 09:26:50,13425.0,2,12400,0,13420.0,8,13425.0,1,S
2018-04-26 09:26:50,13425.0,6,12406,6,13425.0,1,13430.0,11,S
2018-04-26 09:26:56,13430.0,14,12420,2,13425.0,15,13435.0,18,B
2018-04-26 09:26:57,13435.0,4,12424,0,13430.0,9,13440.0,21,B
2018-04-26 09:27:01,13430.0,12,12436,-4,13425.0,12,13435.0,16,S
2018-04-26 09:27:28,13425.0,2,12438,0,13425.0,4,13430.0,4,S
2018-04-26 09:27:54,13430.0,2,12440,2,13430.0,4,13435.0,21,B
2018-04-26 09:27:54,13430.0,4,12444,0,13430.0,2,13435.0,20,B
2018-04-26 09:28:16,13440.0,4,12448,4,13430.0,9,13440.0,13,B
2018-04-26 09:28:25,13440.0,6,12454,2,13435.0,3,13440.0,10,B
2018-04-26 09:28:57,13440.0,8,12462,2,13435.0,13,13445.0,40,B
2018-04-26 09:29:09,13440.0,2,12464,0,13440.0,1,13445.0,45,B
2018-04-26 09:29:10,13445.0,2,12466,2,13440.0,1,13445.0,44,B
2018-04-26 09:29:18,13445.0,4,12470,4,13440.0,2,13445.0,40,B
2018-04-26 09:29:21,13440.0,2,12472,-2,13435.0,14,13445.0,40,S
2018-04-26 09:29:30,13440.0,2,12474,0,13435.0,16,13445.0,40,S
2018-04-26 09:29:48,13440.0,6,12480,-6,13435.0,14,13440.0,17,S
2018-04-26 09:29:56,13435.0,6,12486,-6,13430.0,7,13435.0,1,S
2018-04-26 09:30:01,13435.0,2,12488,0,13435.0,19,13440.0,21,S
2018-04-26 09:30:01,13435.0,2,12490,0,13435.0,21,13440.0,19,S
2018-04-26 09:30:06,13435.0,2,12492,0,13435.0,13,13440.0,18,S
2018-04-26 09:30:17,13440.0,8,12500,-8,13435.0,20,13440.0,15,B
2018-04-26 09:30:29,13440.0,2,12502,-2,13435.0,21,13440.0,14,B
2018-04-26 09:30:36,13440.0,2,12504,-2,13435.0,15,13440.0,13,B
2018-04-26 09:30:44,13440.0,2,12506,-2,13435.0,15,13440.0,14,B
2018-04-26 09:31:00,13440.0,2,12508,-2,13435.0,12,13440.0,13,B
2018-04-26 09:31:01,13440.0,4,12512,-4,13435.0,12,13440.0,11,B
2018-04-26 09:31:20,13440.0,2,12514,0,13435.0,12,13440.0,10,B
2018-04-26 09:31:34,13435.0,2,12516,-2,13435.0,10,13440.0,10,S
2018-04-26 09:31:35,13440.0,2,12518,-2,13435.0,8,13440.0,9,B
2018-04-26 09:31:49,13440.0,4,12522,0,13435.0,8,13440.0,4,B
2018-04-26 09:31:52,13440.0,4,12526,0,13435.0,8,13440.0,2,B
2018-04-26 09:31:55,13440.0,4,12530,2,13435.0,8,13445.0,40,B
2018-04-26 09:32:02,13440.0,4,12534,4,13435.0,10,13445.0,41,B
2018-04-26 09:32:23,13440.0,2,12536,0,13440.0,11,13445.0,33,B
2018-04-26 09:32:24,13445.0,16,12552,12,13440.0,15,13445.0,23,B
2018-04-26 09:32:24,13445.0,10,12562,2,13440.0,12,13445.0,18,B
2018-04-26 09:32:25,13445.0,6,12568,-6,13440.0,12,13445.0,15,B
2018-04-26 09:32:25,13445.0,30,12598,2,13440.0,12,13450.0,8,B
2018-04-26 09:32:32,13445.0,14,12612,4,13440.0,10,13445.0,3,B
2018-04-26 09:32:33,13445.0,6,12618,6,13445.0,5,13450.0,7,B
2018-04-26 09:32:33,13450.0,14,12632,-4,13445.0,22,13455.0,16,B
2018-04-26 09:32:37,13460.0,8,12640,4,13455.0,2,13460.0,19,B
2018-04-26 09:32:38,13455.0,4,12644,-2,13450.0,8,13455.0,2,S
2018-04-26 09:32:38,13450.0,22,12666,14,13445.0,28,13450.0,2,S
2018-04-26 09:32:39,13450.0,4,12670,4,13450.0,7,13455.0,2,S
2018-04-26 09:32:39,13455.0,2,12672,0,13450.0,12,13460.0,13,B
2018-04-26 09:32:41,13460.0,4,12676,0,13455.0,4,13465.0,8,B
2018-04-26 09:32:43,13460.0,2,12678,2,13455.0,9,13465.0,12,B
2018-04-26 09:32:52,13460.0,6,12684,2,13460.0,2,13465.0,15,B
2018-04-26 09:32:53,13460.0,4,12688,-4,13455.0,12,13465.0,15,B
2018-04-26 09:32:59,13460.0,20,12708,20,13455.0,9,13465.0,19,B
2018-04-26 09:33:00,13455.0,2,12710,2,13455.0,8,13465.0,19,S
2018-04-26 09:33:10,13455.0,4,12714,0,13455.0,1,13460.0,11,S
2018-04-26 09:33:11,13455.0,2,12716,0,13450.0,8,13455.0,43,S
2018-04-26 09:33:11,13450.0,16,12732,-8,13445.0,5,13450.0,6,S
2018-04-26 09:33:15,13445.0,4,12736,2,13445.0,2,13450.0,10,S
2018-04-26 09:33:22,13450.0,2,12738,-2,13450.0,1,13455.0,28,B
2018-04-26 09:33:23,13450.0,2,12740,0,13445.0,11,13455.0,28,B
2018-04-26 09:33:25,13450.0,2,12742,0,13450.0,1,13455.0,25,B
2018-04-26 09:33:25,13450.0,2,12744,0,13445.0,12,13450.0,2,B
2018-04-26 09:33:30,13445.0,4,12748,4,13445.0,9,13450.0,3,S
2018-04-26 09:33:31,13450.0,4,12752,-4,13445.0,9,13450.0,1,B
2018-04-26 09:33:39,13450.0,2,12754,-2,13445.0,17,13450.0,10,B
2018-04-26 09:33:43,13445.0,4,12758,-4,13445.0,13,13450.0,10,S
2018-04-26 09:33:45,13445.0,20,12778,12,13445.0,5,13455.0,13,S
2018-04-26 09:34:01,13445.0,2,12780,0,13445.0,7,13450.0,20,S
2018-04-26 09:34:01,13445.0,14,12794,6,13440.0,5,13450.0,24,S
2018-04-26 09:34:02,13445.0,2,12796,0,13440.0,8,13450.0,25,S
2018-04-26 09:34:02,13445.0,2,12798,0,13445.0,3,13450.0,25,S
2018-04-26 09:34:03,13445.0,6,12804,0,13445.0,1,13450.0,25,S
2018-04-26 09:34:03,13445.0,2,12806,-2,13440.0,5,13445.0,27,S
2018-04-26 09:34:07,13445.0,12,12818,10,13440.0,5,13445.0,1,S
2018-04-26 09:34:08,13445.0,4,12822,0,13440.0,8,13450.0,24,S
2018-04-26 09:34:21,13440.0,10,12832,0,13435.0,18,13440.0,5,S
2018-04-26 09:34:21,13440.0,10,12842,0,13440.0,2,13445.0,4,S
2018-04-26 09:34:25,13440.0,10,12852,4,13435.0,17,13440.0,5,S
2018-04-26 09:34:26,13440.0,10,12862,0,13435.0,17,13445.0,4,S
2018-04-26 09:34:45,13440.0,2,12864,0,13435.0,17,13440.0,9,S
2018-04-26 09:34:45,13440.0,2,12866,0,13435.0,19,13440.0,8,S
2018-04-26 09:35:10,13435.0,20,12886,16,13435.0,9,13440.0,14,S
2018-04-26 09:35:12,13440.0,28,12914,0,13435.0,7,13440.0,2,B
2018-04-26 09:35:13,13440.0,4,12918,-4,13440.0,3,13445.0,15,B
2018-04-26 09:35:18,13440.0,4,12922,-2,13440.0,2,13445.0,19,B
2018-04-26 09:35:19,13440.0,4,12926,0,13435.0,7,13440.0,5,B
2018-04-26 09:35:40,13435.0,20,12946,8,13435.0,2,13440.0,15,S
2018-04-26 09:35:45,13435.0,4,12950,0,13430.0,14,13435.0,6,S
2018-04-26 09:35:46,13435.0,10,12960,6,13430.0,20,13435.0,1,S
2018-04-26 09:35:46,13435.0,2,12962,0,13435.0,1,13440.0,7,S
2018-04-26 09:35:52,13435.0,2,12964,0,13430.0,18,13435.0,4,S
2018-04-26 09:35:53,13435.0,6,12970,6,13430.0,22,13435.0,1,S
2018-04-26 09:35:53,13435.0,2,12972,2,13435.0,3,13440.0,7,S
2018-04-26 09:36:16,13435.0,10,12982,6,13430.0,8,13435.0,1,S
2018-04-26 09:37:11,13445.0,10,12992,-2,13440.0,12,13450.0,13,B
2018-04-26 09:37:17,13450.0,4,12996,-4,13445.0,18,13450.0,1,B
2018-04-26 09:37:18,13450.0,2,12998,0,13445.0,18,13455.0,10,B
2018-04-26 09:37:20,13450.0,10,13008,0,13445.0,14,13455.0,11,B
2018-04-26 09:37:22,13450.0,2,13010,-2,13445.0,14,13455.0,11,B
2018-04-26 09:37:26,13450.0,2,13012,0,13450.0,4,13455.0,11,B
2018-04-26 09:37:30,13455.0,2,13014,2,13450.0,10,13455.0,1,B
2018-04-26 09:37:41,13450.0,4,13018,0,13450.0,3,13455.0,16,S
2018-04-26 09:37:42,13450.0,6,13024,6,13445.0,8,13450.0,5,S
2018-04-26 09:37:46,13450.0,2,13026,0,13445.0,19,13455.0,14,S
2018-04-26 09:38:20,13450.0,8,13034,2,13445.0,16,13455.0,14,S
2018-04-26 09:38:50,13450.0,6,13040,4,13450.0,7,13455.0,14,S
2018-04-26 09:38:51,13450.0,14,13054,12,13445.0,8,13450.0,1,S
2018-04-26 09:38:52,13445.0,16,13070,6,13440.0,3,13450.0,12,S
2018-04-26 09:39:05,13445.0,8,13078,-2,13440.0,43,13445.0,3,S
2018-04-26 09:39:06,13445.0,8,13086,-4,13440.0,43,13450.0,21,S
2018-04-26 09:39:09,13445.0,2,13088,0,13440.0,43,13450.0,35,S
2018-04-26 09:39:15,13445.0,6,13094,-2,13440.0,42,13445.0,1,S
2018-04-26 09:39:34,13450.0,14,13108,-14,13450.0,1,13455.0,23,B
2018-04-26 09:39:38,13455.0,4,13112,4,13450.0,13,13460.0,17,B
2018-04-26 09:40:01,13455.0,2,13114,2,13450.0,6,13460.0,28,B
2018-04-26 09:40:10,13455.0,10,13124,10,13445.0,12,13455.0,10,B
2018-04-26 09:40:16,13450.0,6,13130,4,13445.0,4,13450.0,3,S
2018-04-26 09:40:17,13450.0,6,13136,-2,13445.0,14,13455.0,4,S
2018-04-26 09:40:51,13450.0,2,13138,-2,13445.0,14,13455.0,12,S
2018-04-26 09:41:01,13450.0,10,13148,0,13445.0,18,13455.0,10,S
2018-04-26 09:41:16,13455.0,4,13152,0,13450.0,9,13455.0,8,B
2018-04-26 09:41:17,13450.0,2,13154,0,13450.0,8,13455.0,8,S
2018-04-26 09:42:58,13450.0,2,13156,2,13450.0,11,13455.0,3,S
2018-04-26 09:43:46,13450.0,14,13170,-12,13445.0,11,13450.0,2,S
2018-04-26 09:43:47,13450.0,4,13174,4,13445.0,13,13455.0,17,S
2018-04-26 09:43:52,13445.0,20,13194,-10,13445.0,1,13450.0,6,S
2018-04-26 09:43:52,13450.0,6,13200,0,13445.0,2,13450.0,3,B
2018-04-26 09:43:58,13445.0,2,13202,-2,13445.0,1,13450.0,11,S
2018-04-26 09:43:59,13445.0,2,13204,-2,13445.0,1,13450.0,11,S
2018-04-26 09:44:01,13445.0,2,13206,-2,13445.0,1,13450.0,12,S
2018-04-26 09:44:12,13445.0,2,13208,-2,13445.0,1,13450.0,12,S
2018-04-26 09:44:14,13450.0,2,13210,0,13445.0,1,13450.0,11,B
2018-04-26 09:44:28,13450.0,2,13212,-2,13445.0,2,13450.0,10,B
2018-04-26 09:44:29,13450.0,16,13228,0,13445.0,14,13450.0,1,B
2018-04-26 09:44:29,13450.0,2,13230,2,13445.0,14,13455.0,16,B
2018-04-26 09:45:24,13450.0,6,13236,4,13445.0,14,13450.0,2,B
2018-04-26 09:45:25,13445.0,18,13254,8,13440.0,56,13450.0,25,S
2018-04-26 09:45:36,13450.0,44,13298,-18,13450.0,8,13455.0,9,B
2018-04-26 09:45:36,13450.0,16,13314,-12,13445.0,5,13450.0,3,B
2018-04-26 09:46:01,13445.0,2,13316,-2,13445.0,6,13450.0,2,S
2018-04-26 09:46:08,13445.0,8,13324,-6,13440.0,61,13450.0,23,S
2018-04-26 09:46:35,13445.0,2,13326,2,13440.0,57,13445.0,3,S
2018-04-26 09:46:45,13445.0,4,13330,-4,13445.0,2,13450.0,15,S
2018-04-26 09:46:45,13445.0,2,13332,-2,13445.0,1,13450.0,15,S
2018-04-26 09:46:46,13445.0,2,13334,-2,13440.0,57,13450.0,20,S
2018-04-26 09:47:08,13445.0,32,13366,-10,13440.0,54,13450.0,26,S
2018-04-26 09:47:08,13445.0,2,13368,2,13440.0,54,13450.0,32,S
2018-04-26 09:47:18,13440.0,10,13378,6,13440.0,49,13445.0,22,S
2018-04-26 09:47:21,13440.0,10,13388,10,13440.0,44,13445.0,22,S
2018-04-26 09:47:29,13440.0,8,13396,4,13440.0,40,13445.0,21,S
2018-04-26 09:47:29,13440.0,80,13476,72,13435.0,7,13440.0,10,S
2018-04-26 09:47:30,13435.0,2,13478,-2,13435.0,2,13440.0,21,S
2018-04-26 09:47:30,13435.0,4,13482,-4,13430.0,9,13435.0,3,S
2018-04-26 09:47:34,13430.0,8,13490,0,13430.0,5,13435.0,5,S
2018-04-26 09:47:35,13430.0,4,13494,-2,13430.0,6,13435.0,5,S
2018-04-26 09:47:39,13430.0,6,13500,0,13430.0,1,13435.0,8,S
2018-04-26 09:47:39,13430.0,2,13502,-2,13425.0,9,13435.0,20,S
2018-04-26 09:47:41,13440.0,18,13520,-2,13435.0,2,13440.0,16,B
2018-04-26 09:47:43,13435.0,8,13528,-8,13430.0,18,13435.0,5,S
2018-04-26 09:47:45,13435.0,10,13538,-4,13425.0,12,13435.0,9,S
2018-04-26 09:47:56,13435.0,8,13546,-8,13430.0,21,13435.0,4,S
2018-04-26 09:47:56,13435.0,8,13554,8,13430.0,24,13440.0,7,S
2018-04-26 09:48:02,13435.0,2,13556,2,13430.0,11,13435.0,2,S
2018-04-26 09:48:12,13435.0,10,13566,0,13430.0,16,13440.0,14,S
2018-04-26 09:48:13,13440.0,2,13568,0,13430.0,17,13440.0,13,B
2018-04-26 09:48:34,13440.0,2,13570,0,13435.0,21,13445.0,9,B
2018-04-26 09:48:51,13440.0,2,13572,0,13435.0,20,13445.0,13,B
2018-04-26 09:49:00,13445.0,4,13576,0,13440.0,18,13450.0,10,B
2018-04-26 09:49:14,13440.0,4,13580,-4,13435.0,14,13445.0,16,S
2018-04-26 09:49:30,13440.0,2,13582,0,13435.0,12,13440.0,6,S
2018-04-26 09:49:36,13435.0,4,13586,-4,13435.0,5,13440.0,2,S
2018-04-26 09:49:37,13435.0,2,13588,0,13435.0,2,13440.0,9,S
2018-04-26 09:49:37,13435.0,4,13592,-2,13430.0,10,13440.0,9,S
2018-04-26 09:49:41,13430.0,14,13606,-12,13430.0,7,13440.0,12,S
2018-04-26 09:49:49,13435.0,2,13608,0,13430.0,7,13435.0,4,B
2018-04-26 09:49:52,13430.0,14,13622,2,13425.0,14,13430.0,6,S
2018-04-26 09:50:01,13425.0,16,13638,6,13425.0,3,13430.0,12,S
2018-04-26 09:50:02,13425.0,6,13644,0,13420.0,6,13425.0,2,S
2018-04-26 09:50:03,13415.0,20,13664,14,13410.0,3,13420.0,2,S
2018-04-26 09:50:03,13415.0,2,13666,-2,13410.0,10,13415.0,1,S
2018-04-26 09:50:04,13410.0,4,13670,0,13410.0,5,13415.0,8,S
2018-04-26 09:50:05,13410.0,10,13680,2,13405.0,12,13410.0,6,S
2018-04-26 09:50:05,13415.0,14,13694,10,13410.0,10,13415.0,4,B
2018-04-26 09:50:06,13415.0,8,13702,-2,13415.0,3,13420.0,11,B
2018-04-26 09:50:06,13415.0,4,13706,-4,13415.0,3,13420.0,10,B
2018-04-26 09:50:07,13415.0,6,13712,-6,13410.0,22,13420.0,11,B
2018-04-26 09:50:09,13415.0,2,13714,-2,13410.0,17,13415.0,1,B
2018-04-26 09:50:09,13415.0,2,13716,0,13410.0,17,13420.0,15,B
2018-04-26 09:50:11,13410.0,2,13718,-2,13410.0,6,13415.0,2,S
2018-04-26 09:50:12,13410.0,4,13722,-4,13405.0,18,13415.0,10,S
2018-04-26 09:50:12,13415.0,18,13740,14,13415.0,6,13420.0,19,B
2018-04-26 09:50:13,13415.0,12,13752,12,13410.0,5,13415.0,2,B
2018-04-26 09:50:14,13410.0,6,13758,2,13405.0,20,13410.0,1,S
2018-04-26 09:50:14,13410.0,18,13776,6,13405.0,7,13410.0,5,S
2018-04-26 09:50:15,13410.0,2,13778,0,13405.0,7,13410.0,6,S
2018-04-26 09:50:18,13410.0,4,13782,0,13405.0,13,13415.0,12,S
2018-04-26 09:50:20,13405.0,4,13786,-2,13405.0,9,13415.0,15,S
2018-04-26 09:50:21,13405.0,8,13794,-2,13405.0,2,13410.0,3,S
2018-04-26 09:50:24,13405.0,2,13796,-2,13410.0,10,13415.0,6,S
2018-04-26 09:50:24,13415.0,4,13800,0,13410.0,12,13415.0,4,B
2018-04-26 09:50:25,13415.0,4,13804,-2,13410.0,12,13415.0,2,B
2018-04-26 09:50:25,13415.0,4,13808,2,13415.0,13,13420.0,14,B
2018-04-26 09:50:28,13415.0,2,13810,0,13415.0,12,13420.0,14,B
2018-04-26 09:50:29,13415.0,24,13834,0,13410.0,8,13415.0,8,B
2018-04-26 09:50:30,13415.0,16,13850,-16,13415.0,1,13420.0,14,B
2018-04-26 09:50:34,13415.0,10,13860,2,13410.0,8,13420.0,14,B
2018-04-26 09:50:37,13415.0,2,13862,0,13415.0,2,13420.0,14,B
2018-04-26 09:50:43,13420.0,2,13864,0,13415.0,4,13420.0,9,B
2018-04-26 09:50:47,13415.0,2,13866,2,13410.0,9,13420.0,11,S
2018-04-26 09:50:51,13415.0,4,13870,2,13410.0,4,13415.0,1,S
2018-04-26 09:50:54,13410.0,4,13874,-2,13410.0,3,13415.0,1,S
2018-04-26 09:50:57,13410.0,8,13882,4,13405.0,12,13410.0,1,S
2018-04-26 09:50:57,13410.0,6,13888,6,13405.0,7,13410.0,1,S
2018-04-26 09:50:58,13410.0,2,13890,0,13405.0,7,13415.0,26,S
2018-04-26 09:51:00,13410.0,8,13898,-4,13410.0,8,13415.0,10,S
2018-04-26 09:51:01,13410.0,6,13904,6,13405.0,12,13415.0,10,S
2018-04-26 09:51:02,13410.0,24,13928,18,13405.0,1,13410.0,9,S
2018-04-26 09:51:03,13405.0,2,13930,0,13405.0,2,13410.0,9,S
2018-04-26 09:51:04,13410.0,8,13938,0,13405.0,16,13415.0,12,B
2018-04-26 09:51:04,13410.0,6,13944,6,13410.0,10,13420.0,13,B
2018-04-26 09:51:07,13420.0,4,13948,4,13415.0,9,13420.0,3,B
2018-04-26 09:51:09,13420.0,6,13954,0,13415.0,19,13425.0,10,B
2018-04-26 09:51:10,13420.0,2,13956,-2,13420.0,2,13425.0,8,B
2018-04-26 09:51:12,13420.0,4,13960,-4,13415.0,19,13420.0,2,B
2018-04-26 09:51:13,13420.0,4,13964,0,13420.0,2,13425.0,6,B
2018-04-26 09:51:15,13420.0,4,13968,2,13415.0,19,13425.0,6,B
2018-04-26 09:51:17,13425.0,4,13972,0,13425.0,4,13430.0,4,B
2018-04-26 09:51:18,13425.0,6,13978,4,13425.0,2,13430.0,3,B
2018-04-26 09:51:20,13425.0,4,13982,2,13420.0,10,13430.0,10,B
2018-04-26 09:51:21,13425.0,12,13994,6,13425.0,14,13430.0,17,B
2018-04-26 09:51:22,13425.0,28,14022,14,13420.0,3,13425.0,1,B
2018-04-26 09:51:25,13425.0,2,14024,-2,13420.0,10,13430.0,22,B
2018-04-26 09:51:26,13425.0,2,14026,0,13425.0,20,13430.0,4,B
2018-04-26 09:51:31,13425.0,2,14028,2,13425.0,21,13430.0,4,B
2018-04-26 09:51:38,13425.0,2,14030,2,13425.0,23,13435.0,20,B
2018-04-26 09:51:39,13435.0,2,14032,0,13425.0,23,13435.0,19,B
2018-04-26 09:51:40,13425.0,50,14082,-10,13425.0,1,13435.0,19,S
2018-04-26 09:51:41,13430.0,4,14086,0,13425.0,13,13435.0,8,B
2018-04-26 09:51:50,13435.0,20,14106,12,13430.0,3,13435.0,9,B
2018-04-26 09:51:53,13430.0,6,14112,0,13425.0,6,13435.0,14,S
2018-04-26 09:52:02,13425.0,8,14120,-2,13425.0,17,13430.0,22,S
2018-04-26 09:52:02,13425.0,34,14154,20,13420.0,6,13425.0,15,S
2018-04-26 09:52:03,13420.0,4,14158,4,13420.0,2,13425.0,18,S
2018-04-26 09:52:03,13420.0,4,14162,0,13415.0,15,13425.0,27,S
2018-04-26 09:52:04,13415.0,4,14166,0,13415.0,13,13425.0,29,S
2018-04-26 09:52:05,13425.0,4,14170,4,13420.0,1,13425.0,23,B
2018-04-26 09:52:05,13425.0,38,14208,18,13420.0,10,13430.0,11,B
2018-04-26 09:52:12,13425.0,4,14212,2,13425.0,42,13430.0,6,B
2018-04-26 09:52:13,13425.0,4,14216,0,13425.0,40,13430.0,17,B
2018-04-26 09:52:13,13425.0,4,14220,2,13425.0,38,13430.0,18,B
2018-04-26 09:52:14,13425.0,2,14222,2,13425.0,37,13430.0,18,B
2018-04-26 09:52:14,13425.0,14,14236,0,13425.0,30,13430.0,18,B
2018-04-26 09:52:28,13425.0,2,14238,0,13425.0,32,13430.0,19,B
2018-04-26 09:52:29,13425.0,4,14242,4,13425.0,30,13430.0,19,B
2018-04-26 09:52:30,13425.0,8,14250,8,13425.0,26,13430.0,19,B
2018-04-26 09:52:31,13425.0,40,14290,24,13425.0,3,13430.0,23,B
2018-04-26 09:52:31,13425.0,6,14296,0,13420.0,14,13425.0,4,B
2018-04-26 09:52:32,13420.0,10,14306,0,13420.0,6,13425.0,8,S
2018-04-26 09:52:38,13425.0,10,14316,-8,13425.0,2,13430.0,13,B
2018-04-26 09:52:39,13430.0,16,14332,0,13425.0,15,13435.0,9,B
2018-04-26 09:52:42,13430.0,2,14334,0,13425.0,13,13430.0,3,B
2018-04-26 09:52:43,13425.0,10,14344,10,13420.0,11,13430.0,23,S
2018-04-26 09:52:43,13420.0,4,14348,2,13420.0,6,13425.0,2,S
2018-04-26 09:52:45,13425.0,24,14372,2,13425.0,5,13430.0,8,B
2018-04-26 09:52:46,13430.0,2,14374,0,13425.0,10,13435.0,13,B
2018-04-26 09:52:49,13425.0,8,14382,0,13425.0,6,13435.0,8,S
2018-04-26 09:52:53,13425.0,4,14386,0,13420.0,16,13425.0,8,S
2018-04-26 09:52:54,13425.0,16,14402,0,13420.0,20,13430.0,5,S
2018-04-26 09:52:55,13425.0,10,14412,-4,13420.0,18,13430.0,4,S
2018-04-26 09:52:56,13425.0,26,14438,2,13425.0,2,13435.0,10,S
2018-04-26 09:52:56,13430.0,4,14442,0,13425.0,13,13435.0,4,B
2018-04-26 09:52:58,13425.0,20,14462,2,13425.0,8,13435.0,7,S
2018-04-26 09:53:06,13430.0,12,14474,4,13430.0,2,13435.0,9,B
2018-04-26 09:53:06,13430.0,4,14478,-4,13425.0,14,13435.0,9,B
2018-04-26 09:53:08,13430.0,2,14480,0,13430.0,12,13435.0,3,B
2018-04-26 09:53:11,13430.0,6,14486,-4,13425.0,12,13435.0,8,B
2018-04-26 09:53:11,13435.0,2,14488,0,13425.0,14,13435.0,7,B
2018-04-26 09:53:12,13435.0,2,14490,-2,13425.0,14,13435.0,6,B
2018-04-26 09:53:14,13430.0,2,14492,-2,13430.0,4,13435.0,3,S
2018-04-26 09:53:19,13430.0,2,14494,0,13430.0,5,13435.0,3,S
2018-04-26 09:53:27,13435.0,4,14498,2,13430.0,9,13440.0,6,B
2018-04-26 09:53:31,13440.0,10,14508,-10,13435.0,18,13445.0,2,B
2018-04-26 09:53:32,13440.0,2,14510,0,13440.0,1,13445.0,5,B
2018-04-26 09:53:38,13440.0,4,14514,-4,13435.0,21,13445.0,5,B
2018-04-26 09:53:48,13440.0,2,14516,0,13435.0,18,13445.0,10,B
2018-04-26 09:53:48,13440.0,2,14518,0,13435.0,18,13445.0,10,B
2018-04-26 09:53:52,13450.0,32,14550,12,13435.0,18,13455.0,3,B
2018-04-26 09:53:53,13445.0,6,14556,0,13445.0,2,13450.0,8,S
2018-04-26 09:53:54,13445.0,2,14558,0,13445.0,6,13455.0,12,S
2018-04-26 09:53:55,13455.0,28,14586,14,13455.0,2,13460.0,17,B
2018-04-26 09:53:55,13450.0,6,14592,0,13450.0,3,13455.0,16,S
2018-04-26 09:53:56,13450.0,6,14598,-4,13445.0,8,13455.0,20,S
2018-04-26 09:53:57,13455.0,32,14630,18,13445.0,8,13455.0,2,B
2018-04-26 09:53:59,13450.0,4,14634,0,13445.0,8,13455.0,7,S
2018-04-26 09:54:02,13445.0,14,14648,2,13440.0,6,13445.0,11,S
2018-04-26 09:54:02,13440.0,12,14660,0,13435.0,9,13440.0,2,S
2018-04-26 09:54:09,13445.0,4,14664,4,13435.0,10,13445.0,8,B
2018-04-26 09:54:12,13445.0,18,14682,8,13445.0,2,13450.0,18,B
2018-04-26 09:54:12,13445.0,4,14686,4,13440.0,1,13445.0,10,B
2018-04-26 09:54:14,13440.0,2,14688,-2,13440.0,2,13445.0,5,S
2018-04-26 09:54:15,13445.0,8,14696,2,13445.0,6,13450.0,18,B
2018-04-26 09:54:16,13445.0,12,14708,4,13440.0,3,13445.0,3,B
2018-04-26 09:54:17,13445.0,6,14714,2,13445.0,7,13450.0,15,B
2018-04-26 09:54:18,13445.0,14,14728,12,13440.0,4,13450.0,15,B
2018-04-26 09:54:20,13445.0,2,14730,-2,13440.0,6,13450.0,18,B
2018-04-26 09:54:22,13450.0,22,14752,10,13450.0,1,13455.0,14,B
2018-04-26 09:54:22,13450.0,2,14754,0,13445.0,1,13450.0,4,B
2018-04-26 09:54:24,13445.0,2,14756,0,13445.0,2,13450.0,5,S
2018-04-26 09:54:29,13450.0,8,14764,2,13450.0,6,13455.0,15,B
2018-04-26 09:54:34,13455.0,2,14766,0,13450.0,8,13455.0,9,B
2018-04-26 09:54:34,13450.0,2,14768,2,13450.0,7,13455.0,9,S
2018-04-26 09:54:39,13450.0,2,14770,0,13450.0,6,13455.0,8,S
2018-04-26 09:54:39,13450.0,2,14772,2,13450.0,5,13455.0,8,S
2018-04-26 09:54:40,13450.0,10,14782,8,13445.0,21,13450.0,2,S
2018-04-26 09:54:43,13445.0,2,14784,0,13445.0,22,13455.0,15,S
2018-04-26 09:54:45,13455.0,28,14812,2,13450.0,6,13455.0,2,B
2018-04-26 09:54:46,13450.0,2,14814,0,13450.0,5,13455.0,6,S
2018-04-26 09:54:48,13455.0,12,14826,6,13455.0,4,13460.0,25,B
2018-04-26 09:54:48,13455.0,8,14834,6,13450.0,7,13460.0,30,B
2018-04-26 09:54:53,13450.0,22,14856,2,13450.0,8,13455.0,11,S
2018-04-26 09:54:54,13450.0,4,14860,0,13450.0,4,13455.0,11,S
2018-04-26 09:54:55,13455.0,20,14880,0,13450.0,5,13455.0,1,B
2018-04-26 09:54:55,13455.0,2,14882,-2,13450.0,5,13460.0,25,B
2018-04-26 09:54:57,13460.0,20,14902,2,13450.0,5,13460.0,12,B
2018-04-26 09:54:58,13460.0,8,14910,-4,13450.0,5,13460.0,8,B
2018-04-26 09:55:00,13460.0,16,14926,14,13460.0,2,13465.0,4,B
2018-04-26 09:55:01,13460.0,4,14930,4,13455.0,4,13460.0,3,B
2018-04-26 09:55:02,13455.0,8,14938,-6,13450.0,8,13455.0,6,S
2018-04-26 09:55:02,13455.0,12,14950,-12,13455.0,2,13465.0,6,S
2018-04-26 09:55:03,13460.0,4,14954,0,13460.0,13,13465.0,14,B
2018-04-26 09:55:04,13465.0,14,14968,-4,13460.0,18,13470.0,3,B
2018-04-26 09:55:05,13465.0,4,14972,0,13465.0,1,13470.0,1,B
2018-04-26 09:55:07,13465.0,4,14976,0,13465.0,1,13470.0,2,B
2018-04-26 09:55:08,13465.0,2,14978,0,13460.0,13,13470.0,3,B
2018-04-26 09:55:09,13465.0,2,14980,0,13460.0,13,13470.0,5,B
2018-04-26 09:55:10,13465.0,2,14982,0,13460.0,13,13470.0,3,B
2018-04-26 09:55:10,13460.0,2,14984,0,13460.0,12,13470.0,7,S
2018-04-26 09:55:15,13460.0,2,14986,2,13460.0,5,13465.0,1,S
2018-04-26 09:55:18,13465.0,4,14990,0,13460.0,5,13470.0,11,B
2018-04-26 09:55:19,13465.0,2,14992,0,13460.0,8,13470.0,10,B
2018-04-26 09:55:21,13475.0,20,15012,4,13470.0,2,13475.0,8,B
2018-04-26 09:55:23,13470.0,20,15032,4,13465.0,14,13475.0,6,S
2018-04-26 09:55:25,13470.0,4,15036,-2,13465.0,6,13475.0,11,S
2018-04-26 09:55:26,13475.0,4,15040,0,13465.0,7,13475.0,11,B
2018-04-26 09:55:27,13465.0,2,15042,0,13460.0,7,13465.0,2,S
2018-04-26 09:55:52,13470.0,4,15046,0,13470.0,4,13475.0,29,B
2018-04-26 09:55:53,13470.0,18,15064,-6,13470.0,16,13475.0,18,B
2018-04-26 09:55:53,13475.0,28,15092,0,13470.0,12,13475.0,4,B
2018-04-26 09:55:54,13470.0,2,15094,-2,13465.0,17,13475.0,16,S
2018-04-26 09:55:58,13470.0,8,15102,2,13465.0,15,13470.0,6,S
2018-04-26 09:56:01,13470.0,8,15110,-8,13470.0,1,13475.0,13,S
2018-04-26 09:56:02,13470.0,2,15112,0,13470.0,2,13475.0,12,S
2018-04-26 09:56:02,13470.0,2,15114,0,13470.0,3,13475.0,8,S
2018-04-26 09:56:03,13470.0,2,15116,0,13465.0,14,13475.0,9,S
2018-04-26 09:56:23,13465.0,2,15118,0,13465.0,12,13470.0,5,S
2018-04-26 09:56:23,13465.0,2,15120,-2,13465.0,11,13470.0,6,S
2018-04-26 09:56:24,13465.0,2,15122,0,13465.0,10,13470.0,6,S
2018-04-26 09:56:26,13465.0,2,15124,0,13465.0,9,13470.0,7,S
2018-04-26 09:56:27,13465.0,2,15126,0,13465.0,8,13470.0,7,S
2018-04-26 09:56:28,13465.0,2,15128,0,13465.0,7,13470.0,7,S
2018-04-26 09:56:29,13465.0,2,15130,0,13465.0,6,13470.0,7,S
2018-04-26 09:56:30,13465.0,2,15132,0,13465.0,5,13470.0,8,S
2018-04-26 09:56:33,13465.0,2,15134,-2,13465.0,3,13470.0,10,S
2018-04-26 09:56:41,13465.0,2,15136,0,13465.0,2,13470.0,11,S
2018-04-26 09:56:42,13465.0,2,15138,0,13465.0,1,13470.0,10,S
2018-04-26 09:56:43,13465.0,2,15140,2,13460.0,11,13470.0,10,S
2018-04-26 09:56:44,13465.0,2,15142,2,13465.0,2,13470.0,10,S
2018-04-26 09:56:44,13465.0,2,15144,2,13465.0,3,13470.0,10,S
2018-04-26 09:56:45,13465.0,2,15146,0,13465.0,2,13470.0,10,S
2018-04-26 09:56:46,13465.0,2,15148,-2,13465.0,2,13470.0,10,S
2018-04-26 09:56:50,13465.0,2,15150,-2,13465.0,1,13470.0,10,S
2018-04-26 09:56:57,13465.0,2,15152,-2,13460.0,16,13465.0,1,S
2018-04-26 09:56:58,13465.0,2,15154,0,13460.0,16,13470.0,10,S
2018-04-26 09:57:00,13465.0,10,15164,-10,13460.0,16,13470.0,10,S
2018-04-26 09:57:12,13465.0,6,15170,-4,13465.0,4,13470.0,14,S
2018-04-26 09:57:12,13465.0,8,15178,0,13460.0,13,13465.0,2,S
2018-04-26 09:57:52,13465.0,2,15180,0,13460.0,14,13465.0,3,S
2018-04-26 09:57:57,13460.0,10,15190,8,13455.0,25,13465.0,12,S
2018-04-26 09:58:01,13455.0,40,15230,30,13455.0,6,13460.0,2,S
2018-04-26 09:58:01,13450.0,24,15254,-8,13450.0,1,13455.0,24,S
2018-04-26 09:58:02,13450.0,2,15256,0,13445.0,19,13450.0,6,S
2018-04-26 09:58:02,13445.0,10,15266,4,13445.0,18,13455.0,29,S
2018-04-26 09:58:03,13445.0,10,15276,-10,13445.0,13,13450.0,17,S
2018-04-26 09:58:03,13445.0,26,15302,-12,13440.0,5,13445.0,12,S
2018-04-26 09:58:04,13435.0,14,15316,0,13430.0,2,13435.0,4,S
2018-04-26 09:58:04,13435.0,16,15332,-2,13435.0,1,13440.0,8,S
2018-04-26 09:58:05,13435.0,4,15336,0,13430.0,3,13435.0,2,S
2018-04-26 09:58:05,13440.0,26,15362,8,13435.0,1,13445.0,13,B
2018-04-26 09:58:06,13440.0,4,15366,0,13435.0,15,13445.0,13,B
2018-04-26 09:58:12,13445.0,2,15368,0,13440.0,10,13445.0,4,B
2018-04-26 09:58:22,13445.0,2,15370,0,13440.0,17,13445.0,4,B
2018-04-26 09:58:22,13445.0,8,15378,4,13440.0,17,13445.0,1,B
2018-04-26 09:58:23,13445.0,2,15380,0,13445.0,1,13450.0,12,B
2018-04-26 09:58:27,13445.0,2,15382,2,13445.0,12,13450.0,6,B
2018-04-26 09:58:30,13450.0,8,15390,8,13445.0,8,13450.0,2,B
2018-04-26 09:58:44,13450.0,2,15392,2,13445.0,3,13450.0,1,B
2018-04-26 09:58:45,13445.0,6,15398,-4,13440.0,17,13450.0,12,S
2018-04-26 09:58:46,13440.0,14,15412,-2,13435.0,13,13445.0,14,S
2018-04-26 09:58:52,13440.0,2,15414,0,13435.0,1,13440.0,5,S
2018-04-26 09:58:55,13440.0,6,15420,-4,13440.0,4,13445.0,13,S
2018-04-26 09:59:01,13440.0,4,15424,-2,13435.0,18,13440.0,1,S
2018-04-26 09:59:01,13440.0,8,15432,-6,13435.0,20,13445.0,13,S
2018-04-26 09:59:03,13435.0,10,15442,4,13430.0,9,13435.0,1,S
2018-04-26 09:59:06,13430.0,2,15444,0,13425.0,3,13435.0,9,S
2018-04-26 09:59:08,13425.0,12,15456,0,13420.0,7,13430.0,14,S
2018-04-26 09:59:09,13420.0,12,15468,12,13415.0,2,13420.0,2,S
2018-04-26 09:59:10,13415.0,6,15474,-2,13410.0,8,13415.0,4,S
2018-04-26 09:59:10,13415.0,10,15484,8,13410.0,10,13420.0,13,S
2018-04-26 09:59:11,13410.0,10,15494,-4,13410.0,3,13415.0,9,S
2018-04-26 09:59:11,13410.0,28,15522,0,13400.0,43,13410.0,18,S
2018-04-26 09:59:12,13405.0,2,15524,-2,13400.0,43,13405.0,2,S
2018-04-26 09:59:12,13410.0,40,15564,-12,13405.0,7,13415.0,5,B
2018-04-26 09:59:13,13415.0,10,15574,0,13415.0,9,13420.0,9,B
2018-04-26 09:59:13,13415.0,18,15592,12,13415.0,2,13420.0,6,B
2018-04-26 09:59:14,13415.0,4,15596,0,13410.0,10,13420.0,6,B
2018-04-26 09:59:15,13415.0,8,15604,-8,13410.0,11,13420.0,9,B
2018-04-26 09:59:16,13415.0,2,15606,-2,13415.0,13,13420.0,10,B
2018-04-26 09:59:17,13420.0,20,15626,8,13420.0,11,13425.0,4,B
2018-04-26 09:59:17,13425.0,2,15628,2,13420.0,9,13430.0,7,B
2018-04-26 09:59:18,13420.0,10,15638,-2,13420.0,11,13430.0,3,S
2018-04-26 09:59:19,13420.0,6,15644,0,13425.0,1,13430.0,1,S
2018-04-26 09:59:24,13430.0,10,15654,-10,13425.0,5,13430.0,1,B
2018-04-26 09:59:25,13430.0,2,15656,0,13425.0,5,13430.0,1,B
2018-04-26 09:59:28,13425.0,2,15658,0,13425.0,2,13430.0,3,S
2018-04-26 09:59:29,13425.0,2,15660,-2,13425.0,1,13430.0,3,S
2018-04-26 09:59:30,13425.0,2,15662,0,13425.0,4,13430.0,5,S
2018-04-26 09:59:39,13430.0,2,15664,0,13425.0,9,13430.0,5,B
2018-04-26 09:59:43,13425.0,8,15672,-2,13420.0,6,13425.0,4,S
2018-04-26 09:59:44,13425.0,18,15690,-6,13420.0,3,13430.0,10,S
2018-04-26 09:59:45,13425.0,4,15694,0,13425.0,5,13430.0,10,S
2018-04-26 09:59:51,13430.0,2,15696,2,13425.0,13,13430.0,4,B
2018-04-26 09:59:52,13425.0,4,15700,-4,13425.0,11,13430.0,4,S
2018-04-26 09:59:54,13430.0,12,15712,-12,13430.0,1,13435.0,9,B
2018-04-26 09:59:55,13430.0,20,15732,12,13430.0,1,13435.0,1,B
2018-04-26 09:59:56,13435.0,2,15734,0,13430.0,9,13440.0,4,B
2018-04-26 10:00:00,13430.0,2,15736,2,13430.0,7,13440.0,9,S
2018-04-26 10:00:01,13430.0,10,15746,4,13425.0,11,13435.0,5,S
2018-04-26 10:00:01,13425.0,2,15748,0,13425.0,9,13430.0,5,S
2018-04-26 10:00:03,13430.0,2,15750,-2,13425.0,11,13435.0,10,B
2018-04-26 10:00:10,13435.0,4,15754,-4,13430.0,7,13435.0,1,B
2018-04-26 10:00:10,13435.0,2,15756,0,13435.0,15,13440.0,7,B
2018-04-26 10:00:12,13440.0,4,15760,-2,13435.0,9,13440.0,5,B
2018-04-26 10:00:12,13440.0,10,15770,2,13435.0,9,13445.0,3,B
2018-04-26 10:00:13,13440.0,6,15776,-2,13435.0,9,13445.0,8,B
2018-04-26 10:00:18,13440.0,6,15782,4,13440.0,1,13445.0,4,B
2018-04-26 10:00:21,13445.0,2,15784,2,13440.0,3,13445.0,4,B
2018-04-26 10:00:23,13440.0,2,15786,0,13435.0,13,13440.0,2,S
2018-04-26 10:00:24,13440.0,4,15790,4,13435.0,13,13445.0,8,S
2018-04-26 10:00:34,13440.0,2,15792,-2,13435.0,11,13445.0,11,S
2018-04-26 10:00:36,13440.0,2,15794,0,13440.0,1,13445.0,8,S
2018-04-26 10:00:39,13440.0,2,15796,2,13440.0,3,13445.0,5,S
2018-04-26 10:00:41,13445.0,10,15806,-2,13440.0,6,13450.0,7,B
2018-04-26 10:00:43,13445.0,4,15810,4,13440.0,16,13450.0,11,B
2018-04-26 10:00:54,13440.0,2,15812,2,13440.0,17,13450.0,10,S
2018-04-26 10:00:55,13440.0,2,15814,2,13440.0,16,13450.0,10,S
2018-04-26 10:00:55,13440.0,2,15816,0,13440.0,15,13450.0,10,S
2018-04-26 10:00:56,13440.0,2,15818,0,13440.0,18,13450.0,7,S
2018-04-26 10:00:57,13440.0,2,15820,2,13440.0,18,13450.0,7,S
2018-04-26 10:01:03,13445.0,2,15822,-2,13440.0,15,13450.0,7,B
2018-04-26 10:01:21,13450.0,14,15836,6,13445.0,17,13455.0,4,B
2018-04-26 10:01:24,13455.0,2,15838,0,13450.0,9,13460.0,6,B
2018-04-26 10:01:26,13450.0,2,15840,0,13450.0,10,13460.0,9,S
2018-04-26 10:01:27,13455.0,2,15842,2,13450.0,10,13460.0,6,B
2018-04-26 10:01:33,13455.0,2,15844,2,13450.0,10,13460.0,5,B
2018-04-26 10:01:34,13460.0,2,15846,0,13455.0,1,13460.0,4,B
2018-04-26 10:01:34,13455.0,2,15848,0,13450.0,12,13460.0,4,S
2018-04-26 10:01:39,13455.0,2,15850,2,13450.0,12,13455.0,1,S
2018-04-26 10:01:42,13450.0,2,15852,0,13450.0,6,13455.0,16,S
2018-04-26 10:01:54,13450.0,4,15856,0,13450.0,7,13455.0,16,S
2018-04-26 10:01:54,13445.0,18,15874,-4,13445.0,4,13450.0,12,S
2018-04-26 10:01:57,13445.0,2,15876,-2,13440.0,14,13450.0,15,S
2018-04-26 10:02:01,13440.0,30,15906,22,13435.0,16,13440.0,1,S
2018-04-26 10:02:02,13440.0,28,15934,8,13435.0,10,13440.0,3,S
2018-04-26 10:02:03,13440.0,6,15940,6,13435.0,10,13445.0,17,S
2018-04-26 10:02:05,13440.0,6,15946,6,13435.0,13,13445.0,18,S
2018-04-26 10:02:09,13440.0,2,15948,0,13435.0,14,13445.0,8,S
2018-04-26 10:02:11,13435.0,2,15950,0,13435.0,12,13440.0,3,S
2018-04-26 10:02:12,13435.0,2,15952,0,13435.0,9,13440.0,5,S
2018-04-26 10:02:13,13435.0,2,15954,0,13435.0,8,13440.0,3,S
2018-04-26 10:02:14,13435.0,2,15956,0,13435.0,9,13440.0,3,S
2018-04-26 10:02:14,13435.0,2,15958,0,13435.0,8,13440.0,3,S
2018-04-26 10:02:19,13435.0,6,15964,0,13435.0,7,13440.0,1,S
2018-04-26 10:02:29,13440.0,4,15968,0,13435.0,9,13445.0,8,B
2018-04-26 10:02:31,13445.0,12,15980,-6,13440.0,14,13445.0,1,B
2018-04-26 10:02:31,13445.0,2,15982,2,13445.0,1,13450.0,5,B
2018-04-26 10:02:56,13445.0,2,15984,-2,13440.0,17,13445.0,3,B
2018-04-26 10:02:57,13445.0,4,15988,-2,13440.0,17,13445.0,1,B
2018-04-26 10:03:08,13440.0,14,16002,0,13440.0,10,13445.0,3,S
2018-04-26 10:03:21,13440.0,10,16012,0,13440.0,5,13445.0,18,S
2018-04-26 10:03:21,13440.0,10,16022,6,13435.0,12,13440.0,4,S
2018-04-26 10:03:28,13440.0,16,16038,16,13435.0,16,13440.0,2,S
2018-04-26 10:03:28,13440.0,4,16042,-2,13435.0,16,13445.0,8,S
2018-04-26 10:03:32,13445.0,2,16044,0,13435.0,16,13445.0,8,B
2018-04-26 10:03:48,13440.0,2,16046,2,13435.0,16,13445.0,8,S
2018-04-26 10:03:56,13440.0,2,16048,2,13435.0,17,13445.0,6,S
2018-04-26 10:03:58,13445.0,2,16050,-2,13440.0,15,13450.0,7,B
2018-04-26 10:04:07,13440.0,4,16054,-4,13440.0,3,13445.0,5,S
2018-04-26 10:04:13,13440.0,28,16082,16,13435.0,17,13450.0,7,S
2018-04-26 10:04:15,13450.0,10,16092,6,13440.0,9,13450.0,9,B
2018-04-26 10:04:40,13440.0,6,16098,-2,13435.0,16,13440.0,3,S
2018-04-26 10:04:41,13440.0,6,16104,-6,13435.0,12,13440.0,9,S
2018-04-26 10:04:45,13440.0,2,16106,-2,13435.0,12,13440.0,4,S
2018-04-26 10:04:53,13440.0,4,16110,-4,13440.0,1,13445.0,10,S
2018-04-26 10:04:56,13440.0,2,16112,0,13435.0,16,13445.0,9,S
2018-04-26 10:05:09,13435.0,24,16136,0,13430.0,3,13435.0,1,S
2018-04-26 10:05:16,13430.0,2,16138,2,13425.0,10,13430.0,4,S
2018-04-26 10:05:18,13430.0,10,16148,-2,13425.0,10,13430.0,9,S
2018-04-26 10:05:19,13430.0,2,16150,-2,13425.0,10,13430.0,8,S
2018-04-26 10:05:20,13430.0,10,16160,-4,13425.0,10,13435.0,24,S
2018-04-26 10:05:35,13435.0,4,16164,-2,13430.0,7,13440.0,9,B
2018-04-26 10:05:56,13435.0,2,16166,-2,13430.0,4,13435.0,2,B
2018-04-26 10:06:13,13430.0,14,16180,8,13425.0,12,13430.0,10,S
2018-04-26 10:06:13,13425.0,6,16186,6,13425.0,7,13430.0,11,S
2018-04-26 10:06:14,13425.0,14,16200,2,13420.0,10,13425.0,1,S
2018-04-26 10:06:14,13420.0,4,16204,0,13420.0,8,13425.0,17,S
2018-04-26 10:06:21,13420.0,6,16210,6,13420.0,6,13425.0,4,S
2018-04-26 10:06:24,13425.0,4,16214,0,13425.0,1,13430.0,7,B
2018-04-26 10:06:25,13430.0,4,16218,2,13430.0,4,13435.0,6,B
2018-04-26 10:06:26,13435.0,10,16228,6,13430.0,10,13440.0,4,B
2018-04-26 10:06:31,13440.0,4,16232,2,13430.0,8,13440.0,8,B
2018-04-26 10:06:35,13440.0,4,16236,0,13430.0,1,13435.0,3,B
2018-04-26 10:06:41,13440.0,2,16238,0,13425.0,11,13435.0,3,B
2018-04-26 10:06:45,13440.0,2,16240,2,13430.0,1,13435.0,4,B
2018-04-26 10:06:49,13430.0,2,16242,2,13425.0,11,13430.0,4,S
2018-04-26 10:06:50,13430.0,2,16244,2,13425.0,6,13430.0,4,S
2018-04-26 10:06:53,13430.0,6,16250,0,13425.0,14,13435.0,8,S
2018-04-26 10:06:59,13425.0,12,16262,-12,13425.0,6,13435.0,7,S
2018-04-26 10:07:08,13420.0,6,16268,0,13420.0,12,13430.0,9,S
2018-04-26 10:07:11,13425.0,2,16270,0,13425.0,3,13430.0,7,B
2018-04-26 10:07:12,13425.0,2,16272,2,13425.0,2,13430.0,7,B
2018-04-26 10:07:13,13430.0,2,16274,0,13425.0,2,13430.0,6,B
2018-04-26 10:07:20,13430.0,4,16278,0,13425.0,3,13430.0,5,B
2018-04-26 10:07:37,13425.0,2,16280,0,13420.0,8,13430.0,10,S
2018-04-26 10:07:44,13425.0,2,16282,2,13420.0,8,13425.0,7,S
2018-04-26 10:07:44,13425.0,2,16284,0,13420.0,4,13425.0,6,S
2018-04-26 10:07:46,13420.0,8,16292,8,13415.0,6,13420.0,15,S
2018-04-26 10:07:46,13415.0,12,16304,8,13410.0,10,13415.0,5,S
2018-04-26 10:07:49,13410.0,4,16308,0,13410.0,5,13415.0,11,S
2018-04-26 10:07:49,13410.0,8,16316,4,13410.0,2,13420.0,14,S
2018-04-26 10:07:50,13410.0,4,16320,0,13410.0,2,13415.0,13,S
2018-04-26 10:07:53,13410.0,4,16324,0,13405.0,7,13415.0,10,S
2018-04-26 10:07:54,13410.0,14,16338,4,13405.0,6,13410.0,1,S
2018-04-26 10:07:55,13405.0,12,16350,8,13400.0,87,13410.0,8,S
2018-04-26 10:07:55,13400.0,10,16360,0,13400.0,78,13405.0,8,S
2018-04-26 10:07:56,13400.0,58,16418,28,13400.0,62,13410.0,25,S
2018-04-26 10:07:56,13400.0,8,16426,8,13400.0,62,13410.0,10,S
2018-04-26 10:07:57,13410.0,2,16428,0,13400.0,58,13410.0,25,B
2018-04-26 10:07:58,13410.0,8,16436,-6,13405.0,5,13410.0,1,B
2018-04-26 10:08:05,13410.0,2,16438,0,13410.0,8,13415.0,10,B
2018-04-26 10:08:06,13410.0,2,16440,0,13410.0,6,13415.0,2,B
2018-04-26 10:08:07,13415.0,2,16442,0,13410.0,6,13415.0,2,B
2018-04-26 10:08:08,13415.0,4,16446,0,13410.0,6,13420.0,5,B
2018-04-26 10:08:09,13415.0,2,16448,2,13410.0,9,13420.0,4,B
2018-04-26 10:08:11,13410.0,6,16454,-4,13410.0,1,13415.0,4,S
2018-04-26 10:08:14,13405.0,6,16460,4,13400.0,60,13405.0,19,S
2018-04-26 10:08:14,13400.0,18,16478,16,13400.0,49,13405.0,18,S
2018-04-26 10:08:15,13400.0,48,16526,28,13400.0,25,13405.0,27,S
2018-04-26 10:08:15,13400.0,50,16576,42,13395.0,11,13400.0,9,S
2018-04-26 10:08:16,13400.0,26,16602,8,13395.0,7,13400.0,3,S
2018-04-26 10:08:16,13400.0,6,16608,-6,13395.0,7,13405.0,6,S
2018-04-26 10:08:17,13405.0,4,16612,0,13400.0,3,13405.0,2,B
2018-04-26 10:08:20,13400.0,20,16632,8,13395.0,15,13400.0,2,S
2018-04-26 10:08:20,13405.0,8,16640,-2,13400.0,2,13405.0,2,B
2018-04-26 10:08:21,13400.0,10,16650,-4,13395.0,7,13405.0,10,S
2018-04-26 10:08:23,13395.0,8,16658,4,13395.0,2,13400.0,7,S
2018-04-26 10:08:24,13395.0,12,16670,0,13390.0,5,13395.0,9,S
2018-04-26 10:08:25,13395.0,2,16672,0,13385.0,7,13395.0,18,S
2018-04-26 10:08:26,13380.0,18,16690,0,13380.0,7,13385.0,9,S
2018-04-26 10:08:26,13380.0,38,16728,-4,13375.0,1,13380.0,33,S
2018-04-26 10:08:27,13385.0,74,16802,-34,13380.0,1,13385.0,1,B
2018-04-26 10:08:27,13390.0,10,16812,2,13390.0,1,13395.0,27,B
2018-04-26 10:08:28,13395.0,48,16860,-14,13395.0,7,13400.0,7,B
2018-04-26 10:08:28,13390.0,10,16870,0,13390.0,12,13400.0,8,S
2018-04-26 10:08:30,13390.0,6,16876,0,13385.0,8,13390.0,12,S
2018-04-26 10:08:30,13390.0,10,16886,-2,13385.0,8,13390.0,8,S
2018-04-26 10:08:32,13385.0,2,16888,0,13385.0,4,13390.0,17,S
2018-04-26 10:08:35,13385.0,4,16892,0,13380.0,20,13385.0,2,S
2018-04-26 10:08:35,13385.0,12,16904,-6,13385.0,5,13390.0,15,S
2018-04-26 10:08:36,13390.0,2,16906,-2,13385.0,9,13390.0,14,B
2018-04-26 10:08:36,13390.0,2,16908,-2,13385.0,7,13390.0,13,B
2018-04-26 10:08:37,13385.0,2,16910,-2,13385.0,11,13390.0,13,S
2018-04-26 10:08:38,13390.0,24,16934,-10,13385.0,1,13390.0,7,B
2018-04-26 10:08:38,13385.0,2,16936,0,13380.0,12,13390.0,9,S
2018-04-26 10:08:40,13385.0,2,16938,0,13380.0,19,13390.0,7,S
2018-04-26 10:08:42,13390.0,10,16948,-8,13385.0,17,13395.0,8,B
2018-04-26 10:08:43,13395.0,2,16950,0,13390.0,1,13395.0,7,B
2018-04-26 10:08:44,13390.0,2,16952,-2,13385.0,8,13395.0,11,S
2018-04-26 10:08:45,13390.0,20,16972,-2,13390.0,2,13400.0,9,S
2018-04-26 10:08:45,13400.0,16,16988,-2,13400.0,1,13405.0,13,B
2018-04-26 10:08:46,13405.0,18,17006,-2,13400.0,16,13410.0,2,B
2018-04-26 10:08:48,13405.0,10,17016,2,13405.0,10,13415.0,3,B
2018-04-26 10:08:48,13415.0,4,17020,-2,13410.0,3,13415.0,3,B
2018-04-26 10:08:49,13410.0,2,17022,0,13405.0,14,13415.0,1,S
2018-04-26 10:08:49,13410.0,6,17028,4,13410.0,2,13415.0,3,S
2018-04-26 10:08:56,13405.0,6,17034,2,13400.0,16,13410.0,12,S
2018-04-26 10:08:59,13410.0,2,17036,0,13400.0,16,13410.0,17,B
2018-04-26 10:09:03,13400.0,4,17040,-2,13400.0,8,13405.0,3,S
2018-04-26 10:09:08,13405.0,6,17046,-6,13405.0,1,13410.0,12,B
2018-04-26 10:09:09,13405.0,2,17048,-2,13405.0,2,13410.0,10,B
2018-04-26 10:09:10,13400.0,2,17050,-2,13400.0,12,13410.0,11,S
2018-04-26 10:09:11,13405.0,2,17052,-2,13400.0,17,13405.0,3,B
2018-04-26 10:09:12,13405.0,4,17056,0,13400.0,17,13405.0,1,B
2018-04-26 10:09:14,13405.0,16,17072,-4,13400.0,19,13410.0,11,B
2018-04-26 10:09:15,13410.0,8,17080,-6,13400.0,22,13410.0,4,B
2018-04-26 10:09:17,13410.0,8,17088,6,13410.0,3,13415.0,7,B
2018-04-26 10:09:18,13410.0,14,17102,-4,13410.0,14,13420.0,3,B
2018-04-26 10:09:21,13415.0,18,17120,-6,13410.0,16,13420.0,6,B
2018-04-26 10:09:25,13415.0,4,17124,-4,13410.0,9,13420.0,8,B
2018-04-26 10:09:27,13415.0,2,17126,0,13415.0,3,13420.0,9,B
2018-04-26 10:09:30,13420.0,2,17128,2,13415.0,11,13420.0,2,B
2018-04-26 10:09:32,13420.0,2,17130,2,13415.0,12,13420.0,2,B
2018-04-26 10:09:33,13420.0,4,17134,-2,13415.0,13,13425.0,7,B
2018-04-26 10:09:34,13425.0,4,17138,0,13420.0,2,13425.0,2,B
2018-04-26 10:09:35,13415.0,2,17140,-2,13415.0,9,13425.0,7,S
2018-04-26 10:09:43,13415.0,6,17146,-2,13415.0,6,13420.0,21,S
2018-04-26 10:09:43,13415.0,8,17154,6,13415.0,2,13420.0,20,S
2018-04-26 10:09:45,13415.0,2,17156,0,13415.0,1,13420.0,20,S
2018-04-26 10:09:45,13415.0,14,17170,12,13415.0,4,13420.0,20,S
2018-04-26 10:09:46,13415.0,8,17178,2,13410.0,10,13420.0,21,S
2018-04-26 10:09:46,13415.0,2,17180,-2,13410.0,6,13415.0,10,S
2018-04-26 10:09:49,13410.0,8,17188,-8,13405.0,8,13415.0,21,S
2018-04-26 10:09:50,13410.0,2,17190,0,13405.0,6,13415.0,22,S
2018-04-26 10:09:55,13405.0,2,17192,-2,13405.0,10,13415.0,23,S
2018-04-26 10:09:59,13410.0,6,17198,-4,13410.0,2,13415.0,23,B
2018-04-26 10:09:59,13410.0,4,17202,-4,13405.0,6,13415.0,24,B
2018-04-26 10:10:01,13410.0,4,17206,0,13405.0,9,13415.0,12,B
2018-04-26 10:10:04,13405.0,6,17212,2,13405.0,3,13415.0,15,S
2018-04-26 10:10:05,13400.0,16,17228,-4,13400.0,1,13405.0,16,S
2018-04-26 10:10:06,13400.0,2,17230,0,13395.0,6,13405.0,11,S
2018-04-26 10:10:11,13400.0,2,17232,0,13395.0,4,13400.0,2,S
2018-04-26 10:10:12,13390.0,6,17238,-2,13390.0,6,13395.0,2,S
2018-04-26 10:10:13,13400.0,14,17252,-6,13390.0,10,13400.0,1,B
2018-04-26 10:10:13,13390.0,2,17254,-2,13395.0,2,13400.0,6,S
2018-04-26 10:10:14,13395.0,4,17258,-4,13390.0,5,13395.0,14,B
2018-04-26 10:10:14,13395.0,4,17262,0,13390.0,7,13395.0,7,B
2018-04-26 10:10:15,13395.0,14,17276,0,13390.0,12,13400.0,10,B
2018-04-26 10:10:17,13395.0,10,17286,2,13395.0,15,13405.0,10,B
2018-04-26 10:10:18,13395.0,2,17288,0,13395.0,15,13405.0,11,B
2018-04-26 10:10:19,13395.0,6,17294,4,13395.0,3,13405.0,11,B
2018-04-26 10:10:19,13400.0,8,17302,-6,13400.0,2,13405.0,11,B
2018-04-26 10:10:20,13400.0,4,17306,-2,13395.0,3,13400.0,12,B
2018-04-26 10:10:21,13395.0,2,17308,-2,13395.0,8,13405.0,11,S
2018-04-26 10:10:22,13395.0,16,17324,12,13395.0,17,13400.0,3,S
2018-04-26 10:10:22,13400.0,6,17330,6,13400.0,9,13405.0,10,B
2018-04-26 10:10:24,13400.0,2,17332,-2,13400.0,10,13405.0,8,B
2018-04-26 10:10:26,13400.0,4,17336,-4,13400.0,6,13405.0,8,B
2018-04-26 10:10:28,13400.0,10,17346,-2,13400.0,1,13405.0,8,B
2018-04-26 10:10:29,13400.0,4,17350,-2,13395.0,10,13400.0,14,B
2018-04-26 10:10:29,13400.0,22,17372,-4,13400.0,6,13405.0,11,B
2018-04-26 10:10:30,13405.0,22,17394,18,13400.0,22,13410.0,6,B
2018-04-26 10:10:30,13410.0,8,17402,4,13410.0,1,13415.0,4,B
2018-04-26 10:10:31,13410.0,8,17410,-4,13405.0,7,13415.0,5,B
2018-04-26 10:10:31,13410.0,2,17412,0,13405.0,13,13415.0,5,B
2018-04-26 10:10:43,13405.0,20,17432,4,13405.0,2,13410.0,12,S
2018-04-26 10:10:45,13410.0,2,17434,0,13405.0,12,13415.0,7,B
2018-04-26 10:10:48,13405.0,14,17448,0,13400.0,21,13405.0,8,S
2018-04-26 10:10:50,13405.0,4,17452,4,13400.0,10,13405.0,7,S
2018-04-26 10:10:56,13405.0,2,17454,2,13400.0,12,13405.0,6,S
2018-04-26 10:11:01,13405.0,4,17458,4,13400.0,26,13405.0,5,S
2018-04-26 10:11:06,13400.0,2,17460,0,13400.0,24,13405.0,7,S
2018-04-26 10:11:08,13400.0,30,17490,-12,13400.0,9,13405.0,9,S
2018-04-26 10:11:09,13400.0,18,17508,-18,13395.0,4,13400.0,2,S
2018-04-26 10:11:12,13395.0,2,17510,-2,13390.0,7,13395.0,4,S
2018-04-26 10:11:13,13390.0,14,17524,2,13385.0,5,13390.0,1,S
2018-04-26 10:11:13,13385.0,10,17534,2,13380.0,10,13385.0,3,S
2018-04-26 10:11:14,13380.0,34,17568,10,13375.0,1,13385.0,3,S
2018-04-26 10:11:14,13400.0,70,17638,-10,13385.0,3,13395.0,2,B
2018-04-26 10:11:15,13395.0,4,17642,4,13390.0,3,13395.0,1,S
2018-04-26 10:11:16,13390.0,6,17648,-6,13385.0,11,13395.0,8,S
2018-04-26 10:11:17,13390.0,4,17652,0,13385.0,6,13390.0,2,S
2018-04-26 10:11:19,13390.0,2,17654,-2,13390.0,1,13395.0,4,S
2018-04-26 10:11:23,13390.0,6,17660,2,13390.0,4,13395.0,2,S
2018-04-26 10:11:24,13390.0,12,17672,4,13385.0,9,13395.0,4,S
2018-04-26 10:11:24,13385.0,2,17674,-2,13390.0,2,13395.0,14,S
2018-04-26 10:11:25,13390.0,4,17678,4,13385.0,8,13395.0,18,B
2018-04-26 10:11:26,13395.0,2,17680,0,13390.0,31,13395.0,7,B
2018-04-26 10:11:30,13390.0,4,17684,2,13390.0,30,13400.0,11,S
2018-04-26 10:11:34,13390.0,2,17686,2,13390.0,31,13400.0,14,S
2018-04-26 10:11:40,13390.0,6,17692,-6,13390.0,28,13395.0,11,S
2018-04-26 10:11:43,13395.0,16,17708,-4,13395.0,3,13400.0,10,B
2018-04-26 10:11:45,13395.0,2,17710,0,13395.0,2,13400.0,9,B
2018-04-26 10:11:55,13395.0,2,17712,0,13395.0,8,13400.0,4,B
2018-04-26 10:11:57,13400.0,2,17714,0,13395.0,4,13400.0,6,B
2018-04-26 10:12:00,13395.0,2,17716,2,13390.0,33,13395.0,4,S
2018-04-26 10:12:03,13395.0,8,17724,0,13395.0,3,13400.0,11,S
2018-04-26 10:12:04,13395.0,14,17738,10,13390.0,30,13400.0,11,S
2018-04-26 10:12:05,13395.0,4,17742,0,13390.0,30,13400.0,14,S
2018-04-26 10:12:09,13400.0,12,17754,-6,13400.0,44,13405.0,7,B
2018-04-26 10:12:09,13400.0,2,17756,-2,13400.0,43,13405.0,7,B
2018-04-26 10:12:11,13400.0,30,17786,-30,13400.0,28,13405.0,4,B
2018-04-26 10:12:12,13405.0,2,17788,2,13400.0,28,13405.0,3,B
2018-04-26 10:12:14,13400.0,30,17818,-10,13400.0,13,13405.0,16,S
2018-04-26 10:12:16,13400.0,4,17822,-4,13400.0,11,13405.0,13,S
2018-04-26 10:12:24,13405.0,10,17832,4,13405.0,1,13410.0,24,B
2018-04-26 10:12:25,13410.0,6,17838,6,13405.0,14,13415.0,10,B
2018-04-26 10:12:26,13410.0,2,17840,0,13405.0,14,13410.0,1,B
2018-04-26 10:12:26,13410.0,2,17842,0,13405.0,17,13415.0,25,B
2018-04-26 10:12:28,13405.0,4,17846,2,13405.0,17,13415.0,26,S
2018-04-26 10:12:37,13410.0,2,17848,-2,13410.0,1,13415.0,14,B
2018-04-26 10:12:38,13410.0,2,17850,0,13405.0,11,13415.0,20,B
2018-04-26 10:12:42,13410.0,4,17854,0,13405.0,11,13415.0,27,B
2018-04-26 10:12:55,13410.0,6,17860,-4,13405.0,13,13415.0,26,B
2018-04-26 10:13:03,13415.0,12,17872,-6,13415.0,3,13420.0,21,B
2018-04-26 10:13:03,13415.0,6,17878,-6,13410.0,6,13415.0,2,B
2018-04-26 10:13:07,13410.0,6,17884,-6,13410.0,1,13415.0,12,S
2018-04-26 10:13:08,13410.0,2,17886,-2,13405.0,8,13415.0,13,S
2018-04-26 10:13:12,13410.0,6,17892,-6,13405.0,10,13410.0,7,S
2018-04-26 10:13:31,13405.0,2,17894,0,13405.0,4,13410.0,13,S
2018-04-26 10:13:32,13405.0,6,17900,-4,13400.0,21,13405.0,6,S
2018-04-26 10:13:46,13405.0,2,17902,0,13400.0,35,13405.0,1,S
2018-04-26 10:13:47,13405.0,2,17904,2,13405.0,2,13410.0,16,S
2018-04-26 10:13:50,13405.0,8,17912,2,13400.0,20,13405.0,11,S
2018-04-26 10:13:57,13405.0,2,17914,0,13400.0,16,13405.0,13,S
2018-04-26 10:13:59,13405.0,2,17916,0,13400.0,17,13405.0,13,S
2018-04-26 10:14:01,13405.0,4,17920,-4,13400.0,17,13405.0,16,S
2018-04-26 10:14:02,13400.0,2,17922,-2,13400.0,16,13405.0,24,S
2018-04-26 10:14:03,13400.0,12,17934,-12,13400.0,10,13405.0,27,S
2018-04-26 10:14:03,13400.0,20,17954,2,13395.0,10,13405.0,27,S
2018-04-26 10:14:10,13395.0,6,17960,0,13390.0,31,13395.0,9,S
2018-04-26 10:14:14,13395.0,12,17972,-2,13390.0,29,13400.0,14,S
2018-04-26 10:14:28,13395.0,2,17974,-2,13390.0,30,13395.0,6,S
2018-04-26 10:14:29,13395.0,4,17978,4,13390.0,31,13395.0,4,S
2018-04-26 10:14:29,13395.0,8,17986,0,13390.0,31,13395.0,4,S
2018-04-26 10:14:30,13390.0,8,17994,-6,13390.0,28,13395.0,3,S
2018-04-26 10:14:30,13395.0,6,18000,2,13390.0,28,13400.0,14,B
2018-04-26 10:14:31,13400.0,38,18038,26,13400.0,11,13405.0,12,B
2018-04-26 10:14:32,13405.0,2,18040,0,13400.0,12,13405.0,7,B
2018-04-26 10:14:33,13405.0,14,18054,-14,13400.0,13,13410.0,8,B
2018-04-26 10:14:38,13400.0,20,18074,-10,13400.0,16,13410.0,4,S
2018-04-26 10:14:40,13400.0,20,18094,-12,13405.0,1,13410.0,6,S
2018-04-26 10:14:41,13405.0,2,18096,0,13400.0,16,13410.0,7,B
2018-04-26 10:14:44,13405.0,2,18098,0,13400.0,3,13410.0,9,B
2018-04-26 10:14:48,13405.0,6,18104,0,13400.0,10,13405.0,5,B
2018-04-26 10:14:48,13405.0,2,18106,0,13400.0,5,13405.0,10,B
2018-04-26 10:14:52,13405.0,6,18112,-6,13400.0,2,13405.0,5,B
2018-04-26 10:14:54,13405.0,6,18118,4,13400.0,2,13405.0,3,B
2018-04-26 10:30:00,13400.0,10,18128,4,13395.0,11,13400.0,9,S
2018-04-26 10:30:01,13400.0,4,18132,2,13395.0,10,13400.0,7,S
2018-04-26 10:30:04,13395.0,10,18142,-10,13390.0,51,13395.0,2,S
2018-04-26 10:30:06,13390.0,74,18216,-16,13390.0,11,13395.0,9,S
2018-04-26 10:30:06,13385.0,28,18244,2,13385.0,3,13390.0,7,S
2018-04-26 10:30:07,13380.0,16,18260,-4,13380.0,7,13385.0,23,S
2018-04-26 10:30:07,13380.0,14,18274,0,13370.0,11,13380.0,2,S
2018-04-26 10:30:08,13370.0,4,18278,0,13370.0,11,13380.0,6,S
2018-04-26 10:30:08,13380.0,16,18294,-6,13375.0,2,13380.0,1,B
2018-04-26 10:30:09,13375.0,4,18298,0,13370.0,8,13375.0,2,S
2018-04-26 10:30:10,13375.0,56,18354,12,13370.0,8,13375.0,2,S
2018-04-26 10:30:10,13375.0,4,18358,0,13375.0,8,13385.0,63,S
2018-04-26 10:30:11,13375.0,16,18374,6,13370.0,12,13375.0,1,S
2018-04-26 10:30:12,13370.0,2,18376,0,13370.0,9,13375.0,6,S
2018-04-26 10:30:12,13370.0,16,18392,-2,13365.0,51,13370.0,3,S
2018-04-26 10:30:13,13370.0,8,18400,0,13365.0,52,13375.0,7,S
2018-04-26 10:30:15,13370.0,4,18404,0,13370.0,1,13375.0,4,S
2018-04-26 10:30:15,13370.0,4,18408,-2,13365.0,54,13375.0,4,S
2018-04-26 10:30:21,13380.0,6,18414,0,13375.0,4,13380.0,6,B
2018-04-26 10:30:23,13375.0,2,18416,0,13370.0,12,13380.0,8,S
2018-04-26 10:30:27,13375.0,12,18428,-10,13370.0,12,13380.0,6,S
2018-04-26 10:30:30,13370.0,24,18452,-16,13365.0,54,13370.0,14,S
2018-04-26 10:30:30,13370.0,28,18480,0,13370.0,6,13375.0,1,S
2018-04-26 10:30:32,13375.0,2,18482,0,13375.0,2,13380.0,11,B
2018-04-26 10:30:33,13380.0,2,18484,2,13375.0,3,13380.0,8,B
2018-04-26 10:30:35,13380.0,12,18496,0,13375.0,3,13385.0,7,B
2018-04-26 10:30:42,13385.0,2,18498,0,13380.0,1,13385.0,3,B
2018-04-26 10:30:46,13380.0,2,18500,0,13380.0,5,13385.0,1,S
2018-04-26 10:30:46,13385.0,2,18502,2,13380.0,5,13390.0,7,B
2018-04-26 10:30:49,13390.0,12,18514,6,13385.0,7,13395.0,7,B
2018-04-26 10:30:55,13385.0,14,18528,4,13380.0,11,13390.0,6,S
2018-04-26 10:30:58,13385.0,4,18532,-2,13385.0,6,13390.0,3,S
2018-04-26 10:31:01,13385.0,2,18534,-2,13380.0,11,13390.0,8,S
2018-04-26 10:31:03,13380.0,4,18538,-4,13380.0,15,13390.0,3,S
2018-04-26 10:31:07,13385.0,2,18540,0,13380.0,6,13385.0,4,B
2018-04-26 10:31:08,13385.0,2,18542,-2,13380.0,4,13385.0,3,B
2018-04-26 10:31:08,13385.0,2,18544,2,13380.0,4,13385.0,2,B
2018-04-26 10:31:09,13380.0,2,18546,2,13380.0,3,13385.0,1,S
2018-04-26 10:31:09,13380.0,8,18554,2,13380.0,2,13385.0,2,S
2018-04-26 10:31:10,13375.0,14,18568,-10,13375.0,3,13380.0,54,S
2018-04-26 10:31:15,13380.0,10,18578,4,13375.0,14,13385.0,9,B
2018-04-26 10:31:22,13375.0,8,18586,-2,13375.0,8,13380.0,4,S
2018-04-26 10:31:26,13380.0,6,18592,2,13375.0,12,13385.0,9,B
2018-04-26 10:31:27,13380.0,14,18606,-2,13380.0,10,13390.0,10,B
2018-04-26 10:31:32,13385.0,2,18608,-2,13380.0,17,13385.0,2,B
2018-04-26 10:31:34,13385.0,4,18612,-4,13380.0,17,13390.0,10,B
2018-04-26 10:31:38,13390.0,2,18614,-2,13385.0,8,13390.0,3,B
2018-04-26 10:31:39,13390.0,8,18622,0,13385.0,8,13390.0,2,B
2018-04-26 10:31:39,13390.0,4,18626,0,13385.0,8,13395.0,7,B
2018-04-26 10:31:43,13390.0,2,18628,2,13385.0,9,13395.0,8,B
2018-04-26 10:31:52,13390.0,2,18630,0,13385.0,14,13390.0,19,B
2018-04-26 10:31:54,13390.0,4,18634,4,13385.0,15,13390.0,27,B
2018-04-26 10:31:55,13390.0,12,18646,4,13385.0,18,13390.0,21,B
2018-04-26 10:31:55,13390.0,12,18658,0,13385.0,18,13390.0,15,B
2018-04-26 10:31:56,13390.0,30,18688,10,13385.0,18,13395.0,6,B
2018-04-26 10:31:57,13390.0,2,18690,-2,13390.0,4,13395.0,6,B
2018-04-26 10:32:00,13390.0,8,18698,8,13385.0,17,13395.0,5,B
2018-04-26 10:32:03,13385.0,2,18700,-2,13385.0,6,13390.0,6,S
2018-04-26 10:32:05,13390.0,10,18710,0,13390.0,4,13395.0,5,B
2018-04-26 10:32:05,13390.0,2,18712,0,13390.0,3,13395.0,5,B
2018-04-26 10:32:06,13390.0,6,18718,6,13385.0,7,13395.0,5,B
2018-04-26 10:32:07,13390.0,2,18720,0,13385.0,10,13395.0,5,B
2018-04-26 10:32:08,13390.0,2,18722,-2,13385.0,7,13390.0,4,B
2018-04-26 10:32:08,13385.0,8,18730,-2,13380.0,11,13385.0,1,S
2018-04-26 10:32:10,13380.0,2,18732,2,13380.0,3,13385.0,6,S
2018-04-26 10:32:11,13380.0,4,18736,0,13375.0,7,13385.0,7,S
2018-04-26 10:32:12,13380.0,2,18738,-2,13375.0,11,13380.0,1,S
2018-04-26 10:32:12,13380.0,2,18740,-2,13380.0,5,13385.0,1,S
2018-04-26 10:32:20,13380.0,2,18742,-2,13380.0,11,13385.0,3,S
2018-04-26 10:32:33,13385.0,6,18748,-4,13380.0,17,13390.0,16,B
2018-04-26 10:32:40,13385.0,10,18758,10,13385.0,2,13390.0,6,B
2018-04-26 10:32:41,13390.0,8,18766,2,13385.0,20,13390.0,2,B
2018-04-26 10:32:41,13390.0,4,18770,4,13385.0,20,13395.0,6,B
2018-04-26 10:32:51,13395.0,2,18772,2,13390.0,2,13395.0,7,B
2018-04-26 10:32:53,13395.0,2,18774,0,13390.0,12,13395.0,2,B
2018-04-26 10:32:54,13400.0,4,18778,4,13390.0,12,13400.0,11,B
2018-04-26 10:32:55,13395.0,2,18780,0,13390.0,12,13400.0,12,S
2018-04-26 10:32:57,13400.0,2,18782,2,13390.0,13,13400.0,11,B
2018-04-26 10:32:58,13400.0,2,18784,0,13390.0,4,13395.0,3,B
2018-04-26 10:33:00,13395.0,2,18786,0,13390.0,3,13395.0,5,S
2018-04-26 10:33:05,13395.0,4,18790,-4,13390.0,2,13395.0,6,S
2018-04-26 10:33:07,13390.0,4,18794,-2,13385.0,15,13390.0,8,S
2018-04-26 10:33:08,13390.0,2,18796,0,13385.0,18,13390.0,7,S
2018-04-26 10:33:09,13385.0,6,18802,2,13385.0,16,13390.0,6,S
2018-04-26 10:33:10,13390.0,6,18808,-6,13385.0,18,13390.0,3,B
2018-04-26 10:33:13,13390.0,2,18810,-2,13385.0,4,13390.0,7,B
2018-04-26 10:33:23,13390.0,6,18816,-2,13390.0,1,13395.0,6,B
2018-04-26 10:33:24,13395.0,2,18818,0,13390.0,22,13400.0,15,B
2018-04-26 10:33:29,13400.0,2,18820,2,13395.0,5,13400.0,14,B
2018-04-26 10:33:31,13395.0,8,18828,-2,13395.0,1,13400.0,14,S
2018-04-26 10:33:33,13395.0,6,18834,-4,13395.0,1,13400.0,15,S
2018-04-26 10:33:52,13400.0,2,18836,2,13395.0,15,13400.0,8,B
2018-04-26 10:33:53,13400.0,2,18838,0,13395.0,16,13400.0,7,B
2018-04-26 10:33:54,13400.0,6,18844,4,13395.0,16,13400.0,4,B
2018-04-26 10:33:55,13400.0,4,18848,0,13395.0,15,13400.0,3,B
2018-04-26 10:34:04,13400.0,2,18850,2,13395.0,3,13400.0,9,B
2018-04-26 10:34:07,13395.0,4,18854,0,13390.0,14,13395.0,2,S
2018-04-26 10:34:07,13400.0,20,18874,6,13390.0,12,13400.0,6,B
2018-04-26 10:34:10,13395.0,4,18878,0,13390.0,7,13395.0,2,S
2018-04-26 10:34:31,13395.0,2,18880,0,13390.0,13,13395.0,12,S
2018-04-26 10:34:42,13395.0,2,18882,-2,13390.0,14,13395.0,11,S
2018-04-26 10:34:44,13395.0,4,18886,0,13390.0,17,13395.0,6,S
2018-04-26 10:34:46,13395.0,12,18898,0,13390.0,20,13400.0,7,S
2018-04-26 10:34:50,13405.0,12,18910,0,13400.0,11,13405.0,9,B
2018-04-26 10:34:59,13400.0,2,18912,-2,13400.0,2,13405.0,6,S
2018-04-26 10:35:00,13400.0,4,18916,-4,13395.0,8,13400.0,8,S
2018-04-26 10:35:08,13405.0,2,18918,0,13400.0,2,13405.0,5,B
2018-04-26 10:35:10,13405.0,2,18920,-2,13400.0,2,13405.0,4,B
2018-04-26 10:35:14,13400.0,2,18922,2,13400.0,3,13405.0,5,S
2018-04-26 10:35:15,13405.0,10,18932,-6,13400.0,10,13410.0,12,B
2018-04-26 10:35:18,13410.0,20,18952,0,13405.0,15,13415.0,7,B
2018-04-26 10:35:21,13415.0,2,18954,0,13410.0,1,13415.0,5,B
2018-04-26 10:35:26,13415.0,2,18956,-2,13410.0,2,13415.0,4,B
2018-04-26 10:35:38,13415.0,4,18960,-4,13410.0,8,13415.0,2,B
2018-04-26 10:35:39,13415.0,4,18964,-4,13410.0,8,13420.0,11,B
2018-04-26 10:35:42,13415.0,2,18966,2,13410.0,3,13415.0,5,B
2018-04-26 10:35:47,13415.0,2,18968,0,13410.0,13,13420.0,9,B
2018-04-26 10:35:56,13415.0,2,18970,-2,13410.0,13,13420.0,14,B
2018-04-26 10:36:04,13415.0,2,18972,0,13410.0,6,13415.0,7,B
2018-04-26 10:36:12,13410.0,4,18976,-2,13405.0,11,13415.0,7,S
2018-04-26 10:36:13,13415.0,2,18978,0,13405.0,16,13415.0,6,B
2018-04-26 10:36:15,13415.0,6,18984,4,13410.0,1,13415.0,3,B
2018-04-26 10:36:22,13415.0,2,18986,2,13410.0,9,13420.0,20,B
2018-04-26 10:36:26,13415.0,2,18988,-2,13410.0,13,13415.0,1,B
2018-04-26 10:36:27,13420.0,64,19052,34,13420.0,13,13425.0,20,B
2018-04-26 10:36:27,13415.0,32,19084,14,13410.0,5,13420.0,53,S
2018-04-26 10:36:28,13405.0,26,19110,-12,13405.0,8,13415.0,8,S
2018-04-26 10:36:30,13415.0,4,19114,-2,13410.0,4,13415.0,6,B
2018-04-26 10:36:52,13410.0,2,19116,0,13410.0,4,13415.0,6,S
2018-04-26 10:36:53,13410.0,8,19124,8,13405.0,15,13415.0,6,S
2018-04-26 10:36:56,13410.0,2,19126,-2,13410.0,2,13415.0,6,S
2018-04-26 10:38:02,13415.0,2,19128,0,13410.0,11,13415.0,6,B
2018-04-26 10:38:04,13415.0,10,19138,-2,13410.0,14,13415.0,1,B
2018-04-26 10:38:05,13410.0,10,19148,2,13410.0,9,13415.0,1,S
2018-04-26 10:38:08,13415.0,2,19150,2,13410.0,9,13420.0,9,B
2018-04-26 10:38:09,13420.0,20,19170,6,13420.0,40,13425.0,8,B
2018-04-26 10:38:09,13420.0,8,19178,4,13420.0,36,13425.0,8,B
2018-04-26 10:38:10,13420.0,72,19250,52,13420.0,2,13425.0,8,B
2018-04-26 10:38:10,13420.0,4,19254,0,13415.0,5,13420.0,4,B
2018-04-26 10:38:14,13415.0,4,19258,0,13415.0,1,13420.0,5,S
2018-04-26 10:38:19,13420.0,16,19274,-2,13410.0,4,13415.0,5,B
2018-04-26 10:38:46,13410.0,4,19278,2,13410.0,15,13415.0,8,S
2018-04-26 10:38:49,13415.0,2,19280,0,13410.0,15,13415.0,9,B
2018-04-26 10:38:55,13410.0,24,19304,12,13410.0,3,13415.0,10,S
2018-04-26 10:38:56,13410.0,6,19310,4,13405.0,12,13415.0,10,S
2018-04-26 10:38:59,13405.0,24,19334,8,13400.0,17,13405.0,79,S
2018-04-26 10:38:59,13405.0,12,19346,4,13400.0,19,13405.0,73,S
2018-04-26 10:39:00,13405.0,6,19352,0,13400.0,20,13405.0,72,S
2018-04-26 10:39:08,13400.0,8,19360,8,13400.0,20,13405.0,72,S
2018-04-26 10:39:12,13400.0,2,19362,0,13400.0,19,13405.0,72,S
2018-04-26 10:39:15,13400.0,20,19382,20,13400.0,9,13405.0,72,S
2018-04-26 10:39:20,13405.0,8,19390,4,13400.0,10,13405.0,68,B
2018-04-26 10:39:29,13405.0,2,19392,0,13400.0,31,13405.0,67,B
2018-04-26 10:39:29,13405.0,2,19394,0,13400.0,31,13405.0,66,B
2018-04-26 10:39:32,13400.0,20,19414,2,13400.0,26,13405.0,61,S
2018-04-26 10:39:36,13400.0,54,19468,38,13395.0,20,13400.0,32,S
2018-04-26 10:39:36,13405.0,72,19540,2,13400.0,4,13410.0,6,B
2018-04-26 10:39:37,13410.0,6,19546,2,13400.0,2,13410.0,7,B
2018-04-26 10:39:42,13410.0,4,19550,-4,13405.0,10,13410.0,2,B
2018-04-26 10:39:43,13410.0,2,19552,0,13405.0,10,13410.0,1,B
2018-04-26 10:39:50,13410.0,2,19554,0,13405.0,8,13415.0,8,B
2018-04-26 10:39:51,13415.0,4,19558,-4,13410.0,1,13415.0,6,B
2018-04-26 10:40:01,13415.0,4,19562,-2,13410.0,7,13420.0,9,B
2018-04-26 10:40:11,13415.0,2,19564,0,13410.0,7,13420.0,10,B
2018-04-26 10:40:25,13415.0,6,19570,0,13410.0,6,13415.0,9,B
2018-04-26 10:40:25,13410.0,6,19576,2,13410.0,3,13415.0,9,S
2018-04-26 10:40:29,13410.0,4,19580,-4,13410.0,4,13415.0,8,S
2018-04-26 10:40:29,13415.0,8,19588,2,13410.0,9,13415.0,4,B
2018-04-26 10:40:30,13415.0,4,19592,4,13410.0,9,13415.0,2,B
2018-04-26 10:40:30,13415.0,4,19596,2,13410.0,10,13420.0,16,B
2018-04-26 10:40:37,13420.0,2,19598,-2,13415.0,9,13420.0,9,B
2018-04-26 10:40:39,13420.0,4,19602,-2,13415.0,6,13420.0,7,B
2018-04-26 10:40:39,13420.0,12,19614,12,13415.0,6,13420.0,1,B
2018-04-26 10:40:44,13420.0,2,19616,2,13415.0,9,13425.0,11,B
2018-04-26 10:40:45,13415.0,6,19622,4,13415.0,7,13425.0,12,S
2018-04-26 10:40:57,13420.0,10,19632,0,13415.0,6,13420.0,9,B
2018-04-26 10:41:02,13420.0,2,19634,0,13420.0,42,13425.0,14,B
2018-04-26 10:41:04,13425.0,20,19654,4,13420.0,42,13430.0,7,B
2018-04-26 10:41:04,13425.0,2,19656,-2,13420.0,42,13430.0,8,B
2018-04-26 10:41:05,13425.0,4,19660,-4,13420.0,42,13430.0,10,B
2018-04-26 10:41:06,13425.0,2,19662,-2,13420.0,42,13425.0,1,B
2018-04-26 10:41:07,13425.0,2,19664,0,13420.0,42,13430.0,10,B
2018-04-26 10:41:09,13430.0,2,19666,0,13420.0,42,13430.0,9,B
2018-04-26 10:41:11,13425.0,2,19668,-2,13425.0,8,13430.0,7,S
2018-04-26 10:41:12,13425.0,10,19678,4,13425.0,7,13430.0,5,S
2018-04-26 10:41:23,13430.0,4,19682,2,13425.0,5,13430.0,4,B
2018-04-26 10:41:26,13425.0,4,19686,4,13425.0,3,13430.0,11,S
2018-04-26 10:41:31,13425.0,2,19688,0,13425.0,5,13430.0,10,S
2018-04-26 10:41:46,13425.0,2,19690,0,13425.0,9,13430.0,10,S
2018-04-26 10:41:51,13430.0,2,19692,2,13425.0,9,13430.0,9,B
2018-04-26 10:41:57,13425.0,4,19696,0,13425.0,7,13430.0,14,S
2018-04-26 10:41:59,13430.0,18,19714,-6,13430.0,1,13435.0,7,B
2018-04-26 10:42:00,13430.0,2,19716,2,13430.0,2,13435.0,6,B
2018-04-26 10:42:14,13430.0,2,19718,2,13430.0,1,13435.0,10,B
2018-04-26 10:42:15,13435.0,16,19734,6,13430.0,2,13435.0,2,B
2018-04-26 10:42:15,13440.0,10,19744,-2,13435.0,12,13440.0,5,B
2018-04-26 10:42:19,13440.0,8,19752,-4,13435.0,7,13445.0,5,B
2018-04-26 10:42:20,13445.0,6,19758,0,13445.0,6,13450.0,7,B
2018-04-26 10:42:20,13445.0,6,19764,0,13440.0,22,13445.0,1,B
2018-04-26 10:42:21,13445.0,2,19766,0,13440.0,20,13450.0,7,B
2018-04-26 10:42:24,13450.0,10,19776,-6,13440.0,19,13450.0,4,B
2018-04-26 10:42:25,13445.0,2,19778,0,13440.0,4,13445.0,8,S
2018-04-26 10:42:26,13445.0,2,19780,0,13440.0,4,13445.0,8,S
2018-04-26 10:42:28,13440.0,2,19782,0,13440.0,4,13445.0,6,S
2018-04-26 10:42:37,13440.0,2,19784,-2,13440.0,3,13445.0,6,S
2018-04-26 10:42:40,13445.0,2,19786,0,13440.0,16,13450.0,14,B
2018-04-26 10:42:45,13445.0,4,19790,4,13440.0,17,13450.0,6,B
2018-04-26 10:42:51,13445.0,6,19796,0,13445.0,7,13450.0,13,B
2018-04-26 10:42:51,13445.0,2,19798,2,13445.0,6,13450.0,13,B
2018-04-26 10:42:54,13445.0,12,19810,12,13440.0,3,13450.0,11,B
2018-04-26 10:42:55,13450.0,8,19818,8,13440.0,6,13450.0,12,B
2018-04-26 10:43:00,13445.0,4,19822,4,13440.0,6,13450.0,13,S
2018-04-26 10:43:04,13440.0,8,19830,0,13435.0,4,13440.0,4,S
2018-04-26 10:43:05,13440.0,2,19832,0,13435.0,5,13440.0,4,S
2018-04-26 10:43:06,13440.0,8,19840,-4,13435.0,9,13445.0,8,S
2018-04-26 10:43:09,13440.0,2,19842,2,13435.0,8,13445.0,6,S
2018-04-26 10:43:20,13440.0,2,19844,0,13435.0,8,13440.0,8,S
2018-04-26 10:43:36,13435.0,16,19860,-10,13430.0,22,13435.0,7,S
2018-04-26 10:43:36,13435.0,14,19874,0,13430.0,28,13440.0,8,S
2018-04-26 10:43:51,13435.0,4,19878,-2,13430.0,34,13440.0,8,S
2018-04-26 10:43:58,13435.0,2,19880,-2,13430.0,13,13435.0,9,S
2018-04-26 10:44:05,13440.0,16,19896,0,13435.0,3,13445.0,22,B
2018-04-26 10:44:06,13435.0,14,19910,8,13435.0,24,13445.0,8,S
2018-04-26 10:44:09,13440.0,2,19912,0,13435.0,13,13440.0,5,B
2018-04-26 10:44:15,13440.0,6,19918,-6,13435.0,42,13445.0,13,B
2018-04-26 10:44:20,13445.0,2,19920,0,13435.0,7,13445.0,12,B
2018-04-26 10:44:33,13440.0,4,19924,2,13435.0,5,13440.0,2,S
2018-04-26 10:44:34,13440.0,4,19928,0,13440.0,1,13445.0,13,S
2018-04-26 10:45:12,13440.0,8,19936,2,13435.0,16,13445.0,7,S
2018-04-26 10:45:14,13435.0,18,19954,-2,13430.0,9,13435.0,4,S
2018-04-26 10:45:17,13430.0,6,19960,0,13425.0,6,13435.0,11,S
2018-04-26 10:45:22,13435.0,2,19962,0,13425.0,16,13435.0,12,B
2018-04-26 10:45:34,13430.0,6,19968,0,13425.0,22,13435.0,8,S
2018-04-26 10:45:42,13430.0,6,19974,2,13425.0,19,13435.0,9,S
2018-04-26 10:46:06,13425.0,2,19976,2,13425.0,20,13435.0,9,S
2018-04-26 10:46:40,13425.0,2,19978,0,13425.0,6,13430.0,23,S
2018-04-26 10:46:51,13425.0,12,19990,-10,13420.0,42,13430.0,23,S
2018-04-26 10:47:06,13425.0,14,20004,0,13420.0,41,13430.0,36,S
2018-04-26 10:47:07,13430.0,2,20006,0,13425.0,12,13430.0,13,B
2018-04-26 10:47:07,13430.0,26,20032,0,13425.0,12,13435.0,20,B
2018-04-26 10:47:14,13430.0,2,20034,0,13425.0,23,13435.0,23,B
2018-04-26 10:47:39,13430.0,2,20036,0,13430.0,7,13435.0,4,B
2018-04-26 10:47:39,13430.0,2,20038,0,13430.0,6,13435.0,4,B
2018-04-26 10:47:49,13435.0,2,20040,0,13430.0,9,13440.0,7,B
2018-04-26 10:47:50,13430.0,14,20054,12,13430.0,2,13440.0,8,S
2018-04-26 10:48:04,13435.0,2,20056,2,13430.0,13,13435.0,9,B
2018-04-26 10:48:08,13435.0,12,20068,2,13430.0,15,13440.0,16,B
2018-04-26 10:48:14,13435.0,2,20070,0,13435.0,12,13440.0,13,B
2018-04-26 10:48:31,13435.0,2,20072,2,13435.0,11,13440.0,14,B
2018-04-26 10:48:31,13435.0,4,20076,4,13435.0,10,13440.0,11,B
2018-04-26 10:48:36,13435.0,2,20078,2,13435.0,9,13440.0,10,B
2018-04-26 10:48:42,13440.0,16,20094,-8,13435.0,13,13445.0,8,B
2018-04-26 10:48:43,13440.0,2,20096,0,13435.0,13,13445.0,10,B
2018-04-26 10:48:51,13445.0,2,20098,2,13435.0,15,13445.0,9,B
2018-04-26 10:49:04,13440.0,2,20100,0,13435.0,24,13440.0,1,S
2018-04-26 10:49:04,13440.0,4,20104,-4,13435.0,24,13445.0,10,S
2018-04-26 10:49:16,13440.0,2,20106,2,13435.0,17,13445.0,14,S
2018-04-26 10:49:34,13435.0,6,20112,6,13435.0,4,13440.0,7,S
2018-04-26 10:49:45,13435.0,2,20114,2,13435.0,3,13440.0,7,S
2018-04-26 10:49:46,13435.0,6,20120,6,13430.0,14,13440.0,7,S
2018-04-26 10:49:55,13430.0,6,20126,0,13425.0,27,13435.0,12,S
2018-04-26 10:49:56,13430.0,6,20132,0,13425.0,28,13435.0,13,S
2018-04-26 10:50:03,13430.0,2,20134,0,13425.0,26,13435.0,15,S
2018-04-26 10:50:08,13435.0,10,20144,-8,13430.0,1,13435.0,10,B
2018-04-26 10:50:10,13430.0,2,20146,2,13430.0,1,13435.0,10,S
2018-04-26 10:50:20,13430.0,4,20150,-4,13425.0,26,13435.0,12,S
2018-04-26 10:50:21,13430.0,4,20154,4,13430.0,10,13435.0,7,S
2018-04-26 10:50:42,13430.0,14,20168,14,13430.0,13,13435.0,12,S
2018-04-26 10:51:09,13435.0,10,20178,6,13430.0,13,13435.0,8,B
2018-04-26 10:51:10,13435.0,2,20180,-2,13430.0,13,13440.0,6,B
2018-04-26 10:51:15,13440.0,26,20206,16,13435.0,1,13440.0,10,B
2018-04-26 10:51:15,13435.0,4,20210,0,13430.0,13,13440.0,11,S
2018-04-26 10:51:16,13430.0,2,20212,-2,13430.0,12,13435.0,13,S
2018-04-26 10:51:55,13435.0,2,20214,0,13430.0,13,13440.0,15,B
2018-04-26 10:52:18,13435.0,2,20216,0,13435.0,4,13440.0,9,B
2018-04-26 10:52:31,13435.0,2,20218,0,13430.0,14,13435.0,3,B
2018-04-26 10:52:54,13430.0,16,20234,0,13425.0,15,13435.0,11,S
2018-04-26 10:53:02,13430.0,4,20238,0,13425.0,16,13430.0,3,S
2018-04-26 10:53:02,13430.0,6,20244,2,13430.0,8,13435.0,7,S
2018-04-26 10:53:04,13435.0,10,20254,8,13430.0,8,13440.0,10,B
2018-04-26 10:53:05,13435.0,2,20256,0,13430.0,14,13440.0,5,B
2018-04-26 10:53:16,13430.0,2,20258,0,13430.0,3,13435.0,3,S
2018-04-26 10:53:23,13435.0,2,20260,0,13435.0,1,13440.0,13,B
2018-04-26 10:53:31,13435.0,2,20262,2,13430.0,11,13440.0,12,B
2018-04-26 10:53:34,13435.0,2,20264,2,13435.0,2,13440.0,10,B
2018-04-26 10:53:43,13440.0,2,20266,0,13435.0,1,13440.0,7,B
2018-04-26 10:54:09,13435.0,8,20274,-8,13430.0,15,13435.0,32,S
2018-04-26 10:54:10,13430.0,10,20284,0,13430.0,9,13435.0,26,S
2018-04-26 10:54:24,13440.0,8,20292,-2,13430.0,8,13440.0,11,B
2018-04-26 10:54:29,13430.0,12,20304,-2,13425.0,14,13435.0,24,S
2018-04-26 10:54:39,13435.0,2,20306,-2,13430.0,6,13440.0,12,B
2018-04-26 10:54:42,13435.0,2,20308,2,13430.0,6,13435.0,1,B
2018-04-26 10:55:02,13440.0,32,20340,2,13435.0,22,13445.0,22,B
2018-04-26 10:55:58,13440.0,6,20346,6,13435.0,19,13440.0,1,B
2018-04-26 10:56:03,13435.0,2,20348,0,13435.0,15,13440.0,2,S
2018-04-26 10:56:06,13440.0,2,20350,2,13435.0,15,13440.0,1,B
2018-04-26 10:56:06,13440.0,2,20352,2,13435.0,15,13445.0,24,B
2018-04-26 10:56:09,13440.0,2,20354,0,13435.0,17,13445.0,24,B
2018-04-26 10:57:06,13440.0,2,20356,0,13435.0,18,13440.0,4,B
2018-04-26 10:57:51,13440.0,8,20364,8,13440.0,1,13445.0,37,B
2018-04-26 10:57:52,13440.0,4,20368,-2,13435.0,17,13445.0,39,B
2018-04-26 10:58:02,13435.0,36,20404,2,13430.0,22,13440.0,7,S
2018-04-26 10:58:12,13435.0,4,20408,-4,13430.0,6,13435.0,6,S
2018-04-26 10:58:14,13435.0,12,20420,10,13435.0,1,13440.0,23,S
2018-04-26 10:58:15,13435.0,2,20422,0,13435.0,2,13440.0,22,S
2018-04-26 10:58:17,13435.0,10,20432,-2,13430.0,21,13440.0,3,S
2018-04-26 10:58:36,13440.0,2,20434,2,13435.0,4,13440.0,5,B
2018-04-26 10:59:01,13435.0,6,20440,0,13430.0,19,13440.0,7,S
2018-04-26 10:59:45,13430.0,2,20442,2,13425.0,11,13435.0,6,S
2018-04-26 10:59:46,13430.0,4,20446,4,13430.0,1,13435.0,19,S
2018-04-26 10:59:47,13430.0,2,20448,2,13425.0,7,13435.0,21,S
2018-04-26 11:00:01,13425.0,12,20460,-4,13420.0,41,13430.0,22,S
2018-04-26 11:00:11,13425.0,2,20462,-2,13425.0,3,13430.0,11,S
2018-04-26 11:00:36,13425.0,2,20464,0,13425.0,2,13430.0,13,S
2018-04-26 11:00:37,13425.0,4,20468,0,13420.0,41,13430.0,13,S
2018-04-26 11:00:39,13420.0,78,20546,78,13415.0,2,13420.0,1,S
2018-04-26 11:00:44,13415.0,2,20548,0,13415.0,1,13420.0,7,S
2018-04-26 11:00:55,13415.0,6,20554,-4,13410.0,7,13415.0,44,S
2018-04-26 11:00:55,13420.0,92,20646,-48,13415.0,5,13420.0,3,B
2018-04-26 11:00:56,13420.0,6,20652,-2,13415.0,9,13425.0,11,B
2018-04-26 11:00:57,13420.0,4,20656,4,13420.0,1,13425.0,11,B
2018-04-26 11:00:57,13420.0,2,20658,2,13415.0,6,13425.0,13,B
2018-04-26 11:01:00,13415.0,12,20670,-2,13410.0,48,13415.0,4,S
2018-04-26 11:01:00,13420.0,10,20680,2,13415.0,5,13420.0,5,B
2018-04-26 11:01:03,13415.0,2,20682,0,13415.0,4,13420.0,9,S
2018-04-26 11:01:04,13415.0,8,20690,0,13410.0,9,13415.0,1,S
2018-04-26 11:01:13,13410.0,8,20698,2,13410.0,11,13420.0,11,S
2018-04-26 11:01:14,13420.0,2,20700,2,13410.0,11,13420.0,10,B
2018-04-26 11:02:01,13415.0,2,20702,2,13415.0,1,13420.0,13,S
2018-04-26 11:02:11,13415.0,2,20704,0,13410.0,21,13420.0,13,S
2018-04-26 11:02:25,13415.0,6,20710,-6,13410.0,17,13420.0,16,S
2018-04-26 11:02:40,13420.0,4,20714,0,13410.0,8,13420.0,14,B
2018-04-26 11:02:46,13420.0,2,20716,0,13410.0,9,13420.0,13,B
2018-04-26 11:03:13,13420.0,2,20718,0,13415.0,1,13420.0,13,B
2018-04-26 11:04:20,13420.0,6,20724,-2,13415.0,6,13420.0,2,B
2018-04-26 11:04:20,13420.0,4,20728,2,13415.0,6,13425.0,10,B
2018-04-26 11:04:22,13420.0,2,20730,0,13415.0,7,13425.0,13,B
2018-04-26 11:04:23,13420.0,2,20732,-2,13415.0,7,13425.0,13,B
2018-04-26 11:04:44,13420.0,2,20734,0,13415.0,10,13425.0,19,B
2018-04-26 11:04:53,13420.0,2,20736,-2,13415.0,10,13425.0,19,B
2018-04-26 11:05:01,13415.0,2,20738,2,13415.0,9,13425.0,19,S
2018-04-26 11:05:09,13415.0,4,20742,-4,13415.0,9,13425.0,19,S
2018-04-26 11:05:36,13420.0,2,20744,2,13420.0,7,13425.0,17,B
2018-04-26 11:06:07,13420.0,2,20746,0,13420.0,11,13425.0,13,B
2018-04-26 11:06:39,13420.0,6,20752,0,13420.0,9,13425.0,16,B
2018-04-26 11:06:39,13415.0,20,20772,2,13415.0,7,13420.0,13,S
2018-04-26 11:06:42,13415.0,4,20776,-4,13410.0,24,13420.0,10,S
2018-04-26 11:07:04,13415.0,2,20778,0,13415.0,4,13420.0,4,S
2018-04-26 11:07:06,13415.0,8,20786,-2,13410.0,16,13415.0,2,S
2018-04-26 11:07:22,13415.0,8,20794,-2,13410.0,14,13420.0,14,S
2018-04-26 11:07:48,13415.0,2,20796,-2,13410.0,16,13415.0,2,S
2018-04-26 11:07:59,13415.0,10,20806,-10,13415.0,1,13420.0,10,S
2018-04-26 11:08:04,13415.0,4,20810,-2,13410.0,16,13420.0,22,S
2018-04-26 11:08:44,13420.0,2,20812,0,13415.0,9,13420.0,2,B
2018-04-26 11:08:45,13420.0,4,20816,-4,13420.0,1,13425.0,30,B
2018-04-26 11:08:45,13420.0,2,20818,-2,13415.0,8,13420.0,1,B
2018-04-26 11:08:46,13420.0,2,20820,-2,13420.0,1,13425.0,14,B
2018-04-26 11:08:46,13420.0,2,20822,-2,13420.0,3,13425.0,26,B
2018-04-26 11:08:48,13420.0,4,20826,0,13420.0,1,13425.0,14,B
2018-04-26 11:08:49,13420.0,2,20828,0,13415.0,8,13425.0,14,B
2018-04-26 11:08:59,13415.0,2,20830,-2,13415.0,8,13425.0,18,S
2018-04-26 11:09:19,13420.0,14,20844,6,13420.0,1,13425.0,18,B
2018-04-26 11:09:21,13420.0,4,20848,-2,13420.0,1,13425.0,12,B
2018-04-26 11:09:23,13420.0,2,20850,-2,13415.0,9,13420.0,1,B
2018-04-26 11:09:23,13420.0,2,20852,-2,13420.0,1,13425.0,12,B
2018-04-26 11:09:27,13420.0,2,20854,0,13420.0,1,13425.0,12,B
2018-04-26 11:09:27,13420.0,2,20856,-2,13415.0,9,13425.0,12,B
2018-04-26 11:09:46,13420.0,2,20858,-2,13415.0,9,13425.0,18,B
2018-04-26 11:09:48,13420.0,2,20860,0,13415.0,9,13420.0,5,B
2018-04-26 11:09:49,13420.0,2,20862,0,13415.0,9,13420.0,4,B
2018-04-26 11:09:49,13420.0,2,20864,0,13415.0,9,13420.0,10,B
2018-04-26 11:09:51,13420.0,2,20866,-2,13415.0,7,13420.0,9,B
2018-04-26 11:09:51,13420.0,2,20868,-2,13415.0,7,13420.0,8,B
2018-04-26 11:09:52,13420.0,2,20870,-2,13415.0,7,13420.0,7,B
2018-04-26 11:09:52,13420.0,2,20872,0,13415.0,7,13420.0,6,B
2018-04-26 11:09:53,13420.0,2,20874,0,13415.0,7,13420.0,5,B
2018-04-26 11:09:53,13420.0,2,20876,0,13415.0,8,13420.0,4,B
2018-04-26 11:09:54,13420.0,2,20878,0,13415.0,8,13420.0,3,B
2018-04-26 11:09:54,13420.0,2,20880,0,13415.0,8,13420.0,2,B
2018-04-26 11:09:55,13420.0,2,20882,0,13415.0,8,13420.0,1,B
2018-04-26 11:09:55,13420.0,2,20884,0,13415.0,8,13425.0,14,B
2018-04-26 11:09:57,13415.0,8,20892,-8,13415.0,5,13420.0,1,S
2018-04-26 11:10:09,13420.0,2,20894,0,13415.0,5,13420.0,3,B
2018-04-26 11:10:10,13420.0,2,20896,0,13415.0,5,13420.0,2,B
2018-04-26 11:10:10,13420.0,2,20898,0,13415.0,5,13420.0,1,B
2018-04-26 11:10:11,13420.0,2,20900,0,13415.0,5,13425.0,15,B
2018-04-26 11:10:29,13415.0,8,20908,-8,13415.0,3,13420.0,1,S
2018-04-26 11:10:29,13420.0,2,20910,0,13415.0,6,13420.0,1,B
2018-04-26 11:10:57,13420.0,2,20912,2,13415.0,5,13420.0,5,B
2018-04-26 11:10:59,13415.0,2,20914,2,13415.0,2,13420.0,6,S
2018-04-26 11:10:59,13415.0,4,20918,0,13410.0,11,13415.0,5,S
2018-04-26 11:11:32,13415.0,6,20924,-6,13415.0,13,13420.0,5,S
2018-04-26 11:11:38,13415.0,2,20926,2,13415.0,5,13420.0,4,S
2018-04-26 11:11:39,13415.0,10,20936,2,13410.0,11,13415.0,2,S
2018-04-26 11:11:45,13415.0,2,20938,2,13410.0,11,13415.0,1,S
2018-04-26 11:12:28,13430.0,128,21066,92,13415.0,2,13420.0,1,B
2018-04-26 11:12:29,13415.0,8,21074,-8,13415.0,1,13420.0,5,S
2018-04-26 11:12:30,13420.0,4,21078,4,13415.0,6,13420.0,2,B
2018-04-26 11:12:33,13420.0,4,21082,4,13415.0,6,13420.0,1,B
2018-04-26 11:12:33,13420.0,2,21084,-2,13415.0,6,13425.0,1,B
2018-04-26 11:13:01,13420.0,12,21096,6,13415.0,7,13420.0,4,B
2018-04-26 11:13:59,13415.0,8,21104,-8,13410.0,11,13415.0,6,S
2018-04-26 11:14:06,13420.0,4,21108,4,13410.0,10,13420.0,5,B
2018-04-26 11:14:10,13415.0,2,21110,0,13410.0,10,13420.0,6,S
2018-04-26 11:14:45,13415.0,2,21112,-2,13415.0,6,13420.0,4,S
2018-04-26 11:15:03,13415.0,2,21114,0,13415.0,4,13420.0,5,S
2018-04-26 11:15:03,13415.0,8,21122,-6,13410.0,14,13420.0,5,S
2018-04-26 11:16:03,13410.0,10,21132,2,13410.0,8,13420.0,11,S
2018-04-26 11:16:34,13415.0,4,21136,4,13415.0,6,13420.0,12,B
2018-04-26 11:16:35,13420.0,24,21160,8,13415.0,9,13425.0,10,B
2018-04-26 11:17:00,13425.0,12,21172,10,13425.0,1,13430.0,4,B
2018-04-26 11:17:01,13425.0,6,21178,-2,13425.0,1,13430.0,3,B
2018-04-26 11:17:08,13425.0,4,21182,-4,13420.0,5,13430.0,11,B
2018-04-26 11:17:16,13425.0,2,21184,-2,13420.0,5,13425.0,3,B
2018-04-26 11:17:39,13420.0,4,21188,4,13415.0,8,13425.0,10,S
2018-04-26 11:17:47,13420.0,4,21192,2,13420.0,4,13425.0,11,S
2018-04-26 11:19:55,13425.0,2,21194,0,13420.0,33,13430.0,6,B
2018-04-26 11:20:06,13420.0,8,21202,4,13415.0,10,13425.0,9,S
2018-04-26 11:21:02,13415.0,22,21224,8,13410.0,37,13425.0,12,S
2018-04-26 11:21:02,13415.0,4,21228,4,13415.0,8,13420.0,2,S
2018-04-26 11:21:03,13410.0,40,21268,14,13410.0,30,13420.0,2,S
2018-04-26 11:21:03,13410.0,4,21272,0,13415.0,1,13420.0,3,S
2018-04-26 11:21:04,13420.0,10,21282,-2,13415.0,4,13420.0,2,B
2018-04-26 11:21:04,13420.0,2,21284,0,13415.0,4,13420.0,1,B
2018-04-26 11:21:05,13420.0,2,21286,0,13415.0,5,13425.0,5,B
2018-04-26 11:21:13,13420.0,2,21288,0,13415.0,4,13425.0,9,B
2018-04-26 11:21:20,13420.0,2,21290,0,13415.0,7,13425.0,8,B
2018-04-26 11:21:43,13425.0,6,21296,0,13420.0,3,13425.0,1,B
2018-04-26 11:21:44,13425.0,2,21298,0,13420.0,6,13430.0,6,B
2018-04-26 11:21:53,13425.0,2,21300,-2,13420.0,5,13425.0,4,B
2018-04-26 11:21:53,13425.0,2,21302,-2,13420.0,5,13425.0,2,B
2018-04-26 11:21:54,13425.0,2,21304,0,13420.0,5,13425.0,1,B
2018-04-26 11:21:54,13425.0,2,21306,0,13420.0,5,13430.0,10,B
2018-04-26 11:22:02,13430.0,8,21314,-6,13425.0,9,13435.0,5,B
2018-04-26 11:22:10,13430.0,4,21318,-4,13425.0,5,13435.0,8,B
2018-04-26 11:22:44,13430.0,2,21320,0,13425.0,6,13430.0,6,B
2018-04-26 11:22:45,13435.0,28,21348,2,13435.0,30,13440.0,9,B
2018-04-26 11:22:45,13440.0,64,21412,50,13430.0,3,13440.0,11,B
2018-04-26 11:22:46,13430.0,4,21416,0,13430.0,2,13435.0,13,S
2018-04-26 11:22:47,13435.0,2,21418,-2,13430.0,5,13435.0,3,B
2018-04-26 11:22:49,13435.0,2,21420,-2,13430.0,5,13435.0,2,B
2018-04-26 11:22:50,13430.0,2,21422,-2,13430.0,4,13435.0,2,S
2018-04-26 11:22:51,13430.0,2,21424,-2,13425.0,6,13435.0,6,S
2018-04-26 11:23:11,13435.0,4,21428,-4,13430.0,1,13435.0,6,B
2018-04-26 11:23:40,13430.0,2,21430,2,13430.0,3,13435.0,4,S
2018-04-26 11:24:02,13435.0,2,21432,2,13430.0,5,13435.0,3,B
2018-04-26 11:24:05,13430.0,2,21434,-2,13425.0,8,13435.0,6,S
2018-04-26 11:24:11,13425.0,2,21436,0,13425.0,5,13430.0,5,S
2018-04-26 11:24:13,13425.0,10,21446,-8,13420.0,35,13430.0,6,S
2018-04-26 11:24:46,13425.0,2,21448,2,13420.0,40,13430.0,21,S
2018-04-26 11:24:48,13425.0,2,21450,-2,13420.0,63,13430.0,19,S
2018-04-26 11:25:02,13425.0,4,21454,-2,13420.0,63,13425.0,3,S
2018-04-26 11:25:02,13425.0,6,21460,0,13425.0,1,13430.0,15,S
2018-04-26 11:25:12,13425.0,2,21462,0,13420.0,38,13425.0,4,S
2018-04-26 11:25:13,13425.0,8,21470,-8,13425.0,1,13430.0,15,S
2018-04-26 11:25:14,13425.0,4,21474,-2,13420.0,38,13425.0,3,S
2018-04-26 11:25:15,13425.0,6,21480,-6,13425.0,1,13430.0,15,S
2018-04-26 11:25:31,13430.0,4,21484,0,13425.0,8,13430.0,18,B
2018-04-26 11:25:31,13430.0,36,21520,10,13430.0,6,13435.0,3,B
2018-04-26 11:25:49,13430.0,6,21526,4,13425.0,41,13430.0,17,B
2018-04-26 11:25:50,13430.0,34,21560,22,13425.0,42,13435.0,3,B
2018-04-26 11:26:14,13430.0,2,21562,0,13425.0,15,13435.0,7,B
2018-04-26 11:26:18,13425.0,2,21564,0,13425.0,40,13435.0,7,S
2018-04-26 11:26:24,13430.0,16,21580,16,13425.0,36,13430.0,2,B
2018-04-26 11:26:25,13425.0,12,21592,-8,13425.0,2,13430.0,6,S
2018-04-26 11:26:51,13430.0,10,21602,-6,13425.0,2,13430.0,3,B
2018-04-26 11:28:01,13430.0,2,21604,0,13425.0,7,13430.0,2,B
2018-04-26 11:28:22,13425.0,2,21606,0,13425.0,4,13430.0,2,S
2018-04-26 11:28:44,13430.0,2,21608,0,13425.0,4,13430.0,14,B
2018-04-26 11:28:58,13430.0,2,21610,2,13425.0,6,13430.0,13,B
2018-04-26 11:29:20,13425.0,4,21614,0,13425.0,2,13430.0,13,S
2018-04-26 11:29:20,13430.0,4,21618,-4,13425.0,2,13430.0,11,B
2018-04-26 11:29:26,13430.0,2,21620,-2,13425.0,37,13430.0,10,B
2018-04-26 11:29:27,13430.0,14,21634,-2,13425.0,37,13430.0,3,B
2018-04-26 11:29:27,13430.0,6,21640,0,13430.0,1,13435.0,3,B
2018-04-26 11:29:30,13435.0,6,21646,4,13425.0,34,13435.0,3,B
2018-04-26 11:29:41,13435.0,2,21648,0,13430.0,3,13440.0,15,B
2018-04-26 11:29:50,13430.0,4,21652,2,13430.0,2,13435.0,5,S
2018-04-26 13:30:00,13425.0,10,21662,-2,13425.0,28,13430.0,1,S
2018-04-26 13:30:02,13425.0,8,21670,-2,13420.0,33,13430.0,4,S
2018-04-26 13:30:03,13425.0,2,21672,0,13420.0,35,13430.0,6,S
2018-04-26 13:30:05,13425.0,4,21676,-2,13420.0,10,13430.0,4,S
2018-04-26 13:30:07,13430.0,6,21682,-2,13430.0,3,13435.0,7,B
2018-04-26 13:30:10,13440.0,6,21688,0,13430.0,2,13440.0,10,B
2018-04-26 13:30:12,13435.0,2,21690,2,13430.0,5,13435.0,3,S
2018-04-26 13:30:13,13430.0,4,21694,-2,13430.0,1,13435.0,3,S
2018-04-26 13:30:14,13430.0,4,21698,-2,13425.0,10,13435.0,3,S
2018-04-26 13:30:19,13430.0,2,21700,2,13430.0,10,13435.0,3,S
2018-04-26 13:30:19,13430.0,20,21720,20,13425.0,33,13435.0,3,S
2018-04-26 13:30:20,13430.0,4,21724,0,13425.0,10,13435.0,11,S
2018-04-26 13:30:22,13425.0,4,21728,0,13420.0,8,13425.0,2,S
2018-04-26 13:30:22,13420.0,4,21732,-2,13420.0,12,13425.0,1,S
2018-04-26 13:30:23,13425.0,2,21734,-2,13420.0,13,13430.0,2,B
2018-04-26 13:30:32,13420.0,14,21748,0,13415.0,3,13425.0,5,S
2018-04-26 13:30:33,13420.0,4,21752,-2,13415.0,6,13425.0,7,S
2018-04-26 13:30:34,13425.0,2,21754,0,13415.0,6,13425.0,6,B
2018-04-26 13:30:38,13420.0,2,21756,-2,13420.0,1,13425.0,7,S
2018-04-26 13:30:38,13420.0,2,21758,-2,13420.0,5,13425.0,7,S
2018-04-26 13:30:39,13420.0,10,21768,0,13415.0,7,13425.0,6,S
2018-04-26 13:30:40,13420.0,2,21770,0,13415.0,10,13420.0,4,S
2018-04-26 13:30:41,13420.0,2,21772,0,13415.0,8,13420.0,3,S
2018-04-26 13:30:41,13420.0,2,21774,0,13415.0,8,13420.0,2,S
2018-04-26 13:30:42,13420.0,4,21778,0,13415.0,9,13425.0,7,S
2018-04-26 13:30:47,13415.0,4,21782,2,13415.0,7,13425.0,5,S
2018-04-26 13:30:48,13420.0,2,21784,0,13415.0,4,13425.0,5,B
2018-04-26 13:30:55,13425.0,2,21786,-2,13420.0,8,13430.0,8,B
2018-04-26 13:31:00,13420.0,8,21794,-6,13415.0,4,13420.0,4,S
2018-04-26 13:31:00,13420.0,2,21796,-2,13415.0,10,13420.0,3,S
2018-04-26 13:31:01,13420.0,2,21798,-2,13415.0,11,13425.0,2,S
2018-04-26 13:31:01,13415.0,4,21802,0,13415.0,9,13425.0,8,S
2018-04-26 13:31:06,13425.0,2,21804,0,13420.0,6,13430.0,8,B
2018-04-26 13:31:08,13425.0,2,21806,-2,13420.0,9,13430.0,9,B
2018-04-26 13:31:11,13420.0,14,21820,10,13415.0,3,13425.0,16,S
2018-04-26 13:31:24,13420.0,2,21822,0,13415.0,3,13420.0,8,S
2018-04-26 13:31:25,13415.0,4,21826,0,13415.0,1,13420.0,9,S
2018-04-26 13:31:25,13415.0,4,21830,0,13410.0,9,13420.0,7,S
2018-04-26 13:31:27,13420.0,2,21832,-2,13415.0,5,13425.0,9,B
2018-04-26 13:31:28,13420.0,2,21834,-2,13415.0,9,13420.0,7,B
2018-04-26 13:31:28,13420.0,2,21836,-2,13415.0,9,13420.0,5,B
2018-04-26 13:31:29,13420.0,2,21838,-2,13415.0,9,13420.0,3,B
2018-04-26 13:31:29,13420.0,2,21840,-2,13415.0,9,13420.0,1,B
2018-04-26 13:31:30,13420.0,2,21842,-2,13420.0,1,13425.0,11,B
2018-04-26 13:31:37,13420.0,2,21844,2,13415.0,2,13420.0,5,B
2018-04-26 13:31:38,13415.0,6,21850,-2,13410.0,12,13415.0,1,S
2018-04-26 13:31:39,13415.0,6,21856,-2,13410.0,18,13420.0,1,S
2018-04-26 13:31:57,13420.0,6,21862,0,13420.0,1,13425.0,11,B
2018-04-26 13:32:16,13420.0,14,21876,12,13415.0,10,13425.0,6,B
2018-04-26 13:32:17,13415.0,4,21880,-2,13415.0,4,13420.0,1,S
2018-04-26 13:32:18,13415.0,4,21884,-2,13415.0,2,13420.0,1,S
2018-04-26 13:32:39,13420.0,10,21894,-6,13420.0,3,13425.0,2,B
2018-04-26 13:32:48,13415.0,10,21904,10,13415.0,54,13425.0,7,S
2018-04-26 13:32:54,13420.0,2,21906,2,13415.0,54,13420.0,1,B
2018-04-26 13:32:55,13420.0,2,21908,0,13420.0,1,13425.0,8,B
2018-04-26 13:32:58,13420.0,2,21910,2,13420.0,1,13425.0,8,B
2018-04-26 13:33:01,13420.0,2,21912,-2,13420.0,1,13425.0,8,B
2018-04-26 13:33:03,13420.0,2,21914,0,13415.0,54,13420.0,4,B
2018-04-26 13:33:03,13420.0,2,21916,-2,13415.0,57,13420.0,3,B
2018-04-26 13:33:04,13420.0,6,21922,0,13420.0,1,13425.0,8,B
2018-04-26 13:33:05,13420.0,2,21924,-2,13420.0,1,13425.0,8,B
2018-04-26 13:33:17,13420.0,2,21926,0,13415.0,2,13420.0,7,B
2018-04-26 13:33:18,13415.0,4,21930,0,13415.0,1,13420.0,10,S
2018-04-26 13:33:19,13415.0,4,21934,0,13415.0,1,13420.0,8,S
2018-04-26 13:33:25,13415.0,2,21936,0,13410.0,64,13415.0,4,S
2018-04-26 13:33:26,13415.0,6,21942,4,13410.0,68,13415.0,3,S
2018-04-26 13:33:26,13415.0,2,21944,0,13410.0,68,13415.0,2,S
2018-04-26 13:33:27,13410.0,14,21958,-2,13410.0,2,13415.0,8,S
2018-04-26 13:33:28,13415.0,4,21962,-4,13410.0,5,13415.0,1,B
2018-04-26 13:33:33,13415.0,2,21964,2,13410.0,58,13420.0,8,B
2018-04-26 13:33:35,13410.0,4,21968,0,13410.0,1,13415.0,7,S
2018-04-26 13:33:36,13410.0,2,21970,0,13410.0,2,13415.0,12,S
2018-04-26 13:33:36,13410.0,4,21974,-2,13405.0,53,13415.0,10,S
2018-04-26 13:33:41,13405.0,8,21982,-2,13400.0,104,13405.0,4,S
2018-04-26 13:33:42,13405.0,14,21996,-8,13400.0,110,13405.0,1,S
2018-04-26 13:33:42,13405.0,2,21998,0,13400.0,87,13410.0,8,S
2018-04-26 13:33:44,13405.0,12,22010,-8,13405.0,11,13410.0,6,S
2018-04-26 13:33:54,13405.0,10,22020,0,13405.0,8,13410.0,1,S
2018-04-26 13:34:00,13405.0,4,22024,0,13405.0,4,13410.0,3,S
2018-04-26 13:34:12,13410.0,2,22026,0,13405.0,5,13410.0,3,B
2018-04-26 13:34:20,13410.0,4,22030,0,13405.0,6,13410.0,9,B
2018-04-26 13:34:21,13405.0,4,22034,0,13400.0,103,13410.0,7,S
2018-04-26 13:34:21,13405.0,4,22038,0,13400.0,110,13410.0,7,S
2018-04-26 13:34:29,13410.0,2,22040,0,13405.0,15,13410.0,3,B
2018-04-26 13:34:30,13405.0,2,22042,0,13405.0,14,13415.0,14,S
2018-04-26 13:34:30,13405.0,4,22046,-2,13405.0,12,13415.0,16,S
2018-04-26 13:34:33,13410.0,4,22050,0,13410.0,1,13415.0,10,B
2018-04-26 13:34:35,13410.0,4,22054,-2,13405.0,64,13410.0,3,B
2018-04-26 13:34:36,13410.0,6,22060,-6,13410.0,1,13415.0,10,B
2018-04-26 13:34:42,13415.0,2,22062,0,13410.0,1,13415.0,9,B
2018-04-26 13:34:48,13415.0,14,22076,8,13410.0,30,13420.0,9,B
2018-04-26 13:34:51,13415.0,4,22080,-2,13415.0,2,13420.0,18,B
2018-04-26 13:34:52,13415.0,4,22084,-4,13410.0,8,13415.0,2,B
2018-04-26 13:34:53,13410.0,4,22088,0,13410.0,5,13415.0,5,S
2018-04-26 13:34:53,13410.0,4,22092,-2,13410.0,3,13415.0,3,S
2018-04-26 13:34:56,13415.0,4,22096,0,13410.0,4,13415.0,6,B
2018-04-26 13:34:57,13415.0,2,22098,-2,13410.0,31,13415.0,2,B
2018-04-26 13:34:59,13415.0,4,22102,-2,13410.0,3,13415.0,6,B
2018-04-26 13:35:00,13415.0,2,22104,-2,13410.0,9,13415.0,1,B
2018-04-26 13:35:00,13410.0,6,22110,-2,13410.0,31,13420.0,10,S
2018-04-26 13:35:01,13415.0,4,22114,0,13410.0,1,13420.0,14,B
2018-04-26 13:35:03,13415.0,4,22118,-2,13415.0,1,13420.0,14,B
2018-04-26 13:35:03,13415.0,2,22120,0,13410.0,7,13415.0,7,B
2018-04-26 13:35:04,13410.0,4,22124,0,13405.0,40,13410.0,2,S
2018-04-26 13:35:05,13410.0,2,22126,-2,13405.0,47,13410.0,1,S
2018-04-26 13:35:05,13410.0,2,22128,-2,13410.0,1,13415.0,6,S
2018-04-26 13:35:16,13410.0,2,22130,0,13405.0,43,13415.0,6,S
2018-04-26 13:35:17,13410.0,2,22132,0,13405.0,43,13415.0,6,S
2018-04-26 13:35:30,13410.0,2,22134,0,13405.0,40,13415.0,16,S
2018-04-26 13:35:32,13405.0,8,22142,-8,13405.0,14,13415.0,16,S
2018-04-26 13:35:42,13410.0,2,22144,0,13410.0,3,13415.0,14,B
2018-04-26 13:35:43,13410.0,6,22150,0,13405.0,7,13410.0,1,B
2018-04-26 13:35:44,13405.0,2,22152,-2,13405.0,6,13410.0,2,S
2018-04-26 13:35:44,13405.0,4,22156,-4,13405.0,4,13415.0,15,S
2018-04-26 13:35:58,13410.0,2,22158,-2,13405.0,5,13410.0,3,B
2018-04-26 13:36:11,13405.0,2,22160,0,13405.0,17,13410.0,5,S
2018-04-26 13:36:13,13410.0,2,22162,-2,13405.0,17,13410.0,4,B
2018-04-26 13:36:15,13410.0,2,22164,0,13405.0,17,13410.0,2,B
2018-04-26 13:36:16,13410.0,4,22168,-2,13405.0,73,13415.0,14,B
2018-04-26 13:36:18,13415.0,2,22170,0,13410.0,1,13415.0,13,B
2018-04-26 13:36:52,13410.0,16,22186,4,13410.0,4,13415.0,14,S
2018-04-26 13:36:53,13410.0,8,22194,0,13405.0,16,13410.0,2,S
2018-04-26 13:36:54,13405.0,8,22202,-8,13405.0,14,13415.0,14,S
2018-04-26 13:36:58,13410.0,2,22204,0,13405.0,16,13410.0,3,B
2018-04-26 13:37:00,13405.0,6,22210,-2,13405.0,13,13410.0,2,S
2018-04-26 13:37:07,13410.0,2,22212,-2,13405.0,13,13410.0,2,B
2018-04-26 13:37:08,13410.0,2,22214,-2,13405.0,42,13410.0,1,B
2018-04-26 13:37:08,13410.0,2,22216,0,13410.0,1,13415.0,12,B
2018-04-26 13:37:27,13415.0,10,22226,4,13410.0,4,13415.0,3,B
2018-04-26 13:37:58,13415.0,2,22228,2,13410.0,12,13415.0,2,B
2018-04-26 13:38:00,13415.0,4,22232,0,13415.0,3,13420.0,15,B
2018-04-26 13:38:01,13415.0,6,22238,4,13410.0,12,13415.0,1,B
2018-04-26 13:38:02,13410.0,2,22240,0,13410.0,12,13415.0,3,S
2018-04-26 13:38:02,13410.0,4,22244,0,13410.0,10,13415.0,1,S
2018-04-26 13:38:10,13415.0,2,22246,2,13410.0,10,13415.0,1,B
2018-04-26 13:38:11,13415.0,2,22248,2,13410.0,10,13415.0,1,B
2018-04-26 13:38:14,13415.0,2,22250,2,13410.0,8,13415.0,9,B
2018-04-26 13:38:14,13410.0,14,22264,10,13405.0,14,13410.0,3,S
2018-04-26 13:38:15,13405.0,2,22266,0,13405.0,13,13410.0,5,S
2018-04-26 13:38:16,13405.0,4,22270,0,13405.0,11,13410.0,3,S
2018-04-26 13:38:20,13410.0,2,22272,0,13405.0,11,13410.0,2,B
2018-04-26 13:38:24,13405.0,2,22274,2,13405.0,10,13410.0,2,S
2018-04-26 13:38:30,13405.0,8,22282,6,13405.0,5,13410.0,5,S
2018-04-26 13:38:30,13405.0,10,22292,-4,13400.0,81,13410.0,7,S
2018-04-26 13:38:32,13400.0,4,22296,0,13400.0,45,13405.0,9,S
2018-04-26 13:38:32,13400.0,4,22300,0,13400.0,43,13405.0,7,S
2018-04-26 13:38:33,13400.0,10,22310,10,13400.0,38,13405.0,7,S
2018-04-26 13:38:34,13405.0,2,22312,-2,13400.0,70,13405.0,3,B
2018-04-26 13:38:35,13405.0,6,22318,-6,13400.0,38,13405.0,3,B
2018-04-26 13:38:36,13405.0,2,22320,2,13400.0,38,13405.0,3,B
2018-04-26 13:38:37,13405.0,32,22352,10,13405.0,9,13410.0,21,B
2018-04-26 13:38:37,13400.0,84,22436,66,13395.0,14,13400.0,2,S
2018-04-26 13:38:38,13395.0,16,22452,0,13395.0,5,13400.0,7,S
2018-04-26 13:38:39,13395.0,12,22464,8,13390.0,76,13395.0,1,S
2018-04-26 13:38:39,13400.0,4,22468,-4,13395.0,1,13400.0,6,B
2018-04-26 13:38:40,13395.0,4,22472,-2,13390.0,57,13400.0,6,S
2018-04-26 13:38:41,13395.0,10,22482,-2,13390.0,27,13400.0,9,S
2018-04-26 13:38:47,13400.0,30,22512,24,13400.0,5,13405.0,15,B
2018-04-26 13:38:48,13395.0,12,22524,10,13395.0,3,13400.0,13,S
2018-04-26 13:38:49,13395.0,10,22534,-6,13390.0,34,13395.0,1,S
2018-04-26 13:38:49,13395.0,6,22540,-6,13395.0,1,13400.0,7,S
2018-04-26 13:38:50,13395.0,2,22542,2,13390.0,28,13395.0,5,S
2018-04-26 13:38:50,13390.0,4,22546,0,13390.0,25,13395.0,3,S
2018-04-26 13:38:51,13390.0,8,22554,0,13390.0,21,13395.0,1,S
2018-04-26 13:38:53,13395.0,2,22556,2,13390.0,27,13395.0,2,B
2018-04-26 13:38:54,13395.0,4,22560,-4,13390.0,27,13395.0,4,B
2018-04-26 13:38:54,13395.0,8,22568,-8,13390.0,27,13400.0,14,B
2018-04-26 13:38:58,13390.0,2,22570,2,13390.0,22,13400.0,14,S
2018-04-26 13:39:01,13390.0,26,22596,-18,13390.0,9,13395.0,4,S
2018-04-26 13:39:02,13390.0,18,22614,6,13385.0,13,13390.0,4,S
2018-04-26 13:39:03,13385.0,8,22622,0,13385.0,10,13395.0,11,S
2018-04-26 13:39:04,13385.0,18,22640,16,13380.0,37,13385.0,4,S
2018-04-26 13:39:04,13390.0,14,22654,-8,13385.0,4,13390.0,3,B
2018-04-26 13:39:05,13385.0,8,22662,6,13380.0,41,13385.0,4,S
2018-04-26 13:39:05,13390.0,10,22672,-8,13385.0,1,13390.0,1,B
2018-04-26 13:39:07,13390.0,2,22674,0,13390.0,12,13395.0,7,B
2018-04-26 13:39:11,13395.0,12,22686,0,13395.0,1,13400.0,4,B
2018-04-26 13:39:12,13400.0,8,22694,4,13395.0,24,13405.0,6,B
2018-04-26 13:39:13,13400.0,4,22698,0,13395.0,24,13400.0,2,B
2018-04-26 13:39:14,13395.0,12,22710,4,13395.0,22,13400.0,2,S
2018-04-26 13:39:14,13400.0,2,22712,0,13395.0,22,13400.0,1,B
2018-04-26 13:39:15,13400.0,2,22714,-2,13395.0,22,13405.0,5,B
2018-04-26 13:39:19,13400.0,4,22718,0,13395.0,16,13400.0,2,B
2018-04-26 13:39:20,13400.0,2,22720,-2,13395.0,11,13400.0,1,B
2018-04-26 13:39:21,13395.0,2,22722,0,13395.0,3,13400.0,7,S
2018-04-26 13:39:21,13400.0,22,22744,10,13395.0,14,13405.0,3,B
2018-04-26 13:39:22,13400.0,2,22746,-2,13395.0,16,13400.0,3,B
2018-04-26 13:39:23,13400.0,8,22754,-8,13395.0,16,13400.0,3,B
2018-04-26 13:39:24,13395.0,6,22760,-6,13390.0,22,13400.0,1,S
2018-04-26 13:39:24,13395.0,4,22764,-4,13390.0,26,13395.0,2,S
2018-04-26 13:39:25,13395.0,4,22768,0,13395.0,17,13400.0,4,S
2018-04-26 13:39:28,13400.0,6,22774,-2,13395.0,18,13405.0,4,B
2018-04-26 13:39:33,13405.0,2,22776,-2,13400.0,14,13410.0,7,B
2018-04-26 13:39:47,13410.0,2,22778,0,13400.0,9,13410.0,12,B
2018-04-26 13:39:53,13405.0,8,22786,0,13400.0,20,13405.0,2,S
2018-04-26 13:39:55,13400.0,8,22794,-2,13400.0,1,13410.0,9,S
2018-04-26 13:39:57,13405.0,2,22796,0,13400.0,16,13405.0,3,B
2018-04-26 13:39:58,13405.0,6,22802,-6,13400.0,16,13405.0,2,B
2018-04-26 13:39:58,13405.0,4,22806,-4,13400.0,17,13410.0,10,B
2018-04-26 13:40:03,13400.0,4,22810,0,13395.0,16,13400.0,2,S
2018-04-26 13:40:04,13400.0,8,22818,0,13395.0,16,13405.0,8,S
2018-04-26 13:40:07,13405.0,2,22820,-2,13400.0,32,13410.0,7,B
2018-04-26 13:40:12,13405.0,2,22822,2,13405.0,2,13410.0,6,B
2018-04-26 13:40:14,13405.0,2,22824,0,13400.0,20,13405.0,4,B
2018-04-26 13:40:15,13400.0,8,22832,-6,13400.0,18,13410.0,7,S
2018-04-26 13:40:19,13400.0,12,22844,-8,13400.0,1,13405.0,14,S
2018-04-26 13:40:20,13400.0,2,22846,0,13395.0,15,13400.0,2,S
2018-04-26 13:40:21,13395.0,4,22850,-2,13395.0,15,13400.0,2,S
2018-04-26 13:40:21,13395.0,4,22854,-4,13395.0,13,13405.0,7,S
2018-04-26 13:40:27,13400.0,4,22858,-2,13395.0,9,13405.0,8,B
2018-04-26 13:40:28,13405.0,2,22860,2,13405.0,1,13410.0,13,B
2018-04-26 13:40:28,13405.0,2,22862,2,13400.0,15,13405.0,4,B
2018-04-26 13:40:29,13405.0,8,22870,-8,13400.0,15,13410.0,9,B
2018-04-26 13:40:32,13400.0,2,22872,2,13400.0,14,13410.0,9,S
2018-04-26 13:40:35,13400.0,8,22880,6,13400.0,12,13410.0,9,S
2018-04-26 13:40:57,13400.0,6,22886,6,13405.0,12,13410.0,5,S
2018-04-26 13:41:02,13405.0,8,22894,-8,13400.0,15,13405.0,1,B
2018-04-26 13:41:03,13400.0,2,22896,0,13400.0,14,13410.0,8,S
2018-04-26 13:41:29,13410.0,10,22906,-2,13410.0,1,13415.0,6,B
2018-04-26 13:41:40,13415.0,10,22916,-6,13415.0,1,13420.0,15,B
2018-04-26 13:41:41,13415.0,4,22920,-2,13410.0,37,13420.0,13,B
2018-04-26 13:41:52,13415.0,2,22922,-2,13415.0,1,13420.0,14,B
2018-04-26 13:42:03,13415.0,2,22924,-2,13410.0,29,13415.0,1,B
2018-04-26 13:42:04,13415.0,2,22926,-2,13410.0,25,13415.0,1,B
2018-04-26 13:42:05,13415.0,2,22928,-2,13410.0,25,13415.0,1,B
2018-04-26 13:42:06,13415.0,2,22930,0,13410.0,25,13415.0,1,B
2018-04-26 13:42:07,13415.0,2,22932,-2,13410.0,21,13415.0,2,B
2018-04-26 13:42:19,13415.0,2,22934,0,13415.0,5,13420.0,17,B
2018-04-26 13:42:31,13420.0,18,22952,14,13415.0,12,13420.0,5,B
2018-04-26 13:42:32,13420.0,10,22962,8,13420.0,1,13425.0,4,B
2018-04-26 13:42:36,13420.0,2,22964,0,13420.0,4,13425.0,2,B
2018-04-26 13:42:38,13420.0,2,22966,0,13420.0,3,13425.0,13,B
2018-04-26 13:42:44,13420.0,14,22980,0,13420.0,44,13425.0,16,B
2018-04-26 13:42:45,13425.0,4,22984,4,13420.0,43,13425.0,27,B
2018-04-26 13:42:45,13420.0,2,22986,2,13420.0,42,13425.0,16,S
2018-04-26 13:42:54,13425.0,40,23026,-14,13420.0,42,13430.0,17,B
2018-04-26 13:42:55,13425.0,2,23028,-2,13420.0,46,13430.0,3,B
2018-04-26 13:42:56,13425.0,4,23032,0,13420.0,47,13430.0,5,B
2018-04-26 13:42:57,13425.0,2,23034,0,13420.0,48,13430.0,5,B
2018-04-26 13:43:00,13425.0,2,23036,0,13420.0,45,13430.0,5,B
2018-04-26 13:43:06,13425.0,2,23038,2,13425.0,6,13430.0,11,B
2018-04-26 13:43:07,13425.0,12,23050,0,13420.0,45,13430.0,10,B
2018-04-26 13:43:24,13420.0,12,23062,12,13420.0,36,13425.0,15,S
2018-04-26 13:43:47,13420.0,2,23064,0,13420.0,36,13425.0,17,S
2018-04-26 13:44:07,13420.0,2,23066,2,13420.0,35,13425.0,17,S
2018-04-26 13:44:11,13420.0,4,23070,0,13420.0,33,13425.0,18,S
2018-04-26 13:44:18,13420.0,2,23072,0,13420.0,32,13425.0,18,S
2018-04-26 13:44:22,13420.0,16,23088,16,13420.0,24,13425.0,18,S
2018-04-26 13:44:24,13420.0,16,23104,16,13420.0,16,13425.0,18,S
2018-04-26 13:44:28,13425.0,2,23106,-2,13420.0,16,13425.0,17,B
2018-04-26 13:44:52,13420.0,2,23108,0,13420.0,17,13425.0,17,S
2018-04-26 13:45:00,13425.0,34,23142,-14,13425.0,4,13430.0,18,B
2018-04-26 13:45:03,13425.0,8,23150,0,13420.0,22,13430.0,19,B
2018-04-26 13:45:15,13425.0,2,23152,0,13420.0,33,13430.0,23,B
2018-04-26 13:45:29,13420.0,6,23158,6,13420.0,15,13425.0,6,S
2018-04-26 13:45:33,13420.0,4,23162,0,13420.0,13,13425.0,5,S
2018-04-26 13:45:33,13420.0,6,23168,6,13420.0,10,13425.0,5,S
2018-04-26 13:45:36,13420.0,20,23188,-6,13415.0,20,13420.0,34,S
2018-04-26 13:45:47,13415.0,2,23190,-2,13415.0,8,13425.0,13,S
2018-04-26 13:45:52,13415.0,16,23206,-12,13410.0,31,13415.0,26,S
2018-04-26 13:45:53,13415.0,2,23208,-2,13410.0,36,13415.0,25,S
2018-04-26 13:45:53,13415.0,2,23210,-2,13410.0,25,13415.0,24,S
2018-04-26 13:45:54,13415.0,2,23212,-2,13410.0,25,13415.0,23,S
2018-04-26 13:45:54,13415.0,2,23214,-2,13410.0,25,13415.0,22,S
2018-04-26 13:45:55,13415.0,2,23216,-2,13410.0,25,13415.0,21,S
2018-04-26 13:45:55,13415.0,2,23218,-2,13410.0,25,13415.0,20,S
2018-04-26 13:45:56,13415.0,2,23220,-2,13410.0,25,13415.0,19,S
2018-04-26 13:45:56,13415.0,2,23222,-2,13410.0,25,13415.0,18,S
2018-04-26 13:45:57,13415.0,2,23224,-2,13410.0,25,13415.0,17,S
2018-04-26 13:45:57,13415.0,2,23226,-2,13410.0,25,13415.0,16,S
2018-04-26 13:45:58,13415.0,2,23228,-2,13410.0,25,13415.0,15,S
2018-04-26 13:45:58,13415.0,2,23230,-2,13410.0,25,13415.0,14,S
2018-04-26 13:45:59,13415.0,2,23232,-2,13410.0,25,13415.0,13,S
2018-04-26 13:45:59,13415.0,2,23234,-2,13410.0,25,13415.0,12,S
2018-04-26 13:46:00,13415.0,2,23236,-2,13410.0,13,13415.0,11,S
2018-04-26 13:46:00,13415.0,4,23240,-4,13410.0,11,13415.0,9,S
2018-04-26 13:46:01,13415.0,2,23242,-2,13410.0,11,13415.0,8,S
2018-04-26 13:46:18,13415.0,16,23258,-8,13415.0,6,13420.0,4,S
2018-04-26 13:46:29,13420.0,6,23264,-2,13415.0,10,13420.0,2,B
2018-04-26 13:46:29,13420.0,2,23266,2,13415.0,14,13420.0,1,B
2018-04-26 13:46:30,13420.0,2,23268,2,13420.0,22,13425.0,8,B
2018-04-26 13:46:36,13420.0,18,23286,6,13415.0,5,13420.0,17,B
2018-04-26 13:46:55,13420.0,4,23290,-2,13415.0,10,13425.0,27,B
2018-04-26 13:46:56,13420.0,2,23292,0,13415.0,9,13420.0,1,B
2018-04-26 13:47:10,13425.0,8,23300,-8,13420.0,2,13430.0,16,B
2018-04-26 13:47:11,13425.0,2,23302,2,13420.0,6,13425.0,2,B
2018-04-26 13:47:13,13425.0,4,23306,-4,13425.0,2,13430.0,16,B
2018-04-26 13:47:14,13430.0,2,23308,2,13425.0,3,13430.0,15,B
2018-04-26 13:47:14,13425.0,6,23314,-4,13420.0,13,13425.0,2,S
2018-04-26 13:47:19,13420.0,4,23318,-2,13415.0,2,13425.0,10,S
2018-04-26 13:47:20,13420.0,2,23320,0,13420.0,12,13425.0,9,S
2018-04-26 13:47:21,13425.0,2,23322,0,13420.0,23,13430.0,18,B
2018-04-26 13:47:32,13425.0,2,23324,0,13425.0,2,13430.0,13,B
2018-04-26 13:47:55,13430.0,2,23326,-2,13425.0,11,13430.0,10,B
2018-04-26 13:47:59,13430.0,10,23336,-6,13425.0,6,13430.0,5,B
2018-04-26 13:48:00,13430.0,10,23346,0,13425.0,14,13435.0,9,B
2018-04-26 13:48:06,13430.0,2,23348,0,13430.0,2,13435.0,7,B
2018-04-26 13:48:06,13430.0,4,23352,2,13425.0,15,13435.0,23,B
2018-04-26 13:48:13,13430.0,4,23356,0,13425.0,40,13435.0,12,B
2018-04-26 13:48:19,13425.0,4,23360,-4,13420.0,23,13430.0,5,S
2018-04-26 13:48:44,13430.0,4,23364,0,13425.0,10,13430.0,6,B
2018-04-26 13:48:48,13430.0,12,23376,-8,13425.0,32,13435.0,10,B
2018-04-26 13:48:51,13430.0,10,23386,-2,13425.0,17,13435.0,25,B
2018-04-26 13:48:52,13430.0,2,23388,2,13425.0,20,13430.0,1,B
2018-04-26 13:48:52,13430.0,2,23390,0,13425.0,20,13435.0,6,B
2018-04-26 13:48:56,13430.0,2,23392,2,13425.0,17,13435.0,13,B
2018-04-26 13:49:05,13435.0,2,23394,0,13430.0,6,13435.0,12,B
2018-04-26 13:49:07,13430.0,12,23406,4,13425.0,21,13435.0,14,S
2018-04-26 13:49:08,13435.0,2,23408,0,13425.0,21,13435.0,13,B
2018-04-26 13:49:18,13430.0,8,23416,-4,13430.0,1,13435.0,15,S
2018-04-26 13:49:19,13430.0,2,23418,0,13425.0,21,13435.0,15,S
2018-04-26 13:49:35,13435.0,10,23428,4,13425.0,17,13435.0,11,B
2018-04-26 13:50:08,13430.0,8,23436,-4,13425.0,13,13430.0,1,S
2018-04-26 13:50:52,13430.0,2,23438,0,13425.0,10,13430.0,6,S
2018-04-26 13:51:04,13425.0,2,23440,-2,13425.0,10,13430.0,12,S
2018-04-26 13:51:04,13425.0,20,23460,0,13420.0,8,13430.0,12,S
2018-04-26 13:51:12,13420.0,2,23462,0,13420.0,14,13425.0,8,S
2018-04-26 13:51:22,13420.0,2,23464,0,13420.0,3,13425.0,8,S
2018-04-26 13:51:43,13425.0,2,23466,2,13420.0,1,13425.0,7,B
2018-04-26 13:52:09,13420.0,2,23468,0,13415.0,17,13425.0,4,S
2018-04-26 13:52:21,13425.0,2,23470,2,13420.0,22,13425.0,4,B
2018-04-26 13:52:21,13425.0,4,23474,4,13420.0,34,13430.0,15,B
2018-04-26 13:52:40,13425.0,2,23476,2,13420.0,40,13430.0,15,B
2018-04-26 13:53:01,13430.0,16,23492,-12,13430.0,5,13435.0,21,B
2018-04-26 13:53:36,13430.0,2,23494,2,13430.0,7,13435.0,19,B
2018-04-26 13:53:45,13435.0,32,23526,2,13430.0,21,13435.0,4,B
2018-04-26 13:54:00,13435.0,4,23530,0,13430.0,21,13435.0,4,B
2018-04-26 13:54:12,13430.0,6,23536,6,13430.0,18,13435.0,5,S
2018-04-26 13:54:32,13430.0,4,23540,4,13425.0,5,13435.0,17,S
2018-04-26 13:55:18,13435.0,20,23560,-8,13430.0,8,13440.0,6,B
2018-04-26 13:55:20,13435.0,4,23564,0,13430.0,9,13440.0,9,B
2018-04-26 13:55:51,13435.0,4,23568,0,13430.0,24,13435.0,1,B
2018-04-26 13:55:51,13435.0,2,23570,0,13430.0,24,13440.0,13,B
2018-04-26 13:55:55,13435.0,2,23572,0,13435.0,4,13440.0,14,B
2018-04-26 13:56:12,13435.0,2,23574,2,13435.0,4,13440.0,7,B
2018-04-26 13:56:17,13435.0,2,23576,2,13435.0,3,13440.0,7,B
2018-04-26 13:56:23,13435.0,6,23582,0,13430.0,19,13440.0,13,B
2018-04-26 13:56:31,13430.0,2,23584,0,13430.0,6,13435.0,27,S
2018-04-26 13:56:43,13430.0,2,23586,2,13430.0,8,13435.0,13,S
2018-04-26 13:56:58,13430.0,2,23588,0,13430.0,7,13435.0,10,S
2018-04-26 13:57:01,13430.0,2,23590,-2,13430.0,6,13435.0,11,S
2018-04-26 13:57:04,13430.0,2,23592,-2,13430.0,5,13435.0,11,S
2018-04-26 13:57:10,13430.0,10,23602,-4,13425.0,17,13430.0,3,S
2018-04-26 13:57:11,13425.0,6,23608,2,13420.0,20,13425.0,1,S
2018-04-26 13:57:16,13420.0,10,23618,8,13420.0,2,13425.0,11,S
2018-04-26 13:57:16,13420.0,4,23622,-2,13415.0,10,13425.0,11,S
2018-04-26 13:57:22,13420.0,2,23624,0,13420.0,14,13425.0,2,S
2018-04-26 13:57:32,13420.0,2,23626,0,13420.0,13,13425.0,1,S
2018-04-26 13:57:33,13425.0,2,23628,-2,13420.0,13,13430.0,20,B
2018-04-26 13:57:34,13430.0,26,23654,-14,13430.0,113,13435.0,16,B
2018-04-26 13:57:35,13430.0,108,23762,-36,13430.0,59,13435.0,13,B
2018-04-26 13:57:35,13430.0,118,23880,-118,13425.0,3,13430.0,5,B
2018-04-26 13:57:47,13425.0,2,23882,2,13420.0,6,13430.0,8,S
2018-04-26 13:57:47,13420.0,4,23886,4,13420.0,9,13430.0,11,S
2018-04-26 13:57:57,13420.0,4,23890,2,13415.0,8,13420.0,2,S
2018-04-26 13:57:58,13415.0,8,23898,8,13415.0,1,13420.0,11,S
2018-04-26 13:58:22,13415.0,2,23900,2,13410.0,19,13420.0,10,S
2018-04-26 13:58:26,13415.0,2,23902,-2,13415.0,7,13420.0,8,S
2018-04-26 13:58:27,13415.0,14,23916,-14,13410.0,21,13420.0,8,S
2018-04-26 13:58:34,13415.0,2,23918,-2,13415.0,21,13420.0,12,S
2018-04-26 13:58:55,13415.0,10,23928,0,13415.0,17,13420.0,10,S
2018-04-26 13:59:13,13420.0,18,23946,-12,13415.0,21,13425.0,23,B
2018-04-26 13:59:30,13420.0,2,23948,0,13415.0,22,13425.0,21,B
2018-04-26 13:59:59,13420.0,8,23956,0,13420.0,11,13425.0,10,B
2018-04-26 14:00:00,13420.0,22,23978,-22,13415.0,7,13425.0,9,B
2018-04-26 14:00:37,13415.0,2,23980,-2,13415.0,3,13420.0,1,S
2018-04-26 14:01:17,13415.0,2,23982,0,13415.0,4,13420.0,5,S
2018-04-26 14:01:20,13415.0,4,23986,-4,13410.0,21,13420.0,5,S
2018-04-26 14:01:20,13415.0,2,23988,0,13410.0,23,13420.0,6,S
2018-04-26 14:01:59,13415.0,2,23990,-2,13415.0,1,13420.0,8,S
2018-04-26 14:02:07,13420.0,12,24002,-4,13415.0,11,13425.0,8,B
2018-04-26 14:02:28,13420.0,2,24004,0,13415.0,11,13420.0,2,B
2018-04-26 14:02:28,13420.0,4,24008,0,13415.0,11,13425.0,8,B
2018-04-26 14:02:38,13420.0,8,24016,-8,13415.0,9,13425.0,24,B
2018-04-26 14:03:09,13425.0,2,24018,-2,13415.0,13,13425.0,5,B
2018-04-26 14:03:09,13415.0,2,24020,-2,13415.0,12,13425.0,5,S
2018-04-26 14:03:25,13420.0,2,24022,0,13415.0,12,13425.0,2,B
2018-04-26 14:03:45,13420.0,2,24024,0,13415.0,12,13425.0,4,B
2018-04-26 14:04:37,13425.0,2,24026,-2,13415.0,12,13425.0,5,B
2018-04-26 14:04:51,13425.0,2,24028,2,13420.0,2,13425.0,5,B
2018-04-26 14:04:55,13420.0,2,24030,0,13415.0,11,13425.0,12,S
2018-04-26 14:05:25,13425.0,2,24032,2,13415.0,7,13425.0,16,B
2018-04-26 14:06:36,13415.0,12,24044,4,13415.0,2,13420.0,1,S
2018-04-26 14:06:37,13415.0,6,24050,0,13415.0,2,13420.0,9,S
2018-04-26 14:06:37,13415.0,4,24054,-2,13410.0,28,13420.0,15,S
2018-04-26 14:06:57,13415.0,6,24060,0,13410.0,23,13420.0,20,S
2018-04-26 14:07:23,13420.0,2,24062,0,13415.0,23,13420.0,3,B
2018-04-26 14:07:23,13420.0,6,24068,-4,13415.0,23,13425.0,15,B
2018-04-26 14:07:25,13415.0,2,24070,0,13415.0,22,13425.0,24,S
2018-04-26 14:07:27,13415.0,20,24090,18,13415.0,12,13425.0,24,S
2018-04-26 14:07:57,13415.0,20,24110,10,13415.0,19,13425.0,6,S
2018-04-26 14:09:02,13415.0,2,24112,0,13415.0,2,13420.0,15,S
2018-04-26 14:09:11,13415.0,6,24118,2,13410.0,40,13415.0,3,S
2018-04-26 14:09:26,13415.0,10,24128,-4,13410.0,22,13420.0,13,S
2018-04-26 14:09:27,13415.0,14,24142,-14,13415.0,4,13420.0,9,S
2018-04-26 14:09:49,13415.0,2,24144,-2,13410.0,38,13420.0,11,S
2018-04-26 14:10:21,13415.0,2,24146,0,13410.0,24,13420.0,20,S
2018-04-26 14:10:33,13420.0,2,24148,2,13415.0,7,13420.0,5,B
2018-04-26 14:10:33,13415.0,4,24152,0,13415.0,5,13420.0,5,S
2018-04-26 14:11:06,13415.0,2,24154,0,13410.0,33,13420.0,10,S
2018-04-26 14:11:08,13410.0,4,24158,4,13410.0,31,13420.0,12,S
2018-04-26 14:11:10,13415.0,2,24160,-2,13410.0,31,13420.0,14,B
2018-04-26 14:11:33,13410.0,2,24162,0,13410.0,43,13420.0,14,S
2018-04-26 14:12:01,13420.0,2,24164,0,13415.0,2,13420.0,13,B
2018-04-26 14:12:21,13420.0,32,24196,-2,13415.0,18,13425.0,11,B
2018-04-26 14:13:26,13415.0,4,24200,2,13415.0,13,13425.0,12,S
2018-04-26 14:13:33,13425.0,12,24212,2,13415.0,13,13425.0,6,B
2018-04-26 14:13:42,13420.0,4,24216,2,13420.0,1,13425.0,5,S
2018-04-26 14:14:06,13420.0,2,24218,0,13415.0,25,13425.0,8,S
2018-04-26 14:14:36,13420.0,2,24220,-2,13415.0,10,13420.0,6,S
2018-04-26 14:14:51,13415.0,14,24234,6,13415.0,2,13420.0,10,S
2018-04-26 14:14:52,13415.0,4,24238,0,13410.0,34,13420.0,12,S
2018-04-26 14:15:17,13415.0,2,24240,0,13410.0,30,13415.0,3,S
2018-04-26 14:15:19,13415.0,4,24244,2,13410.0,29,13415.0,1,S
2018-04-26 14:15:20,13415.0,2,24246,2,13410.0,29,13420.0,11,S
2018-04-26 14:16:40,13410.0,4,24250,-4,13410.0,23,13415.0,6,S
2018-04-26 14:16:41,13410.0,8,24258,-8,13410.0,19,13415.0,21,S
2018-04-26 14:16:43,13410.0,6,24264,0,13410.0,20,13415.0,4,S
2018-04-26 14:17:11,13410.0,12,24276,0,13410.0,10,13415.0,28,S
2018-04-26 14:17:33,13410.0,2,24278,0,13410.0,9,13415.0,7,S
2018-04-26 14:17:35,13415.0,14,24292,0,13415.0,43,13420.0,31,B
2018-04-26 14:17:35,13415.0,30,24322,-24,13415.0,28,13420.0,36,B
2018-04-26 14:17:36,13415.0,56,24378,0,13410.0,12,13415.0,4,B
2018-04-26 14:17:37,13410.0,4,24382,-2,13410.0,8,13415.0,3,S
2018-04-26 14:17:37,13410.0,4,24386,0,13410.0,6,13415.0,1,S
2018-04-26 14:17:46,13415.0,6,24392,-4,13415.0,47,13420.0,41,B
2018-04-26 14:17:46,13415.0,14,24406,-8,13415.0,40,13420.0,39,B
2018-04-26 14:17:47,13415.0,4,24410,-4,13415.0,38,13420.0,38,B
2018-04-26 14:17:47,13415.0,14,24424,-14,13415.0,32,13420.0,37,B
2018-04-26 14:17:48,13415.0,8,24432,-8,13415.0,28,13420.0,38,B
2018-04-26 14:17:48,13415.0,8,24440,-8,13415.0,24,13420.0,24,B
2018-04-26 14:17:49,13415.0,8,24448,-8,13415.0,20,13420.0,24,B
2018-04-26 14:17:49,13415.0,8,24456,-8,13415.0,16,13420.0,24,B
2018-04-26 14:17:50,13415.0,8,24464,-8,13415.0,12,13420.0,24,B
2018-04-26 14:17:50,13415.0,4,24468,-4,13415.0,10,13420.0,22,B
2018-04-26 14:17:51,13415.0,8,24476,-8,13415.0,6,13420.0,22,B
2018-04-26 14:17:51,13415.0,8,24484,-8,13415.0,8,13420.0,19,B
2018-04-26 14:17:52,13420.0,16,24500,0,13415.0,4,13420.0,6,B
2018-04-26 14:17:52,13415.0,8,24508,-8,13410.0,6,13420.0,10,S
2018-04-26 14:17:54,13410.0,12,24520,-12,13405.0,5,13415.0,6,S
2018-04-26 14:17:55,13410.0,10,24530,0,13405.0,18,13415.0,2,S
2018-04-26 14:18:56,13410.0,4,24534,0,13410.0,4,13415.0,1,S
2018-04-26 14:19:27,13410.0,6,24540,-4,13405.0,4,13410.0,1,S
2018-04-26 14:19:29,13405.0,6,24546,-4,13405.0,1,13415.0,13,S
2018-04-26 14:19:37,13415.0,6,24552,-2,13415.0,47,13420.0,16,B
2018-04-26 14:19:38,13415.0,4,24556,-4,13415.0,48,13420.0,21,B
2018-04-26 14:19:38,13415.0,12,24568,-12,13415.0,42,13420.0,33,B
2018-04-26 14:19:39,13415.0,4,24572,-4,13415.0,40,13420.0,29,B
2018-04-26 14:19:39,13415.0,10,24582,-10,13415.0,35,13420.0,31,B
2018-04-26 14:19:40,13415.0,70,24652,-70,13410.0,3,13415.0,3,B
2018-04-26 14:19:41,13410.0,4,24656,-4,13410.0,1,13415.0,10,S
2018-04-26 14:19:43,13410.0,2,24658,-2,13410.0,1,13415.0,10,S
2018-04-26 14:19:43,13410.0,2,24660,-2,13405.0,5,13410.0,5,S
2018-04-26 14:19:44,13405.0,8,24668,-6,13400.0,67,13415.0,19,S
2018-04-26 14:19:48,13415.0,12,24680,-2,13405.0,30,13415.0,11,B
2018-04-26 14:19:55,13415.0,16,24696,-8,13415.0,42,13420.0,15,B
2018-04-26 14:19:56,13415.0,14,24710,-12,13415.0,35,13420.0,19,B
2018-04-26 14:19:56,13415.0,12,24722,-10,13415.0,29,13420.0,17,B
2018-04-26 14:19:57,13415.0,8,24730,-8,13415.0,25,13420.0,17,B
2018-04-26 14:19:57,13420.0,12,24742,-4,13415.0,21,13420.0,15,B
2018-04-26 14:19:58,13415.0,4,24746,-4,13415.0,19,13420.0,16,S
2018-04-26 14:19:58,13415.0,8,24754,-8,13415.0,15,13420.0,15,S
2018-04-26 14:19:59,13415.0,8,24762,-8,13415.0,11,13420.0,16,S
2018-04-26 14:19:59,13415.0,8,24770,-8,13415.0,7,13420.0,16,S
2018-04-26 14:20:00,13415.0,8,24778,-8,13415.0,3,13420.0,16,S
2018-04-26 14:20:00,13415.0,6,24784,-6,13410.0,6,13415.0,1,S
2018-04-26 14:20:02,13410.0,10,24794,0,13410.0,1,13415.0,9,S
2018-04-26 14:20:02,13410.0,2,24796,0,13405.0,9,13410.0,1,S
2018-04-26 14:20:03,13410.0,6,24802,-2,13405.0,9,13415.0,9,S
2018-04-26 14:20:04,13410.0,4,24806,0,13410.0,2,13415.0,8,S
2018-04-26 14:20:06,13415.0,6,24812,-2,13415.0,47,13420.0,11,B
2018-04-26 14:20:06,13415.0,8,24820,-8,13415.0,43,13420.0,15,B
2018-04-26 14:20:07,13415.0,12,24832,-12,13415.0,37,13420.0,13,B
2018-04-26 14:20:07,13415.0,4,24836,-4,13415.0,35,13420.0,13,B
2018-04-26 14:20:08,13415.0,12,24848,-12,13415.0,34,13420.0,13,B
2018-04-26 14:20:08,13415.0,4,24852,-4,13415.0,32,13420.0,13,B
2018-04-26 14:20:09,13415.0,4,24856,-4,13415.0,30,13420.0,13,B
2018-04-26 14:20:09,13415.0,12,24868,-12,13415.0,24,13420.0,13,B
2018-04-26 14:20:10,13415.0,12,24880,-12,13415.0,18,13420.0,13,B
2018-04-26 14:20:10,13415.0,4,24884,-4,13415.0,16,13420.0,13,B
2018-04-26 14:20:11,13415.0,4,24888,-4,13415.0,14,13420.0,13,B
2018-04-26 14:20:11,13415.0,18,24906,-4,13415.0,5,13420.0,13,B
2018-04-26 14:20:12,13415.0,10,24916,6,13410.0,4,13415.0,3,B
2018-04-26 14:20:13,13410.0,4,24920,-4,13410.0,2,13415.0,14,S
2018-04-26 14:20:13,13410.0,4,24924,-4,13410.0,2,13415.0,10,S
2018-04-26 14:20:15,13410.0,2,24926,-2,13405.0,11,13410.0,1,S
2018-04-26 14:20:15,13410.0,2,24928,-2,13405.0,11,13415.0,8,S
2018-04-26 14:20:19,13415.0,26,24954,-14,13415.0,39,13420.0,11,B
2018-04-26 14:20:19,13415.0,38,24992,-30,13415.0,20,13420.0,19,B
2018-04-26 14:20:20,13415.0,40,25032,-12,13410.0,6,13415.0,5,B
2018-04-26 14:20:21,13410.0,4,25036,-2,13410.0,2,13415.0,7,S
2018-04-26 14:20:22,13410.0,2,25038,0,13410.0,1,13415.0,7,S
2018-04-26 14:20:23,13410.0,2,25040,2,13405.0,13,13415.0,7,S
2018-04-26 14:20:25,13415.0,26,25066,-6,13415.0,37,13420.0,13,B
2018-04-26 14:20:25,13415.0,20,25086,-6,13415.0,30,13420.0,21,B
2018-04-26 14:20:26,13415.0,22,25108,-18,13415.0,16,13420.0,19,B
2018-04-26 14:20:26,13415.0,12,25120,-12,13415.0,10,13420.0,19,B
2018-04-26 14:20:27,13415.0,6,25126,-6,13415.0,7,13420.0,19,B
2018-04-26 14:20:27,13415.0,2,25128,-2,13415.0,6,13420.0,19,B
2018-04-26 14:20:28,13415.0,2,25130,-2,13415.0,5,13420.0,19,B
2018-04-26 14:20:28,13415.0,2,25132,-2,13415.0,4,13420.0,17,B
2018-04-26 14:20:29,13415.0,2,25134,0,13415.0,5,13420.0,8,B
2018-04-26 14:20:30,13415.0,2,25136,-2,13415.0,2,13420.0,8,B
2018-04-26 14:20:31,13415.0,4,25140,-4,13415.0,1,13420.0,17,B
2018-04-26 14:20:31,13415.0,2,25142,0,13410.0,4,13420.0,18,B
2018-04-26 14:20:34,13410.0,2,25144,-2,13410.0,5,13415.0,2,S
2018-04-26 14:20:35,13415.0,4,25148,2,13415.0,18,13420.0,16,B
2018-04-26 14:20:39,13415.0,10,25158,10,13415.0,15,13420.0,9,B
2018-04-26 14:20:50,13415.0,4,25162,0,13415.0,11,13420.0,22,B
2018-04-26 14:21:00,13415.0,10,25172,10,13415.0,6,13420.0,23,B
2018-04-26 14:21:01,13415.0,2,25174,0,13415.0,5,13420.0,23,B
2018-04-26 14:21:08,13415.0,6,25180,0,13415.0,2,13420.0,23,B
2018-04-26 14:21:24,13415.0,8,25188,0,13410.0,2,13420.0,23,B
2018-04-26 14:21:25,13410.0,4,25192,2,13410.0,3,13415.0,15,S
2018-04-26 14:21:26,13410.0,6,25198,0,13405.0,10,13415.0,26,S
2018-04-26 14:21:26,13415.0,64,25262,-6,13415.0,18,13420.0,11,B
2018-04-26 14:21:27,13415.0,18,25280,-10,13415.0,9,13420.0,16,B
2018-04-26 14:21:27,13415.0,18,25298,0,13410.0,2,13420.0,16,B
2018-04-26 14:21:35,13410.0,4,25302,-2,13405.0,6,13415.0,6,S
2018-04-26 14:21:35,13415.0,24,25326,-2,13415.0,38,13420.0,22,B
2018-04-26 14:21:37,13415.0,40,25366,0,13415.0,18,13420.0,9,B
2018-04-26 14:21:37,13415.0,6,25372,-2,13415.0,15,13420.0,10,B
2018-04-26 14:21:38,13410.0,36,25408,-24,13405.0,7,13415.0,12,S
2018-04-26 14:21:42,13415.0,18,25426,-4,13415.0,41,13420.0,37,B
2018-04-26 14:21:43,13415.0,46,25472,-22,13415.0,18,13420.0,41,B
2018-04-26 14:21:43,13415.0,36,25508,-8,13410.0,3,13415.0,1,B
2018-04-26 14:21:45,13410.0,6,25514,2,13405.0,9,13410.0,1,S
2018-04-26 14:21:54,13415.0,26,25540,-6,13415.0,37,13420.0,29,B
2018-04-26 14:21:55,13415.0,42,25582,-2,13415.0,16,13420.0,48,B
2018-04-26 14:21:55,13415.0,32,25614,0,13410.0,3,13415.0,6,B
2018-04-26 14:21:56,13415.0,4,25618,0,13410.0,2,13415.0,4,B
2018-04-26 14:21:59,13415.0,18,25636,-2,13415.0,41,13420.0,16,B
2018-04-26 14:22:00,13415.0,10,25646,0,13415.0,36,13420.0,14,B
2018-04-26 14:22:01,13415.0,2,25648,0,13415.0,35,13420.0,14,B
2018-04-26 14:22:02,13415.0,2,25650,-2,13415.0,34,13420.0,19,B
2018-04-26 14:22:03,13415.0,2,25652,-2,13415.0,33,13420.0,21,B
2018-04-26 14:22:04,13420.0,2,25654,0,13415.0,35,13420.0,20,B
2018-04-26 14:22:05,13420.0,40,25694,-2,13420.0,18,13425.0,16,B
2018-04-26 14:22:05,13420.0,8,25702,0,13420.0,10,13425.0,11,B
2018-04-26 14:22:06,13425.0,22,25724,12,13420.0,10,13430.0,8,B
2018-04-26 14:22:14,13420.0,18,25742,-12,13415.0,35,13420.0,11,S
2018-04-26 14:22:14,13420.0,28,25770,2,13420.0,2,13425.0,2,S
2018-04-26 14:22:25,13425.0,48,25818,-42,13425.0,1,13430.0,5,B
2018-04-26 14:22:26,13430.0,2,25820,2,13425.0,6,13435.0,5,B
2018-04-26 14:22:29,13425.0,10,25830,10,13425.0,3,13435.0,9,S
2018-04-26 14:22:32,13425.0,10,25840,6,13420.0,12,13435.0,8,S
2018-04-26 14:22:54,13425.0,2,25842,-2,13425.0,10,13430.0,5,S
2018-04-26 14:22:55,13425.0,20,25862,2,13420.0,12,13430.0,5,S
2018-04-26 14:23:10,13430.0,16,25878,-4,13430.0,12,13435.0,13,B
2018-04-26 14:23:11,13430.0,16,25894,-2,13430.0,4,13435.0,16,B
2018-04-26 14:23:11,13430.0,8,25902,0,13425.0,2,13430.0,1,B
2018-04-26 14:23:21,13430.0,4,25906,-2,13430.0,31,13435.0,22,B
2018-04-26 14:23:27,13435.0,16,25922,0,13430.0,33,13440.0,8,B
2018-04-26 14:23:29,13435.0,10,25932,0,13430.0,33,13440.0,16,B
2018-04-26 14:23:41,13435.0,16,25948,-6,13435.0,23,13440.0,17,B
2018-04-26 14:23:42,13440.0,2,25950,-2,13435.0,24,13440.0,13,B
2018-04-26 14:23:44,13440.0,4,25954,-2,13435.0,24,13440.0,11,B
2018-04-26 14:23:49,13435.0,2,25956,-2,13435.0,23,13440.0,11,S
2018-04-26 14:23:51,13440.0,22,25978,12,13435.0,25,13445.0,9,B
2018-04-26 14:23:59,13445.0,2,25980,0,13440.0,8,13445.0,8,B
2018-04-26 14:24:01,13440.0,2,25982,-2,13440.0,7,13445.0,8,S
2018-04-26 14:24:04,13440.0,10,25992,-4,13435.0,25,13440.0,14,S
2018-04-26 14:24:04,13435.0,2,25994,-2,13435.0,22,13440.0,16,S
2018-04-26 14:24:13,13440.0,30,26024,-6,13440.0,6,13445.0,10,B
2018-04-26 14:24:14,13440.0,18,26042,-2,13435.0,3,13440.0,7,B
2018-04-26 14:24:17,13435.0,2,26044,0,13435.0,5,13440.0,8,S
2018-04-26 14:24:20,13435.0,6,26050,2,13435.0,2,13440.0,7,S
2018-04-26 14:24:27,13440.0,14,26064,-12,13440.0,13,13445.0,9,B
2018-04-26 14:24:28,13440.0,26,26090,-26,13435.0,7,13445.0,7,B
2018-04-26 14:24:39,13440.0,10,26100,0,13440.0,15,13445.0,13,B
2018-04-26 14:24:39,13440.0,30,26130,0,13435.0,3,13440.0,7,B
2018-04-26 14:24:42,13435.0,2,26132,-2,13430.0,4,13440.0,3,S
2018-04-26 14:24:46,13440.0,6,26138,-4,13440.0,17,13445.0,12,B
2018-04-26 14:24:46,13440.0,14,26152,-6,13440.0,10,13445.0,12,B
2018-04-26 14:24:51,13440.0,2,26154,0,13440.0,9,13445.0,13,B
2018-04-26 14:24:59,13440.0,2,26156,0,13440.0,8,13445.0,15,B
2018-04-26 14:25:03,13440.0,2,26158,0,13440.0,7,13445.0,15,B
2018-04-26 14:25:03,13440.0,2,26160,0,13440.0,6,13445.0,15,B
2018-04-26 14:25:04,13440.0,4,26164,-4,13440.0,4,13445.0,15,B
2018-04-26 14:25:10,13440.0,2,26166,0,13440.0,3,13445.0,18,B
2018-04-26 14:25:12,13440.0,2,26168,-2,13440.0,2,13445.0,18,B
2018-04-26 14:25:12,13440.0,4,26172,-4,13435.0,2,13445.0,18,B
2018-04-26 14:25:14,13445.0,40,26212,-20,13435.0,3,13445.0,2,B
2018-04-26 14:25:17,13440.0,2,26214,2,13440.0,3,13445.0,2,S
2018-04-26 14:25:24,13445.0,22,26236,-4,13445.0,9,13450.0,29,B
2018-04-26 14:25:24,13445.0,18,26254,-2,13440.0,4,13445.0,4,B
2018-04-26 14:25:25,13450.0,8,26262,4,13440.0,4,13450.0,35,B
2018-04-26 14:25:26,13450.0,2,26264,-2,13440.0,4,13450.0,37,B
2018-04-26 14:25:26,13450.0,2,26266,0,13440.0,4,13450.0,36,B
2018-04-26 14:25:27,13450.0,8,26274,8,13440.0,4,13450.0,32,B
2018-04-26 14:25:30,13445.0,32,26306,-2,13445.0,5,13450.0,27,S
2018-04-26 14:25:32,13445.0,4,26310,-4,13445.0,4,13450.0,26,S
2018-04-26 14:25:35,13445.0,8,26318,2,13440.0,6,13445.0,1,S
2018-04-26 14:25:38,13440.0,2,26320,2,13440.0,4,13445.0,4,S
2018-04-26 14:25:44,13445.0,10,26330,0,13445.0,15,13450.0,25,B
2018-04-26 14:25:48,13445.0,2,26332,0,13445.0,14,13450.0,27,B
2018-04-26 14:26:00,13445.0,4,26336,0,13445.0,12,13450.0,30,B
2018-04-26 14:26:04,13445.0,6,26342,-4,13445.0,10,13450.0,28,B
2018-04-26 14:26:13,13450.0,26,26368,0,13445.0,14,13450.0,8,B
2018-04-26 14:26:13,13450.0,2,26370,0,13445.0,14,13450.0,7,B
2018-04-26 14:26:26,13450.0,2,26372,0,13445.0,14,13450.0,7,B
2018-04-26 14:26:28,13450.0,14,26386,12,13445.0,14,13455.0,7,B
2018-04-26 14:26:35,13455.0,24,26410,-10,13445.0,15,13455.0,2,B
2018-04-26 14:26:36,13455.0,2,26412,-2,13450.0,2,13460.0,17,B
2018-04-26 14:26:45,13455.0,20,26432,-16,13455.0,11,13460.0,12,B
2018-04-26 14:26:47,13455.0,6,26438,0,13455.0,8,13460.0,13,B
2018-04-26 14:26:47,13455.0,16,26454,-4,13450.0,5,13455.0,1,B
2018-04-26 14:26:49,13450.0,2,26456,-2,13450.0,4,13455.0,1,S
2018-04-26 14:26:50,13460.0,24,26480,-6,13450.0,4,13460.0,4,B
2018-04-26 14:26:50,13460.0,10,26490,0,13450.0,5,13455.0,1,B
2018-04-26 14:26:51,13455.0,2,26492,-2,13450.0,5,13460.0,1,S
2018-04-26 14:26:55,13460.0,4,26496,-2,13450.0,6,13460.0,2,B
2018-04-26 14:26:57,13460.0,18,26514,18,13460.0,36,13465.0,31,B
2018-04-26 14:26:58,13460.0,44,26558,24,13460.0,14,13465.0,41,B
2018-04-26 14:26:58,13460.0,32,26590,32,13455.0,2,13465.0,23,B
2018-04-26 14:26:59,13460.0,2,26592,0,13455.0,5,13465.0,18,B
2018-04-26 14:27:00,13460.0,2,26594,2,13455.0,5,13460.0,1,B
2018-04-26 14:27:01,13460.0,2,26596,2,13455.0,5,13465.0,18,B
2018-04-26 14:27:02,13465.0,40,26636,-6,13455.0,5,13465.0,3,B
2018-04-26 14:27:06,13465.0,8,26644,-2,13465.0,8,13470.0,28,B
2018-04-26 14:27:06,13465.0,14,26658,-6,13465.0,1,13470.0,32,B
2018-04-26 14:27:07,13465.0,2,26660,0,13460.0,4,13465.0,3,B
2018-04-26 14:27:08,13465.0,2,26662,2,13460.0,4,13465.0,3,B
2018-04-26 14:27:08,13460.0,8,26670,8,13455.0,5,13465.0,3,S
2018-04-26 14:27:09,13470.0,6,26676,-2,13465.0,18,13470.0,30,B
2018-04-26 14:27:09,13465.0,2,26678,0,13465.0,17,13470.0,32,S
2018-04-26 14:27:10,13465.0,2,26680,0,13465.0,16,13470.0,32,S
2018-04-26 14:27:10,13465.0,6,26686,-4,13465.0,13,13470.0,32,S
2018-04-26 14:27:11,13465.0,2,26688,0,13465.0,12,13470.0,32,S
2018-04-26 14:27:11,13470.0,4,26692,0,13465.0,11,13470.0,31,B
2018-04-26 14:27:12,13470.0,22,26714,0,13465.0,10,13470.0,21,B
2018-04-26 14:27:12,13465.0,2,26716,0,13465.0,9,13470.0,21,S
2018-04-26 14:27:13,13465.0,2,26718,0,13465.0,8,13470.0,30,S
2018-04-26 14:27:13,13465.0,12,26730,0,13465.0,2,13470.0,30,S
2018-04-26 14:27:14,13465.0,2,26732,0,13465.0,1,13470.0,30,S
2018-04-26 14:27:14,13465.0,2,26734,0,13460.0,4,13470.0,30,S
2018-04-26 14:27:15,13465.0,2,26736,2,13460.0,7,13470.0,34,S
2018-04-26 14:27:18,13460.0,2,26738,0,13460.0,6,13465.0,2,S
2018-04-26 14:27:19,13465.0,6,26744,-4,13465.0,4,13470.0,31,B
2018-04-26 14:27:20,13465.0,6,26750,-4,13465.0,10,13470.0,34,B
2018-04-26 14:27:21,13465.0,22,26772,-16,13460.0,6,13470.0,34,B
2018-04-26 14:27:27,13465.0,2,26774,0,13465.0,22,13470.0,34,B
2018-04-26 14:27:27,13465.0,2,26776,0,13465.0,21,13470.0,33,B
2018-04-26 14:27:28,13465.0,2,26778,0,13465.0,20,13470.0,35,B
2018-04-26 14:27:33,13465.0,2,26780,0,13465.0,19,13470.0,35,B
2018-04-26 14:27:34,13470.0,2,26782,2,13465.0,19,13470.0,31,B
2018-04-26 14:27:34,13470.0,16,26798,0,13465.0,21,13470.0,24,B
2018-04-26 14:27:35,13465.0,2,26800,0,13465.0,18,13470.0,28,S
2018-04-26 14:27:38,13465.0,2,26802,-2,13465.0,17,13470.0,34,S
2018-04-26 14:27:44,13465.0,2,26804,0,13465.0,20,13470.0,30,S
2018-04-26 14:27:48,13465.0,10,26814,0,13465.0,12,13470.0,31,S
2018-04-26 14:27:52,13465.0,2,26816,0,13465.0,11,13470.0,28,S
2018-04-26 14:27:53,13465.0,16,26832,-2,13465.0,5,13470.0,25,S
2018-04-26 14:27:54,13465.0,10,26842,-10,13460.0,5,13465.0,10,S
2018-04-26 14:27:54,13465.0,2,26844,-2,13460.0,8,13465.0,9,S
2018-04-26 14:27:59,13465.0,4,26848,-2,13460.0,8,13465.0,7,S
2018-04-26 14:27:59,13465.0,14,26862,-14,13460.0,8,13470.0,30,S
2018-04-26 14:28:01,13465.0,2,26864,0,13465.0,3,13470.0,31,S
2018-04-26 14:28:02,13465.0,6,26870,-6,13460.0,8,13465.0,6,S
2018-04-26 14:28:04,13460.0,2,26872,-2,13460.0,7,13465.0,6,S
2018-04-26 14:28:06,13465.0,12,26884,-12,13460.0,7,13465.0,1,B
2018-04-26 14:28:06,13465.0,2,26886,-2,13460.0,7,13470.0,21,B
2018-04-26 14:28:18,13470.0,6,26892,-4,13465.0,24,13470.0,22,B
2018-04-26 14:28:21,13465.0,8,26900,-6,13460.0,6,13465.0,1,S
2018-04-26 14:28:21,13465.0,2,26902,-2,13465.0,11,13470.0,21,S
2018-04-26 14:28:24,13465.0,8,26910,-8,13460.0,6,13465.0,16,S
2018-04-26 14:28:25,13465.0,32,26942,-32,13460.0,6,13470.0,17,S
2018-04-26 14:28:26,13465.0,2,26944,0,13465.0,5,13470.0,15,S
2018-04-26 14:28:26,13465.0,2,26946,-2,13465.0,4,13470.0,15,S
2018-04-26 14:28:28,13470.0,36,26982,-8,13470.0,2,13475.0,9,B
2018-04-26 14:28:29,13470.0,4,26986,-4,13465.0,1,13475.0,22,B
2018-04-26 14:28:38,13470.0,2,26988,0,13470.0,19,13475.0,20,B
2018-04-26 14:28:39,13475.0,2,26990,2,13470.0,19,13475.0,19,B
2018-04-26 14:28:42,13475.0,2,26992,2,13470.0,19,13475.0,18,B
2018-04-26 14:28:49,13475.0,2,26994,2,13470.0,19,13475.0,19,B
2018-04-26 14:28:56,13475.0,2,26996,2,13470.0,21,13475.0,14,B
2018-04-26 14:28:58,13475.0,2,26998,2,13470.0,21,13475.0,13,B
2018-04-26 14:28:58,13470.0,2,27000,-2,13470.0,20,13475.0,13,S
2018-04-26 14:28:59,13475.0,2,27002,2,13470.0,20,13475.0,12,B
2018-04-26 14:28:59,13470.0,4,27006,-4,13470.0,18,13475.0,12,S
2018-04-26 14:29:01,13470.0,2,27008,0,13470.0,18,13475.0,12,S
2018-04-26 14:29:02,13470.0,20,27028,-20,13470.0,8,13475.0,12,S
2018-04-26 14:29:03,13470.0,16,27044,-2,13465.0,5,13470.0,9,S
2018-04-26 14:29:04,13475.0,20,27064,-4,13465.0,5,13470.0,1,B
2018-04-26 14:29:08,13470.0,6,27070,-4,13470.0,1,13475.0,12,S
2018-04-26 14:29:09,13470.0,10,27080,8,13465.0,7,13475.0,10,S
2018-04-26 14:29:11,13470.0,2,27082,-2,13470.0,4,13475.0,5,S
2018-04-26 14:29:12,13470.0,4,27086,0,13465.0,9,13470.0,1,S
2018-04-26 14:29:13,13465.0,12,27098,-4,13465.0,3,13470.0,3,S
2018-04-26 14:29:14,13465.0,2,27100,0,13465.0,1,13470.0,7,S
2018-04-26 14:29:14,13465.0,2,27102,2,13460.0,8,13470.0,12,S
2018-04-26 14:29:19,13460.0,2,27104,0,13460.0,4,13470.0,18,S
2018-04-26 14:29:22,13460.0,4,27108,0,13460.0,18,13470.0,12,S
2018-04-26 14:29:23,13465.0,2,27110,-2,13460.0,3,13465.0,3,B
2018-04-26 14:29:32,13465.0,4,27114,0,13460.0,9,13465.0,2,B
2018-04-26 14:29:38,13460.0,4,27118,2,13460.0,5,13465.0,1,S
2018-04-26 14:29:39,13465.0,2,27120,0,13465.0,6,13470.0,19,B
2018-04-26 14:29:43,13465.0,2,27122,2,13465.0,3,13470.0,12,B
2018-04-26 14:29:47,13465.0,4,27126,-4,13460.0,10,13470.0,34,B
2018-04-26 14:29:52,13460.0,4,27130,0,13460.0,8,13465.0,12,S
2018-04-26 14:29:54,13460.0,2,27132,2,13460.0,7,13465.0,22,S
2018-04-26 14:29:58,13460.0,2,27134,2,13460.0,7,13465.0,22,S
2018-04-26 14:29:58,13460.0,14,27148,4,13455.0,18,13460.0,4,S
2018-04-26 14:29:59,13460.0,8,27156,0,13455.0,19,13465.0,22,S
2018-04-26 14:30:04,13460.0,4,27160,-4,13460.0,1,13465.0,14,S
2018-04-26 14:30:09,13460.0,2,27162,0,13460.0,1,13465.0,4,S
2018-04-26 14:30:16,13460.0,4,27166,-4,13455.0,8,13465.0,7,S
2018-04-26 14:30:16,13460.0,2,27168,0,13460.0,1,13465.0,8,S
2018-04-26 14:30:20,13460.0,2,27170,2,13455.0,8,13465.0,8,S
2018-04-26 14:30:37,13455.0,14,27184,-10,13455.0,18,13460.0,10,S
2018-04-26 14:30:38,13455.0,10,27194,-8,13455.0,13,13460.0,10,S
2018-04-26 14:30:39,13455.0,26,27220,0,13450.0,2,13460.0,12,S
2018-04-26 14:30:40,13455.0,8,27228,0,13450.0,8,13460.0,12,S
2018-04-26 14:30:45,13450.0,2,27230,-2,13450.0,9,13460.0,12,S
2018-04-26 14:30:46,13445.0,54,27284,-46,13440.0,6,13445.0,23,S
2018-04-26 14:30:46,13450.0,48,27332,-46,13445.0,18,13455.0,2,B
2018-04-26 14:30:54,13455.0,2,27334,-2,13450.0,3,13455.0,3,B
2018-04-26 14:30:57,13450.0,6,27340,-6,13445.0,6,13455.0,3,S
2018-04-26 14:30:58,13450.0,4,27344,4,13450.0,2,13455.0,3,S
2018-04-26 14:31:00,13450.0,4,27348,0,13445.0,6,13455.0,7,S
2018-04-26 14:31:03,13450.0,6,27354,-6,13445.0,6,13450.0,7,S
2018-04-26 14:31:18,13450.0,18,27372,2,13450.0,7,13455.0,9,S
2018-04-26 14:31:24,13450.0,2,27374,2,13450.0,9,13455.0,10,S
2018-04-26 14:31:28,13455.0,12,27386,2,13450.0,3,13455.0,4,B
2018-04-26 14:31:31,13450.0,26,27412,10,13450.0,3,13460.0,4,S
2018-04-26 14:31:34,13450.0,8,27420,-6,13445.0,10,13450.0,1,S
2018-04-26 14:31:39,13450.0,2,27422,0,13445.0,1,13450.0,3,S
2018-04-26 14:31:42,13445.0,2,27424,0,13445.0,20,13450.0,1,S
2018-04-26 14:32:02,13445.0,42,27466,-6,13440.0,7,13450.0,15,S
2018-04-26 14:32:03,13450.0,2,27468,0,13440.0,20,13450.0,14,B
2018-04-26 14:32:15,13445.0,26,27494,-14,13445.0,5,13450.0,14,S
2018-04-26 14:32:20,13445.0,2,27496,0,13445.0,3,13450.0,15,S
2018-04-26 14:32:22,13450.0,24,27520,-20,13450.0,2,13455.0,10,B
2018-04-26 14:32:31,13450.0,6,27526,6,13445.0,33,13455.0,11,B
2018-04-26 14:32:44,13450.0,2,27528,-2,13445.0,25,13455.0,24,B
2018-04-26 14:32:47,13450.0,2,27530,2,13445.0,31,13455.0,11,B
2018-04-26 14:32:48,13450.0,4,27534,0,13445.0,31,13455.0,12,B
2018-04-26 14:33:03,13455.0,4,27538,0,13450.0,21,13455.0,10,B
2018-04-26 14:33:12,13450.0,4,27542,0,13450.0,19,13455.0,32,S
2018-04-26 14:33:13,13450.0,32,27574,-16,13450.0,3,13455.0,32,S
2018-04-26 14:33:13,13450.0,6,27580,-4,13445.0,27,13450.0,1,S
2018-04-26 14:33:20,13445.0,2,27582,-2,13445.0,25,13450.0,3,S
2018-04-26 14:33:58,13445.0,2,27584,-2,13445.0,21,13450.0,13,S
2018-04-26 14:34:01,13445.0,10,27594,-10,13445.0,16,13450.0,13,S
2018-04-26 14:34:05,13450.0,2,27596,0,13445.0,16,13450.0,13,B
2018-04-26 14:34:05,13445.0,2,27598,-2,13445.0,15,13450.0,15,S
2018-04-26 14:34:06,13445.0,30,27628,2,13440.0,30,13450.0,27,S
2018-04-26 14:34:21,13440.0,2,27630,-2,13440.0,24,13445.0,9,S
2018-04-26 14:34:21,13440.0,40,27670,-30,13440.0,4,13445.0,26,S
2018-04-26 14:34:22,13440.0,8,27678,0,13435.0,14,13440.0,1,S
2018-04-26 14:34:26,13440.0,6,27684,0,13435.0,19,13440.0,7,S
2018-04-26 14:34:30,13440.0,18,27702,-6,13440.0,5,13445.0,17,S
2018-04-26 14:34:35,13445.0,32,27734,-24,13445.0,4,13450.0,35,B
2018-04-26 14:34:36,13445.0,8,27742,-2,13440.0,9,13445.0,1,B
2018-04-26 14:34:43,13445.0,2,27744,2,13440.0,10,13445.0,6,B
2018-04-26 14:34:50,13440.0,2,27746,-2,13440.0,9,13445.0,6,S
2018-04-26 14:34:53,13445.0,4,27750,-4,13440.0,9,13445.0,9,B
2018-04-26 14:34:57,13440.0,4,27754,0,13440.0,7,13445.0,8,S
2018-04-26 14:35:10,13440.0,4,27758,0,13440.0,25,13445.0,9,S
2018-04-26 14:35:14,13445.0,18,27776,0,13445.0,4,13450.0,17,B
2018-04-26 14:35:15,13445.0,4,27780,2,13445.0,9,13450.0,16,B
2018-04-26 14:35:23,13445.0,10,27790,-8,13440.0,34,13450.0,15,B
2018-04-26 14:35:42,13445.0,4,27794,0,13440.0,22,13450.0,18,B
2018-04-26 14:35:46,13450.0,2,27796,2,13445.0,10,13450.0,14,B
2018-04-26 14:35:47,13450.0,2,27798,0,13445.0,3,13450.0,13,B
2018-04-26 14:36:03,13445.0,4,27802,2,13440.0,33,13445.0,7,S
2018-04-26 14:36:04,13445.0,14,27816,-10,13440.0,33,13450.0,14,S
2018-04-26 14:36:08,13445.0,2,27818,-2,13440.0,33,13445.0,4,S
2018-04-26 14:36:08,13445.0,4,27822,0,13440.0,32,13445.0,2,S
2018-04-26 14:36:17,13440.0,4,27826,0,13440.0,23,13445.0,7,S
2018-04-26 14:36:24,13440.0,6,27832,-6,13440.0,21,13445.0,6,S
2018-04-26 14:36:32,13440.0,4,27836,0,13440.0,19,13445.0,6,S
2018-04-26 14:36:36,13440.0,14,27850,0,13440.0,12,13445.0,6,S
2018-04-26 14:36:56,13445.0,14,27864,-6,13440.0,20,13450.0,13,B
2018-04-26 14:37:04,13445.0,10,27874,-10,13440.0,21,13445.0,15,B
2018-04-26 14:37:15,13440.0,6,27880,0,13440.0,17,13445.0,15,S
2018-04-26 14:37:16,13445.0,10,27890,0,13440.0,17,13445.0,10,B
2018-04-26 14:37:39,13440.0,20,27910,2,13440.0,3,13445.0,15,S
2018-04-26 14:37:48,13440.0,20,27930,-12,13440.0,14,13445.0,15,S
2018-04-26 14:37:51,13440.0,4,27934,0,13440.0,12,13445.0,15,S
2018-04-26 14:37:55,13440.0,4,27938,0,13440.0,10,13445.0,15,S
2018-04-26 14:37:56,13440.0,10,27948,0,13440.0,5,13445.0,15,S
2018-04-26 14:37:58,13440.0,4,27952,0,13440.0,4,13445.0,15,S
2018-04-26 14:38:00,13440.0,2,27954,-2,13440.0,3,13445.0,15,S
2018-04-26 14:38:11,13440.0,10,27964,4,13440.0,10,13445.0,16,S
2018-04-26 14:38:12,13440.0,6,27970,-6,13440.0,7,13445.0,16,S
2018-04-26 14:38:36,13440.0,10,27980,0,13440.0,5,13445.0,9,S
2018-04-26 14:38:46,13440.0,6,27986,-6,13440.0,2,13445.0,11,S
2018-04-26 14:38:52,13440.0,6,27992,2,13435.0,20,13440.0,2,S
2018-04-26 14:38:53,13440.0,4,27996,2,13435.0,19,13445.0,12,S
2018-04-26 14:39:05,13440.0,14,28010,-10,13440.0,13,13445.0,26,S
2018-04-26 14:39:07,13440.0,10,28020,-10,13440.0,13,13445.0,16,S
2018-04-26 14:39:07,13440.0,10,28030,-10,13440.0,8,13445.0,16,S
2018-04-26 14:39:10,13445.0,14,28044,-10,13440.0,1,13445.0,11,B
2018-04-26 14:39:12,13440.0,2,28046,0,13435.0,18,13440.0,1,S
2018-04-26 14:39:12,13440.0,12,28058,10,13435.0,18,13445.0,11,S
2018-04-26 14:39:23,13440.0,4,28062,0,13440.0,21,13445.0,12,S
2018-04-26 14:39:26,13440.0,10,28072,0,13440.0,16,13445.0,12,S
2018-04-26 14:39:27,13440.0,4,28076,-4,13440.0,14,13445.0,13,S
2018-04-26 14:39:30,13440.0,10,28086,-10,13440.0,6,13445.0,13,S
2018-04-26 14:39:35,13440.0,12,28098,0,13435.0,20,13440.0,5,S
2018-04-26 14:39:36,13435.0,40,28138,-20,13430.0,5,13435.0,3,S
2018-04-26 14:39:36,13435.0,10,28148,10,13430.0,4,13440.0,17,S
2018-04-26 14:39:37,13430.0,4,28152,-2,13430.0,4,13440.0,12,S
2018-04-26 14:39:39,13435.0,8,28160,0,13430.0,6,13440.0,10,B
2018-04-26 14:39:47,13430.0,6,28166,2,13425.0,5,13435.0,2,S
2018-04-26 14:39:50,13425.0,2,28168,0,13420.0,13,13430.0,3,S
2018-04-26 14:39:51,13420.0,12,28180,-2,13420.0,7,13430.0,8,S
2018-04-26 14:39:52,13425.0,12,28192,0,13425.0,13,13435.0,7,B
2018-04-26 14:39:54,13425.0,2,28194,2,13425.0,13,13430.0,1,B
2018-04-26 14:39:55,13420.0,36,28230,-8,13420.0,3,13425.0,21,S
2018-04-26 14:39:56,13425.0,14,28244,-4,13420.0,11,13430.0,9,B
2018-04-26 14:39:59,13425.0,2,28246,0,13420.0,8,13430.0,14,B
2018-04-26 14:40:00,13420.0,24,28270,-14,13415.0,7,13420.0,38,S
2018-04-26 14:40:00,13420.0,6,28276,-4,13415.0,7,13420.0,37,S
2018-04-26 14:40:01,13420.0,74,28350,4,13415.0,9,13425.0,5,S
2018-04-26 14:40:02,13425.0,2,28352,0,13425.0,4,13430.0,10,B
2018-04-26 14:40:03,13425.0,14,28366,6,13420.0,18,13430.0,9,B
2018-04-26 14:40:09,13430.0,6,28372,2,13425.0,36,13430.0,3,B
2018-04-26 14:40:10,13425.0,6,28378,4,13425.0,26,13430.0,8,S
2018-04-26 14:40:11,13425.0,42,28420,-22,13420.0,5,13425.0,2,S
2018-04-26 14:40:15,13430.0,12,28432,-8,13425.0,24,13435.0,6,B
2018-04-26 14:40:16,13430.0,2,28434,2,13430.0,1,13435.0,4,B
2018-04-26 14:40:16,13430.0,2,28436,0,13425.0,34,13435.0,5,B
2018-04-26 14:40:19,13425.0,10,28446,0,13425.0,15,13430.0,9,S
2018-04-26 14:40:20,13425.0,30,28476,0,13420.0,6,13425.0,1,S
2018-04-26 14:40:21,13420.0,6,28482,2,13415.0,9,13420.0,4,S
2018-04-26 14:40:21,13420.0,8,28490,0,13420.0,4,13425.0,11,S
2018-04-26 14:40:22,13425.0,22,28512,-12,13425.0,4,13430.0,1,B
2018-04-26 14:40:23,13430.0,6,28518,-2,13425.0,9,13430.0,2,B
2018-04-26 14:40:24,13425.0,2,28520,0,13425.0,5,13430.0,2,S
2018-04-26 14:40:32,13425.0,6,28526,-2,13420.0,12,13425.0,7,S
2018-04-26 14:40:33,13425.0,2,28528,0,13420.0,12,13425.0,6,S
2018-04-26 14:40:34,13425.0,8,28536,-8,13420.0,20,13425.0,2,S
2018-04-26 14:40:34,13425.0,4,28540,-4,13420.0,20,13430.0,9,S
2018-04-26 14:40:36,13420.0,10,28550,4,13420.0,15,13430.0,9,S
2018-04-26 14:40:40,13425.0,20,28570,-20,13425.0,11,13430.0,11,B
2018-04-26 14:40:42,13425.0,20,28590,-20,13425.0,1,13430.0,11,B
2018-04-26 14:40:50,13430.0,2,28592,0,13425.0,18,13430.0,10,B
2018-04-26 14:40:55,13430.0,20,28612,-16,13425.0,18,13435.0,6,B
2018-04-26 14:40:55,13430.0,12,28624,-12,13430.0,14,13435.0,10,B
2018-04-26 14:40:59,13430.0,10,28634,0,13430.0,10,13435.0,10,B
2018-04-26 14:41:07,13435.0,14,28648,4,13435.0,3,13440.0,16,B
2018-04-26 14:41:07,13435.0,6,28654,0,13430.0,13,13435.0,6,B
2018-04-26 14:41:08,13430.0,4,28658,-4,13430.0,11,13435.0,3,S
2018-04-26 14:41:14,13435.0,20,28678,0,13430.0,12,13440.0,11,B
2018-04-26 14:41:15,13430.0,10,28688,0,13430.0,7,13440.0,10,S
2018-04-26 14:41:19,13435.0,20,28708,12,13430.0,4,13435.0,5,B
2018-04-26 14:41:30,13430.0,14,28722,4,13430.0,2,13435.0,3,S
2018-04-26 14:41:39,13435.0,6,28728,-6,13435.0,17,13440.0,10,B
2018-04-26 14:41:39,13435.0,34,28762,-34,13430.0,4,13440.0,10,B
2018-04-26 14:41:41,13425.0,16,28778,0,13420.0,7,13430.0,19,S
2018-04-26 14:41:41,13430.0,36,28814,-6,13420.0,9,13430.0,2,B
2018-04-26 14:41:42,13425.0,2,28816,-2,13425.0,7,13435.0,18,S
2018-04-26 14:41:45,13430.0,2,28818,-2,13430.0,3,13435.0,19,B
2018-04-26 14:41:47,13430.0,6,28824,-6,13425.0,5,13430.0,2,B
2018-04-26 14:41:50,13425.0,10,28834,4,13420.0,9,13430.0,2,S
2018-04-26 14:41:58,13430.0,52,28886,-48,13425.0,12,13430.0,13,B
2018-04-26 14:41:59,13430.0,2,28888,0,13425.0,17,13430.0,12,B
2018-04-26 14:42:01,13430.0,24,28912,4,13425.0,22,13435.0,11,B
2018-04-26 14:42:01,13425.0,10,28922,0,13425.0,17,13435.0,10,S
2018-04-26 14:42:08,13430.0,30,28952,-6,13430.0,5,13435.0,10,B
2018-04-26 14:42:09,13430.0,10,28962,-10,13425.0,7,13435.0,12,B
2018-04-26 14:42:12,13435.0,12,28974,0,13430.0,10,13440.0,7,B
2018-04-26 14:42:13,13435.0,4,28978,4,13430.0,10,13435.0,4,B
2018-04-26 14:42:19,13435.0,2,28980,0,13430.0,10,13435.0,4,B
2018-04-26 14:42:21,13435.0,12,28992,6,13435.0,14,13440.0,12,B
2018-04-26 14:42:22,13435.0,22,29014,0,13435.0,3,13440.0,12,B
2018-04-26 14:42:24,13435.0,6,29020,0,13430.0,5,13435.0,2,B
2018-04-26 14:42:25,13430.0,14,29034,-2,13425.0,12,13440.0,11,S
2018-04-26 14:42:30,13435.0,4,29038,-4,13430.0,13,13435.0,3,B
2018-04-26 14:42:31,13430.0,16,29054,4,13430.0,8,13440.0,10,S
2018-04-26 14:42:36,13435.0,2,29056,-2,13435.0,19,13440.0,11,B
2018-04-26 14:42:39,13440.0,22,29078,6,13440.0,4,13445.0,7,B
2018-04-26 14:42:41,13440.0,2,29080,2,13440.0,21,13445.0,5,B
2018-04-26 14:42:43,13440.0,4,29084,-4,13440.0,19,13445.0,4,B
2018-04-26 14:42:44,13445.0,2,29086,0,13440.0,21,13445.0,4,B
2018-04-26 14:42:48,13445.0,10,29096,8,13445.0,2,13450.0,9,B
2018-04-26 14:42:48,13445.0,8,29104,-8,13440.0,21,13445.0,2,B
2018-04-26 14:42:49,13445.0,6,29110,0,13440.0,21,13445.0,1,B
2018-04-26 14:42:50,13445.0,2,29112,0,13440.0,21,13450.0,12,B
2018-04-26 14:42:53,13445.0,32,29144,-10,13445.0,1,13450.0,11,B
2018-04-26 14:42:54,13445.0,8,29152,0,13445.0,1,13450.0,11,B
2018-04-26 14:42:55,13440.0,4,29156,-4,13440.0,20,13450.0,11,S
2018-04-26 14:42:57,13440.0,10,29166,0,13440.0,15,13450.0,10,S
2018-04-26 14:42:58,13445.0,4,29170,0,13440.0,15,13445.0,2,B
2018-04-26 14:42:59,13445.0,4,29174,0,13440.0,15,13450.0,10,B
2018-04-26 14:43:00,13445.0,4,29178,2,13440.0,15,13450.0,10,B
2018-04-26 14:43:21,13440.0,2,29180,-2,13440.0,14,13450.0,13,S
2018-04-26 14:43:23,13440.0,4,29184,-4,13440.0,9,13445.0,4,S
2018-04-26 14:43:24,13440.0,4,29188,-4,13440.0,7,13445.0,7,S
2018-04-26 14:43:24,13440.0,4,29192,-4,13440.0,5,13445.0,7,S
2018-04-26 14:43:25,13440.0,4,29196,-4,13440.0,3,13445.0,7,S
2018-04-26 14:43:25,13440.0,4,29200,-4,13440.0,1,13445.0,7,S
2018-04-26 14:43:26,13440.0,2,29202,-2,13435.0,23,13440.0,1,S
2018-04-26 14:43:26,13440.0,2,29204,0,13435.0,23,13445.0,4,S
2018-04-26 14:43:27,13440.0,4,29208,-4,13435.0,25,13445.0,5,S
2018-04-26 14:43:28,13440.0,4,29212,-4,13435.0,25,13445.0,5,S
2018-04-26 14:43:31,13440.0,4,29216,-4,13440.0,18,13445.0,6,S
2018-04-26 14:43:31,13440.0,4,29220,-4,13440.0,16,13445.0,7,S
2018-04-26 14:43:32,13440.0,4,29224,-4,13440.0,14,13445.0,6,S
2018-04-26 14:43:49,13440.0,28,29252,-8,13435.0,22,13445.0,28,S
2018-04-26 14:43:57,13435.0,24,29276,-12,13435.0,10,13440.0,5,S
2018-04-26 14:43:59,13440.0,2,29278,2,13435.0,9,13440.0,6,B
2018-04-26 14:44:00,13435.0,2,29280,-2,13435.0,8,13440.0,6,S
2018-04-26 14:44:01,13435.0,16,29296,4,13430.0,12,13435.0,1,S
2018-04-26 14:44:03,13435.0,14,29310,12,13435.0,15,13440.0,8,S
2018-04-26 14:44:11,13440.0,14,29324,-12,13440.0,3,13445.0,26,B
2018-04-26 14:44:11,13440.0,6,29330,-6,13435.0,9,13445.0,28,B
2018-04-26 14:44:22,13435.0,2,29332,2,13435.0,9,13440.0,4,S
2018-04-26 14:44:33,13435.0,8,29340,-8,13430.0,18,13440.0,7,S
2018-04-26 14:44:34,13435.0,2,29342,0,13430.0,15,13435.0,3,S
2018-04-26 14:44:35,13435.0,6,29348,0,13435.0,3,13440.0,12,S
2018-04-26 14:44:41,13435.0,2,29350,0,13435.0,3,13440.0,12,S
2018-04-26 14:44:42,13435.0,6,29356,0,13430.0,18,13440.0,12,S
2018-04-26 14:44:48,13430.0,4,29360,-4,13430.0,10,13435.0,22,S
2018-04-26 14:44:53,13430.0,14,29374,-14,13430.0,2,13435.0,13,S
2018-04-26 14:44:53,13430.0,4,29378,-2,13425.0,4,13430.0,7,S
2018-04-26 14:45:01,13430.0,10,29388,-4,13425.0,8,13435.0,18,S
2018-04-26 14:45:02,13430.0,32,29420,-10,13430.0,2,13435.0,8,S
2018-04-26 14:45:03,13430.0,4,29424,4,13425.0,7,13430.0,5,S
2018-04-26 14:45:06,13425.0,2,29426,-2,13420.0,6,13425.0,4,S
2018-04-26 14:45:08,13420.0,4,29430,-4,13415.0,9,13420.0,4,S
2018-04-26 14:45:09,13420.0,8,29438,-8,13420.0,6,13425.0,4,S
2018-04-26 14:45:09,13425.0,4,29442,4,13420.0,15,13430.0,12,B
2018-04-26 14:45:10,13430.0,6,29448,-2,13425.0,9,13430.0,3,B
2018-04-26 14:45:11,13430.0,6,29454,6,13425.0,12,13435.0,4,B
2018-04-26 14:45:16,13430.0,4,29458,0,13425.0,10,13435.0,7,B
2018-04-26 14:45:17,13435.0,4,29462,4,13435.0,3,13440.0,5,B
2018-04-26 14:45:21,13435.0,6,29468,0,13430.0,3,13440.0,12,B
2018-04-26 14:45:30,13435.0,2,29470,0,13425.0,11,13435.0,3,B
2018-04-26 14:45:32,13430.0,6,29476,-6,13425.0,11,13430.0,2,S
2018-04-26 14:45:43,13425.0,14,29490,-10,13420.0,11,13425.0,4,S
2018-04-26 14:45:44,13425.0,10,29500,-8,13420.0,8,13425.0,2,S
2018-04-26 14:45:50,13420.0,4,29504,-4,13420.0,1,13425.0,6,S
2018-04-26 14:45:51,13420.0,2,29506,-2,13415.0,8,13425.0,6,S
2018-04-26 14:45:51,13415.0,10,29516,4,13415.0,3,13425.0,6,S
2018-04-26 14:45:59,13430.0,20,29536,2,13425.0,11,13435.0,6,B
2018-04-26 14:46:04,13430.0,4,29540,0,13430.0,4,13435.0,5,B
2018-04-26 14:46:15,13425.0,2,29542,-2,13425.0,14,13430.0,6,S
2018-04-26 14:46:23,13425.0,10,29552,0,13425.0,11,13430.0,5,S
2018-04-26 14:46:26,13430.0,10,29562,8,13425.0,11,13430.0,22,B
2018-04-26 14:46:33,13430.0,66,29628,54,13425.0,11,13435.0,9,B
2018-04-26 14:46:34,13430.0,2,29630,-2,13425.0,12,13435.0,9,B
2018-04-26 14:46:35,13425.0,20,29650,-6,13425.0,7,13435.0,9,S
2018-04-26 14:46:45,13430.0,10,29660,2,13425.0,13,13435.0,5,B
2018-04-26 14:46:49,13435.0,6,29666,0,13430.0,11,13440.0,5,B
2018-04-26 14:46:50,13430.0,4,29670,2,13430.0,10,13435.0,7,S
2018-04-26 14:46:53,13435.0,2,29672,0,13430.0,11,13435.0,1,B
2018-04-26 14:46:54,13435.0,2,29674,-2,13430.0,9,13440.0,12,B
2018-04-26 14:46:56,13435.0,2,29676,2,13430.0,11,13440.0,11,B
2018-04-26 14:46:59,13430.0,20,29696,2,13430.0,9,13440.0,11,S
2018-04-26 14:47:05,13430.0,18,29714,-12,13425.0,6,13435.0,14,S
2018-04-26 14:47:14,13425.0,20,29734,0,13425.0,2,13435.0,11,S
2018-04-26 14:47:14,13425.0,2,29736,-2,13425.0,4,13435.0,10,S
2018-04-26 14:47:23,13425.0,8,29744,4,13420.0,9,13430.0,8,S
2018-04-26 14:47:33,13420.0,10,29754,6,13420.0,8,13430.0,19,S
2018-04-26 14:47:47,13420.0,10,29764,-4,13420.0,6,13430.0,19,S
2018-04-26 14:47:54,13420.0,10,29774,4,13420.0,1,13425.0,1,S
2018-04-26 14:47:55,13420.0,2,29776,-2,13415.0,13,13425.0,7,S
2018-04-26 14:48:06,13420.0,4,29780,0,13415.0,16,13420.0,8,S
2018-04-26 14:48:07,13430.0,24,29804,8,13420.0,16,13430.0,20,B
2018-04-26 14:48:09,13425.0,2,29806,0,13420.0,14,13430.0,22,S
2018-04-26 14:48:18,13420.0,10,29816,-10,13420.0,9,13425.0,4,S
2018-04-26 14:48:27,13425.0,2,29818,0,13420.0,9,13430.0,22,B
2018-04-26 14:48:33,13420.0,10,29828,0,13420.0,12,13430.0,19,S
2018-04-26 14:48:39,13420.0,20,29848,-14,13420.0,3,13430.0,19,S
2018-04-26 14:48:44,13420.0,10,29858,10,13415.0,17,13420.0,40,S
2018-04-26 14:48:45,13420.0,10,29868,4,13415.0,17,13420.0,35,S
2018-04-26 14:48:50,13420.0,2,29870,0,13415.0,12,13420.0,37,S
2018-04-26 14:48:52,13415.0,4,29874,-4,13415.0,9,13420.0,35,S
2018-04-26 14:48:54,13415.0,10,29884,6,13415.0,4,13420.0,37,S
2018-04-26 14:48:55,13415.0,4,29888,-2,13415.0,2,13420.0,37,S
2018-04-26 14:48:55,13415.0,4,29892,-2,13410.0,10,13420.0,37,S
2018-04-26 14:49:01,13410.0,38,29930,18,13405.0,38,13410.0,15,S
2018-04-26 14:49:02,13425.0,40,29970,4,13410.0,40,13420.0,2,B
2018-04-26 14:49:10,13415.0,2,29972,0,13410.0,9,13415.0,4,S
2018-04-26 14:49:10,13415.0,2,29974,0,13410.0,9,13415.0,3,S
2018-04-26 14:49:14,13415.0,4,29978,0,13410.0,10,13415.0,1,S
2018-04-26 14:49:16,13415.0,2,29980,2,13410.0,10,13420.0,7,S
2018-04-26 14:49:24,13415.0,6,29986,-4,13410.0,11,13420.0,14,S
2018-04-26 14:49:25,13415.0,2,29988,2,13410.0,11,13420.0,14,S
2018-04-26 14:49:29,13415.0,8,29996,0,13410.0,7,13415.0,18,S
2018-04-26 14:49:36,13415.0,2,29998,0,13410.0,3,13415.0,21,S
2018-04-26 14:49:43,13410.0,6,30004,4,13405.0,4,13410.0,2,S
2018-04-26 14:49:44,13410.0,4,30008,4,13405.0,6,13415.0,16,S
2018-04-26 14:49:52,13405.0,2,30010,0,13405.0,8,13415.0,20,S
2018-04-26 14:49:58,13410.0,4,30014,0,13405.0,6,13410.0,3,B
2018-04-26 14:49:59,13405.0,6,30020,-2,13405.0,7,13410.0,1,S
2018-04-26 14:50:00,13410.0,4,30024,-2,13405.0,7,13415.0,18,B
2018-04-26 14:50:01,13410.0,2,30026,-2,13405.0,6,13415.0,14,B
2018-04-26 14:50:05,13405.0,10,30036,-4,13405.0,2,13415.0,17,S
2018-04-26 14:50:06,13405.0,12,30048,-12,13400.0,110,13405.0,2,S
2018-04-26 14:50:07,13405.0,4,30052,-4,13405.0,8,13415.0,17,S
2018-04-26 14:50:08,13405.0,2,30054,0,13405.0,7,13415.0,17,S
2018-04-26 14:50:16,13415.0,22,30076,-2,13415.0,9,13420.0,15,B
2018-04-26 14:50:17,13415.0,2,30078,-2,13415.0,8,13420.0,16,B
2018-04-26 14:50:20,13420.0,20,30098,-2,13420.0,10,13425.0,4,B
2018-04-26 14:50:20,13420.0,20,30118,-4,13415.0,8,13420.0,2,B
2018-04-26 14:50:26,13420.0,10,30128,-8,13415.0,8,13420.0,2,B
2018-04-26 14:50:35,13415.0,16,30144,-16,13410.0,5,13415.0,3,S
2018-04-26 14:50:41,13415.0,2,30146,-2,13410.0,22,13415.0,8,S
2018-04-26 14:50:48,13415.0,2,30148,-2,13410.0,22,13420.0,18,S
2018-04-26 14:50:49,13410.0,10,30158,0,13410.0,17,13415.0,2,S
2018-04-26 14:50:55,13410.0,8,30166,0,13410.0,13,13415.0,9,S
2018-04-26 14:50:58,13410.0,2,30168,-2,13410.0,14,13415.0,3,S
2018-04-26 14:51:02,13415.0,6,30174,0,13415.0,1,13420.0,18,B
2018-04-26 14:51:04,13415.0,2,30176,0,13415.0,1,13420.0,5,B
2018-04-26 14:51:06,13415.0,2,30178,-2,13415.0,2,13420.0,5,B
2018-04-26 14:51:10,13415.0,2,30180,2,13410.0,15,13415.0,6,B
2018-04-26 14:51:15,13415.0,16,30196,-16,13415.0,12,13420.0,28,B
2018-04-26 14:51:21,13420.0,2,30198,-2,13415.0,12,13420.0,16,B
2018-04-26 14:51:27,13420.0,4,30202,-2,13415.0,15,13420.0,3,B
2018-04-26 14:51:27,13420.0,8,30210,4,13415.0,15,13425.0,7,B
2018-04-26 14:51:28,13420.0,2,30212,0,13415.0,15,13425.0,10,B
2018-04-26 14:51:32,13420.0,2,30214,0,13415.0,14,13420.0,5,B
2018-04-26 14:51:33,13415.0,26,30240,-14,13410.0,14,13420.0,7,S
2018-04-26 14:51:45,13415.0,6,30246,-2,13415.0,17,13420.0,8,S
2018-04-26 14:51:51,13415.0,10,30256,0,13415.0,12,13420.0,8,S
2018-04-26 14:51:56,13415.0,2,30258,-2,13415.0,11,13420.0,14,S
2018-04-26 14:51:57,13420.0,40,30298,-28,13415.0,11,13425.0,21,B
2018-04-26 14:52:09,13420.0,18,30316,0,13420.0,11,13425.0,14,B
2018-04-26 14:52:09,13420.0,22,30338,0,13420.0,4,13425.0,12,B
2018-04-26 14:52:11,13420.0,4,30342,0,13415.0,18,13425.0,12,B
2018-04-26 14:52:13,13420.0,12,30354,-2,13420.0,14,13425.0,14,B
2018-04-26 14:52:14,13420.0,28,30382,-16,13415.0,18,13425.0,13,B
2018-04-26 14:52:17,13420.0,2,30384,0,13420.0,19,13425.0,15,B
2018-04-26 14:52:17,13420.0,8,30392,0,13420.0,15,13425.0,15,B
2018-04-26 14:52:18,13420.0,2,30394,0,13420.0,14,13425.0,15,B
2018-04-26 14:52:18,13425.0,8,30402,-2,13420.0,14,13425.0,10,B
2018-04-26 14:52:22,13420.0,2,30404,0,13420.0,14,13425.0,17,S
2018-04-26 14:52:27,13420.0,2,30406,0,13420.0,17,13425.0,12,S
2018-04-26 14:52:29,13420.0,4,30410,0,13420.0,15,13425.0,7,S
2018-04-26 14:52:30,13425.0,14,30424,-6,13425.0,1,13430.0,24,B
2018-04-26 14:52:31,13430.0,32,30456,-26,13430.0,4,13435.0,5,B
2018-04-26 14:52:31,13430.0,14,30470,-2,13425.0,10,13435.0,7,B
2018-04-26 14:52:41,13425.0,2,30472,0,13425.0,3,13430.0,13,S
2018-04-26 14:52:44,13425.0,2,30474,-2,13425.0,27,13430.0,7,S
2018-04-26 14:52:45,13430.0,12,30486,2,13430.0,1,13435.0,12,B
2018-04-26 14:52:49,13430.0,2,30488,-2,13430.0,6,13435.0,13,B
2018-04-26 14:52:50,13430.0,10,30498,0,13430.0,1,13435.0,13,B
2018-04-26 14:52:51,13430.0,2,30500,0,13425.0,28,13435.0,13,B
2018-04-26 14:52:58,13430.0,2,30502,0,13430.0,20,13435.0,14,B
2018-04-26 14:53:00,13430.0,6,30508,0,13430.0,17,13435.0,14,B
2018-04-26 14:53:02,13430.0,2,30510,-2,13430.0,20,13435.0,10,B
2018-04-26 14:53:03,13430.0,40,30550,4,13425.0,28,13430.0,1,B
2018-04-26 14:53:03,13430.0,8,30558,-4,13425.0,25,13430.0,5,B
2018-04-26 14:53:04,13430.0,10,30568,-6,13425.0,25,13430.0,5,B
2018-04-26 14:53:04,13430.0,10,30578,0,13430.0,5,13435.0,4,B
2018-04-26 14:53:09,13430.0,2,30580,-2,13430.0,7,13435.0,5,B
2018-04-26 14:53:20,13435.0,6,30586,-2,13430.0,3,13435.0,5,B
2018-04-26 14:53:20,13440.0,12,30598,-8,13430.0,10,13440.0,12,B
2018-04-26 14:53:23,13430.0,4,30602,0,13430.0,2,13440.0,17,S
2018-04-26 14:53:24,13430.0,4,30606,2,13425.0,28,13435.0,1,S
2018-04-26 14:53:25,13430.0,4,30610,0,13430.0,3,13435.0,3,S
2018-04-26 14:53:25,13430.0,4,30614,0,13430.0,2,13435.0,5,S
2018-04-26 14:53:26,13430.0,4,30618,2,13425.0,30,13435.0,5,S
2018-04-26 14:53:27,13425.0,16,30634,8,13425.0,29,13435.0,5,S
2018-04-26 14:53:27,13425.0,4,30638,0,13425.0,27,13435.0,5,S
2018-04-26 14:53:28,13425.0,8,30646,0,13425.0,23,13435.0,5,S
2018-04-26 14:53:30,13430.0,4,30650,2,13430.0,3,13435.0,4,B
2018-04-26 14:53:31,13430.0,4,30654,0,13430.0,2,13435.0,4,B
2018-04-26 14:53:31,13430.0,4,30658,0,13425.0,21,13435.0,4,B
2018-04-26 14:53:32,13430.0,8,30666,2,13425.0,21,13435.0,4,B
2018-04-26 14:53:36,13435.0,2,30668,-2,13425.0,23,13435.0,5,B
2018-04-26 14:53:39,13435.0,4,30672,-4,13430.0,1,13440.0,13,B
2018-04-26 14:53:40,13435.0,10,30682,0,13435.0,3,13440.0,10,B
2018-04-26 14:53:40,13435.0,4,30686,2,13435.0,9,13440.0,10,B
2018-04-26 14:53:41,13435.0,10,30696,10,13435.0,7,13440.0,7,B
2018-04-26 14:53:41,13435.0,4,30700,4,13435.0,2,13440.0,7,B
2018-04-26 14:53:42,13440.0,18,30718,2,13430.0,10,13445.0,8,B
2018-04-26 14:53:42,13435.0,4,30722,0,13435.0,8,13445.0,9,S
2018-04-26 14:53:43,13435.0,2,30724,2,13435.0,9,13445.0,6,S
2018-04-26 14:53:44,13435.0,4,30728,0,13435.0,1,13440.0,5,S
2018-04-26 14:53:45,13435.0,2,30730,0,13430.0,10,13435.0,1,S
2018-04-26 14:53:45,13435.0,6,30736,6,13430.0,10,13440.0,4,S
2018-04-26 14:53:47,13435.0,2,30738,0,13435.0,2,13440.0,8,S
2018-04-26 14:53:47,13435.0,2,30740,0,13430.0,12,13435.0,1,S
2018-04-26 14:53:48,13435.0,2,30742,0,13430.0,12,13435.0,2,S
2018-04-26 14:53:49,13435.0,4,30746,4,13430.0,11,13440.0,5,S
2018-04-26 14:53:49,13440.0,2,30748,0,13430.0,11,13440.0,4,B
2018-04-26 14:53:52,13435.0,4,30752,4,13430.0,21,13435.0,2,S
2018-04-26 14:53:52,13435.0,4,30756,2,13430.0,21,13440.0,8,S
2018-04-26 14:54:01,13440.0,6,30762,-2,13435.0,22,13445.0,15,B
2018-04-26 14:54:09,13440.0,8,30770,4,13435.0,25,13440.0,1,B
2018-04-26 14:54:10,13435.0,4,30774,0,13435.0,19,13440.0,8,S
2018-04-26 14:54:10,13435.0,4,30778,0,13435.0,17,13440.0,8,S
2018-04-26 14:54:11,13435.0,4,30782,0,13435.0,15,13440.0,8,S
2018-04-26 14:54:12,13435.0,4,30786,0,13435.0,13,13440.0,7,S
2018-04-26 14:54:13,13435.0,4,30790,0,13435.0,11,13440.0,7,S
2018-04-26 14:54:14,13435.0,4,30794,0,13435.0,9,13440.0,4,S
2018-04-26 14:54:15,13440.0,2,30796,-2,13440.0,4,13445.0,16,B
2018-04-26 14:54:15,13440.0,6,30802,-2,13440.0,1,13445.0,18,B
2018-04-26 14:54:16,13440.0,2,30804,-2,13435.0,12,13440.0,3,B
2018-04-26 14:54:17,13435.0,4,30808,0,13435.0,10,13440.0,2,S
2018-04-26 14:54:21,13435.0,10,30818,-10,13435.0,4,13440.0,2,S
2018-04-26 14:54:22,13440.0,4,30822,0,13435.0,15,13445.0,21,B
2018-04-26 14:54:34,13445.0,22,30844,-8,13445.0,1,13450.0,34,B
2018-04-26 14:54:34,13445.0,2,30846,0,13445.0,5,13450.0,32,B
2018-04-26 14:54:36,13445.0,2,30848,2,13445.0,4,13450.0,32,B
2018-04-26 14:54:37,13450.0,10,30858,10,13445.0,5,13450.0,27,B
2018-04-26 14:54:38,13450.0,4,30862,0,13445.0,8,13450.0,25,B
2018-04-26 14:54:44,13445.0,2,30864,0,13445.0,6,13450.0,25,S
2018-04-26 14:54:44,13445.0,12,30876,8,13440.0,11,13450.0,25,S
2018-04-26 14:54:46,13440.0,8,30884,4,13435.0,18,13445.0,13,S
2018-04-26 14:54:51,13445.0,2,30886,2,13440.0,2,13445.0,6,B
2018-04-26 14:54:51,13445.0,12,30898,-4,13445.0,1,13450.0,35,B
2018-04-26 14:54:53,13445.0,4,30902,2,13440.0,16,13445.0,19,B
2018-04-26 14:54:54,13440.0,4,30906,0,13440.0,13,13450.0,35,S
2018-04-26 14:54:55,13440.0,4,30910,0,13440.0,13,13450.0,34,S
2018-04-26 14:55:04,13450.0,52,30962,6,13450.0,1,13455.0,12,B
2018-04-26 14:55:05,13445.0,2,30964,-2,13445.0,30,13455.0,10,S
2018-04-26 14:55:06,13455.0,8,30972,0,13445.0,30,13455.0,6,B
2018-04-26 14:55:07,13455.0,12,30984,-2,13450.0,1,13460.0,23,B
2018-04-26 14:55:09,13455.0,2,30986,0,13445.0,8,13450.0,1,B
2018-04-26 14:55:11,13450.0,2,30988,-2,13445.0,7,13450.0,1,S
2018-04-26 14:55:18,13445.0,16,31004,-2,13440.0,11,13445.0,3,S
2018-04-26 14:55:21,13445.0,2,31006,0,13440.0,33,13450.0,13,S
2018-04-26 14:55:22,13445.0,4,31010,0,13440.0,20,13450.0,12,S
2018-04-26 14:55:36,13445.0,2,31012,-2,13440.0,20,13445.0,1,S
2018-04-26 14:55:36,13445.0,2,31014,-2,13440.0,20,13450.0,12,S
2018-04-26 14:55:50,13445.0,2,31016,-2,13445.0,13,13450.0,14,S
2018-04-26 14:55:51,13445.0,26,31042,0,13440.0,14,13450.0,14,S
2018-04-26 14:55:58,13445.0,2,31044,-2,13440.0,13,13450.0,17,S
2018-04-26 14:56:11,13440.0,10,31054,0,13440.0,8,13450.0,17,S
2018-04-26 14:56:26,13445.0,4,31058,-4,13445.0,12,13450.0,7,B
2018-04-26 14:56:34,13450.0,12,31070,-2,13445.0,18,13455.0,21,B
2018-04-26 14:56:35,13450.0,2,31072,2,13445.0,24,13455.0,20,B
2018-04-26 14:56:38,13445.0,2,31074,-2,13445.0,29,13455.0,20,S
2018-04-26 14:56:42,13450.0,2,31076,2,13445.0,23,13455.0,19,B
2018-04-26 14:56:44,13450.0,2,31078,2,13445.0,12,13455.0,21,B
2018-04-26 14:56:45,13455.0,2,31080,0,13445.0,12,13455.0,20,B
2018-04-26 14:56:58,13445.0,4,31084,-4,13445.0,10,13450.0,6,S
2018-04-26 14:57:01,13450.0,4,31088,0,13445.0,10,13450.0,9,B
2018-04-26 14:57:02,13450.0,18,31106,8,13445.0,31,13455.0,20,B
2018-04-26 14:57:02,13455.0,4,31110,-4,13445.0,33,13455.0,10,B
2018-04-26 14:57:07,13455.0,2,31112,2,13445.0,34,13455.0,15,B
2018-04-26 14:57:16,13445.0,2,31114,0,13445.0,34,13455.0,16,S
2018-04-26 14:57:24,13450.0,2,31116,2,13445.0,34,13455.0,15,B
2018-04-26 14:57:35,13445.0,32,31148,-28,13440.0,8,13445.0,4,S
2018-04-26 14:57:35,13445.0,8,31156,0,13440.0,29,13450.0,1,S
2018-04-26 14:57:42,13440.0,4,31160,-4,13440.0,29,13445.0,6,S
2018-04-26 14:57:43,13440.0,12,31172,2,13440.0,1,13445.0,6,S
2018-04-26 14:57:43,13440.0,2,31174,0,13435.0,14,13445.0,6,S
2018-04-26 14:57:51,13445.0,2,31176,0,13435.0,24,13445.0,6,B
2018-04-26 14:57:53,13435.0,18,31194,2,13435.0,14,13445.0,6,S
2018-04-26 14:57:58,13440.0,32,31226,-32,13435.0,16,13440.0,8,B
2018-04-26 14:58:00,13435.0,38,31264,-28,13435.0,14,13445.0,1,S
2018-04-26 14:58:01,13440.0,4,31268,-4,13435.0,15,13440.0,3,B
2018-04-26 14:58:01,13435.0,8,31276,-8,13435.0,14,13445.0,7,S
2018-04-26 14:58:02,13440.0,28,31304,-28,13435.0,18,13440.0,7,B
2018-04-26 14:58:02,13440.0,8,31312,-8,13435.0,18,13440.0,3,B
2018-04-26 14:58:03,13440.0,6,31318,-6,13440.0,1,13445.0,7,B
2018-04-26 14:58:03,13440.0,4,31322,-4,13440.0,1,13445.0,7,B
2018-04-26 14:58:04,13445.0,6,31328,-4,13435.0,9,13445.0,4,B
2018-04-26 14:58:04,13440.0,16,31344,-16,13435.0,32,13440.0,1,S
2018-04-26 14:58:05,13440.0,2,31346,-2,13440.0,2,13445.0,5,S
2018-04-26 14:58:20,13445.0,8,31354,2,13435.0,24,13445.0,6,B
2018-04-26 14:58:20,13440.0,12,31366,-12,13440.0,3,13445.0,6,S
2018-04-26 14:58:23,13445.0,12,31378,-10,13445.0,14,13450.0,10,B
2018-04-26 14:58:23,13445.0,8,31386,-8,13445.0,10,13450.0,10,B
2018-04-26 14:58:30,13445.0,2,31388,0,13445.0,9,13450.0,9,B
2018-04-26 14:58:30,13445.0,12,31400,0,13445.0,3,13450.0,9,B
2018-04-26 14:58:31,13445.0,6,31406,-6,13440.0,2,13445.0,1,B
2018-04-26 14:58:33,13445.0,4,31410,-4,13445.0,18,13450.0,10,B
2018-04-26 14:58:47,13450.0,2,31412,-2,13445.0,19,13450.0,15,B
2018-04-26 14:58:49,13445.0,2,31414,-2,13445.0,18,13450.0,15,S
2018-04-26 14:58:49,13445.0,10,31424,-2,13445.0,13,13450.0,16,S
2018-04-26 14:58:50,13445.0,10,31434,-2,13445.0,9,13450.0,15,S
2018-04-26 14:58:51,13445.0,8,31442,0,13445.0,5,13450.0,15,S
2018-04-26 14:58:51,13445.0,8,31450,0,13445.0,1,13450.0,16,S
2018-04-26 14:58:52,13445.0,2,31452,-2,13440.0,3,13450.0,15,S
2018-04-26 14:58:52,13445.0,6,31458,-6,13440.0,5,13450.0,15,S
2018-04-26 14:58:53,13445.0,10,31468,-10,13445.0,1,13450.0,15,S
2018-04-26 14:58:53,13445.0,2,31470,0,13440.0,5,13450.0,15,S
2018-04-26 14:58:54,13445.0,10,31480,-6,13440.0,3,13445.0,5,S
2018-04-26 14:58:55,13450.0,40,31520,-12,13440.0,3,13455.0,4,B
2018-04-26 14:58:57,13440.0,8,31528,2,13440.0,1,13450.0,9,S
2018-04-26 14:58:59,13445.0,2,31530,2,13440.0,3,13450.0,9,B
2018-04-26 14:59:01,13450.0,6,31536,-6,13440.0,4,13450.0,7,B
2018-04-26 14:59:01,13440.0,6,31542,-2,13435.0,5,13450.0,7,S
2018-04-26 14:59:06,13440.0,2,31544,2,13440.0,3,13450.0,28,S
2018-04-26 14:59:07,13450.0,40,31584,-12,13440.0,3,13450.0,8,B
2018-04-26 14:59:07,13445.0,2,31586,0,13440.0,3,13450.0,8,S
2018-04-26 14:59:10,13445.0,8,31594,6,13445.0,3,13450.0,5,S
2018-04-26 14:59:11,13450.0,10,31604,-2,13450.0,15,13455.0,2,B
2018-04-26 14:59:13,13455.0,4,31608,-2,13450.0,14,13455.0,1,B
2018-04-26 14:59:20,13455.0,2,31610,-2,13450.0,14,13455.0,5,B
2018-04-26 14:59:21,13455.0,2,31612,-2,13450.0,14,13455.0,4,B
2018-04-26 14:59:22,13450.0,4,31616,-4,13450.0,12,13455.0,4,S
2018-04-26 14:59:25,13455.0,2,31618,0,13450.0,12,13455.0,3,B
2018-04-26 14:59:26,13450.0,8,31626,0,13450.0,8,13455.0,4,S
2018-04-26 14:59:26,13450.0,8,31634,0,13450.0,4,13455.0,4,S
2018-04-26 14:59:27,13450.0,8,31642,0,13445.0,3,13455.0,4,S
2018-04-26 14:59:29,13445.0,6,31648,6,13440.0,3,13445.0,1,S
2018-04-26 14:59:29,13445.0,2,31650,0,13440.0,3,13445.0,3,S
2018-04-26 14:59:30,13445.0,4,31654,-4,13440.0,3,13445.0,1,S
2018-04-26 14:59:30,13445.0,2,31656,-2,13440.0,3,13455.0,7,S
2018-04-26 14:59:32,13445.0,2,31658,-2,13440.0,3,13455.0,12,S
2018-04-26 14:59:32,13435.0,16,31674,-14,13435.0,3,13455.0,12,S
2018-04-26 14:59:35,13455.0,2,31676,0,13440.0,20,13455.0,13,B
2018-04-26 14:59:38,13455.0,2,31678,0,13440.0,22,13455.0,6,B
2018-04-26 14:59:41,13440.0,2,31680,0,13440.0,21,13455.0,6,S
2018-04-26 14:59:41,13455.0,2,31682,-2,13440.0,21,13455.0,5,B
2018-04-26 14:59:42,13455.0,2,31684,0,13440.0,21,13450.0,3,B
2018-04-26 14:59:45,13455.0,2,31686,-2,13440.0,21,13455.0,4,B
2018-04-26 14:59:47,13445.0,2,31688,0,13440.0,15,13455.0,4,S
2018-04-26 14:59:48,13455.0,2,31690,-2,13440.0,22,13455.0,3,B
2018-04-26 14:59:50,13445.0,2,31692,-2,13440.0,1,13460.0,14,S
2018-04-26 14:59:51,13460.0,2,31694,0,13440.0,2,13460.0,14,B
2018-04-26 14:59:54,13450.0,10,31704,-2,13440.0,3,13460.0,14,S
2018-04-26 14:59:56,13460.0,4,31708,0,13450.0,2,13460.0,12,B
2018-04-26 14:59:57,13450.0,6,31714,-4,13440.0,1,13460.0,13,S
2018-04-26 14:59:58,13440.0,2,31716,2,13435.0,2,13450.0,1,S
2018-04-26 20:59:00,13440.0,204,204,81602,0.0,0,0.0,0,B
2018-04-26 21:00:00,13445.0,76,280,4,13445.0,40,13455.0,2,B
2018-04-26 21:00:01,13460.0,22,302,4,13460.0,6,13465.0,49,B
2018-04-26 21:00:01,13455.0,24,326,8,13455.0,4,13465.0,45,S
2018-04-26 21:00:02,13460.0,28,354,18,13455.0,25,13460.0,16,B
2018-04-26 21:00:02,13465.0,70,424,0,13460.0,8,13465.0,17,B
2018-04-26 21:00:03,13465.0,10,434,0,13460.0,6,13465.0,10,B
2018-04-26 21:00:03,13465.0,20,454,8,13460.0,1,13470.0,3,B
2018-04-26 21:00:04,13460.0,4,458,4,13455.0,7,13465.0,4,S
2018-04-26 21:00:05,13460.0,4,462,2,13455.0,2,13460.0,20,S
2018-04-26 21:00:05,13455.0,8,470,-2,13455.0,2,13460.0,19,S
2018-04-26 21:00:06,13455.0,12,482,2,13455.0,4,13460.0,14,S
2018-04-26 21:00:06,13460.0,4,486,4,13455.0,7,13460.0,12,B
2018-04-26 21:00:09,13455.0,2,488,2,13455.0,5,13460.0,12,S
2018-04-26 21:00:11,13455.0,6,494,4,13450.0,5,13460.0,17,S
2018-04-26 21:00:13,13455.0,2,496,-2,13450.0,11,13460.0,16,S
2018-04-26 21:00:14,13450.0,2,498,2,13450.0,10,13455.0,1,S
2018-04-26 21:00:15,13455.0,4,502,0,13455.0,2,13460.0,14,B
2018-04-26 21:00:15,13460.0,6,508,0,13450.0,8,13460.0,14,B
2018-04-26 21:00:18,13460.0,2,510,2,13455.0,2,13460.0,12,B
2018-04-26 21:00:20,13455.0,4,514,4,13450.0,9,13455.0,18,S
2018-04-26 21:00:20,13455.0,38,552,36,13455.0,1,13460.0,13,S
2018-04-26 21:00:21,13455.0,10,562,4,13450.0,9,13460.0,13,S
2018-04-26 21:00:22,13460.0,2,564,2,13455.0,4,13460.0,11,B
2018-04-26 21:00:23,13455.0,2,566,0,13455.0,7,13460.0,11,S
2018-04-26 21:00:27,13460.0,2,568,2,13455.0,10,13460.0,10,B
2018-04-26 21:00:27,13460.0,2,570,2,13455.0,10,13460.0,9,B
2018-04-26 21:00:29,13460.0,10,580,8,13455.0,17,13460.0,4,B
2018-04-26 21:00:29,13460.0,8,588,2,13455.0,16,13465.0,12,B
2018-04-26 21:00:31,13460.0,6,594,-4,13455.0,15,13460.0,2,B
2018-04-26 21:00:31,13460.0,4,598,-2,13460.0,2,13465.0,11,B
2018-04-26 21:00:32,13460.0,2,600,-2,13460.0,1,13465.0,11,B
2018-04-26 21:00:33,13465.0,2,602,2,13460.0,1,13465.0,15,B
2018-04-26 21:00:37,13460.0,2,604,-2,13460.0,3,13465.0,21,S
2018-04-26 21:00:37,13460.0,2,606,2,13455.0,15,13460.0,2,S
2018-04-26 21:00:39,13455.0,36,642,26,13450.0,18,13455.0,2,S
2018-04-26 21:00:39,13455.0,4,646,2,13455.0,1,13460.0,2,S
2018-04-26 21:00:40,13455.0,2,648,0,13455.0,2,13460.0,15,S
2018-04-26 21:00:41,13455.0,4,652,4,13455.0,2,13460.0,17,S
2018-04-26 21:00:41,13455.0,8,660,2,13450.0,7,13460.0,12,S
2018-04-26 21:00:43,13455.0,2,662,0,13450.0,8,13455.0,1,S
2018-04-26 21:00:47,13455.0,22,684,6,13450.0,7,13460.0,19,S
2018-04-26 21:00:48,13455.0,4,688,4,13450.0,7,13455.0,2,S
2018-04-26 21:00:49,13455.0,4,692,0,13450.0,9,13460.0,21,S
2018-04-26 21:00:52,13450.0,12,704,10,13450.0,1,13455.0,12,S
2018-04-26 21:00:52,13445.0,6,710,-4,13445.0,1,13450.0,5,S
2018-04-26 21:00:53,13445.0,2,712,-2,13445.0,3,13450.0,16,S
2018-04-26 21:00:54,13445.0,2,714,0,13445.0,3,13450.0,16,S
2018-04-26 21:00:56,13445.0,2,716,-2,13445.0,4,13450.0,11,S
2018-04-26 21:00:56,13450.0,22,738,-4,13450.0,2,13455.0,9,B
2018-04-26 21:00:57,13450.0,4,742,0,13450.0,2,13455.0,9,B
2018-04-26 21:00:57,13450.0,4,746,-2,13445.0,18,13455.0,12,B
2018-04-26 21:00:59,13450.0,2,748,2,13445.0,6,13455.0,15,B
2018-04-26 21:01:00,13450.0,2,750,2,13450.0,5,13455.0,16,B
2018-04-26 21:01:01,13450.0,12,762,0,13445.0,5,13455.0,16,B
2018-04-26 21:01:02,13450.0,4,766,0,13445.0,7,13455.0,16,B
2018-04-26 21:01:08,13455.0,2,768,-2,13450.0,12,13455.0,2,B
2018-04-26 21:01:08,13455.0,4,772,-4,13450.0,12,13460.0,11,B
2018-04-26 21:01:09,13450.0,2,774,2,13450.0,11,13460.0,14,S
2018-04-26 21:01:11,13455.0,4,778,0,13455.0,1,13460.0,18,B
2018-04-26 21:01:15,13455.0,2,780,2,13455.0,4,13460.0,20,B
2018-04-26 21:01:16,13460.0,12,792,-2,13455.0,13,13460.0,9,B
2018-04-26 21:01:17,13460.0,18,810,4,13460.0,5,13465.0,12,B
2018-04-26 21:01:18,13465.0,10,820,6,13460.0,8,13465.0,7,B
2018-04-26 21:01:18,13465.0,4,824,0,13460.0,11,13465.0,5,B
2018-04-26 21:01:19,13465.0,10,834,4,13465.0,7,13470.0,6,B
2018-04-26 21:01:20,13470.0,4,838,-2,13465.0,8,13470.0,2,B
2018-04-26 21:01:20,13475.0,8,846,-4,13470.0,9,13475.0,24,B
2018-04-26 21:01:21,13475.0,6,852,0,13470.0,17,13475.0,21,B
2018-04-26 21:01:22,13475.0,42,894,28,13470.0,19,13480.0,10,B
2018-04-26 21:01:22,13480.0,2,896,-2,13475.0,8,13480.0,9,B
2018-04-26 21:01:23,13475.0,14,910,4,13475.0,1,13480.0,13,S
2018-04-26 21:01:24,13475.0,2,912,2,13470.0,15,13475.0,8,S
2018-04-26 21:01:26,13475.0,6,918,-4,13470.0,15,13475.0,2,S
2018-04-26 21:01:27,13475.0,4,922,-4,13475.0,10,13480.0,18,S
2018-04-26 21:01:30,13475.0,4,926,4,13475.0,9,13480.0,11,S
2018-04-26 21:01:30,13475.0,6,932,0,13475.0,6,13480.0,17,S
2018-04-26 21:01:31,13475.0,4,936,0,13475.0,4,13480.0,17,S
2018-04-26 21:01:32,13475.0,6,942,0,13470.0,10,13475.0,4,S
2018-04-26 21:01:34,13475.0,4,946,0,13470.0,19,13475.0,11,S
2018-04-26 21:01:35,13475.0,22,968,18,13470.0,19,13480.0,21,S
2018-04-26 21:01:37,13475.0,4,972,0,13470.0,19,13480.0,20,S
2018-04-26 21:01:40,13475.0,2,974,0,13470.0,17,13480.0,32,S
2018-04-26 21:01:44,13470.0,2,976,0,13470.0,7,13475.0,20,S
2018-04-26 21:01:44,13470.0,2,978,-2,13470.0,6,13475.0,20,S
2018-04-26 21:01:45,13470.0,6,984,-2,13470.0,1,13475.0,20,S
2018-04-26 21:01:45,13470.0,6,990,-2,13470.0,4,13475.0,6,S
2018-04-26 21:01:46,13470.0,2,992,0,13470.0,9,13475.0,5,S
2018-04-26 21:01:47,13475.0,6,998,2,13470.0,9,13475.0,2,B
2018-04-26 21:01:50,13470.0,6,1004,6,13470.0,8,13475.0,2,S
2018-04-26 21:01:51,13475.0,6,1010,0,13475.0,1,13480.0,44,B
2018-04-26 21:01:52,13475.0,2,1012,0,13475.0,3,13480.0,44,B
2018-04-26 21:01:54,13475.0,4,1016,0,13475.0,1,13480.0,39,B
2018-04-26 21:01:54,13475.0,2,1018,0,13470.0,9,13480.0,39,B
2018-04-26 21:01:59,13470.0,2,1020,2,13470.0,8,13475.0,7,S
2018-04-26 21:02:02,13470.0,2,1022,2,13470.0,8,13475.0,7,S
2018-04-26 21:02:02,13475.0,8,1030,0,13470.0,11,13475.0,3,B
2018-04-26 21:02:03,13475.0,6,1036,-4,13475.0,4,13480.0,55,B
2018-04-26 21:02:03,13475.0,4,1040,2,13475.0,2,13480.0,51,B
2018-04-26 21:02:04,13475.0,4,1044,0,13470.0,14,13480.0,51,B
2018-04-26 21:02:06,13475.0,4,1048,-4,13470.0,7,13475.0,14,B
2018-04-26 21:02:11,13475.0,8,1056,-8,13470.0,7,13475.0,6,B
2018-04-26 21:02:16,13470.0,2,1058,-2,13470.0,7,13475.0,13,S
2018-04-26 21:02:17,13475.0,2,1060,0,13470.0,10,13475.0,12,B
2018-04-26 21:02:20,13470.0,2,1062,2,13470.0,9,13475.0,11,S
2018-04-26 21:02:22,13470.0,4,1066,-2,13470.0,9,13475.0,21,S
2018-04-26 21:02:22,13470.0,18,1084,-10,13465.0,10,13470.0,2,S
2018-04-26 21:02:32,13470.0,2,1086,0,13465.0,13,13475.0,25,S
2018-04-26 21:02:39,13470.0,2,1088,-2,13470.0,8,13475.0,26,S
2018-04-26 21:02:43,13470.0,16,1104,6,13465.0,9,13470.0,3,S
2018-04-26 21:02:45,13465.0,8,1112,2,13460.0,6,13470.0,20,S
2018-04-26 21:02:46,13460.0,8,1120,2,13455.0,4,13465.0,19,S
2018-04-26 21:02:47,13460.0,2,1122,2,13455.0,7,13465.0,22,S
2018-04-26 21:02:49,13455.0,6,1128,2,13450.0,3,13460.0,11,S
2018-04-26 21:02:50,13450.0,2,1130,0,13450.0,4,13455.0,3,S
2018-04-26 21:02:53,13450.0,36,1166,6,13445.0,14,13450.0,282,S
2018-04-26 21:02:54,13450.0,100,1266,24,13445.0,1,13450.0,258,S
2018-04-26 21:02:54,13445.0,18,1284,8,13445.0,1,13450.0,262,S
2018-04-26 21:02:55,13445.0,10,1294,-4,13445.0,1,13450.0,262,S
2018-04-26 21:02:55,13440.0,6,1300,4,13440.0,6,13445.0,4,S
2018-04-26 21:02:56,13445.0,10,1310,6,13440.0,7,13445.0,1,B
2018-04-26 21:02:56,13445.0,4,1314,2,13440.0,5,13445.0,3,B
2018-04-26 21:02:57,13445.0,2,1316,0,13440.0,6,13445.0,3,B
2018-04-26 21:02:57,13440.0,8,1324,-2,13440.0,4,13445.0,2,S
2018-04-26 21:03:01,13440.0,8,1332,-2,13435.0,3,13445.0,14,S
2018-04-26 21:03:02,13440.0,4,1336,4,13435.0,7,13440.0,1,S
2018-04-26 21:03:02,13440.0,4,1340,2,13435.0,15,13445.0,12,S
2018-04-26 21:03:03,13440.0,6,1346,-6,13435.0,24,13440.0,7,S
2018-04-26 21:03:04,13445.0,24,1370,-4,13440.0,2,13445.0,2,B
2018-04-26 21:03:05,13440.0,10,1380,6,13440.0,5,13445.0,2,S
2018-04-26 21:03:08,13445.0,2,1382,0,13440.0,8,13445.0,2,B
2018-04-26 21:03:09,13445.0,2,1384,0,13440.0,9,13450.0,264,B
2018-04-26 21:03:12,13440.0,4,1388,4,13440.0,15,13450.0,264,S
2018-04-26 21:03:29,13440.0,2,1390,2,13440.0,19,13445.0,5,S
2018-04-26 21:03:30,13445.0,4,1394,0,13440.0,19,13445.0,3,B
2018-04-26 21:03:33,13445.0,6,1400,6,13440.0,48,13445.0,4,B
2018-04-26 21:03:34,13445.0,8,1408,-4,13440.0,48,13450.0,7,B
2018-04-26 21:03:35,13445.0,2,1410,-2,13445.0,1,13450.0,11,B
2018-04-26 21:03:38,13445.0,4,1414,-2,13445.0,1,13450.0,13,B
2018-04-26 21:03:41,13450.0,2,1416,-2,13445.0,5,13450.0,11,B
2018-04-26 21:03:45,13445.0,10,1426,6,13440.0,44,13445.0,45,S
2018-04-26 21:03:45,13445.0,2,1428,0,13440.0,47,13445.0,44,S
2018-04-26 21:03:46,13445.0,2,1430,2,13440.0,47,13445.0,43,S
2018-04-26 21:03:50,13445.0,24,1454,12,13440.0,54,13445.0,31,S
2018-04-26 21:03:51,13445.0,62,1516,30,13445.0,12,13450.0,6,S
2018-04-26 21:03:51,13450.0,4,1520,2,13445.0,12,13450.0,4,B
2018-04-26 21:03:56,13450.0,6,1526,4,13445.0,29,13450.0,3,B
2018-04-26 21:03:59,13445.0,8,1534,0,13445.0,16,13450.0,19,S
2018-04-26 21:04:00,13445.0,2,1536,-2,13445.0,15,13450.0,19,S
2018-04-26 21:04:05,13450.0,10,1546,4,13445.0,23,13455.0,5,B
2018-04-26 21:04:07,13450.0,42,1588,32,13445.0,18,13450.0,22,B
2018-04-26 21:04:08,13450.0,2,1590,2,13445.0,21,13450.0,21,B
2018-04-26 21:04:10,13450.0,2,1592,0,13445.0,22,13450.0,20,B
2018-04-26 21:04:11,13450.0,2,1594,0,13445.0,27,13450.0,19,B
2018-04-26 21:04:13,13450.0,2,1596,0,13445.0,27,13450.0,19,B
2018-04-26 21:04:15,13445.0,42,1638,-2,13440.0,41,13445.0,2,S
2018-04-26 21:04:17,13445.0,2,1640,0,13440.0,50,13450.0,25,S
2018-04-26 21:04:20,13450.0,4,1644,4,13445.0,11,13450.0,17,B
2018-04-26 21:04:20,13445.0,6,1650,6,13445.0,12,13450.0,15,S
2018-04-26 21:04:21,13440.0,74,1724,-36,13440.0,15,13445.0,30,S
2018-04-26 21:04:21,13440.0,12,1736,0,13440.0,9,13445.0,31,S
2018-04-26 21:04:22,13445.0,16,1752,-8,13440.0,23,13450.0,19,B
2018-04-26 21:04:23,13445.0,6,1758,0,13440.0,17,13450.0,20,B
2018-04-26 21:04:28,13440.0,22,1780,-16,13435.0,14,13445.0,13,S
2018-04-26 21:04:29,13435.0,28,1808,-10,13430.0,4,13435.0,6,S
2018-04-26 21:04:29,13435.0,2,1810,0,13430.0,2,13435.0,2,S
2018-04-26 21:04:30,13435.0,4,1814,-4,13435.0,5,13440.0,15,S
2018-04-26 21:04:31,13440.0,2,1816,-2,13435.0,5,13440.0,9,B
2018-04-26 21:04:33,13435.0,4,1820,0,13435.0,3,13440.0,12,S
2018-04-26 21:04:34,13435.0,2,1822,-2,13430.0,6,13435.0,4,S
2018-04-26 21:04:36,13430.0,8,1830,4,13425.0,5,13435.0,6,S
2018-04-26 21:04:36,13425.0,4,1834,-4,13425.0,6,13435.0,5,S
2018-04-26 21:04:37,13425.0,10,1844,8,13425.0,2,13430.0,2,S
2018-04-26 21:04:37,13430.0,4,1848,0,13425.0,12,13430.0,2,B
2018-04-26 21:04:38,13430.0,4,1852,0,13430.0,2,13435.0,6,B
2018-04-26 21:04:44,13430.0,4,1856,0,13430.0,1,13435.0,7,B
2018-04-26 21:04:49,13435.0,4,1860,-2,13430.0,22,13435.0,7,B
2018-04-26 21:04:51,13435.0,10,1870,-4,13435.0,5,13440.0,13,B
2018-04-26 21:04:55,13435.0,4,1874,4,13435.0,12,13440.0,10,B
2018-04-26 21:05:01,13440.0,2,1876,2,13435.0,14,13440.0,3,B
2018-04-26 21:05:01,13440.0,6,1882,-4,13440.0,3,13445.0,5,B
2018-04-26 21:05:07,13440.0,2,1884,0,13440.0,3,13445.0,8,B
2018-04-26 21:05:16,13440.0,4,1888,0,13435.0,19,13440.0,7,B
2018-04-26 21:05:29,13440.0,8,1896,-8,13435.0,19,13445.0,26,B
2018-04-26 21:05:32,13440.0,2,1898,-2,13435.0,15,13440.0,2,B
2018-04-26 21:05:33,13440.0,4,1902,0,13440.0,2,13445.0,26,B
2018-04-26 21:05:48,13440.0,16,1918,14,13435.0,9,13440.0,2,B
2018-04-26 21:05:49,13440.0,2,1920,0,13435.0,10,13440.0,1,B
2018-04-26 21:05:51,13435.0,12,1932,0,13430.0,35,13435.0,11,S
2018-04-26 21:05:53,13430.0,6,1938,2,13430.0,27,13435.0,7,S
2018-04-26 21:05:57,13430.0,8,1946,0,13430.0,23,13435.0,7,S
2018-04-26 21:06:00,13435.0,2,1948,0,13430.0,24,13435.0,6,B
2018-04-26 21:06:20,13435.0,8,1956,-4,13435.0,1,13440.0,16,B
2018-04-26 21:06:20,13435.0,2,1958,0,13430.0,27,13435.0,3,B
2018-04-26 21:06:22,13435.0,2,1960,-2,13435.0,3,13440.0,16,B
2018-04-26 21:06:23,13430.0,20,1980,0,13430.0,20,13435.0,1,S
2018-04-26 21:06:26,13430.0,2,1982,-2,13430.0,17,13435.0,16,S
2018-04-26 21:06:27,13435.0,2,1984,0,13430.0,17,13435.0,15,B
2018-04-26 21:06:30,13430.0,6,1990,-6,13430.0,14,13435.0,15,S
2018-04-26 21:06:31,13435.0,30,2020,-20,13435.0,35,13440.0,25,B
2018-04-26 21:06:31,13435.0,70,2090,0,13430.0,14,13435.0,1,B
2018-04-26 21:06:35,13430.0,20,2110,-18,13430.0,2,13435.0,6,S
2018-04-26 21:06:35,13430.0,4,2114,2,13425.0,4,13430.0,2,S
2018-04-26 21:06:37,13425.0,6,2120,-6,13420.0,4,13425.0,1,S
2018-04-26 21:06:42,13425.0,6,2126,0,13420.0,18,13430.0,11,S
2018-04-26 21:06:43,13430.0,2,2128,0,13425.0,21,13430.0,4,B
2018-04-26 21:06:45,13425.0,2,2130,0,13425.0,20,13430.0,3,S
2018-04-26 21:06:49,13430.0,6,2136,4,13425.0,23,13435.0,9,B
2018-04-26 21:06:51,13430.0,8,2144,-4,13425.0,16,13430.0,4,B
2018-04-26 21:07:00,13430.0,2,2146,-2,13425.0,17,13435.0,13,B
2018-04-26 21:07:03,13435.0,8,2154,2,13430.0,17,13435.0,3,B
2018-04-26 21:07:04,13435.0,6,2160,-2,13430.0,13,13440.0,9,B
2018-04-26 21:07:06,13435.0,2,2162,2,13435.0,1,13440.0,11,B
2018-04-26 21:07:09,13440.0,14,2176,-4,13440.0,14,13445.0,5,B
2018-04-26 21:07:10,13445.0,10,2186,-6,13440.0,18,13450.0,19,B
2018-04-26 21:07:10,13445.0,2,2188,0,13445.0,1,13450.0,5,B
2018-04-26 21:07:16,13445.0,2,2190,2,13440.0,24,13450.0,9,B
2018-04-26 21:07:18,13445.0,8,2198,2,13440.0,16,13445.0,4,B
2018-04-26 21:07:19,13445.0,10,2208,2,13440.0,10,13450.0,15,B
2018-04-26 21:07:27,13440.0,10,2218,10,13440.0,12,13445.0,1,S
2018-04-26 21:07:29,13445.0,2,2220,2,13445.0,1,13450.0,21,B
2018-04-26 21:07:29,13445.0,2,2222,0,13440.0,13,13450.0,20,B
2018-04-26 21:07:35,13450.0,2,2224,-2,13440.0,23,13450.0,9,B
2018-04-26 21:07:38,13445.0,2,2226,-2,13440.0,9,13450.0,11,S
2018-04-26 21:07:43,13445.0,2,2228,0,13440.0,17,13450.0,9,S
2018-04-26 21:07:59,13440.0,6,2234,0,13440.0,16,13450.0,8,S
2018-04-26 21:08:09,13430.0,92,2326,52,13425.0,5,13430.0,208,S
2018-04-26 21:08:10,13430.0,164,2490,76,13425.0,11,13430.0,126,S
2018-04-26 21:08:10,13430.0,138,2628,90,13425.0,24,13430.0,59,S
2018-04-26 21:08:11,13425.0,14,2642,-2,13420.0,25,13430.0,66,S
2018-04-26 21:08:11,13420.0,12,2654,4,13420.0,23,13430.0,62,S
2018-04-26 21:08:12,13425.0,2,2656,-2,13420.0,11,13425.0,1,B
2018-04-26 21:08:12,13425.0,2,2658,0,13420.0,11,13425.0,8,B
2018-04-26 21:08:15,13420.0,4,2662,4,13420.0,7,13425.0,8,S
2018-04-26 21:08:16,13425.0,2,2664,0,13420.0,7,13425.0,7,B
2018-04-26 21:08:17,13425.0,2,2666,-2,13420.0,7,13425.0,6,B
2018-04-26 21:08:18,13430.0,16,2682,-4,13420.0,7,13430.0,57,B
2018-04-26 21:08:18,13425.0,4,2686,-2,13425.0,1,13430.0,55,S
2018-04-26 21:08:19,13425.0,10,2696,0,13420.0,10,13425.0,1,S
2018-04-26 21:08:20,13425.0,12,2708,-12,13420.0,10,13425.0,3,S
2018-04-26 21:08:20,13425.0,6,2714,-6,13420.0,14,13430.0,55,S
2018-04-26 21:08:23,13425.0,6,2720,-4,13425.0,1,13430.0,55,S
2018-04-26 21:08:24,13425.0,6,2726,0,13420.0,6,13425.0,3,S
2018-04-26 21:08:25,13425.0,2,2728,-2,13420.0,7,13430.0,56,S
2018-04-26 21:08:29,13420.0,20,2748,10,13415.0,7,13425.0,2,S
2018-04-26 21:08:31,13425.0,2,2750,0,13415.0,7,13425.0,1,B
2018-04-26 21:08:35,13420.0,2,2752,0,13420.0,1,13425.0,6,S
2018-04-26 21:08:36,13410.0,56,2808,20,13405.0,7,13410.0,26,S
2018-04-26 21:08:37,13420.0,60,2868,56,13415.0,19,13420.0,1,B
2018-04-26 21:08:39,13420.0,2,2870,0,13415.0,18,13425.0,4,B
2018-04-26 21:08:47,13420.0,2,2872,2,13415.0,20,13425.0,6,B
2018-04-26 21:08:52,13420.0,2,2874,0,13415.0,20,13425.0,9,B
2018-04-26 21:09:04,13420.0,2,2876,-2,13420.0,2,13425.0,9,B
2018-04-26 21:09:06,13425.0,8,2884,2,13420.0,12,13430.0,7,B
2018-04-26 21:09:09,13425.0,8,2892,8,13420.0,11,13430.0,9,B
2018-04-26 21:09:15,13420.0,2,2894,0,13420.0,5,13425.0,4,S
2018-04-26 21:09:16,13415.0,10,2904,6,13415.0,8,13425.0,13,S
2018-04-26 21:09:17,13420.0,4,2908,0,13420.0,3,13425.0,13,B
2018-04-26 21:09:17,13420.0,2,2910,0,13420.0,2,13425.0,13,B
2018-04-26 21:09:18,13420.0,2,2912,2,13420.0,1,13425.0,13,B
2018-04-26 21:09:21,13420.0,2,2914,0,13415.0,8,13425.0,12,B
2018-04-26 21:09:23,13425.0,2,2916,-2,13415.0,9,13425.0,11,B
2018-04-26 21:09:23,13425.0,2,2918,0,13415.0,10,13425.0,10,B
2018-04-26 21:09:27,13425.0,2,2920,-2,13420.0,2,13425.0,9,B
2018-04-26 21:09:28,13425.0,2,2922,0,13420.0,2,13425.0,8,B
2018-04-26 21:09:41,13420.0,14,2936,14,13415.0,13,13420.0,11,S
2018-04-26 21:09:42,13420.0,22,2958,22,13415.0,15,13425.0,7,S
2018-04-26 21:09:42,13420.0,2,2960,0,13420.0,1,13425.0,7,S
2018-04-26 21:09:50,13420.0,6,2966,2,13420.0,1,13425.0,7,S
2018-04-26 21:09:51,13420.0,2,2968,2,13415.0,15,13425.0,7,S
2018-04-26 21:10:04,13425.0,2,2970,0,13420.0,4,13425.0,4,B
2018-04-26 21:10:09,13425.0,2,2972,-2,13420.0,5,13425.0,3,B
2018-04-26 21:10:16,13425.0,2,2974,-2,13420.0,20,13425.0,4,B
2018-04-26 21:10:18,13420.0,4,2978,-4,13415.0,11,13420.0,2,S
2018-04-26 21:10:18,13415.0,12,2990,-6,13415.0,5,13420.0,12,S
2018-04-26 21:10:19,13415.0,10,3000,0,13410.0,15,13420.0,14,S
2018-04-26 21:10:20,13415.0,2,3002,-2,13410.0,17,13415.0,3,S
2018-04-26 21:10:23,13410.0,6,3008,0,13410.0,14,13415.0,3,S
2018-04-26 21:10:24,13415.0,2,3010,0,13410.0,11,13415.0,4,B
2018-04-26 21:10:27,13415.0,2,3012,0,13410.0,12,13415.0,3,B
2018-04-26 21:10:30,13415.0,2,3014,0,13410.0,12,13415.0,4,B
2018-04-26 21:10:31,13410.0,2,3016,0,13410.0,11,13415.0,7,S
2018-04-26 21:10:31,13410.0,2,3018,2,13410.0,10,13415.0,7,S
2018-04-26 21:10:33,13410.0,2,3020,0,13410.0,13,13415.0,7,S
2018-04-26 21:10:37,13410.0,2,3022,0,13410.0,10,13415.0,9,S
2018-04-26 21:10:55,13415.0,4,3026,-4,13410.0,12,13415.0,4,B
2018-04-26 21:10:59,13410.0,26,3052,-22,13405.0,4,13410.0,22,S
2018-04-26 21:11:00,13410.0,44,3096,-28,13410.0,3,13415.0,4,S
2018-04-26 21:11:00,13410.0,4,3100,2,13410.0,1,13415.0,12,S
2018-04-26 21:11:01,13410.0,6,3106,-4,13405.0,6,13415.0,12,S
2018-04-26 21:11:10,13410.0,2,3108,0,13405.0,8,13410.0,5,S
2018-04-26 21:11:16,13410.0,12,3120,10,13405.0,7,13415.0,11,S
2018-04-26 21:11:20,13410.0,10,3130,6,13410.0,9,13415.0,4,S
2018-04-26 21:11:24,13415.0,2,3132,-2,13410.0,9,13415.0,2,B
2018-04-26 21:11:27,13410.0,4,3136,2,13410.0,7,13415.0,1,S
2018-04-26 21:11:32,13415.0,2,3138,-2,13410.0,10,13415.0,1,B
2018-04-26 21:11:39,13415.0,2,3140,-2,13410.0,10,13415.0,2,B
2018-04-26 21:11:46,13410.0,2,3142,2,13410.0,9,13415.0,7,S
2018-04-26 21:11:51,13410.0,6,3148,0,13410.0,6,13415.0,6,S
2018-04-26 21:11:55,13410.0,2,3150,0,13410.0,5,13415.0,7,S
2018-04-26 21:11:56,13410.0,4,3154,-4,13405.0,8,13410.0,6,S
2018-04-26 21:11:58,13410.0,2,3156,-2,13405.0,7,13410.0,3,S
2018-04-26 21:12:02,13410.0,2,3158,0,13405.0,7,13410.0,1,S
2018-04-26 21:12:02,13410.0,2,3160,-2,13410.0,9,13415.0,8,S
2018-04-26 21:12:04,13410.0,2,3162,0,13410.0,1,13415.0,8,S
2018-04-26 21:12:12,13410.0,4,3166,0,13405.0,7,13410.0,1,S
2018-04-26 21:12:12,13410.0,2,3168,-2,13410.0,5,13415.0,10,S
2018-04-26 21:12:14,13415.0,6,3174,-6,13415.0,7,13420.0,10,B
2018-04-26 21:12:17,13415.0,2,3176,-2,13415.0,2,13420.0,10,B
2018-04-26 21:12:23,13415.0,2,3178,-2,13410.0,5,13415.0,4,B
2018-04-26 21:12:24,13415.0,8,3186,0,13410.0,5,13420.0,26,B
2018-04-26 21:12:27,13415.0,2,3188,2,13415.0,4,13420.0,11,B
2018-04-26 21:12:35,13420.0,8,3196,-4,13420.0,7,13425.0,10,B
2018-04-26 21:12:37,13425.0,2,3198,2,13420.0,6,13425.0,5,B
2018-04-26 21:12:37,13425.0,2,3200,2,13420.0,6,13425.0,4,B
2018-04-26 21:12:38,13420.0,2,3202,0,13420.0,5,13425.0,5,S
2018-04-26 21:12:40,13425.0,2,3204,0,13420.0,7,13425.0,9,B
2018-04-26 21:12:42,13420.0,4,3208,4,13420.0,6,13425.0,9,S
2018-04-26 21:12:47,13420.0,8,3216,4,13415.0,4,13425.0,16,S
2018-04-26 21:12:50,13415.0,2,3218,0,13410.0,4,13415.0,1,S
2018-04-26 21:12:50,13415.0,2,3220,2,13415.0,1,13420.0,10,S
2018-04-26 21:12:51,13415.0,2,3222,2,13410.0,6,13415.0,3,S
2018-04-26 21:12:52,13410.0,10,3232,8,13405.0,7,13410.0,4,S
2018-04-26 21:12:57,13410.0,2,3234,-2,13405.0,8,13410.0,3,S
2018-04-26 21:12:58,13410.0,2,3236,2,13405.0,8,13415.0,21,S
2018-04-26 21:13:02,13415.0,2,3238,0,13410.0,10,13420.0,5,B
2018-04-26 21:13:11,13415.0,2,3240,2,13410.0,11,13420.0,8,B
2018-04-26 21:13:33,13420.0,2,3242,-2,13415.0,8,13425.0,18,B
2018-04-26 21:13:38,13420.0,2,3244,0,13415.0,11,13425.0,15,B
2018-04-26 21:13:51,13425.0,10,3254,6,13420.0,1,13425.0,15,B
2018-04-26 21:13:56,13425.0,6,3260,2,13420.0,1,13425.0,12,B
2018-04-26 21:13:58,13420.0,2,3262,2,13420.0,1,13425.0,12,S
2018-04-26 21:14:02,13425.0,8,3270,-4,13425.0,3,13430.0,9,B
2018-04-26 21:14:03,13430.0,12,3282,-6,13425.0,8,13430.0,1,B
2018-04-26 21:14:04,13430.0,2,3284,0,13430.0,1,13435.0,20,B
2018-04-26 21:14:09,13430.0,2,3286,2,13430.0,7,13435.0,5,B
2018-04-26 21:14:12,13435.0,20,3306,4,13435.0,20,13440.0,19,B
2018-04-26 21:14:12,13435.0,40,3346,0,13430.0,2,13435.0,3,B
2018-04-26 21:14:15,13435.0,6,3352,0,13430.0,2,13435.0,3,B
2018-04-26 21:14:23,13435.0,2,3354,0,13430.0,6,13435.0,4,B
2018-04-26 21:14:28,13430.0,10,3364,6,13425.0,4,13430.0,10,S
2018-04-26 21:14:28,13425.0,4,3368,4,13425.0,1,13430.0,13,S
2018-04-26 21:14:30,13425.0,6,3374,0,13425.0,2,13430.0,13,S
2018-04-26 21:14:36,13430.0,4,3378,-4,13425.0,4,13430.0,7,B
2018-04-26 21:14:54,13425.0,6,3384,4,13420.0,19,13430.0,8,S
2018-04-26 21:15:02,13430.0,2,3386,-2,13425.0,3,13430.0,12,B
2018-04-26 21:15:08,13430.0,8,3394,0,13425.0,4,13430.0,8,B
2018-04-26 21:15:32,13430.0,4,3398,0,13425.0,11,13435.0,12,B
2018-04-26 21:15:36,13435.0,6,3404,-4,13430.0,2,13435.0,2,B
2018-04-26 21:15:39,13435.0,6,3410,0,13430.0,12,13435.0,2,B
2018-04-26 21:15:40,13435.0,4,3414,0,13435.0,1,13440.0,6,B
2018-04-26 21:15:41,13440.0,4,3418,-4,13435.0,4,13440.0,6,B
2018-04-26 21:15:51,13435.0,2,3420,2,13435.0,8,13440.0,11,S
2018-04-26 21:15:54,13440.0,16,3436,-16,13435.0,9,13445.0,20,B
2018-04-26 21:15:55,13445.0,2,3438,0,13440.0,2,13445.0,19,B
2018-04-26 21:15:56,13445.0,38,3476,28,13440.0,10,13450.0,12,B
2018-04-26 21:15:58,13445.0,6,3482,-4,13440.0,13,13445.0,2,B
2018-04-26 21:16:00,13450.0,10,3492,6,13440.0,13,13450.0,9,B
2018-04-26 21:16:01,13445.0,4,3496,2,13440.0,13,13450.0,9,S
2018-04-26 21:16:05,13450.0,26,3522,4,13445.0,8,13455.0,4,B
2018-04-26 21:16:06,13455.0,8,3530,-6,13450.0,5,13460.0,10,B
2018-04-26 21:16:09,13455.0,2,3532,2,13450.0,7,13455.0,7,B
2018-04-26 21:16:11,13455.0,14,3546,6,13450.0,1,13455.0,6,B
2018-04-26 21:16:12,13450.0,6,3552,-2,13445.0,5,13450.0,3,S
2018-04-26 21:16:13,13450.0,2,3554,0,13445.0,5,13450.0,4,S
2018-04-26 21:16:20,13445.0,8,3562,6,13440.0,7,13445.0,1,S
2018-04-26 21:16:24,13440.0,4,3566,-2,13435.0,11,13445.0,9,S
2018-04-26 21:16:35,13435.0,2,3568,2,13435.0,15,13445.0,9,S
2018-04-26 21:16:40,13440.0,2,3570,0,13435.0,11,13440.0,3,B
2018-04-26 21:16:42,13440.0,4,3574,0,13440.0,2,13445.0,9,B
2018-04-26 21:16:46,13440.0,2,3576,-2,13440.0,2,13445.0,9,B
2018-04-26 21:16:51,13440.0,2,3578,2,13435.0,12,13440.0,2,B
2018-04-26 21:16:54,13435.0,8,3586,0,13435.0,5,13440.0,10,S
2018-04-26 21:16:54,13440.0,2,3588,0,13435.0,5,13440.0,9,B
2018-04-26 21:16:55,13440.0,2,3590,2,13435.0,5,13440.0,8,B
2018-04-26 21:16:56,13440.0,2,3592,2,13435.0,5,13440.0,7,B
2018-04-26 21:17:04,13435.0,2,3594,-2,13435.0,6,13440.0,7,S
2018-04-26 21:17:08,13435.0,12,3606,12,13430.0,7,13440.0,9,S
2018-04-26 21:17:10,13430.0,2,3608,2,13425.0,4,13435.0,6,S
2018-04-26 21:17:11,13425.0,4,3612,2,13425.0,5,13430.0,2,S
2018-04-26 21:17:13,13430.0,4,3616,-2,13425.0,7,13435.0,7,B
2018-04-26 21:17:20,13430.0,8,3624,0,13430.0,6,13435.0,5,B
2018-04-26 21:17:22,13430.0,4,3628,2,13425.0,6,13430.0,1,B
2018-04-26 21:17:23,13430.0,2,3630,2,13425.0,4,13435.0,16,B
2018-04-26 21:17:25,13425.0,8,3638,4,13425.0,1,13430.0,1,S
2018-04-26 21:17:30,13430.0,12,3650,10,13425.0,3,13430.0,1,B
2018-04-26 21:17:32,13430.0,2,3652,2,13430.0,1,13435.0,10,B
2018-04-26 21:17:33,13430.0,2,3654,0,13430.0,1,13435.0,10,B
2018-04-26 21:17:37,13435.0,10,3664,-6,13430.0,2,13435.0,5,B
2018-04-26 21:17:52,13435.0,10,3674,2,13430.0,4,13435.0,1,B
2018-04-26 21:17:55,13435.0,2,3676,0,13430.0,8,13440.0,9,B
2018-04-26 21:18:09,13435.0,2,3678,0,13430.0,12,13440.0,10,B
2018-04-26 21:18:15,13440.0,2,3680,0,13435.0,1,13440.0,9,B
2018-04-26 21:18:15,13435.0,2,3682,2,13430.0,13,13435.0,1,S
2018-04-26 21:18:22,13435.0,4,3686,2,13435.0,3,13440.0,8,S
2018-04-26 21:18:22,13435.0,6,3692,0,13430.0,8,13435.0,15,S
2018-04-26 21:18:23,13430.0,16,3708,-10,13425.0,14,13435.0,14,S
2018-04-26 21:18:53,13430.0,2,3710,0,13425.0,13,13435.0,16,S
2018-04-26 21:19:05,13435.0,2,3712,0,13425.0,13,13435.0,12,B
2018-04-26 21:19:28,13430.0,4,3716,4,13425.0,12,13435.0,15,S
2018-04-26 21:19:57,13425.0,8,3724,-4,13420.0,24,13430.0,11,S
2018-04-26 21:19:59,13425.0,6,3730,6,13420.0,25,13425.0,2,S
2018-04-26 21:20:00,13420.0,6,3736,4,13420.0,22,13425.0,2,S
2018-04-26 21:20:01,13425.0,4,3740,2,13420.0,22,13430.0,12,B
2018-04-26 21:20:07,13430.0,20,3760,8,13425.0,3,13435.0,10,B
2018-04-26 21:20:09,13430.0,6,3766,0,13425.0,8,13435.0,12,B
2018-04-26 21:20:11,13435.0,8,3774,2,13430.0,11,13440.0,3,B
2018-04-26 21:20:11,13435.0,2,3776,-2,13435.0,5,13440.0,5,B
2018-04-26 21:20:12,13435.0,6,3782,-6,13435.0,3,13440.0,6,B
2018-04-26 21:20:12,13435.0,6,3788,6,13430.0,11,13440.0,7,B
2018-04-26 21:20:37,13445.0,12,3800,4,13435.0,9,13445.0,9,B
2018-04-26 21:20:59,13440.0,2,3802,2,13435.0,12,13445.0,12,S
2018-04-26 21:21:03,13435.0,8,3810,-2,13430.0,7,13440.0,3,S
2018-04-26 21:21:04,13435.0,4,3814,2,13430.0,9,13440.0,7,S
2018-04-26 21:21:51,13435.0,8,3822,2,13430.0,11,13435.0,8,S
2018-04-26 21:21:54,13435.0,2,3824,0,13430.0,8,13435.0,5,S
2018-04-26 21:21:57,13435.0,2,3826,0,13430.0,8,13435.0,4,S
2018-04-26 21:22:35,13435.0,2,3828,0,13430.0,8,13435.0,4,S
2018-04-26 21:22:47,13435.0,10,3838,2,13430.0,7,13440.0,10,S
2018-04-26 21:22:52,13435.0,2,3840,0,13430.0,7,13435.0,2,S
2018-04-26 21:22:54,13430.0,4,3844,-4,13430.0,2,13435.0,9,S
2018-04-26 21:22:54,13430.0,4,3848,2,13425.0,9,13430.0,2,S
2018-04-26 21:23:00,13425.0,6,3854,2,13425.0,8,13430.0,2,S
2018-04-26 21:23:01,13430.0,2,3856,2,13425.0,8,13430.0,1,B
2018-04-26 21:23:10,13430.0,2,3858,-2,13425.0,7,13435.0,22,B
2018-04-26 21:23:18,13430.0,6,3864,4,13430.0,8,13435.0,2,B
2018-04-26 21:23:25,13435.0,2,3866,0,13430.0,9,13440.0,23,B
2018-04-26 21:23:29,13435.0,2,3868,0,13435.0,3,13440.0,26,B
2018-04-26 21:23:31,13435.0,2,3870,0,13435.0,2,13440.0,14,B
2018-04-26 21:23:35,13435.0,6,3876,6,13430.0,8,13440.0,14,B
2018-04-26 21:23:55,13440.0,4,3880,0,13440.0,3,13445.0,8,B
2018-04-26 21:23:56,13435.0,8,3888,2,13435.0,7,13440.0,1,S
2018-04-26 21:23:59,13435.0,6,3894,0,13435.0,5,13445.0,15,S
2018-04-26 21:24:07,13435.0,4,3898,-4,13430.0,22,13440.0,8,S
2018-04-26 21:24:25,13430.0,6,3904,2,13430.0,4,13435.0,6,S
2018-04-26 21:24:33,13435.0,2,3906,0,13430.0,5,13435.0,5,B
2018-04-26 21:24:51,13435.0,4,3910,-4,13430.0,19,13435.0,2,B
2018-04-26 21:24:51,13435.0,4,3914,-4,13435.0,2,13440.0,8,B
2018-04-26 21:25:17,13440.0,4,3918,4,13440.0,1,13445.0,12,B
2018-04-26 21:25:18,13440.0,2,3920,2,13435.0,20,13445.0,27,B
2018-04-26 21:25:22,13445.0,4,3924,-2,13440.0,10,13445.0,3,B
2018-04-26 21:25:22,13450.0,14,3938,-2,13445.0,1,13450.0,12,B
2018-04-26 21:25:28,13445.0,2,3940,2,13445.0,1,13450.0,10,S
2018-04-26 21:25:46,13440.0,4,3944,2,13435.0,20,13440.0,2,S
2018-04-26 21:25:50,13440.0,4,3948,4,13435.0,20,13445.0,20,S
2018-04-26 21:26:11,13440.0,2,3950,0,13435.0,20,13445.0,19,S
2018-04-26 21:26:18,13435.0,2,3952,-2,13435.0,19,13445.0,21,S
2018-04-26 21:26:23,13445.0,4,3956,-2,13440.0,62,13445.0,15,B
2018-04-26 21:26:23,13445.0,30,3986,-6,13445.0,7,13450.0,8,B
2018-04-26 21:26:24,13450.0,2,3988,-2,13445.0,3,13450.0,3,B
2018-04-26 21:26:25,13450.0,2,3990,0,13445.0,5,13450.0,2,B
2018-04-26 21:26:52,13450.0,2,3992,-2,13445.0,7,13450.0,11,B
2018-04-26 21:26:53,13450.0,12,4004,4,13445.0,7,13450.0,5,B
2018-04-26 21:26:58,13450.0,8,4012,0,13445.0,13,13450.0,1,B
2018-04-26 21:26:59,13455.0,12,4024,2,13455.0,1,13460.0,12,B
2018-04-26 21:27:00,13455.0,8,4032,-6,13450.0,5,13460.0,12,B
2018-04-26 21:27:04,13450.0,14,4046,-2,13445.0,5,13455.0,27,S
2018-04-26 21:27:18,13445.0,2,4048,-2,13445.0,4,13450.0,3,S
2018-04-26 21:27:21,13450.0,2,4050,0,13445.0,5,13450.0,2,B
2018-04-26 21:27:22,13445.0,2,4052,2,13445.0,7,13450.0,2,S
2018-04-26 21:27:27,13445.0,2,4054,2,13445.0,2,13450.0,2,S
2018-04-26 21:27:50,13450.0,2,4056,2,13445.0,7,13450.0,13,B
2018-04-26 21:28:08,13450.0,2,4058,2,13445.0,8,13450.0,13,B
2018-04-26 21:28:08,13450.0,2,4060,2,13445.0,8,13450.0,12,B
2018-04-26 21:28:10,13450.0,24,4084,16,13445.0,9,13455.0,28,B
2018-04-26 21:28:11,13455.0,8,4092,2,13450.0,14,13455.0,5,B
2018-04-26 21:28:19,13455.0,2,4094,0,13450.0,14,13455.0,5,B
2018-04-26 21:28:26,13450.0,2,4096,2,13450.0,11,13455.0,5,S
2018-04-26 21:28:27,13455.0,2,4098,0,13450.0,11,13455.0,4,B
2018-04-26 21:28:28,13455.0,8,4106,2,13455.0,1,13460.0,28,B
2018-04-26 21:28:29,13455.0,2,4108,0,13450.0,8,13455.0,1,B
2018-04-26 21:28:30,13455.0,2,4110,0,13455.0,2,13460.0,29,B
2018-04-26 21:28:30,13455.0,2,4112,-2,13455.0,1,13460.0,29,B
2018-04-26 21:28:31,13455.0,2,4114,0,13450.0,10,13460.0,29,B
2018-04-26 21:28:40,13455.0,8,4122,0,13450.0,14,13455.0,1,B
2018-04-26 21:28:46,13455.0,4,4126,4,13455.0,3,13460.0,43,B
2018-04-26 21:28:47,13455.0,6,4132,0,13450.0,15,13460.0,43,B
2018-04-26 21:29:04,13460.0,4,4136,4,13455.0,6,13460.0,31,B
2018-04-26 21:29:06,13460.0,12,4148,10,13455.0,6,13460.0,13,B
2018-04-26 21:29:09,13460.0,20,4168,8,13455.0,6,13465.0,43,B
2018-04-26 21:29:10,13465.0,2,4170,2,13460.0,8,13465.0,1,B
2018-04-26 21:29:11,13465.0,2,4172,-2,13460.0,8,13470.0,34,B
2018-04-26 21:29:16,13465.0,2,4174,-2,13460.0,9,13470.0,25,B
2018-04-26 21:29:26,13460.0,2,4176,0,13460.0,3,13465.0,13,S
2018-04-26 21:29:26,13460.0,4,4180,0,13455.0,7,13465.0,13,S
2018-04-26 21:29:28,13460.0,4,4184,-2,13455.0,7,13460.0,14,S
2018-04-26 21:29:29,13455.0,4,4188,-2,13455.0,4,13460.0,4,S
2018-04-26 21:29:38,13460.0,2,4190,2,13455.0,4,13460.0,5,B
2018-04-26 21:29:40,13455.0,2,4192,-2,13455.0,2,13460.0,6,S
2018-04-26 21:29:43,13460.0,2,4194,0,13455.0,4,13460.0,5,B
2018-04-26 21:29:46,13460.0,2,4196,0,13455.0,6,13460.0,5,B
2018-04-26 21:29:49,13460.0,2,4198,2,13455.0,6,13460.0,4,B
2018-04-26 21:29:55,13460.0,2,4200,0,13455.0,8,13460.0,4,B
2018-04-26 21:29:56,13460.0,2,4202,2,13455.0,8,13460.0,3,B
2018-04-26 21:29:57,13460.0,2,4204,2,13455.0,9,13460.0,2,B
2018-04-26 21:29:58,13460.0,4,4208,4,13460.0,2,13465.0,14,B
2018-04-26 21:29:59,13460.0,2,4210,2,13460.0,8,13465.0,10,B
2018-04-26 21:30:07,13460.0,2,4212,0,13460.0,6,13465.0,7,B
2018-04-26 21:30:18,13460.0,2,4214,2,13460.0,3,13465.0,7,B
2018-04-26 21:30:19,13460.0,2,4216,0,13455.0,13,13465.0,7,B
2018-04-26 21:30:20,13460.0,2,4218,2,13455.0,13,13465.0,8,B
2018-04-26 21:30:23,13455.0,18,4236,0,13450.0,10,13460.0,11,S
2018-04-26 21:30:28,13455.0,2,4238,0,13450.0,13,13455.0,2,S
2018-04-26 21:30:28,13455.0,4,4242,4,13450.0,13,13460.0,10,S
2018-04-26 21:30:36,13455.0,4,4246,4,13455.0,3,13460.0,10,S
2018-04-26 21:30:40,13455.0,2,4248,0,13455.0,8,13460.0,6,S
2018-04-26 21:30:42,13455.0,8,4256,-2,13450.0,18,13460.0,9,S
2018-04-26 21:31:01,13455.0,6,4262,2,13455.0,7,13460.0,17,S
2018-04-26 21:31:08,13460.0,2,4264,0,13455.0,7,13460.0,16,B
2018-04-26 21:31:09,13455.0,14,4278,-6,13450.0,17,13455.0,7,S
2018-04-26 21:31:16,13450.0,2,4280,0,13450.0,13,13455.0,12,S
2018-04-26 21:31:18,13455.0,2,4282,0,13450.0,13,13455.0,11,B
2018-04-26 21:31:27,13455.0,2,4284,0,13450.0,13,13455.0,13,B
2018-04-26 21:31:30,13455.0,22,4306,0,13455.0,8,13460.0,19,B
2018-04-26 21:31:35,13455.0,22,4328,4,13450.0,12,13460.0,22,B
2018-04-26 21:31:36,13455.0,6,4334,2,13450.0,13,13460.0,23,B
2018-04-26 21:31:43,13455.0,2,4336,2,13455.0,1,13460.0,24,B
2018-04-26 21:31:51,13455.0,2,4338,0,13455.0,1,13460.0,26,B
2018-04-26 21:31:51,13455.0,2,4340,0,13450.0,25,13460.0,26,B
2018-04-26 21:31:57,13455.0,2,4342,2,13450.0,25,13460.0,26,B
2018-04-26 21:32:01,13455.0,4,4346,2,13455.0,1,13460.0,27,B
2018-04-26 21:32:02,13455.0,2,4348,0,13450.0,11,13455.0,5,B
2018-04-26 21:32:02,13455.0,2,4350,0,13450.0,12,13455.0,1,B
2018-04-26 21:32:03,13455.0,2,4352,0,13450.0,12,13460.0,21,B
2018-04-26 21:32:10,13455.0,2,4354,2,13455.0,2,13460.0,21,B
2018-04-26 21:32:16,13455.0,4,4358,0,13450.0,15,13455.0,11,B
2018-04-26 21:32:30,13455.0,8,4366,-8,13450.0,13,13455.0,5,B
2018-04-26 21:32:37,13455.0,2,4368,2,13450.0,13,13455.0,3,B
2018-04-26 21:32:44,13450.0,2,4370,-2,13450.0,12,13455.0,2,S
2018-04-26 21:32:52,13455.0,4,4374,4,13450.0,27,13460.0,25,B
2018-04-26 21:33:01,13450.0,2,4376,0,13450.0,27,13460.0,25,S
2018-04-26 21:33:14,13460.0,2,4378,-2,13450.0,16,13460.0,24,B
2018-04-26 21:33:35,13455.0,2,4380,0,13450.0,18,13455.0,3,S
2018-04-26 21:33:40,13460.0,52,4432,-36,13460.0,34,13465.0,20,B
2018-04-26 21:33:41,13455.0,72,4504,-58,13455.0,2,13460.0,27,S
2018-04-26 21:33:41,13455.0,4,4508,4,13450.0,17,13455.0,2,S
2018-04-26 21:33:47,13450.0,2,4510,-2,13450.0,23,13460.0,22,S
2018-04-26 21:33:56,13455.0,2,4512,2,13450.0,25,13460.0,16,B
2018-04-26 21:33:58,13455.0,2,4514,0,13450.0,27,13460.0,16,B
2018-04-26 21:34:39,13450.0,26,4540,2,13445.0,6,13455.0,8,S
2018-04-26 21:34:47,13450.0,2,4542,0,13445.0,3,13450.0,10,S
2018-04-26 21:34:57,13445.0,6,4548,-2,13445.0,13,13450.0,1,S
2018-04-26 21:35:00,13445.0,2,4550,-2,13445.0,12,13450.0,1,S
2018-04-26 21:35:04,13450.0,2,4552,0,13445.0,12,13455.0,9,B
2018-04-26 21:35:08,13450.0,2,4554,0,13445.0,11,13455.0,12,B
2018-04-26 21:35:16,13450.0,2,4556,0,13445.0,9,13455.0,12,B
2018-04-26 21:35:24,13450.0,2,4558,2,13445.0,2,13450.0,6,B
2018-04-26 21:35:36,13445.0,10,4568,6,13440.0,33,13450.0,7,S
2018-04-26 21:36:10,13445.0,2,4570,2,13445.0,1,13450.0,8,S
2018-04-26 21:36:36,13450.0,12,4582,4,13450.0,4,13455.0,15,B
2018-04-26 21:36:42,13455.0,2,4584,2,13450.0,14,13455.0,2,B
2018-04-26 21:36:49,13455.0,2,4586,0,13450.0,14,13455.0,1,B
2018-04-26 21:36:50,13455.0,2,4588,0,13450.0,14,13455.0,1,B
2018-04-26 21:36:50,13455.0,2,4590,2,13450.0,14,13460.0,13,B
2018-04-26 21:37:04,13455.0,2,4592,2,13450.0,19,13455.0,4,B
2018-04-26 21:37:07,13450.0,30,4622,10,13445.0,12,13450.0,4,S
2018-04-26 21:38:12,13445.0,2,4624,-2,13445.0,4,13450.0,6,S
2018-04-26 21:38:47,13445.0,2,4626,2,13445.0,5,13450.0,7,S
2018-04-26 21:39:16,13445.0,4,4630,2,13445.0,3,13450.0,7,S
2018-04-26 21:39:17,13445.0,4,4634,-4,13445.0,2,13450.0,7,S
2018-04-26 21:39:20,13450.0,2,4636,2,13445.0,1,13450.0,6,B
2018-04-26 21:39:37,13450.0,4,4640,4,13445.0,1,13450.0,6,B
2018-04-26 21:40:30,13445.0,8,4648,-8,13440.0,39,13450.0,6,S
2018-04-26 21:40:32,13445.0,4,4652,0,13440.0,39,13450.0,7,S
2018-04-26 21:40:33,13445.0,2,4654,-2,13440.0,39,13450.0,8,S
2018-04-26 21:40:43,13445.0,2,4656,-2,13440.0,51,13450.0,14,S
2018-04-26 21:40:48,13445.0,2,4658,0,13440.0,51,13450.0,14,S
2018-04-26 21:41:19,13440.0,2,4660,0,13440.0,33,13445.0,13,S
2018-04-26 21:41:30,13440.0,6,4666,0,13440.0,27,13445.0,16,S
2018-04-26 21:41:36,13445.0,10,4676,6,13440.0,37,13445.0,11,B
2018-04-26 21:41:38,13445.0,2,4678,0,13440.0,37,13445.0,12,B
2018-04-26 21:41:43,13440.0,2,4680,-2,13440.0,36,13445.0,12,S
2018-04-26 21:42:07,13445.0,4,4684,2,13440.0,36,13445.0,12,B
2018-04-26 21:42:07,13445.0,24,4708,0,13445.0,11,13450.0,18,B
2018-04-26 21:42:27,13445.0,10,4718,6,13445.0,4,13450.0,11,B
2018-04-26 21:42:28,13445.0,2,4720,2,13445.0,4,13450.0,11,B
2018-04-26 21:42:38,13445.0,8,4728,2,13440.0,46,13445.0,1,B
2018-04-26 21:42:39,13445.0,2,4730,2,13440.0,46,13450.0,15,B
2018-04-26 21:42:53,13445.0,4,4734,4,13440.0,46,13445.0,3,B
2018-04-26 21:42:53,13445.0,6,4740,0,13440.0,46,13450.0,15,B
2018-04-26 21:43:19,13445.0,2,4742,2,13440.0,63,13450.0,11,B
2018-04-26 21:43:41,13440.0,10,4752,-10,13440.0,46,13450.0,15,S
2018-04-26 21:43:49,13440.0,34,4786,-34,13440.0,29,13445.0,1,S
2018-04-26 21:43:54,13440.0,10,4796,-2,13440.0,24,13445.0,2,S
2018-04-26 21:44:00,13440.0,10,4806,0,13440.0,19,13445.0,2,S
2018-04-26 21:44:14,13440.0,2,4808,2,13440.0,14,13445.0,4,S
2018-04-26 21:44:14,13445.0,4,4812,-2,13440.0,14,13445.0,2,B
2018-04-26 21:44:15,13440.0,4,4816,4,13440.0,12,13450.0,15,S
2018-04-26 21:44:39,13440.0,20,4836,6,13440.0,3,13445.0,5,S
2018-04-26 21:44:40,13440.0,8,4844,4,13440.0,2,13445.0,7,S
2018-04-26 21:44:47,13445.0,4,4848,-4,13440.0,2,13445.0,5,B
2018-04-26 21:44:51,13440.0,4,4852,0,13435.0,38,13440.0,3,S
2018-04-26 21:44:51,13440.0,6,4858,0,13435.0,41,13445.0,9,S
2018-04-26 21:44:52,13440.0,10,4868,10,13435.0,45,13445.0,10,S
2018-04-26 21:45:12,13440.0,10,4878,6,13440.0,4,13445.0,7,S
2018-04-26 21:45:23,13445.0,4,4882,0,13440.0,11,13445.0,5,B
2018-04-26 21:45:36,13445.0,10,4892,0,13445.0,4,13450.0,28,B
2018-04-26 21:45:36,13445.0,8,4900,-8,13440.0,12,13445.0,1,B
2018-04-26 21:45:57,13440.0,10,4910,8,13440.0,19,13450.0,29,S
2018-04-26 21:46:14,13440.0,6,4916,6,13440.0,6,13445.0,5,S
2018-04-26 21:46:16,13445.0,4,4920,0,13440.0,25,13445.0,3,B
2018-04-26 21:46:16,13445.0,2,4922,-2,13440.0,41,13445.0,1,B
2018-04-26 21:46:17,13445.0,2,4924,-2,13440.0,44,13450.0,16,B
2018-04-26 21:46:17,13440.0,10,4934,10,13440.0,41,13450.0,16,S
2018-04-26 21:46:18,13445.0,2,4936,0,13445.0,3,13450.0,16,B
2018-04-26 21:46:24,13445.0,8,4944,2,13440.0,45,13445.0,1,B
2018-04-26 21:46:25,13445.0,8,4952,-2,13440.0,43,13450.0,16,B
2018-04-26 21:46:33,13445.0,4,4956,-2,13440.0,34,13445.0,2,B
2018-04-26 21:46:34,13445.0,2,4958,0,13440.0,9,13445.0,1,B
2018-04-26 21:46:39,13440.0,2,4960,2,13440.0,5,13445.0,1,S
2018-04-26 21:46:42,13440.0,10,4970,8,13440.0,2,13445.0,3,S
2018-04-26 21:47:03,13440.0,2,4972,2,13440.0,6,13445.0,5,S
2018-04-26 21:47:03,13440.0,4,4976,4,13440.0,4,13445.0,5,S
2018-04-26 21:47:05,13440.0,6,4982,6,13440.0,1,13445.0,5,S
2018-04-26 21:47:23,13445.0,4,4986,-4,13440.0,1,13445.0,3,B
2018-04-26 21:47:33,13440.0,2,4988,0,13435.0,39,13445.0,9,S
2018-04-26 21:48:26,13440.0,4,4992,4,13435.0,42,13440.0,2,S
2018-04-26 21:48:26,13440.0,4,4996,4,13435.0,42,13445.0,9,S
2018-04-26 21:48:32,13445.0,4,5000,-2,13435.0,43,13445.0,8,B
2018-04-26 21:48:57,13445.0,2,5002,-2,13440.0,1,13445.0,4,B
2018-04-26 21:49:01,13440.0,8,5010,2,13435.0,51,13440.0,1,S
2018-04-26 21:49:01,13440.0,2,5012,0,13435.0,53,13445.0,12,S
2018-04-26 21:49:07,13445.0,6,5018,-2,13440.0,8,13450.0,29,B
2018-04-26 21:49:17,13440.0,2,5020,-2,13440.0,2,13445.0,23,S
2018-04-26 21:49:18,13440.0,8,5028,0,13435.0,34,13440.0,4,S
2018-04-26 21:49:18,13440.0,2,5030,-2,13435.0,36,13440.0,1,S
2018-04-26 21:49:21,13440.0,2,5032,-2,13435.0,35,13445.0,24,S
2018-04-26 21:49:24,13440.0,2,5034,-2,13435.0,35,13445.0,24,S
2018-04-26 21:49:26,13440.0,10,5044,10,13435.0,35,13445.0,21,S
2018-04-26 21:49:31,13440.0,10,5054,6,13435.0,55,13445.0,6,S
2018-04-26 21:49:38,13440.0,10,5064,6,13435.0,13,13445.0,17,S
2018-04-26 21:49:40,13445.0,12,5076,4,13445.0,1,13450.0,33,B
2018-04-26 21:49:45,13450.0,2,5078,-2,13445.0,5,13450.0,24,B
2018-04-26 21:49:45,13445.0,10,5088,2,13440.0,38,13450.0,24,S
2018-04-26 21:49:49,13445.0,12,5100,-6,13440.0,31,13450.0,24,S
2018-04-26 21:49:51,13445.0,2,5102,-2,13440.0,24,13445.0,3,S
2018-04-26 21:49:55,13445.0,6,5108,0,13440.0,25,13450.0,29,S
2018-04-26 21:50:01,13445.0,2,5110,2,13445.0,3,13450.0,24,S
2018-04-26 21:50:10,13445.0,4,5114,4,13440.0,30,13445.0,3,S
2018-04-26 21:50:10,13445.0,6,5120,0,13440.0,29,13450.0,23,S
2018-04-26 21:50:18,13450.0,4,5124,-2,13445.0,1,13450.0,26,B
2018-04-26 21:50:22,13445.0,2,5126,2,13445.0,3,13450.0,22,S
2018-04-26 21:50:26,13445.0,2,5128,0,13440.0,29,13445.0,4,S
2018-04-26 21:50:29,13445.0,8,5136,8,13445.0,1,13450.0,26,S
2018-04-26 21:50:45,13450.0,4,5140,0,13445.0,7,13450.0,19,B
2018-04-26 21:50:48,13450.0,2,5142,0,13445.0,7,13450.0,18,B
2018-04-26 21:50:58,13450.0,2,5144,2,13445.0,6,13450.0,18,B
2018-04-26 21:51:01,13450.0,2,5146,2,13445.0,6,13450.0,16,B
2018-04-26 21:51:23,13450.0,32,5178,10,13445.0,11,13455.0,32,B
2018-04-26 21:51:24,13455.0,22,5200,-8,13450.0,10,13460.0,29,B
2018-04-26 21:51:26,13460.0,2,5202,-2,13455.0,9,13460.0,21,B
2018-04-26 21:51:27,13460.0,40,5242,6,13455.0,10,13460.0,1,B
2018-04-26 21:51:28,13460.0,2,5244,0,13455.0,5,13460.0,3,B
2018-04-26 21:51:33,13455.0,8,5252,0,13450.0,17,13460.0,7,S
2018-04-26 21:51:40,13455.0,4,5256,0,13450.0,20,13460.0,11,S
2018-04-26 21:51:42,13455.0,2,5258,2,13450.0,19,13460.0,14,S
2018-04-26 21:51:43,13460.0,4,5262,-4,13450.0,21,13460.0,13,B
2018-04-26 21:51:44,13460.0,6,5268,-6,13450.0,21,13460.0,11,B
2018-04-26 21:51:53,13455.0,10,5278,4,13450.0,20,13460.0,13,S
2018-04-26 21:52:05,13460.0,2,5280,-2,13450.0,21,13460.0,15,B
2018-04-26 21:52:05,13450.0,20,5300,10,13450.0,11,13460.0,19,S
2018-04-26 21:52:12,13455.0,4,5304,0,13450.0,57,13455.0,4,B
2018-04-26 21:52:15,13455.0,4,5308,2,13450.0,57,13455.0,9,B
2018-04-26 21:52:19,13455.0,2,5310,0,13450.0,52,13455.0,24,B
2018-04-26 21:52:34,13450.0,10,5320,10,13450.0,47,13455.0,22,S
2018-04-26 21:52:48,13450.0,20,5340,20,13450.0,37,13455.0,22,S
2018-04-26 21:52:58,13450.0,6,5346,6,13450.0,34,13455.0,23,S
2018-04-26 21:53:12,13450.0,8,5354,8,13450.0,30,13455.0,24,S
2018-04-26 21:53:18,13450.0,60,5414,58,13445.0,8,13450.0,3,S
2018-04-26 21:53:19,13445.0,4,5418,0,13440.0,12,13450.0,10,S
2018-04-26 21:53:23,13445.0,2,5420,-2,13440.0,17,13450.0,15,S
2018-04-26 21:53:24,13445.0,2,5422,0,13440.0,19,13450.0,15,S
2018-04-26 21:53:25,13440.0,10,5432,8,13440.0,14,13450.0,15,S
2018-04-26 21:53:34,13445.0,2,5434,-2,13440.0,9,13445.0,2,B
2018-04-26 21:53:38,13445.0,4,5438,-2,13440.0,10,13445.0,1,B
2018-04-26 21:53:39,13445.0,2,5440,0,13445.0,1,13450.0,24,B
2018-04-26 21:53:39,13445.0,2,5442,0,13440.0,14,13445.0,2,B
2018-04-26 21:53:42,13440.0,10,5452,-6,13440.0,10,13450.0,27,S
2018-04-26 21:53:55,13445.0,4,5456,0,13440.0,5,13445.0,3,B
2018-04-26 21:53:58,13440.0,6,5462,4,13440.0,1,13445.0,22,S
2018-04-26 21:53:59,13440.0,2,5464,2,13435.0,22,13440.0,2,S
2018-04-26 21:54:01,13440.0,2,5466,-2,13435.0,24,13445.0,22,S
2018-04-26 21:54:25,13440.0,4,5470,0,13435.0,26,13445.0,17,S
2018-04-26 21:54:40,13440.0,2,5472,0,13435.0,25,13440.0,11,S
2018-04-26 21:54:53,13435.0,10,5482,-2,13435.0,11,13440.0,5,S
2018-04-26 21:54:59,13440.0,4,5486,0,13435.0,11,13440.0,3,B
2018-04-26 21:55:36,13440.0,2,5488,0,13435.0,13,13440.0,3,B
2018-04-26 21:56:06,13440.0,4,5492,4,13435.0,11,13440.0,1,B
2018-04-26 21:56:21,13440.0,2,5494,-2,13440.0,1,13445.0,28,B
2018-04-26 21:56:21,13440.0,2,5496,0,13435.0,16,13440.0,3,B
2018-04-26 21:56:49,13435.0,4,5500,-4,13435.0,14,13440.0,8,S
2018-04-26 21:56:51,13435.0,28,5528,10,13430.0,6,13435.0,1,S
2018-04-26 21:56:52,13430.0,2,5530,0,13425.0,13,13430.0,1,S
2018-04-26 21:57:05,13430.0,6,5536,6,13430.0,1,13435.0,6,S
2018-04-26 21:57:06,13435.0,12,5548,0,13435.0,7,13440.0,13,B
2018-04-26 21:57:25,13440.0,2,5550,0,13435.0,4,13440.0,4,B
2018-04-26 21:57:28,13440.0,2,5552,0,13435.0,4,13440.0,6,B
2018-04-26 21:57:51,13440.0,2,5554,0,13435.0,7,13440.0,4,B
2018-04-26 21:57:52,13435.0,2,5556,0,13435.0,6,13440.0,4,S
2018-04-26 21:58:18,13435.0,10,5566,2,13435.0,3,13440.0,4,S
2018-04-26 21:58:20,13440.0,4,5570,-2,13435.0,3,13440.0,4,B
2018-04-26 21:58:35,13440.0,2,5572,0,13435.0,22,13445.0,30,B
2018-04-26 21:58:41,13435.0,20,5592,16,13435.0,10,13440.0,1,S
2018-04-26 21:58:52,13435.0,10,5602,6,13435.0,1,13440.0,3,S
2018-04-26 21:58:53,13435.0,4,5606,-2,13435.0,2,13440.0,7,S
2018-04-26 21:58:53,13435.0,2,5608,2,13430.0,19,13440.0,8,S
2018-04-26 21:59:03,13435.0,10,5618,-10,13430.0,21,13440.0,12,S
2018-04-26 21:59:06,13435.0,6,5624,6,13435.0,6,13440.0,13,S
2018-04-26 21:59:17,13435.0,4,5628,0,13430.0,18,13440.0,10,S
2018-04-26 21:59:39,13435.0,2,5630,0,13435.0,3,13440.0,7,S
2018-04-26 21:59:42,13435.0,6,5636,6,13430.0,18,13435.0,14,S
2018-04-26 21:59:42,13435.0,28,5664,28,13435.0,4,13440.0,11,S
2018-04-26 21:59:46,13440.0,4,5668,-4,13430.0,18,13440.0,11,B
2018-04-26 21:59:50,13435.0,2,5670,2,13435.0,2,13440.0,11,S
2018-04-26 21:59:55,13440.0,4,5674,0,13440.0,4,13445.0,26,B
2018-04-26 22:00:02,13445.0,24,5698,-14,13440.0,7,13450.0,28,B
2018-04-26 22:00:05,13445.0,4,5702,0,13445.0,5,13450.0,11,B
2018-04-26 22:00:06,13445.0,10,5712,-2,13440.0,8,13445.0,4,B
2018-04-26 22:00:08,13440.0,6,5718,0,13435.0,8,13445.0,11,S
2018-04-26 22:00:22,13440.0,2,5720,2,13440.0,2,13445.0,10,S
2018-04-26 22:00:38,13445.0,4,5724,0,13435.0,12,13445.0,14,B
2018-04-26 22:01:16,13440.0,2,5726,-2,13435.0,13,13445.0,8,S
2018-04-26 22:01:23,13440.0,2,5728,0,13435.0,4,13440.0,8,S
2018-04-26 22:02:14,13440.0,2,5730,0,13435.0,5,13440.0,7,S
2018-04-26 22:02:38,13440.0,8,5738,6,13435.0,27,13445.0,20,S
2018-04-26 22:03:17,13440.0,2,5740,0,13435.0,6,13440.0,4,S
2018-04-26 22:03:18,13440.0,4,5744,-4,13435.0,6,13440.0,2,S
2018-04-26 22:03:32,13440.0,2,5746,-2,13435.0,6,13440.0,6,S
2018-04-26 22:03:33,13440.0,6,5752,-2,13435.0,6,13440.0,3,S
2018-04-26 22:03:40,13435.0,12,5764,2,13430.0,14,13435.0,8,S
2018-04-26 22:04:21,13435.0,2,5766,0,13430.0,11,13435.0,8,S
2018-04-26 22:04:23,13435.0,4,5770,-2,13430.0,11,13435.0,6,S
2018-04-26 22:04:24,13435.0,12,5782,12,13430.0,11,13440.0,20,S
2018-04-26 22:04:26,13440.0,12,5794,6,13440.0,1,13445.0,16,B
2018-04-26 22:04:28,13440.0,4,5798,0,13435.0,18,13440.0,2,B
2018-04-26 22:04:29,13440.0,4,5802,2,13435.0,18,13440.0,1,B
2018-04-26 22:04:29,13440.0,2,5804,2,13435.0,18,13440.0,1,B
2018-04-26 22:04:55,13440.0,4,5808,0,13435.0,12,13440.0,1,B
2018-04-26 22:06:00,13435.0,10,5818,2,13435.0,3,13440.0,10,S
2018-04-26 22:06:00,13435.0,6,5824,2,13430.0,51,13435.0,3,S
2018-04-26 22:06:03,13440.0,2,5826,0,13435.0,1,13440.0,35,B
2018-04-26 22:06:26,13430.0,10,5836,2,13430.0,38,13435.0,24,S
2018-04-26 22:06:26,13430.0,4,5840,-4,13430.0,36,13435.0,26,S
2018-04-26 22:06:28,13430.0,72,5912,-54,13425.0,12,13430.0,6,S
2018-04-26 22:06:29,13425.0,24,5936,-12,13420.0,11,13425.0,1,S
2018-04-26 22:06:29,13420.0,10,5946,-4,13420.0,9,13430.0,24,S
2018-04-26 22:06:30,13420.0,4,5950,-4,13420.0,7,13425.0,3,S
2018-04-26 22:06:36,13420.0,12,5962,8,13415.0,21,13425.0,11,S
2018-04-26 22:06:39,13420.0,10,5972,4,13415.0,3,13420.0,5,S
2018-04-26 22:06:39,13415.0,2,5974,0,13415.0,3,13420.0,6,S
2018-04-26 22:06:41,13415.0,8,5982,-8,13410.0,26,13420.0,6,S
2018-04-26 22:06:43,13420.0,4,5986,2,13420.0,3,13425.0,14,B
2018-04-26 22:06:51,13420.0,8,5994,4,13420.0,1,13425.0,6,B
2018-04-26 22:06:54,13420.0,2,5996,2,13420.0,4,13425.0,10,B
2018-04-26 22:06:57,13420.0,4,6000,-4,13420.0,3,13425.0,10,B
2018-04-26 22:07:01,13420.0,4,6004,-4,13415.0,32,13420.0,1,B
2018-04-26 22:07:02,13420.0,2,6006,0,13420.0,2,13425.0,9,B
2018-04-26 22:07:06,13420.0,2,6008,-2,13420.0,3,13425.0,11,B
2018-04-26 22:07:18,13420.0,2,6010,0,13420.0,5,13425.0,9,B
2018-04-26 22:07:18,13420.0,10,6020,4,13415.0,33,13425.0,9,B
2018-04-26 22:07:36,13425.0,2,6022,0,13420.0,15,13425.0,1,B
2018-04-26 22:07:37,13425.0,2,6024,0,13425.0,1,13430.0,32,B
2018-04-26 22:07:38,13425.0,2,6026,-2,13420.0,16,13430.0,41,B
2018-04-26 22:07:40,13425.0,2,6028,-2,13420.0,16,13425.0,1,B
2018-04-26 22:07:43,13420.0,4,6032,0,13420.0,8,13425.0,3,S
2018-04-26 22:08:00,13420.0,2,6034,2,13420.0,6,13425.0,23,S
2018-04-26 22:08:00,13420.0,12,6046,-6,13415.0,24,13425.0,23,S
2018-04-26 22:08:02,13415.0,2,6048,0,13415.0,27,13425.0,24,S
2018-04-26 22:08:04,13425.0,4,6052,-4,13415.0,27,13425.0,23,B
2018-04-26 22:08:16,13425.0,4,6056,0,13420.0,13,13430.0,19,B
2018-04-26 22:08:19,13420.0,2,6058,2,13420.0,13,13430.0,28,S
2018-04-26 22:08:23,13425.0,2,6060,0,13420.0,13,13425.0,3,B
2018-04-26 22:08:36,13420.0,2,6062,-2,13420.0,9,13425.0,3,S
2018-04-26 22:08:52,13420.0,12,6074,-4,13420.0,1,13425.0,10,S
2018-04-26 22:08:53,13420.0,2,6076,0,13415.0,25,13420.0,3,S
2018-04-26 22:09:02,13420.0,6,6082,-6,13415.0,26,13425.0,18,S
2018-04-26 22:09:04,13420.0,2,6084,0,13420.0,1,13425.0,5,S
2018-04-26 22:09:05,13420.0,6,6090,4,13420.0,2,13425.0,5,S
2018-04-26 22:09:32,13425.0,2,6092,0,13420.0,4,13425.0,5,B
2018-04-26 22:09:39,13425.0,2,6094,-2,13420.0,8,13425.0,2,B
2018-04-26 22:10:27,13425.0,4,6098,-4,13420.0,8,13425.0,2,B
2018-04-26 22:10:30,13420.0,2,6100,0,13420.0,7,13425.0,2,S
2018-04-26 22:10:47,13420.0,2,6102,2,13420.0,6,13425.0,4,S
2018-04-26 22:11:11,13420.0,4,6106,4,13420.0,2,13425.0,12,S
2018-04-26 22:11:11,13420.0,2,6108,0,13420.0,1,13425.0,13,S
2018-04-26 22:11:21,13420.0,2,6110,0,13420.0,2,13425.0,10,S
2018-04-26 22:11:34,13425.0,10,6120,-8,13425.0,1,13430.0,28,B
2018-04-26 22:11:35,13430.0,6,6126,-2,13425.0,15,13430.0,17,B
2018-04-26 22:11:55,13430.0,2,6128,2,13425.0,7,13430.0,15,B
2018-04-26 22:11:57,13430.0,2,6130,-2,13425.0,7,13430.0,14,B
2018-04-26 22:12:11,13430.0,8,6138,4,13425.0,8,13430.0,4,B
2018-04-26 22:12:12,13425.0,6,6144,-2,13425.0,7,13430.0,2,S
2018-04-26 22:12:24,13430.0,2,6146,0,13425.0,9,13430.0,1,B
2018-04-26 22:12:25,13430.0,2,6148,0,13425.0,9,13435.0,13,B
2018-04-26 22:12:26,13430.0,4,6152,-2,13425.0,14,13435.0,24,B
2018-04-26 22:12:33,13430.0,2,6154,-2,13425.0,14,13435.0,39,B
2018-04-26 22:12:38,13430.0,2,6156,0,13425.0,14,13435.0,39,B
2018-04-26 22:12:47,13435.0,4,6160,-4,13430.0,14,13435.0,1,B
2018-04-26 22:12:47,13435.0,4,6164,-2,13430.0,14,13440.0,25,B
2018-04-26 22:12:48,13435.0,2,6166,0,13430.0,14,13435.0,2,B
2018-04-26 22:12:51,13435.0,2,6168,0,13430.0,15,13435.0,1,B
2018-04-26 22:12:51,13435.0,2,6170,0,13430.0,15,13440.0,32,B
2018-04-26 22:12:58,13435.0,2,6172,0,13430.0,16,13435.0,1,B
2018-04-26 22:12:58,13435.0,2,6174,-2,13430.0,16,13440.0,18,B
2018-04-26 22:13:17,13430.0,12,6186,2,13425.0,13,13435.0,20,S
2018-04-26 22:14:35,13425.0,2,6188,0,13425.0,10,13430.0,3,S
2018-04-26 22:15:13,13430.0,6,6194,-6,13430.0,2,13435.0,21,B
2018-04-26 22:15:19,13435.0,2,6196,2,13430.0,11,13435.0,8,B
2018-04-26 22:15:24,13430.0,2,6198,-2,13430.0,1,13435.0,17,S
2018-04-26 22:15:25,13430.0,2,6200,0,13425.0,11,13430.0,2,S
2018-04-26 22:16:48,13430.0,2,6202,2,13425.0,5,13430.0,2,S
2018-04-26 22:17:17,13430.0,2,6204,0,13425.0,9,13430.0,1,S
2018-04-26 22:17:27,13430.0,2,6206,0,13430.0,2,13435.0,17,S
2018-04-26 22:17:27,13430.0,2,6208,0,13430.0,1,13435.0,17,S
2018-04-26 22:17:28,13430.0,2,6210,0,13425.0,10,13435.0,17,S
2018-04-26 22:18:01,13425.0,12,6222,12,13420.0,16,13425.0,3,S
2018-04-26 22:18:12,13420.0,10,6232,6,13420.0,6,13425.0,6,S
2018-04-26 22:18:17,13420.0,2,6234,-2,13420.0,5,13425.0,6,S
2018-04-26 22:18:22,13420.0,6,6240,-4,13420.0,1,13425.0,6,S
2018-04-26 22:18:23,13420.0,4,6244,-4,13415.0,57,13425.0,4,S
2018-04-26 22:18:24,13420.0,4,6248,0,13415.0,57,13420.0,8,S
2018-04-26 22:18:29,13420.0,8,6256,0,13415.0,25,13420.0,3,S
2018-04-26 22:18:42,13415.0,22,6278,18,13415.0,11,13420.0,35,S
2018-04-26 22:18:43,13415.0,22,6300,-10,13410.0,11,13415.0,1,S
2018-04-26 22:18:43,13410.0,2,6302,0,13410.0,9,13415.0,3,S
2018-04-26 22:18:44,13410.0,8,6310,2,13410.0,4,13415.0,6,S
2018-04-26 22:18:45,13410.0,2,6312,2,13410.0,2,13415.0,12,S
2018-04-26 22:18:46,13410.0,4,6316,-4,13405.0,10,13410.0,8,S
2018-04-26 22:18:46,13405.0,2,6318,0,13405.0,7,13410.0,3,S
2018-04-26 22:18:47,13405.0,2,6320,-2,13405.0,7,13410.0,9,S
2018-04-26 22:18:48,13405.0,2,6322,2,13405.0,5,13410.0,8,S
2018-04-26 22:18:50,13410.0,2,6324,2,13405.0,6,13410.0,9,B
2018-04-26 22:18:52,13405.0,8,6332,0,13405.0,3,13410.0,33,S
2018-04-26 22:18:53,13405.0,6,6338,4,13400.0,28,13410.0,33,S
2018-04-26 22:18:54,13405.0,2,6340,0,13400.0,29,13405.0,5,S
2018-04-26 22:19:01,13400.0,2,6342,0,13400.0,26,13405.0,4,S
2018-04-26 22:19:02,13400.0,14,6356,-2,13400.0,22,13405.0,5,S
2018-04-26 22:19:03,13405.0,10,6366,-2,13405.0,3,13410.0,10,B
2018-04-26 22:19:06,13410.0,4,6370,0,13405.0,23,13410.0,2,B
2018-04-26 22:19:07,13405.0,4,6374,0,13405.0,18,13410.0,3,S
2018-04-26 22:19:08,13405.0,6,6380,2,13405.0,15,13410.0,2,S
2018-04-26 22:19:10,13410.0,4,6384,0,13405.0,15,13415.0,34,B
2018-04-26 22:19:15,13405.0,24,6408,-10,13400.0,61,13405.0,18,S
2018-04-26 22:19:16,13410.0,38,6446,-18,13405.0,3,13410.0,6,B
2018-04-26 22:19:16,13405.0,2,6448,2,13405.0,4,13410.0,6,S
2018-04-26 22:19:20,13410.0,2,6450,-2,13410.0,1,13415.0,36,B
2018-04-26 22:19:24,13410.0,4,6454,2,13405.0,42,13410.0,2,B
2018-04-26 22:19:25,13410.0,4,6458,-2,13405.0,9,13415.0,22,B
2018-04-26 22:19:25,13405.0,2,6460,-2,13405.0,10,13415.0,23,S
2018-04-26 22:19:30,13410.0,6,6466,4,13410.0,2,13415.0,20,B
2018-04-26 22:19:35,13415.0,2,6468,-2,13410.0,6,13415.0,5,B
2018-04-26 22:19:35,13415.0,10,6478,-10,13410.0,7,13420.0,8,B
2018-04-26 22:19:37,13415.0,2,6480,-2,13410.0,9,13415.0,1,B
2018-04-26 22:19:41,13410.0,2,6482,0,13410.0,7,13415.0,11,S
2018-04-26 22:19:42,13410.0,14,6496,8,13405.0,18,13410.0,1,S
2018-04-26 22:19:48,13410.0,2,6498,2,13405.0,16,13415.0,18,S
2018-04-26 22:19:51,13410.0,4,6502,0,13405.0,17,13415.0,18,S
2018-04-26 22:19:55,13410.0,2,6504,0,13405.0,17,13410.0,9,S
2018-04-26 22:20:01,13410.0,2,6506,0,13405.0,16,13410.0,8,S
2018-04-26 22:20:19,13410.0,2,6508,0,13405.0,20,13410.0,7,S
2018-04-26 22:20:21,13410.0,10,6518,0,13405.0,20,13410.0,2,S
2018-04-26 22:20:26,13410.0,2,6520,0,13405.0,18,13410.0,4,S
2018-04-26 22:20:28,13410.0,2,6522,0,13405.0,18,13410.0,2,S
2018-04-26 22:20:30,13410.0,2,6524,2,13405.0,19,13415.0,22,S
2018-04-26 22:20:39,13405.0,2,6526,0,13405.0,18,13410.0,8,S
2018-04-26 22:20:47,13410.0,4,6530,-4,13410.0,3,13415.0,34,B
2018-04-26 22:20:47,13410.0,6,6536,0,13405.0,18,13410.0,4,B
2018-04-26 22:20:48,13410.0,2,6538,0,13405.0,18,13410.0,5,B
2018-04-26 22:20:52,13410.0,10,6548,-2,13405.0,16,13410.0,3,B
2018-04-26 22:20:54,13410.0,8,6556,-4,13405.0,16,13415.0,19,B
2018-04-26 22:20:55,13410.0,2,6558,2,13405.0,22,13415.0,18,B
2018-04-26 22:21:01,13410.0,18,6576,18,13410.0,1,13415.0,33,B
2018-04-26 22:21:02,13410.0,4,6580,-2,13410.0,4,13415.0,33,B
2018-04-26 22:21:02,13410.0,8,6588,-8,13405.0,23,13410.0,1,B
2018-04-26 22:21:03,13405.0,20,6608,8,13405.0,10,13410.0,28,S
2018-04-26 22:21:03,13400.0,34,6642,20,13400.0,13,13405.0,2,S
2018-04-26 22:21:05,13400.0,20,6662,16,13395.0,6,13400.0,2,S
2018-04-26 22:21:07,13400.0,10,6672,0,13395.0,6,13405.0,17,S
2018-04-26 22:21:08,13400.0,6,6678,2,13400.0,3,13405.0,7,S
2018-04-26 22:21:15,13400.0,2,6680,0,13395.0,16,13405.0,20,S
2018-04-26 22:21:16,13400.0,10,6690,4,13395.0,15,13405.0,20,S
2018-04-26 22:21:18,13400.0,8,6698,0,13395.0,9,13405.0,20,S
2018-04-26 22:21:19,13400.0,6,6704,0,13400.0,2,13405.0,20,S
2018-04-26 22:21:21,13400.0,2,6706,0,13400.0,4,13405.0,14,S
2018-04-26 22:21:23,13400.0,2,6708,2,13400.0,10,13405.0,4,S
2018-04-26 22:21:26,13405.0,2,6710,0,13400.0,10,13410.0,14,B
2018-04-26 22:21:27,13400.0,10,6720,6,13400.0,10,13405.0,1,S
2018-04-26 22:21:29,13405.0,2,6722,0,13400.0,5,13405.0,3,B
2018-04-26 22:21:36,13400.0,2,6724,2,13400.0,6,13405.0,1,S
2018-04-26 22:21:43,13405.0,18,6742,0,13400.0,1,13405.0,1,B
2018-04-26 22:21:43,13400.0,2,6744,2,13400.0,2,13405.0,27,S
2018-04-26 22:21:44,13400.0,4,6748,0,13395.0,14,13405.0,27,S
2018-04-26 22:21:48,13400.0,2,6750,0,13400.0,3,13405.0,27,S
2018-04-26 22:21:49,13400.0,4,6754,-4,13395.0,11,13400.0,1,S
2018-04-26 22:21:49,13400.0,4,6758,-2,13395.0,11,13405.0,27,S
2018-04-26 22:21:53,13395.0,2,6760,2,13395.0,5,13400.0,3,S
2018-04-26 22:21:53,13400.0,10,6770,0,13395.0,6,13405.0,24,B
2018-04-26 22:22:00,13405.0,2,6772,0,13400.0,4,13405.0,22,B
2018-04-26 22:22:01,13400.0,8,6780,-2,13395.0,16,13405.0,22,S
2018-04-26 22:22:11,13405.0,6,6786,-2,13400.0,15,13405.0,7,B
2018-04-26 22:22:12,13405.0,20,6806,-10,13400.0,15,13410.0,18,B
2018-04-26 22:22:13,13410.0,34,6840,16,13410.0,1,13415.0,27,B
2018-04-26 22:22:13,13415.0,14,6854,-8,13410.0,14,13420.0,10,B
2018-04-26 22:22:18,13410.0,30,6884,-8,13410.0,6,13415.0,1,S
2018-04-26 22:22:19,13415.0,2,6886,0,13410.0,6,13420.0,11,B
2018-04-26 22:22:24,13410.0,4,6890,0,13410.0,1,13415.0,11,S
2018-04-26 22:22:32,13410.0,4,6894,0,13405.0,16,13410.0,15,S
2018-04-26 22:22:33,13410.0,2,6896,2,13405.0,5,13410.0,10,S
2018-04-26 22:22:36,13405.0,2,6898,-2,13405.0,4,13410.0,11,S
2018-04-26 22:22:40,13405.0,2,6900,0,13405.0,3,13410.0,13,S
2018-04-26 22:22:41,13405.0,2,6902,0,13405.0,2,13410.0,13,S
2018-04-26 22:22:48,13405.0,2,6904,2,13405.0,11,13410.0,13,S
2018-04-26 22:23:02,13410.0,10,6914,-4,13405.0,17,13410.0,6,B
2018-04-26 22:23:06,13405.0,2,6916,2,13405.0,16,13410.0,6,S
2018-04-26 22:23:09,13405.0,10,6926,10,13405.0,11,13410.0,6,S
2018-04-26 22:23:16,13405.0,2,6928,0,13405.0,10,13410.0,7,S
2018-04-26 22:23:27,13410.0,10,6938,0,13405.0,10,13410.0,2,B
2018-04-26 22:23:42,13410.0,10,6948,0,13405.0,10,13410.0,1,B
2018-04-26 22:23:48,13410.0,2,6950,0,13405.0,10,13415.0,19,B
2018-04-26 22:24:00,13410.0,4,6954,2,13410.0,8,13415.0,19,B
2018-04-26 22:24:01,13410.0,16,6970,16,13405.0,14,13415.0,19,B
2018-04-26 22:24:32,13410.0,2,6972,2,13405.0,10,13410.0,1,B
2018-04-26 22:24:33,13405.0,2,6974,2,13405.0,9,13410.0,1,S
2018-04-26 22:24:37,13405.0,2,6976,2,13405.0,8,13410.0,1,S
2018-04-26 22:24:38,13410.0,2,6978,-2,13405.0,8,13415.0,34,B
2018-04-26 22:25:09,13410.0,2,6980,0,13405.0,15,13410.0,1,B
2018-04-26 22:25:10,13410.0,2,6982,0,13405.0,15,13415.0,19,B
2018-04-26 22:25:22,13405.0,8,6990,4,13405.0,16,13415.0,34,S
2018-04-26 22:25:25,13405.0,2,6992,0,13405.0,9,13410.0,24,S
2018-04-26 22:25:36,13410.0,6,6998,-2,13405.0,10,13410.0,8,B
2018-04-26 22:25:37,13410.0,2,7000,2,13405.0,10,13410.0,4,B
2018-04-26 22:25:40,13405.0,4,7004,-4,13405.0,8,13410.0,26,S
2018-04-26 22:25:45,13410.0,2,7006,0,13405.0,11,13410.0,5,B
2018-04-26 22:26:12,13410.0,10,7016,2,13410.0,15,13415.0,14,B
2018-04-26 22:26:12,13415.0,8,7024,-6,13410.0,13,13415.0,2,B
2018-04-26 22:26:13,13415.0,4,7028,0,13410.0,16,13420.0,26,B
2018-04-26 22:26:17,13410.0,10,7038,4,13410.0,11,13415.0,10,S
2018-04-26 22:26:48,13415.0,24,7062,6,13410.0,14,13420.0,16,B
2018-04-26 22:26:50,13420.0,10,7072,2,13415.0,9,13425.0,13,B
2018-04-26 22:26:52,13425.0,10,7082,6,13425.0,1,13430.0,10,B
2018-04-26 22:26:53,13425.0,2,7084,-2,13420.0,14,13430.0,29,B
2018-04-26 22:26:58,13425.0,6,7090,-2,13420.0,14,13430.0,30,B
2018-04-26 22:27:02,13430.0,8,7098,-6,13420.0,18,13430.0,24,B
2018-04-26 22:27:03,13425.0,2,7100,-2,13420.0,15,13430.0,14,S
2018-04-26 22:27:05,13420.0,4,7104,-2,13415.0,11,13420.0,5,S
2018-04-26 22:27:06,13420.0,10,7114,-10,13415.0,11,13425.0,14,S
2018-04-26 22:27:14,13415.0,2,7116,0,13415.0,14,13425.0,19,S
2018-04-26 22:27:22,13415.0,24,7140,-16,13410.0,13,13420.0,6,S
2018-04-26 22:27:29,13415.0,2,7142,-2,13410.0,1,13415.0,13,S
2018-04-26 22:27:59,13410.0,16,7158,-2,13405.0,17,13415.0,9,S
2018-04-26 22:28:00,13405.0,30,7188,-2,13400.0,8,13405.0,1,S
2018-04-26 22:28:02,13405.0,8,7196,2,13400.0,17,13410.0,14,S
2018-04-26 22:28:08,13405.0,10,7206,0,13400.0,14,13410.0,6,S
2018-04-26 22:28:17,13405.0,6,7212,0,13400.0,13,13410.0,20,S
2018-04-26 22:28:24,13405.0,4,7216,2,13400.0,15,13405.0,2,S
2018-04-26 22:28:26,13400.0,14,7230,-2,13395.0,13,13405.0,15,S
2018-04-26 22:28:28,13400.0,28,7258,-8,13400.0,2,13405.0,15,S
2018-04-26 22:28:33,13405.0,18,7276,-12,13405.0,13,13410.0,24,B
2018-04-26 22:28:33,13405.0,26,7302,-24,13400.0,6,13410.0,28,B
2018-04-26 22:28:36,13400.0,10,7312,-6,13400.0,6,13405.0,2,S
2018-04-26 22:28:42,13405.0,2,7314,-2,13405.0,2,13410.0,30,B
2018-04-26 22:28:47,13405.0,2,7316,0,13405.0,8,13410.0,13,B
2018-04-26 22:28:53,13410.0,2,7318,0,13405.0,12,13410.0,4,B
2018-04-26 22:28:56,13410.0,2,7320,-2,13405.0,12,13410.0,2,B
2018-04-26 22:29:01,13410.0,4,7324,-2,13405.0,12,13415.0,16,B
2018-04-26 22:29:08,13405.0,20,7344,-8,13405.0,1,13410.0,1,S
2018-04-26 22:29:13,13405.0,2,7346,2,13405.0,4,13410.0,5,S
2018-04-26 22:29:33,13405.0,2,7348,-2,13400.0,16,13410.0,5,S
2018-04-26 22:29:47,13405.0,6,7354,-4,13400.0,23,13405.0,7,S
2018-04-26 22:29:47,13405.0,14,7368,-6,13405.0,1,13410.0,5,S
2018-04-26 22:29:57,13410.0,8,7376,-8,13405.0,1,13415.0,35,B
2018-04-26 22:30:04,13405.0,2,7378,0,13405.0,4,13410.0,3,S
2018-04-26 22:30:18,13405.0,4,7382,-2,13400.0,24,13410.0,5,S
2018-04-26 22:30:42,13405.0,6,7388,0,13400.0,25,13410.0,6,S
2018-04-26 22:30:44,13410.0,4,7392,-4,13410.0,4,13415.0,15,B
2018-04-26 22:30:47,13410.0,8,7400,0,13405.0,16,13415.0,13,B
2018-04-26 22:30:51,13405.0,2,7402,0,13405.0,3,13410.0,5,S
2018-04-26 22:30:51,13405.0,6,7408,6,13400.0,21,13405.0,1,S
2018-04-26 22:30:52,13405.0,2,7410,0,13405.0,1,13410.0,11,S
2018-04-26 22:30:53,13405.0,2,7412,-2,13400.0,26,13410.0,11,S
2018-04-26 22:31:01,13405.0,6,7418,2,13400.0,24,13410.0,7,S
2018-04-26 22:31:06,13405.0,2,7420,0,13405.0,6,13410.0,3,S
2018-04-26 22:31:10,13410.0,6,7426,-6,13405.0,6,13415.0,17,B
2018-04-26 22:31:23,13410.0,4,7430,-4,13410.0,3,13415.0,24,B
2018-04-26 22:31:23,13410.0,6,7436,-6,13405.0,9,13415.0,24,B
2018-04-26 22:31:39,13410.0,2,7438,0,13405.0,15,13410.0,4,B
2018-04-26 22:31:40,13405.0,20,7458,-16,13405.0,5,13410.0,4,S
2018-04-26 22:31:42,13405.0,2,7460,-2,13405.0,4,13410.0,4,S
2018-04-26 22:31:52,13405.0,4,7464,-4,13405.0,3,13410.0,6,S
2018-04-26 22:32:14,13410.0,2,7466,0,13405.0,6,13410.0,7,B
2018-04-26 22:32:22,13410.0,14,7480,8,13410.0,4,13415.0,24,B
2018-04-26 22:32:24,13415.0,16,7496,-4,13410.0,18,13415.0,2,B
2018-04-26 22:32:25,13415.0,4,7500,-2,13415.0,3,13420.0,9,B
2018-04-26 22:32:26,13420.0,6,7506,-6,13415.0,10,13425.0,8,B
2018-04-26 22:32:28,13415.0,6,7512,2,13410.0,13,13420.0,27,S
2018-04-26 22:32:29,13415.0,4,7516,-2,13410.0,13,13420.0,27,S
2018-04-26 22:32:33,13420.0,8,7524,2,13415.0,10,13425.0,25,B
2018-04-26 22:32:36,13420.0,2,7526,0,13420.0,1,13425.0,31,B
2018-04-26 22:32:37,13420.0,2,7528,-2,13415.0,13,13420.0,8,B
2018-04-26 22:32:38,13415.0,2,7530,2,13415.0,3,13420.0,16,S
2018-04-26 22:32:56,13415.0,20,7550,-10,13410.0,14,13420.0,17,S
2018-04-26 22:33:57,13420.0,12,7562,-2,13415.0,13,13420.0,2,B
2018-04-26 22:33:58,13420.0,4,7566,-4,13420.0,4,13425.0,13,B
2018-04-26 22:34:09,13420.0,2,7568,0,13420.0,2,13425.0,15,B
2018-04-26 22:34:09,13420.0,4,7572,0,13415.0,10,13420.0,5,B
2018-04-26 22:34:11,13420.0,4,7576,-2,13415.0,6,13420.0,3,B
2018-04-26 22:34:12,13415.0,2,7578,0,13415.0,5,13420.0,3,S
2018-04-26 22:34:18,13415.0,8,7586,8,13415.0,1,13420.0,4,S
2018-04-26 22:34:24,13420.0,2,7588,0,13420.0,39,13425.0,14,B
2018-04-26 22:34:26,13420.0,2,7590,0,13420.0,38,13425.0,12,B
2018-04-26 22:34:41,13420.0,8,7598,2,13420.0,34,13425.0,15,B
2018-04-26 22:34:43,13420.0,2,7600,2,13420.0,33,13425.0,18,B
2018-04-26 22:34:44,13420.0,10,7610,10,13420.0,28,13425.0,18,B
2018-04-26 22:34:48,13420.0,2,7612,2,13420.0,27,13425.0,18,B
2018-04-26 22:34:56,13425.0,20,7632,2,13420.0,27,13425.0,8,B
2018-04-26 22:35:38,13420.0,2,7634,2,13420.0,26,13425.0,9,S
2018-04-26 22:37:44,13425.0,28,7662,10,13420.0,31,13430.0,16,B
2018-04-26 22:37:45,13430.0,8,7670,4,13425.0,10,13430.0,3,B
2018-04-26 22:37:52,13430.0,6,7676,-2,13425.0,10,13430.0,3,B
2018-04-26 22:38:07,13425.0,4,7680,0,13425.0,5,13430.0,11,S
2018-04-26 22:38:08,13425.0,2,7682,0,13420.0,36,13430.0,17,S
2018-04-26 22:38:13,13425.0,4,7686,0,13420.0,32,13425.0,1,S
2018-04-26 22:38:14,13425.0,2,7688,2,13420.0,32,13430.0,32,S
2018-04-26 22:38:44,13420.0,12,7700,0,13420.0,23,13425.0,28,S
2018-04-26 22:38:44,13420.0,4,7704,4,13420.0,21,13425.0,32,S
2018-04-26 22:38:45,13420.0,42,7746,36,13415.0,16,13420.0,4,S
2018-04-26 22:39:19,13420.0,2,7748,-2,13415.0,13,13420.0,9,S
2018-04-26 22:39:46,13415.0,2,7750,0,13415.0,17,13420.0,26,S
2018-04-26 22:40:02,13420.0,46,7796,-38,13415.0,27,13425.0,17,B
2018-04-26 22:40:05,13425.0,20,7816,18,13420.0,20,13430.0,28,B
2018-04-26 22:40:09,13425.0,14,7830,-4,13425.0,1,13430.0,11,B
2018-04-26 22:40:10,13425.0,2,7832,-2,13420.0,15,13425.0,3,B
2018-04-26 22:40:23,13425.0,12,7844,-2,13420.0,20,13430.0,30,B
2018-04-26 22:40:34,13430.0,30,7874,-4,13425.0,18,13435.0,10,B
2018-04-26 22:40:35,13435.0,2,7876,-2,13430.0,5,13435.0,7,B
2018-04-26 22:40:35,13435.0,2,7878,0,13430.0,7,13435.0,6,B
2018-04-26 22:40:36,13435.0,2,7880,-2,13430.0,8,13435.0,4,B
2018-04-26 22:40:36,13435.0,2,7882,0,13430.0,8,13435.0,4,B
2018-04-26 22:40:56,13430.0,2,7884,2,13430.0,8,13435.0,13,S
2018-04-26 22:40:56,13430.0,14,7898,0,13425.0,16,13435.0,11,S
2018-04-26 22:41:00,13430.0,2,7900,0,13425.0,22,13435.0,13,S
2018-04-26 22:41:12,13430.0,2,7902,-2,13425.0,22,13435.0,12,S
2018-04-26 22:41:17,13430.0,2,7904,0,13430.0,5,13435.0,11,S
2018-04-26 22:41:20,13430.0,2,7906,2,13430.0,12,13435.0,11,S
2018-04-26 22:41:32,13430.0,2,7908,0,13430.0,12,13435.0,11,S
2018-04-26 22:41:33,13430.0,2,7910,-2,13430.0,6,13435.0,11,S
2018-04-26 22:41:44,13435.0,2,7912,0,13430.0,2,13435.0,10,B
2018-04-26 22:41:47,13435.0,2,7914,0,13430.0,10,13435.0,9,B
2018-04-26 22:41:50,13435.0,20,7934,2,13430.0,12,13440.0,6,B
2018-04-26 22:41:56,13430.0,2,7936,2,13430.0,19,13440.0,6,S
2018-04-26 22:42:02,13435.0,2,7938,0,13430.0,2,13435.0,12,B
2018-04-26 22:42:13,13430.0,4,7942,2,13425.0,13,13435.0,11,S
2018-04-26 22:42:33,13430.0,2,7944,2,13425.0,13,13435.0,10,S
2018-04-26 22:42:58,13435.0,6,7950,-6,13430.0,14,13435.0,5,B
2018-04-26 22:42:58,13435.0,10,7960,0,13430.0,14,13440.0,24,B
2018-04-26 22:43:26,13435.0,4,7964,2,13430.0,20,13435.0,3,B
2018-04-26 22:43:28,13435.0,6,7970,0,13430.0,20,13440.0,21,B
2018-04-26 22:43:41,13435.0,2,7972,-2,13430.0,22,13440.0,20,B
2018-04-26 22:44:03,13435.0,2,7974,0,13430.0,23,13440.0,20,B
2018-04-26 22:44:07,13435.0,2,7976,0,13430.0,23,13440.0,20,B
2018-04-26 22:44:23,13430.0,2,7978,-2,13430.0,4,13435.0,9,S
2018-04-26 22:44:24,13430.0,8,7986,4,13425.0,12,13430.0,1,S
2018-04-26 22:44:36,13430.0,2,7988,-2,13425.0,18,13435.0,17,S
2018-04-26 22:45:25,13430.0,10,7998,2,13425.0,21,13435.0,38,S
2018-04-26 22:45:39,13430.0,2,8000,0,13430.0,4,13435.0,33,S
2018-04-26 22:45:49,13430.0,2,8002,0,13430.0,4,13435.0,33,S
2018-04-26 22:45:50,13430.0,8,8010,4,13425.0,21,13435.0,33,S
2018-04-26 22:45:51,13430.0,2,8012,0,13425.0,20,13430.0,1,S
2018-04-26 22:45:55,13430.0,2,8014,0,13425.0,16,13435.0,35,S
2018-04-26 22:46:06,13430.0,2,8016,0,13425.0,16,13435.0,35,S
2018-04-26 22:46:07,13430.0,2,8018,2,13425.0,16,13430.0,1,S
2018-04-26 22:46:10,13430.0,4,8022,2,13425.0,23,13435.0,35,S
2018-04-26 22:46:11,13430.0,2,8024,2,13425.0,22,13435.0,35,S
2018-04-26 22:46:47,13430.0,2,8026,0,13425.0,23,13435.0,34,S
2018-04-26 22:47:41,13430.0,2,8028,-2,13430.0,3,13435.0,39,S
2018-04-26 22:48:06,13435.0,2,8030,-2,13430.0,10,13435.0,30,B
2018-04-26 22:48:07,13435.0,60,8090,-12,13435.0,2,13440.0,18,B
2018-04-26 22:48:18,13440.0,4,8094,2,13435.0,13,13440.0,9,B
2018-04-26 22:48:39,13435.0,2,8096,0,13435.0,5,13440.0,9,S
2018-04-26 22:48:50,13440.0,20,8116,2,13435.0,23,13445.0,14,B
2018-04-26 22:48:51,13445.0,8,8124,6,13440.0,6,13445.0,5,B
2018-04-26 22:49:02,13445.0,10,8134,-2,13440.0,18,13450.0,7,B
2018-04-26 22:49:03,13440.0,10,8144,-10,13440.0,3,13445.0,3,S
2018-04-26 22:49:04,13440.0,2,8146,-2,13440.0,4,13445.0,9,S
2018-04-26 22:49:04,13440.0,8,8154,-4,13435.0,17,13440.0,2,S
2018-04-26 22:49:05,13435.0,16,8170,-10,13430.0,7,13440.0,5,S
2018-04-26 22:49:06,13435.0,2,8172,0,13435.0,3,13440.0,5,S
2018-04-26 22:49:06,13435.0,4,8176,-4,13435.0,1,13440.0,5,S
2018-04-26 22:49:07,13435.0,2,8178,-2,13430.0,13,13440.0,6,S
2018-04-26 22:49:08,13435.0,2,8180,-2,13430.0,13,13440.0,6,S
2018-04-26 22:49:08,13440.0,2,8182,0,13430.0,13,13440.0,5,B
2018-04-26 22:49:09,13435.0,2,8184,-2,13435.0,5,13440.0,1,S
2018-04-26 22:49:15,13440.0,2,8186,0,13435.0,14,13445.0,13,B
2018-04-26 22:49:24,13445.0,12,8198,-4,13440.0,11,13450.0,12,B
2018-04-26 22:49:33,13445.0,2,8200,0,13440.0,3,13445.0,5,B
2018-04-26 22:49:44,13445.0,2,8202,0,13440.0,3,13445.0,10,B
2018-04-26 22:49:48,13440.0,6,8208,0,13435.0,16,13445.0,13,S
2018-04-26 22:49:49,13435.0,2,8210,0,13435.0,14,13445.0,27,S
2018-04-26 22:49:51,13440.0,2,8212,-2,13435.0,14,13445.0,27,B
2018-04-26 22:49:55,13440.0,2,8214,-2,13435.0,13,13440.0,2,B
2018-04-26 22:50:15,13435.0,6,8220,-6,13435.0,10,13440.0,4,S
2018-04-26 22:50:18,13440.0,6,8226,4,13440.0,3,13445.0,10,B
2018-04-26 22:50:24,13440.0,2,8228,2,13440.0,2,13445.0,6,B
2018-04-26 22:50:53,13440.0,2,8230,0,13435.0,18,13440.0,3,B
2018-04-26 22:50:59,13440.0,6,8236,-6,13435.0,16,13440.0,2,B
2018-04-26 22:51:13,13445.0,6,8242,-2,13435.0,15,13445.0,13,B
2018-04-26 22:51:29,13435.0,2,8244,0,13435.0,16,13440.0,4,S
2018-04-26 22:51:31,13440.0,2,8246,2,13435.0,16,13440.0,3,B
2018-04-26 22:51:53,13440.0,2,8248,2,13435.0,17,13440.0,2,B
2018-04-26 22:52:02,13440.0,2,8250,2,13435.0,17,13440.0,2,B
2018-04-26 22:52:04,13440.0,2,8252,0,13435.0,18,13445.0,28,B
2018-04-26 22:52:05,13440.0,2,8254,0,13440.0,20,13445.0,7,B
2018-04-26 22:52:17,13445.0,4,8258,2,13440.0,14,13445.0,4,B
2018-04-26 22:52:30,13440.0,12,8270,-6,13435.0,12,13445.0,10,S
2018-04-26 22:52:42,13440.0,2,8272,0,13435.0,22,13440.0,1,S
2018-04-26 22:52:42,13440.0,2,8274,0,13435.0,22,13445.0,11,S
2018-04-26 22:52:44,13440.0,4,8278,0,13435.0,19,13445.0,12,S
2018-04-26 22:52:56,13445.0,2,8280,-2,13440.0,3,13445.0,8,B
2018-04-26 22:53:20,13440.0,2,8282,2,13440.0,7,13445.0,7,S
2018-04-26 22:53:22,13440.0,14,8296,0,13435.0,13,13440.0,1,S
2018-04-26 22:53:43,13435.0,2,8298,-2,13435.0,12,13440.0,5,S
2018-04-26 22:53:44,13435.0,2,8300,0,13435.0,11,13440.0,5,S
2018-04-26 22:54:02,13435.0,2,8302,0,13435.0,10,13440.0,6,S
2018-04-26 22:54:05,13435.0,4,8306,-2,13435.0,8,13440.0,6,S
2018-04-26 22:54:15,13440.0,4,8310,-4,13435.0,6,13440.0,4,B
2018-04-26 22:54:30,13435.0,2,8312,0,13435.0,5,13440.0,8,S
2018-04-26 22:55:00,13440.0,4,8316,-4,13435.0,7,13440.0,5,B
2018-04-26 22:55:01,13440.0,4,8320,-2,13435.0,6,13440.0,3,B
2018-04-26 22:55:01,13440.0,2,8322,0,13435.0,6,13440.0,3,B
2018-04-26 22:55:04,13440.0,4,8326,-4,13435.0,19,13445.0,15,B
2018-04-26 22:55:09,13440.0,2,8328,0,13440.0,5,13445.0,8,B
2018-04-26 22:55:09,13440.0,2,8330,0,13440.0,4,13445.0,8,B
2018-04-26 22:55:35,13440.0,2,8332,2,13440.0,5,13445.0,9,B
2018-04-26 22:56:17,13440.0,6,8338,-2,13440.0,4,13445.0,9,B
2018-04-26 22:56:29,13445.0,2,8340,-2,13440.0,3,13445.0,8,B
2018-04-26 22:56:45,13445.0,8,8348,4,13440.0,3,13445.0,5,B
2018-04-26 22:56:50,13445.0,2,8350,0,13440.0,3,13445.0,6,B
2018-04-26 22:56:52,13440.0,4,8354,-4,13440.0,1,13445.0,6,S
2018-04-26 22:56:57,13440.0,4,8358,2,13435.0,20,13440.0,3,S
2018-04-26 22:57:00,13440.0,2,8360,0,13435.0,13,13440.0,5,S
2018-04-26 22:57:01,13440.0,12,8372,-8,13435.0,12,13440.0,3,S
2018-04-26 22:57:07,13440.0,2,8374,-2,13435.0,12,13440.0,10,S
2018-04-26 22:57:20,13440.0,18,8392,-18,13440.0,2,13445.0,8,S
2018-04-26 22:57:30,13445.0,12,8404,2,13440.0,7,13450.0,11,B
2018-04-26 22:57:31,13445.0,14,8418,-10,13440.0,7,13450.0,10,B
2018-04-26 22:57:33,13445.0,2,8420,0,13440.0,7,13445.0,6,B
2018-04-26 22:57:34,13445.0,2,8422,0,13440.0,41,13445.0,5,B
2018-04-26 22:57:37,13445.0,2,8424,0,13440.0,41,13445.0,4,B
2018-04-26 22:57:38,13445.0,2,8426,0,13440.0,41,13445.0,3,B
2018-04-26 22:57:43,13445.0,2,8428,-2,13440.0,12,13445.0,5,B
2018-04-26 22:57:47,13445.0,2,8430,-2,13440.0,12,13445.0,1,B
2018-04-26 22:57:53,13445.0,2,8432,-2,13440.0,12,13450.0,8,B
2018-04-26 22:58:00,13435.0,6,8438,-6,13435.0,10,13445.0,14,S
2018-04-26 22:58:00,13440.0,46,8484,-46,13440.0,7,13445.0,14,B
2018-04-26 22:58:01,13440.0,2,8486,-2,13440.0,6,13445.0,14,B
2018-04-26 22:58:01,13440.0,2,8488,-2,13440.0,5,13445.0,14,B
2018-04-26 22:58:04,13445.0,2,8490,0,13440.0,5,13445.0,13,B
2018-04-26 22:58:29,13445.0,12,8502,-12,13445.0,14,13450.0,7,B
2018-04-26 22:58:37,13445.0,12,8514,-12,13445.0,9,13450.0,16,B
2018-04-26 22:58:40,13445.0,10,8524,0,13445.0,4,13450.0,16,B
2018-04-26 22:58:41,13445.0,8,8532,-8,13440.0,9,13450.0,16,B
2018-04-26 22:58:41,13445.0,40,8572,-40,13440.0,9,13445.0,4,B
2018-04-26 22:58:43,13445.0,2,8574,0,13440.0,9,13445.0,3,B
2018-04-26 22:58:56,13445.0,2,8576,0,13440.0,9,13445.0,6,B
2018-04-26 22:59:00,13440.0,2,8578,-2,13440.0,8,13445.0,6,S
2018-04-26 22:59:01,13440.0,8,8586,-8,13440.0,3,13445.0,6,S
2018-04-26 22:59:11,13440.0,6,8592,-6,13435.0,2,13445.0,8,S
2018-04-26 22:59:11,13440.0,8,8600,-4,13435.0,9,13445.0,8,S
2018-04-26 22:59:12,13440.0,10,8610,-10,13435.0,9,13440.0,3,S
2018-04-26 22:59:22,13440.0,2,8612,0,13435.0,9,13440.0,2,S
2018-04-26 22:59:29,13440.0,2,8614,-2,13435.0,11,13440.0,1,S
2018-04-26 22:59:30,13435.0,6,8620,-4,13435.0,8,13440.0,4,S
2018-04-26 22:59:31,13435.0,2,8622,-2,13435.0,7,13440.0,4,S
2018-04-26 22:59:31,13435.0,12,8634,-2,13435.0,1,13440.0,4,S
2018-04-26 22:59:32,13435.0,2,8636,0,13430.0,4,13440.0,4,S
2018-04-26 22:59:33,13435.0,2,8638,-2,13430.0,5,13435.0,3,S
2018-04-26 22:59:35,13435.0,2,8640,0,13430.0,5,13435.0,2,S
2018-04-26 22:59:37,13435.0,2,8642,-2,13430.0,5,13435.0,1,S
2018-04-26 22:59:38,13435.0,2,8644,-2,13430.0,5,13440.0,1,S
2018-04-26 22:59:38,13435.0,4,8648,-4,13430.0,6,13440.0,3,S
2018-04-26 22:59:40,13430.0,2,8650,0,13430.0,4,13435.0,2,S
2018-04-26 22:59:41,13430.0,4,8654,-2,13430.0,2,13435.0,2,S
2018-04-26 22:59:46,13435.0,2,8656,-2,13430.0,3,13435.0,1,B
2018-04-26 22:59:49,13435.0,2,8658,-2,13430.0,3,13440.0,1,B
2018-04-26 22:59:52,13445.0,4,8662,-2,13430.0,3,13445.0,10,B
2018-04-27 09:00:00,13445.0,2,8664,2,13430.0,3,13445.0,9,B
2018-04-27 09:00:02,13445.0,2,8666,0,13435.0,2,13440.0,1,B
2018-04-27 09:00:02,13435.0,4,8670,0,13430.0,5,13440.0,3,S
2018-04-27 09:00:08,13440.0,4,8674,2,13435.0,1,13440.0,6,B
2018-04-27 09:00:10,13440.0,6,8680,0,13435.0,1,13440.0,5,B
2018-04-27 09:00:14,13435.0,2,8682,-2,13435.0,1,13440.0,7,S
2018-04-27 09:00:14,13435.0,2,8684,2,13430.0,5,13435.0,2,S
2018-04-27 09:00:15,13435.0,2,8686,2,13430.0,3,13440.0,7,S
2018-04-27 09:00:15,13440.0,2,8688,-2,13430.0,5,13440.0,6,B
2018-04-27 09:00:17,13430.0,2,8690,-2,13430.0,4,13435.0,3,S
2018-04-27 09:00:24,13435.0,2,8692,0,13430.0,3,13435.0,1,B
2018-04-27 09:00:25,13430.0,4,8696,2,13430.0,3,13435.0,1,S
2018-04-27 09:00:26,13430.0,8,8704,-4,13425.0,5,13430.0,2,S
2018-04-27 09:00:27,13430.0,2,8706,2,13425.0,5,13430.0,1,S
2018-04-27 09:00:30,13430.0,4,8710,4,13425.0,3,13435.0,7,S
2018-04-27 09:00:33,13425.0,4,8714,2,13425.0,4,13435.0,7,S
2018-04-27 09:00:37,13430.0,2,8716,0,13425.0,2,13430.0,1,B
2018-04-27 09:00:43,13430.0,2,8718,2,13425.0,2,13430.0,1,B
2018-04-27 09:00:55,13425.0,14,8732,12,13420.0,11,13430.0,7,S
2018-04-27 09:01:00,13420.0,2,8734,-2,13420.0,10,13425.0,1,S
2018-04-27 09:01:00,13420.0,10,8744,10,13420.0,5,13425.0,2,S
2018-04-27 09:01:03,13420.0,2,8746,2,13420.0,5,13425.0,2,S
2018-04-27 09:01:03,13420.0,10,8756,8,13415.0,12,13420.0,1,S
2018-04-27 09:01:04,13420.0,6,8762,2,13415.0,12,13420.0,4,S
2018-04-27 09:01:09,13420.0,2,8764,0,13415.0,12,13420.0,1,S
2018-04-27 09:01:22,13420.0,10,8774,0,13420.0,1,13425.0,16,S
2018-04-27 09:01:23,13425.0,2,8776,2,13425.0,1,13430.0,19,B
2018-04-27 09:01:24,13425.0,2,8778,0,13420.0,16,13430.0,21,B
2018-04-27 09:01:27,13430.0,2,8780,0,13420.0,16,13430.0,22,B
2018-04-27 09:01:33,13420.0,2,8782,0,13420.0,15,13430.0,21,S
2018-04-27 09:01:35,13430.0,2,8784,0,13420.0,16,13430.0,20,B
2018-04-27 09:01:44,13425.0,8,8792,-2,13420.0,24,13430.0,9,S
2018-04-27 09:01:45,13420.0,4,8796,2,13425.0,1,13430.0,9,S
2018-04-27 09:01:55,13430.0,2,8798,0,13425.0,2,13430.0,9,B
2018-04-27 09:01:56,13425.0,4,8802,-2,13420.0,22,13430.0,10,S
2018-04-27 09:02:05,13425.0,2,8804,0,13420.0,21,13425.0,4,S
2018-04-27 09:02:07,13425.0,12,8816,2,13425.0,1,13430.0,9,S
2018-04-27 09:02:11,13430.0,6,8822,0,13425.0,12,13435.0,7,B
2018-04-27 09:02:16,13430.0,2,8824,2,13430.0,2,13435.0,6,B
2018-04-27 09:02:23,13435.0,8,8832,-2,13435.0,2,13440.0,2,B
2018-04-27 09:02:42,13435.0,2,8834,2,13435.0,2,13440.0,5,B
2018-04-27 09:02:43,13435.0,4,8838,4,13430.0,7,13435.0,4,B
2018-04-27 09:02:44,13430.0,2,8840,0,13425.0,8,13435.0,12,S
2018-04-27 09:02:49,13430.0,2,8842,2,13425.0,10,13435.0,16,S
2018-04-27 09:02:53,13425.0,4,8846,0,13425.0,8,13435.0,17,S
2018-04-27 09:02:58,13425.0,6,8852,-4,13425.0,5,13435.0,18,S
2018-04-27 09:03:03,13435.0,2,8854,0,13425.0,5,13435.0,17,B
2018-04-27 09:03:04,13435.0,2,8856,0,13425.0,5,13435.0,16,B
2018-04-27 09:03:19,13430.0,2,8858,0,13425.0,8,13430.0,2,S
2018-04-27 09:03:19,13430.0,4,8862,2,13430.0,2,13435.0,16,S
2018-04-27 09:03:20,13430.0,4,8866,0,13425.0,8,13435.0,16,S
2018-04-27 09:03:25,13430.0,20,8886,20,13425.0,10,13435.0,16,S
2018-04-27 09:03:54,13435.0,2,8888,2,13425.0,10,13435.0,15,B
2018-04-27 09:03:59,13430.0,2,8890,2,13425.0,9,13435.0,17,S
2018-04-27 09:04:07,13430.0,2,8892,2,13425.0,9,13435.0,17,S
2018-04-27 09:04:33,13435.0,2,8894,0,13430.0,1,13435.0,13,B
2018-04-27 09:04:36,13430.0,2,8896,2,13425.0,9,13430.0,1,S
2018-04-27 09:04:37,13430.0,2,8898,0,13425.0,9,13435.0,13,S
2018-04-27 09:04:49,13435.0,32,8930,10,13435.0,11,13440.0,11,B
2018-04-27 09:04:59,13440.0,6,8936,-6,13435.0,7,13445.0,26,B
2018-04-27 09:05:00,13435.0,4,8940,0,13435.0,8,13440.0,3,S
2018-04-27 09:05:01,13440.0,6,8946,6,13435.0,13,13445.0,33,B
2018-04-27 09:05:15,13435.0,4,8950,0,13435.0,8,13440.0,32,S
2018-04-27 09:05:15,13435.0,16,8966,2,13430.0,9,13435.0,1,S
2018-04-27 09:05:19,13435.0,4,8970,-2,13430.0,11,13440.0,38,S
2018-04-27 09:05:25,13435.0,6,8976,-6,13435.0,5,13440.0,22,S
2018-04-27 09:05:26,13435.0,10,8986,0,13430.0,13,13435.0,3,S
2018-04-27 09:05:27,13430.0,6,8992,4,13430.0,8,13435.0,3,S
2018-04-27 09:05:28,13430.0,2,8994,0,13430.0,2,13435.0,8,S
2018-04-27 09:05:37,13430.0,10,9004,8,13425.0,15,13435.0,14,S
2018-04-27 09:05:51,13430.0,8,9012,0,13425.0,14,13430.0,6,S
2018-04-27 09:05:51,13430.0,4,9016,0,13425.0,14,13430.0,4,S
2018-04-27 09:05:52,13430.0,8,9024,4,13430.0,2,13435.0,15,S
2018-04-27 09:06:05,13435.0,2,9026,2,13425.0,13,13435.0,14,B
2018-04-27 09:06:18,13435.0,8,9034,6,13430.0,22,13440.0,10,B
2018-04-27 09:06:27,13430.0,2,9036,0,13430.0,13,13435.0,6,S
2018-04-27 09:06:31,13435.0,2,9038,0,13430.0,13,13435.0,5,B
2018-04-27 09:06:46,13430.0,18,9056,2,13425.0,14,13430.0,7,S
2018-04-27 09:06:47,13425.0,12,9068,8,13420.0,22,13425.0,3,S
2018-04-27 09:06:47,13425.0,4,9072,-2,13420.0,22,13425.0,7,S
2018-04-27 09:06:49,13425.0,2,9074,0,13420.0,27,13425.0,8,S
2018-04-27 09:06:49,13425.0,2,9076,0,13420.0,27,13425.0,7,S
2018-04-27 09:07:01,13420.0,2,9078,-2,13420.0,25,13425.0,7,S
2018-04-27 09:07:02,13420.0,30,9108,20,13415.0,14,13420.0,3,S
2018-04-27 09:07:03,13420.0,2,9110,-2,13415.0,18,13420.0,16,S
2018-04-27 09:07:04,13415.0,8,9118,0,13415.0,8,13420.0,21,S
2018-04-27 09:07:05,13410.0,24,9142,0,13410.0,15,13415.0,2,S
2018-04-27 09:07:05,13410.0,2,9144,0,13410.0,16,13415.0,2,S
2018-04-27 09:07:06,13410.0,10,9154,-2,13410.0,13,13415.0,2,S
2018-04-27 09:07:09,13415.0,2,9156,-2,13410.0,13,13415.0,6,B
2018-04-27 09:07:17,13415.0,2,9158,0,13410.0,20,13415.0,5,B
2018-04-27 09:07:18,13415.0,6,9164,-6,13410.0,25,13420.0,17,B
2018-04-27 09:07:20,13415.0,2,9166,0,13415.0,1,13420.0,19,B
2018-04-27 09:07:21,13415.0,2,9168,2,13410.0,24,13415.0,1,B
2018-04-27 09:07:21,13415.0,2,9170,2,13410.0,24,13420.0,19,B
2018-04-27 09:07:24,13415.0,2,9172,0,13415.0,1,13420.0,19,B
2018-04-27 09:07:33,13415.0,2,9174,2,13415.0,10,13420.0,19,B
2018-04-27 09:07:39,13420.0,2,9176,-2,13415.0,10,13420.0,16,B
2018-04-27 09:07:44,13420.0,2,9178,0,13415.0,14,13420.0,9,B
2018-04-27 09:07:47,13420.0,2,9180,0,13415.0,10,13420.0,10,B
2018-04-27 09:07:52,13415.0,8,9188,8,13415.0,6,13420.0,23,S
2018-04-27 09:07:52,13415.0,12,9200,12,13410.0,25,13420.0,23,S
2018-04-27 09:07:54,13410.0,8,9208,0,13410.0,5,13415.0,17,S
2018-04-27 09:07:55,13410.0,8,9216,6,13410.0,1,13415.0,17,S
2018-04-27 09:07:55,13410.0,2,9218,2,13405.0,8,13410.0,2,S
2018-04-27 09:07:56,13410.0,6,9224,0,13405.0,15,13410.0,2,S
2018-04-27 09:07:56,13410.0,4,9228,0,13405.0,20,13415.0,13,S
2018-04-27 09:08:04,13410.0,2,9230,2,13410.0,6,13415.0,15,S
2018-04-27 09:08:05,13410.0,2,9232,0,13410.0,2,13415.0,13,S
2018-04-27 09:08:06,13415.0,6,9238,-4,13415.0,1,13420.0,22,B
2018-04-27 09:08:10,13415.0,2,9240,2,13410.0,24,13420.0,22,B
2018-04-27 09:08:18,13415.0,2,9242,-2,13415.0,2,13420.0,22,B
2018-04-27 09:08:32,13420.0,4,9246,0,13415.0,7,13420.0,20,B
2018-04-27 09:08:32,13415.0,14,9260,6,13410.0,33,13420.0,20,S
2018-04-27 09:08:42,13410.0,30,9290,28,13410.0,4,13415.0,13,S
2018-04-27 09:08:43,13410.0,8,9298,6,13405.0,14,13410.0,12,S
2018-04-27 09:08:44,13400.0,30,9328,20,13400.0,5,13405.0,1,S
2018-04-27 09:08:44,13395.0,12,9340,2,13395.0,4,13405.0,42,S
2018-04-27 09:08:45,13395.0,8,9348,-4,13390.0,4,13395.0,1,S
2018-04-27 09:08:45,13390.0,22,9370,10,13385.0,8,13390.0,3,S
2018-04-27 09:08:46,13390.0,26,9396,2,13385.0,6,13390.0,7,S
2018-04-27 09:08:46,13390.0,24,9420,14,13385.0,11,13390.0,6,S
2018-04-27 09:08:47,13400.0,28,9448,18,13395.0,1,13400.0,16,B
2018-04-27 09:08:47,13400.0,12,9460,-6,13395.0,6,13400.0,1,B
2018-04-27 09:08:48,13395.0,12,9472,0,13395.0,8,13405.0,21,S
2018-04-27 09:08:49,13395.0,2,9474,2,13395.0,7,13400.0,1,S
2018-04-27 09:08:50,13395.0,2,9476,-2,13390.0,23,13400.0,11,S
2018-04-27 09:08:51,13395.0,4,9480,4,13390.0,22,13400.0,13,S
2018-04-27 09:08:53,13395.0,14,9494,6,13390.0,3,13395.0,25,S
2018-04-27 09:08:54,13390.0,6,9500,2,13385.0,6,13390.0,9,S
2018-04-27 09:08:54,13390.0,18,9518,18,13385.0,6,13395.0,21,S
2018-04-27 09:08:55,13390.0,4,9522,0,13390.0,2,13395.0,15,S
2018-04-27 09:08:57,13395.0,2,9524,2,13390.0,2,13395.0,15,B
2018-04-27 09:08:57,13395.0,2,9526,-2,13390.0,2,13395.0,14,B
2018-04-27 09:08:59,13395.0,24,9550,8,13395.0,1,13400.0,5,B
2018-04-27 09:09:00,13400.0,8,9558,-4,13395.0,2,13405.0,14,B
2018-04-27 09:09:03,13400.0,8,9566,-8,13395.0,5,13400.0,13,B
2018-04-27 09:09:04,13395.0,2,9568,0,13395.0,6,13400.0,12,S
2018-04-27 09:09:05,13395.0,10,9578,4,13395.0,4,13400.0,12,S
2018-04-27 09:09:07,13400.0,22,9600,0,13400.0,9,13405.0,17,B
2018-04-27 09:09:09,13405.0,18,9618,14,13405.0,8,13410.0,5,B
2018-04-27 09:09:12,13405.0,6,9624,0,13405.0,4,13410.0,5,B
2018-04-27 09:09:12,13405.0,8,9632,0,13400.0,18,13410.0,5,B
2018-04-27 09:09:15,13405.0,10,9642,-2,13400.0,15,13410.0,4,B
2018-04-27 09:09:20,13405.0,2,9644,-2,13400.0,16,13405.0,4,B
2018-04-27 09:09:21,13405.0,2,9646,0,13405.0,1,13410.0,14,B
2018-04-27 09:09:23,13410.0,20,9666,-4,13405.0,5,13410.0,3,B
2018-04-27 09:09:24,13410.0,6,9672,0,13410.0,13,13415.0,2,B
2018-04-27 09:09:32,13415.0,2,9674,-2,13415.0,2,13420.0,32,B
2018-04-27 09:09:33,13415.0,4,9678,0,13410.0,17,13415.0,2,B
2018-04-27 09:09:34,13415.0,2,9680,2,13410.0,16,13420.0,33,B
2018-04-27 09:09:36,13420.0,20,9700,20,13415.0,15,13420.0,21,B
2018-04-27 09:09:38,13415.0,2,9702,2,13415.0,5,13420.0,25,S
2018-04-27 09:09:39,13415.0,2,9704,0,13415.0,4,13420.0,25,S
2018-04-27 09:09:42,13420.0,4,9708,2,13415.0,16,13420.0,19,B
2018-04-27 09:09:43,13420.0,38,9746,32,13415.0,16,13425.0,10,B
2018-04-27 09:09:43,13420.0,2,9748,2,13420.0,16,13425.0,6,B
2018-04-27 09:09:44,13425.0,4,9752,-4,13420.0,20,13430.0,5,B
2018-04-27 09:09:45,13425.0,44,9796,-14,13420.0,22,13425.0,28,B
2018-04-27 09:09:46,13425.0,56,9852,-18,13425.0,5,13430.0,6,B
2018-04-27 09:09:46,13425.0,22,9874,-6,13420.0,14,13430.0,3,B
2018-04-27 09:09:47,13425.0,4,9878,4,13420.0,13,13425.0,1,B
2018-04-27 09:09:48,13420.0,16,9894,-2,13415.0,16,13420.0,1,S
2018-04-27 09:09:50,13420.0,2,9896,-2,13415.0,12,13425.0,13,S
2018-04-27 09:09:59,13420.0,4,9900,-4,13415.0,13,13425.0,11,S
2018-04-27 09:10:00,13420.0,2,9902,0,13420.0,1,13425.0,11,S
2018-04-27 09:10:01,13425.0,10,9912,2,13420.0,18,13430.0,9,B
2018-04-27 09:10:03,13425.0,2,9914,0,13420.0,8,13425.0,3,B
2018-04-27 09:10:07,13420.0,2,9916,0,13420.0,6,13425.0,4,S
2018-04-27 09:10:13,13420.0,2,9918,2,13420.0,5,13425.0,7,S
2018-04-27 09:10:13,13420.0,4,9922,2,13420.0,3,13425.0,8,S
2018-04-27 09:10:18,13420.0,2,9924,-2,13420.0,2,13425.0,8,S
2018-04-27 09:10:21,13420.0,2,9926,0,13420.0,4,13425.0,4,S
2018-04-27 09:10:27,13420.0,4,9930,0,13420.0,5,13425.0,8,S
2018-04-27 09:10:28,13420.0,10,9940,-10,13415.0,11,13425.0,8,S
2018-04-27 09:10:29,13415.0,10,9950,-6,13410.0,12,13420.0,12,S
2018-04-27 09:10:32,13415.0,2,9952,-2,13415.0,1,13420.0,19,S
2018-04-27 09:10:40,13415.0,2,9954,2,13410.0,16,13420.0,17,S
2018-04-27 09:10:51,13415.0,4,9958,2,13410.0,16,13415.0,28,S
2018-04-27 09:10:52,13415.0,4,9962,2,13410.0,14,13415.0,26,S
2018-04-27 09:10:52,13415.0,2,9964,2,13410.0,14,13415.0,25,S
2018-04-27 09:10:59,13415.0,2,9966,2,13410.0,11,13415.0,24,S
2018-04-27 09:11:03,13410.0,24,9990,-10,13405.0,25,13410.0,3,S
2018-04-27 09:11:08,13410.0,2,9992,0,13405.0,46,13410.0,9,S
2018-04-27 09:11:09,13405.0,2,9994,-2,13405.0,45,13410.0,9,S
2018-04-27 09:11:11,13410.0,2,9996,0,13405.0,85,13410.0,6,B
2018-04-27 09:11:24,13410.0,10,10006,0,13405.0,86,13415.0,30,B
2018-04-27 09:11:24,13410.0,2,10008,-2,13405.0,86,13415.0,32,B
2018-04-27 09:11:37,13410.0,4,10012,-2,13405.0,96,13410.0,1,B
2018-04-27 09:11:37,13410.0,2,10014,0,13410.0,1,13415.0,34,B
2018-04-27 09:11:38,13410.0,4,10018,0,13405.0,96,13415.0,34,B
2018-04-27 09:11:46,13410.0,2,10020,-2,13405.0,71,13410.0,8,B
2018-04-27 09:11:47,13405.0,2,10022,2,13405.0,70,13410.0,8,S
2018-04-27 09:11:53,13410.0,18,10040,-4,13410.0,6,13415.0,44,B
2018-04-27 09:12:03,13410.0,6,10046,-6,13410.0,3,13415.0,30,B
2018-04-27 09:12:04,13410.0,6,10052,4,13405.0,52,13410.0,6,B
2018-04-27 09:12:06,13410.0,2,10054,0,13410.0,1,13415.0,30,B
2018-04-27 09:12:07,13410.0,2,10056,-2,13405.0,54,13415.0,30,B
2018-04-27 09:12:08,13410.0,4,10060,0,13405.0,54,13410.0,2,B
2018-04-27 09:12:08,13410.0,4,10064,2,13405.0,54,13415.0,30,B
2018-04-27 09:12:15,13410.0,4,10068,0,13410.0,3,13415.0,42,B
2018-04-27 09:12:16,13410.0,6,10074,0,13405.0,52,13415.0,30,B
2018-04-27 09:12:21,13405.0,102,10176,50,13400.0,19,13405.0,9,S
2018-04-27 09:12:26,13405.0,10,10186,0,13405.0,1,13410.0,13,S
2018-04-27 09:12:35,13405.0,2,10188,2,13405.0,5,13410.0,8,S
2018-04-27 09:12:37,13410.0,2,10190,-2,13405.0,5,13410.0,6,B
2018-04-27 09:12:53,13405.0,4,10194,0,13405.0,2,13410.0,8,S
2018-04-27 09:13:00,13410.0,2,10196,0,13405.0,2,13410.0,7,B
2018-04-27 09:13:11,13410.0,2,10198,-2,13405.0,9,13410.0,3,B
2018-04-27 09:13:11,13410.0,6,10204,-6,13405.0,13,13415.0,31,B
2018-04-27 09:13:15,13405.0,2,10206,0,13405.0,28,13415.0,31,S
2018-04-27 09:13:29,13410.0,8,10214,0,13405.0,28,13410.0,2,B
2018-04-27 09:13:29,13410.0,4,10218,0,13410.0,2,13415.0,31,B
2018-04-27 09:13:36,13410.0,14,10232,6,13410.0,5,13415.0,43,B
2018-04-27 09:13:36,13410.0,10,10242,6,13405.0,8,13410.0,7,B
2018-04-27 09:13:38,13405.0,16,10258,-10,13400.0,33,13410.0,6,S
2018-04-27 09:13:46,13405.0,8,10266,4,13405.0,3,13410.0,32,S
2018-04-27 09:13:52,13405.0,2,10268,-2,13405.0,5,13410.0,10,S
2018-04-27 09:13:57,13405.0,18,10286,8,13400.0,21,13405.0,4,S
2018-04-27 09:13:59,13400.0,38,10324,0,13395.0,2,13400.0,1,S
2018-04-27 09:14:00,13395.0,4,10328,0,13390.0,6,13395.0,10,S
2018-04-27 09:14:01,13395.0,2,10330,0,13390.0,5,13395.0,13,S
2018-04-27 09:14:02,13395.0,22,10352,-14,13395.0,8,13400.0,12,S
2018-04-27 09:14:13,13395.0,6,10358,-6,13395.0,6,13400.0,10,S
2018-04-27 09:14:17,13395.0,22,10380,-12,13390.0,52,13395.0,29,S
2018-04-27 09:14:17,13395.0,24,10404,0,13390.0,54,13395.0,17,S
2018-04-27 09:14:18,13395.0,34,10438,-28,13395.0,7,13400.0,8,S
2018-04-27 09:14:19,13395.0,12,10450,10,13390.0,57,13395.0,12,S
2018-04-27 09:14:21,13395.0,6,10456,2,13390.0,45,13395.0,11,S
2018-04-27 09:14:22,13395.0,2,10458,2,13390.0,45,13395.0,10,S
2018-04-27 09:14:23,13395.0,20,10478,-4,13390.0,44,13395.0,1,S
2018-04-27 09:14:23,13390.0,4,10482,0,13390.0,38,13395.0,11,S
2018-04-27 09:14:24,13390.0,4,10486,0,13390.0,36,13395.0,10,S
2018-04-27 09:14:27,13395.0,2,10488,0,13390.0,33,13395.0,5,B
2018-04-27 09:14:28,13390.0,2,10490,2,13390.0,32,13400.0,23,S
2018-04-27 09:14:31,13395.0,2,10492,0,13395.0,6,13400.0,18,B
2018-04-27 09:14:32,13395.0,8,10500,0,13395.0,8,13400.0,5,B
2018-04-27 09:14:32,13400.0,10,10510,10,13400.0,1,13405.0,27,B
2018-04-27 09:14:39,13400.0,2,10512,-2,13395.0,11,13400.0,8,B
2018-04-27 09:14:42,13400.0,2,10514,-2,13395.0,22,13400.0,9,B
2018-04-27 09:14:47,13400.0,2,10516,-2,13395.0,17,13400.0,18,B
2018-04-27 09:14:50,13400.0,2,10518,-2,13395.0,22,13400.0,3,B
2018-04-27 09:14:50,13400.0,2,10520,0,13395.0,22,13400.0,14,B
2018-04-27 09:14:51,13395.0,2,10522,0,13395.0,21,13400.0,15,S
2018-04-27 09:14:53,13400.0,8,10530,6,13395.0,21,13400.0,9,B
2018-04-27 09:14:55,13395.0,2,10532,0,13395.0,15,13400.0,15,S
2018-04-27 09:14:56,13395.0,30,10562,10,13390.0,37,13395.0,6,S
2018-04-27 09:14:58,13395.0,12,10574,12,13390.0,37,13395.0,2,S
2018-04-27 09:14:58,13395.0,6,10580,2,13390.0,37,13400.0,16,S
2018-04-27 09:15:01,13400.0,2,10582,0,13395.0,12,13400.0,3,B
2018-04-27 09:15:02,13400.0,4,10586,0,13395.0,12,13405.0,19,B
2018-04-27 09:15:04,13405.0,2,10588,0,13400.0,19,13405.0,7,B
2018-04-27 09:15:32,13400.0,40,10628,18,13395.0,7,13400.0,2,S
2018-04-27 09:15:33,13395.0,8,10636,-6,13390.0,15,13400.0,12,S
2018-04-27 09:15:35,13395.0,4,10640,0,13395.0,2,13400.0,8,S
2018-04-27 09:15:41,13395.0,4,10644,0,13390.0,26,13395.0,5,S
2018-04-27 09:15:42,13390.0,18,10662,12,13385.0,7,13395.0,20,S
2018-04-27 09:15:44,13390.0,2,10664,0,13385.0,39,13395.0,18,S
2018-04-27 09:15:48,13390.0,2,10666,0,13390.0,1,13395.0,17,S
2018-04-27 09:15:51,13390.0,2,10668,0,13390.0,10,13395.0,15,S
2018-04-27 09:15:57,13395.0,2,10670,2,13390.0,11,13395.0,13,B
2018-04-27 09:16:02,13390.0,20,10690,16,13385.0,21,13390.0,1,S
2018-04-27 09:16:04,13385.0,6,10696,-4,13380.0,17,13390.0,31,S
2018-04-27 09:16:07,13385.0,4,10700,0,13385.0,3,13390.0,24,S
2018-04-27 09:16:09,13385.0,2,10702,0,13385.0,4,13390.0,14,S
2018-04-27 09:16:16,13390.0,18,10720,6,13385.0,22,13395.0,10,B
2018-04-27 09:16:25,13395.0,8,10728,-8,13395.0,9,13400.0,15,B
2018-04-27 09:16:27,13395.0,2,10730,-2,13395.0,6,13400.0,21,B
2018-04-27 09:16:40,13395.0,12,10742,6,13390.0,16,13395.0,5,B
2018-04-27 09:16:44,13395.0,4,10746,4,13390.0,14,13395.0,9,B
2018-04-27 09:16:47,13395.0,8,10754,0,13390.0,24,13395.0,1,B
2018-04-27 09:16:50,13390.0,4,10758,-4,13390.0,12,13395.0,26,S
2018-04-27 09:16:50,13390.0,22,10780,12,13385.0,13,13395.0,26,S
2018-04-27 09:16:52,13390.0,24,10804,-8,13390.0,1,13395.0,12,S
2018-04-27 09:16:58,13385.0,2,10806,-2,13385.0,16,13390.0,3,S
2018-04-27 09:17:03,13390.0,2,10808,-2,13385.0,12,13390.0,3,B
2018-04-27 09:17:05,13385.0,18,10826,2,13380.0,28,13390.0,10,S
2018-04-27 09:17:06,13385.0,2,10828,0,13380.0,24,13385.0,9,S
2018-04-27 09:17:07,13380.0,38,10866,22,13375.0,6,13380.0,1,S
2018-04-27 09:17:08,13375.0,12,10878,6,13370.0,35,13375.0,4,S
2018-04-27 09:17:08,13370.0,2,10880,0,13370.0,34,13375.0,13,S
2018-04-27 09:17:09,13375.0,24,10904,20,13375.0,45,13380.0,51,B
2018-04-27 09:17:09,13375.0,36,10940,10,13375.0,31,13380.0,21,B
2018-04-27 09:17:10,13380.0,32,10972,14,13380.0,1,13385.0,20,B
2018-04-27 09:17:10,13375.0,24,10996,20,13375.0,32,13380.0,1,S
2018-04-27 09:17:11,13370.0,46,11042,26,13370.0,32,13375.0,6,S
2018-04-27 09:17:11,13375.0,4,11046,0,13370.0,37,13375.0,1,B
2018-04-27 09:17:12,13375.0,2,11048,-2,13375.0,2,13380.0,33,B
2018-04-27 09:17:13,13380.0,12,11060,12,13375.0,15,13385.0,27,B
2018-04-27 09:17:17,13380.0,2,11062,2,13375.0,7,13380.0,17,B
2018-04-27 09:17:18,13380.0,2,11064,0,13375.0,11,13380.0,10,B
2018-04-27 09:17:19,13380.0,12,11076,-4,13375.0,13,13385.0,33,B
2018-04-27 09:17:21,13380.0,10,11086,0,13380.0,11,13385.0,10,B
2018-04-27 09:17:26,13385.0,4,11090,4,13380.0,11,13385.0,8,B
2018-04-27 09:17:30,13385.0,2,11092,2,13380.0,11,13385.0,10,B
2018-04-27 09:17:33,13380.0,22,11114,14,13375.0,19,13380.0,4,S
2018-04-27 09:17:34,13380.0,8,11122,2,13380.0,3,13385.0,10,S
2018-04-27 09:17:37,13385.0,8,11130,0,13380.0,29,13390.0,6,B
2018-04-27 09:17:40,13390.0,4,11134,0,13385.0,3,13390.0,3,B
2018-04-27 09:17:42,13390.0,2,11136,-2,13385.0,13,13395.0,8,B
2018-04-27 09:17:44,13395.0,4,11140,0,13390.0,18,13400.0,11,B
2018-04-27 09:17:55,13395.0,4,11144,0,13395.0,1,13400.0,16,B
2018-04-27 09:17:56,13395.0,2,11146,0,13390.0,28,13400.0,16,B
2018-04-27 09:18:06,13400.0,4,11150,4,13395.0,19,13400.0,9,B
2018-04-27 09:18:07,13400.0,4,11154,4,13395.0,19,13400.0,7,B
2018-04-27 09:18:07,13400.0,4,11158,4,13395.0,19,13400.0,5,B
2018-04-27 09:18:09,13400.0,10,11168,10,13400.0,5,13405.0,18,B
2018-04-27 09:18:22,13405.0,36,11204,-4,13405.0,1,13410.0,29,B
2018-04-27 09:18:23,13410.0,6,11210,-2,13405.0,15,13410.0,1,B
2018-04-27 09:18:23,13400.0,40,11250,12,13400.0,12,13405.0,8,S
2018-04-27 09:18:25,13400.0,2,11252,2,13400.0,3,13405.0,9,S
2018-04-27 09:18:44,13400.0,20,11272,6,13395.0,13,13400.0,1,S
2018-04-27 09:18:45,13395.0,4,11276,-2,13395.0,3,13400.0,17,S
2018-04-27 09:18:46,13395.0,2,11278,-2,13390.0,37,13400.0,17,S
2018-04-27 09:18:49,13395.0,20,11298,18,13390.0,24,13395.0,5,S
2018-04-27 09:18:55,13395.0,2,11300,0,13390.0,29,13400.0,29,S
2018-04-27 09:18:58,13395.0,2,11302,-2,13390.0,31,13400.0,29,S
2018-04-27 09:19:08,13395.0,2,11304,0,13390.0,30,13395.0,1,S
2018-04-27 09:19:11,13395.0,2,11306,0,13395.0,2,13400.0,29,S
2018-04-27 09:19:17,13395.0,4,11310,2,13395.0,24,13400.0,4,S
2018-04-27 09:19:20,13400.0,4,11314,-4,13395.0,24,13400.0,3,B
2018-04-27 09:19:27,13400.0,8,11322,-4,13400.0,5,13405.0,10,B
2018-04-27 09:19:27,13400.0,2,11324,0,13400.0,21,13405.0,10,B
2018-04-27 09:19:30,13405.0,4,11328,-4,13400.0,20,13405.0,22,B
2018-04-27 09:19:33,13400.0,2,11330,0,13400.0,19,13405.0,10,S
2018-04-27 09:19:43,13405.0,4,11334,4,13400.0,24,13410.0,8,B
2018-04-27 09:19:51,13405.0,4,11338,4,13400.0,104,13410.0,10,B
2018-04-27 09:19:52,13405.0,2,11340,2,13400.0,106,13405.0,1,B
2018-04-27 09:19:55,13405.0,12,11352,2,13400.0,102,13410.0,11,B
2018-04-27 09:19:59,13405.0,4,11356,0,13400.0,103,13410.0,14,B
2018-04-27 09:20:00,13400.0,2,11358,0,13400.0,104,13405.0,1,S
2018-04-27 09:20:05,13405.0,26,11384,-12,13400.0,94,13405.0,2,B
2018-04-27 09:20:08,13400.0,4,11388,4,13400.0,98,13405.0,1,S
2018-04-27 09:20:10,13400.0,2,11390,2,13400.0,97,13405.0,1,S
2018-04-27 09:20:11,13400.0,10,11400,10,13400.0,92,13405.0,1,S
2018-04-27 09:20:12,13405.0,2,11402,-2,13400.0,92,13410.0,42,B
2018-04-27 09:20:19,13405.0,26,11428,-8,13405.0,1,13410.0,30,B
2018-04-27 09:20:20,13405.0,4,11432,2,13405.0,23,13410.0,5,B
2018-04-27 09:20:20,13405.0,2,11434,0,13405.0,14,13410.0,5,B
2018-04-27 09:20:22,13405.0,2,11436,2,13405.0,15,13410.0,5,B
2018-04-27 09:20:26,13405.0,2,11438,-2,13405.0,14,13410.0,9,B
2018-04-27 09:20:30,13405.0,2,11440,-2,13405.0,13,13410.0,9,B
2018-04-27 09:20:31,13410.0,2,11442,2,13405.0,15,13410.0,7,B
2018-04-27 09:20:31,13410.0,2,11444,0,13405.0,15,13410.0,1,B
2018-04-27 09:20:35,13410.0,8,11452,4,13410.0,1,13415.0,35,B
2018-04-27 09:20:38,13410.0,20,11472,16,13405.0,16,13410.0,1,B
2018-04-27 09:20:38,13410.0,2,11474,2,13405.0,18,13415.0,31,B
2018-04-27 09:20:44,13405.0,2,11476,2,13405.0,17,13415.0,38,S
2018-04-27 09:20:49,13410.0,20,11496,8,13410.0,4,13415.0,27,B
2018-04-27 09:20:52,13410.0,4,11500,4,13405.0,27,13410.0,8,B
2018-04-27 09:20:53,13410.0,22,11522,12,13410.0,1,13415.0,27,B
2018-04-27 09:20:57,13410.0,6,11528,2,13405.0,15,13410.0,7,B
2018-04-27 09:20:58,13410.0,14,11542,2,13405.0,15,13415.0,27,B
2018-04-27 09:21:02,13410.0,8,11550,0,13405.0,14,13410.0,4,B
2018-04-27 09:21:02,13410.0,4,11554,0,13405.0,14,13415.0,35,B
2018-04-27 09:21:11,13410.0,2,11556,-2,13410.0,14,13415.0,26,B
2018-04-27 09:21:14,13415.0,6,11562,0,13410.0,7,13415.0,22,B
2018-04-27 09:21:38,13415.0,44,11606,44,13415.0,1,13420.0,6,B
2018-04-27 09:21:38,13415.0,2,11608,0,13415.0,9,13420.0,6,B
2018-04-27 09:21:59,13415.0,8,11616,4,13410.0,16,13415.0,1,B
2018-04-27 09:22:14,13415.0,20,11636,0,13410.0,14,13415.0,5,B
2018-04-27 09:22:33,13410.0,2,11638,2,13410.0,14,13415.0,7,S
2018-04-27 09:22:39,13410.0,4,11642,0,13410.0,12,13415.0,7,S
2018-04-27 09:22:46,13415.0,14,11656,0,13415.0,3,13420.0,16,B
2018-04-27 09:22:47,13415.0,10,11666,4,13415.0,19,13420.0,8,B
2018-04-27 09:22:48,13415.0,2,11668,-2,13415.0,18,13420.0,8,B
2018-04-27 09:22:50,13420.0,12,11680,-6,13420.0,1,13425.0,7,B
2018-04-27 09:22:55,13420.0,2,11682,-2,13420.0,13,13425.0,7,B
2018-04-27 09:22:57,13420.0,2,11684,-2,13420.0,12,13425.0,7,B
2018-04-27 09:22:58,13425.0,14,11698,2,13425.0,33,13430.0,20,B
2018-04-27 09:23:01,13425.0,2,11700,2,13425.0,32,13430.0,25,B
2018-04-27 09:23:02,13420.0,66,11766,64,13420.0,11,13425.0,2,S
2018-04-27 09:23:15,13430.0,48,11814,24,13430.0,1,13435.0,8,B
2018-04-27 09:23:16,13430.0,4,11818,0,13425.0,22,13435.0,8,B
2018-04-27 09:23:16,13435.0,16,11834,-2,13430.0,13,13440.0,7,B
2018-04-27 09:23:21,13430.0,4,11838,0,13430.0,9,13435.0,10,S
2018-04-27 09:23:22,13430.0,4,11842,4,13430.0,6,13435.0,13,S
2018-04-27 09:23:25,13430.0,2,11844,0,13430.0,2,13435.0,13,S
2018-04-27 09:23:28,13430.0,2,11846,0,13430.0,1,13435.0,14,S
2018-04-27 09:23:31,13430.0,20,11866,0,13430.0,2,13435.0,8,S
2018-04-27 09:23:34,13430.0,12,11878,10,13425.0,18,13430.0,5,S
2018-04-27 09:23:34,13435.0,20,11898,-4,13430.0,1,13435.0,7,B
2018-04-27 09:23:35,13435.0,2,11900,-2,13430.0,10,13435.0,6,B
2018-04-27 09:23:38,13430.0,20,11920,2,13430.0,5,13435.0,6,S
2018-04-27 09:23:38,13430.0,2,11922,0,13425.0,16,13435.0,6,S
2018-04-27 09:23:42,13430.0,2,11924,0,13425.0,15,13430.0,15,S
2018-04-27 09:23:50,13425.0,10,11934,8,13425.0,9,13430.0,15,S
2018-04-27 09:23:50,13425.0,18,11952,8,13420.0,7,13425.0,6,S
2018-04-27 09:24:14,13425.0,2,11954,-2,13420.0,16,13425.0,3,S
2018-04-27 09:24:14,13425.0,2,11956,0,13420.0,16,13425.0,2,S
2018-04-27 09:24:26,13420.0,2,11958,0,13420.0,14,13425.0,8,S
2018-04-27 09:24:33,13420.0,2,11960,0,13420.0,13,13425.0,8,S
2018-04-27 09:24:38,13420.0,2,11962,0,13420.0,12,13425.0,8,S
2018-04-27 09:24:42,13425.0,6,11968,-6,13420.0,15,13430.0,36,B
2018-04-27 09:24:52,13425.0,2,11970,-2,13420.0,14,13430.0,25,B
2018-04-27 09:25:25,13420.0,4,11974,-4,13420.0,3,13425.0,7,S
2018-04-27 09:25:31,13425.0,4,11978,0,13420.0,15,13430.0,35,B
2018-04-27 09:25:51,13425.0,6,11984,0,13420.0,15,13425.0,18,B
2018-04-27 09:25:51,13425.0,6,11990,-6,13420.0,17,13425.0,15,B
2018-04-27 09:25:52,13425.0,6,11996,0,13420.0,17,13425.0,12,B
2018-04-27 09:26:06,13425.0,28,12024,-8,13420.0,18,13430.0,28,B
2018-04-27 09:26:10,13430.0,2,12026,2,13420.0,18,13430.0,29,B
2018-04-27 09:26:13,13430.0,4,12030,0,13425.0,17,13430.0,22,B
2018-04-27 09:26:14,13430.0,44,12074,38,13430.0,3,13435.0,6,B
2018-04-27 09:26:27,13430.0,28,12102,-14,13425.0,11,13430.0,8,B
2018-04-27 09:26:42,13425.0,2,12104,-2,13425.0,8,13430.0,7,S
2018-04-27 09:26:47,13425.0,4,12108,-4,13425.0,6,13430.0,7,S
2018-04-27 09:26:49,13430.0,2,12110,2,13425.0,6,13430.0,6,B
2018-04-27 09:26:54,13425.0,16,12126,6,13420.0,12,13425.0,2,S
2018-04-27 09:26:55,13425.0,4,12130,4,13420.0,7,13425.0,4,S
2018-04-27 09:26:55,13425.0,8,12138,-2,13420.0,7,13430.0,21,S
2018-04-27 09:26:58,13425.0,4,12142,0,13420.0,8,13425.0,8,S
2018-04-27 09:26:59,13425.0,16,12158,4,13420.0,6,13425.0,4,S
2018-04-27 09:27:06,13420.0,8,12166,4,13420.0,8,13425.0,4,S
2018-04-27 09:27:19,13420.0,4,12170,-2,13420.0,6,13425.0,31,S
2018-04-27 09:27:26,13425.0,4,12174,-4,13420.0,5,13425.0,30,B
2018-04-27 09:27:27,13425.0,4,12178,-4,13420.0,6,13425.0,28,B
2018-04-27 09:27:53,13420.0,2,12180,0,13420.0,17,13425.0,31,S
2018-04-27 09:27:59,13420.0,14,12194,8,13420.0,9,13425.0,31,S
2018-04-27 09:27:59,13420.0,18,12212,4,13415.0,14,13425.0,31,S
2018-04-27 09:28:12,13415.0,4,12216,2,13415.0,11,13425.0,30,S
2018-04-27 09:28:14,13420.0,4,12220,2,13420.0,1,13425.0,30,B
2018-04-27 09:28:15,13420.0,2,12222,0,13415.0,11,13420.0,3,B
2018-04-27 09:28:18,13415.0,16,12238,-2,13410.0,23,13415.0,1,S
2018-04-27 09:28:19,13415.0,2,12240,-2,13410.0,6,13415.0,11,S
2018-04-27 09:28:49,13415.0,30,12270,-16,13410.0,10,13420.0,9,S
2018-04-27 09:28:51,13425.0,14,12284,8,13420.0,1,13425.0,21,B
2018-04-27 09:28:51,13425.0,8,12292,0,13420.0,4,13425.0,17,B
2018-04-27 09:28:53,13420.0,8,12300,0,13415.0,11,13425.0,17,S
2018-04-27 09:28:58,13420.0,4,12304,0,13415.0,13,13425.0,22,S
2018-04-27 09:29:07,13420.0,2,12306,-2,13415.0,13,13425.0,22,S
2018-04-27 09:29:13,13415.0,4,12310,2,13415.0,12,13425.0,23,S
2018-04-27 09:29:14,13415.0,4,12314,0,13415.0,10,13425.0,23,S
2018-04-27 09:29:16,13415.0,4,12318,4,13415.0,8,13425.0,23,S
2018-04-27 09:29:17,13415.0,4,12322,4,13415.0,6,13420.0,1,S
2018-04-27 09:29:25,13420.0,10,12332,-10,13415.0,17,13425.0,24,B
2018-04-27 09:29:49,13415.0,2,12334,0,13415.0,15,13420.0,4,S
2018-04-27 09:29:51,13415.0,2,12336,0,13415.0,14,13420.0,4,S
2018-04-27 09:29:51,13415.0,2,12338,0,13415.0,13,13420.0,4,S
2018-04-27 09:29:52,13415.0,2,12340,0,13415.0,12,13420.0,4,S
2018-04-27 09:29:53,13415.0,2,12342,0,13415.0,11,13420.0,5,S
2018-04-27 09:30:01,13420.0,20,12362,-8,13415.0,11,13425.0,52,B
2018-04-27 09:30:02,13425.0,20,12382,20,13420.0,8,13425.0,21,B
2018-04-27 09:30:02,13420.0,8,12390,8,13420.0,4,13425.0,21,S
2018-04-27 09:30:05,13420.0,4,12394,4,13420.0,5,13425.0,21,S
2018-04-27 09:30:06,13420.0,4,12398,4,13420.0,3,13425.0,21,S
2018-04-27 09:30:10,13420.0,6,12404,0,13415.0,6,13420.0,6,S
2018-04-27 09:30:11,13415.0,12,12416,4,13410.0,10,13420.0,29,S
2018-04-27 09:30:14,13415.0,2,12418,-2,13410.0,8,13415.0,1,S
2018-04-27 09:30:16,13415.0,2,12420,-2,13410.0,8,13415.0,2,S
2018-04-27 09:30:23,13410.0,4,12424,4,13410.0,5,13415.0,7,S
2018-04-27 09:30:26,13410.0,8,12432,8,13410.0,14,13415.0,7,S
2018-04-27 09:30:28,13410.0,8,12440,4,13410.0,10,13415.0,7,S
2018-04-27 09:30:36,13410.0,4,12444,0,13410.0,8,13415.0,7,S
2018-04-27 09:30:41,13415.0,2,12446,0,13410.0,8,13415.0,6,B
2018-04-27 09:30:45,13415.0,4,12450,-2,13410.0,8,13415.0,5,B
2018-04-27 09:30:51,13410.0,2,12452,0,13405.0,16,13410.0,1,S
2018-04-27 09:30:53,13410.0,2,12454,2,13410.0,1,13415.0,12,S
2018-04-27 09:30:58,13410.0,4,12458,4,13405.0,16,13410.0,1,S
2018-04-27 09:31:02,13410.0,2,12460,2,13410.0,1,13415.0,11,S
2018-04-27 09:31:03,13410.0,2,12462,0,13405.0,16,13415.0,11,S
2018-04-27 09:31:09,13410.0,2,12464,2,13405.0,16,13415.0,14,S
2018-04-27 09:31:14,13405.0,4,12468,2,13405.0,14,13410.0,4,S
2018-04-27 09:31:30,13410.0,2,12470,0,13405.0,17,13410.0,5,B
2018-04-27 09:31:45,13410.0,2,12472,2,13405.0,19,13410.0,12,B
2018-04-27 09:31:46,13410.0,2,12474,2,13405.0,19,13410.0,11,B
2018-04-27 09:31:48,13410.0,12,12486,-10,13405.0,19,13410.0,5,B
2018-04-27 09:31:52,13410.0,2,12488,0,13405.0,20,13410.0,4,B
2018-04-27 09:32:06,13405.0,2,12490,-2,13405.0,24,13410.0,4,S
2018-04-27 09:32:12,13410.0,4,12494,-4,13405.0,21,13410.0,4,B
2018-04-27 09:32:26,13410.0,2,12496,0,13405.0,14,13410.0,14,B
2018-04-27 09:32:27,13405.0,14,12510,-2,13405.0,7,13410.0,18,S
2018-04-27 09:32:27,13405.0,14,12524,-6,13400.0,108,13405.0,1,S
2018-04-27 09:32:28,13400.0,12,12536,12,13400.0,102,13410.0,18,S
2018-04-27 09:32:34,13400.0,2,12538,0,13400.0,100,13405.0,17,S
2018-04-27 09:32:40,13400.0,2,12540,0,13400.0,99,13405.0,16,S
2018-04-27 09:32:54,13400.0,4,12544,2,13400.0,98,13405.0,15,S
2018-04-27 09:32:55,13400.0,22,12566,18,13400.0,97,13405.0,18,S
2018-04-27 09:32:56,13400.0,4,12570,0,13400.0,95,13405.0,18,S
2018-04-27 09:32:58,13405.0,34,12604,4,13400.0,100,13405.0,2,B
2018-04-27 09:33:04,13405.0,8,12612,0,13405.0,7,13410.0,13,B
2018-04-27 09:33:14,13405.0,2,12614,-2,13405.0,8,13410.0,12,B
2018-04-27 09:33:30,13405.0,2,12616,0,13405.0,8,13410.0,23,B
2018-04-27 09:34:03,13405.0,2,12618,2,13405.0,8,13410.0,23,B
2018-04-27 09:34:05,13410.0,10,12628,6,13405.0,12,13410.0,11,B
2018-04-27 09:34:05,13410.0,22,12650,-10,13410.0,4,13415.0,5,B
2018-04-27 09:34:14,13410.0,2,12652,0,13410.0,13,13415.0,7,B
2018-04-27 09:34:14,13410.0,10,12662,-2,13410.0,5,13415.0,24,B
2018-04-27 09:34:15,13410.0,10,12672,0,13405.0,11,13410.0,1,B
2018-04-27 09:34:33,13405.0,2,12674,0,13405.0,10,13410.0,6,S
2018-04-27 09:34:35,13410.0,8,12682,2,13405.0,10,13410.0,2,B
2018-04-27 09:34:36,13410.0,6,12688,2,13410.0,7,13415.0,40,B
2018-04-27 09:34:36,13410.0,14,12702,12,13405.0,10,13410.0,1,B
2018-04-27 09:34:37,13410.0,4,12706,0,13405.0,10,13415.0,40,B
2018-04-27 09:34:45,13410.0,10,12716,-10,13405.0,10,13415.0,25,B
2018-04-27 09:35:16,13405.0,6,12722,-4,13405.0,1,13410.0,13,S
2018-04-27 09:35:16,13405.0,2,12724,-2,13400.0,102,13405.0,10,S
2018-04-27 09:35:38,13405.0,34,12758,10,13400.0,100,13405.0,2,S
2018-04-27 09:35:39,13405.0,4,12762,-4,13405.0,2,13410.0,39,S
2018-04-27 09:35:49,13405.0,12,12774,0,13400.0,102,13405.0,2,S
2018-04-27 09:36:08,13400.0,6,12780,0,13400.0,92,13405.0,34,S
2018-04-27 09:36:08,13400.0,4,12784,0,13400.0,90,13405.0,19,S
2018-04-27 09:36:10,13400.0,2,12786,2,13400.0,89,13405.0,19,S
2018-04-27 09:36:22,13400.0,2,12788,0,13400.0,94,13405.0,17,S
2018-04-27 09:36:39,13405.0,22,12810,-18,13405.0,3,13410.0,16,B
2018-04-27 09:36:40,13410.0,6,12816,-6,13405.0,17,13410.0,5,B
2018-04-27 09:36:41,13410.0,8,12824,0,13405.0,17,13410.0,1,B
2018-04-27 09:36:44,13410.0,4,12828,-4,13410.0,3,13415.0,11,B
2018-04-27 09:36:45,13410.0,6,12834,0,13410.0,1,13415.0,18,B
2018-04-27 09:36:45,13410.0,2,12836,0,13405.0,16,13415.0,20,B
2018-04-27 09:37:47,13410.0,2,12838,0,13405.0,13,13410.0,21,B
2018-04-27 09:39:37,13405.0,6,12844,6,13405.0,6,13410.0,26,S
2018-04-27 09:39:38,13405.0,12,12856,12,13400.0,98,13405.0,1,S
2018-04-27 09:39:57,13405.0,4,12860,-4,13400.0,95,13405.0,8,S
2018-04-27 09:39:58,13405.0,6,12866,-6,13400.0,95,13405.0,5,S
2018-04-27 09:40:19,13400.0,10,12876,10,13400.0,90,13405.0,37,S
2018-04-27 09:40:19,13400.0,10,12886,10,13400.0,85,13405.0,22,S
2018-04-27 09:40:20,13400.0,2,12888,0,13400.0,84,13405.0,22,S
2018-04-27 09:40:26,13405.0,16,12904,-14,13400.0,86,13410.0,12,B
2018-04-27 09:40:27,13405.0,2,12906,0,13400.0,87,13410.0,20,B
2018-04-27 09:40:28,13410.0,2,12908,2,13405.0,4,13410.0,26,B
2018-04-27 09:40:41,13405.0,4,12912,2,13405.0,1,13410.0,26,S
2018-04-27 09:40:49,13410.0,8,12920,8,13405.0,11,13410.0,8,B
2018-04-27 09:40:50,13410.0,2,12922,0,13405.0,10,13410.0,2,B
2018-04-27 09:40:52,13410.0,8,12930,0,13405.0,11,13415.0,8,B
2018-04-27 09:40:55,13410.0,2,12932,2,13405.0,11,13415.0,20,B
2018-04-27 09:41:21,13405.0,12,12944,2,13405.0,5,13410.0,18,S
2018-04-27 09:41:22,13405.0,10,12954,6,13405.0,1,13410.0,23,S
2018-04-27 09:41:46,13405.0,8,12962,4,13400.0,85,13405.0,7,S
2018-04-27 09:41:46,13405.0,8,12970,-4,13400.0,87,13405.0,3,S
2018-04-27 09:41:48,13405.0,6,12976,-6,13405.0,3,13410.0,21,S
2018-04-27 09:41:55,13405.0,2,12978,0,13405.0,1,13410.0,21,S
2018-04-27 09:42:16,13410.0,2,12980,0,13405.0,3,13410.0,20,B
2018-04-27 09:42:41,13405.0,8,12988,4,13400.0,89,13405.0,1,S
2018-04-27 09:42:41,13405.0,2,12990,0,13405.0,1,13410.0,16,S
2018-04-27 09:42:53,13405.0,4,12994,4,13405.0,1,13410.0,15,S
2018-04-27 09:43:56,13405.0,6,13000,-4,13405.0,9,13410.0,16,S
2018-04-27 09:44:07,13410.0,2,13002,0,13405.0,18,13410.0,4,B
2018-04-27 09:44:07,13410.0,8,13010,0,13410.0,1,13415.0,19,B
2018-04-27 09:45:27,13410.0,18,13028,18,13405.0,9,13410.0,13,B
2018-04-27 09:45:40,13410.0,12,13040,2,13405.0,18,13415.0,16,B
2018-04-27 09:45:45,13410.0,10,13050,10,13405.0,18,13415.0,19,B
2018-04-27 09:46:29,13410.0,2,13052,2,13405.0,14,13410.0,16,B
2018-04-27 09:46:36,13405.0,18,13070,-4,13400.0,75,13405.0,1,S
2018-04-27 09:46:37,13405.0,36,13106,2,13400.0,70,13405.0,1,S
2018-04-27 09:46:43,13405.0,4,13110,0,13400.0,70,13405.0,1,S
2018-04-27 09:46:44,13400.0,4,13114,4,13400.0,68,13405.0,27,S
2018-04-27 09:46:45,13400.0,14,13128,8,13400.0,61,13405.0,27,S
2018-04-27 09:46:45,13400.0,78,13206,44,13400.0,21,13405.0,27,S
2018-04-27 09:46:46,13400.0,42,13248,14,13395.0,11,13400.0,8,S
2018-04-27 09:46:49,13395.0,18,13266,-4,13390.0,8,13400.0,13,S
2018-04-27 09:46:50,13395.0,2,13268,0,13390.0,12,13400.0,16,S
2018-04-27 09:46:50,13395.0,2,13270,2,13390.0,9,13395.0,8,S
2018-04-27 09:47:00,13395.0,20,13290,-8,13395.0,3,13400.0,5,S
2018-04-27 09:47:01,13395.0,2,13292,0,13390.0,23,13400.0,11,S
2018-04-27 09:47:09,13395.0,2,13294,0,13390.0,29,13400.0,35,S
2018-04-27 09:47:16,13395.0,20,13314,0,13390.0,28,13400.0,19,S
2018-04-27 09:47:17,13390.0,38,13352,16,13390.0,8,13395.0,15,S
2018-04-27 09:47:17,13385.0,24,13376,-6,13385.0,2,13390.0,6,S
2018-04-27 09:47:18,13380.0,8,13384,-4,13380.0,8,13390.0,28,S
2018-04-27 09:47:19,13385.0,16,13400,0,13380.0,16,13390.0,27,B
2018-04-27 09:47:20,13390.0,20,13420,16,13380.0,19,13390.0,16,B
2018-04-27 09:47:25,13385.0,4,13424,0,13380.0,15,13390.0,15,S
2018-04-27 09:47:28,13385.0,2,13426,0,13385.0,3,13390.0,15,S
2018-04-27 09:47:29,13385.0,6,13432,2,13380.0,13,13385.0,1,S
2018-04-27 09:47:30,13385.0,6,13438,4,13385.0,2,13390.0,17,S
2018-04-27 09:47:30,13385.0,4,13442,0,13380.0,13,13385.0,5,S
2018-04-27 09:47:31,13380.0,26,13468,-18,13375.0,6,13380.0,27,S
2018-04-27 09:47:31,13380.0,54,13522,-20,13380.0,6,13385.0,3,S
2018-04-27 09:47:32,13385.0,2,13524,2,13380.0,9,13390.0,19,B
2018-04-27 09:47:34,13385.0,4,13528,0,13380.0,14,13390.0,20,B
2018-04-27 09:47:41,13385.0,2,13530,-2,13385.0,11,13390.0,14,B
2018-04-27 09:47:42,13390.0,6,13536,6,13385.0,14,13390.0,2,B
2018-04-27 09:47:42,13390.0,2,13538,0,13385.0,16,13390.0,2,B
2018-04-27 09:47:43,13390.0,4,13542,-2,13385.0,16,13395.0,9,B
2018-04-27 09:47:45,13390.0,14,13556,-4,13385.0,13,13395.0,10,B
2018-04-27 09:47:56,13390.0,2,13558,2,13390.0,16,13400.0,6,B
2018-04-27 09:48:04,13390.0,2,13560,0,13390.0,2,13395.0,6,B
2018-04-27 09:48:05,13390.0,4,13564,0,13385.0,14,13395.0,11,B
2018-04-27 09:48:09,13390.0,8,13572,4,13385.0,5,13395.0,14,B
2018-04-27 09:48:10,13395.0,2,13574,0,13385.0,5,13395.0,13,B
2018-04-27 09:48:15,13395.0,6,13580,6,13390.0,17,13400.0,11,B
2018-04-27 09:48:16,13400.0,2,13582,-2,13395.0,6,13400.0,11,B
2018-04-27 09:48:17,13400.0,4,13586,-4,13395.0,8,13405.0,2,B
2018-04-27 09:48:18,13400.0,6,13592,-6,13395.0,9,13405.0,13,B
2018-04-27 09:48:19,13395.0,14,13606,2,13390.0,10,13395.0,6,S
2018-04-27 09:48:22,13390.0,2,13608,0,13390.0,3,13395.0,7,S
2018-04-27 09:48:23,13390.0,2,13610,0,13385.0,12,13395.0,16,S
2018-04-27 09:48:26,13390.0,2,13612,0,13390.0,7,13395.0,7,S
2018-04-27 09:48:35,13395.0,2,13614,-2,13390.0,8,13395.0,7,B
2018-04-27 09:48:38,13395.0,2,13616,2,13395.0,2,13400.0,20,B
2018-04-27 09:48:41,13400.0,2,13618,-2,13395.0,13,13405.0,10,B
2018-04-27 09:48:52,13395.0,2,13620,0,13390.0,22,13400.0,14,S
2018-04-27 09:48:54,13395.0,2,13622,0,13395.0,1,13400.0,17,S
2018-04-27 09:48:54,13395.0,2,13624,-2,13395.0,1,13400.0,17,S
2018-04-27 09:48:58,13395.0,2,13626,2,13390.0,20,13400.0,17,S
2018-04-27 09:49:10,13395.0,2,13628,0,13395.0,9,13400.0,7,S
2018-04-27 09:49:21,13400.0,4,13632,2,13395.0,10,13405.0,10,B
2018-04-27 09:49:23,13405.0,6,13638,-2,13405.0,3,13410.0,12,B
2018-04-27 09:49:24,13405.0,2,13640,0,13405.0,11,13410.0,10,B
2018-04-27 09:49:26,13405.0,2,13642,0,13405.0,10,13410.0,9,B
2018-04-27 09:49:29,13405.0,12,13654,2,13400.0,9,13405.0,10,B
2018-04-27 09:50:28,13405.0,18,13672,8,13405.0,31,13410.0,25,B
2018-04-27 09:50:31,13405.0,14,13686,0,13405.0,24,13410.0,40,B
2018-04-27 09:50:32,13405.0,48,13734,16,13400.0,5,13405.0,1,B
2018-04-27 09:50:32,13400.0,2,13736,0,13400.0,1,13405.0,37,S
2018-04-27 09:50:33,13400.0,2,13738,-2,13395.0,13,13400.0,1,S
2018-04-27 09:50:33,13400.0,2,13740,0,13395.0,13,13405.0,21,S
2018-04-27 09:50:38,13400.0,6,13746,2,13395.0,13,13400.0,1,S
2018-04-27 09:50:47,13400.0,2,13748,-2,13395.0,16,13405.0,19,S
2018-04-27 09:51:15,13395.0,24,13772,-14,13390.0,11,13395.0,1,S
2018-04-27 09:51:15,13395.0,2,13774,0,13390.0,13,13395.0,7,S
2018-04-27 09:51:27,13395.0,18,13792,16,13395.0,1,13400.0,15,S
2018-04-27 09:51:28,13395.0,2,13794,2,13390.0,13,13400.0,18,S
2018-04-27 09:51:48,13400.0,2,13796,-2,13395.0,1,13400.0,11,B
2018-04-27 09:52:15,13395.0,12,13808,0,13390.0,18,13400.0,10,S
2018-04-27 09:52:18,13390.0,24,13832,0,13385.0,4,13395.0,13,S
2018-04-27 09:52:22,13390.0,2,13834,2,13385.0,3,13390.0,15,S
2018-04-27 09:52:36,13385.0,8,13842,-4,13380.0,9,13385.0,36,S
2018-04-27 09:52:37,13385.0,2,13844,-2,13380.0,9,13385.0,35,S
2018-04-27 09:52:37,13385.0,2,13846,0,13380.0,10,13385.0,34,S
2018-04-27 09:52:39,13385.0,8,13854,-8,13380.0,9,13385.0,30,S
2018-04-27 09:52:39,13385.0,2,13856,0,13380.0,9,13385.0,29,S
2018-04-27 09:52:44,13380.0,12,13868,2,13375.0,8,13385.0,35,S
2018-04-27 09:52:45,13380.0,2,13870,0,13375.0,6,13380.0,2,S
2018-04-27 09:52:46,13370.0,32,13902,10,13370.0,34,13375.0,1,S
2018-04-27 09:52:46,13365.0,76,13978,8,13365.0,1,13370.0,2,S
2018-04-27 09:52:47,13360.0,24,14002,-2,13360.0,8,13365.0,3,S
2018-04-27 09:52:47,13360.0,34,14036,2,13365.0,5,13370.0,4,S
2018-04-27 09:52:48,13365.0,12,14048,0,13365.0,8,13370.0,4,B
2018-04-27 09:52:48,13360.0,30,14078,0,13355.0,17,13365.0,15,S
2018-04-27 09:52:49,13360.0,2,14080,-2,13360.0,1,13365.0,16,S
2018-04-27 09:52:49,13360.0,2,14082,-2,13355.0,3,13360.0,1,S
2018-04-27 09:52:50,13360.0,2,14084,0,13355.0,2,13360.0,1,S
2018-04-27 09:52:50,13355.0,6,14090,0,13350.0,24,13365.0,9,S
2018-04-27 09:52:51,13355.0,4,14094,0,13355.0,11,13360.0,2,S
2018-04-27 09:52:51,13360.0,4,14098,4,13355.0,19,13365.0,4,B
2018-04-27 09:52:56,13360.0,4,14102,0,13355.0,13,13365.0,10,B
2018-04-27 09:52:58,13365.0,4,14106,4,13360.0,2,13365.0,7,B
2018-04-27 09:52:59,13365.0,14,14120,6,13365.0,1,13370.0,9,B
2018-04-27 09:53:00,13365.0,4,14124,2,13360.0,12,13370.0,6,B
2018-04-27 09:53:01,13365.0,4,14128,2,13360.0,5,13370.0,14,B
2018-04-27 09:53:04,13365.0,2,14130,-2,13360.0,4,13365.0,4,B
2018-04-27 09:53:06,13360.0,12,14142,2,13360.0,4,13365.0,2,S
2018-04-27 09:53:09,13360.0,12,14154,-4,13360.0,1,13365.0,3,S
2018-04-27 09:53:13,13365.0,4,14158,0,13360.0,14,13370.0,10,B
2018-04-27 09:53:21,13365.0,2,14160,-2,13360.0,16,13370.0,8,B
2018-04-27 09:53:24,13365.0,4,14164,0,13365.0,1,13370.0,8,B
2018-04-27 09:53:25,13370.0,4,14168,-2,13365.0,1,13370.0,7,B
2018-04-27 09:53:31,13370.0,2,14170,0,13370.0,2,13375.0,16,B
2018-04-27 09:53:32,13370.0,4,14174,-4,13365.0,9,13370.0,1,B
2018-04-27 09:53:34,13370.0,2,14176,0,13365.0,8,13375.0,17,B
2018-04-27 09:53:39,13370.0,2,14178,-2,13370.0,2,13375.0,13,B
2018-04-27 09:53:41,13370.0,2,14180,-2,13370.0,5,13375.0,4,B
2018-04-27 09:53:42,13370.0,8,14188,4,13365.0,26,13375.0,10,B
2018-04-27 09:53:43,13370.0,2,14190,0,13365.0,22,13370.0,1,B
2018-04-27 09:53:51,13370.0,2,14192,-2,13365.0,22,13370.0,1,B
2018-04-27 09:53:56,13365.0,6,14198,0,13365.0,13,13370.0,15,S
2018-04-27 09:54:00,13365.0,26,14224,10,13360.0,5,13365.0,1,S
2018-04-27 09:54:01,13360.0,4,14228,0,13360.0,2,13365.0,11,S
2018-04-27 09:54:02,13360.0,4,14232,2,13355.0,5,13360.0,3,S
2018-04-27 09:54:02,13355.0,8,14240,-2,13350.0,25,13355.0,3,S
2018-04-27 09:54:03,13350.0,14,14254,8,13350.0,18,13355.0,12,S
2018-04-27 09:54:03,13345.0,40,14294,10,13345.0,3,13350.0,10,S
2018-04-27 09:54:04,13350.0,26,14320,4,13350.0,1,13355.0,15,B
2018-04-27 09:54:04,13360.0,28,14348,20,13355.0,1,13360.0,15,B
2018-04-27 09:54:05,13360.0,36,14384,8,13355.0,3,13365.0,8,B
2018-04-27 09:54:05,13355.0,2,14386,2,13355.0,2,13360.0,3,S
2018-04-27 09:54:07,13360.0,6,14392,-2,13350.0,10,13360.0,17,B
2018-04-27 09:54:08,13350.0,10,14402,2,13345.0,6,13355.0,17,S
2018-04-27 09:54:10,13350.0,4,14406,0,13350.0,1,13355.0,18,S
2018-04-27 09:54:11,13345.0,2,14408,2,13345.0,9,13355.0,13,S
2018-04-27 09:54:14,13355.0,2,14410,0,13345.0,9,13355.0,12,B
2018-04-27 09:54:16,13350.0,2,14412,-2,13345.0,3,13350.0,9,S
2018-04-27 09:54:16,13345.0,2,14414,0,13345.0,2,13350.0,9,S
2018-04-27 09:54:19,13345.0,6,14420,2,13340.0,19,13350.0,14,S
2018-04-27 09:54:19,13350.0,2,14422,0,13345.0,1,13350.0,11,B
2018-04-27 09:54:21,13345.0,2,14424,0,13345.0,4,13350.0,13,S
2018-04-27 09:54:22,13345.0,4,14428,2,13345.0,1,13350.0,15,S
2018-04-27 09:54:22,13350.0,4,14432,4,13340.0,20,13350.0,13,B
2018-04-27 09:54:24,13340.0,38,14470,34,13335.0,7,13345.0,11,S
2018-04-27 09:54:24,13340.0,14,14484,-2,13335.0,1,13340.0,6,S
2018-04-27 09:54:25,13330.0,8,14492,6,13330.0,107,13340.0,7,S
2018-04-27 09:54:25,13340.0,12,14504,2,13335.0,8,13340.0,6,B
2018-04-27 09:54:26,13340.0,16,14520,4,13340.0,2,13345.0,15,B
2018-04-27 09:54:29,13340.0,8,14528,-4,13335.0,10,13345.0,12,B
2018-04-27 09:54:30,13340.0,2,14530,0,13335.0,11,13345.0,12,B
2018-04-27 09:54:32,13340.0,10,14540,-6,13335.0,6,13340.0,3,B
2018-04-27 09:54:32,13345.0,10,14550,-4,13340.0,10,13345.0,6,B
2018-04-27 09:54:33,13345.0,12,14562,0,13345.0,2,13350.0,4,B
2018-04-27 09:54:36,13350.0,4,14566,0,13345.0,16,13355.0,8,B
2018-04-27 09:54:37,13345.0,12,14578,0,13345.0,9,13355.0,7,S
2018-04-27 09:54:37,13345.0,2,14580,0,13345.0,9,13355.0,8,S
2018-04-27 09:54:39,13355.0,10,14590,-2,13350.0,2,13355.0,3,B
2018-04-27 09:54:40,13355.0,12,14602,0,13350.0,14,13355.0,1,B
2018-04-27 09:54:41,13355.0,2,14604,0,13350.0,16,13360.0,5,B
2018-04-27 09:54:44,13360.0,2,14606,0,13355.0,4,13360.0,4,B
2018-04-27 09:54:46,13355.0,4,14610,-4,13355.0,1,13360.0,10,S
2018-04-27 09:54:47,13355.0,2,14612,-2,13350.0,11,13355.0,1,S
2018-04-27 09:54:48,13355.0,2,14614,-2,13350.0,6,13360.0,11,S
2018-04-27 09:54:48,13355.0,2,14616,2,13350.0,6,13360.0,10,S
2018-04-27 09:54:54,13360.0,2,14618,0,13355.0,40,13360.0,11,B
2018-04-27 09:54:56,13355.0,14,14632,14,13355.0,33,13360.0,13,S
2018-04-27 09:54:57,13360.0,2,14634,-2,13355.0,33,13360.0,12,B
2018-04-27 09:54:58,13355.0,14,14648,14,13355.0,26,13360.0,13,S
2018-04-27 09:54:58,13355.0,38,14686,38,13355.0,7,13360.0,13,S
2018-04-27 09:54:59,13350.0,34,14720,-6,13345.0,4,13355.0,10,S
2018-04-27 09:55:02,13350.0,2,14722,0,13345.0,2,13350.0,13,S
2018-04-27 09:55:03,13350.0,16,14738,0,13345.0,14,13355.0,6,S
2018-04-27 09:55:07,13350.0,4,14742,-2,13350.0,2,13355.0,6,S
2018-04-27 09:55:08,13350.0,8,14750,-4,13345.0,12,13350.0,1,S
2018-04-27 09:55:09,13350.0,2,14752,0,13350.0,1,13355.0,8,S
2018-04-27 09:55:10,13350.0,2,14754,0,13345.0,9,13350.0,5,S
2018-04-27 09:55:11,13345.0,4,14758,2,13340.0,3,13350.0,13,S
2018-04-27 09:55:13,13340.0,2,14760,0,13340.0,8,13345.0,23,S
2018-04-27 09:55:14,13345.0,10,14770,8,13340.0,4,13345.0,22,B
2018-04-27 09:55:15,13345.0,2,14772,2,13340.0,6,13345.0,21,B
2018-04-27 09:55:24,13345.0,2,14774,0,13340.0,8,13345.0,21,B
2018-04-27 09:55:25,13345.0,42,14816,10,13345.0,6,13350.0,8,B
2018-04-27 09:55:29,13350.0,2,14818,0,13345.0,9,13350.0,5,B
2018-04-27 09:55:39,13345.0,12,14830,-4,13340.0,10,13350.0,14,S
2018-04-27 09:55:44,13350.0,2,14832,-2,13340.0,10,13350.0,12,B
2018-04-27 09:55:50,13350.0,2,14834,2,13345.0,4,13350.0,10,B
2018-04-27 09:55:50,13350.0,4,14838,-2,13345.0,4,13350.0,8,B
2018-04-27 09:55:51,13345.0,4,14842,-2,13345.0,3,13350.0,9,S
2018-04-27 09:55:52,13350.0,6,14848,4,13340.0,10,13350.0,10,B
2018-04-27 09:55:59,13345.0,4,14852,-4,13340.0,11,13345.0,2,S
2018-04-27 09:56:00,13350.0,62,14914,40,13350.0,4,13355.0,10,B
2018-04-27 09:56:01,13340.0,20,14934,12,13345.0,3,13350.0,14,S
2018-04-27 09:56:01,13340.0,10,14944,-4,13335.0,10,13345.0,6,S
2018-04-27 09:56:04,13340.0,2,14946,-2,13335.0,7,13340.0,1,S
2018-04-27 09:56:06,13340.0,10,14956,-2,13335.0,12,13345.0,10,S
2018-04-27 09:56:13,13340.0,2,14958,2,13340.0,30,13345.0,9,S
2018-04-27 09:56:13,13340.0,8,14966,4,13340.0,26,13345.0,7,S
2018-04-27 09:56:15,13345.0,10,14976,6,13340.0,32,13350.0,7,B
2018-04-27 09:56:15,13345.0,4,14980,-2,13340.0,32,13345.0,3,B
2018-04-27 09:56:16,13345.0,6,14986,-6,13340.0,32,13350.0,5,B
2018-04-27 09:56:17,13340.0,2,14988,2,13340.0,26,13345.0,6,S
2018-04-27 09:56:19,13345.0,10,14998,-2,13340.0,26,13345.0,1,B
2018-04-27 09:56:20,13345.0,2,15000,0,13345.0,9,13350.0,9,B
2018-04-27 09:56:22,13345.0,14,15014,-6,13340.0,31,13350.0,5,B
2018-04-27 09:56:23,13350.0,2,15016,2,13345.0,2,13350.0,6,B
2018-04-27 09:56:25,13350.0,4,15020,-2,13345.0,2,13350.0,6,B
2018-04-27 09:56:33,13350.0,4,15024,-2,13345.0,10,13350.0,2,B
2018-04-27 09:56:41,13350.0,12,15036,-4,13345.0,11,13355.0,30,B
2018-04-27 09:56:42,13350.0,4,15040,0,13345.0,16,13355.0,22,B
2018-04-27 09:56:48,13350.0,4,15044,4,13345.0,15,13355.0,37,B
2018-04-27 09:56:51,13350.0,2,15046,2,13350.0,9,13355.0,8,B
2018-04-27 09:56:53,13355.0,2,15048,2,13350.0,9,13355.0,5,B
2018-04-27 09:56:55,13350.0,2,15050,0,13350.0,8,13355.0,6,S
2018-04-27 09:56:57,13355.0,12,15062,12,13355.0,5,13360.0,26,B
2018-04-27 09:56:58,13360.0,8,15070,4,13355.0,22,13360.0,21,B
2018-04-27 09:56:58,13360.0,2,15072,2,13355.0,17,13360.0,5,B
2018-04-27 09:56:59,13360.0,8,15080,0,13355.0,17,13360.0,1,B
2018-04-27 09:56:59,13360.0,2,15082,-2,13360.0,2,13365.0,23,B
2018-04-27 09:57:00,13360.0,2,15084,2,13355.0,16,13365.0,32,B
2018-04-27 09:57:00,13365.0,2,15086,0,13355.0,12,13365.0,34,B
2018-04-27 09:57:05,13365.0,2,15088,0,13360.0,2,13365.0,34,B
2018-04-27 09:57:05,13360.0,4,15092,0,13355.0,13,13365.0,33,S
2018-04-27 09:57:09,13355.0,2,15094,-2,13355.0,11,13360.0,2,S
2018-04-27 09:57:10,13360.0,4,15098,-4,13355.0,12,13365.0,31,B
2018-04-27 09:57:11,13360.0,4,15102,-4,13355.0,13,13365.0,34,B
2018-04-27 09:57:19,13365.0,12,15114,-4,13355.0,10,13365.0,31,B
2018-04-27 09:57:26,13360.0,20,15134,-18,13355.0,14,13360.0,7,S
2018-04-27 09:57:27,13360.0,14,15148,-14,13360.0,4,13365.0,4,S
2018-04-27 09:57:27,13365.0,2,15150,0,13360.0,22,13365.0,2,B
2018-04-27 09:57:28,13365.0,4,15154,-2,13365.0,3,13370.0,17,B
2018-04-27 09:57:32,13365.0,6,15160,-2,13365.0,1,13370.0,4,B
2018-04-27 09:57:35,13365.0,2,15162,2,13360.0,6,13365.0,8,B
2018-04-27 09:57:38,13360.0,6,15168,0,13355.0,9,13365.0,26,S
2018-04-27 09:57:47,13360.0,2,15170,-2,13360.0,9,13365.0,24,S
2018-04-27 09:57:48,13360.0,2,15172,-2,13360.0,5,13365.0,3,S
2018-04-27 09:57:49,13360.0,2,15174,0,13360.0,4,13365.0,2,S
2018-04-27 09:57:52,13365.0,2,15176,-2,13360.0,10,13370.0,26,B
2018-04-27 09:57:55,13365.0,2,15178,0,13365.0,2,13370.0,7,B
2018-04-27 09:57:58,13370.0,8,15186,-8,13365.0,1,13370.0,3,B
2018-04-27 09:58:00,13365.0,2,15188,2,13365.0,2,13370.0,4,S
2018-04-27 09:58:01,13365.0,4,15192,0,13365.0,1,13370.0,15,S
2018-04-27 09:58:02,13365.0,2,15194,-2,13360.0,13,13365.0,1,S
2018-04-27 09:58:07,13365.0,4,15198,0,13365.0,5,13370.0,13,S
2018-04-27 09:58:12,13365.0,2,15200,2,13365.0,12,13370.0,6,S
2018-04-27 09:58:13,13370.0,8,15208,4,13365.0,14,13375.0,2,B
2018-04-27 09:58:14,13370.0,2,15210,2,13365.0,15,13375.0,16,B
2018-04-27 09:58:15,13365.0,2,15212,-2,13365.0,11,13375.0,19,S
2018-04-27 09:58:18,13370.0,4,15216,0,13365.0,9,13370.0,1,B
2018-04-27 09:58:20,13370.0,2,15218,0,13370.0,9,13375.0,17,B
2018-04-27 09:58:21,13370.0,2,15220,2,13370.0,8,13375.0,16,B
2018-04-27 09:58:21,13370.0,4,15224,2,13370.0,6,13375.0,16,B
2018-04-27 09:58:22,13375.0,2,15226,0,13370.0,6,13375.0,16,B
2018-04-27 09:58:29,13375.0,2,15228,-2,13370.0,6,13375.0,15,B
2018-04-27 09:58:33,13375.0,4,15232,-2,13370.0,6,13375.0,12,B
2018-04-27 09:58:34,13370.0,2,15234,0,13370.0,5,13375.0,14,S
2018-04-27 09:58:38,13370.0,2,15236,0,13370.0,4,13375.0,15,S
2018-04-27 09:58:40,13370.0,2,15238,2,13370.0,3,13375.0,15,S
2018-04-27 09:58:46,13375.0,2,15240,2,13370.0,4,13375.0,16,B
2018-04-27 09:58:53,13370.0,2,15242,2,13370.0,4,13375.0,18,S
2018-04-27 09:58:56,13375.0,2,15244,0,13370.0,4,13375.0,18,B
2018-04-27 09:58:57,13370.0,8,15252,6,13365.0,10,13370.0,16,S
2018-04-27 09:58:58,13370.0,2,15254,-2,13365.0,5,13370.0,24,S
2018-04-27 09:59:07,13365.0,8,15262,-2,13360.0,24,13370.0,17,S
2018-04-27 09:59:08,13360.0,20,15282,4,13360.0,8,13365.0,16,S
2018-04-27 09:59:09,13360.0,12,15294,-2,13360.0,2,13365.0,22,S
2018-04-27 09:59:09,13360.0,4,15298,0,13355.0,7,13365.0,22,S
2018-04-27 09:59:11,13365.0,8,15306,8,13355.0,11,13365.0,20,B
2018-04-27 09:59:12,13355.0,2,15308,0,13355.0,10,13365.0,20,S
2018-04-27 09:59:15,13355.0,2,15310,2,13355.0,13,13365.0,19,S
2018-04-27 09:59:18,13355.0,2,15312,2,13355.0,5,13360.0,13,S
2018-04-27 09:59:19,13355.0,6,15318,-4,13350.0,18,13360.0,18,S
2018-04-27 09:59:19,13350.0,6,15324,2,13350.0,16,13360.0,16,S
2018-04-27 09:59:22,13355.0,2,15326,-2,13350.0,16,13360.0,14,B
2018-04-27 09:59:26,13360.0,2,15328,2,13355.0,8,13360.0,10,B
2018-04-27 09:59:26,13360.0,18,15346,6,13355.0,19,13365.0,24,B
2018-04-27 09:59:32,13355.0,8,15354,8,13350.0,18,13355.0,1,S
2018-04-27 09:59:36,13350.0,4,15358,2,13350.0,12,13355.0,8,S
2018-04-27 09:59:42,13355.0,10,15368,0,13350.0,13,13355.0,3,B
2018-04-27 09:59:45,13350.0,26,15394,-18,13345.0,14,13350.0,5,S
2018-04-27 09:59:46,13350.0,10,15404,-6,13350.0,13,13355.0,2,S
2018-04-27 09:59:54,13345.0,2,15406,0,13345.0,17,13350.0,2,S
2018-04-27 09:59:54,13345.0,28,15434,4,13345.0,1,13350.0,35,S
2018-04-27 09:59:55,13345.0,2,15436,2,13340.0,34,13345.0,3,S
2018-04-27 09:59:56,13340.0,40,15476,4,13340.0,14,13345.0,7,S
2018-04-27 09:59:57,13340.0,2,15478,2,13340.0,11,13345.0,7,S
2018-04-27 09:59:57,13340.0,8,15486,8,13340.0,6,13345.0,9,S
2018-04-27 09:59:58,13340.0,12,15498,0,13335.0,5,13345.0,24,S
2018-04-27 09:59:59,13335.0,2,15500,0,13335.0,1,13340.0,14,S
2018-04-27 10:00:00,13340.0,4,15504,0,13335.0,2,13340.0,8,B
2018-04-27 10:00:01,13335.0,4,15508,0,13330.0,109,13335.0,1,S
2018-04-27 10:00:01,13330.0,48,15556,0,13330.0,85,13335.0,10,S
2018-04-27 10:00:02,13330.0,62,15618,-18,13330.0,53,13335.0,11,S
2018-04-27 10:00:02,13320.0,112,15730,-42,13320.0,3,13325.0,18,S
2018-04-27 10:00:03,13325.0,24,15754,-8,13315.0,45,13325.0,16,B
2018-04-27 10:00:03,13330.0,48,15802,42,13320.0,20,13330.0,10,B
2018-04-27 10:00:04,13330.0,22,15824,-4,13330.0,1,13335.0,10,B
2018-04-27 10:00:05,13335.0,14,15838,0,13330.0,3,13335.0,4,B
2018-04-27 10:00:06,13325.0,6,15844,-6,13325.0,9,13330.0,4,S
2018-04-27 10:00:11,13330.0,2,15846,2,13325.0,5,13330.0,9,B
2018-04-27 10:00:12,13325.0,6,15852,0,13320.0,8,13330.0,15,S
2018-04-27 10:00:14,13325.0,2,15854,-2,13325.0,2,13330.0,15,S
2018-04-27 10:00:14,13325.0,2,15856,2,13325.0,1,13330.0,15,S
2018-04-27 10:00:16,13330.0,2,15858,0,13325.0,2,13330.0,12,B
2018-04-27 10:00:17,13330.0,4,15862,0,13325.0,2,13330.0,6,B
2018-04-27 10:00:18,13325.0,8,15870,2,13325.0,1,13330.0,6,S
2018-04-27 10:00:18,13330.0,2,15872,2,13325.0,2,13330.0,5,B
2018-04-27 10:00:20,13330.0,4,15876,-2,13325.0,7,13335.0,10,B
2018-04-27 10:00:22,13330.0,2,15878,0,13325.0,7,13335.0,12,B
2018-04-27 10:00:23,13325.0,2,15880,0,13325.0,7,13335.0,12,S
2018-04-27 10:00:23,13325.0,4,15884,-4,13325.0,5,13335.0,12,S
2018-04-27 10:00:25,13325.0,10,15894,-4,13320.0,3,13325.0,24,S
2018-04-27 10:00:26,13325.0,48,15942,-4,13325.0,11,13330.0,5,S
2018-04-27 10:00:26,13330.0,8,15950,0,13330.0,1,13335.0,13,B
2018-04-27 10:00:27,13335.0,6,15956,-4,13330.0,15,13340.0,7,B
2018-04-27 10:00:29,13335.0,4,15960,-4,13335.0,2,13340.0,12,B
2018-04-27 10:00:31,13335.0,14,15974,2,13330.0,10,13340.0,8,B
2018-04-27 10:00:31,13330.0,2,15976,-2,13330.0,9,13340.0,16,S
2018-04-27 10:00:32,13340.0,4,15980,4,13330.0,9,13340.0,14,B
2018-04-27 10:00:36,13335.0,4,15984,-4,13335.0,3,13340.0,10,S
2018-04-27 10:00:37,13340.0,2,15986,2,13335.0,5,13340.0,8,B
2018-04-27 10:00:39,13340.0,8,15994,-8,13340.0,3,13345.0,4,B
2018-04-27 10:00:39,13335.0,8,16002,-6,13335.0,8,13345.0,6,S
2018-04-27 10:00:40,13335.0,2,16004,0,13335.0,7,13345.0,7,S
2018-04-27 10:00:41,13335.0,2,16006,2,13335.0,6,13345.0,11,S
2018-04-27 10:00:43,13335.0,2,16008,-2,13335.0,5,13345.0,26,S
2018-04-27 10:00:45,13345.0,4,16012,4,13340.0,8,13345.0,2,B
2018-04-27 10:00:46,13345.0,2,16014,0,13340.0,8,13350.0,18,B
2018-04-27 10:00:48,13350.0,16,16030,-6,13345.0,1,13350.0,2,B
2018-04-27 10:00:49,13350.0,14,16044,0,13350.0,3,13355.0,4,B
2018-04-27 10:00:49,13350.0,16,16060,4,13345.0,14,13355.0,3,B
2018-04-27 10:00:50,13355.0,2,16062,0,13345.0,12,13360.0,2,B
2018-04-27 10:00:51,13350.0,4,16066,0,13350.0,2,13355.0,2,S
2018-04-27 10:00:53,13345.0,2,16068,-2,13345.0,9,13350.0,2,S
2018-04-27 10:00:55,13350.0,6,16074,0,13350.0,3,13355.0,6,B
2018-04-27 10:00:55,13345.0,8,16082,-6,13345.0,2,13350.0,3,S
2018-04-27 10:00:56,13350.0,4,16086,-2,13345.0,4,13350.0,6,B
2018-04-27 10:00:58,13345.0,2,16088,0,13345.0,1,13350.0,4,S
2018-04-27 10:01:00,13350.0,4,16092,0,13345.0,3,13350.0,4,B
2018-04-27 10:01:01,13345.0,14,16106,4,13340.0,19,13345.0,1,S
2018-04-27 10:01:02,13350.0,4,16110,0,13345.0,8,13350.0,2,B
2018-04-27 10:01:05,13350.0,4,16114,-4,13345.0,9,13355.0,4,B
2018-04-27 10:01:07,13350.0,2,16116,0,13345.0,9,13355.0,6,B
2018-04-27 10:01:10,13355.0,4,16120,-2,13350.0,12,13360.0,4,B
2018-04-27 10:01:13,13360.0,2,16122,-2,13355.0,6,13365.0,5,B
2018-04-27 10:01:16,13355.0,10,16132,8,13350.0,10,13360.0,8,S
2018-04-27 10:01:16,13350.0,2,16134,0,13350.0,4,13355.0,5,S
2018-04-27 10:01:21,13355.0,2,16136,0,13350.0,3,13355.0,4,B
2018-04-27 10:01:24,13350.0,4,16140,4,13350.0,3,13355.0,4,S
2018-04-27 10:01:24,13350.0,2,16142,2,13350.0,2,13355.0,4,S
2018-04-27 10:01:25,13350.0,2,16144,0,13350.0,1,13355.0,4,S
2018-04-27 10:01:28,13345.0,10,16154,6,13345.0,4,13355.0,6,S
2018-04-27 10:01:34,13345.0,2,16156,-2,13345.0,7,13355.0,7,S
2018-04-27 10:01:40,13350.0,2,16158,0,13345.0,7,13355.0,7,B
2018-04-27 10:01:47,13355.0,2,16160,2,13350.0,3,13355.0,7,B
2018-04-27 10:01:48,13355.0,6,16166,-4,13355.0,4,13360.0,10,B
2018-04-27 10:01:49,13360.0,2,16168,0,13355.0,2,13360.0,7,B
2018-04-27 10:01:51,13360.0,2,16170,0,13355.0,2,13360.0,6,B
2018-04-27 10:01:54,13360.0,2,16172,2,13355.0,2,13360.0,6,B
2018-04-27 10:01:55,13360.0,2,16174,2,13355.0,2,13360.0,6,B
2018-04-27 10:01:56,13360.0,2,16176,2,13355.0,2,13360.0,2,B
2018-04-27 10:01:56,13360.0,2,16178,0,13355.0,2,13360.0,1,B
2018-04-27 10:01:57,13360.0,2,16180,0,13355.0,4,13365.0,10,B
2018-04-27 10:01:57,13365.0,2,16182,2,13360.0,2,13365.0,9,B
2018-04-27 10:01:58,13355.0,6,16188,0,13355.0,4,13360.0,1,S
2018-04-27 10:01:58,13360.0,4,16192,-2,13355.0,5,13365.0,10,B
2018-04-27 10:02:00,13365.0,2,16194,2,13355.0,5,13365.0,9,B
2018-04-27 10:02:07,13365.0,2,16196,2,13355.0,7,13365.0,8,B
2018-04-27 10:02:10,13355.0,4,16200,0,13350.0,4,13360.0,7,S
2018-04-27 10:02:11,13350.0,2,16202,-2,13350.0,4,13360.0,8,S
2018-04-27 10:02:15,13345.0,12,16214,-2,13345.0,6,13350.0,6,S
2018-04-27 10:02:15,13345.0,6,16220,-4,13345.0,2,13350.0,8,S
2018-04-27 10:02:23,13350.0,16,16236,-12,13345.0,5,13355.0,17,B
2018-04-27 10:02:30,13345.0,6,16242,-2,13340.0,4,13350.0,6,S
2018-04-27 10:02:37,13345.0,8,16250,-8,13340.0,21,13345.0,6,S
2018-04-27 10:02:37,13345.0,14,16264,-10,13345.0,6,13350.0,4,S
2018-04-27 10:02:46,13345.0,2,16266,0,13345.0,2,13350.0,3,S
2018-04-27 10:02:53,13350.0,2,16268,2,13345.0,4,13350.0,2,B
2018-04-27 10:02:58,13350.0,6,16274,0,13350.0,11,13355.0,8,B
2018-04-27 10:02:58,13355.0,4,16278,-2,13350.0,9,13360.0,6,B
2018-04-27 10:03:12,13350.0,2,16280,-2,13345.0,12,13350.0,12,S
2018-04-27 10:03:13,13350.0,26,16306,-10,13350.0,2,13355.0,8,S
2018-04-27 10:03:24,13350.0,12,16318,-12,13350.0,7,13355.0,2,S
2018-04-27 10:03:25,13355.0,4,16322,2,13350.0,7,13360.0,8,B
2018-04-27 10:03:32,13355.0,6,16328,0,13350.0,9,13355.0,1,B
2018-04-27 10:03:39,13355.0,2,16330,0,13350.0,9,13360.0,7,B
2018-04-27 10:03:40,13350.0,20,16350,-10,13350.0,1,13355.0,1,S
2018-04-27 10:03:42,13355.0,2,16352,0,13350.0,5,13360.0,7,B
2018-04-27 10:03:49,13355.0,6,16358,-4,13350.0,6,13355.0,3,B
2018-04-27 10:03:50,13355.0,6,16364,6,13355.0,7,13360.0,8,B
2018-04-27 10:03:53,13355.0,10,16374,10,13355.0,5,13360.0,3,B
2018-04-27 10:03:54,13360.0,6,16380,-2,13360.0,1,13365.0,5,B
2018-04-27 10:03:55,13365.0,8,16388,-8,13360.0,14,13370.0,3,B
2018-04-27 10:03:56,13355.0,40,16428,-16,13355.0,11,13370.0,8,S
2018-04-27 10:03:57,13355.0,2,16430,2,13360.0,9,13365.0,4,S
2018-04-27 10:03:59,13360.0,2,16432,0,13360.0,8,13365.0,3,B
2018-04-27 10:04:01,13365.0,4,16436,0,13360.0,11,13370.0,5,B
2018-04-27 10:04:02,13365.0,2,16438,0,13360.0,10,13370.0,7,B
2018-04-27 10:04:03,13365.0,2,16440,0,13360.0,12,13370.0,9,B
2018-04-27 10:04:13,13360.0,20,16460,-18,13355.0,2,13360.0,10,S
2018-04-27 10:04:14,13360.0,26,16486,-16,13355.0,5,13365.0,7,S
2018-04-27 10:04:15,13360.0,2,16488,0,13355.0,11,13360.0,1,S
2018-04-27 10:04:16,13360.0,2,16490,2,13355.0,9,13365.0,4,S
2018-04-27 10:04:17,13355.0,16,16506,-8,13350.0,6,13360.0,8,S
2018-04-27 10:04:22,13360.0,8,16514,0,13355.0,14,13360.0,7,B
2018-04-27 10:04:40,13355.0,2,16516,2,13355.0,8,13360.0,9,S
2018-04-27 10:04:41,13355.0,2,16518,0,13355.0,7,13360.0,10,S
2018-04-27 10:04:47,13360.0,20,16538,0,13355.0,8,13360.0,3,B
2018-04-27 10:04:54,13360.0,2,16540,0,13355.0,8,13365.0,20,B
2018-04-27 10:05:00,13360.0,2,16542,-2,13355.0,9,13365.0,30,B
2018-04-27 10:05:14,13365.0,2,16544,0,13360.0,6,13365.0,18,B
2018-04-27 10:05:19,13365.0,20,16564,0,13360.0,12,13365.0,1,B
2018-04-27 10:05:22,13360.0,2,16566,0,13360.0,2,13365.0,17,S
2018-04-27 10:05:23,13360.0,4,16570,0,13355.0,9,13365.0,17,S
2018-04-27 10:05:31,13365.0,2,16572,0,13360.0,15,13365.0,2,B
2018-04-27 10:05:33,13360.0,12,16584,2,13355.0,10,13360.0,5,S
2018-04-27 10:05:38,13355.0,6,16590,-6,13355.0,4,13360.0,13,S
2018-04-27 10:05:43,13355.0,10,16600,2,13350.0,20,13360.0,53,S
2018-04-27 10:05:50,13350.0,16,16616,2,13345.0,7,13355.0,16,S
2018-04-27 10:05:52,13350.0,2,16618,0,13345.0,11,13355.0,18,S
2018-04-27 10:05:58,13350.0,4,16622,-2,13345.0,12,13350.0,3,S
2018-04-27 10:06:03,13350.0,6,16628,0,13345.0,12,13350.0,10,S
2018-04-27 10:06:08,13350.0,20,16648,0,13350.0,10,13355.0,14,S
2018-04-27 10:06:08,13350.0,20,16668,20,13345.0,11,13350.0,2,S
2018-04-27 10:06:11,13350.0,4,16672,-4,13345.0,11,13355.0,15,S
2018-04-27 10:06:15,13355.0,2,16674,0,13350.0,10,13355.0,6,B
2018-04-27 10:06:17,13355.0,2,16676,0,13350.0,20,13355.0,5,B
2018-04-27 10:06:21,13355.0,4,16680,0,13350.0,20,13355.0,3,B
2018-04-27 10:06:27,13355.0,4,16684,0,13350.0,14,13355.0,5,B
2018-04-27 10:06:29,13355.0,6,16690,-4,13355.0,2,13360.0,52,B
2018-04-27 10:06:30,13355.0,4,16694,0,13355.0,1,13360.0,54,B
2018-04-27 10:06:31,13355.0,2,16696,-2,13355.0,2,13360.0,55,B
2018-04-27 10:06:31,13355.0,4,16700,0,13350.0,23,13360.0,55,B
2018-04-27 10:06:49,13355.0,2,16702,-2,13350.0,23,13355.0,14,B
2018-04-27 10:06:49,13355.0,28,16730,-4,13355.0,14,13360.0,52,B
2018-04-27 10:06:54,13355.0,30,16760,8,13355.0,2,13360.0,53,B
2018-04-27 10:06:55,13355.0,48,16808,-46,13350.0,22,13360.0,32,B
2018-04-27 10:06:58,13355.0,6,16814,-2,13350.0,27,13355.0,1,B
2018-04-27 10:07:01,13355.0,4,16818,-4,13355.0,1,13360.0,35,B
2018-04-27 10:07:04,13355.0,4,16822,0,13350.0,21,13360.0,35,B
2018-04-27 10:07:30,13350.0,2,16824,-2,13350.0,21,13360.0,43,S
2018-04-27 10:07:49,13355.0,2,16826,0,13350.0,21,13355.0,15,B
2018-04-27 10:08:28,13355.0,2,16828,0,13350.0,17,13355.0,15,B
2018-04-27 10:09:03,13355.0,6,16834,0,13350.0,14,13355.0,12,B
2018-04-27 10:09:16,13355.0,2,16836,2,13350.0,14,13355.0,11,B
2018-04-27 10:09:33,13350.0,4,16840,-2,13350.0,4,13355.0,19,S
2018-04-27 10:09:34,13350.0,4,16844,-4,13350.0,2,13355.0,19,S
2018-04-27 10:09:34,13350.0,4,16848,-4,13345.0,12,13355.0,19,S
2018-04-27 10:09:39,13345.0,4,16852,2,13345.0,3,13350.0,13,S
2018-04-27 10:09:40,13350.0,2,16854,0,13345.0,3,13350.0,13,B
2018-04-27 10:09:45,13350.0,10,16864,-2,13345.0,13,13355.0,18,B
2018-04-27 10:10:08,13345.0,10,16874,-8,13340.0,11,13345.0,5,S
2018-04-27 10:10:11,13345.0,10,16884,-10,13340.0,8,13350.0,11,S
2018-04-27 10:10:12,13350.0,2,16886,0,13345.0,15,13355.0,18,B
2018-04-27 10:10:24,13350.0,2,16888,0,13350.0,2,13355.0,20,B
2018-04-27 10:10:25,13350.0,2,16890,2,13345.0,16,13355.0,21,B
2018-04-27 10:10:25,13355.0,8,16898,0,13345.0,16,13355.0,17,B
2018-04-27 10:10:31,13355.0,12,16910,-12,13345.0,17,13355.0,10,B
2018-04-27 10:10:32,13355.0,6,16916,-2,13350.0,6,13355.0,1,B
2018-04-27 10:10:49,13355.0,2,16918,-2,13350.0,12,13360.0,40,B
2018-04-27 10:10:50,13355.0,2,16920,2,13350.0,14,13360.0,42,B
2018-04-27 10:11:18,13350.0,2,16922,0,13350.0,5,13355.0,17,S
2018-04-27 10:11:18,13350.0,10,16932,6,13345.0,14,13355.0,22,S
2018-04-27 10:11:20,13355.0,2,16934,0,13345.0,14,13355.0,21,B
2018-04-27 10:11:24,13350.0,2,16936,-2,13345.0,15,13350.0,1,S
2018-04-27 10:11:48,13350.0,4,16940,4,13345.0,8,13355.0,21,S
2018-04-27 10:12:03,13350.0,2,16942,-2,13345.0,8,13355.0,21,S
2018-04-27 10:12:37,13345.0,4,16946,-2,13340.0,33,13345.0,1,S
2018-04-27 10:12:51,13340.0,6,16952,-2,13340.0,23,13345.0,10,S
2018-04-27 10:12:51,13340.0,46,16998,-26,13335.0,3,13340.0,1,S
2018-04-27 10:12:52,13340.0,2,17000,-2,13335.0,9,13340.0,6,S
2018-04-27 10:12:52,13340.0,12,17012,-10,13340.0,6,13345.0,8,S
2018-04-27 10:12:58,13340.0,10,17022,-2,13335.0,15,13340.0,5,S
2018-04-27 10:12:58,13340.0,10,17032,-10,13335.0,13,13345.0,7,S
2018-04-27 10:13:05,13345.0,4,17036,-4,13335.0,14,13345.0,17,B
2018-04-27 10:13:15,13345.0,18,17054,-6,13340.0,13,13345.0,6,B
2018-04-27 10:13:16,13345.0,12,17066,4,13340.0,14,13350.0,3,B
2018-04-27 10:13:17,13345.0,4,17070,-4,13340.0,12,13350.0,10,B
2018-04-27 10:13:28,13345.0,10,17080,6,13340.0,15,13350.0,16,B
2018-04-27 10:13:42,13345.0,2,17082,2,13340.0,10,13350.0,18,B
2018-04-27 10:13:54,13350.0,4,17086,2,13340.0,7,13350.0,18,B
2018-04-27 10:13:54,13340.0,8,17094,6,13340.0,3,13350.0,18,S
2018-04-27 10:14:01,13350.0,8,17102,-8,13340.0,13,13350.0,14,B
2018-04-27 10:14:02,13340.0,4,17106,-2,13340.0,12,13350.0,14,S
2018-04-27 10:14:03,13350.0,2,17108,-2,13340.0,12,13350.0,14,B
2018-04-27 10:14:24,13350.0,2,17110,-2,13340.0,4,13345.0,4,B
2018-04-27 10:14:24,13345.0,2,17112,-2,13340.0,4,13345.0,3,S
2018-04-27 10:14:30,13345.0,6,17118,-6,13340.0,4,13350.0,16,S
2018-04-27 10:14:36,13340.0,2,17120,0,13340.0,7,13345.0,1,S
2018-04-27 10:14:42,13340.0,2,17122,-2,13340.0,7,13345.0,1,S
2018-04-27 10:14:42,13345.0,2,17124,-2,13345.0,1,13350.0,13,B
2018-04-27 10:14:43,13345.0,6,17130,-6,13340.0,14,13350.0,14,B
2018-04-27 10:30:00,13345.0,6,17136,0,13340.0,16,13345.0,18,B
2018-04-27 10:30:01,13345.0,34,17170,-24,13340.0,17,13350.0,11,B
2018-04-27 10:30:04,13345.0,2,17172,2,13345.0,4,13350.0,9,B
2018-04-27 10:30:08,13350.0,16,17188,2,13345.0,25,13350.0,1,B
2018-04-27 10:30:08,13350.0,2,17190,0,13345.0,25,13355.0,8,B
2018-04-27 10:30:14,13355.0,6,17196,0,13350.0,16,13355.0,2,B
2018-04-27 10:30:15,13355.0,4,17200,-4,13350.0,16,13360.0,8,B
2018-04-27 10:30:15,13355.0,2,17202,-2,13350.0,17,13360.0,8,B
2018-04-27 10:30:21,13355.0,2,17204,2,13355.0,2,13360.0,11,B
2018-04-27 10:30:25,13360.0,2,17206,0,13355.0,7,13360.0,7,B
2018-04-27 10:30:33,13355.0,16,17222,-12,13350.0,16,13355.0,6,S
2018-04-27 10:30:33,13350.0,2,17224,2,13350.0,4,13355.0,10,S
2018-04-27 10:30:34,13350.0,8,17232,6,13345.0,3,13350.0,1,S
2018-04-27 10:30:41,13345.0,8,17240,2,13345.0,2,13350.0,11,S
2018-04-27 10:30:57,13350.0,16,17256,-12,13350.0,6,13355.0,10,B
2018-04-27 10:30:59,13350.0,16,17272,-16,13350.0,4,13355.0,6,B
2018-04-27 10:31:05,13350.0,8,17280,0,13350.0,1,13355.0,13,B
2018-04-27 10:31:06,13350.0,2,17282,2,13345.0,10,13355.0,13,B
2018-04-27 10:31:16,13350.0,2,17284,0,13345.0,9,13350.0,5,B
2018-04-27 10:31:32,13350.0,2,17286,0,13345.0,9,13350.0,5,B
2018-04-27 10:31:42,13350.0,2,17288,0,13345.0,11,13350.0,4,B
2018-04-27 10:32:09,13350.0,2,17290,0,13345.0,10,13350.0,15,B
2018-04-27 10:32:17,13345.0,2,17292,2,13345.0,7,13350.0,13,S
2018-04-27 10:32:48,13350.0,6,17298,-2,13345.0,20,13350.0,10,B
2018-04-27 10:32:49,13350.0,4,17302,0,13345.0,22,13350.0,9,B
2018-04-27 10:32:49,13350.0,18,17320,2,13345.0,22,13350.0,1,B
2018-04-27 10:32:50,13350.0,2,17322,0,13345.0,22,13355.0,13,B
2018-04-27 10:32:52,13350.0,2,17324,-2,13350.0,3,13355.0,16,B
2018-04-27 10:32:54,13355.0,2,17326,-2,13350.0,3,13355.0,27,B
2018-04-27 10:32:56,13355.0,4,17330,-4,13350.0,26,13355.0,2,B
2018-04-27 10:32:57,13355.0,4,17334,-2,13350.0,25,13360.0,15,B
2018-04-27 10:32:59,13350.0,20,17354,-12,13350.0,16,13360.0,20,S
2018-04-27 10:33:09,13350.0,2,17356,0,13355.0,1,13360.0,22,S
2018-04-27 10:33:09,13355.0,2,17358,0,13350.0,21,13355.0,1,B
2018-04-27 10:33:17,13355.0,24,17382,0,13350.0,19,13360.0,22,B
2018-04-27 10:33:18,13360.0,26,17408,6,13355.0,22,13365.0,6,B
2018-04-27 10:33:21,13365.0,2,17410,0,13360.0,21,13370.0,7,B
2018-04-27 10:33:24,13365.0,6,17416,0,13365.0,1,13370.0,15,B
2018-04-27 10:33:25,13365.0,2,17418,0,13360.0,23,13370.0,15,B
2018-04-27 10:33:31,13365.0,2,17420,0,13360.0,5,13365.0,18,B
2018-04-27 10:33:34,13365.0,2,17422,2,13360.0,5,13365.0,10,B
2018-04-27 10:33:36,13365.0,4,17426,4,13360.0,20,13365.0,1,B
2018-04-27 10:33:37,13365.0,2,17428,-2,13360.0,20,13370.0,14,B
2018-04-27 10:33:54,13365.0,2,17430,2,13360.0,5,13365.0,12,B
2018-04-27 10:34:10,13365.0,2,17432,0,13360.0,5,13365.0,11,B
2018-04-27 10:34:13,13360.0,10,17442,0,13355.0,7,13360.0,5,S
2018-04-27 10:34:14,13365.0,16,17458,-16,13355.0,22,13365.0,7,B
2018-04-27 10:34:16,13360.0,2,17460,-2,13360.0,3,13365.0,9,S
2018-04-27 10:34:21,13360.0,2,17462,-2,13360.0,2,13365.0,18,S
2018-04-27 10:34:47,13365.0,4,17466,0,13360.0,21,13370.0,16,B
2018-04-27 10:34:49,13360.0,2,17468,2,13360.0,20,13370.0,17,S
2018-04-27 10:34:58,13365.0,2,17470,0,13360.0,25,13370.0,17,B
2018-04-27 10:35:03,13365.0,4,17474,0,13365.0,20,13370.0,6,B
2018-04-27 10:35:07,13370.0,12,17486,0,13370.0,3,13375.0,10,B
2018-04-27 10:35:08,13375.0,4,17490,-2,13370.0,5,13375.0,12,B
2018-04-27 10:35:15,13375.0,2,17492,0,13370.0,5,13375.0,7,B
2018-04-27 10:35:21,13370.0,10,17502,0,13365.0,22,13370.0,3,S
2018-04-27 10:35:22,13365.0,6,17508,0,13360.0,10,13370.0,15,S
2018-04-27 10:35:25,13370.0,2,17510,0,13360.0,10,13370.0,20,B
2018-04-27 10:35:35,13365.0,2,17512,0,13360.0,12,13365.0,1,S
2018-04-27 10:35:53,13360.0,2,17514,0,13360.0,14,13365.0,14,S
2018-04-27 10:35:56,13365.0,2,17516,-2,13360.0,13,13365.0,13,B
2018-04-27 10:35:59,13360.0,22,17538,-8,13355.0,7,13365.0,16,S
2018-04-27 10:36:31,13365.0,32,17570,-14,13355.0,23,13365.0,17,B
2018-04-27 10:36:40,13360.0,2,17572,-2,13360.0,20,13365.0,13,S
2018-04-27 10:36:42,13365.0,8,17580,0,13360.0,20,13365.0,9,B
2018-04-27 10:36:56,13360.0,2,17582,2,13360.0,5,13365.0,15,S
2018-04-27 10:36:59,13360.0,10,17592,-2,13360.0,1,13365.0,15,S
2018-04-27 10:37:16,13360.0,2,17594,0,13355.0,11,13365.0,16,S
2018-04-27 10:37:35,13355.0,20,17614,-8,13355.0,5,13365.0,21,S
2018-04-27 10:37:56,13355.0,2,17616,0,13355.0,14,13365.0,22,S
2018-04-27 10:37:58,13360.0,2,17618,0,13355.0,14,13365.0,22,B
2018-04-27 10:38:01,13355.0,2,17620,0,13355.0,13,13365.0,23,S
2018-04-27 10:38:01,13355.0,2,17622,0,13355.0,12,13365.0,23,S
2018-04-27 10:38:02,13355.0,2,17624,0,13355.0,11,13365.0,23,S
2018-04-27 10:38:02,13355.0,2,17626,0,13355.0,10,13365.0,23,S
2018-04-27 10:38:03,13355.0,2,17628,0,13355.0,9,13365.0,23,S
2018-04-27 10:38:03,13355.0,2,17630,0,13355.0,8,13365.0,23,S
2018-04-27 10:38:04,13355.0,2,17632,0,13355.0,7,13360.0,2,S
2018-04-27 10:38:04,13355.0,2,17634,0,13355.0,6,13360.0,6,S
2018-04-27 10:38:05,13355.0,2,17636,0,13355.0,5,13360.0,6,S
2018-04-27 10:38:05,13355.0,2,17638,0,13355.0,5,13360.0,6,S
2018-04-27 10:38:06,13355.0,2,17640,0,13355.0,6,13360.0,6,S
2018-04-27 10:38:08,13355.0,2,17642,0,13355.0,5,13360.0,6,S
2018-04-27 10:38:08,13355.0,2,17644,0,13355.0,4,13360.0,7,S
2018-04-27 10:38:09,13355.0,2,17646,0,13355.0,3,13360.0,7,S
2018-04-27 10:38:09,13355.0,2,17648,2,13355.0,2,13360.0,7,S
2018-04-27 10:38:10,13355.0,2,17650,2,13355.0,1,13360.0,7,S
2018-04-27 10:38:10,13350.0,2,17652,2,13350.0,45,13360.0,7,S
2018-04-27 10:38:19,13355.0,6,17658,2,13355.0,6,13360.0,2,B
2018-04-27 10:38:19,13360.0,8,17666,-4,13355.0,21,13365.0,17,B
2018-04-27 10:38:26,13355.0,2,17668,0,13355.0,4,13360.0,5,S
2018-04-27 10:38:29,13355.0,2,17670,2,13355.0,2,13360.0,6,S
2018-04-27 10:38:29,13355.0,2,17672,2,13355.0,1,13360.0,6,S
2018-04-27 10:38:30,13355.0,2,17674,0,13350.0,33,13360.0,6,S
2018-04-27 10:38:41,13350.0,20,17694,-12,13350.0,3,13355.0,2,S
2018-04-27 10:38:42,13355.0,4,17698,-4,13350.0,5,13360.0,13,B
2018-04-27 10:38:42,13350.0,2,17700,0,13350.0,3,13360.0,13,S
2018-04-27 10:38:46,13355.0,4,17704,-2,13350.0,2,13360.0,13,B
2018-04-27 10:38:48,13350.0,2,17706,-2,13350.0,2,13355.0,11,S
2018-04-27 10:39:26,13355.0,8,17714,2,13350.0,11,13355.0,7,B
2018-04-27 10:39:35,13355.0,4,17718,0,13350.0,12,13355.0,5,B
2018-04-27 10:39:35,13355.0,8,17726,-6,13350.0,29,13355.0,1,B
2018-04-27 10:39:36,13355.0,4,17730,2,13355.0,1,13360.0,11,B
2018-04-27 10:39:36,13350.0,2,17732,2,13355.0,1,13360.0,11,S
2018-04-27 10:39:41,13350.0,2,17734,2,13355.0,5,13360.0,11,S
2018-04-27 10:39:42,13350.0,2,17736,2,13355.0,3,13360.0,11,S
2018-04-27 10:39:43,13350.0,2,17738,2,13355.0,2,13360.0,11,S
2018-04-27 10:39:43,13350.0,2,17740,2,13355.0,1,13360.0,11,S
2018-04-27 10:39:44,13350.0,4,17744,4,13350.0,68,13360.0,11,S
2018-04-27 10:39:57,13355.0,2,17746,0,13355.0,2,13360.0,6,B
2018-04-27 10:39:58,13355.0,4,17750,2,13350.0,68,13360.0,16,B
2018-04-27 10:39:59,13350.0,142,17892,-40,13345.0,64,13350.0,29,S
2018-04-27 10:39:59,13350.0,4,17896,0,13345.0,12,13350.0,27,S
2018-04-27 10:40:01,13350.0,12,17908,-4,13345.0,12,13350.0,21,S
2018-04-27 10:40:01,13355.0,62,17970,-44,13350.0,5,13360.0,35,B
2018-04-27 10:40:05,13355.0,2,17972,2,13350.0,4,13355.0,5,B
2018-04-27 10:40:09,13350.0,8,17980,-6,13345.0,17,13350.0,6,S
2018-04-27 10:40:10,13345.0,8,17988,0,13345.0,9,13350.0,8,S
2018-04-27 10:40:15,13350.0,2,17990,0,13345.0,10,13350.0,17,B
2018-04-27 10:40:19,13350.0,6,17996,-6,13345.0,11,13350.0,14,B
2018-04-27 10:40:30,13350.0,2,17998,-2,13345.0,9,13350.0,13,B
2018-04-27 10:40:31,13350.0,2,18000,0,13345.0,9,13350.0,12,B
2018-04-27 10:40:32,13350.0,22,18022,-12,13345.0,9,13350.0,1,B
2018-04-27 10:40:32,13350.0,2,18024,-2,13350.0,24,13355.0,6,B
2018-04-27 10:40:33,13355.0,4,18028,-2,13355.0,1,13360.0,24,B
2018-04-27 10:40:33,13350.0,12,18040,10,13350.0,8,13360.0,26,S
2018-04-27 10:40:36,13355.0,4,18044,2,13350.0,9,13355.0,3,B
2018-04-27 10:40:36,13355.0,2,18046,0,13350.0,9,13355.0,2,B
2018-04-27 10:40:38,13355.0,2,18048,-2,13350.0,9,13355.0,1,B
2018-04-27 10:41:11,13355.0,8,18056,0,13355.0,3,13360.0,28,B
2018-04-27 10:41:11,13355.0,6,18062,6,13350.0,9,13355.0,1,B
2018-04-27 10:41:13,13360.0,2,18064,0,13355.0,2,13360.0,9,B
2018-04-27 10:41:21,13355.0,2,18066,2,13355.0,6,13360.0,4,S
2018-04-27 10:41:27,13355.0,2,18068,2,13355.0,6,13360.0,4,S
2018-04-27 10:41:30,13355.0,8,18076,0,13355.0,3,13360.0,8,S
2018-04-27 10:41:31,13355.0,6,18082,0,13350.0,11,13360.0,25,S
2018-04-27 10:41:31,13350.0,2,18084,0,13350.0,6,13355.0,2,S
2018-04-27 10:41:34,13350.0,2,18086,-2,13350.0,5,13355.0,6,S
2018-04-27 10:41:42,13355.0,2,18088,-2,13350.0,2,13355.0,5,B
2018-04-27 10:41:48,13350.0,10,18098,-10,13345.0,9,13350.0,5,S
2018-04-27 10:41:59,13345.0,14,18112,-8,13340.0,23,13345.0,2,S
2018-04-27 10:42:18,13350.0,2,18114,-2,13345.0,1,13350.0,10,B
2018-04-27 10:42:27,13345.0,2,18116,2,13340.0,23,13350.0,10,S
2018-04-27 10:42:43,13345.0,2,18118,0,13345.0,2,13350.0,12,S
2018-04-27 10:43:14,13350.0,22,18140,6,13350.0,1,13355.0,21,B
2018-04-27 10:43:47,13350.0,2,18142,2,13350.0,2,13355.0,17,B
2018-04-27 10:43:53,13350.0,2,18144,-2,13350.0,1,13355.0,17,B
2018-04-27 10:43:54,13355.0,4,18148,-4,13345.0,10,13355.0,16,B
2018-04-27 10:44:00,13345.0,2,18150,0,13345.0,3,13350.0,13,S
2018-04-27 10:44:00,13345.0,6,18156,0,13340.0,24,13345.0,3,S
2018-04-27 10:44:08,13345.0,6,18162,-6,13345.0,6,13350.0,15,S
2018-04-27 10:44:08,13350.0,2,18164,-2,13345.0,6,13350.0,12,B
2018-04-27 10:45:01,13350.0,4,18168,4,13345.0,8,13355.0,24,B
2018-04-27 10:45:28,13350.0,2,18170,2,13350.0,1,13355.0,24,B
2018-04-27 10:45:28,13345.0,10,18180,2,13345.0,6,13350.0,10,S
2018-04-27 10:45:30,13345.0,12,18192,-6,13340.0,26,13345.0,1,S
2018-04-27 10:45:31,13345.0,2,18194,-2,13345.0,2,13350.0,10,S
2018-04-27 10:45:33,13345.0,2,18196,-2,13345.0,3,13350.0,10,S
2018-04-27 10:45:57,13340.0,16,18212,14,13340.0,23,13350.0,21,S
2018-04-27 10:45:57,13340.0,16,18228,16,13340.0,15,13350.0,21,S
2018-04-27 10:45:58,13350.0,10,18238,0,13340.0,14,13350.0,17,B
2018-04-27 10:46:05,13345.0,2,18240,0,13340.0,10,13345.0,1,S
2018-04-27 10:46:16,13340.0,20,18260,-16,13335.0,11,13345.0,4,S
2018-04-27 10:46:18,13340.0,6,18266,-2,13335.0,15,13340.0,3,S
2018-04-27 10:46:19,13340.0,6,18272,2,13335.0,15,13345.0,5,S
2018-04-27 10:46:24,13340.0,2,18274,-2,13335.0,17,13345.0,18,S
2018-04-27 10:46:32,13345.0,2,18276,2,13335.0,17,13345.0,17,B
2018-04-27 10:46:32,13335.0,2,18278,0,13335.0,21,13340.0,2,S
2018-04-27 10:46:35,13340.0,4,18282,4,13340.0,3,13345.0,20,B
2018-04-27 10:46:35,13340.0,2,18284,2,13340.0,2,13345.0,20,B
2018-04-27 10:46:36,13345.0,2,18286,0,13340.0,2,13345.0,19,B
2018-04-27 10:46:40,13340.0,20,18306,-16,13335.0,20,13345.0,17,S
2018-04-27 10:46:50,13340.0,2,18308,0,13335.0,10,13340.0,3,S
2018-04-27 10:46:50,13335.0,20,18328,-18,13335.0,5,13340.0,3,S
2018-04-27 10:46:59,13335.0,14,18342,4,13330.0,7,13340.0,13,S
2018-04-27 10:47:03,13330.0,2,18344,-2,13330.0,11,13335.0,2,S
2018-04-27 10:47:04,13335.0,4,18348,0,13330.0,10,13335.0,2,B
2018-04-27 10:47:04,13335.0,4,18352,-4,13330.0,10,13340.0,19,B
2018-04-27 10:47:13,13335.0,2,18354,0,13330.0,11,13335.0,1,B
2018-04-27 10:47:13,13335.0,2,18356,0,13330.0,10,13340.0,20,B
2018-04-27 10:47:16,13330.0,20,18376,-12,13330.0,1,13340.0,20,S
2018-04-27 10:47:17,13335.0,4,18380,0,13330.0,3,13340.0,20,B
2018-04-27 10:47:24,13330.0,16,18396,-6,13325.0,6,13330.0,2,S
2018-04-27 10:47:24,13330.0,4,18400,0,13330.0,6,13335.0,2,S
2018-04-27 10:47:25,13330.0,4,18404,-2,13330.0,5,13335.0,1,S
2018-04-27 10:47:27,13330.0,2,18406,0,13330.0,5,13335.0,1,S
2018-04-27 10:47:33,13330.0,6,18412,4,13330.0,4,13340.0,22,S
2018-04-27 10:47:36,13340.0,2,18414,2,13330.0,6,13340.0,21,B
2018-04-27 10:47:37,13330.0,12,18426,-4,13325.0,14,13330.0,5,S
2018-04-27 10:47:37,13330.0,10,18436,-10,13330.0,11,13335.0,4,S
2018-04-27 10:47:57,13330.0,4,18440,0,13330.0,21,13335.0,12,S
2018-04-27 10:48:00,13330.0,4,18444,0,13330.0,24,13335.0,12,S
2018-04-27 10:48:01,13330.0,2,18446,2,13330.0,23,13335.0,12,S
2018-04-27 10:48:03,13335.0,2,18448,2,13330.0,23,13335.0,11,B
2018-04-27 10:48:04,13335.0,2,18450,0,13330.0,23,13335.0,12,B
2018-04-27 10:48:08,13330.0,2,18452,2,13330.0,22,13335.0,12,S
2018-04-27 10:48:09,13330.0,2,18454,0,13330.0,21,13335.0,12,S
2018-04-27 10:48:13,13335.0,10,18464,0,13330.0,23,13335.0,7,B
2018-04-27 10:48:14,13335.0,2,18466,0,13330.0,23,13335.0,6,B
2018-04-27 10:48:24,13335.0,2,18468,-2,13330.0,23,13335.0,5,B
2018-04-27 10:48:53,13330.0,14,18482,-12,13330.0,10,13335.0,22,S
2018-04-27 10:48:53,13330.0,20,18502,10,13325.0,5,13335.0,22,S
2018-04-27 10:49:07,13325.0,24,18526,-10,13325.0,4,13330.0,12,S
2018-04-27 10:49:07,13325.0,2,18528,-2,13325.0,3,13330.0,12,S
2018-04-27 10:49:08,13325.0,6,18534,-6,13320.0,19,13330.0,14,S
2018-04-27 10:49:15,13325.0,2,18536,2,13325.0,1,13330.0,16,S
2018-04-27 10:49:15,13325.0,2,18538,0,13320.0,29,13325.0,9,S
2018-04-27 10:49:16,13325.0,18,18556,-10,13325.0,2,13330.0,16,S
2018-04-27 10:49:31,13325.0,6,18562,-2,13325.0,5,13330.0,17,S
2018-04-27 10:49:32,13325.0,6,18568,-2,13325.0,3,13330.0,16,S
2018-04-27 10:49:43,13330.0,2,18570,0,13325.0,6,13330.0,14,B
2018-04-27 10:49:51,13325.0,10,18580,-10,13325.0,1,13330.0,14,S
2018-04-27 10:49:57,13325.0,4,18584,2,13320.0,30,13325.0,1,S
2018-04-27 10:50:03,13325.0,2,18586,0,13320.0,19,13325.0,8,S
2018-04-27 10:50:03,13320.0,10,18596,-4,13320.0,14,13325.0,8,S
2018-04-27 10:50:04,13325.0,6,18602,4,13320.0,13,13325.0,6,B
2018-04-27 10:50:04,13320.0,6,18608,0,13320.0,10,13325.0,6,S
2018-04-27 10:50:08,13320.0,4,18612,0,13320.0,8,13325.0,6,S
2018-04-27 10:50:11,13320.0,6,18618,0,13320.0,6,13325.0,6,S
2018-04-27 10:50:11,13320.0,6,18624,2,13320.0,3,13325.0,6,S
2018-04-27 10:50:14,13320.0,2,18626,2,13320.0,4,13325.0,6,S
2018-04-27 10:50:15,13320.0,8,18634,0,13315.0,46,13320.0,1,S
2018-04-27 10:50:15,13320.0,2,18636,0,13315.0,53,13325.0,10,S
2018-04-27 10:50:16,13315.0,2,18638,0,13315.0,52,13325.0,13,S
2018-04-27 10:50:17,13315.0,26,18664,-24,13315.0,40,13325.0,13,S
2018-04-27 10:50:21,13315.0,8,18672,0,13315.0,38,13325.0,14,S
2018-04-27 10:50:23,13315.0,4,18676,0,13315.0,41,13325.0,14,S
2018-04-27 10:50:26,13320.0,4,18680,0,13320.0,3,13325.0,15,B
2018-04-27 10:50:27,13320.0,6,18686,-6,13315.0,41,13320.0,2,B
2018-04-27 10:50:28,13320.0,2,18688,0,13315.0,41,13320.0,1,B
2018-04-27 10:50:29,13320.0,2,18690,-2,13315.0,41,13325.0,15,B
2018-04-27 10:50:32,13325.0,26,18716,20,13320.0,9,13325.0,1,B
2018-04-27 10:50:33,13325.0,2,18718,2,13325.0,22,13330.0,8,B
2018-04-27 10:50:35,13325.0,10,18728,-4,13325.0,4,13330.0,2,B
2018-04-27 10:50:37,13330.0,4,18732,-4,13330.0,1,13335.0,24,B
2018-04-27 10:50:37,13330.0,2,18734,0,13325.0,4,13330.0,2,B
2018-04-27 10:50:43,13330.0,10,18744,4,13325.0,11,13335.0,26,B
2018-04-27 10:50:49,13325.0,2,18746,0,13325.0,12,13330.0,17,S
2018-04-27 10:50:52,13330.0,2,18748,0,13325.0,13,13330.0,16,B
2018-04-27 10:50:59,13330.0,2,18750,-2,13325.0,17,13330.0,15,B
2018-04-27 10:51:24,13325.0,4,18754,-4,13325.0,19,13330.0,22,S
2018-04-27 10:51:33,13325.0,4,18758,0,13325.0,15,13330.0,27,S
2018-04-27 10:51:33,13325.0,30,18788,10,13320.0,20,13325.0,6,S
2018-04-27 10:51:43,13325.0,2,18790,2,13320.0,16,13325.0,14,S
2018-04-27 10:51:47,13320.0,2,18792,2,13320.0,15,13325.0,14,S
2018-04-27 10:52:02,13320.0,14,18806,14,13320.0,5,13325.0,9,S
2018-04-27 10:52:04,13320.0,10,18816,-2,13315.0,37,13325.0,20,S
2018-04-27 10:52:12,13315.0,6,18822,0,13315.0,31,13320.0,2,S
2018-04-27 10:52:17,13315.0,2,18824,0,13315.0,30,13325.0,33,S
2018-04-27 10:52:21,13320.0,18,18842,4,13320.0,6,13325.0,19,B
2018-04-27 10:52:22,13320.0,6,18848,4,13320.0,1,13325.0,10,B
2018-04-27 10:52:24,13320.0,2,18850,2,13320.0,2,13325.0,10,B
2018-04-27 10:52:33,13320.0,2,18852,0,13320.0,2,13325.0,10,B
2018-04-27 10:52:39,13320.0,6,18858,4,13315.0,42,13320.0,2,B
2018-04-27 10:52:40,13320.0,4,18862,4,13320.0,6,13325.0,10,B
2018-04-27 10:52:56,13320.0,6,18868,2,13320.0,2,13325.0,8,B
2018-04-27 10:52:58,13320.0,4,18872,-2,13320.0,1,13325.0,9,B
2018-04-27 10:53:02,13320.0,2,18874,0,13315.0,42,13325.0,9,B
2018-04-27 10:53:03,13320.0,10,18884,10,13315.0,42,13320.0,2,B
2018-04-27 10:53:03,13320.0,4,18888,4,13320.0,1,13325.0,13,B
2018-04-27 10:53:12,13325.0,2,18890,0,13320.0,2,13325.0,9,B
2018-04-27 10:53:19,13325.0,2,18892,2,13320.0,2,13325.0,8,B
2018-04-27 10:53:26,13325.0,4,18896,-2,13320.0,2,13325.0,6,B
2018-04-27 10:53:54,13320.0,2,18898,0,13320.0,4,13325.0,6,S
2018-04-27 10:54:10,13320.0,8,18906,-2,13320.0,2,13325.0,8,S
2018-04-27 10:54:29,13320.0,6,18912,6,13315.0,42,13320.0,22,S
2018-04-27 10:54:30,13320.0,12,18924,8,13315.0,40,13320.0,16,S
2018-04-27 10:54:33,13320.0,24,18948,24,13315.0,40,13320.0,4,S
2018-04-27 10:54:34,13320.0,8,18956,0,13320.0,5,13325.0,10,S
2018-04-27 10:54:39,13320.0,2,18958,0,13320.0,1,13325.0,7,S
2018-04-27 10:54:51,13320.0,6,18964,0,13315.0,43,13325.0,9,S
2018-04-27 10:54:52,13315.0,4,18968,0,13315.0,26,13320.0,8,S
2018-04-27 10:54:53,13315.0,26,18994,-16,13315.0,13,13320.0,8,S
2018-04-27 10:54:53,13315.0,4,18998,2,13315.0,11,13320.0,8,S
2018-04-27 10:55:02,13315.0,22,19020,6,13310.0,21,13320.0,11,S
2018-04-27 10:55:04,13315.0,8,19028,-8,13315.0,1,13320.0,15,S
2018-04-27 10:55:05,13315.0,2,19030,0,13315.0,3,13320.0,16,S
2018-04-27 10:55:10,13315.0,6,19036,-2,13310.0,32,13315.0,1,S
2018-04-27 10:55:12,13315.0,38,19074,-8,13305.0,9,13315.0,14,S
2018-04-27 10:55:14,13310.0,2,19076,0,13305.0,20,13315.0,7,S
2018-04-27 10:55:14,13310.0,38,19114,-24,13310.0,3,13320.0,19,S
2018-04-27 10:55:15,13315.0,2,19116,0,13310.0,3,13315.0,5,B
2018-04-27 10:55:24,13315.0,2,19118,0,13310.0,5,13315.0,6,B
2018-04-27 10:55:26,13310.0,2,19120,-2,13310.0,4,13315.0,14,S
2018-04-27 10:55:26,13310.0,2,19122,-2,13310.0,3,13315.0,9,S
2018-04-27 10:55:31,13310.0,2,19124,0,13310.0,2,13315.0,11,S
2018-04-27 10:55:32,13310.0,4,19128,0,13305.0,15,13310.0,15,S
2018-04-27 10:55:34,13310.0,10,19138,-10,13305.0,8,13310.0,16,S
2018-04-27 10:55:35,13305.0,6,19144,4,13305.0,3,13310.0,34,S
2018-04-27 10:55:36,13300.0,8,19152,-2,13305.0,2,13310.0,34,S
2018-04-27 10:55:36,13300.0,12,19164,-6,13300.0,177,13310.0,36,S
2018-04-27 10:55:40,13305.0,18,19182,8,13300.0,179,13305.0,9,B
2018-04-27 10:55:40,13305.0,18,19200,12,13305.0,6,13310.0,14,B
2018-04-27 10:55:43,13310.0,8,19208,-6,13305.0,4,13310.0,10,B
2018-04-27 10:55:43,13310.0,8,19216,-2,13305.0,7,13310.0,3,B
2018-04-27 10:55:44,13310.0,6,19222,-6,13310.0,4,13315.0,12,B
2018-04-27 10:55:44,13315.0,2,19224,0,13310.0,1,13315.0,11,B
2018-04-27 10:55:51,13310.0,20,19244,20,13310.0,1,13315.0,10,S
2018-04-27 10:55:51,13310.0,2,19246,0,13305.0,10,13315.0,13,S
2018-04-27 10:55:55,13310.0,2,19248,0,13305.0,6,13310.0,5,S
2018-04-27 10:55:56,13310.0,10,19258,4,13305.0,7,13315.0,16,S
2018-04-27 10:55:57,13310.0,2,19260,0,13305.0,8,13310.0,3,S
2018-04-27 10:56:02,13305.0,2,19262,-2,13305.0,19,13310.0,14,S
2018-04-27 10:56:02,13305.0,2,19264,0,13305.0,18,13310.0,14,S
2018-04-27 10:56:09,13305.0,12,19276,4,13300.0,181,13305.0,4,S
2018-04-27 10:56:09,13305.0,10,19286,4,13305.0,15,13310.0,5,S
2018-04-27 10:56:10,13310.0,2,19288,0,13305.0,14,13310.0,9,B
2018-04-27 10:56:15,13310.0,2,19290,2,13305.0,15,13310.0,8,B
2018-04-27 10:56:21,13305.0,22,19312,14,13300.0,179,13310.0,23,S
2018-04-27 10:56:23,13305.0,6,19318,2,13300.0,177,13305.0,13,S
2018-04-27 10:56:24,13305.0,34,19352,6,13300.0,177,13310.0,30,S
2018-04-27 10:56:25,13305.0,2,19354,2,13300.0,177,13305.0,5,S
2018-04-27 10:56:26,13305.0,18,19372,-12,13300.0,181,13305.0,5,S
2018-04-27 10:56:27,13300.0,58,19430,20,13300.0,148,13305.0,17,S
2018-04-27 10:56:27,13300.0,20,19450,0,13300.0,139,13305.0,5,S
2018-04-27 10:56:31,13300.0,14,19464,10,13300.0,132,13305.0,8,S
2018-04-27 10:56:31,13300.0,72,19536,40,13300.0,96,13305.0,12,S
2018-04-27 10:56:32,13300.0,168,19704,124,13300.0,12,13305.0,24,S
2018-04-27 10:56:32,13295.0,28,19732,-12,13295.0,1,13300.0,28,S
2018-04-27 10:56:33,13290.0,50,19782,30,13285.0,10,13290.0,4,S
2018-04-27 10:56:33,13290.0,18,19800,-2,13290.0,7,13295.0,9,S
2018-04-27 10:56:34,13290.0,2,19802,0,13290.0,4,13295.0,6,S
2018-04-27 10:56:34,13290.0,8,19810,6,13285.0,10,13290.0,2,S
2018-04-27 10:56:35,13290.0,4,19814,0,13285.0,10,13295.0,14,S
2018-04-27 10:56:35,13285.0,4,19818,2,13285.0,8,13290.0,2,S
2018-04-27 10:56:36,13290.0,2,19820,0,13285.0,8,13290.0,4,B
2018-04-27 10:56:39,13285.0,18,19838,6,13280.0,19,13285.0,1,S
2018-04-27 10:56:39,13285.0,14,19852,0,13285.0,1,13290.0,16,S
2018-04-27 10:56:40,13285.0,2,19854,-2,13280.0,19,13285.0,2,S
2018-04-27 10:56:40,13285.0,4,19858,0,13285.0,9,13290.0,13,S
2018-04-27 10:56:41,13290.0,12,19870,-2,13285.0,22,13290.0,2,B
2018-04-27 10:56:41,13290.0,4,19874,-4,13290.0,3,13295.0,7,B
2018-04-27 10:56:46,13290.0,2,19876,2,13285.0,20,13295.0,8,B
2018-04-27 10:56:47,13295.0,18,19894,6,13295.0,8,13300.0,22,B
2018-04-27 10:56:47,13290.0,22,19916,0,13290.0,9,13300.0,22,S
2018-04-27 10:56:48,13290.0,2,19918,0,13290.0,8,13295.0,2,S
2018-04-27 10:56:48,13295.0,2,19920,0,13290.0,9,13295.0,2,B
2018-04-27 10:56:49,13290.0,4,19924,-2,13290.0,7,13295.0,2,S
2018-04-27 10:56:51,13295.0,2,19926,-2,13290.0,14,13295.0,1,B
2018-04-27 10:56:51,13295.0,4,19930,-4,13295.0,2,13300.0,12,B
2018-04-27 10:56:52,13295.0,2,19932,0,13295.0,3,13300.0,12,B
2018-04-27 10:56:53,13295.0,2,19934,0,13295.0,2,13300.0,8,B
2018-04-27 10:56:54,13300.0,4,19938,-2,13295.0,1,13300.0,7,B
2018-04-27 10:56:54,13295.0,2,19940,0,13290.0,19,13300.0,10,S
2018-04-27 10:56:57,13295.0,8,19948,6,13290.0,19,13295.0,4,S
2018-04-27 10:56:57,13295.0,8,19956,8,13290.0,19,13300.0,10,S
2018-04-27 10:56:58,13300.0,2,19958,2,13290.0,19,13300.0,9,B
2018-04-27 10:57:02,13300.0,2,19960,0,13290.0,20,13300.0,13,B
2018-04-27 10:57:04,13290.0,38,19998,-10,13285.0,17,13290.0,2,S
2018-04-27 10:57:05,13285.0,20,20018,-2,13280.0,19,13285.0,4,S
2018-04-27 10:57:05,13285.0,8,20026,0,13280.0,17,13285.0,4,S
2018-04-27 10:57:06,13280.0,6,20032,6,13280.0,14,13285.0,7,S
2018-04-27 10:57:06,13280.0,4,20036,-4,13280.0,13,13285.0,7,S
2018-04-27 10:57:07,13285.0,14,20050,10,13280.0,13,13290.0,9,B
2018-04-27 10:57:08,13280.0,4,20054,0,13280.0,15,13290.0,9,S
2018-04-27 10:57:10,13280.0,20,20074,16,13280.0,10,13290.0,11,S
2018-04-27 10:57:14,13285.0,4,20078,0,13280.0,13,13290.0,9,B
2018-04-27 10:57:17,13285.0,6,20084,0,13280.0,15,13290.0,10,B
2018-04-27 10:57:25,13285.0,4,20088,0,13280.0,12,13285.0,1,B
2018-04-27 10:57:27,13280.0,4,20092,-2,13280.0,2,13285.0,2,S
2018-04-27 10:57:28,13285.0,12,20104,10,13280.0,13,13285.0,3,B
2018-04-27 10:57:29,13285.0,16,20120,12,13280.0,18,13290.0,12,B
2018-04-27 10:57:33,13285.0,4,20124,-4,13285.0,6,13290.0,6,B
2018-04-27 10:57:36,13290.0,8,20132,-2,13285.0,21,13295.0,7,B
2018-04-27 10:57:43,13290.0,2,20134,0,13290.0,3,13295.0,9,B
2018-04-27 10:57:44,13285.0,12,20146,-2,13280.0,22,13290.0,8,S
2018-04-27 10:57:47,13290.0,16,20162,-6,13290.0,2,13295.0,10,B
2018-04-27 10:57:51,13290.0,2,20164,0,13290.0,18,13295.0,4,B
2018-04-27 10:57:52,13290.0,2,20166,0,13290.0,19,13295.0,4,B
2018-04-27 10:57:55,13295.0,6,20172,-4,13290.0,12,13295.0,7,B
2018-04-27 10:58:03,13290.0,2,20174,0,13290.0,10,13295.0,11,S
2018-04-27 10:58:04,13290.0,20,20194,-14,13285.0,12,13295.0,11,S
2018-04-27 10:58:06,13285.0,2,20196,0,13280.0,17,13290.0,10,S
2018-04-27 10:58:07,13290.0,2,20198,-2,13280.0,17,13290.0,11,B
2018-04-27 10:58:08,13290.0,4,20202,-2,13280.0,17,13290.0,11,B
2018-04-27 10:58:09,13280.0,4,20206,-4,13280.0,15,13290.0,11,S
2018-04-27 10:58:10,13290.0,4,20210,0,13285.0,12,13295.0,9,B
2018-04-27 10:58:18,13285.0,16,20226,6,13280.0,15,13290.0,11,S
2018-04-27 10:58:20,13285.0,12,20238,8,13280.0,13,13290.0,12,S
2018-04-27 10:58:22,13285.0,2,20240,0,13285.0,2,13290.0,13,S
2018-04-27 10:58:22,13280.0,2,20242,0,13280.0,16,13290.0,13,S
2018-04-27 10:58:23,13280.0,2,20244,2,13285.0,12,13290.0,2,S
2018-04-27 10:58:24,13290.0,2,20246,-2,13285.0,14,13295.0,8,B
2018-04-27 10:58:25,13290.0,12,20258,12,13285.0,17,13295.0,12,B
2018-04-27 10:58:26,13285.0,2,20260,2,13285.0,17,13295.0,12,S
2018-04-27 10:58:30,13295.0,2,20262,0,13285.0,16,13295.0,11,B
2018-04-27 10:58:33,13290.0,2,20264,0,13290.0,2,13295.0,10,S
2018-04-27 10:58:38,13295.0,2,20266,2,13290.0,3,13295.0,8,B
2018-04-27 10:58:44,13290.0,2,20268,2,13290.0,3,13295.0,13,S
2018-04-27 10:58:45,13290.0,2,20270,0,13290.0,2,13295.0,13,S
2018-04-27 10:58:49,13290.0,2,20272,0,13290.0,1,13295.0,20,S
2018-04-27 10:58:54,13295.0,2,20274,2,13290.0,6,13295.0,6,B
2018-04-27 10:58:59,13295.0,4,20278,0,13290.0,7,13295.0,8,B
2018-04-27 10:59:01,13295.0,2,20280,-2,13290.0,8,13295.0,6,B
2018-04-27 10:59:01,13295.0,2,20282,-2,13290.0,11,13295.0,5,B
2018-04-27 10:59:04,13295.0,4,20286,-2,13290.0,12,13295.0,3,B
2018-04-27 10:59:05,13295.0,2,20288,-2,13290.0,12,13295.0,2,B
2018-04-27 10:59:06,13295.0,4,20292,0,13295.0,1,13300.0,5,B
2018-04-27 10:59:07,13295.0,2,20294,0,13290.0,10,13295.0,17,B
2018-04-27 10:59:08,13295.0,2,20296,0,13290.0,7,13295.0,10,B
2018-04-27 10:59:10,13295.0,6,20302,2,13290.0,7,13295.0,7,B
2018-04-27 10:59:11,13295.0,2,20304,2,13290.0,6,13295.0,6,B
2018-04-27 10:59:13,13295.0,2,20306,2,13290.0,7,13295.0,6,B
2018-04-27 10:59:15,13290.0,4,20310,4,13290.0,5,13295.0,6,S
2018-04-27 10:59:16,13295.0,4,20314,0,13290.0,5,13295.0,5,B
2018-04-27 10:59:17,13290.0,2,20316,2,13290.0,5,13295.0,5,S
2018-04-27 10:59:20,13290.0,4,20320,0,13290.0,6,13295.0,4,S
2018-04-27 10:59:24,13295.0,2,20322,0,13290.0,5,13295.0,8,B
2018-04-27 10:59:25,13290.0,6,20328,2,13285.0,14,13290.0,1,S
2018-04-27 10:59:26,13285.0,10,20338,2,13280.0,13,13285.0,3,S
2018-04-27 10:59:26,13285.0,6,20344,6,13280.0,11,13285.0,5,S
2018-04-27 10:59:27,13285.0,12,20356,8,13280.0,10,13290.0,27,S
2018-04-27 10:59:28,13280.0,30,20386,-24,13275.0,4,13285.0,2,S
2018-04-27 10:59:28,13275.0,8,20394,4,13270.0,8,13275.0,7,S
2018-04-27 10:59:29,13275.0,20,20414,12,13270.0,4,13280.0,6,S
2018-04-27 10:59:29,13275.0,2,20416,0,13270.0,6,13275.0,2,S
2018-04-27 10:59:31,13275.0,6,20422,-4,13275.0,10,13280.0,7,S
2018-04-27 10:59:31,13270.0,28,20450,8,13270.0,7,13280.0,4,S
2018-04-27 10:59:32,13270.0,12,20462,-6,13270.0,2,13275.0,1,S
2018-04-27 10:59:32,13270.0,8,20470,-2,13270.0,4,13280.0,13,S
2018-04-27 10:59:36,13270.0,2,20472,0,13270.0,7,13275.0,1,S
2018-04-27 10:59:37,13275.0,2,20474,0,13270.0,7,13280.0,15,B
2018-04-27 10:59:40,13275.0,2,20476,0,13275.0,1,13280.0,15,B
2018-04-27 10:59:42,13280.0,22,20498,0,13280.0,2,13285.0,11,B
2018-04-27 10:59:42,13275.0,8,20506,-4,13275.0,10,13285.0,10,S
2018-04-27 10:59:44,13275.0,4,20510,0,13275.0,7,13285.0,11,S
2018-04-27 10:59:46,13285.0,2,20512,2,13275.0,15,13285.0,10,B
2018-04-27 10:59:47,13280.0,2,20514,2,13280.0,2,13285.0,9,S
2018-04-27 10:59:47,13280.0,2,20516,2,13275.0,17,13285.0,9,S
2018-04-27 10:59:48,13270.0,52,20568,4,13265.0,6,13270.0,4,S
2018-04-27 10:59:48,13275.0,18,20586,8,13270.0,17,13280.0,6,B
2018-04-27 10:59:51,13270.0,14,20600,-12,13265.0,4,13275.0,6,S
2018-04-27 10:59:52,13265.0,4,20604,0,13265.0,2,13270.0,8,S
2018-04-27 10:59:53,13260.0,12,20616,2,13260.0,16,13265.0,9,S
2018-04-27 10:59:53,13260.0,8,20624,0,13260.0,10,13265.0,6,S
2018-04-27 10:59:54,13260.0,20,20644,-16,13255.0,4,13260.0,1,S
2018-04-27 10:59:54,13260.0,2,20646,-2,13255.0,8,13260.0,1,S
2018-04-27 10:59:55,13260.0,2,20648,2,13260.0,1,13265.0,13,S
2018-04-27 10:59:55,13260.0,2,20650,-2,13260.0,8,13265.0,8,S
2018-04-27 10:59:57,13265.0,4,20654,0,13260.0,13,13265.0,1,B
2018-04-27 10:59:59,13270.0,10,20664,-10,13260.0,6,13270.0,9,B
2018-04-27 11:00:00,13265.0,12,20676,10,13260.0,6,13270.0,8,S
2018-04-27 11:00:01,13260.0,10,20686,-2,13260.0,1,13265.0,4,S
2018-04-27 11:00:01,13255.0,4,20690,0,13255.0,8,13260.0,20,S
2018-04-27 11:00:02,13255.0,48,20738,24,13255.0,2,13265.0,18,S
2018-04-27 11:00:03,13260.0,4,20742,4,13260.0,9,13265.0,18,B
2018-04-27 11:00:03,13260.0,18,20760,-14,13260.0,1,13265.0,7,B
2018-04-27 11:00:04,13265.0,8,20768,8,13265.0,10,13270.0,6,B
2018-04-27 11:00:04,13260.0,24,20792,-12,13260.0,3,13265.0,2,S
2018-04-27 11:00:05,13260.0,4,20796,0,13260.0,2,13265.0,20,S
2018-04-27 11:00:05,13260.0,4,20800,-4,13255.0,9,13265.0,20,S
2018-04-27 11:00:08,13255.0,14,20814,-6,13250.0,29,13260.0,15,S
2018-04-27 11:00:09,13255.0,2,20816,2,13250.0,29,13255.0,5,S
2018-04-27 11:00:10,13250.0,18,20834,-4,13250.0,20,13255.0,12,S
2018-04-27 11:00:10,13240.0,50,20884,10,13235.0,5,13250.0,10,S
2018-04-27 11:00:11,13250.0,18,20902,6,13240.0,4,13250.0,9,B
2018-04-27 11:00:11,13250.0,10,20912,-6,13245.0,4,13250.0,4,B
2018-04-27 11:00:12,13250.0,2,20914,-2,13245.0,4,13250.0,10,B
2018-04-27 11:00:13,13240.0,12,20926,0,13245.0,1,13250.0,10,S
2018-04-27 11:00:14,13250.0,2,20928,0,13245.0,1,13250.0,9,B
2018-04-27 11:00:16,13245.0,2,20930,2,13245.0,1,13250.0,9,S
2018-04-27 11:00:17,13250.0,22,20952,-10,13245.0,5,13250.0,7,B
2018-04-27 11:00:18,13245.0,4,20956,4,13245.0,2,13250.0,7,S
2018-04-27 11:00:18,13245.0,4,20960,0,13245.0,1,13250.0,7,S
2018-04-27 11:00:19,13245.0,2,20962,0,13240.0,25,13245.0,4,S
2018-04-27 11:00:20,13240.0,36,20998,-8,13235.0,9,13245.0,17,S
2018-04-27 11:00:21,13240.0,2,21000,0,13235.0,8,13245.0,18,S
2018-04-27 11:00:23,13240.0,2,21002,2,13235.0,5,13240.0,5,S
2018-04-27 11:00:23,13240.0,6,21008,-6,13235.0,6,13245.0,17,S
2018-04-27 11:00:24,13235.0,4,21012,-2,13235.0,8,13245.0,14,S
2018-04-27 11:00:27,13235.0,2,21014,0,13235.0,6,13240.0,4,S
2018-04-27 11:00:28,13235.0,2,21016,0,13235.0,3,13240.0,9,S
2018-04-27 11:00:29,13245.0,20,21036,10,13235.0,5,13245.0,15,B
2018-04-27 11:00:31,13235.0,2,21038,-2,13235.0,7,13245.0,11,S
2018-04-27 11:00:31,13245.0,2,21040,0,13240.0,2,13245.0,7,B
2018-04-27 11:00:32,13245.0,12,21052,8,13240.0,6,13250.0,16,B
2018-04-27 11:00:33,13240.0,2,21054,0,13240.0,4,13245.0,2,S
2018-04-27 11:00:34,13240.0,4,21058,-2,13240.0,4,13245.0,6,S
2018-04-27 11:00:35,13245.0,16,21074,-8,13235.0,7,13245.0,3,B
2018-04-27 11:00:35,13245.0,2,21076,0,13240.0,7,13245.0,2,B
2018-04-27 11:00:37,13240.0,4,21080,-4,13240.0,4,13245.0,4,S
2018-04-27 11:00:37,13245.0,2,21082,0,13240.0,5,13245.0,3,B
2018-04-27 11:00:38,13240.0,2,21084,0,13240.0,4,13245.0,5,S
2018-04-27 11:00:40,13240.0,2,21086,-2,13240.0,5,13245.0,6,S
2018-04-27 11:00:42,13245.0,4,21090,0,13240.0,9,13250.0,16,B
2018-04-27 11:00:43,13240.0,2,21092,0,13240.0,13,13245.0,2,S
2018-04-27 11:00:44,13245.0,4,21096,4,13245.0,11,13250.0,9,B
2018-04-27 11:00:46,13245.0,14,21110,8,13240.0,10,13245.0,9,B
2018-04-27 11:00:46,13240.0,12,21122,-10,13240.0,2,13245.0,4,S
2018-04-27 11:00:48,13245.0,2,21124,0,13240.0,3,13245.0,1,B
2018-04-27 11:00:50,13240.0,6,21130,-2,13235.0,19,13240.0,1,S
2018-04-27 11:00:50,13240.0,4,21134,2,13235.0,14,13240.0,5,S
2018-04-27 11:00:53,13240.0,6,21140,6,13235.0,15,13245.0,12,S
2018-04-27 11:00:55,13245.0,2,21142,0,13240.0,8,13245.0,11,B
2018-04-27 11:00:57,13240.0,4,21146,2,13240.0,8,13245.0,10,S
2018-04-27 11:00:57,13240.0,10,21156,-4,13240.0,3,13245.0,10,S
2018-04-27 11:00:58,13240.0,6,21162,-6,13235.0,15,13240.0,3,S
2018-04-27 11:01:00,13240.0,8,21170,0,13240.0,2,13245.0,11,S
2018-04-27 11:01:00,13240.0,4,21174,0,13235.0,17,13245.0,10,S
2018-04-27 11:01:02,13240.0,6,21180,0,13240.0,7,13245.0,11,S
2018-04-27 11:01:04,13245.0,6,21186,2,13240.0,12,13250.0,15,B
2018-04-27 11:01:06,13245.0,2,21188,0,13240.0,20,13250.0,13,B
2018-04-27 11:01:07,13250.0,2,21190,0,13240.0,20,13250.0,11,B
2018-04-27 11:01:08,13245.0,6,21196,0,13240.0,21,13250.0,9,S
2018-04-27 11:01:09,13250.0,2,21198,-2,13245.0,8,13250.0,4,B
2018-04-27 11:01:09,13250.0,8,21206,2,13245.0,12,13255.0,7,B
2018-04-27 11:01:10,13245.0,2,21208,2,13245.0,14,13255.0,7,S
2018-04-27 11:01:12,13255.0,8,21216,-4,13250.0,16,13260.0,8,B
2018-04-27 11:01:16,13260.0,10,21226,-4,13260.0,4,13265.0,6,B
2018-04-27 11:01:16,13260.0,2,21228,0,13260.0,8,13265.0,3,B
2018-04-27 11:01:17,13260.0,6,21234,4,13260.0,7,13265.0,2,B
2018-04-27 11:01:17,13260.0,2,21236,0,13260.0,6,13265.0,2,B
2018-04-27 11:01:20,13260.0,14,21250,10,13255.0,18,13265.0,7,B
2018-04-27 11:01:20,13260.0,2,21252,0,13255.0,16,13260.0,3,B
2018-04-27 11:01:21,13260.0,6,21258,-4,13260.0,2,13265.0,13,B
2018-04-27 11:01:22,13260.0,2,21260,0,13260.0,8,13265.0,6,B
2018-04-27 11:01:25,13265.0,2,21262,0,13260.0,12,13265.0,4,B
2018-04-27 11:01:26,13265.0,2,21264,0,13260.0,12,13265.0,3,B
2018-04-27 11:01:26,13265.0,6,21270,4,13265.0,1,13270.0,3,B
2018-04-27 11:01:27,13265.0,4,21274,2,13260.0,14,13270.0,6,B
2018-04-27 11:01:28,13265.0,2,21276,2,13265.0,5,13270.0,3,B
2018-04-27 11:01:28,13265.0,2,21278,0,13265.0,4,13270.0,3,B
2018-04-27 11:01:32,13270.0,4,21282,2,13265.0,10,13270.0,1,B
2018-04-27 11:01:37,13270.0,6,21288,4,13270.0,7,13275.0,6,B
2018-04-27 11:01:37,13265.0,22,21310,14,13265.0,7,13275.0,6,S
2018-04-27 11:01:40,13265.0,8,21318,0,13260.0,13,13270.0,12,S
2018-04-27 11:01:41,13270.0,8,21326,0,13260.0,13,13270.0,11,B
2018-04-27 11:01:42,13270.0,2,21328,-2,13260.0,13,13270.0,10,B
2018-04-27 11:01:42,13270.0,2,21330,0,13260.0,13,13270.0,10,B
2018-04-27 11:01:44,13270.0,2,21332,2,13260.0,14,13270.0,10,B
2018-04-27 11:01:45,13270.0,6,21338,6,13260.0,13,13270.0,8,B
2018-04-27 11:01:46,13260.0,2,21340,-2,13260.0,4,13265.0,16,S
2018-04-27 11:01:46,13260.0,2,21342,-2,13260.0,4,13265.0,17,S
2018-04-27 11:01:48,13265.0,2,21344,2,13260.0,5,13265.0,14,B
2018-04-27 11:01:50,13265.0,20,21364,8,13260.0,5,13265.0,1,B
2018-04-27 11:01:50,13260.0,4,21368,0,13260.0,12,13270.0,9,S
2018-04-27 11:02:00,13260.0,2,21370,-2,13260.0,11,13265.0,15,S
2018-04-27 11:02:01,13260.0,6,21376,0,13255.0,17,13265.0,15,S
2018-04-27 11:02:04,13265.0,6,21382,-6,13260.0,13,13265.0,12,B
2018-04-27 11:02:05,13265.0,2,21384,-2,13260.0,13,13265.0,11,B
2018-04-27 11:02:06,13260.0,2,21386,0,13260.0,12,13265.0,11,S
2018-04-27 11:02:09,13265.0,22,21408,10,13260.0,15,13265.0,1,B
2018-04-27 11:02:10,13265.0,2,21410,-2,13260.0,15,13270.0,16,B
2018-04-27 11:02:16,13265.0,2,21412,0,13265.0,5,13270.0,16,B
2018-04-27 11:02:16,13265.0,2,21414,0,13265.0,4,13270.0,16,B
2018-04-27 11:02:17,13265.0,2,21416,0,13265.0,3,13270.0,15,B
2018-04-27 11:02:17,13265.0,2,21418,0,13265.0,2,13270.0,15,B
2018-04-27 11:02:18,13270.0,4,21422,0,13265.0,2,13270.0,13,B
2018-04-27 11:02:19,13265.0,2,21424,0,13265.0,2,13270.0,13,S
2018-04-27 11:02:19,13265.0,2,21426,0,13260.0,9,13270.0,13,S
2018-04-27 11:02:20,13270.0,12,21438,-12,13265.0,27,13270.0,4,B
2018-04-27 11:02:21,13270.0,4,21442,0,13265.0,27,13270.0,2,B
2018-04-27 11:02:21,13270.0,4,21446,-4,13270.0,1,13275.0,6,B
2018-04-27 11:02:22,13270.0,2,21448,2,13265.0,23,13275.0,6,B
2018-04-27 11:02:23,13270.0,2,21450,2,13270.0,1,13275.0,6,B
2018-04-27 11:02:24,13270.0,2,21452,2,13270.0,2,13275.0,6,B
2018-04-27 11:02:25,13275.0,2,21454,2,13270.0,6,13275.0,4,B
2018-04-27 11:02:26,13275.0,2,21456,0,13270.0,7,13275.0,3,B
2018-04-27 11:02:26,13270.0,2,21458,0,13270.0,4,13275.0,4,S
2018-04-27 11:02:28,13270.0,12,21470,8,13265.0,32,13275.0,4,S
2018-04-27 11:02:29,13275.0,2,21472,0,13270.0,8,13275.0,5,B
2018-04-27 11:02:32,13275.0,2,21474,2,13270.0,8,13275.0,7,B
2018-04-27 11:02:35,13275.0,4,21478,-2,13270.0,11,13280.0,5,B
2018-04-27 11:02:35,13270.0,8,21486,2,13270.0,12,13280.0,6,S
2018-04-27 11:02:38,13280.0,2,21488,0,13275.0,1,13280.0,9,B
2018-04-27 11:02:40,13280.0,4,21492,0,13275.0,1,13280.0,9,B
2018-04-27 11:02:40,13275.0,4,21496,-2,13270.0,12,13280.0,9,S
2018-04-27 11:02:42,13275.0,2,21498,-2,13270.0,10,13275.0,3,S
2018-04-27 11:02:44,13275.0,2,21500,0,13270.0,9,13275.0,4,S
2018-04-27 11:02:45,13275.0,6,21506,-2,13270.0,9,13275.0,1,S
2018-04-27 11:02:47,13275.0,4,21510,4,13270.0,11,13280.0,10,S
2018-04-27 11:02:51,13270.0,6,21516,-4,13270.0,10,13275.0,2,S
2018-04-27 11:02:51,13275.0,2,21518,0,13270.0,10,13275.0,1,B
2018-04-27 11:02:54,13275.0,2,21520,2,13270.0,8,13275.0,3,B
2018-04-27 11:03:01,13275.0,2,21522,2,13270.0,10,13275.0,6,B
2018-04-27 11:03:03,13275.0,2,21524,2,13270.0,9,13275.0,1,B
2018-04-27 11:03:08,13270.0,2,21526,0,13270.0,8,13275.0,1,S
2018-04-27 11:03:16,13275.0,4,21530,4,13270.0,6,13280.0,8,B
2018-04-27 11:03:23,13270.0,2,21532,0,13270.0,2,13275.0,7,S
2018-04-27 11:03:25,13270.0,2,21534,0,13265.0,19,13275.0,7,S
2018-04-27 11:03:29,13270.0,6,21540,-2,13265.0,3,13270.0,10,S
2018-04-27 11:03:32,13270.0,2,21542,2,13265.0,6,13270.0,3,S
2018-04-27 11:03:32,13270.0,2,21544,0,13265.0,6,13270.0,2,S
2018-04-27 11:03:34,13270.0,2,21546,2,13265.0,6,13270.0,1,S
2018-04-27 11:03:39,13270.0,2,21548,0,13265.0,7,13275.0,11,S
2018-04-27 11:03:41,13270.0,4,21552,-2,13265.0,14,13275.0,9,S
2018-04-27 11:03:55,13270.0,4,21556,2,13265.0,13,13270.0,1,S
2018-04-27 11:04:01,13265.0,6,21562,4,13265.0,1,13270.0,17,S
2018-04-27 11:04:10,13265.0,2,21564,0,13265.0,5,13270.0,19,S
2018-04-27 11:04:18,13265.0,4,21568,-4,13265.0,9,13270.0,6,S
2018-04-27 11:04:27,13270.0,2,21570,0,13265.0,9,13270.0,5,B
2018-04-27 11:04:32,13265.0,2,21572,-2,13265.0,3,13270.0,17,S
2018-04-27 11:04:37,13265.0,4,21576,0,13265.0,10,13270.0,8,S
2018-04-27 11:04:45,13270.0,14,21590,10,13270.0,1,13275.0,11,B
2018-04-27 11:04:46,13270.0,12,21602,-2,13265.0,12,13275.0,8,B
2018-04-27 11:04:50,13270.0,2,21604,0,13265.0,11,13275.0,12,B
2018-04-27 11:04:53,13275.0,6,21610,-4,13270.0,10,13280.0,5,B
2018-04-27 11:05:09,13270.0,4,21614,2,13265.0,13,13275.0,8,S
2018-04-27 11:05:10,13275.0,4,21618,-4,13265.0,13,13275.0,6,B
2018-04-27 11:05:15,13275.0,2,21620,2,13265.0,14,13275.0,6,B
2018-04-27 11:05:18,13265.0,4,21624,0,13265.0,13,13275.0,13,S
2018-04-27 11:05:22,13270.0,4,21628,0,13265.0,13,13270.0,3,B
2018-04-27 11:05:29,13265.0,2,21630,2,13265.0,12,13270.0,2,S
2018-04-27 11:05:35,13270.0,4,21634,0,13270.0,3,13275.0,20,B
2018-04-27 11:05:53,13270.0,2,21636,0,13270.0,3,13275.0,27,B
2018-04-27 11:05:58,13270.0,6,21642,0,13265.0,12,13275.0,29,B
2018-04-27 11:06:04,13265.0,2,21644,0,13265.0,6,13270.0,1,S
2018-04-27 11:06:05,13265.0,2,21646,0,13265.0,4,13270.0,7,S
2018-04-27 11:06:05,13265.0,2,21648,2,13260.0,9,13270.0,11,S
2018-04-27 11:06:07,13270.0,2,21650,0,13260.0,11,13270.0,12,B
2018-04-27 11:06:13,13265.0,2,21652,-2,13260.0,19,13270.0,11,S
2018-04-27 11:06:18,13265.0,2,21654,-2,13260.0,19,13270.0,10,S
2018-04-27 11:06:19,13260.0,2,21656,0,13260.0,18,13270.0,10,S
2018-04-27 11:06:22,13260.0,2,21658,2,13260.0,7,13265.0,10,S
2018-04-27 11:06:22,13260.0,4,21662,4,13260.0,5,13265.0,12,S
2018-04-27 11:06:23,13260.0,2,21664,0,13260.0,4,13265.0,10,S
2018-04-27 11:06:26,13260.0,2,21666,-2,13260.0,3,13265.0,10,S
2018-04-27 11:06:27,13260.0,6,21672,-6,13255.0,17,13260.0,6,S
2018-04-27 11:06:34,13260.0,2,21674,0,13255.0,20,13260.0,5,S
2018-04-27 11:06:35,13255.0,10,21684,-10,13255.0,16,13260.0,5,S
2018-04-27 11:06:36,13255.0,2,21686,-2,13255.0,15,13260.0,5,S
2018-04-27 11:06:40,13260.0,12,21698,0,13260.0,4,13265.0,13,B
2018-04-27 11:06:41,13260.0,8,21706,0,13255.0,21,13265.0,13,B
2018-04-27 11:06:50,13265.0,4,21710,0,13260.0,4,13265.0,5,B
2018-04-27 11:07:02,13260.0,4,21714,4,13260.0,8,13265.0,12,S
2018-04-27 11:07:02,13260.0,8,21722,0,13260.0,4,13265.0,12,S
2018-04-27 11:07:03,13260.0,8,21730,-8,13255.0,21,13260.0,2,S
2018-04-27 11:07:05,13260.0,4,21734,-4,13255.0,19,13265.0,12,S
2018-04-27 11:07:07,13260.0,10,21744,0,13260.0,5,13265.0,4,S
2018-04-27 11:07:18,13265.0,4,21748,0,13260.0,13,13270.0,7,B
2018-04-27 11:07:18,13260.0,2,21750,2,13260.0,12,13270.0,8,S
2018-04-27 11:07:25,13260.0,2,21752,0,13260.0,14,13270.0,9,S
2018-04-27 11:07:32,13270.0,6,21758,-2,13270.0,17,13275.0,21,B
2018-04-27 11:07:33,13270.0,4,21762,-2,13270.0,15,13275.0,22,B
2018-04-27 11:07:34,13270.0,2,21764,0,13270.0,14,13275.0,23,B
2018-04-27 11:07:34,13270.0,2,21766,-2,13270.0,13,13275.0,23,B
2018-04-27 11:07:37,13270.0,10,21776,-10,13270.0,8,13275.0,20,B
2018-04-27 11:07:53,13270.0,2,21778,0,13270.0,7,13275.0,19,B
2018-04-27 11:07:53,13270.0,2,21780,0,13270.0,6,13275.0,19,B
2018-04-27 11:07:54,13270.0,4,21784,-2,13270.0,5,13275.0,18,B
2018-04-27 11:07:54,13270.0,2,21786,0,13270.0,4,13275.0,18,B
2018-04-27 11:07:55,13270.0,4,21790,0,13270.0,2,13275.0,18,B
2018-04-27 11:07:55,13270.0,2,21792,0,13270.0,1,13275.0,18,B
2018-04-27 11:07:56,13270.0,2,21794,0,13265.0,11,13275.0,18,B
2018-04-27 11:08:00,13270.0,2,21796,2,13270.0,4,13275.0,19,B
2018-04-27 11:08:00,13270.0,8,21804,0,13265.0,10,13270.0,6,B
2018-04-27 11:08:03,13265.0,4,21808,-2,13265.0,3,13270.0,11,S
2018-04-27 11:08:04,13265.0,6,21814,0,13260.0,8,13265.0,3,S
2018-04-27 11:08:05,13265.0,4,21818,4,13260.0,8,13265.0,1,S
2018-04-27 11:08:06,13265.0,2,21820,2,13260.0,8,13270.0,14,S
2018-04-27 11:08:12,13265.0,2,21822,0,13265.0,3,13270.0,14,S
2018-04-27 11:08:13,13265.0,2,21824,2,13265.0,10,13270.0,4,S
2018-04-27 11:08:19,13265.0,8,21832,4,13260.0,13,13270.0,12,S
2018-04-27 11:08:28,13265.0,2,21834,0,13260.0,13,13265.0,1,S
2018-04-27 11:08:28,13260.0,10,21844,-4,13260.0,7,13265.0,1,S
2018-04-27 11:08:29,13260.0,4,21848,0,13260.0,5,13265.0,1,S
2018-04-27 11:08:31,13260.0,8,21856,0,13255.0,35,13260.0,2,S
2018-04-27 11:08:31,13260.0,4,21860,0,13255.0,35,13265.0,16,S
2018-04-27 11:08:32,13260.0,2,21862,2,13255.0,35,13265.0,16,S
2018-04-27 11:08:41,13260.0,2,21864,2,13260.0,4,13265.0,13,S
2018-04-27 11:08:44,13260.0,10,21874,8,13260.0,2,13265.0,13,S
2018-04-27 11:08:45,13260.0,4,21878,4,13255.0,38,13260.0,2,S
2018-04-27 11:08:53,13260.0,2,21880,2,13255.0,32,13260.0,10,S
2018-04-27 11:08:54,13260.0,10,21890,-8,13255.0,32,13260.0,5,S
2018-04-27 11:08:56,13255.0,4,21894,-4,13255.0,30,13260.0,6,S
2018-04-27 11:08:56,13255.0,4,21898,-2,13255.0,28,13260.0,6,S
2018-04-27 11:08:57,13255.0,2,21900,2,13255.0,27,13260.0,6,S
2018-04-27 11:08:57,13260.0,4,21904,-2,13255.0,26,13260.0,5,B
2018-04-27 11:08:58,13255.0,2,21906,2,13255.0,25,13260.0,5,S
2018-04-27 11:08:58,13255.0,2,21908,2,13255.0,24,13260.0,5,S
2018-04-27 11:08:59,13255.0,2,21910,2,13255.0,23,13260.0,5,S
2018-04-27 11:08:59,13255.0,10,21920,8,13255.0,18,13260.0,5,S
2018-04-27 11:09:00,13260.0,6,21926,4,13255.0,18,13265.0,26,B
2018-04-27 11:09:01,13255.0,2,21928,2,13255.0,18,13260.0,2,S
2018-04-27 11:09:01,13255.0,2,21930,2,13255.0,17,13260.0,2,S
2018-04-27 11:09:02,13255.0,2,21932,2,13255.0,16,13260.0,2,S
2018-04-27 11:09:02,13255.0,2,21934,2,13255.0,14,13260.0,2,S
2018-04-27 11:09:03,13255.0,2,21936,2,13255.0,12,13260.0,2,S
2018-04-27 11:09:03,13260.0,4,21940,4,13255.0,11,13260.0,2,B
2018-04-27 11:09:04,13255.0,2,21942,2,13255.0,10,13260.0,2,S
2018-04-27 11:09:04,13255.0,2,21944,2,13255.0,9,13260.0,3,S
2018-04-27 11:09:05,13255.0,2,21946,2,13255.0,8,13260.0,3,S
2018-04-27 11:09:05,13255.0,2,21948,2,13255.0,7,13260.0,4,S
2018-04-27 11:09:06,13255.0,2,21950,2,13255.0,6,13260.0,4,S
2018-04-27 11:09:06,13255.0,8,21958,2,13255.0,2,13260.0,9,S
2018-04-27 11:09:07,13255.0,12,21970,8,13250.0,15,13255.0,1,S
2018-04-27 11:09:07,13255.0,2,21972,0,13255.0,2,13260.0,4,S
2018-04-27 11:09:08,13250.0,2,21974,2,13250.0,15,13260.0,6,S
2018-04-27 11:09:08,13250.0,2,21976,0,13250.0,14,13260.0,7,S
2018-04-27 11:09:11,13250.0,2,21978,0,13250.0,12,13255.0,5,S
2018-04-27 11:09:12,13250.0,24,22002,8,13245.0,4,13250.0,4,S
2018-04-27 11:09:13,13250.0,10,22012,6,13250.0,2,13255.0,9,S
2018-04-27 11:09:16,13245.0,2,22014,0,13245.0,13,13255.0,8,S
2018-04-27 11:09:21,13245.0,4,22018,4,13245.0,11,13255.0,9,S
2018-04-27 11:09:22,13255.0,4,22022,-2,13255.0,1,13260.0,15,B
2018-04-27 11:09:23,13250.0,4,22026,-2,13250.0,10,13260.0,11,S
2018-04-27 11:09:27,13250.0,4,22030,-2,13245.0,9,13255.0,10,S
2018-04-27 11:09:45,13250.0,6,22036,6,13245.0,11,13250.0,2,S
2018-04-27 11:09:46,13245.0,8,22044,2,13245.0,1,13250.0,4,S
2018-04-27 11:09:51,13245.0,2,22046,2,13240.0,12,13250.0,8,S
2018-04-27 11:09:58,13240.0,6,22052,-6,13240.0,4,13245.0,9,S
2018-04-27 11:09:58,13240.0,8,22060,-2,13235.0,16,13240.0,15,S
2018-04-27 11:09:59,13235.0,10,22070,8,13235.0,10,13240.0,11,S
2018-04-27 11:10:00,13225.0,36,22106,22,13225.0,8,13235.0,42,S
2018-04-27 11:10:00,13225.0,28,22134,10,13220.0,3,13225.0,6,S
2018-04-27 11:10:01,13225.0,16,22150,8,13220.0,4,13230.0,11,S
2018-04-27 11:10:01,13230.0,24,22174,16,13230.0,12,13235.0,22,B
2018-04-27 11:10:02,13235.0,40,22214,-6,13230.0,8,13235.0,2,B
2018-04-27 11:10:02,13230.0,16,22230,-12,13225.0,10,13230.0,4,S
2018-04-27 11:10:03,13235.0,20,22250,-10,13230.0,6,13240.0,12,B
2018-04-27 11:10:04,13235.0,10,22260,6,13230.0,13,13235.0,3,B
2018-04-27 11:10:05,13230.0,6,22266,-2,13225.0,11,13230.0,2,S
2018-04-27 11:10:06,13235.0,6,22272,2,13230.0,17,13235.0,7,B
2018-04-27 11:10:06,13235.0,16,22288,-10,13230.0,6,13240.0,12,B
2018-04-27 11:10:07,13230.0,16,22304,4,13230.0,4,13240.0,14,S
2018-04-27 11:10:10,13230.0,4,22308,4,13225.0,12,13230.0,2,S
2018-04-27 11:10:11,13225.0,6,22314,2,13225.0,8,13230.0,10,S
2018-04-27 11:10:11,13225.0,22,22336,8,13225.0,9,13235.0,8,S
2018-04-27 11:10:13,13225.0,6,22342,-2,13225.0,14,13235.0,7,S
2018-04-27 11:10:16,13235.0,2,22344,0,13225.0,8,13235.0,19,B
2018-04-27 11:10:17,13235.0,30,22374,4,13235.0,5,13240.0,7,B
2018-04-27 11:10:18,13235.0,2,22376,0,13240.0,1,13245.0,8,B
2018-04-27 11:10:18,13240.0,2,22378,0,13235.0,21,13240.0,5,B
2018-04-27 11:10:19,13235.0,6,22384,0,13235.0,18,13240.0,8,S
2018-04-27 11:10:19,13235.0,4,22388,0,13235.0,16,13240.0,6,S
2018-04-27 11:10:20,13235.0,4,22392,0,13235.0,12,13240.0,4,S
2018-04-27 11:10:20,13240.0,6,22398,0,13235.0,12,13240.0,1,B
2018-04-27 11:10:22,13240.0,2,22400,2,13235.0,14,13240.0,4,B
2018-04-27 11:10:23,13240.0,8,22408,8,13240.0,12,13245.0,11,B
2018-04-27 11:10:28,13245.0,10,22418,0,13245.0,5,13250.0,8,B
2018-04-27 11:10:30,13245.0,6,22424,-6,13245.0,3,13255.0,12,B
2018-04-27 11:10:32,13245.0,4,22428,-4,13245.0,7,13255.0,12,B
2018-04-27 11:10:33,13250.0,2,22430,0,13245.0,9,13255.0,10,B
2018-04-27 11:10:39,13250.0,2,22432,0,13245.0,6,13250.0,4,B
2018-04-27 11:10:41,13245.0,2,22434,0,13245.0,5,13250.0,5,S
2018-04-27 11:10:43,13250.0,10,22444,-2,13245.0,9,13255.0,14,B
2018-04-27 11:10:44,13245.0,4,22448,0,13245.0,8,13255.0,14,S
2018-04-27 11:10:59,13250.0,6,22454,0,13250.0,3,13255.0,11,B
2018-04-27 11:11:00,13250.0,2,22456,0,13250.0,2,13255.0,11,B
2018-04-27 11:11:00,13250.0,2,22458,2,13250.0,1,13255.0,11,B
2018-04-27 11:11:01,13245.0,4,22462,2,13245.0,15,13255.0,11,S
2018-04-27 11:11:04,13245.0,8,22470,0,13245.0,12,13255.0,11,S
2018-04-27 11:11:05,13245.0,2,22472,2,13250.0,2,13255.0,12,S
2018-04-27 11:11:07,13255.0,2,22474,0,13250.0,2,13255.0,10,B
2018-04-27 11:11:09,13255.0,2,22476,0,13250.0,2,13255.0,9,B
2018-04-27 11:11:10,13255.0,2,22478,0,13250.0,2,13255.0,8,B
2018-04-27 11:11:10,13255.0,2,22480,0,13250.0,2,13255.0,6,B
2018-04-27 11:11:13,13250.0,6,22486,-6,13245.0,15,13250.0,1,S
2018-04-27 11:11:14,13245.0,4,22490,2,13245.0,9,13255.0,11,S
2018-04-27 11:11:15,13245.0,4,22494,4,13250.0,6,13255.0,7,S
2018-04-27 11:11:21,13255.0,14,22508,-6,13255.0,3,13260.0,23,B
2018-04-27 11:11:21,13255.0,6,22514,4,13255.0,6,13260.0,20,B
2018-04-27 11:11:22,13260.0,42,22556,0,13255.0,6,13265.0,2,B
2018-04-27 11:11:23,13265.0,10,22566,-4,13260.0,11,13270.0,3,B
2018-04-27 11:11:24,13265.0,12,22578,6,13260.0,11,13265.0,1,B
2018-04-27 11:11:24,13265.0,10,22588,8,13265.0,2,13270.0,11,B
2018-04-27 11:11:25,13265.0,2,22590,0,13265.0,1,13270.0,5,B
2018-04-27 11:11:25,13260.0,6,22596,2,13260.0,7,13265.0,2,S
2018-04-27 11:11:26,13265.0,4,22600,0,13260.0,7,13265.0,4,B
2018-04-27 11:11:26,13265.0,6,22606,0,13260.0,8,13265.0,1,B
2018-04-27 11:11:27,13260.0,2,22608,2,13260.0,4,13270.0,9,S
2018-04-27 11:11:28,13265.0,2,22610,2,13260.0,7,13270.0,9,B
2018-04-27 11:11:29,13260.0,2,22612,0,13260.0,2,13265.0,4,S
2018-04-27 11:11:32,13265.0,6,22618,0,13260.0,2,13265.0,2,B
2018-04-27 11:11:36,13265.0,2,22620,0,13265.0,1,13270.0,9,B
2018-04-27 11:11:36,13265.0,2,22622,2,13265.0,1,13270.0,9,B
2018-04-27 11:11:38,13265.0,2,22624,0,13260.0,11,13270.0,9,B
2018-04-27 11:11:39,13260.0,6,22630,0,13260.0,10,13265.0,6,S
2018-04-27 11:11:40,13265.0,2,22632,0,13260.0,8,13265.0,4,B
2018-04-27 11:11:40,13260.0,8,22640,0,13260.0,1,13270.0,8,S
2018-04-27 11:11:43,13265.0,4,22644,-4,13260.0,5,13270.0,8,B
2018-04-27 11:11:44,13270.0,2,22646,2,13260.0,5,13270.0,9,B
2018-04-27 11:11:52,13260.0,2,22648,0,13260.0,6,13265.0,5,S
2018-04-27 11:12:03,13260.0,2,22650,-2,13260.0,6,13265.0,7,S
2018-04-27 11:12:15,13265.0,16,22666,-2,13260.0,9,13270.0,27,B
2018-04-27 11:12:16,13265.0,2,22668,2,13265.0,9,13270.0,5,B
2018-04-27 11:12:17,13265.0,2,22670,2,13265.0,8,13270.0,3,B
2018-04-27 11:12:17,13265.0,2,22672,2,13265.0,7,13270.0,3,B
2018-04-27 11:12:18,13265.0,2,22674,0,13265.0,6,13270.0,3,B
2018-04-27 11:12:18,13265.0,2,22676,0,13265.0,5,13270.0,5,B
2018-04-27 11:12:21,13265.0,2,22678,0,13265.0,3,13270.0,6,B
2018-04-27 11:12:21,13265.0,2,22680,0,13265.0,2,13270.0,6,B
2018-04-27 11:12:22,13260.0,2,22682,0,13260.0,17,13270.0,8,S
2018-04-27 11:12:44,13270.0,4,22686,-2,13265.0,7,13270.0,1,B
2018-04-27 11:12:45,13270.0,2,22688,-2,13265.0,10,13275.0,17,B
2018-04-27 11:12:46,13270.0,2,22690,0,13270.0,1,13275.0,18,B
2018-04-27 11:12:50,13265.0,2,22692,2,13265.0,12,13270.0,2,S
2018-04-27 11:13:08,13265.0,12,22704,4,13260.0,14,13270.0,8,S
2018-04-27 11:13:12,13265.0,10,22714,8,13260.0,8,13265.0,8,S
2018-04-27 11:13:13,13265.0,16,22730,-10,13265.0,6,13270.0,15,S
2018-04-27 11:13:13,13265.0,2,22732,2,13265.0,2,13270.0,12,S
2018-04-27 11:13:14,13265.0,2,22734,2,13265.0,2,13270.0,12,S
2018-04-27 11:13:18,13260.0,2,22736,0,13260.0,14,13270.0,7,S
2018-04-27 11:13:19,13265.0,2,22738,0,13265.0,1,13270.0,12,B
2018-04-27 11:13:19,13265.0,6,22744,-4,13265.0,3,13270.0,5,B
2018-04-27 11:13:24,13265.0,2,22746,2,13260.0,13,13265.0,3,B
2018-04-27 11:13:25,13260.0,2,22748,0,13260.0,10,13265.0,5,S
2018-04-27 11:13:26,13265.0,8,22756,-6,13265.0,1,13270.0,13,B
2018-04-27 11:13:26,13265.0,2,22758,2,13260.0,12,13270.0,10,B
2018-04-27 11:13:37,13265.0,2,22760,2,13265.0,3,13270.0,10,B
2018-04-27 11:13:38,13260.0,8,22768,-6,13260.0,6,13265.0,1,S
2018-04-27 11:13:39,13265.0,2,22770,2,13260.0,10,13270.0,11,B
2018-04-27 11:13:45,13270.0,2,22772,2,13265.0,9,13270.0,5,B
2018-04-27 11:13:47,13270.0,2,22774,2,13265.0,10,13270.0,4,B
2018-04-27 11:13:48,13270.0,6,22780,4,13265.0,10,13270.0,1,B
2018-04-27 11:13:56,13270.0,2,22782,0,13270.0,1,13275.0,19,B
2018-04-27 11:13:57,13270.0,2,22784,0,13270.0,15,13275.0,15,B
2018-04-27 11:13:57,13270.0,2,22786,2,13270.0,6,13275.0,15,B
2018-04-27 11:13:58,13265.0,14,22800,6,13265.0,11,13275.0,19,S
2018-04-27 11:14:06,13270.0,2,22802,2,13265.0,8,13270.0,4,B
2018-04-27 11:14:10,13270.0,2,22804,2,13265.0,8,13270.0,2,B
2018-04-27 11:14:10,13270.0,2,22806,2,13265.0,8,13270.0,1,B
2018-04-27 11:14:11,13270.0,2,22808,0,13265.0,13,13275.0,21,B
2018-04-27 11:14:14,13275.0,42,22850,30,13275.0,6,13280.0,3,B
2018-04-27 11:14:15,13270.0,2,22852,0,13270.0,10,13280.0,2,S
2018-04-27 11:14:15,13270.0,2,22854,0,13270.0,9,13280.0,10,S
2018-04-27 11:14:21,13280.0,2,22856,0,13270.0,16,13280.0,12,B
2018-04-27 11:14:22,13275.0,2,22858,0,13275.0,4,13280.0,9,S
2018-04-27 11:14:22,13275.0,6,22864,-4,13275.0,1,13280.0,9,S
2018-04-27 11:14:23,13275.0,2,22866,0,13275.0,5,13280.0,5,S
2018-04-27 11:14:23,13275.0,6,22872,2,13275.0,8,13280.0,1,S
2018-04-27 11:14:25,13280.0,2,22874,-2,13280.0,1,13285.0,10,B
2018-04-27 11:14:25,13280.0,2,22876,0,13275.0,16,13285.0,10,B
2018-04-27 11:14:27,13275.0,2,22878,2,13275.0,16,13285.0,12,S
2018-04-27 11:14:32,13275.0,2,22880,2,13280.0,3,13285.0,15,S
2018-04-27 11:14:32,13275.0,2,22882,0,13280.0,2,13285.0,15,S
2018-04-27 11:14:33,13275.0,2,22884,0,13280.0,1,13285.0,12,S
2018-04-27 11:14:33,13275.0,2,22886,0,13275.0,18,13285.0,12,S
2018-04-27 11:14:36,13275.0,2,22888,2,13280.0,3,13285.0,7,S
2018-04-27 11:14:37,13285.0,8,22896,-8,13280.0,3,13285.0,1,B
2018-04-27 11:14:38,13290.0,6,22902,-4,13285.0,1,13290.0,4,B
2018-04-27 11:14:38,13280.0,6,22908,2,13280.0,6,13290.0,7,S
2018-04-27 11:14:43,13280.0,4,22912,-4,13275.0,14,13285.0,16,S
2018-04-27 11:14:45,13280.0,4,22916,0,13275.0,17,13280.0,4,S
2018-04-27 11:14:45,13275.0,4,22920,-2,13275.0,10,13280.0,12,S
2018-04-27 11:14:47,13280.0,2,22922,2,13275.0,10,13280.0,11,B
2018-04-27 11:14:49,13280.0,16,22938,6,13280.0,16,13285.0,10,B
2018-04-27 11:14:49,13280.0,2,22940,0,13280.0,14,13285.0,9,B
2018-04-27 11:14:50,13280.0,2,22942,0,13280.0,5,13285.0,9,B
2018-04-27 11:14:50,13280.0,2,22944,2,13280.0,4,13285.0,9,B
2018-04-27 11:14:55,13285.0,4,22948,4,13280.0,4,13285.0,9,B
2018-04-27 11:14:59,13280.0,14,22962,-2,13280.0,1,13285.0,8,S
2018-04-27 11:14:59,13280.0,2,22964,2,13275.0,15,13285.0,8,S
2018-04-27 11:15:01,13280.0,22,22986,0,13270.0,11,13280.0,8,S
2018-04-27 11:15:02,13280.0,2,22988,0,13270.0,9,13280.0,8,S
2018-04-27 11:15:05,13270.0,2,22990,2,13270.0,6,13275.0,1,S
2018-04-27 11:15:06,13275.0,2,22992,-2,13275.0,4,13280.0,10,B
2018-04-27 11:15:07,13275.0,8,23000,-4,13270.0,4,13275.0,2,B
2018-04-27 11:15:08,13270.0,4,23004,2,13270.0,1,13275.0,1,S
2018-04-27 11:15:09,13270.0,4,23008,2,13270.0,2,13275.0,3,S
2018-04-27 11:15:14,13275.0,4,23012,0,13270.0,4,13280.0,8,B
2018-04-27 11:15:17,13270.0,2,23014,2,13270.0,3,13280.0,9,S
2018-04-27 11:15:21,13280.0,16,23030,-4,13270.0,10,13280.0,1,B
2018-04-27 11:15:23,13280.0,10,23040,6,13275.0,10,13285.0,21,B
2018-04-27 11:15:24,13280.0,2,23042,2,13280.0,11,13285.0,4,B
2018-04-27 11:15:25,13280.0,2,23044,2,13280.0,10,13285.0,4,B
2018-04-27 11:15:26,13280.0,2,23046,2,13280.0,9,13285.0,4,B
2018-04-27 11:15:26,13280.0,2,23048,2,13280.0,8,13285.0,4,B
2018-04-27 11:15:27,13280.0,2,23050,2,13280.0,7,13285.0,3,B
2018-04-27 11:15:27,13280.0,2,23052,2,13280.0,6,13285.0,3,B
2018-04-27 11:15:28,13280.0,4,23056,0,13280.0,4,13285.0,3,B
2018-04-27 11:15:32,13280.0,2,23058,0,13280.0,4,13285.0,3,B
2018-04-27 11:15:32,13280.0,8,23066,6,13275.0,12,13280.0,4,B
2018-04-27 11:15:33,13275.0,8,23074,2,13275.0,6,13280.0,3,S
2018-04-27 11:15:34,13280.0,6,23080,0,13275.0,9,13285.0,4,B
2018-04-27 11:15:38,13280.0,2,23082,-2,13275.0,7,13285.0,55,B
2018-04-27 11:15:42,13280.0,2,23084,0,13275.0,11,13285.0,54,B
2018-04-27 11:15:43,13280.0,2,23086,-2,13275.0,11,13285.0,54,B
2018-04-27 11:15:43,13285.0,2,23088,0,13275.0,11,13285.0,53,B
2018-04-27 11:15:58,13280.0,16,23104,12,13275.0,25,13285.0,53,S
2018-04-27 11:15:59,13280.0,2,23106,0,13275.0,25,13285.0,55,S
2018-04-27 11:16:00,13280.0,2,23108,-2,13275.0,9,13280.0,5,S
2018-04-27 11:16:00,13280.0,2,23110,0,13275.0,9,13280.0,4,S
2018-04-27 11:16:17,13280.0,2,23112,-2,13275.0,6,13280.0,4,S
2018-04-27 11:16:33,13275.0,2,23114,-2,13270.0,9,13280.0,21,S
2018-04-27 11:16:40,13275.0,4,23118,4,13270.0,11,13275.0,6,S
2018-04-27 11:16:42,13275.0,2,23120,-2,13270.0,9,13275.0,4,S
2018-04-27 11:16:43,13275.0,2,23122,0,13270.0,10,13280.0,22,S
2018-04-27 11:16:49,13280.0,2,23124,-2,13275.0,1,13280.0,9,B
2018-04-27 11:16:50,13275.0,2,23126,2,13275.0,1,13280.0,9,S
2018-04-27 11:16:54,13275.0,6,23132,6,13270.0,25,13275.0,1,S
2018-04-27 11:16:54,13275.0,4,23136,-2,13270.0,9,13275.0,4,S
2018-04-27 11:17:03,13275.0,4,23140,0,13270.0,15,13275.0,1,S
2018-04-27 11:17:03,13275.0,2,23142,0,13270.0,27,13280.0,12,S
2018-04-27 11:17:09,13275.0,2,23144,-2,13270.0,10,13280.0,25,S
2018-04-27 11:17:20,13275.0,2,23146,2,13270.0,10,13275.0,4,S
2018-04-27 11:17:37,13270.0,4,23150,4,13270.0,3,13275.0,6,S
2018-04-27 11:17:50,13275.0,2,23152,-2,13270.0,5,13275.0,7,B
2018-04-27 11:18:02,13270.0,2,23154,0,13270.0,6,13275.0,6,S
2018-04-27 11:18:04,13270.0,2,23156,-2,13270.0,5,13275.0,6,S
2018-04-27 11:18:07,13270.0,6,23162,2,13265.0,33,13270.0,2,S
2018-04-27 11:18:10,13265.0,10,23172,10,13265.0,16,13270.0,5,S
2018-04-27 11:18:10,13270.0,10,23182,4,13270.0,6,13275.0,9,B
2018-04-27 11:18:24,13275.0,2,23184,0,13270.0,5,13275.0,7,B
2018-04-27 11:18:39,13270.0,2,23186,0,13270.0,3,13275.0,6,S
2018-04-27 11:18:53,13270.0,4,23190,-4,13270.0,1,13275.0,6,S
2018-04-27 11:19:05,13270.0,2,23192,0,13265.0,21,13275.0,7,S
2018-04-27 11:19:30,13270.0,2,23194,0,13265.0,20,13275.0,8,S
2018-04-27 11:19:36,13270.0,2,23196,2,13265.0,20,13270.0,1,S
2018-04-27 11:19:36,13270.0,2,23198,2,13265.0,20,13275.0,8,S
2018-04-27 11:19:50,13270.0,2,23200,2,13270.0,3,13275.0,6,S
2018-04-27 11:19:51,13270.0,2,23202,0,13270.0,2,13275.0,6,S
2018-04-27 11:20:05,13270.0,4,23206,0,13265.0,20,13270.0,1,S
2018-04-27 11:20:05,13270.0,2,23208,0,13265.0,20,13275.0,7,S
2018-04-27 11:20:26,13265.0,32,23240,-4,13260.0,7,13270.0,10,S
2018-04-27 11:20:27,13265.0,4,23244,0,13260.0,11,13270.0,10,S
2018-04-27 11:20:45,13260.0,6,23250,-4,13260.0,1,13265.0,7,S
2018-04-27 11:20:45,13260.0,2,23252,0,13255.0,4,13265.0,7,S
2018-04-27 11:20:51,13260.0,2,23254,2,13255.0,8,13260.0,3,S
2018-04-27 11:20:53,13260.0,2,23256,2,13255.0,7,13260.0,2,S
2018-04-27 11:21:07,13255.0,2,23258,-2,13250.0,11,13260.0,7,S
2018-04-27 11:21:07,13250.0,4,23262,-2,13250.0,14,13260.0,7,S
2018-04-27 11:21:27,13255.0,2,23264,0,13250.0,18,13255.0,8,B
2018-04-27 11:21:30,13255.0,14,23278,-4,13255.0,7,13260.0,6,B
2018-04-27 11:21:31,13260.0,4,23282,0,13255.0,22,13265.0,11,B
2018-04-27 11:21:35,13260.0,10,23292,-8,13255.0,14,13265.0,9,B
2018-04-27 11:21:44,13260.0,14,23306,14,13255.0,18,13260.0,1,B
2018-04-27 11:21:44,13260.0,2,23308,2,13255.0,18,13265.0,10,B
2018-04-27 11:21:51,13260.0,2,23310,-2,13255.0,10,13260.0,8,B
2018-04-27 11:21:57,13260.0,2,23312,0,13255.0,10,13260.0,7,B
2018-04-27 11:22:02,13260.0,8,23320,0,13260.0,1,13265.0,13,B
2018-04-27 11:22:02,13260.0,2,23322,2,13255.0,13,13265.0,13,B
2018-04-27 11:22:05,13265.0,2,23324,2,13255.0,14,13265.0,12,B
2018-04-27 11:22:14,13255.0,22,23346,0,13250.0,16,13255.0,1,S
2018-04-27 11:22:15,13255.0,24,23370,-8,13250.0,10,13260.0,7,S
2018-04-27 11:22:18,13255.0,2,23372,0,13250.0,12,13255.0,1,S
2018-04-27 11:22:21,13255.0,6,23378,6,13250.0,14,13255.0,1,S
2018-04-27 11:22:21,13255.0,2,23380,2,13255.0,3,13260.0,5,S
2018-04-27 11:22:24,13255.0,8,23388,6,13255.0,14,13265.0,10,S
2018-04-27 11:22:25,13255.0,6,23394,-2,13255.0,9,13260.0,1,S
2018-04-27 11:22:29,13260.0,4,23398,0,13260.0,6,13265.0,13,B
2018-04-27 11:22:33,13260.0,2,23400,2,13260.0,4,13265.0,9,B
2018-04-27 11:22:33,13260.0,2,23402,2,13260.0,3,13265.0,7,B
2018-04-27 11:22:43,13260.0,10,23412,-4,13255.0,10,13260.0,2,B
2018-04-27 11:22:43,13260.0,4,23416,-4,13260.0,2,13265.0,5,B
2018-04-27 11:22:49,13260.0,2,23418,2,13260.0,4,13265.0,7,B
2018-04-27 11:22:50,13260.0,2,23420,2,13260.0,4,13265.0,7,B
2018-04-27 11:22:51,13260.0,2,23422,2,13260.0,3,13265.0,7,B
2018-04-27 11:22:51,13260.0,2,23424,2,13260.0,2,13265.0,7,B
2018-04-27 11:22:52,13260.0,2,23426,2,13260.0,1,13265.0,7,B
2018-04-27 11:22:56,13260.0,2,23428,-2,13255.0,11,13265.0,7,B
2018-04-27 11:23:05,13255.0,2,23430,-2,13255.0,6,13260.0,6,S
2018-04-27 11:23:09,13260.0,2,23432,0,13255.0,7,13260.0,5,B
2018-04-27 11:23:10,13260.0,2,23434,0,13255.0,7,13260.0,4,B
2018-04-27 11:23:14,13260.0,2,23436,0,13255.0,5,13260.0,4,B
2018-04-27 11:23:25,13260.0,2,23438,0,13255.0,5,13260.0,1,B
2018-04-27 11:23:25,13260.0,2,23440,0,13255.0,5,13265.0,22,B
2018-04-27 11:23:33,13260.0,4,23444,0,13255.0,10,13265.0,21,B
2018-04-27 11:23:34,13255.0,2,23446,0,13255.0,9,13265.0,21,S
2018-04-27 11:23:34,13260.0,2,23448,0,13255.0,9,13265.0,21,B
2018-04-27 11:23:40,13260.0,4,23452,0,13260.0,2,13265.0,20,B
2018-04-27 11:23:40,13260.0,2,23454,0,13260.0,2,13265.0,19,B
2018-04-27 11:23:42,13260.0,2,23456,0,13260.0,1,13265.0,7,B
2018-04-27 11:23:43,13260.0,2,23458,0,13255.0,9,13265.0,7,B
2018-04-27 11:23:43,13265.0,2,23460,2,13255.0,10,13265.0,7,B
2018-04-27 11:23:48,13260.0,2,23462,2,13260.0,1,13265.0,7,S
2018-04-27 11:23:48,13260.0,2,23464,0,13255.0,9,13265.0,7,S
2018-04-27 11:23:57,13255.0,14,23478,-6,13250.0,18,13255.0,3,S
2018-04-27 11:23:59,13255.0,4,23482,-4,13250.0,14,13255.0,5,S
2018-04-27 11:24:02,13255.0,16,23498,2,13255.0,1,13260.0,10,S
2018-04-27 11:24:02,13255.0,2,23500,0,13250.0,13,13255.0,2,S
2018-04-27 11:24:05,13250.0,22,23522,-4,13245.0,8,13250.0,3,S
2018-04-27 11:24:11,13245.0,12,23534,4,13240.0,7,13250.0,7,S
2018-04-27 11:24:12,13245.0,6,23540,6,13240.0,5,13250.0,11,S
2018-04-27 11:24:13,13245.0,8,23548,0,13240.0,10,13245.0,2,S
2018-04-27 11:24:14,13245.0,4,23552,-4,13240.0,10,13250.0,10,S
2018-04-27 11:24:15,13245.0,4,23556,-4,13245.0,3,13250.0,7,S
2018-04-27 11:24:18,13245.0,4,23560,-2,13240.0,10,13250.0,12,S
2018-04-27 11:24:27,13245.0,2,23562,2,13240.0,6,13245.0,6,S
2018-04-27 11:24:29,13245.0,2,23564,-2,13240.0,7,13245.0,4,S
2018-04-27 11:24:29,13245.0,8,23572,-8,13245.0,6,13250.0,9,S
2018-04-27 11:24:31,13245.0,2,23574,2,13240.0,5,13245.0,3,S
2018-04-27 11:24:31,13245.0,2,23576,-2,13240.0,3,13245.0,3,S
2018-04-27 11:24:34,13245.0,4,23580,2,13240.0,4,13245.0,1,S
2018-04-27 11:24:41,13250.0,22,23602,20,13245.0,14,13255.0,3,B
2018-04-27 11:24:42,13250.0,2,23604,0,13245.0,17,13255.0,3,B
2018-04-27 11:24:43,13250.0,2,23606,0,13250.0,2,13255.0,5,B
2018-04-27 11:24:44,13250.0,2,23608,2,13245.0,14,13255.0,5,B
2018-04-27 11:24:45,13250.0,2,23610,0,13245.0,14,13255.0,4,B
2018-04-27 11:24:47,13255.0,2,23612,2,13245.0,14,13255.0,4,B
2018-04-27 11:24:49,13250.0,2,23614,0,13250.0,1,13255.0,2,S
2018-04-27 11:24:50,13250.0,2,23616,2,13245.0,15,13255.0,4,S
2018-04-27 11:24:55,13250.0,2,23618,2,13245.0,14,13255.0,8,S
2018-04-27 11:24:56,13245.0,10,23628,-2,13245.0,2,13250.0,4,S
2018-04-27 11:24:57,13240.0,6,23634,-2,13240.0,13,13245.0,1,S
2018-04-27 11:24:59,13250.0,12,23646,0,13240.0,10,13250.0,10,B
2018-04-27 11:25:06,13245.0,2,23648,-2,13240.0,12,13250.0,13,S
2018-04-27 11:25:16,13245.0,2,23650,2,13245.0,4,13250.0,8,S
2018-04-27 11:25:17,13245.0,2,23652,0,13245.0,7,13250.0,5,S
2018-04-27 11:25:17,13245.0,2,23654,0,13245.0,7,13250.0,5,S
2018-04-27 11:25:18,13245.0,2,23656,0,13245.0,7,13250.0,4,S
2018-04-27 11:25:22,13250.0,2,23658,0,13245.0,2,13250.0,4,B
2018-04-27 11:25:23,13245.0,2,23660,0,13245.0,1,13250.0,4,S
2018-04-27 11:25:25,13245.0,2,23662,0,13245.0,2,13250.0,5,S
2018-04-27 11:25:30,13245.0,4,23666,2,13240.0,11,13250.0,5,S
2018-04-27 11:25:42,13250.0,2,23668,-2,13245.0,6,13250.0,1,B
2018-04-27 11:25:43,13250.0,2,23670,0,13250.0,9,13255.0,6,B
2018-04-27 11:25:43,13250.0,2,23672,2,13250.0,1,13255.0,3,B
2018-04-27 11:25:44,13250.0,2,23674,2,13245.0,10,13255.0,5,B
2018-04-27 11:25:48,13245.0,2,23676,0,13245.0,9,13255.0,4,S
2018-04-27 11:25:51,13245.0,2,23678,0,13245.0,11,13255.0,5,S
2018-04-27 11:25:53,13245.0,4,23682,-4,13245.0,11,13255.0,5,S
2018-04-27 11:25:58,13255.0,8,23690,-2,13250.0,2,13255.0,11,B
2018-04-27 11:25:59,13250.0,2,23692,0,13250.0,1,13255.0,11,S
2018-04-27 11:25:59,13250.0,2,23694,0,13245.0,11,13255.0,11,S
2018-04-27 11:26:05,13255.0,4,23698,2,13245.0,14,13255.0,9,B
2018-04-27 11:26:09,13250.0,8,23706,-2,13245.0,11,13255.0,11,S
2018-04-27 11:26:11,13245.0,2,23708,0,13245.0,3,13250.0,3,S
2018-04-27 11:26:11,13245.0,2,23710,2,13245.0,3,13250.0,4,S
2018-04-27 11:26:13,13250.0,4,23714,2,13245.0,3,13250.0,3,B
2018-04-27 11:26:13,13250.0,2,23716,0,13245.0,2,13250.0,4,B
2018-04-27 11:26:14,13245.0,2,23718,2,13245.0,1,13250.0,5,S
2018-04-27 11:26:14,13240.0,2,23720,2,13240.0,10,13245.0,4,S
2018-04-27 11:26:15,13240.0,8,23728,0,13240.0,7,13250.0,8,S
2018-04-27 11:26:27,13245.0,2,23730,-2,13240.0,13,13250.0,25,B
2018-04-27 11:26:31,13240.0,10,23740,8,13240.0,15,13250.0,8,S
2018-04-27 11:26:47,13250.0,2,23742,-2,13250.0,3,13255.0,18,B
2018-04-27 11:26:48,13245.0,8,23750,-4,13245.0,5,13250.0,4,S
2018-04-27 11:26:49,13245.0,4,23754,2,13245.0,3,13250.0,1,S
2018-04-27 11:26:50,13245.0,4,23758,0,13245.0,4,13250.0,1,S
2018-04-27 11:26:52,13250.0,2,23760,0,13245.0,8,13255.0,9,B
2018-04-27 11:27:02,13245.0,2,23762,0,13240.0,15,13250.0,10,S
2018-04-27 11:27:03,13245.0,6,23768,0,13245.0,3,13250.0,5,S
2018-04-27 11:27:15,13245.0,2,23770,-2,13240.0,15,13250.0,10,S
2018-04-27 11:27:39,13245.0,2,23772,2,13240.0,13,13245.0,2,S
2018-04-27 11:27:44,13250.0,2,23774,0,13240.0,16,13250.0,12,B
2018-04-27 11:27:47,13250.0,2,23776,0,13240.0,16,13250.0,11,B
2018-04-27 11:27:50,13250.0,2,23778,2,13240.0,16,13250.0,9,B
2018-04-27 11:27:53,13240.0,4,23782,2,13240.0,15,13250.0,9,S
2018-04-27 11:27:59,13240.0,4,23786,0,13240.0,18,13250.0,9,S
2018-04-27 11:28:00,13245.0,2,23788,2,13240.0,19,13245.0,4,B
2018-04-27 11:28:01,13245.0,6,23794,6,13240.0,19,13245.0,1,B
2018-04-27 11:28:01,13245.0,2,23796,2,13245.0,2,13250.0,9,B
2018-04-27 11:28:02,13240.0,6,23802,2,13240.0,14,13250.0,9,S
2018-04-27 11:28:05,13250.0,6,23808,-2,13240.0,13,13250.0,11,B
2018-04-27 11:28:06,13240.0,2,23810,0,13240.0,12,13250.0,11,S
2018-04-27 11:28:07,13240.0,2,23812,0,13240.0,11,13250.0,11,S
2018-04-27 11:28:16,13245.0,4,23816,4,13240.0,24,13245.0,3,B
2018-04-27 11:28:27,13240.0,6,23822,2,13240.0,19,13245.0,5,S
2018-04-27 11:28:34,13240.0,2,23824,-2,13240.0,20,13245.0,8,S
2018-04-27 11:28:35,13240.0,4,23828,-2,13240.0,28,13245.0,8,S
2018-04-27 11:28:35,13235.0,80,23908,-34,13230.0,28,13235.0,60,S
2018-04-27 11:28:36,13235.0,22,23930,-10,13230.0,26,13235.0,49,S
2018-04-27 11:28:36,13235.0,14,23944,-6,13230.0,16,13235.0,42,S
2018-04-27 11:28:39,13230.0,30,23974,16,13225.0,5,13230.0,6,S
2018-04-27 11:28:40,13225.0,8,23982,-2,13220.0,17,13225.0,2,S
2018-04-27 11:28:41,13220.0,2,23984,-2,13220.0,1,13225.0,2,S
2018-04-27 11:28:41,13215.0,6,23990,-6,13215.0,14,13220.0,2,S
2018-04-27 11:28:42,13220.0,16,24006,-2,13215.0,19,13225.0,12,B
2018-04-27 11:28:44,13220.0,4,24010,-4,13220.0,2,13225.0,13,B
2018-04-27 11:28:45,13220.0,2,24012,0,13220.0,1,13225.0,13,B
2018-04-27 11:28:45,13220.0,2,24014,2,13215.0,1,13220.0,5,B
2018-04-27 11:28:46,13215.0,4,24018,2,13210.0,19,13220.0,6,S
2018-04-27 11:28:49,13215.0,18,24036,-8,13205.0,17,13215.0,3,S
2018-04-27 11:28:50,13210.0,14,24050,-10,13210.0,12,13215.0,2,S
2018-04-27 11:28:50,13210.0,14,24064,-8,13210.0,20,13220.0,16,S
2018-04-27 11:28:51,13215.0,4,24068,0,13210.0,20,13220.0,16,B
2018-04-27 11:28:55,13215.0,2,24070,2,13205.0,22,13210.0,2,B
2018-04-27 11:28:55,13210.0,10,24080,-4,13210.0,1,13215.0,14,S
2018-04-27 11:28:56,13215.0,2,24082,-2,13210.0,19,13215.0,9,B
2018-04-27 11:28:57,13210.0,4,24086,0,13205.0,17,13215.0,10,S
2018-04-27 11:28:59,13205.0,22,24108,12,13210.0,1,13215.0,10,S
2018-04-27 11:28:59,13205.0,20,24128,-8,13200.0,149,13210.0,2,S
2018-04-27 11:29:00,13210.0,4,24132,2,13210.0,1,13215.0,10,B
2018-04-27 11:29:00,13210.0,10,24142,6,13205.0,1,13215.0,8,B
2018-04-27 11:29:01,13215.0,14,24156,-10,13205.0,3,13215.0,6,B
2018-04-27 11:29:03,13210.0,2,24158,-2,13205.0,4,13210.0,9,S
2018-04-27 11:29:03,13215.0,22,24180,-12,13210.0,2,13215.0,3,B
2018-04-27 11:29:05,13215.0,2,24182,0,13215.0,1,13220.0,10,B
2018-04-27 11:29:06,13215.0,2,24184,-2,13215.0,2,13220.0,9,B
2018-04-27 11:29:15,13215.0,2,24186,0,13215.0,6,13220.0,6,B
2018-04-27 11:29:17,13215.0,2,24188,0,13215.0,7,13220.0,6,B
2018-04-27 11:29:18,13220.0,2,24190,0,13215.0,7,13220.0,5,B
2018-04-27 11:29:19,13215.0,4,24194,-2,13215.0,5,13220.0,5,S
2018-04-27 11:29:20,13220.0,4,24198,0,13215.0,3,13220.0,7,B
2018-04-27 11:29:21,13220.0,4,24202,0,13215.0,1,13220.0,6,B
2018-04-27 11:29:21,13220.0,4,24206,4,13215.0,1,13220.0,4,B
2018-04-27 11:29:23,13220.0,2,24208,0,13215.0,2,13220.0,4,B
2018-04-27 11:29:24,13220.0,4,24212,0,13215.0,2,13220.0,2,B
2018-04-27 11:29:24,13220.0,8,24220,2,13220.0,1,13225.0,7,B
2018-04-27 11:29:25,13220.0,2,24222,0,13215.0,8,13225.0,8,B
2018-04-27 11:29:27,13225.0,2,24224,0,13220.0,7,13225.0,5,B
2018-04-27 11:29:29,13220.0,4,24228,0,13220.0,5,13225.0,4,S
2018-04-27 11:29:30,13220.0,8,24236,0,13220.0,1,13225.0,4,S
2018-04-27 11:29:31,13220.0,2,24238,2,13215.0,12,13220.0,1,S
2018-04-27 11:29:31,13220.0,2,24240,2,13220.0,1,13225.0,4,S
2018-04-27 11:29:32,13220.0,2,24242,0,13215.0,12,13225.0,5,S
2018-04-27 11:29:34,13215.0,2,24244,-2,13215.0,9,13225.0,8,S
2018-04-27 11:29:36,13220.0,2,24246,0,13215.0,9,13225.0,9,B
2018-04-27 11:29:41,13220.0,2,24248,2,13215.0,6,13220.0,4,B
2018-04-27 11:29:42,13215.0,6,24254,-4,13215.0,6,13220.0,2,S
2018-04-27 11:29:45,13215.0,4,24258,-4,13215.0,9,13225.0,9,S
2018-04-27 11:29:47,13225.0,16,24274,-6,13220.0,7,13230.0,2,B
2018-04-27 11:29:50,13225.0,4,24278,0,13220.0,9,13230.0,3,B
2018-04-27 11:29:52,13230.0,4,24282,2,13220.0,7,13230.0,9,B
2018-04-27 11:29:52,13220.0,6,24288,0,13220.0,7,13230.0,6,S
2018-04-27 11:29:54,13225.0,2,24290,0,13220.0,12,13230.0,7,B
2018-04-27 11:29:57,13225.0,8,24298,-6,13220.0,3,13230.0,9,B
2018-04-27 11:29:58,13230.0,6,24304,4,13220.0,3,13230.0,5,B
2018-04-27 13:30:00,13230.0,18,24322,2,13230.0,2,13235.0,63,B
2018-04-27 13:30:01,13230.0,6,24328,6,13225.0,6,13230.0,5,B
2018-04-27 13:30:01,13230.0,4,24332,4,13230.0,1,13235.0,51,B
2018-04-27 13:30:02,13225.0,10,24342,2,13225.0,3,13230.0,3,S
2018-04-27 13:30:02,13225.0,8,24350,4,13225.0,4,13230.0,2,S
2018-04-27 13:30:03,13230.0,2,24352,0,13225.0,6,13230.0,3,B
2018-04-27 13:30:04,13230.0,4,24356,2,13225.0,6,13230.0,1,B
2018-04-27 13:30:04,13225.0,2,24358,0,13225.0,7,13230.0,1,S
2018-04-27 13:30:05,13235.0,4,24362,-2,13225.0,9,13235.0,53,B
2018-04-27 13:30:08,13230.0,4,24366,0,13225.0,9,13235.0,53,S
2018-04-27 13:30:09,13235.0,2,24368,0,13225.0,9,13235.0,52,B
2018-04-27 13:30:11,13230.0,2,24370,-2,13225.0,9,13235.0,13,S
2018-04-27 13:30:12,13230.0,6,24376,6,13225.0,6,13235.0,12,S
2018-04-27 13:30:14,13230.0,8,24384,0,13230.0,2,13235.0,11,S
2018-04-27 13:30:14,13225.0,12,24396,8,13225.0,3,13235.0,11,S
2018-04-27 13:30:16,13230.0,2,24398,0,13225.0,7,13230.0,1,B
2018-04-27 13:30:16,13230.0,2,24400,2,13225.0,7,13235.0,15,B
2018-04-27 13:30:18,13230.0,2,24402,0,13225.0,10,13235.0,14,B
2018-04-27 13:30:22,13225.0,4,24406,4,13225.0,10,13235.0,15,S
2018-04-27 13:30:24,13225.0,12,24418,10,13220.0,13,13230.0,8,S
2018-04-27 13:30:26,13225.0,4,24422,0,13220.0,12,13230.0,12,S
2018-04-27 13:30:30,13220.0,12,24434,-2,13215.0,7,13225.0,6,S
2018-04-27 13:30:31,13220.0,2,24436,0,13215.0,9,13225.0,6,S
2018-04-27 13:30:33,13220.0,2,24438,-2,13215.0,9,13225.0,10,S
2018-04-27 13:30:34,13220.0,2,24440,-2,13215.0,9,13220.0,5,S
2018-04-27 13:30:35,13220.0,8,24448,8,13215.0,2,13220.0,5,S
2018-04-27 13:30:36,13215.0,4,24452,4,13210.0,5,13220.0,5,S
2018-04-27 13:30:36,13215.0,6,24458,0,13215.0,7,13220.0,1,S
2018-04-27 13:30:38,13215.0,4,24462,0,13220.0,1,13225.0,13,S
2018-04-27 13:30:42,13220.0,6,24468,-4,13215.0,12,13225.0,19,B
2018-04-27 13:30:49,13220.0,2,24470,0,13215.0,6,13220.0,1,B
2018-04-27 13:30:50,13220.0,2,24472,0,13215.0,5,13220.0,1,B
2018-04-27 13:30:56,13220.0,6,24478,2,13215.0,8,13225.0,36,B
2018-04-27 13:30:57,13220.0,2,24480,-2,13215.0,5,13220.0,1,B
2018-04-27 13:30:57,13220.0,4,24484,4,13220.0,8,13225.0,18,B
2018-04-27 13:30:58,13220.0,8,24492,2,13220.0,3,13225.0,15,B
2018-04-27 13:30:58,13220.0,6,24498,0,13215.0,7,13225.0,15,B
2018-04-27 13:31:04,13220.0,4,24502,0,13215.0,10,13225.0,23,B
2018-04-27 13:31:06,13225.0,28,24530,12,13220.0,11,13230.0,15,B
2018-04-27 13:31:07,13230.0,4,24534,0,13225.0,1,13230.0,12,B
2018-04-27 13:31:07,13230.0,6,24540,-2,13220.0,13,13230.0,12,B
2018-04-27 13:31:12,13230.0,2,24542,2,13225.0,5,13230.0,9,B
2018-04-27 13:31:13,13230.0,28,24570,22,13230.0,3,13235.0,16,B
2018-04-27 13:31:14,13230.0,4,24574,0,13230.0,2,13235.0,16,B
2018-04-27 13:31:14,13230.0,4,24578,-4,13225.0,9,13235.0,16,B
2018-04-27 13:31:25,13230.0,2,24580,-2,13225.0,1,13230.0,8,B
2018-04-27 13:31:25,13230.0,2,24582,-2,13225.0,1,13230.0,7,B
2018-04-27 13:31:26,13230.0,10,24592,-10,13225.0,1,13230.0,4,B
2018-04-27 13:31:27,13225.0,2,24594,-2,13220.0,9,13230.0,8,S
2018-04-27 13:31:31,13230.0,2,24596,-2,13225.0,5,13230.0,6,B
2018-04-27 13:31:32,13230.0,8,24604,4,13225.0,8,13235.0,19,B
2018-04-27 13:31:40,13235.0,2,24606,0,13230.0,8,13235.0,15,B
2018-04-27 13:31:41,13230.0,20,24626,-8,13225.0,13,13230.0,10,S
2018-04-27 13:31:42,13225.0,2,24628,0,13225.0,9,13230.0,10,S
2018-04-27 13:31:43,13225.0,14,24642,-6,13225.0,5,13230.0,4,S
2018-04-27 13:31:44,13225.0,10,24652,6,13220.0,6,13230.0,5,S
2018-04-27 13:31:48,13230.0,2,24654,0,13220.0,10,13230.0,8,B
2018-04-27 13:31:50,13220.0,4,24658,2,13220.0,8,13230.0,11,S
2018-04-27 13:31:53,13220.0,4,24662,2,13220.0,6,13230.0,9,S
2018-04-27 13:31:54,13220.0,10,24672,2,13220.0,5,13230.0,9,S
2018-04-27 13:31:55,13230.0,2,24674,-2,13220.0,5,13230.0,8,B
2018-04-27 13:32:01,13230.0,2,24676,-2,13225.0,7,13235.0,21,B
2018-04-27 13:32:02,13225.0,6,24682,0,13225.0,9,13235.0,23,S
2018-04-27 13:32:05,13230.0,6,24688,0,13225.0,4,13230.0,2,B
2018-04-27 13:32:06,13225.0,6,24694,2,13220.0,7,13230.0,8,S
2018-04-27 13:32:07,13225.0,12,24706,8,13220.0,3,13230.0,10,S
2018-04-27 13:32:08,13225.0,4,24710,2,13220.0,6,13230.0,10,S
2018-04-27 13:32:09,13230.0,2,24712,0,13225.0,5,13230.0,5,B
2018-04-27 13:32:10,13225.0,2,24714,2,13220.0,11,13230.0,13,S
2018-04-27 13:32:14,13230.0,2,24716,2,13220.0,9,13230.0,16,B
2018-04-27 13:32:19,13220.0,8,24724,4,13220.0,6,13230.0,15,S
2018-04-27 13:32:23,13225.0,2,24726,0,13220.0,9,13230.0,16,B
2018-04-27 13:32:31,13225.0,8,24734,0,13225.0,1,13230.0,15,B
2018-04-27 13:32:31,13225.0,2,24736,-2,13220.0,10,13230.0,15,B
2018-04-27 13:32:35,13220.0,10,24746,6,13220.0,8,13225.0,3,S
2018-04-27 13:32:45,13220.0,10,24756,8,13220.0,2,13225.0,5,S
2018-04-27 13:32:46,13220.0,6,24762,-2,13215.0,7,13225.0,5,S
2018-04-27 13:32:47,13220.0,2,24764,0,13220.0,7,13225.0,2,S
2018-04-27 13:32:48,13225.0,2,24766,0,13220.0,9,13230.0,16,B
2018-04-27 13:32:50,13225.0,2,24768,0,13220.0,11,13230.0,16,B
2018-04-27 13:32:51,13225.0,4,24772,0,13220.0,10,13230.0,16,B
2018-04-27 13:32:56,13220.0,6,24778,6,13215.0,8,13220.0,5,S
2018-04-27 13:32:56,13220.0,10,24788,0,13215.0,9,13225.0,10,S
2018-04-27 13:32:57,13215.0,4,24792,-4,13215.0,9,13225.0,11,S
2018-04-27 13:32:58,13220.0,2,24794,2,13215.0,9,13225.0,14,B
2018-04-27 13:33:01,13225.0,2,24796,0,13220.0,1,13225.0,13,B
2018-04-27 13:33:01,13220.0,2,24798,0,13215.0,9,13220.0,3,S
2018-04-27 13:33:02,13220.0,6,24804,-2,13215.0,6,13220.0,3,S
2018-04-27 13:33:05,13220.0,2,24806,0,13215.0,3,13220.0,6,S
2018-04-27 13:33:06,13220.0,4,24810,2,13215.0,3,13220.0,4,S
2018-04-27 13:33:07,13220.0,2,24812,0,13215.0,3,13220.0,3,S
2018-04-27 13:33:10,13215.0,6,24818,0,13215.0,2,13220.0,2,S
2018-04-27 13:33:19,13215.0,4,24822,0,13215.0,1,13220.0,2,S
2018-04-27 13:33:22,13225.0,6,24828,4,13215.0,3,13225.0,23,B
2018-04-27 13:33:23,13225.0,2,24830,-2,13215.0,3,13220.0,1,B
2018-04-27 13:33:26,13215.0,6,24836,2,13210.0,11,13220.0,12,S
2018-04-27 13:33:30,13210.0,18,24854,6,13205.0,3,13215.0,24,S
2018-04-27 13:33:31,13210.0,4,24858,4,13210.0,7,13215.0,12,S
2018-04-27 13:33:35,13215.0,2,24860,0,13210.0,3,13215.0,4,B
2018-04-27 13:33:36,13210.0,4,24864,-2,13205.0,15,13215.0,12,S
2018-04-27 13:33:37,13210.0,4,24868,-4,13205.0,5,13215.0,17,S
2018-04-27 13:33:39,13210.0,2,24870,0,13205.0,3,13210.0,6,S
2018-04-27 13:33:40,13205.0,4,24874,-4,13205.0,1,13210.0,14,S
2018-04-27 13:33:40,13205.0,4,24878,-2,13200.0,156,13205.0,15,S
2018-04-27 13:33:41,13205.0,34,24912,-16,13205.0,17,13210.0,8,S
2018-04-27 13:33:43,13210.0,8,24920,0,13205.0,9,13210.0,2,B
2018-04-27 13:33:44,13210.0,6,24926,6,13205.0,9,13215.0,17,B
2018-04-27 13:33:45,13210.0,4,24930,2,13205.0,13,13215.0,19,B
2018-04-27 13:33:45,13205.0,4,24934,-2,13205.0,12,13215.0,18,S
2018-04-27 13:33:47,13210.0,8,24942,-2,13205.0,16,13215.0,5,B
2018-04-27 13:33:48,13210.0,12,24954,10,13210.0,2,13215.0,2,B
2018-04-27 13:33:48,13215.0,2,24956,0,13210.0,9,13215.0,4,B
2018-04-27 13:33:49,13215.0,4,24960,-4,13215.0,6,13220.0,9,B
2018-04-27 13:33:54,13215.0,2,24962,2,13210.0,15,13220.0,10,B
2018-04-27 13:33:55,13210.0,10,24972,0,13210.0,10,13220.0,10,S
2018-04-27 13:34:14,13215.0,8,24980,6,13210.0,12,13215.0,1,B
2018-04-27 13:34:14,13215.0,6,24986,4,13215.0,1,13220.0,4,B
2018-04-27 13:34:17,13215.0,2,24988,2,13210.0,13,13215.0,7,B
2018-04-27 13:34:17,13215.0,12,25000,12,13210.0,13,13215.0,1,B
2018-04-27 13:34:18,13215.0,2,25002,0,13215.0,1,13220.0,9,B
2018-04-27 13:34:21,13220.0,2,25004,-2,13215.0,4,13220.0,7,B
2018-04-27 13:34:24,13220.0,6,25010,4,13220.0,17,13225.0,13,B
2018-04-27 13:34:24,13225.0,8,25018,4,13220.0,15,13225.0,11,B
2018-04-27 13:34:26,13225.0,2,25020,2,13220.0,15,13225.0,11,B
2018-04-27 13:34:27,13220.0,2,25022,0,13220.0,14,13225.0,11,S
2018-04-27 13:34:31,13220.0,28,25050,28,13215.0,8,13220.0,46,S
2018-04-27 13:34:37,13215.0,6,25056,6,13215.0,1,13220.0,47,S
2018-04-27 13:34:38,13215.0,2,25058,0,13210.0,13,13215.0,1,S
2018-04-27 13:34:39,13215.0,2,25060,0,13210.0,9,13215.0,4,S
2018-04-27 13:34:52,13215.0,4,25064,-4,13210.0,20,13215.0,3,S
2018-04-27 13:34:52,13210.0,8,25072,6,13210.0,19,13215.0,3,S
2018-04-27 13:34:53,13215.0,2,25074,0,13210.0,19,13215.0,3,B
2018-04-27 13:34:57,13215.0,6,25080,-4,13215.0,2,13220.0,53,B
2018-04-27 13:34:58,13210.0,14,25094,-4,13210.0,14,13215.0,3,S
2018-04-27 13:35:00,13215.0,2,25096,2,13210.0,12,13215.0,1,B
2018-04-27 13:35:00,13215.0,2,25098,-2,13210.0,12,13220.0,52,B
2018-04-27 13:35:02,13210.0,2,25100,2,13210.0,13,13220.0,62,S
2018-04-27 13:35:03,13215.0,2,25102,2,13210.0,15,13215.0,2,B
2018-04-27 13:35:04,13210.0,2,25104,2,13210.0,28,13220.0,62,S
2018-04-27 13:35:08,13220.0,4,25108,0,13215.0,1,13220.0,60,B
2018-04-27 13:35:12,13215.0,10,25118,-6,13210.0,26,13220.0,57,S
2018-04-27 13:35:16,13210.0,2,25120,0,13210.0,29,13220.0,60,S
2018-04-27 13:35:20,13210.0,6,25126,6,13215.0,16,13220.0,44,S
2018-04-27 13:35:25,13220.0,12,25138,6,13215.0,16,13220.0,43,B
2018-04-27 13:35:25,13220.0,76,25214,64,13220.0,7,13225.0,11,B
2018-04-27 13:35:27,13220.0,2,25216,2,13220.0,5,13225.0,9,B
2018-04-27 13:35:34,13220.0,2,25218,2,13220.0,24,13225.0,6,B
2018-04-27 13:35:36,13225.0,2,25220,0,13220.0,24,13225.0,5,B
2018-04-27 13:35:37,13220.0,4,25224,4,13220.0,23,13225.0,3,S
2018-04-27 13:35:46,13225.0,20,25244,-18,13220.0,7,13225.0,10,B
2018-04-27 13:35:50,13220.0,10,25254,10,13220.0,12,13230.0,23,S
2018-04-27 13:35:52,13225.0,2,25256,0,13220.0,11,13225.0,1,B
2018-04-27 13:35:53,13225.0,2,25258,2,13220.0,9,13225.0,1,B
2018-04-27 13:35:57,13225.0,2,25260,0,13220.0,16,13230.0,28,B
2018-04-27 13:36:00,13220.0,4,25264,2,13220.0,17,13230.0,28,S
2018-04-27 13:36:01,13225.0,10,25274,0,13220.0,19,13230.0,28,B
2018-04-27 13:36:03,13220.0,12,25286,8,13220.0,13,13230.0,29,S
2018-04-27 13:36:03,13230.0,2,25288,0,13225.0,1,13230.0,28,B
2018-04-27 13:36:04,13225.0,4,25292,0,13220.0,13,13230.0,28,S
2018-04-27 13:36:07,13220.0,10,25302,2,13220.0,10,13230.0,28,S
2018-04-27 13:36:13,13225.0,2,25304,0,13220.0,7,13225.0,18,B
2018-04-27 13:36:16,13225.0,4,25308,4,13220.0,7,13225.0,16,B
2018-04-27 13:36:20,13220.0,10,25318,8,13220.0,2,13225.0,16,S
2018-04-27 13:36:26,13225.0,2,25320,2,13220.0,2,13225.0,15,B
2018-04-27 13:36:29,13220.0,4,25324,2,13220.0,7,13225.0,15,S
2018-04-27 13:36:36,13220.0,8,25332,0,13220.0,8,13225.0,11,S
2018-04-27 13:36:37,13220.0,10,25342,2,13220.0,19,13230.0,28,S
2018-04-27 13:36:42,13220.0,4,25346,0,13215.0,8,13225.0,18,S
2018-04-27 13:36:47,13220.0,2,25348,-2,13215.0,15,13225.0,23,S
2018-04-27 13:36:49,13215.0,10,25358,8,13215.0,15,13220.0,2,S
2018-04-27 13:36:55,13220.0,2,25360,2,13215.0,16,13220.0,1,B
2018-04-27 13:36:58,13220.0,2,25362,2,13215.0,15,13220.0,1,B
2018-04-27 13:37:00,13220.0,2,25364,2,13220.0,7,13225.0,23,B
2018-04-27 13:37:01,13220.0,2,25366,0,13215.0,15,13225.0,24,B
2018-04-27 13:37:02,13220.0,4,25370,-4,13215.0,15,13225.0,16,B
2018-04-27 13:37:03,13225.0,4,25374,-4,13215.0,17,13225.0,17,B
2018-04-27 13:37:04,13215.0,20,25394,18,13215.0,7,13225.0,19,S
2018-04-27 13:37:07,13215.0,2,25396,2,13215.0,5,13220.0,11,S
2018-04-27 13:37:19,13220.0,14,25410,6,13215.0,12,13220.0,2,B
2018-04-27 13:37:20,13220.0,8,25418,-4,13215.0,8,13220.0,2,B
2018-04-27 13:37:24,13220.0,2,25420,0,13215.0,7,13220.0,11,B
2018-04-27 13:37:25,13220.0,2,25422,0,13215.0,7,13220.0,10,B
2018-04-27 13:37:31,13220.0,2,25424,0,13215.0,6,13220.0,9,B
2018-04-27 13:37:33,13215.0,12,25436,-2,13210.0,15,13220.0,9,S
2018-04-27 13:37:47,13215.0,12,25448,0,13210.0,7,13215.0,21,S
2018-04-27 13:37:48,13210.0,14,25462,4,13205.0,10,13210.0,1,S
2018-04-27 13:37:49,13205.0,14,25476,10,13205.0,3,13210.0,6,S
2018-04-27 13:37:50,13210.0,2,25478,2,13205.0,3,13210.0,5,B
2018-04-27 13:37:51,13210.0,2,25480,0,13205.0,9,13215.0,21,B
2018-04-27 13:37:52,13210.0,2,25482,0,13205.0,9,13215.0,21,B
2018-04-27 13:37:55,13210.0,2,25484,0,13210.0,1,13215.0,21,B
2018-04-27 13:38:00,13215.0,2,25486,0,13210.0,8,13215.0,17,B
2018-04-27 13:38:00,13210.0,10,25496,8,13210.0,3,13215.0,17,S
2018-04-27 13:38:05,13215.0,2,25498,0,13210.0,5,13215.0,16,B
2018-04-27 13:38:07,13215.0,12,25510,12,13210.0,13,13215.0,1,B
2018-04-27 13:38:07,13215.0,2,25512,-2,13210.0,14,13220.0,12,B
2018-04-27 13:38:12,13215.0,10,25522,2,13215.0,3,13220.0,12,B
2018-04-27 13:38:13,13220.0,2,25524,0,13215.0,15,13220.0,2,B
2018-04-27 13:38:17,13220.0,4,25528,2,13215.0,15,13225.0,17,B
2018-04-27 13:38:20,13220.0,4,25532,0,13215.0,15,13225.0,19,B
2018-04-27 13:38:27,13215.0,10,25542,6,13215.0,11,13225.0,19,S
2018-04-27 13:38:39,13220.0,20,25562,14,13215.0,90,13220.0,35,B
2018-04-27 13:38:39,13220.0,78,25640,34,13220.0,1,13225.0,6,B
2018-04-27 13:38:42,13220.0,2,25642,2,13220.0,4,13225.0,5,B
2018-04-27 13:38:50,13225.0,4,25646,4,13220.0,12,13230.0,39,B
2018-04-27 13:39:09,13225.0,4,25650,0,13220.0,18,13230.0,36,B
2018-04-27 13:39:11,13225.0,4,25654,-4,13220.0,23,13230.0,36,B
2018-04-27 13:39:22,13220.0,20,25674,18,13220.0,6,13225.0,15,S
2018-04-27 13:39:23,13225.0,4,25678,2,13220.0,6,13225.0,11,B
2018-04-27 13:39:41,13220.0,10,25688,10,13220.0,10,13230.0,32,S
2018-04-27 13:39:43,13220.0,20,25708,2,13215.0,52,13220.0,6,S
2018-04-27 13:39:52,13220.0,6,25714,0,13220.0,1,13225.0,18,S
2018-04-27 13:40:18,13220.0,2,25716,0,13220.0,2,13225.0,15,S
2018-04-27 13:40:39,13225.0,10,25726,0,13220.0,3,13225.0,9,B
2018-04-27 13:40:45,13220.0,4,25730,0,13220.0,1,13225.0,9,S
2018-04-27 13:40:45,13225.0,2,25732,-2,13220.0,1,13225.0,8,B
2018-04-27 13:40:50,13220.0,2,25734,0,13215.0,47,13225.0,13,S
2018-04-27 13:40:51,13220.0,4,25738,4,13215.0,43,13220.0,10,S
2018-04-27 13:40:55,13220.0,2,25740,2,13215.0,43,13220.0,11,S
2018-04-27 13:40:56,13220.0,10,25750,4,13215.0,43,13220.0,1,S
2018-04-27 13:40:57,13220.0,2,25752,0,13215.0,43,13220.0,1,S
2018-04-27 13:41:01,13215.0,2,25754,-2,13215.0,43,13220.0,3,S
2018-04-27 13:41:02,13220.0,6,25760,2,13215.0,43,13225.0,20,B
2018-04-27 13:41:04,13220.0,2,25762,2,13215.0,45,13220.0,1,B
2018-04-27 13:41:08,13215.0,4,25766,0,13215.0,44,13220.0,1,S
2018-04-27 13:41:14,13215.0,2,25768,0,13215.0,42,13220.0,1,S
2018-04-27 13:41:17,13215.0,4,25772,0,13215.0,41,13220.0,1,S
2018-04-27 13:41:35,13220.0,2,25774,0,13220.0,1,13225.0,24,B
2018-04-27 13:41:49,13220.0,10,25784,10,13215.0,48,13225.0,13,B
2018-04-27 13:41:50,13220.0,2,25786,-2,13215.0,48,13225.0,13,B
2018-04-27 13:41:52,13220.0,2,25788,0,13215.0,48,13225.0,34,B
2018-04-27 13:42:11,13225.0,2,25790,0,13215.0,48,13225.0,22,B
2018-04-27 13:42:39,13225.0,2,25792,-2,13215.0,48,13225.0,22,B
2018-04-27 13:42:54,13225.0,2,25794,0,13215.0,52,13225.0,21,B
2018-04-27 13:43:13,13225.0,4,25798,0,13215.0,51,13225.0,23,B
2018-04-27 13:43:14,13225.0,2,25800,-2,13215.0,51,13225.0,22,B
2018-04-27 13:43:20,13220.0,2,25802,0,13220.0,1,13225.0,22,S
2018-04-27 13:43:21,13225.0,4,25806,0,13220.0,2,13225.0,20,B
2018-04-27 13:43:23,13220.0,4,25810,4,13215.0,57,13220.0,3,S
2018-04-27 13:43:23,13220.0,6,25816,6,13215.0,57,13225.0,21,S
2018-04-27 13:43:41,13215.0,2,25818,0,13215.0,45,13220.0,21,S
2018-04-27 13:43:41,13215.0,10,25828,10,13215.0,40,13220.0,21,S
2018-04-27 13:43:42,13220.0,2,25830,-2,13215.0,40,13220.0,20,B
2018-04-27 13:43:47,13215.0,10,25840,10,13215.0,35,13220.0,36,S
2018-04-27 13:43:47,13220.0,14,25854,6,13215.0,29,13220.0,35,B
2018-04-27 13:43:53,13220.0,12,25866,-4,13215.0,43,13220.0,7,B
2018-04-27 13:43:54,13220.0,14,25880,2,13215.0,43,13225.0,14,B
2018-04-27 13:44:01,13215.0,8,25888,8,13215.0,25,13220.0,28,S
2018-04-27 13:44:01,13210.0,52,25940,36,13210.0,7,13215.0,1,S
2018-04-27 13:44:02,13210.0,12,25952,12,13205.0,3,13215.0,32,S
2018-04-27 13:44:03,13210.0,2,25954,2,13205.0,5,13210.0,27,S
2018-04-27 13:44:03,13205.0,10,25964,-4,13200.0,166,13205.0,1,S
2018-04-27 13:44:04,13200.0,4,25968,-2,13200.0,169,13205.0,5,S
2018-04-27 13:44:04,13200.0,24,25992,-18,13200.0,152,13205.0,13,S
2018-04-27 13:44:05,13200.0,34,26026,-4,13200.0,152,13210.0,17,S
2018-04-27 13:44:06,13205.0,24,26050,12,13200.0,147,13205.0,8,B
2018-04-27 13:44:08,13205.0,4,26054,0,13200.0,152,13205.0,12,B
2018-04-27 13:44:09,13205.0,2,26056,-2,13200.0,152,13205.0,14,B
2018-04-27 13:44:10,13205.0,2,26058,-2,13200.0,147,13205.0,16,B
2018-04-27 13:44:10,13200.0,6,26064,6,13200.0,144,13205.0,18,S
2018-04-27 13:44:11,13205.0,36,26100,-26,13200.0,144,13205.0,19,B
2018-04-27 13:44:11,13205.0,16,26116,2,13205.0,9,13210.0,2,B
2018-04-27 13:44:12,13205.0,2,26118,0,13205.0,17,13210.0,3,B
2018-04-27 13:44:16,13205.0,6,26124,6,13205.0,15,13210.0,2,B
2018-04-27 13:44:16,13205.0,8,26132,0,13205.0,11,13210.0,3,B
2018-04-27 13:44:19,13210.0,6,26138,6,13205.0,16,13210.0,3,B
2018-04-27 13:44:23,13205.0,14,26152,-10,13200.0,158,13205.0,3,S
2018-04-27 13:44:27,13205.0,8,26160,8,13205.0,1,13210.0,19,S
2018-04-27 13:44:27,13205.0,2,26162,0,13200.0,155,13205.0,18,S
2018-04-27 13:44:28,13200.0,2,26164,0,13200.0,149,13205.0,16,S
2018-04-27 13:44:30,13205.0,22,26186,12,13200.0,154,13205.0,1,B
2018-04-27 13:44:31,13200.0,6,26192,-4,13200.0,153,13210.0,14,S
2018-04-27 13:44:32,13205.0,2,26194,0,13200.0,157,13210.0,15,B
2018-04-27 13:44:32,13205.0,2,26196,0,13200.0,157,13210.0,23,B
2018-04-27 13:44:33,13200.0,42,26238,26,13200.0,133,13205.0,6,S
2018-04-27 13:44:36,13205.0,2,26240,-2,13200.0,133,13205.0,5,B
2018-04-27 13:44:37,13200.0,8,26248,6,13200.0,129,13205.0,7,S
2018-04-27 13:44:38,13200.0,64,26312,36,13200.0,92,13205.0,14,S
2018-04-27 13:44:39,13200.0,4,26316,0,13200.0,90,13205.0,19,S
2018-04-27 13:44:39,13200.0,4,26320,0,13200.0,83,13205.0,24,S
2018-04-27 13:44:41,13200.0,30,26350,22,13200.0,68,13205.0,25,S
2018-04-27 13:44:41,13200.0,18,26368,18,13200.0,59,13205.0,25,S
2018-04-27 13:44:42,13200.0,2,26370,2,13200.0,58,13205.0,19,S
2018-04-27 13:44:42,13200.0,10,26380,10,13200.0,53,13205.0,19,S
2018-04-27 13:44:44,13205.0,2,26382,0,13200.0,53,13205.0,20,B
2018-04-27 13:44:46,13200.0,20,26402,20,13200.0,53,13205.0,20,S
2018-04-27 13:44:46,13200.0,14,26416,-4,13200.0,46,13205.0,10,S
2018-04-27 13:44:47,13200.0,10,26426,10,13200.0,41,13205.0,10,S
2018-04-27 13:44:48,13205.0,4,26430,4,13200.0,43,13205.0,8,B
2018-04-27 13:44:49,13205.0,18,26448,-6,13200.0,49,13205.0,1,B
2018-04-27 13:44:49,13205.0,2,26450,-2,13200.0,50,13210.0,22,B
2018-04-27 13:44:57,13200.0,2,26452,0,13200.0,36,13205.0,7,S
2018-04-27 13:44:58,13200.0,2,26454,0,13200.0,40,13205.0,13,S
2018-04-27 13:44:59,13200.0,2,26456,-2,13200.0,39,13205.0,13,S
2018-04-27 13:45:02,13205.0,2,26458,-2,13200.0,39,13205.0,12,B
2018-04-27 13:45:02,13205.0,24,26482,-2,13200.0,48,13210.0,27,B
2018-04-27 13:45:04,13210.0,36,26518,6,13210.0,18,13215.0,14,B
2018-04-27 13:45:05,13215.0,10,26528,-6,13210.0,22,13220.0,13,B
2018-04-27 13:45:05,13210.0,2,26530,2,13210.0,27,13220.0,13,S
2018-04-27 13:45:07,13210.0,2,26532,2,13210.0,26,13220.0,12,S
2018-04-27 13:45:20,13215.0,6,26538,0,13215.0,6,13220.0,16,B
2018-04-27 13:45:20,13215.0,2,26540,0,13210.0,22,13220.0,15,B
2018-04-27 13:45:21,13210.0,10,26550,0,13210.0,17,13220.0,15,S
2018-04-27 13:45:27,13220.0,2,26552,0,13210.0,22,13220.0,19,B
2018-04-27 13:45:31,13215.0,2,26554,0,13210.0,22,13220.0,18,S
2018-04-27 13:45:45,13210.0,10,26564,-4,13210.0,13,13215.0,8,S
2018-04-27 13:45:46,13215.0,2,26566,0,13210.0,13,13215.0,7,B
2018-04-27 13:45:49,13215.0,4,26570,2,13210.0,16,13215.0,5,B
2018-04-27 13:45:49,13215.0,10,26580,-10,13215.0,5,13220.0,18,B
2018-04-27 13:45:50,13210.0,14,26594,8,13210.0,19,13220.0,23,S
2018-04-27 13:45:50,13220.0,12,26606,-8,13215.0,1,13220.0,20,B
2018-04-27 13:45:51,13215.0,4,26610,2,13215.0,2,13220.0,20,S
2018-04-27 13:45:51,13215.0,2,26612,2,13215.0,1,13220.0,18,S
2018-04-27 13:45:52,13215.0,2,26614,2,13215.0,5,13220.0,11,S
2018-04-27 13:45:52,13210.0,2,26616,2,13210.0,19,13220.0,11,S
2018-04-27 13:45:54,13210.0,2,26618,0,13215.0,3,13220.0,6,S
2018-04-27 13:45:54,13210.0,2,26620,0,13215.0,2,13220.0,6,S
2018-04-27 13:45:55,13210.0,2,26622,0,13215.0,1,13220.0,11,S
2018-04-27 13:45:55,13210.0,2,26624,0,13215.0,1,13220.0,10,S
2018-04-27 13:45:56,13210.0,2,26626,0,13215.0,2,13220.0,10,S
2018-04-27 13:45:57,13220.0,10,26636,0,13215.0,17,13225.0,8,B
2018-04-27 13:45:57,13220.0,2,26638,2,13215.0,22,13225.0,10,B
2018-04-27 13:45:58,13215.0,2,26640,2,13215.0,7,13220.0,12,S
2018-04-27 13:45:58,13215.0,2,26642,2,13215.0,7,13220.0,15,S
2018-04-27 13:46:01,13215.0,2,26644,0,13215.0,5,13220.0,26,S
2018-04-27 13:46:01,13210.0,2,26646,0,13210.0,20,13220.0,26,S
2018-04-27 13:46:06,13210.0,2,26648,2,13210.0,23,13220.0,23,S
2018-04-27 13:46:41,13210.0,2,26650,2,13210.0,11,13215.0,16,S
2018-04-27 13:46:49,13215.0,2,26652,0,13210.0,12,13215.0,15,B
2018-04-27 13:46:54,13210.0,2,26654,2,13210.0,11,13215.0,11,S
2018-04-27 13:46:55,13210.0,2,26656,2,13210.0,10,13215.0,11,S
2018-04-27 13:46:55,13210.0,2,26658,2,13210.0,9,13215.0,11,S
2018-04-27 13:46:56,13210.0,2,26660,2,13210.0,8,13215.0,11,S
2018-04-27 13:46:56,13210.0,2,26662,2,13210.0,7,13215.0,11,S
2018-04-27 13:46:57,13210.0,2,26664,0,13210.0,6,13215.0,9,S
2018-04-27 13:46:57,13210.0,2,26666,0,13210.0,5,13215.0,14,S
2018-04-27 13:46:58,13210.0,2,26668,0,13210.0,4,13215.0,14,S
2018-04-27 13:46:58,13210.0,2,26670,0,13210.0,3,13215.0,14,S
2018-04-27 13:46:59,13210.0,6,26676,-2,13205.0,25,13210.0,2,S
2018-04-27 13:46:59,13205.0,4,26680,0,13205.0,26,13210.0,1,S
2018-04-27 13:47:03,13210.0,8,26688,-2,13210.0,1,13215.0,21,B
2018-04-27 13:47:04,13210.0,2,26690,0,13210.0,3,13215.0,13,B
2018-04-27 13:47:04,13210.0,2,26692,2,13210.0,3,13215.0,13,B
2018-04-27 13:47:05,13210.0,2,26694,2,13210.0,3,13215.0,13,B
2018-04-27 13:47:12,13210.0,4,26698,2,13210.0,1,13215.0,15,B
2018-04-27 13:47:13,13210.0,2,26700,0,13210.0,1,13215.0,15,B
2018-04-27 13:47:13,13210.0,2,26702,0,13205.0,32,13210.0,2,B
2018-04-27 13:47:20,13210.0,8,26710,-2,13205.0,31,13210.0,1,B
2018-04-27 13:47:24,13210.0,2,26712,0,13205.0,26,13210.0,3,B
2018-04-27 13:47:27,13210.0,2,26714,-2,13205.0,26,13210.0,2,B
2018-04-27 13:47:27,13210.0,4,26718,-4,13205.0,26,13215.0,29,B
2018-04-27 13:47:28,13205.0,6,26724,-2,13205.0,30,13215.0,27,S
2018-04-27 13:47:29,13210.0,2,26726,0,13205.0,28,13210.0,3,B
2018-04-27 13:47:32,13210.0,10,26736,0,13210.0,15,13215.0,28,B
2018-04-27 13:47:32,13210.0,2,26738,0,13210.0,14,13215.0,30,B
2018-04-27 13:47:33,13210.0,2,26740,0,13210.0,13,13215.0,30,B
2018-04-27 13:47:34,13210.0,2,26742,0,13210.0,12,13215.0,30,B
2018-04-27 13:47:35,13210.0,2,26744,0,13210.0,12,13215.0,21,B
2018-04-27 13:47:36,13210.0,2,26746,0,13210.0,11,13215.0,21,B
2018-04-27 13:47:37,13210.0,22,26768,-20,13205.0,28,13210.0,1,B
2018-04-27 13:47:38,13210.0,6,26774,-2,13210.0,13,13215.0,14,B
2018-04-27 13:47:38,13210.0,26,26800,-10,13205.0,16,13210.0,7,B
2018-04-27 13:47:39,13210.0,24,26824,-2,13205.0,5,13210.0,9,B
2018-04-27 13:47:44,13210.0,4,26828,2,13210.0,2,13215.0,31,B
2018-04-27 13:47:47,13210.0,2,26830,-2,13210.0,1,13215.0,22,B
2018-04-27 13:47:53,13210.0,2,26832,0,13205.0,18,13215.0,24,B
2018-04-27 13:47:58,13205.0,2,26834,0,13200.0,57,13210.0,23,S
2018-04-27 13:47:59,13210.0,2,26836,-2,13200.0,67,13210.0,24,B
2018-04-27 13:48:01,13205.0,4,26840,-4,13200.0,67,13210.0,24,S
2018-04-27 13:48:06,13205.0,2,26842,2,13200.0,57,13205.0,4,S
2018-04-27 13:48:14,13200.0,14,26856,0,13200.0,37,13205.0,27,S
2018-04-27 13:48:15,13200.0,74,26930,58,13195.0,10,13205.0,35,S
2018-04-27 13:48:16,13195.0,8,26938,-4,13195.0,2,13200.0,9,S
2018-04-27 13:48:17,13195.0,8,26946,2,13195.0,2,13200.0,9,S
2018-04-27 13:48:17,13195.0,2,26948,-2,13190.0,10,13195.0,3,S
2018-04-27 13:48:23,13190.0,10,26958,2,13190.0,3,13195.0,8,S
2018-04-27 13:48:23,13190.0,6,26964,2,13185.0,6,13195.0,13,S
2018-04-27 13:48:24,13185.0,4,26968,2,13185.0,7,13195.0,24,S
2018-04-27 13:48:24,13190.0,2,26970,-2,13185.0,7,13195.0,29,B
2018-04-27 13:48:25,13195.0,20,26990,-10,13185.0,7,13195.0,24,B
2018-04-27 13:48:27,13190.0,4,26994,0,13185.0,9,13190.0,6,S
2018-04-27 13:48:27,13190.0,2,26996,0,13185.0,4,13190.0,10,S
2018-04-27 13:48:28,13190.0,2,26998,0,13185.0,4,13190.0,15,S
2018-04-27 13:48:28,13190.0,2,27000,0,13185.0,6,13190.0,14,S
2018-04-27 13:48:29,13190.0,2,27002,0,13185.0,5,13190.0,13,S
2018-04-27 13:48:29,13190.0,2,27004,0,13185.0,6,13190.0,12,S
2018-04-27 13:48:30,13190.0,8,27012,8,13185.0,21,13195.0,24,S
2018-04-27 13:48:32,13185.0,18,27030,-2,13180.0,28,13185.0,2,S
2018-04-27 13:48:32,13185.0,72,27102,56,13175.0,7,13185.0,10,S
2018-04-27 13:48:33,13175.0,16,27118,0,13170.0,5,13180.0,1,S
2018-04-27 13:48:33,13170.0,18,27136,-14,13165.0,5,13175.0,3,S
2018-04-27 13:48:34,13165.0,6,27142,0,13165.0,2,13175.0,34,S
2018-04-27 13:48:34,13175.0,8,27150,0,13170.0,1,13175.0,32,B
2018-04-27 13:48:35,13170.0,18,27168,2,13170.0,7,13175.0,12,S
2018-04-27 13:48:35,13175.0,14,27182,8,13170.0,21,13180.0,29,B
2018-04-27 13:48:36,13175.0,2,27184,0,13175.0,1,13180.0,23,B
2018-04-27 13:48:36,13175.0,2,27186,0,13170.0,14,13175.0,1,B
2018-04-27 13:48:37,13170.0,18,27204,-12,13165.0,19,13175.0,28,S
2018-04-27 13:48:38,13170.0,60,27264,18,13175.0,1,13180.0,21,S
2018-04-27 13:48:38,13175.0,2,27266,0,13170.0,12,13180.0,16,B
2018-04-27 13:48:40,13170.0,8,27274,-4,13170.0,23,13180.0,16,S
2018-04-27 13:48:42,13170.0,4,27278,-4,13165.0,18,13175.0,12,S
2018-04-27 13:48:44,13175.0,2,27280,-2,13170.0,7,13175.0,6,B
2018-04-27 13:48:45,13165.0,22,27302,2,13165.0,4,13170.0,29,S
2018-04-27 13:48:45,13165.0,8,27310,-8,13160.0,13,13165.0,12,S
2018-04-27 13:48:46,13160.0,2,27312,0,13160.0,14,13165.0,6,S
2018-04-27 13:48:47,13160.0,46,27358,14,13155.0,7,13160.0,2,S
2018-04-27 13:48:47,13165.0,6,27364,-2,13160.0,5,13165.0,2,B
2018-04-27 13:48:50,13160.0,2,27366,-2,13160.0,11,13165.0,21,S
2018-04-27 13:48:51,13165.0,2,27368,0,13160.0,11,13165.0,20,B
2018-04-27 13:48:52,13165.0,20,27388,20,13160.0,12,13165.0,10,B
2018-04-27 13:48:53,13165.0,2,27390,0,13160.0,12,13165.0,9,B
2018-04-27 13:48:54,13160.0,4,27394,2,13160.0,22,13165.0,9,S
2018-04-27 13:48:55,13160.0,12,27406,4,13160.0,22,13165.0,5,S
2018-04-27 13:48:55,13165.0,10,27416,0,13160.0,22,13170.0,19,B
2018-04-27 13:48:56,13165.0,2,27418,2,13165.0,10,13170.0,5,B
2018-04-27 13:48:57,13165.0,20,27438,6,13165.0,12,13170.0,3,B
2018-04-27 13:48:57,13165.0,10,27448,-10,13165.0,11,13170.0,1,B
2018-04-27 13:48:58,13170.0,4,27452,-2,13165.0,10,13175.0,18,B
2018-04-27 13:48:59,13165.0,2,27454,2,13165.0,11,13175.0,25,S
2018-04-27 13:49:04,13170.0,18,27472,-18,13170.0,1,13175.0,22,B
2018-04-27 13:49:04,13165.0,2,27474,2,13165.0,24,13170.0,5,S
2018-04-27 13:49:05,13175.0,14,27488,4,13170.0,14,13175.0,3,B
2018-04-27 13:49:05,13175.0,2,27490,0,13170.0,23,13175.0,1,B
2018-04-27 13:49:06,13175.0,4,27494,4,13170.0,28,13180.0,18,B
2018-04-27 13:49:07,13180.0,2,27496,0,13175.0,1,13180.0,25,B
2018-04-27 13:49:08,13175.0,8,27504,-4,13175.0,4,13180.0,12,S
2018-04-27 13:49:10,13175.0,14,27518,10,13170.0,27,13175.0,1,S
2018-04-27 13:49:10,13175.0,2,27520,0,13175.0,1,13180.0,24,S
2018-04-27 13:49:11,13180.0,2,27522,2,13175.0,6,13180.0,16,B
2018-04-27 13:49:13,13180.0,2,27524,2,13175.0,21,13180.0,2,B
2018-04-27 13:49:14,13180.0,4,27528,-2,13180.0,2,13185.0,9,B
2018-04-27 13:49:18,13185.0,2,27530,0,13185.0,18,13190.0,11,B
2018-04-27 13:49:19,13185.0,36,27566,-4,13180.0,22,13185.0,4,B
2018-04-27 13:49:21,13185.0,24,27590,4,13180.0,20,13190.0,26,B
2018-04-27 13:49:24,13180.0,20,27610,-8,13180.0,26,13190.0,26,S
2018-04-27 13:49:24,13190.0,14,27624,-2,13180.0,24,13190.0,21,B
2018-04-27 13:49:26,13185.0,2,27626,0,13180.0,24,13185.0,7,S
2018-04-27 13:49:27,13185.0,14,27640,14,13185.0,1,13190.0,23,S
2018-04-27 13:49:31,13185.0,8,27648,-4,13180.0,24,13190.0,19,S
2018-04-27 13:49:38,13190.0,4,27652,4,13190.0,1,13195.0,6,B
2018-04-27 13:49:41,13190.0,16,27668,0,13185.0,23,13195.0,25,B
2018-04-27 13:49:42,13190.0,6,27674,-6,13185.0,17,13195.0,24,B
2018-04-27 13:49:44,13195.0,14,27688,-8,13185.0,21,13195.0,14,B
2018-04-27 13:49:45,13195.0,2,27690,0,13185.0,21,13195.0,13,B
2018-04-27 13:49:48,13190.0,2,27692,2,13190.0,10,13195.0,9,S
2018-04-27 13:49:52,13195.0,2,27694,2,13190.0,11,13195.0,9,B
2018-04-27 13:49:52,13195.0,2,27696,2,13190.0,11,13195.0,8,B
2018-04-27 13:49:55,13190.0,4,27700,0,13190.0,9,13195.0,13,S
2018-04-27 13:49:56,13190.0,20,27720,18,13185.0,22,13190.0,6,S
2018-04-27 13:49:58,13190.0,2,27722,0,13185.0,18,13190.0,7,S
2018-04-27 13:50:01,13185.0,2,27724,-2,13185.0,17,13190.0,9,S
2018-04-27 13:50:02,13190.0,2,27726,-2,13185.0,15,13190.0,6,B
2018-04-27 13:50:06,13185.0,2,27728,0,13185.0,16,13190.0,6,S
2018-04-27 13:50:09,13190.0,2,27730,2,13185.0,16,13190.0,5,B
2018-04-27 13:50:13,13185.0,2,27732,0,13185.0,15,13190.0,3,S
2018-04-27 13:50:18,13185.0,2,27734,0,13185.0,14,13190.0,6,S
2018-04-27 13:50:32,13190.0,6,27740,-4,13185.0,33,13190.0,2,B
2018-04-27 13:50:32,13190.0,4,27744,0,13185.0,21,13195.0,24,B
2018-04-27 13:50:46,13190.0,2,27746,0,13185.0,16,13190.0,14,B
2018-04-27 13:50:48,13185.0,2,27748,0,13185.0,15,13190.0,14,S
2018-04-27 13:50:53,13185.0,2,27750,0,13185.0,14,13190.0,14,S
2018-04-27 13:50:59,13190.0,2,27752,2,13185.0,14,13190.0,10,B
2018-04-27 13:51:02,13190.0,2,27754,2,13185.0,14,13190.0,29,B
2018-04-27 13:51:07,13185.0,2,27756,2,13185.0,5,13190.0,25,S
2018-04-27 13:51:08,13185.0,10,27766,4,13180.0,26,13190.0,28,S
2018-04-27 13:51:11,13185.0,4,27770,0,13185.0,1,13190.0,28,S
2018-04-27 13:51:22,13180.0,10,27780,6,13180.0,24,13185.0,2,S
2018-04-27 13:51:29,13185.0,2,27782,-2,13185.0,5,13190.0,32,B
2018-04-27 13:51:29,13185.0,6,27788,-6,13185.0,2,13190.0,32,B
2018-04-27 13:51:43,13185.0,8,27796,0,13185.0,8,13190.0,20,B
2018-04-27 13:51:50,13190.0,14,27810,4,13185.0,20,13195.0,21,B
2018-04-27 13:51:52,13190.0,2,27812,0,13190.0,17,13195.0,2,B
2018-04-27 13:51:53,13195.0,2,27814,0,13190.0,18,13200.0,10,B
2018-04-27 13:51:56,13195.0,2,27816,0,13195.0,17,13200.0,5,B
2018-04-27 13:51:56,13195.0,2,27818,2,13195.0,15,13200.0,5,B
2018-04-27 13:51:57,13195.0,2,27820,2,13195.0,9,13200.0,9,B
2018-04-27 13:51:57,13190.0,2,27822,0,13190.0,17,13200.0,27,S
2018-04-27 13:52:05,13200.0,4,27826,4,13190.0,19,13200.0,27,B
2018-04-27 13:52:14,13190.0,8,27834,0,13190.0,15,13195.0,4,S
2018-04-27 13:52:21,13190.0,2,27836,-2,13185.0,14,13195.0,23,S
2018-04-27 13:52:24,13190.0,2,27838,0,13185.0,18,13195.0,21,S
2018-04-27 13:52:30,13190.0,2,27840,0,13185.0,29,13195.0,24,S
2018-04-27 13:52:31,13190.0,2,27842,-2,13190.0,1,13195.0,21,S
2018-04-27 13:52:31,13195.0,30,27872,-20,13190.0,1,13195.0,6,B
2018-04-27 13:52:36,13190.0,2,27874,-2,13185.0,18,13195.0,19,S
2018-04-27 13:52:50,13190.0,2,27876,-2,13190.0,21,13195.0,3,S
2018-04-27 13:52:51,13190.0,2,27878,0,13190.0,7,13195.0,20,S
2018-04-27 13:52:52,13190.0,8,27886,-6,13185.0,17,13195.0,20,S
2018-04-27 13:53:02,13190.0,8,27894,4,13190.0,3,13195.0,18,S
2018-04-27 13:53:15,13190.0,2,27896,0,13190.0,7,13195.0,15,S
2018-04-27 13:53:20,13190.0,4,27900,4,13190.0,5,13195.0,13,S
2018-04-27 13:53:20,13195.0,2,27902,2,13190.0,5,13195.0,12,B
2018-04-27 13:53:22,13195.0,4,27906,0,13190.0,17,13200.0,23,B
2018-04-27 13:53:23,13190.0,4,27910,-2,13190.0,18,13200.0,22,S
2018-04-27 13:53:28,13200.0,4,27914,0,13190.0,19,13200.0,22,B
2018-04-27 13:53:41,13190.0,34,27948,10,13185.0,13,13195.0,23,S
2018-04-27 13:53:41,13190.0,4,27952,2,13185.0,7,13195.0,25,S
2018-04-27 13:53:50,13190.0,2,27954,-2,13185.0,13,13190.0,3,S
2018-04-27 13:53:50,13190.0,2,27956,0,13185.0,13,13190.0,1,S
2018-04-27 13:54:01,13185.0,2,27958,2,13185.0,5,13190.0,33,S
2018-04-27 13:54:02,13185.0,2,27960,0,13185.0,3,13190.0,35,S
2018-04-27 13:54:02,13185.0,2,27962,0,13185.0,2,13190.0,23,S
2018-04-27 13:54:03,13185.0,4,27966,0,13180.0,19,13185.0,1,S
2018-04-27 13:54:06,13180.0,2,27968,0,13180.0,18,13185.0,1,S
2018-04-27 13:54:16,13180.0,2,27970,0,13180.0,12,13185.0,11,S
2018-04-27 13:54:18,13180.0,24,27994,6,13175.0,7,13180.0,5,S
2018-04-27 13:54:27,13180.0,2,27996,0,13170.0,5,13175.0,13,S
2018-04-27 13:54:29,13175.0,2,27998,0,13170.0,5,13175.0,11,S
2018-04-27 13:54:29,13170.0,4,28002,-2,13170.0,2,13175.0,12,S
2018-04-27 13:54:30,13170.0,4,28006,-4,13165.0,6,13170.0,4,S
2018-04-27 13:54:30,13165.0,6,28012,0,13165.0,1,13170.0,25,S
2018-04-27 13:54:31,13165.0,2,28014,0,13160.0,20,13165.0,2,S
2018-04-27 13:54:31,13160.0,28,28042,-4,13160.0,6,13165.0,32,S
2018-04-27 13:54:32,13160.0,12,28054,-4,13155.0,1,13160.0,9,S
2018-04-27 13:54:32,13160.0,24,28078,18,13150.0,136,13160.0,14,S
2018-04-27 13:54:33,13155.0,38,28116,18,13155.0,7,13165.0,19,S
2018-04-27 13:54:35,13155.0,2,28118,-2,13155.0,24,13165.0,5,S
2018-04-27 13:54:37,13155.0,2,28120,-2,13155.0,16,13165.0,16,S
2018-04-27 13:54:39,13155.0,4,28124,4,13155.0,14,13165.0,18,S
2018-04-27 13:54:40,13155.0,2,28126,2,13155.0,13,13165.0,18,S
2018-04-27 13:54:44,13160.0,8,28134,8,13155.0,16,13160.0,4,B
2018-04-27 13:54:45,13165.0,4,28138,0,13155.0,16,13160.0,2,B
2018-04-27 13:54:45,13155.0,2,28140,0,13155.0,15,13160.0,2,S
2018-04-27 13:54:47,13160.0,4,28144,0,13155.0,13,13165.0,12,B
2018-04-27 13:54:49,13160.0,2,28146,0,13160.0,1,13165.0,15,B
2018-04-27 13:54:52,13160.0,4,28150,2,13155.0,18,13165.0,11,B
2018-04-27 13:54:53,13155.0,2,28152,0,13155.0,17,13160.0,1,S
2018-04-27 13:54:54,13155.0,4,28156,0,13155.0,16,13165.0,14,S
2018-04-27 13:54:54,13155.0,2,28158,0,13155.0,15,13165.0,14,S
2018-04-27 13:54:55,13155.0,2,28160,0,13155.0,14,13165.0,14,S
2018-04-27 13:54:55,13155.0,2,28162,0,13155.0,13,13165.0,14,S
2018-04-27 13:54:56,13165.0,2,28164,2,13155.0,13,13165.0,13,B
2018-04-27 13:54:58,13155.0,2,28166,0,13155.0,6,13160.0,8,S
2018-04-27 13:55:00,13155.0,2,28168,0,13155.0,7,13160.0,8,S
2018-04-27 13:55:00,13155.0,2,28170,2,13155.0,6,13160.0,8,S
2018-04-27 13:55:03,13160.0,14,28184,-4,13160.0,1,13165.0,16,B
2018-04-27 13:55:03,13160.0,2,28186,-2,13160.0,12,13165.0,8,B
2018-04-27 13:55:04,13160.0,2,28188,2,13160.0,17,13165.0,3,B
2018-04-27 13:55:06,13160.0,6,28194,-4,13160.0,16,13170.0,13,B
2018-04-27 13:55:08,13165.0,14,28208,4,13160.0,19,13170.0,18,B
2018-04-27 13:55:08,13165.0,2,28210,2,13165.0,2,13170.0,9,B
2018-04-27 13:55:09,13165.0,2,28212,0,13165.0,5,13170.0,9,B
2018-04-27 13:55:09,13165.0,2,28214,0,13165.0,4,13170.0,9,B
2018-04-27 13:55:10,13165.0,2,28216,2,13165.0,3,13170.0,9,B
2018-04-27 13:55:10,13165.0,2,28218,2,13165.0,2,13170.0,9,B
2018-04-27 13:55:11,13165.0,2,28220,2,13165.0,1,13170.0,9,B
2018-04-27 13:55:11,13165.0,2,28222,2,13165.0,1,13170.0,9,B
2018-04-27 13:55:12,13165.0,2,28224,0,13165.0,2,13170.0,9,B
2018-04-27 13:55:13,13165.0,2,28226,0,13165.0,1,13170.0,9,B
2018-04-27 13:55:13,13165.0,2,28228,0,13165.0,1,13170.0,9,B
2018-04-27 13:55:14,13170.0,2,28230,0,13165.0,1,13170.0,8,B
2018-04-27 13:55:14,13170.0,12,28242,0,13165.0,1,13170.0,2,B
2018-04-27 13:55:15,13165.0,8,28250,-2,13165.0,17,13175.0,10,S
2018-04-27 13:55:16,13170.0,6,28256,-6,13170.0,5,13175.0,7,B
2018-04-27 13:55:17,13175.0,16,28272,0,13170.0,20,13180.0,7,B
2018-04-27 13:55:17,13175.0,2,28274,2,13175.0,3,13180.0,3,B
2018-04-27 13:55:18,13175.0,6,28280,-4,13175.0,4,13180.0,13,B
2018-04-27 13:55:19,13170.0,10,28290,-6,13170.0,16,13175.0,8,S
2018-04-27 13:55:19,13170.0,2,28292,0,13170.0,10,13175.0,6,S
2018-04-27 13:55:20,13170.0,2,28294,2,13170.0,14,13175.0,5,S
2018-04-27 13:55:20,13175.0,10,28304,-2,13175.0,4,13180.0,23,B
2018-04-27 13:55:21,13175.0,2,28306,0,13175.0,6,13180.0,22,B
2018-04-27 13:55:24,13175.0,4,28310,-2,13175.0,2,13180.0,23,B
2018-04-27 13:55:26,13175.0,2,28312,2,13175.0,1,13180.0,23,B
2018-04-27 13:55:29,13180.0,2,28314,2,13170.0,22,13180.0,22,B
2018-04-27 13:55:31,13170.0,2,28316,2,13170.0,21,13180.0,13,S
2018-04-27 13:55:34,13170.0,2,28318,2,13170.0,20,13180.0,11,S
2018-04-27 13:55:35,13170.0,2,28320,2,13170.0,19,13180.0,19,S
2018-04-27 13:55:38,13175.0,4,28324,0,13170.0,19,13175.0,1,B
2018-04-27 13:55:39,13175.0,2,28326,-2,13170.0,19,13180.0,19,B
2018-04-27 13:55:41,13175.0,10,28336,8,13170.0,22,13180.0,18,B
2018-04-27 13:55:42,13175.0,2,28338,0,13170.0,22,13175.0,3,B
2018-04-27 13:55:43,13175.0,6,28344,-4,13170.0,22,13180.0,21,B
2018-04-27 13:55:44,13175.0,2,28346,0,13170.0,22,13175.0,1,B
2018-04-27 13:55:45,13175.0,2,28348,2,13170.0,22,13180.0,21,B
2018-04-27 13:55:51,13175.0,4,28352,-4,13170.0,14,13175.0,6,B
2018-04-27 13:55:52,13170.0,14,28366,4,13165.0,19,13175.0,17,S
2018-04-27 13:55:53,13165.0,2,28368,0,13165.0,18,13170.0,1,S
2018-04-27 13:55:53,13175.0,4,28372,-2,13165.0,20,13175.0,15,B
2018-04-27 13:55:54,13175.0,20,28392,0,13165.0,20,13175.0,5,B
2018-04-27 13:55:59,13175.0,6,28398,4,13170.0,16,13175.0,2,B
2018-04-27 13:55:59,13175.0,2,28400,0,13170.0,16,13180.0,22,B
2018-04-27 13:56:07,13175.0,2,28402,2,13175.0,7,13180.0,16,B
2018-04-27 13:56:08,13175.0,2,28404,2,13175.0,12,13180.0,16,B
2018-04-27 13:56:09,13175.0,2,28406,2,13175.0,11,13180.0,16,B
2018-04-27 13:56:09,13175.0,22,28428,6,13170.0,21,13175.0,2,B
2018-04-27 13:56:10,13175.0,4,28432,0,13170.0,21,13175.0,1,B
2018-04-27 13:56:11,13170.0,24,28456,2,13170.0,2,13175.0,17,S
2018-04-27 13:56:12,13170.0,4,28460,0,13165.0,4,13170.0,9,S
2018-04-27 13:56:12,13165.0,2,28462,0,13160.0,9,13170.0,29,S
2018-04-27 13:56:15,13165.0,2,28464,0,13165.0,1,13170.0,14,S
2018-04-27 13:56:18,13165.0,2,28466,0,13160.0,16,13170.0,20,S
2018-04-27 13:56:24,13165.0,2,28468,2,13160.0,5,13165.0,13,S
2018-04-27 13:56:27,13160.0,8,28476,-2,13155.0,11,13160.0,3,S
2018-04-27 13:56:28,13160.0,12,28488,-8,13155.0,8,13160.0,4,S
2018-04-27 13:56:28,13160.0,8,28496,-6,13160.0,1,13165.0,11,S
2018-04-27 13:56:30,13165.0,2,28498,0,13160.0,2,13165.0,7,B
2018-04-27 13:56:32,13160.0,2,28500,0,13160.0,1,13165.0,7,S
2018-04-27 13:56:35,13165.0,14,28514,8,13165.0,3,13170.0,14,B
2018-04-27 13:56:36,13165.0,6,28520,4,13160.0,6,13170.0,17,B
2018-04-27 13:56:40,13165.0,4,28524,2,13160.0,13,13165.0,1,B
2018-04-27 13:56:41,13165.0,2,28526,0,13160.0,13,13170.0,17,B
2018-04-27 13:56:43,13165.0,2,28528,2,13160.0,14,13165.0,5,B
2018-04-27 13:56:44,13165.0,10,28538,6,13165.0,3,13170.0,15,B
2018-04-27 13:56:46,13165.0,2,28540,2,13165.0,5,13170.0,10,B
2018-04-27 13:56:58,13170.0,4,28544,-2,13170.0,2,13175.0,17,B
2018-04-27 13:56:59,13170.0,2,28546,2,13170.0,1,13175.0,14,B
2018-04-27 13:56:59,13170.0,2,28548,2,13165.0,14,13175.0,14,B
2018-04-27 13:57:05,13165.0,2,28550,0,13165.0,4,13170.0,18,S
2018-04-27 13:57:06,13165.0,8,28558,-2,13160.0,12,13165.0,3,S
2018-04-27 13:57:16,13160.0,12,28570,-10,13160.0,9,13165.0,2,S
2018-04-27 13:57:17,13165.0,4,28574,-4,13160.0,9,13170.0,20,B
2018-04-27 13:57:22,13160.0,2,28576,-2,13160.0,6,13165.0,3,S
2018-04-27 13:57:25,13160.0,38,28614,4,13155.0,17,13160.0,131,S
2018-04-27 13:57:27,13160.0,6,28620,0,13155.0,19,13160.0,128,S
2018-04-27 13:57:28,13155.0,2,28622,-2,13155.0,18,13160.0,128,S
2018-04-27 13:57:31,13160.0,4,28626,4,13155.0,16,13160.0,126,B
2018-04-27 13:57:32,13160.0,4,28630,0,13155.0,16,13160.0,125,B
2018-04-27 13:57:34,13155.0,2,28632,0,13155.0,13,13160.0,127,S
2018-04-27 13:57:35,13160.0,2,28634,2,13155.0,13,13160.0,126,B
2018-04-27 13:57:42,13155.0,2,28636,2,13155.0,20,13160.0,124,S
2018-04-27 13:57:42,13155.0,2,28638,2,13155.0,21,13160.0,124,S
2018-04-27 13:57:45,13160.0,12,28650,12,13155.0,22,13160.0,118,B
2018-04-27 13:57:46,13155.0,2,28652,0,13155.0,21,13160.0,118,S
2018-04-27 13:57:50,13160.0,2,28654,0,13155.0,24,13160.0,117,B
2018-04-27 13:57:53,13155.0,8,28662,4,13155.0,15,13160.0,122,S
2018-04-27 13:57:54,13160.0,2,28664,2,13155.0,15,13160.0,121,B
2018-04-27 13:57:57,13155.0,2,28666,2,13155.0,15,13160.0,122,S
2018-04-27 13:57:58,13155.0,6,28672,-2,13155.0,14,13160.0,122,S
2018-04-27 13:57:58,13155.0,2,28674,2,13155.0,13,13160.0,122,S
2018-04-27 13:58:02,13155.0,2,28676,0,13155.0,12,13160.0,122,S
2018-04-27 13:58:03,13160.0,8,28684,2,13155.0,12,13160.0,119,B
2018-04-27 13:58:03,13155.0,2,28686,2,13155.0,11,13160.0,119,S
2018-04-27 13:58:04,13155.0,2,28688,2,13155.0,10,13160.0,119,S
2018-04-27 13:58:13,13155.0,32,28720,20,13150.0,160,13155.0,96,S
2018-04-27 13:58:14,13155.0,6,28726,6,13150.0,163,13155.0,93,S
2018-04-27 13:58:15,13150.0,8,28734,6,13150.0,130,13155.0,101,S
2018-04-27 13:58:16,13155.0,2,28736,0,13150.0,130,13155.0,100,B
2018-04-27 13:58:18,13150.0,6,28742,6,13150.0,130,13155.0,99,S
2018-04-27 13:58:22,13150.0,2,28744,2,13150.0,157,13155.0,93,S
2018-04-27 13:58:22,13155.0,4,28748,0,13150.0,157,13155.0,91,B
2018-04-27 13:58:23,13155.0,8,28756,0,13150.0,158,13155.0,87,B
2018-04-27 13:58:23,13160.0,194,28950,132,13155.0,6,13165.0,22,B
2018-04-27 13:58:24,13160.0,4,28954,2,13155.0,13,13160.0,7,B
2018-04-27 13:58:24,13155.0,10,28964,4,13155.0,6,13160.0,2,S
2018-04-27 13:58:27,13155.0,4,28968,0,13155.0,6,13160.0,17,S
2018-04-27 13:58:28,13155.0,10,28978,6,13150.0,143,13155.0,1,S
2018-04-27 13:58:29,13155.0,2,28980,0,13155.0,22,13160.0,10,S
2018-04-27 13:58:32,13155.0,4,28984,4,13155.0,14,13160.0,10,S
2018-04-27 13:58:38,13155.0,2,28986,-2,13155.0,5,13160.0,14,S
2018-04-27 13:58:41,13160.0,2,28988,2,13155.0,4,13160.0,14,B
2018-04-27 13:58:43,13155.0,10,28998,4,13150.0,144,13160.0,13,S
2018-04-27 13:58:49,13160.0,4,29002,4,13155.0,7,13160.0,9,B
2018-04-27 13:58:49,13160.0,2,29004,2,13155.0,7,13160.0,8,B
2018-04-27 13:58:55,13160.0,16,29020,2,13155.0,23,13165.0,17,B
2018-04-27 13:59:02,13165.0,2,29022,2,13160.0,9,13165.0,11,B
2018-04-27 13:59:04,13165.0,8,29030,0,13165.0,1,13170.0,9,B
2018-04-27 13:59:04,13165.0,2,29032,0,13165.0,17,13170.0,1,B
2018-04-27 13:59:05,13170.0,2,29034,0,13165.0,15,13175.0,6,B
2018-04-27 13:59:06,13170.0,2,29036,0,13170.0,10,13175.0,3,B
2018-04-27 13:59:06,13175.0,8,29044,2,13170.0,11,13180.0,8,B
2018-04-27 13:59:07,13170.0,2,29046,2,13170.0,11,13180.0,10,S
2018-04-27 13:59:09,13170.0,2,29048,2,13170.0,11,13175.0,5,S
2018-04-27 13:59:09,13170.0,2,29050,2,13170.0,9,13175.0,5,S
2018-04-27 13:59:10,13170.0,2,29052,2,13170.0,8,13175.0,5,S
2018-04-27 13:59:11,13170.0,4,29056,0,13170.0,6,13175.0,5,S
2018-04-27 13:59:11,13170.0,2,29058,0,13170.0,6,13175.0,5,S
2018-04-27 13:59:12,13170.0,12,29070,8,13165.0,19,13170.0,4,S
2018-04-27 13:59:12,13170.0,2,29072,2,13165.0,9,13170.0,23,S
2018-04-27 13:59:13,13165.0,2,29074,0,13160.0,20,13165.0,6,S
2018-04-27 13:59:19,13165.0,2,29076,-2,13160.0,15,13165.0,2,S
2018-04-27 13:59:19,13165.0,4,29080,0,13165.0,8,13170.0,35,S
2018-04-27 13:59:21,13170.0,2,29082,0,13165.0,8,13170.0,32,B
2018-04-27 13:59:21,13165.0,12,29094,0,13165.0,2,13170.0,34,S
2018-04-27 13:59:27,13170.0,2,29096,0,13165.0,4,13170.0,19,B
2018-04-27 13:59:30,13170.0,2,29098,2,13165.0,4,13170.0,17,B
2018-04-27 13:59:33,13165.0,2,29100,2,13165.0,3,13170.0,18,S
2018-04-27 13:59:35,13165.0,2,29102,2,13165.0,2,13170.0,17,S
2018-04-27 13:59:42,13165.0,4,29106,4,13165.0,5,13170.0,17,S
2018-04-27 13:59:44,13165.0,2,29108,0,13160.0,17,13170.0,20,S
2018-04-27 13:59:53,13165.0,2,29110,0,13165.0,1,13170.0,23,S
2018-04-27 13:59:53,13165.0,2,29112,0,13160.0,20,13170.0,23,S
2018-04-27 13:59:54,13165.0,2,29114,2,13165.0,2,13170.0,23,S
2018-04-27 13:59:57,13165.0,2,29116,2,13165.0,2,13170.0,22,S
2018-04-27 13:59:57,13165.0,4,29120,0,13160.0,20,13170.0,22,S
2018-04-27 13:59:59,13165.0,2,29122,0,13160.0,20,13170.0,22,S
2018-04-27 14:00:04,13160.0,10,29132,8,13160.0,5,13165.0,21,S
2018-04-27 14:00:06,13160.0,20,29152,10,13155.0,16,13160.0,8,S
2018-04-27 14:00:09,13160.0,6,29158,0,13160.0,2,13165.0,14,S
2018-04-27 14:00:11,13160.0,2,29160,0,13160.0,1,13165.0,15,S
2018-04-27 14:00:12,13160.0,2,29162,0,13160.0,1,13165.0,13,S
2018-04-27 14:00:13,13160.0,2,29164,-2,13155.0,19,13160.0,2,S
2018-04-27 14:00:15,13160.0,2,29166,0,13155.0,18,13165.0,13,S
2018-04-27 14:00:22,13165.0,4,29170,0,13165.0,3,13170.0,13,B
2018-04-27 14:00:23,13165.0,2,29172,0,13165.0,6,13170.0,8,B
2018-04-27 14:00:23,13165.0,2,29174,0,13165.0,6,13170.0,9,B
2018-04-27 14:00:24,13160.0,2,29176,0,13160.0,12,13170.0,9,S
2018-04-27 14:00:28,13160.0,2,29178,0,13165.0,14,13170.0,3,S
2018-04-27 14:00:28,13160.0,2,29180,2,13165.0,12,13170.0,3,S
2018-04-27 14:00:29,13160.0,2,29182,0,13160.0,14,13170.0,12,S
2018-04-27 14:00:30,13160.0,4,29186,0,13160.0,12,13170.0,20,S
2018-04-27 14:00:31,13160.0,4,29190,0,13160.0,10,13170.0,20,S
2018-04-27 14:00:33,13160.0,2,29192,2,13165.0,18,13170.0,5,S
2018-04-27 14:00:33,13160.0,2,29194,2,13165.0,13,13170.0,5,S
2018-04-27 14:00:34,13165.0,24,29218,4,13160.0,7,13165.0,5,B
2018-04-27 14:00:35,13160.0,2,29220,0,13160.0,7,13165.0,11,S
2018-04-27 14:00:36,13160.0,2,29222,0,13160.0,5,13165.0,11,S
2018-04-27 14:00:36,13160.0,2,29224,0,13160.0,4,13165.0,11,S
2018-04-27 14:00:42,13160.0,2,29226,2,13160.0,4,13165.0,12,S
2018-04-27 14:00:42,13165.0,22,29248,8,13165.0,3,13170.0,14,B
2018-04-27 14:00:43,13165.0,2,29250,2,13165.0,3,13170.0,11,B
2018-04-27 14:00:43,13165.0,6,29256,-6,13160.0,17,13170.0,13,B
2018-04-27 14:00:45,13160.0,2,29258,0,13160.0,12,13170.0,17,S
2018-04-27 14:00:45,13160.0,2,29260,2,13160.0,11,13170.0,17,S
2018-04-27 14:00:46,13160.0,2,29262,2,13160.0,10,13170.0,17,S
2018-04-27 14:00:46,13160.0,2,29264,2,13160.0,10,13170.0,17,S
2018-04-27 14:00:48,13160.0,2,29266,2,13160.0,1,13165.0,6,S
2018-04-27 14:00:48,13160.0,2,29268,2,13160.0,1,13165.0,6,S
2018-04-27 14:00:50,13160.0,2,29270,2,13155.0,22,13165.0,5,S
2018-04-27 14:00:51,13160.0,2,29272,2,13160.0,2,13165.0,5,S
2018-04-27 14:00:51,13160.0,2,29274,0,13160.0,1,13165.0,5,S
2018-04-27 14:00:52,13160.0,2,29276,2,13160.0,1,13165.0,5,S
2018-04-27 14:00:53,13160.0,2,29278,2,13160.0,1,13165.0,5,S
2018-04-27 14:00:54,13160.0,2,29280,0,13160.0,1,13165.0,5,S
2018-04-27 14:00:54,13165.0,4,29284,-4,13160.0,2,13165.0,3,B
2018-04-27 14:00:55,13160.0,2,29286,2,13160.0,1,13165.0,3,S
2018-04-27 14:00:55,13160.0,2,29288,0,13160.0,1,13165.0,3,S
2018-04-27 14:00:56,13160.0,2,29290,2,13155.0,23,13165.0,3,S
2018-04-27 14:00:56,13160.0,2,29292,2,13160.0,1,13165.0,3,S
2018-04-27 14:00:57,13160.0,2,29294,0,13160.0,1,13165.0,3,S
2018-04-27 14:00:58,13160.0,2,29296,2,13155.0,23,13165.0,3,S
2018-04-27 14:00:58,13160.0,2,29298,2,13160.0,1,13165.0,3,S
2018-04-27 14:00:59,13160.0,2,29300,2,13155.0,25,13165.0,3,S
2018-04-27 14:00:59,13160.0,2,29302,2,13160.0,1,13165.0,3,S
2018-04-27 14:01:00,13160.0,2,29304,0,13160.0,1,13165.0,3,S
2018-04-27 14:01:01,13160.0,2,29306,2,13160.0,2,13165.0,2,S
2018-04-27 14:01:01,13160.0,2,29308,2,13160.0,2,13165.0,2,S
2018-04-27 14:01:02,13160.0,2,29310,2,13160.0,1,13165.0,8,S
2018-04-27 14:01:04,13160.0,2,29312,2,13155.0,23,13165.0,8,S
2018-04-27 14:01:05,13160.0,2,29314,2,13160.0,14,13165.0,8,S
2018-04-27 14:01:05,13160.0,2,29316,2,13160.0,13,13165.0,7,S
2018-04-27 14:01:06,13160.0,2,29318,2,13160.0,12,13165.0,7,S
2018-04-27 14:01:06,13160.0,2,29320,2,13160.0,11,13165.0,7,S
2018-04-27 14:01:07,13160.0,2,29322,2,13155.0,24,13165.0,8,S
2018-04-27 14:01:08,13160.0,2,29324,2,13155.0,24,13165.0,8,S
2018-04-27 14:01:09,13160.0,2,29326,2,13160.0,10,13165.0,10,S
2018-04-27 14:01:09,13160.0,2,29328,2,13160.0,9,13165.0,10,S
2018-04-27 14:01:10,13160.0,2,29330,2,13160.0,8,13165.0,10,S
2018-04-27 14:01:10,13160.0,2,29332,2,13160.0,7,13165.0,10,S
2018-04-27 14:01:11,13160.0,2,29334,2,13160.0,6,13165.0,10,S
2018-04-27 14:01:11,13160.0,2,29336,2,13160.0,5,13165.0,10,S
2018-04-27 14:01:12,13160.0,2,29338,2,13160.0,4,13165.0,10,S
2018-04-27 14:01:12,13160.0,2,29340,2,13160.0,3,13165.0,10,S
2018-04-27 14:01:13,13160.0,2,29342,2,13160.0,2,13165.0,9,S
2018-04-27 14:01:13,13160.0,2,29344,2,13160.0,1,13165.0,9,S
2018-04-27 14:01:14,13160.0,2,29346,2,13160.0,1,13165.0,9,S
2018-04-27 14:01:15,13160.0,10,29356,-6,13160.0,1,13165.0,9,S
2018-04-27 14:01:15,13160.0,2,29358,2,13155.0,34,13165.0,9,S
2018-04-27 14:01:16,13160.0,2,29360,2,13160.0,2,13165.0,9,S
2018-04-27 14:01:17,13160.0,2,29362,2,13160.0,1,13165.0,9,S
2018-04-27 14:01:17,13160.0,2,29364,2,13160.0,1,13165.0,9,S
2018-04-27 14:01:23,13160.0,2,29366,2,13155.0,34,13165.0,9,S
2018-04-27 14:01:24,13160.0,2,29368,2,13155.0,34,13165.0,11,S
2018-04-27 14:01:25,13160.0,2,29370,2,13155.0,34,13165.0,11,S
2018-04-27 14:01:26,13160.0,2,29372,2,13160.0,1,13165.0,12,S
2018-04-27 14:01:26,13160.0,2,29374,2,13160.0,1,13165.0,12,S
2018-04-27 14:01:31,13165.0,2,29376,0,13160.0,2,13165.0,11,B
2018-04-27 14:01:37,13165.0,12,29388,10,13165.0,14,13170.0,7,B
2018-04-27 14:01:38,13170.0,10,29398,-4,13165.0,16,13175.0,11,B
2018-04-27 14:01:38,13165.0,6,29404,6,13165.0,18,13175.0,21,S
2018-04-27 14:01:39,13165.0,2,29406,2,13170.0,7,13175.0,2,S
2018-04-27 14:01:39,13165.0,2,29408,2,13170.0,8,13175.0,7,S
2018-04-27 14:01:40,13170.0,4,29412,2,13170.0,6,13175.0,7,B
2018-04-27 14:01:40,13170.0,2,29414,2,13170.0,5,13175.0,7,B
2018-04-27 14:01:41,13170.0,2,29416,0,13170.0,3,13175.0,8,B
2018-04-27 14:01:41,13170.0,2,29418,2,13170.0,2,13175.0,8,B
2018-04-27 14:01:42,13170.0,2,29420,2,13170.0,1,13175.0,8,B
2018-04-27 14:01:42,13170.0,2,29422,2,13170.0,1,13175.0,8,B
2018-04-27 14:01:43,13180.0,6,29428,2,13170.0,27,13180.0,11,B
2018-04-27 14:01:43,13180.0,4,29432,2,13170.0,16,13180.0,15,B
2018-04-27 14:01:44,13165.0,32,29464,8,13165.0,16,13175.0,31,S
2018-04-27 14:01:46,13165.0,6,29470,4,13165.0,21,13175.0,24,S
2018-04-27 14:01:48,13165.0,2,29472,2,13170.0,17,13175.0,16,S
2018-04-27 14:01:48,13170.0,4,29476,2,13170.0,21,13175.0,15,B
2018-04-27 14:01:49,13170.0,2,29478,2,13170.0,16,13175.0,15,B
2018-04-27 14:01:49,13170.0,2,29480,2,13170.0,15,13175.0,15,B
2018-04-27 14:01:50,13170.0,2,29482,2,13170.0,14,13175.0,15,B
2018-04-27 14:01:50,13170.0,2,29484,2,13170.0,18,13175.0,15,B
2018-04-27 14:01:51,13170.0,2,29486,2,13170.0,12,13175.0,20,B
2018-04-27 14:01:51,13170.0,2,29488,2,13170.0,11,13175.0,20,B
2018-04-27 14:01:52,13170.0,2,29490,2,13170.0,10,13175.0,20,B
2018-04-27 14:01:52,13170.0,2,29492,2,13170.0,9,13175.0,21,B
2018-04-27 14:01:53,13170.0,2,29494,2,13170.0,8,13175.0,21,B
2018-04-27 14:01:53,13170.0,2,29496,2,13170.0,7,13175.0,21,B
2018-04-27 14:01:54,13170.0,2,29498,2,13170.0,6,13175.0,21,B
2018-04-27 14:01:54,13170.0,2,29500,2,13170.0,6,13175.0,21,B
2018-04-27 14:01:57,13175.0,2,29502,-2,13170.0,6,13175.0,18,B
2018-04-27 14:01:58,13170.0,2,29504,2,13170.0,11,13175.0,4,S
2018-04-27 14:01:59,13170.0,2,29506,2,13170.0,11,13175.0,4,S
2018-04-27 14:02:00,13170.0,2,29508,2,13170.0,10,13175.0,4,S
2018-04-27 14:02:01,13170.0,4,29512,2,13170.0,8,13175.0,4,S
2018-04-27 14:02:01,13170.0,2,29514,2,13170.0,8,13175.0,4,S
2018-04-27 14:02:02,13175.0,8,29522,-4,13175.0,1,13180.0,20,B
2018-04-27 14:02:02,13175.0,2,29524,2,13175.0,1,13180.0,17,B
2018-04-27 14:02:03,13175.0,2,29526,0,13175.0,3,13180.0,9,B
2018-04-27 14:02:04,13175.0,2,29528,2,13175.0,2,13180.0,9,B
2018-04-27 14:02:04,13175.0,10,29538,2,13175.0,1,13180.0,5,B
2018-04-27 14:02:05,13175.0,2,29540,0,13175.0,1,13180.0,1,B
2018-04-27 14:02:06,13175.0,2,29542,2,13175.0,1,13180.0,1,B
2018-04-27 14:02:06,13175.0,2,29544,2,13175.0,1,13180.0,2,B
2018-04-27 14:02:07,13175.0,2,29546,2,13170.0,13,13180.0,7,B
2018-04-27 14:02:08,13175.0,2,29548,2,13175.0,1,13180.0,8,B
2018-04-27 14:02:09,13175.0,2,29550,2,13175.0,1,13180.0,13,B
2018-04-27 14:02:09,13175.0,2,29552,0,13170.0,25,13180.0,13,B
2018-04-27 14:02:10,13175.0,2,29554,2,13170.0,10,13175.0,2,B
2018-04-27 14:02:11,13175.0,2,29556,2,13170.0,8,13175.0,9,B
2018-04-27 14:02:13,13175.0,2,29558,0,13170.0,8,13175.0,8,B
2018-04-27 14:02:16,13170.0,4,29562,2,13170.0,7,13180.0,20,S
2018-04-27 14:02:18,13175.0,2,29564,0,13170.0,12,13180.0,20,B
2018-04-27 14:02:20,13180.0,4,29568,0,13175.0,10,13180.0,2,B
2018-04-27 14:02:20,13175.0,2,29570,0,13175.0,12,13180.0,2,S
2018-04-27 14:02:21,13175.0,2,29572,2,13175.0,11,13180.0,2,S
2018-04-27 14:02:21,13180.0,6,29578,2,13180.0,4,13185.0,8,B
2018-04-27 14:02:22,13180.0,2,29580,2,13180.0,3,13185.0,7,B
2018-04-27 14:02:22,13180.0,2,29582,2,13180.0,1,13185.0,7,B
2018-04-27 14:02:23,13180.0,2,29584,2,13180.0,2,13185.0,9,B
2018-04-27 14:02:23,13175.0,6,29590,4,13175.0,27,13185.0,16,S
2018-04-27 14:02:24,13175.0,2,29592,0,13175.0,12,13185.0,17,S
2018-04-27 14:02:24,13175.0,2,29594,2,13175.0,6,13180.0,1,S
2018-04-27 14:02:27,13175.0,2,29596,2,13175.0,9,13180.0,8,S
2018-04-27 14:02:28,13175.0,2,29598,2,13175.0,8,13180.0,8,S
2018-04-27 14:02:29,13180.0,2,29600,0,13175.0,4,13180.0,12,B
2018-04-27 14:02:30,13175.0,2,29602,2,13175.0,6,13180.0,13,S
2018-04-27 14:02:31,13175.0,2,29604,0,13175.0,8,13180.0,13,S
2018-04-27 14:02:31,13175.0,2,29606,2,13175.0,9,13180.0,13,S
2018-04-27 14:02:32,13180.0,4,29610,2,13175.0,8,13180.0,12,B
2018-04-27 14:02:32,13175.0,2,29612,2,13175.0,7,13180.0,12,S
2018-04-27 14:02:33,13175.0,2,29614,2,13175.0,7,13180.0,12,S
2018-04-27 14:02:33,13180.0,2,29616,0,13175.0,13,13180.0,2,B
2018-04-27 14:02:35,13180.0,2,29618,-2,13175.0,13,13180.0,1,B
2018-04-27 14:02:40,13175.0,2,29620,2,13175.0,7,13180.0,14,S
2018-04-27 14:02:40,13175.0,2,29622,2,13175.0,6,13180.0,14,S
2018-04-27 14:02:41,13180.0,4,29626,2,13175.0,6,13180.0,12,B
2018-04-27 14:02:42,13180.0,2,29628,0,13175.0,7,13180.0,12,B
2018-04-27 14:02:44,13180.0,2,29630,0,13175.0,8,13185.0,18,B
2018-04-27 14:02:45,13175.0,2,29632,2,13175.0,7,13180.0,13,S
2018-04-27 14:02:46,13180.0,32,29664,24,13175.0,6,13185.0,20,B
2018-04-27 14:02:46,13175.0,2,29666,2,13175.0,6,13180.0,3,S
2018-04-27 14:02:47,13180.0,10,29676,-8,13175.0,8,13185.0,20,B
2018-04-27 14:02:49,13175.0,4,29680,4,13175.0,16,13185.0,20,S
2018-04-27 14:02:51,13185.0,2,29682,0,13175.0,16,13185.0,17,B
2018-04-27 14:02:52,13185.0,16,29698,2,13185.0,2,13190.0,8,B
2018-04-27 14:02:52,13180.0,6,29704,0,13180.0,2,13190.0,12,S
2018-04-27 14:02:53,13180.0,2,29706,0,13180.0,8,13190.0,12,S
2018-04-27 14:02:53,13180.0,2,29708,2,13180.0,11,13190.0,12,S
2018-04-27 14:02:54,13180.0,2,29710,0,13180.0,10,13185.0,2,S
2018-04-27 14:02:54,13180.0,2,29712,2,13180.0,9,13185.0,10,S
2018-04-27 14:02:55,13180.0,2,29714,2,13175.0,18,13185.0,19,S
2018-04-27 14:02:56,13180.0,2,29716,0,13180.0,2,13185.0,7,S
2018-04-27 14:02:56,13180.0,2,29718,0,13180.0,1,13185.0,8,S
2018-04-27 14:02:57,13185.0,18,29736,16,13185.0,6,13190.0,16,B
2018-04-27 14:02:57,13180.0,14,29750,6,13180.0,4,13190.0,18,S
2018-04-27 14:02:58,13180.0,2,29752,2,13180.0,11,13185.0,1,S
2018-04-27 14:02:58,13180.0,2,29754,0,13180.0,12,13185.0,4,S
2018-04-27 14:02:59,13180.0,2,29756,0,13180.0,11,13185.0,1,S
2018-04-27 14:02:59,13180.0,2,29758,0,13180.0,10,13185.0,1,S
2018-04-27 14:03:00,13180.0,2,29760,0,13180.0,9,13185.0,1,S
2018-04-27 14:03:00,13180.0,2,29762,0,13180.0,8,13185.0,1,S
2018-04-27 14:03:01,13180.0,2,29764,0,13180.0,7,13185.0,1,S
2018-04-27 14:03:01,13180.0,2,29766,0,13180.0,7,13185.0,1,S
2018-04-27 14:03:02,13185.0,2,29768,-2,13180.0,10,13190.0,18,B
2018-04-27 14:03:02,13180.0,2,29770,0,13180.0,9,13190.0,18,S
2018-04-27 14:03:04,13180.0,2,29772,0,13185.0,3,13190.0,7,S
2018-04-27 14:03:04,13180.0,2,29774,2,13185.0,8,13190.0,12,S
2018-04-27 14:03:05,13185.0,4,29778,4,13185.0,2,13190.0,11,B
2018-04-27 14:03:06,13185.0,4,29782,-2,13180.0,17,13190.0,11,B
2018-04-27 14:03:08,13180.0,6,29788,0,13180.0,3,13185.0,13,S
2018-04-27 14:03:09,13180.0,2,29790,2,13180.0,5,13185.0,13,S
2018-04-27 14:03:12,13180.0,2,29792,2,13180.0,4,13185.0,14,S
2018-04-27 14:03:13,13185.0,38,29830,12,13180.0,3,13185.0,4,B
2018-04-27 14:03:13,13180.0,2,29832,2,13180.0,2,13185.0,5,S
2018-04-27 14:03:14,13180.0,2,29834,2,13180.0,1,13185.0,5,S
2018-04-27 14:03:14,13180.0,2,29836,2,13180.0,1,13185.0,5,S
2018-04-27 14:03:15,13180.0,2,29838,2,13180.0,10,13185.0,5,S
2018-04-27 14:03:16,13180.0,2,29840,2,13180.0,9,13185.0,5,S
2018-04-27 14:03:16,13180.0,2,29842,2,13180.0,8,13185.0,5,S
2018-04-27 14:03:17,13180.0,2,29844,2,13180.0,7,13185.0,4,S
2018-04-27 14:03:17,13180.0,2,29846,2,13180.0,6,13185.0,4,S
2018-04-27 14:03:18,13180.0,2,29848,2,13180.0,5,13185.0,6,S
2018-04-27 14:03:18,13180.0,2,29850,2,13180.0,4,13185.0,7,S
2018-04-27 14:03:26,13185.0,2,29852,0,13180.0,12,13185.0,8,B
2018-04-27 14:03:32,13185.0,2,29854,0,13180.0,13,13185.0,8,B
2018-04-27 14:03:35,13185.0,16,29870,0,13185.0,2,13190.0,27,B
2018-04-27 14:03:36,13180.0,6,29876,6,13180.0,12,13185.0,3,S
2018-04-27 14:03:40,13190.0,4,29880,-4,13180.0,12,13190.0,15,B
2018-04-27 14:03:41,13190.0,2,29882,-2,13180.0,12,13190.0,14,B
2018-04-27 14:03:44,13190.0,4,29886,0,13180.0,12,13190.0,12,B
2018-04-27 14:03:46,13185.0,4,29890,2,13180.0,17,13190.0,12,S
2018-04-27 14:03:48,13185.0,2,29892,2,13180.0,16,13190.0,12,S
2018-04-27 14:03:51,13185.0,2,29894,2,13180.0,16,13190.0,12,S
2018-04-27 14:03:53,13185.0,2,29896,0,13185.0,1,13190.0,12,S
2018-04-27 14:03:53,13185.0,12,29908,0,13185.0,1,13190.0,7,S
2018-04-27 14:03:54,13190.0,2,29910,0,13185.0,1,13190.0,3,B
2018-04-27 14:03:55,13185.0,2,29912,2,13180.0,17,13190.0,3,S
2018-04-27 14:03:56,13185.0,2,29914,0,13185.0,6,13190.0,3,S
2018-04-27 14:03:56,13185.0,2,29916,0,13185.0,5,13190.0,3,S
2018-04-27 14:03:57,13185.0,2,29918,0,13185.0,3,13190.0,3,S
2018-04-27 14:03:57,13185.0,2,29920,0,13185.0,1,13190.0,3,S
2018-04-27 14:03:58,13180.0,2,29922,2,13180.0,18,13190.0,4,S
2018-04-27 14:03:59,13180.0,2,29924,2,13180.0,18,13190.0,4,S
2018-04-27 14:04:00,13180.0,2,29926,2,13180.0,17,13190.0,4,S
2018-04-27 14:04:01,13180.0,2,29928,2,13180.0,16,13190.0,4,S
2018-04-27 14:04:02,13180.0,2,29930,2,13180.0,15,13185.0,2,S
2018-04-27 14:04:03,13185.0,2,29932,-2,13180.0,15,13190.0,15,B
2018-04-27 14:04:10,13185.0,2,29934,0,13180.0,19,13190.0,16,B
2018-04-27 14:04:13,13190.0,2,29936,2,13180.0,19,13190.0,15,B
2018-04-27 14:04:15,13185.0,2,29938,2,13180.0,18,13185.0,1,S
2018-04-27 14:04:16,13180.0,2,29940,0,13180.0,4,13185.0,15,S
2018-04-27 14:04:16,13185.0,10,29950,-4,13175.0,18,13185.0,13,B
2018-04-27 14:04:18,13185.0,6,29956,2,13175.0,20,13185.0,11,B
2018-04-27 14:04:22,13185.0,2,29958,0,13175.0,14,13180.0,4,B
2018-04-27 14:04:25,13180.0,2,29960,2,13175.0,15,13180.0,3,S
2018-04-27 14:04:28,13180.0,2,29962,0,13175.0,15,13180.0,3,S
2018-04-27 14:04:30,13180.0,6,29968,4,13180.0,1,13185.0,16,S
2018-04-27 14:04:33,13180.0,2,29970,0,13180.0,11,13185.0,2,S
2018-04-27 14:04:37,13185.0,2,29972,0,13180.0,11,13190.0,17,B
2018-04-27 14:04:39,13190.0,2,29974,0,13180.0,12,13190.0,17,B
2018-04-27 14:04:44,13190.0,2,29976,0,13180.0,13,13190.0,16,B
2018-04-27 14:04:45,13190.0,2,29978,0,13180.0,18,13190.0,15,B
2018-04-27 14:04:46,13180.0,2,29980,0,13180.0,18,13190.0,15,S
2018-04-27 14:04:51,13180.0,2,29982,2,13180.0,17,13190.0,15,S
2018-04-27 14:04:52,13180.0,2,29984,2,13180.0,16,13190.0,15,S
2018-04-27 14:04:52,13180.0,2,29986,0,13180.0,15,13190.0,16,S
2018-04-27 14:04:53,13180.0,2,29988,0,13180.0,14,13190.0,16,S
2018-04-27 14:04:53,13180.0,2,29990,0,13180.0,13,13190.0,19,S
2018-04-27 14:04:54,13190.0,2,29992,0,13180.0,13,13190.0,18,B
2018-04-27 14:04:57,13185.0,4,29996,4,13185.0,3,13190.0,18,S
2018-04-27 14:04:58,13185.0,2,29998,2,13185.0,3,13190.0,18,S
2018-04-27 14:05:01,13185.0,6,30004,2,13180.0,18,13185.0,3,S
2018-04-27 14:05:02,13180.0,6,30010,0,13180.0,5,13185.0,15,S
2018-04-27 14:05:02,13180.0,2,30012,0,13180.0,4,13185.0,15,S
2018-04-27 14:05:03,13180.0,2,30014,0,13180.0,3,13185.0,15,S
2018-04-27 14:05:03,13180.0,2,30016,0,13180.0,2,13185.0,15,S
2018-04-27 14:05:04,13180.0,2,30018,2,13180.0,1,13185.0,15,S
2018-04-27 14:05:04,13180.0,2,30020,2,13180.0,5,13185.0,15,S
2018-04-27 14:05:09,13180.0,2,30022,0,13180.0,4,13185.0,15,S
2018-04-27 14:05:10,13180.0,2,30024,0,13180.0,3,13185.0,15,S
2018-04-27 14:05:10,13180.0,2,30026,0,13180.0,2,13185.0,15,S
2018-04-27 14:05:11,13180.0,2,30028,0,13180.0,1,13185.0,15,S
2018-04-27 14:05:11,13180.0,2,30030,0,13175.0,19,13185.0,15,S
2018-04-27 14:05:12,13180.0,6,30036,-6,13180.0,1,13185.0,15,S
2018-04-27 14:05:13,13180.0,2,30038,0,13180.0,2,13185.0,14,S
2018-04-27 14:05:14,13180.0,2,30040,0,13180.0,1,13185.0,14,S
2018-04-27 14:05:14,13180.0,2,30042,0,13175.0,19,13185.0,14,S
2018-04-27 14:05:15,13180.0,2,30044,2,13180.0,2,13185.0,14,S
2018-04-27 14:05:16,13180.0,2,30046,2,13180.0,3,13185.0,10,S
2018-04-27 14:05:16,13180.0,2,30048,2,13180.0,2,13185.0,10,S
2018-04-27 14:05:17,13180.0,2,30050,0,13180.0,1,13185.0,10,S
2018-04-27 14:05:17,13180.0,2,30052,0,13175.0,19,13185.0,10,S
2018-04-27 14:05:18,13180.0,2,30054,0,13180.0,1,13185.0,9,S
2018-04-27 14:05:19,13180.0,2,30056,2,13175.0,19,13185.0,9,S
2018-04-27 14:05:20,13180.0,2,30058,0,13180.0,2,13185.0,9,S
2018-04-27 14:05:21,13180.0,2,30060,-2,13175.0,19,13180.0,1,S
2018-04-27 14:05:25,13180.0,4,30064,-2,13180.0,20,13185.0,16,S
2018-04-27 14:05:26,13180.0,2,30066,2,13180.0,19,13185.0,16,S
2018-04-27 14:05:26,13180.0,2,30068,2,13180.0,18,13185.0,16,S
2018-04-27 14:05:27,13180.0,2,30070,2,13180.0,17,13185.0,16,S
2018-04-27 14:05:27,13180.0,2,30072,2,13180.0,16,13185.0,16,S
2018-04-27 14:05:28,13180.0,2,30074,2,13180.0,15,13185.0,10,S
2018-04-27 14:05:28,13180.0,2,30076,2,13180.0,14,13185.0,10,S
2018-04-27 14:05:29,13180.0,2,30078,2,13180.0,13,13185.0,10,S
2018-04-27 14:05:29,13180.0,2,30080,2,13180.0,12,13185.0,10,S
2018-04-27 14:05:30,13180.0,2,30082,2,13180.0,11,13185.0,10,S
2018-04-27 14:05:30,13180.0,2,30084,2,13180.0,10,13185.0,10,S
2018-04-27 14:05:31,13180.0,2,30086,2,13180.0,9,13185.0,10,S
2018-04-27 14:05:31,13180.0,2,30088,2,13180.0,9,13185.0,10,S
2018-04-27 14:05:34,13185.0,8,30096,4,13180.0,9,13185.0,6,B
2018-04-27 14:05:35,13180.0,8,30104,0,13180.0,13,13185.0,4,S
2018-04-27 14:05:36,13180.0,2,30106,2,13180.0,12,13185.0,5,S
2018-04-27 14:05:36,13180.0,2,30108,2,13180.0,12,13185.0,5,S
2018-04-27 14:05:39,13185.0,2,30110,2,13180.0,12,13185.0,4,B
2018-04-27 14:05:39,13180.0,2,30112,2,13180.0,11,13185.0,6,S
2018-04-27 14:05:40,13180.0,4,30116,2,13180.0,9,13185.0,12,S
2018-04-27 14:05:40,13180.0,18,30134,4,13175.0,19,13185.0,36,S
2018-04-27 14:05:41,13175.0,2,30136,2,13175.0,18,13180.0,1,S
2018-04-27 14:05:42,13180.0,2,30138,-2,13180.0,2,13185.0,24,B
2018-04-27 14:05:44,13180.0,2,30140,2,13180.0,5,13185.0,14,B
2018-04-27 14:05:45,13180.0,2,30142,2,13180.0,3,13185.0,14,B
2018-04-27 14:05:56,13180.0,2,30144,0,13180.0,3,13185.0,16,B
2018-04-27 14:05:56,13180.0,2,30146,0,13180.0,2,13185.0,16,B
2018-04-27 14:05:57,13180.0,2,30148,0,13180.0,1,13185.0,16,B
2018-04-27 14:05:57,13180.0,2,30150,2,13175.0,18,13185.0,16,B
2018-04-27 14:06:02,13180.0,2,30152,0,13175.0,18,13180.0,4,B
2018-04-27 14:06:03,13180.0,2,30154,0,13180.0,1,13185.0,21,B
2018-04-27 14:06:08,13185.0,4,30158,0,13180.0,13,13185.0,4,B
2018-04-27 14:06:09,13185.0,8,30166,-6,13180.0,20,13190.0,10,B
2018-04-27 14:06:24,13185.0,2,30168,2,13180.0,19,13190.0,12,B
2018-04-27 14:06:33,13190.0,2,30170,-2,13180.0,20,13190.0,11,B
2018-04-27 14:06:34,13185.0,2,30172,2,13185.0,6,13190.0,11,S
2018-04-27 14:06:34,13185.0,2,30174,0,13185.0,5,13190.0,11,S
2018-04-27 14:06:35,13185.0,12,30186,0,13180.0,20,13195.0,21,S
2018-04-27 14:06:36,13185.0,24,30210,2,13185.0,10,13190.0,3,S
2018-04-27 14:06:36,13190.0,8,30218,-2,13190.0,13,13195.0,5,B
2018-04-27 14:06:37,13190.0,8,30226,0,13190.0,16,13200.0,12,B
2018-04-27 14:06:37,13190.0,2,30228,2,13190.0,16,13200.0,28,B
2018-04-27 14:06:39,13200.0,6,30234,2,13190.0,16,13200.0,25,B
2018-04-27 14:06:39,13190.0,4,30238,-4,13190.0,14,13200.0,25,S
2018-04-27 14:06:40,13190.0,2,30240,2,13195.0,1,13200.0,30,S
2018-04-27 14:06:40,13190.0,4,30244,2,13190.0,8,13200.0,30,S
2018-04-27 14:06:41,13190.0,4,30248,4,13190.0,7,13200.0,17,S
2018-04-27 14:06:41,13190.0,2,30250,2,13190.0,7,13200.0,30,S
2018-04-27 14:06:44,13200.0,20,30270,16,13190.0,7,13200.0,8,B
2018-04-27 14:06:45,13190.0,4,30274,4,13190.0,7,13200.0,8,S
2018-04-27 14:06:48,13195.0,2,30276,0,13190.0,7,13200.0,8,B
2018-04-27 14:06:51,13190.0,2,30278,2,13190.0,6,13200.0,13,S
2018-04-27 14:06:52,13190.0,2,30280,2,13190.0,10,13200.0,13,S
2018-04-27 14:06:52,13190.0,2,30282,2,13190.0,10,13200.0,8,S
2018-04-27 14:06:54,13200.0,10,30292,-8,13195.0,1,13200.0,3,B
2018-04-27 14:06:54,13200.0,6,30298,-2,13190.0,10,13200.0,2,B
2018-04-27 14:06:55,13200.0,6,30304,2,13195.0,1,13205.0,4,B
2018-04-27 14:06:55,13195.0,2,30306,2,13195.0,12,13200.0,4,S
2018-04-27 14:06:56,13200.0,10,30316,0,13195.0,11,13200.0,5,B
2018-04-27 14:06:56,13195.0,2,30318,2,13195.0,10,13205.0,7,S
2018-04-27 14:06:57,13195.0,2,30320,2,13195.0,9,13205.0,13,S
2018-04-27 14:06:57,13195.0,2,30322,2,13195.0,12,13205.0,21,S
2018-04-27 14:06:58,13195.0,2,30324,0,13195.0,12,13205.0,21,S
2018-04-27 14:06:59,13195.0,2,30326,0,13195.0,11,13205.0,21,S
2018-04-27 14:07:00,13195.0,2,30328,0,13195.0,10,13205.0,21,S
2018-04-27 14:07:00,13195.0,2,30330,0,13195.0,12,13205.0,9,S
2018-04-27 14:07:01,13195.0,2,30332,0,13200.0,5,13205.0,13,S
2018-04-27 14:07:01,13195.0,10,30342,-6,13195.0,7,13200.0,12,S
2018-04-27 14:07:02,13195.0,2,30344,2,13195.0,6,13200.0,7,S
2018-04-27 14:07:02,13195.0,2,30346,0,13195.0,5,13200.0,7,S
2018-04-27 14:07:03,13195.0,2,30348,0,13195.0,4,13200.0,7,S
2018-04-27 14:07:03,13195.0,2,30350,0,13195.0,4,13200.0,7,S
2018-04-27 14:07:04,13195.0,2,30352,0,13195.0,2,13200.0,7,S
2018-04-27 14:07:05,13195.0,2,30354,2,13195.0,2,13200.0,7,S
2018-04-27 14:07:05,13200.0,2,30356,0,13195.0,2,13200.0,6,B
2018-04-27 14:07:06,13195.0,2,30358,2,13195.0,1,13200.0,6,S
2018-04-27 14:07:06,13195.0,2,30360,2,13195.0,1,13200.0,6,S
2018-04-27 14:07:08,13200.0,4,30364,0,13195.0,1,13200.0,4,B
2018-04-27 14:07:12,13195.0,2,30366,2,13190.0,11,13200.0,4,S
2018-04-27 14:07:12,13190.0,2,30368,2,13190.0,10,13200.0,4,S
2018-04-27 14:07:13,13195.0,6,30374,0,13190.0,2,13195.0,14,B
2018-04-27 14:07:14,13185.0,6,30380,4,13185.0,11,13195.0,14,S
2018-04-27 14:07:15,13185.0,2,30382,0,13190.0,9,13195.0,5,S
2018-04-27 14:07:21,13190.0,2,30384,2,13190.0,10,13195.0,3,B
2018-04-27 14:07:22,13190.0,2,30386,0,13190.0,9,13195.0,3,B
2018-04-27 14:07:25,13195.0,2,30388,2,13185.0,16,13195.0,16,B
2018-04-27 14:07:29,13195.0,10,30398,-6,13185.0,16,13195.0,17,B
2018-04-27 14:07:31,13185.0,2,30400,2,13185.0,14,13195.0,19,S
2018-04-27 14:07:33,13185.0,2,30402,0,13185.0,6,13190.0,14,S
2018-04-27 14:07:49,13185.0,2,30404,0,13180.0,15,13190.0,19,S
2018-04-27 14:07:50,13190.0,10,30414,0,13180.0,17,13190.0,14,B
2018-04-27 14:07:53,13185.0,4,30418,0,13185.0,18,13195.0,15,S
2018-04-27 14:07:53,13185.0,2,30420,0,13185.0,17,13195.0,15,S
2018-04-27 14:07:54,13185.0,2,30422,0,13185.0,16,13195.0,15,S
2018-04-27 14:07:54,13185.0,2,30424,0,13185.0,15,13195.0,15,S
2018-04-27 14:07:55,13185.0,2,30426,0,13185.0,15,13195.0,20,S
2018-04-27 14:08:03,13185.0,2,30428,2,13185.0,14,13195.0,20,S
2018-04-27 14:08:04,13185.0,2,30430,2,13185.0,10,13190.0,1,S
2018-04-27 14:08:04,13185.0,2,30432,2,13185.0,9,13190.0,1,S
2018-04-27 14:08:05,13185.0,2,30434,0,13185.0,8,13190.0,1,S
2018-04-27 14:08:05,13185.0,2,30436,0,13185.0,7,13190.0,1,S
2018-04-27 14:08:06,13185.0,2,30438,2,13185.0,6,13190.0,1,S
2018-04-27 14:08:06,13185.0,2,30440,0,13185.0,5,13190.0,1,S
2018-04-27 14:08:07,13185.0,2,30442,0,13185.0,4,13190.0,6,S
2018-04-27 14:08:07,13185.0,2,30444,0,13185.0,4,13190.0,6,S
2018-04-27 14:08:09,13190.0,10,30454,0,13185.0,4,13190.0,1,B
2018-04-27 14:08:13,13190.0,4,30458,2,13190.0,1,13195.0,20,B
2018-04-27 14:08:14,13185.0,4,30462,2,13185.0,2,13190.0,1,S
2018-04-27 14:08:14,13185.0,4,30466,2,13185.0,1,13190.0,7,S
2018-04-27 14:08:15,13185.0,6,30472,0,13180.0,17,13190.0,14,S
2018-04-27 14:08:18,13180.0,2,30474,2,13180.0,15,13190.0,19,S
2018-04-27 14:08:18,13180.0,2,30476,0,13180.0,13,13190.0,19,S
2018-04-27 14:08:22,13190.0,2,30478,0,13180.0,13,13190.0,18,B
2018-04-27 14:08:29,13190.0,4,30482,-4,13180.0,32,13190.0,7,B
2018-04-27 14:08:30,13185.0,2,30484,2,13185.0,12,13190.0,2,S
2018-04-27 14:08:30,13190.0,6,30490,4,13185.0,25,13195.0,30,B
2018-04-27 14:08:31,13185.0,2,30492,0,13185.0,14,13195.0,30,S
2018-04-27 14:08:31,13185.0,2,30494,0,13185.0,8,13190.0,1,S
2018-04-27 14:08:32,13185.0,2,30496,0,13185.0,7,13195.0,30,S
2018-04-27 14:08:32,13185.0,2,30498,2,13185.0,6,13195.0,30,S
2018-04-27 14:08:33,13185.0,2,30500,2,13185.0,6,13195.0,30,S
2018-04-27 14:08:34,13185.0,2,30502,2,13185.0,6,13190.0,3,S
2018-04-27 14:08:35,13185.0,2,30504,2,13185.0,4,13190.0,9,S
2018-04-27 14:08:35,13185.0,2,30506,2,13185.0,3,13190.0,9,S
2018-04-27 14:08:36,13185.0,2,30508,0,13180.0,18,13190.0,9,S
2018-04-27 14:08:42,13185.0,2,30510,2,13185.0,1,13190.0,15,S
2018-04-27 14:08:42,13180.0,6,30516,4,13180.0,24,13190.0,15,S
2018-04-27 14:08:47,13180.0,4,30520,0,13180.0,22,13190.0,17,S
2018-04-27 14:09:19,13180.0,2,30522,0,13180.0,15,13185.0,14,S
2018-04-27 14:09:24,13180.0,2,30524,0,13180.0,16,13185.0,10,S
2018-04-27 14:09:25,13185.0,2,30526,-2,13180.0,16,13185.0,9,B
2018-04-27 14:09:26,13185.0,2,30528,-2,13180.0,16,13185.0,7,B
2018-04-27 14:09:32,13185.0,4,30532,4,13180.0,16,13185.0,5,B
2018-04-27 14:09:35,13185.0,2,30534,2,13180.0,22,13190.0,40,B
2018-04-27 14:09:37,13180.0,4,30538,2,13180.0,21,13190.0,40,S
2018-04-27 14:09:53,13180.0,2,30540,2,13180.0,12,13185.0,15,S
2018-04-27 14:09:53,13180.0,2,30542,2,13180.0,14,13185.0,15,S
2018-04-27 14:09:54,13180.0,2,30544,2,13180.0,15,13185.0,9,S
2018-04-27 14:10:10,13180.0,2,30546,2,13180.0,5,13185.0,15,S
2018-04-27 14:10:11,13180.0,2,30548,2,13180.0,4,13185.0,15,S
2018-04-27 14:10:11,13180.0,2,30550,2,13180.0,3,13185.0,15,S
2018-04-27 14:10:12,13180.0,2,30552,2,13180.0,2,13185.0,15,S
2018-04-27 14:10:12,13180.0,2,30554,0,13180.0,6,13185.0,13,S
2018-04-27 14:10:13,13180.0,2,30556,0,13180.0,7,13185.0,8,S
2018-04-27 14:10:14,13180.0,2,30558,2,13180.0,6,13185.0,8,S
2018-04-27 14:10:20,13180.0,2,30560,2,13180.0,5,13185.0,8,S
2018-04-27 14:10:24,13180.0,2,30562,2,13180.0,4,13185.0,8,S
2018-04-27 14:10:24,13180.0,2,30564,2,13180.0,3,13185.0,8,S
2018-04-27 14:10:48,13180.0,2,30566,2,13180.0,3,13185.0,9,S
2018-04-27 14:10:50,13180.0,2,30568,2,13180.0,2,13185.0,9,S
2018-04-27 14:10:50,13180.0,2,30570,2,13180.0,1,13185.0,9,S
2018-04-27 14:10:51,13180.0,2,30572,2,13180.0,1,13185.0,9,S
2018-04-27 14:10:52,13180.0,2,30574,2,13175.0,9,13185.0,9,S
2018-04-27 14:10:53,13180.0,2,30576,2,13180.0,2,13185.0,9,S
2018-04-27 14:10:54,13180.0,2,30578,2,13180.0,1,13185.0,9,S
2018-04-27 14:10:54,13180.0,2,30580,2,13175.0,15,13185.0,9,S
2018-04-27 14:11:00,13185.0,10,30590,8,13175.0,20,13185.0,9,B
2018-04-27 14:11:01,13185.0,10,30600,8,13175.0,20,13185.0,4,B
2018-04-27 14:11:02,13185.0,10,30610,4,13175.0,20,13185.0,5,B
2018-04-27 14:11:03,13185.0,10,30620,10,13180.0,1,13185.0,2,B
2018-04-27 14:11:03,13180.0,2,30622,0,13180.0,1,13185.0,3,S
2018-04-27 14:11:05,13180.0,2,30624,2,13180.0,1,13185.0,5,S
2018-04-27 14:11:05,13180.0,2,30626,2,13175.0,20,13185.0,5,S
2018-04-27 14:11:12,13180.0,2,30628,2,13180.0,19,13185.0,5,S
2018-04-27 14:11:14,13180.0,2,30630,0,13180.0,18,13185.0,3,S
2018-04-27 14:11:18,13180.0,2,30632,2,13180.0,17,13185.0,2,S
2018-04-27 14:11:25,13185.0,4,30636,2,13180.0,20,13185.0,1,B
2018-04-27 14:11:26,13180.0,2,30638,2,13180.0,20,13185.0,1,S
2018-04-27 14:11:27,13185.0,2,30640,0,13185.0,19,13190.0,38,B
2018-04-27 14:11:28,13185.0,12,30652,6,13185.0,13,13190.0,40,B
2018-04-27 14:11:28,13185.0,2,30654,2,13185.0,12,13190.0,40,B
2018-04-27 14:11:36,13190.0,54,30708,-48,13190.0,40,13195.0,19,B
2018-04-27 14:11:37,13195.0,6,30714,0,13190.0,50,13195.0,10,B
2018-04-27 14:11:37,13190.0,2,30716,0,13190.0,49,13195.0,10,S
2018-04-27 14:11:38,13190.0,6,30722,0,13190.0,45,13195.0,10,S
2018-04-27 14:11:46,13195.0,20,30742,-20,13195.0,1,13200.0,22,B
2018-04-27 14:11:46,13195.0,2,30744,0,13195.0,4,13200.0,23,B
2018-04-27 14:11:52,13195.0,2,30746,-2,13195.0,10,13200.0,16,B
2018-04-27 14:11:57,13195.0,2,30748,2,13195.0,10,13200.0,14,B
2018-04-27 14:11:58,13200.0,6,30754,0,13195.0,10,13200.0,11,B
2018-04-27 14:11:59,13195.0,2,30756,2,13195.0,9,13200.0,11,S
2018-04-27 14:12:07,13200.0,4,30760,0,13195.0,11,13200.0,10,B
2018-04-27 14:12:10,13195.0,6,30766,-4,13195.0,8,13200.0,20,S
2018-04-27 14:12:16,13195.0,14,30780,-2,13195.0,1,13200.0,23,S
2018-04-27 14:12:17,13195.0,2,30782,-2,13190.0,52,13195.0,3,S
2018-04-27 14:12:24,13195.0,2,30784,0,13190.0,44,13195.0,11,S
2018-04-27 14:12:27,13195.0,2,30786,0,13190.0,44,13195.0,15,S
2018-04-27 14:12:42,13195.0,2,30788,2,13190.0,44,13195.0,12,S
2018-04-27 14:12:46,13195.0,4,30792,2,13190.0,44,13195.0,9,S
2018-04-27 14:12:54,13195.0,2,30794,2,13190.0,45,13195.0,4,S
2018-04-27 14:12:56,13195.0,10,30804,2,13190.0,50,13200.0,30,S
2018-04-27 14:13:03,13195.0,2,30806,2,13190.0,52,13200.0,35,S
2018-04-27 14:13:05,13200.0,2,30808,0,13190.0,52,13200.0,34,B
2018-04-27 14:13:06,13200.0,4,30812,2,13190.0,52,13200.0,32,B
2018-04-27 14:13:11,13200.0,64,30876,20,13200.0,18,13205.0,7,B
2018-04-27 14:13:11,13200.0,46,30922,10,13190.0,55,13195.0,1,B
2018-04-27 14:13:12,13195.0,2,30924,0,13195.0,12,13200.0,1,S
2018-04-27 14:13:14,13195.0,2,30926,2,13195.0,12,13200.0,5,S
2018-04-27 14:13:15,13200.0,4,30930,0,13195.0,12,13200.0,8,B
2018-04-27 14:13:16,13200.0,16,30946,0,13200.0,2,13205.0,9,B
2018-04-27 14:13:17,13205.0,12,30958,-4,13205.0,1,13210.0,3,B
2018-04-27 14:13:17,13205.0,4,30962,0,13205.0,1,13210.0,5,B
2018-04-27 14:13:18,13205.0,2,30964,0,13200.0,12,13210.0,10,B
2018-04-27 14:13:27,13200.0,16,30980,6,13200.0,1,13205.0,15,S
2018-04-27 14:13:28,13195.0,4,30984,0,13195.0,62,13205.0,20,S
2018-04-27 14:13:29,13205.0,44,31028,18,13205.0,28,13210.0,24,B
2018-04-27 14:13:29,13200.0,58,31086,58,13195.0,62,13205.0,7,S
2018-04-27 14:13:31,13200.0,2,31088,2,13200.0,1,13205.0,7,S
2018-04-27 14:13:34,13205.0,2,31090,0,13200.0,1,13205.0,7,B
2018-04-27 14:13:34,13205.0,2,31092,0,13200.0,1,13205.0,6,B
2018-04-27 14:13:35,13205.0,2,31094,2,13200.0,2,13205.0,5,B
2018-04-27 14:13:35,13200.0,2,31096,2,13200.0,2,13205.0,5,S
2018-04-27 14:13:37,13200.0,2,31098,0,13200.0,1,13205.0,5,S
2018-04-27 14:13:44,13200.0,2,31100,2,13200.0,1,13205.0,5,S
2018-04-27 14:13:44,13200.0,2,31102,2,13195.0,62,13205.0,6,S
2018-04-27 14:13:53,13205.0,28,31130,10,13205.0,24,13210.0,36,B
2018-04-27 14:13:53,13205.0,50,31180,26,13205.0,4,13210.0,33,B
2018-04-27 14:13:54,13200.0,6,31186,4,13200.0,10,13205.0,2,S
2018-04-27 14:14:05,13205.0,10,31196,0,13200.0,10,13205.0,3,B
2018-04-27 14:14:17,13200.0,6,31202,-4,13195.0,69,13200.0,3,S
2018-04-27 14:14:18,13195.0,6,31208,-4,13195.0,63,13200.0,2,S
2018-04-27 14:14:18,13195.0,6,31214,-6,13195.0,60,13200.0,6,S
2018-04-27 14:14:22,13200.0,2,31216,2,13195.0,60,13200.0,7,B
2018-04-27 14:14:24,13200.0,14,31230,8,13200.0,6,13205.0,24,B
2018-04-27 14:14:27,13200.0,2,31232,2,13200.0,6,13205.0,23,B
2018-04-27 14:14:33,13200.0,2,31234,2,13200.0,5,13205.0,24,B
2018-04-27 14:14:33,13200.0,4,31238,-2,13200.0,3,13205.0,24,B
2018-04-27 14:14:34,13200.0,2,31240,2,13200.0,2,13205.0,24,B
2018-04-27 14:14:35,13200.0,4,31244,4,13195.0,71,13200.0,1,B
2018-04-27 14:14:35,13200.0,2,31246,0,13200.0,3,13205.0,25,B
2018-04-27 14:14:36,13200.0,4,31250,-2,13195.0,71,13205.0,25,B
2018-04-27 14:14:37,13205.0,2,31252,2,13195.0,71,13205.0,25,B
2018-04-27 14:14:42,13200.0,2,31254,-2,13195.0,70,13205.0,25,S
2018-04-27 14:14:42,13205.0,6,31260,-4,13195.0,70,13205.0,22,B
2018-04-27 14:14:43,13200.0,2,31262,2,13200.0,2,13205.0,22,S
2018-04-27 14:14:44,13200.0,2,31264,2,13200.0,2,13205.0,21,S
2018-04-27 14:14:45,13200.0,2,31266,2,13200.0,1,13205.0,21,S
2018-04-27 14:14:45,13200.0,2,31268,2,13200.0,1,13205.0,21,S
2018-04-27 14:14:46,13205.0,12,31280,12,13200.0,1,13205.0,15,B
2018-04-27 14:14:47,13200.0,2,31282,2,13195.0,70,13205.0,15,S
2018-04-27 14:14:48,13195.0,2,31284,0,13195.0,69,13205.0,15,S
2018-04-27 14:14:51,13195.0,2,31286,2,13200.0,2,13205.0,15,S
2018-04-27 14:14:52,13205.0,4,31290,2,13195.0,69,13205.0,15,B
2018-04-27 14:14:55,13195.0,2,31292,0,13195.0,68,13205.0,15,S
2018-04-27 14:15:06,13195.0,2,31294,0,13195.0,71,13205.0,15,S
2018-04-27 14:15:07,13195.0,10,31304,-6,13195.0,69,13205.0,15,S
2018-04-27 14:15:09,13195.0,2,31306,0,13195.0,67,13205.0,15,S
2018-04-27 14:15:14,13205.0,2,31308,2,13200.0,10,13205.0,12,B
2018-04-27 14:15:16,13205.0,10,31318,2,13200.0,11,13205.0,7,B
2018-04-27 14:15:18,13205.0,4,31322,0,13200.0,11,13205.0,5,B
2018-04-27 14:15:19,13200.0,2,31324,-2,13200.0,10,13205.0,5,S
2018-04-27 14:15:21,13205.0,8,31332,-4,13200.0,17,13210.0,25,B
2018-04-27 14:15:23,13205.0,4,31336,0,13200.0,22,13205.0,1,B
2018-04-27 14:15:25,13205.0,2,31338,2,13200.0,18,13205.0,2,B
2018-04-27 14:15:31,13200.0,2,31340,-2,13200.0,14,13205.0,4,S
2018-04-27 14:15:32,13205.0,4,31344,0,13200.0,14,13205.0,2,B
2018-04-27 14:15:35,13200.0,2,31346,0,13200.0,15,13205.0,2,S
2018-04-27 14:15:36,13200.0,2,31348,0,13200.0,14,13205.0,2,S
2018-04-27 14:15:41,13205.0,4,31352,0,13200.0,14,13210.0,32,B
2018-04-27 14:15:49,13210.0,2,31354,0,13200.0,19,13210.0,30,B
2018-04-27 14:15:51,13210.0,2,31356,2,13205.0,1,13210.0,29,B
2018-04-27 14:15:51,13205.0,6,31362,6,13205.0,2,13210.0,26,S
2018-04-27 14:15:52,13205.0,4,31366,4,13200.0,20,13210.0,26,S
2018-04-27 14:15:53,13200.0,6,31372,-4,13200.0,20,13205.0,2,S
2018-04-27 14:15:56,13205.0,2,31374,0,13205.0,1,13210.0,28,B
2018-04-27 14:15:57,13205.0,2,31376,0,13200.0,19,13210.0,28,B
2018-04-27 14:16:01,13205.0,2,31378,2,13200.0,19,13210.0,27,B
2018-04-27 14:16:18,13205.0,2,31380,0,13200.0,18,13205.0,3,B
2018-04-27 14:16:29,13200.0,22,31402,-12,13195.0,57,13200.0,6,S
2018-04-27 14:16:30,13200.0,10,31412,0,13195.0,62,13205.0,15,S
2018-04-27 14:16:38,13200.0,2,31414,0,13195.0,62,13205.0,15,S
2018-04-27 14:17:02,13195.0,4,31418,4,13195.0,60,13205.0,16,S
2018-04-27 14:17:34,13205.0,30,31448,12,13205.0,5,13210.0,22,B
2018-04-27 14:17:34,13200.0,22,31470,12,13195.0,55,13205.0,8,S
2018-04-27 14:17:41,13200.0,2,31472,2,13195.0,55,13205.0,9,S
2018-04-27 14:17:43,13200.0,2,31474,0,13200.0,2,13205.0,9,S
2018-04-27 14:17:44,13200.0,4,31478,2,13195.0,57,13205.0,9,S
2018-04-27 14:17:47,13195.0,10,31488,10,13195.0,54,13205.0,9,S
2018-04-27 14:18:04,13195.0,2,31490,0,13195.0,55,13205.0,9,S
2018-04-27 14:18:07,13200.0,8,31498,-2,13195.0,55,13205.0,3,B
2018-04-27 14:18:09,13200.0,2,31500,0,13200.0,2,13205.0,5,B
2018-04-27 14:18:13,13200.0,4,31504,4,13200.0,1,13205.0,3,B
2018-04-27 14:18:40,13200.0,2,31506,2,13200.0,4,13205.0,3,B
2018-04-27 14:18:41,13200.0,2,31508,2,13200.0,3,13205.0,4,B
2018-04-27 14:18:41,13200.0,2,31510,0,13200.0,1,13205.0,4,B
2018-04-27 14:18:47,13200.0,2,31512,0,13195.0,54,13200.0,1,B
2018-04-27 14:19:10,13195.0,4,31516,2,13195.0,46,13200.0,7,S
2018-04-27 14:19:11,13195.0,4,31520,2,13195.0,44,13200.0,7,S
2018-04-27 14:19:11,13195.0,2,31522,2,13195.0,42,13200.0,10,S
2018-04-27 14:19:12,13195.0,2,31524,2,13195.0,41,13200.0,11,S
2018-04-27 14:19:12,13195.0,4,31528,2,13195.0,39,13200.0,11,S
2018-04-27 14:19:13,13195.0,2,31530,0,13195.0,38,13200.0,10,S
2018-04-27 14:19:18,13200.0,2,31532,2,13195.0,38,13200.0,8,B
2018-04-27 14:19:29,13195.0,2,31534,0,13195.0,37,13200.0,13,S
2018-04-27 14:20:05,13200.0,30,31564,2,13195.0,41,13205.0,8,B
2018-04-27 14:20:06,13200.0,4,31568,4,13200.0,4,13205.0,4,B
2018-04-27 14:20:07,13200.0,4,31572,-2,13200.0,1,13205.0,5,B
2018-04-27 14:20:07,13200.0,4,31576,2,13195.0,45,13205.0,5,B
2018-04-27 14:20:08,13200.0,4,31580,4,13195.0,45,13200.0,1,B
2018-04-27 14:20:09,13200.0,2,31582,0,13195.0,45,13205.0,5,B
2018-04-27 14:20:11,13195.0,2,31584,2,13195.0,40,13200.0,7,S
2018-04-27 14:20:16,13200.0,4,31588,4,13195.0,40,13200.0,6,B
2018-04-27 14:20:18,13200.0,2,31590,0,13195.0,39,13200.0,5,B
2018-04-27 14:20:18,13200.0,10,31600,-10,13195.0,39,13205.0,8,B
2018-04-27 14:20:23,13200.0,2,31602,0,13195.0,39,13205.0,14,B
2018-04-27 14:20:42,13195.0,2,31604,0,13195.0,38,13200.0,10,S
2018-04-27 14:20:42,13195.0,4,31608,0,13195.0,36,13200.0,10,S
2018-04-27 14:20:47,13200.0,22,31630,-18,13195.0,40,13205.0,9,B
2018-04-27 14:20:48,13200.0,10,31640,0,13195.0,40,13205.0,6,B
2018-04-27 14:20:55,13200.0,8,31648,4,13195.0,41,13205.0,7,B
2018-04-27 14:20:56,13200.0,4,31652,2,13195.0,41,13205.0,7,B
2018-04-27 14:21:03,13200.0,2,31654,2,13195.0,41,13205.0,7,B
2018-04-27 14:21:17,13195.0,2,31656,2,13195.0,40,13205.0,8,S
2018-04-27 14:21:21,13195.0,2,31658,2,13200.0,2,13205.0,8,S
2018-04-27 14:21:22,13195.0,6,31664,6,13195.0,39,13205.0,8,S
2018-04-27 14:21:28,13195.0,2,31666,2,13200.0,3,13205.0,7,S
2018-04-27 14:21:29,13195.0,2,31668,2,13200.0,3,13205.0,7,S
2018-04-27 14:21:34,13200.0,8,31676,0,13200.0,3,13205.0,8,B
2018-04-27 14:21:35,13200.0,2,31678,0,13200.0,2,13205.0,8,B
2018-04-27 14:21:35,13200.0,2,31680,0,13200.0,1,13205.0,8,B
2018-04-27 14:21:36,13200.0,2,31682,0,13195.0,38,13205.0,8,B
2018-04-27 14:21:39,13200.0,2,31684,0,13195.0,38,13205.0,8,B
2018-04-27 14:21:42,13200.0,2,31686,2,13200.0,1,13205.0,8,B
2018-04-27 14:21:43,13200.0,2,31688,2,13195.0,39,13205.0,8,B
2018-04-27 14:22:00,13200.0,4,31692,2,13200.0,3,13205.0,4,B
2018-04-27 14:22:01,13200.0,2,31694,2,13200.0,2,13205.0,4,B
2018-04-27 14:22:01,13200.0,2,31696,2,13200.0,1,13205.0,4,B
2018-04-27 14:22:02,13200.0,2,31698,2,13195.0,39,13205.0,5,B
2018-04-27 14:22:11,13205.0,10,31708,-4,13200.0,1,13205.0,1,B
2018-04-27 14:22:24,13205.0,2,31710,2,13200.0,13,13210.0,19,B
2018-04-27 14:22:51,13205.0,2,31712,0,13200.0,13,13210.0,20,B
2018-04-27 14:22:51,13210.0,10,31722,10,13200.0,13,13210.0,15,B
2018-04-27 14:23:03,13205.0,8,31730,-2,13200.0,13,13210.0,15,S
2018-04-27 14:23:04,13210.0,12,31742,4,13200.0,13,13210.0,9,B
2018-04-27 14:23:05,13205.0,2,31744,2,13200.0,13,13210.0,9,S
2018-04-27 14:23:12,13210.0,22,31766,-4,13205.0,7,13215.0,4,B
2018-04-27 14:23:13,13205.0,2,31768,2,13205.0,11,13215.0,5,S
2018-04-27 14:23:13,13205.0,2,31770,2,13205.0,10,13215.0,5,S
2018-04-27 14:23:14,13205.0,2,31772,2,13205.0,9,13215.0,6,S
2018-04-27 14:23:14,13205.0,2,31774,2,13205.0,8,13215.0,6,S
2018-04-27 14:23:15,13205.0,2,31776,2,13205.0,7,13215.0,6,S
2018-04-27 14:23:15,13205.0,2,31778,2,13205.0,6,13215.0,6,S
2018-04-27 14:23:16,13205.0,2,31780,2,13205.0,7,13215.0,6,S
2018-04-27 14:23:16,13205.0,2,31782,0,13205.0,6,13215.0,6,S
2018-04-27 14:23:17,13205.0,2,31784,2,13205.0,5,13215.0,7,S
2018-04-27 14:23:17,13205.0,2,31786,0,13205.0,5,13215.0,8,S
2018-04-27 14:23:18,13205.0,2,31788,2,13205.0,6,13215.0,8,S
2018-04-27 14:23:19,13205.0,2,31790,0,13205.0,5,13215.0,9,S
2018-04-27 14:23:19,13205.0,2,31792,0,13205.0,4,13215.0,11,S
2018-04-27 14:23:20,13205.0,2,31794,0,13205.0,3,13215.0,11,S
2018-04-27 14:23:20,13205.0,2,31796,0,13205.0,5,13215.0,11,S
2018-04-27 14:23:21,13205.0,2,31798,2,13205.0,4,13215.0,11,S
2018-04-27 14:23:21,13205.0,2,31800,2,13205.0,3,13215.0,11,S
2018-04-27 14:23:22,13205.0,2,31802,0,13205.0,2,13210.0,1,S
2018-04-27 14:23:22,13205.0,2,31804,0,13205.0,1,13210.0,1,S
2018-04-27 14:23:23,13205.0,2,31806,0,13205.0,2,13210.0,1,S
2018-04-27 14:23:23,13205.0,2,31808,2,13205.0,1,13210.0,1,S
2018-04-27 14:23:24,13205.0,2,31810,0,13200.0,21,13210.0,1,S
2018-04-27 14:23:25,13205.0,2,31812,2,13200.0,23,13210.0,4,S
2018-04-27 14:23:32,13210.0,2,31814,0,13200.0,33,13210.0,3,B
2018-04-27 14:23:33,13205.0,2,31816,2,13205.0,2,13210.0,3,S
2018-04-27 14:23:33,13205.0,2,31818,0,13205.0,2,13210.0,3,S
2018-04-27 14:23:34,13205.0,2,31820,2,13205.0,2,13210.0,3,S
2018-04-27 14:23:35,13205.0,2,31822,2,13205.0,1,13210.0,3,S
2018-04-27 14:23:35,13205.0,2,31824,0,13205.0,1,13210.0,4,S
2018-04-27 14:23:37,13205.0,2,31826,2,13205.0,1,13210.0,5,S
2018-04-27 14:23:38,13205.0,2,31828,2,13205.0,1,13210.0,5,S
2018-04-27 14:23:41,13205.0,2,31830,2,13200.0,33,13210.0,5,S
2018-04-27 14:23:44,13205.0,2,31832,2,13200.0,33,13210.0,5,S
2018-04-27 14:23:46,13205.0,2,31834,2,13200.0,33,13210.0,2,S
2018-04-27 14:23:47,13205.0,2,31836,2,13205.0,5,13210.0,2,S
2018-04-27 14:23:50,13210.0,4,31840,-2,13205.0,7,13215.0,12,B
2018-04-27 14:23:50,13205.0,2,31842,2,13205.0,6,13215.0,13,S
2018-04-27 14:23:51,13205.0,2,31844,0,13210.0,1,13215.0,11,S
2018-04-27 14:23:51,13215.0,16,31860,-10,13205.0,11,13215.0,5,B
2018-04-27 14:23:52,13205.0,6,31866,0,13205.0,11,13215.0,3,S
2018-04-27 14:23:53,13205.0,2,31868,0,13205.0,4,13215.0,7,S
2018-04-27 14:23:53,13205.0,2,31870,2,13205.0,4,13215.0,8,S
2018-04-27 14:23:54,13205.0,2,31872,2,13205.0,8,13215.0,9,S
2018-04-27 14:23:55,13205.0,2,31874,2,13205.0,10,13210.0,1,S
2018-04-27 14:23:55,13205.0,2,31876,2,13205.0,9,13210.0,2,S
2018-04-27 14:23:56,13205.0,2,31878,2,13205.0,3,13210.0,2,S
2018-04-27 14:23:56,13205.0,2,31880,0,13205.0,2,13210.0,2,S
2018-04-27 14:23:57,13205.0,2,31882,0,13205.0,1,13210.0,2,S
2018-04-27 14:23:57,13205.0,2,31884,0,13200.0,29,13210.0,3,S
2018-04-27 14:23:58,13210.0,2,31886,0,13200.0,31,13210.0,3,B
2018-04-27 14:24:03,13205.0,2,31888,0,13200.0,32,13210.0,7,S
2018-04-27 14:24:05,13205.0,2,31890,0,13205.0,2,13210.0,5,S
2018-04-27 14:24:11,13205.0,2,31892,0,13205.0,5,13210.0,5,S
2018-04-27 14:24:17,13205.0,2,31894,2,13205.0,6,13210.0,3,S
2018-04-27 14:24:18,13205.0,12,31906,-2,13200.0,28,13210.0,3,S
2018-04-27 14:24:27,13210.0,2,31908,2,13205.0,10,13210.0,4,B
2018-04-27 14:24:28,13215.0,14,31922,0,13205.0,16,13215.0,7,B
2018-04-27 14:24:28,13215.0,6,31928,0,13210.0,10,13215.0,1,B
2018-04-27 14:24:29,13210.0,4,31932,0,13210.0,10,13220.0,8,S
2018-04-27 14:24:30,13210.0,2,31934,0,13215.0,4,13220.0,5,S
2018-04-27 14:24:30,13220.0,12,31946,0,13215.0,14,13225.0,2,B
2018-04-27 14:24:31,13215.0,10,31956,-8,13215.0,16,13225.0,4,S
2018-04-27 14:24:31,13215.0,4,31960,2,13215.0,8,13220.0,11,S
2018-04-27 14:24:32,13210.0,18,31978,-8,13210.0,4,13215.0,4,S
2018-04-27 14:24:32,13215.0,2,31980,0,13210.0,6,13220.0,9,B
2018-04-27 14:24:33,13215.0,4,31984,2,13215.0,1,13220.0,9,B
2018-04-27 14:24:34,13215.0,2,31986,2,13210.0,16,13220.0,9,B
2018-04-27 14:24:39,13210.0,2,31988,0,13215.0,3,13220.0,10,S
2018-04-27 14:24:40,13210.0,2,31990,2,13215.0,2,13220.0,9,S
2018-04-27 14:24:40,13215.0,4,31994,4,13215.0,2,13220.0,6,B
2018-04-27 14:24:41,13215.0,2,31996,2,13215.0,2,13220.0,4,B
2018-04-27 14:24:42,13215.0,2,31998,2,13215.0,1,13220.0,5,B
2018-04-27 14:24:42,13215.0,2,32000,2,13210.0,17,13220.0,5,B
2018-04-27 14:24:44,13220.0,2,32002,0,13210.0,18,13220.0,2,B
2018-04-27 14:24:45,13215.0,2,32004,2,13210.0,18,13220.0,2,S
2018-04-27 14:24:47,13215.0,2,32006,2,13215.0,1,13220.0,2,S
2018-04-27 14:24:47,13220.0,2,32008,0,13215.0,1,13220.0,2,B
2018-04-27 14:24:50,13220.0,6,32014,0,13215.0,9,13225.0,10,B
2018-04-27 14:24:52,13220.0,6,32020,0,13215.0,19,13220.0,19,B
2018-04-27 14:24:52,13220.0,38,32058,-12,13220.0,6,13225.0,1,B
2018-04-27 14:24:53,13225.0,10,32068,-2,13220.0,10,13230.0,20,B
2018-04-27 14:24:53,13230.0,4,32072,2,13220.0,11,13230.0,19,B
2018-04-27 14:24:54,13230.0,6,32078,2,13220.0,10,13230.0,17,B
2018-04-27 14:24:54,13220.0,2,32080,2,13220.0,9,13230.0,21,S
2018-04-27 14:24:55,13220.0,2,32082,0,13225.0,1,13230.0,23,S
2018-04-27 14:24:55,13225.0,6,32088,-4,13220.0,11,13230.0,23,B
2018-04-27 14:24:56,13220.0,2,32090,0,13220.0,12,13225.0,5,S
2018-04-27 14:24:56,13220.0,2,32092,0,13220.0,7,13225.0,12,S
2018-04-27 14:24:57,13220.0,2,32094,0,13220.0,6,13225.0,12,S
2018-04-27 14:24:57,13220.0,2,32096,0,13220.0,5,13225.0,6,S
2018-04-27 14:24:58,13220.0,2,32098,0,13220.0,7,13225.0,2,S
2018-04-27 14:24:58,13220.0,2,32100,2,13220.0,6,13225.0,2,S
2018-04-27 14:24:59,13225.0,4,32104,2,13220.0,5,13225.0,1,B
2018-04-27 14:24:59,13220.0,6,32110,2,13220.0,5,13230.0,16,S
2018-04-27 14:25:00,13230.0,4,32114,0,13220.0,8,13230.0,15,B
2018-04-27 14:25:01,13220.0,2,32116,0,13220.0,12,13230.0,12,S
2018-04-27 14:25:02,13220.0,2,32118,0,13220.0,18,13230.0,12,S
2018-04-27 14:25:02,13220.0,4,32122,4,13225.0,1,13230.0,12,S
2018-04-27 14:25:03,13220.0,6,32128,0,13220.0,13,13230.0,13,S
2018-04-27 14:25:03,13225.0,6,32134,-2,13225.0,4,13230.0,8,B
2018-04-27 14:25:04,13220.0,18,32152,2,13220.0,19,13225.0,1,S
2018-04-27 14:25:04,13225.0,2,32154,-2,13220.0,20,13230.0,12,B
2018-04-27 14:25:06,13230.0,52,32206,14,13230.0,24,13235.0,9,B
2018-04-27 14:25:06,13225.0,50,32256,34,13220.0,13,13230.0,9,S
2018-04-27 14:25:08,13230.0,12,32268,2,13225.0,3,13230.0,8,B
2018-04-27 14:25:08,13225.0,2,32270,2,13225.0,2,13230.0,8,S
2018-04-27 14:25:11,13225.0,2,32272,0,13225.0,2,13230.0,14,S
2018-04-27 14:25:13,13225.0,2,32274,2,13225.0,1,13230.0,15,S
2018-04-27 14:25:14,13225.0,2,32276,0,13220.0,15,13225.0,3,S
2018-04-27 14:25:15,13225.0,6,32282,0,13220.0,20,13230.0,15,S
2018-04-27 14:25:17,13225.0,2,32284,0,13220.0,21,13230.0,15,S
2018-04-27 14:25:19,13225.0,2,32286,2,13225.0,6,13230.0,16,S
2018-04-27 14:25:20,13225.0,12,32298,12,13225.0,1,13230.0,16,S
2018-04-27 14:25:20,13225.0,4,32302,2,13220.0,20,13225.0,3,S
2018-04-27 14:25:23,13225.0,2,32304,2,13220.0,13,13225.0,9,S
2018-04-27 14:25:32,13220.0,2,32306,2,13220.0,13,13225.0,10,S
2018-04-27 14:25:36,13225.0,14,32320,4,13220.0,15,13230.0,14,B
2018-04-27 14:25:38,13225.0,10,32330,-8,13225.0,2,13230.0,14,B
2018-04-27 14:25:42,13225.0,4,32334,0,13220.0,18,13230.0,14,B
2018-04-27 14:25:45,13220.0,2,32336,0,13220.0,16,13225.0,7,S
2018-04-27 14:25:46,13225.0,8,32344,-4,13220.0,16,13225.0,1,B
2018-04-27 14:25:47,13225.0,2,32346,0,13220.0,16,13230.0,21,B
2018-04-27 14:25:47,13220.0,2,32348,0,13220.0,16,13230.0,21,S
2018-04-27 14:25:52,13225.0,2,32350,0,13220.0,19,13225.0,7,B
2018-04-27 14:26:02,13220.0,2,32352,-2,13220.0,7,13225.0,8,S
2018-04-27 14:26:15,13220.0,14,32366,-8,13215.0,9,13220.0,5,S
2018-04-27 14:26:17,13215.0,14,32380,-4,13210.0,11,13215.0,3,S
2018-04-27 14:26:18,13215.0,12,32392,0,13210.0,11,13220.0,19,S
2018-04-27 14:26:19,13215.0,2,32394,0,13215.0,4,13220.0,11,S
2018-04-27 14:26:22,13215.0,12,32406,-2,13210.0,11,13220.0,13,S
2018-04-27 14:26:24,13215.0,2,32408,0,13210.0,3,13215.0,2,S
2018-04-27 14:26:24,13210.0,6,32414,-2,13205.0,9,13215.0,6,S
2018-04-27 14:26:27,13210.0,10,32424,2,13205.0,12,13215.0,12,S
2018-04-27 14:26:29,13205.0,4,32428,0,13205.0,12,13215.0,6,S
2018-04-27 14:26:36,13210.0,2,32430,0,13205.0,13,13215.0,11,B
2018-04-27 14:26:38,13210.0,2,32432,0,13205.0,11,13215.0,11,B
2018-04-27 14:26:52,13215.0,6,32438,4,13210.0,6,13215.0,1,B
2018-04-27 14:27:13,13210.0,2,32440,0,13210.0,4,13215.0,5,S
2018-04-27 14:27:14,13210.0,4,32444,-2,13205.0,27,13210.0,7,S
2018-04-27 14:27:15,13215.0,16,32460,-16,13205.0,27,13215.0,11,B
2018-04-27 14:27:16,13210.0,2,32462,0,13210.0,6,13215.0,10,S
2018-04-27 14:27:18,13210.0,2,32464,2,13210.0,8,13215.0,5,S
2018-04-27 14:27:25,13210.0,12,32476,-2,13205.0,32,13210.0,4,S
2018-04-27 14:27:27,13205.0,4,32480,-2,13205.0,22,13210.0,19,S
2018-04-27 14:27:27,13205.0,44,32524,38,13200.0,39,13210.0,19,S
2018-04-27 14:27:35,13210.0,10,32534,0,13205.0,19,13215.0,12,B
2018-04-27 14:27:48,13210.0,2,32536,0,13210.0,1,13215.0,8,B
2018-04-27 14:27:52,13210.0,2,32538,2,13205.0,19,13215.0,8,B
2018-04-27 14:27:54,13215.0,6,32544,-4,13205.0,19,13215.0,6,B
2018-04-27 14:27:59,13210.0,2,32546,0,13210.0,7,13215.0,5,S
2018-04-27 14:28:00,13210.0,2,32548,-2,13210.0,6,13215.0,5,S
2018-04-27 14:28:02,13210.0,2,32550,-2,13210.0,5,13215.0,6,S
2018-04-27 14:28:21,13210.0,2,32552,0,13210.0,3,13215.0,12,S
2018-04-27 14:28:21,13210.0,6,32558,-6,13205.0,16,13210.0,8,S
2018-04-27 14:28:37,13205.0,2,32560,-2,13205.0,9,13210.0,5,S
2018-04-27 14:28:45,13205.0,2,32562,2,13205.0,5,13210.0,7,S
2018-04-27 14:28:48,13205.0,6,32568,-2,13205.0,2,13210.0,8,S
2018-04-27 14:29:00,13205.0,2,32570,0,13200.0,33,13210.0,15,S
2018-04-27 14:29:02,13205.0,4,32574,2,13200.0,33,13210.0,10,S
2018-04-27 14:29:03,13205.0,2,32576,0,13200.0,33,13210.0,15,S
2018-04-27 14:29:12,13205.0,2,32578,2,13200.0,33,13210.0,10,S
2018-04-27 14:29:15,13205.0,2,32580,-2,13205.0,2,13210.0,14,S
2018-04-27 14:29:29,13210.0,2,32582,-2,13205.0,2,13210.0,9,B
2018-04-27 14:29:29,13205.0,2,32584,2,13205.0,1,13210.0,8,S
2018-04-27 14:29:32,13210.0,2,32586,0,13205.0,2,13210.0,7,B
2018-04-27 14:29:39,13210.0,2,32588,0,13205.0,2,13210.0,6,B
2018-04-27 14:29:41,13205.0,4,32592,0,13200.0,32,13210.0,10,S
2018-04-27 14:29:49,13205.0,6,32598,-2,13200.0,23,13205.0,1,S
2018-04-27 14:29:58,13200.0,6,32604,4,13200.0,16,13205.0,6,S
2018-04-27 14:30:07,13205.0,4,32608,2,13205.0,7,13210.0,16,B
2018-04-27 14:30:14,13205.0,2,32610,0,13205.0,5,13210.0,12,B
2018-04-27 14:30:32,13205.0,2,32612,2,13205.0,3,13210.0,11,B
2018-04-27 14:30:33,13210.0,2,32614,0,13205.0,3,13210.0,10,B
2018-04-27 14:30:48,13210.0,4,32618,0,13205.0,8,13210.0,3,B
2018-04-27 14:31:02,13210.0,6,32624,-2,13205.0,10,13215.0,11,B
2018-04-27 14:31:05,13215.0,2,32626,-2,13210.0,1,13215.0,10,B
2018-04-27 14:31:12,13210.0,4,32630,2,13205.0,16,13215.0,7,S
2018-04-27 14:31:14,13210.0,2,32632,0,13205.0,14,13210.0,1,S
2018-04-27 14:31:24,13210.0,2,32634,-2,13205.0,4,13210.0,5,S
2018-04-27 14:31:25,13210.0,4,32638,0,13205.0,10,13210.0,1,S
2018-04-27 14:31:26,13210.0,2,32640,0,13205.0,10,13215.0,18,S
2018-04-27 14:31:32,13210.0,6,32646,2,13205.0,6,13210.0,1,S
2018-04-27 14:31:34,13210.0,4,32650,0,13205.0,7,13210.0,1,S
2018-04-27 14:31:38,13205.0,2,32652,2,13205.0,6,13210.0,2,S
2018-04-27 14:31:49,13205.0,6,32658,-6,13200.0,31,13210.0,5,S
2018-04-27 14:31:51,13210.0,2,32660,-2,13205.0,1,13210.0,7,B
2018-04-27 14:31:58,13205.0,2,32662,-2,13200.0,33,13210.0,7,S
2018-04-27 14:32:05,13205.0,2,32664,-2,13200.0,33,13210.0,7,S
2018-04-27 14:32:06,13210.0,2,32666,2,13205.0,1,13210.0,6,B
2018-04-27 14:32:17,13205.0,2,32668,-2,13200.0,33,13210.0,6,S
2018-04-27 14:32:19,13200.0,4,32672,2,13200.0,19,13205.0,22,S
2018-04-27 14:32:24,13205.0,2,32674,0,13200.0,19,13205.0,20,B
2018-04-27 14:32:27,13200.0,2,32676,0,13200.0,18,13205.0,20,S
2018-04-27 14:32:29,13200.0,34,32710,2,13195.0,58,13200.0,4,S
2018-04-27 14:32:31,13195.0,2,32712,0,13195.0,51,13200.0,6,S
2018-04-27 14:32:32,13195.0,4,32716,4,13195.0,49,13200.0,11,S
2018-04-27 14:32:32,13195.0,26,32742,14,13195.0,36,13200.0,17,S
2018-04-27 14:32:38,13195.0,4,32746,0,13195.0,34,13200.0,17,S
2018-04-27 14:32:39,13195.0,30,32776,28,13195.0,19,13200.0,20,S
2018-04-27 14:32:40,13195.0,38,32814,14,13190.0,55,13195.0,2,S
2018-04-27 14:32:40,13195.0,4,32818,4,13190.0,55,13200.0,17,S
2018-04-27 14:32:41,13200.0,4,32822,0,13195.0,1,13200.0,14,B
2018-04-27 14:32:43,13195.0,8,32830,6,13195.0,8,13200.0,5,S
2018-04-27 14:32:50,13195.0,4,32834,2,13195.0,3,13200.0,11,S
2018-04-27 14:32:50,13195.0,6,32840,6,13190.0,62,13195.0,1,S
2018-04-27 14:32:51,13195.0,2,32842,0,13190.0,64,13200.0,11,S
2018-04-27 14:32:53,13195.0,2,32844,-2,13195.0,1,13200.0,18,S
2018-04-27 14:32:55,13195.0,2,32846,0,13190.0,64,13200.0,19,S
2018-04-27 14:32:57,13190.0,4,32850,-4,13190.0,62,13200.0,19,S
2018-04-27 14:32:59,13190.0,8,32858,-6,13190.0,44,13195.0,7,S
2018-04-27 14:33:00,13190.0,6,32864,4,13190.0,41,13195.0,13,S
2018-04-27 14:33:01,13190.0,2,32866,0,13190.0,40,13195.0,11,S
2018-04-27 14:33:04,13190.0,8,32874,8,13190.0,36,13195.0,19,S
2018-04-27 14:33:04,13195.0,6,32880,2,13190.0,36,13195.0,14,B
2018-04-27 14:33:05,13190.0,2,32882,0,13190.0,35,13195.0,14,S
2018-04-27 14:33:08,13190.0,2,32884,2,13190.0,34,13195.0,12,S
2018-04-27 14:33:12,13190.0,2,32886,2,13190.0,33,13195.0,11,S
2018-04-27 14:33:14,13195.0,22,32908,-2,13195.0,5,13200.0,11,B
2018-04-27 14:33:18,13195.0,2,32910,-2,13195.0,16,13200.0,3,B
2018-04-27 14:33:22,13200.0,6,32916,4,13200.0,3,13205.0,14,B
2018-04-27 14:33:23,13205.0,8,32924,-6,13205.0,4,13210.0,13,B
2018-04-27 14:33:24,13200.0,10,32934,-6,13200.0,4,13205.0,23,S
2018-04-27 14:33:24,13200.0,6,32940,6,13200.0,1,13205.0,29,S
2018-04-27 14:33:25,13200.0,2,32942,2,13195.0,9,13200.0,3,S
2018-04-27 14:33:25,13200.0,4,32946,0,13195.0,9,13200.0,3,S
2018-04-27 14:33:26,13195.0,2,32948,0,13195.0,9,13200.0,3,S
2018-04-27 14:33:27,13195.0,4,32952,2,13195.0,3,13200.0,1,S
2018-04-27 14:33:28,13200.0,6,32958,4,13200.0,1,13205.0,24,B
2018-04-27 14:33:32,13200.0,10,32968,10,13195.0,13,13200.0,4,B
2018-04-27 14:33:33,13195.0,8,32976,4,13195.0,9,13200.0,3,S
2018-04-27 14:33:34,13195.0,2,32978,0,13195.0,3,13200.0,3,S
2018-04-27 14:33:37,13195.0,6,32984,0,13190.0,43,13195.0,3,S
2018-04-27 14:33:38,13195.0,6,32990,0,13190.0,43,13195.0,4,S
2018-04-27 14:33:38,13190.0,4,32994,0,13190.0,31,13195.0,4,S
2018-04-27 14:33:44,13195.0,2,32996,0,13190.0,31,13195.0,3,B
2018-04-27 14:33:44,13195.0,6,33002,2,13190.0,31,13200.0,15,B
2018-04-27 14:33:46,13195.0,6,33008,0,13190.0,35,13200.0,17,B
2018-04-27 14:33:52,13195.0,2,33010,0,13195.0,4,13200.0,10,B
2018-04-27 14:34:14,13200.0,2,33012,0,13195.0,9,13205.0,14,B
2018-04-27 14:34:15,13200.0,4,33016,0,13200.0,12,13205.0,7,B
2018-04-27 14:34:16,13205.0,4,33020,2,13200.0,15,13205.0,2,B
2018-04-27 14:34:16,13205.0,4,33024,4,13205.0,2,13210.0,7,B
2018-04-27 14:34:20,13205.0,2,33026,2,13205.0,4,13210.0,4,B
2018-04-27 14:34:20,13205.0,6,33032,6,13205.0,1,13210.0,4,B
2018-04-27 14:34:22,13205.0,2,33034,2,13200.0,19,13210.0,4,B
2018-04-27 14:34:27,13200.0,4,33038,2,13200.0,5,13205.0,17,S
2018-04-27 14:34:40,13200.0,2,33040,0,13200.0,5,13205.0,15,S
2018-04-27 14:34:41,13200.0,2,33042,-2,13200.0,4,13205.0,15,S
2018-04-27 14:34:54,13200.0,2,33044,-2,13200.0,3,13205.0,15,S
2018-04-27 14:35:01,13200.0,2,33046,0,13200.0,3,13205.0,10,S
2018-04-27 14:36:03,13200.0,2,33048,-2,13200.0,14,13205.0,4,S
2018-04-27 14:36:09,13205.0,8,33056,4,13205.0,6,13210.0,18,B
2018-04-27 14:36:09,13205.0,12,33068,12,13200.0,14,13210.0,18,B
2018-04-27 14:36:11,13200.0,8,33076,2,13200.0,12,13210.0,17,S
2018-04-27 14:36:24,13200.0,2,33078,0,13200.0,11,13210.0,20,S
2018-04-27 14:36:29,13200.0,2,33080,2,13200.0,10,13210.0,20,S
2018-04-27 14:36:29,13200.0,2,33082,2,13200.0,9,13205.0,2,S
2018-04-27 14:36:37,13200.0,2,33084,2,13200.0,8,13210.0,21,S
2018-04-27 14:36:38,13200.0,8,33092,8,13200.0,2,13205.0,22,S
2018-04-27 14:36:39,13200.0,4,33096,4,13195.0,24,13200.0,7,S
2018-04-27 14:36:39,13200.0,20,33116,-6,13195.0,16,13200.0,2,S
2018-04-27 14:36:40,13200.0,4,33120,0,13195.0,16,13205.0,21,S
2018-04-27 14:36:41,13195.0,2,33122,0,13195.0,15,13205.0,22,S
2018-04-27 14:36:46,13200.0,2,33124,2,13195.0,13,13200.0,4,B
2018-04-27 14:36:47,13200.0,2,33126,0,13195.0,13,13200.0,3,B
2018-04-27 14:36:52,13195.0,14,33140,0,13195.0,5,13200.0,7,S
2018-04-27 14:36:55,13195.0,2,33142,-2,13195.0,6,13200.0,3,S
2018-04-27 14:36:57,13195.0,2,33144,0,13195.0,15,13200.0,3,S
2018-04-27 14:37:09,13195.0,28,33172,8,13195.0,1,13200.0,16,S
2018-04-27 14:37:10,13195.0,2,33174,0,13190.0,40,13195.0,4,S
2018-04-27 14:37:11,13195.0,12,33186,0,13190.0,40,13200.0,17,S
2018-04-27 14:37:21,13195.0,2,33188,-2,13190.0,42,13195.0,1,S
2018-04-27 14:37:21,13195.0,2,33190,0,13195.0,2,13200.0,16,S
2018-04-27 14:37:27,13200.0,8,33198,6,13200.0,6,13205.0,18,B
2018-04-27 14:37:28,13200.0,10,33208,10,13200.0,1,13205.0,17,B
2018-04-27 14:37:28,13200.0,10,33218,2,13195.0,9,13205.0,17,B
2018-04-27 14:37:29,13200.0,8,33226,8,13195.0,9,13205.0,16,B
2018-04-27 14:37:36,13200.0,2,33228,2,13195.0,9,13200.0,1,B
2018-04-27 14:37:37,13195.0,2,33230,2,13195.0,3,13200.0,4,S
2018-04-27 14:37:37,13195.0,2,33232,0,13195.0,3,13200.0,5,S
2018-04-27 14:37:39,13195.0,2,33234,0,13195.0,3,13200.0,5,S
2018-04-27 14:37:40,13195.0,2,33236,0,13195.0,2,13200.0,5,S
2018-04-27 14:37:40,13195.0,2,33238,0,13195.0,2,13200.0,5,S
2018-04-27 14:37:44,13200.0,8,33246,2,13200.0,6,13205.0,15,B
2018-04-27 14:37:45,13195.0,14,33260,0,13195.0,1,13200.0,4,S
2018-04-27 14:37:46,13195.0,4,33264,2,13190.0,42,13200.0,1,S
2018-04-27 14:37:46,13195.0,4,33268,4,13195.0,7,13200.0,1,S
2018-04-27 14:38:14,13200.0,10,33278,8,13195.0,2,13205.0,15,B
2018-04-27 14:38:27,13200.0,2,33280,0,13195.0,4,13200.0,4,B
2018-04-27 14:38:32,13200.0,6,33286,2,13200.0,17,13210.0,16,B
2018-04-27 14:38:32,13200.0,2,33288,2,13200.0,16,13210.0,16,B
2018-04-27 14:38:33,13200.0,2,33290,2,13200.0,25,13210.0,14,B
2018-04-27 14:38:36,13205.0,8,33298,0,13200.0,18,13210.0,15,B
2018-04-27 14:38:40,13200.0,2,33300,2,13200.0,11,13205.0,1,S
2018-04-27 14:38:40,13200.0,2,33302,2,13200.0,10,13205.0,1,S
2018-04-27 14:38:41,13200.0,2,33304,2,13200.0,9,13205.0,1,S
2018-04-27 14:38:41,13200.0,2,33306,2,13200.0,8,13205.0,1,S
2018-04-27 14:38:42,13200.0,2,33308,2,13200.0,7,13210.0,19,S
2018-04-27 14:38:42,13200.0,6,33314,0,13200.0,5,13210.0,19,S
2018-04-27 14:38:43,13200.0,2,33316,0,13200.0,5,13210.0,19,S
2018-04-27 14:38:47,13200.0,2,33318,2,13205.0,7,13210.0,6,S
2018-04-27 14:38:48,13200.0,2,33320,2,13205.0,5,13210.0,8,S
2018-04-27 14:38:48,13200.0,2,33322,2,13205.0,4,13210.0,8,S
2018-04-27 14:38:49,13200.0,2,33324,2,13205.0,3,13210.0,8,S
2018-04-27 14:38:49,13200.0,2,33326,0,13205.0,2,13210.0,8,S
2018-04-27 14:38:50,13200.0,2,33328,0,13205.0,1,13210.0,8,S
2018-04-27 14:38:50,13200.0,2,33330,0,13200.0,22,13210.0,8,S
2018-04-27 14:38:59,13210.0,6,33336,-4,13205.0,6,13210.0,3,B
2018-04-27 14:38:59,13210.0,6,33342,0,13210.0,3,13215.0,10,B
2018-04-27 14:39:00,13210.0,2,33344,2,13210.0,6,13215.0,4,B
2018-04-27 14:39:00,13210.0,2,33346,2,13210.0,6,13215.0,3,B
2018-04-27 14:39:01,13215.0,2,33348,-2,13210.0,6,13215.0,1,B
2018-04-27 14:39:02,13210.0,4,33352,4,13210.0,5,13220.0,11,S
2018-04-27 14:39:02,13210.0,2,33354,2,13210.0,5,13215.0,4,S
2018-04-27 14:39:03,13210.0,2,33356,2,13210.0,6,13215.0,4,S
2018-04-27 14:39:04,13210.0,2,33358,2,13210.0,4,13215.0,4,S
2018-04-27 14:39:04,13210.0,4,33362,0,13210.0,3,13215.0,3,S
2018-04-27 14:39:05,13210.0,2,33364,0,13210.0,2,13215.0,5,S
2018-04-27 14:39:05,13210.0,2,33366,2,13210.0,1,13215.0,6,S
2018-04-27 14:39:06,13210.0,2,33368,2,13210.0,1,13215.0,6,S
2018-04-27 14:39:07,13210.0,2,33370,2,13210.0,1,13215.0,5,S
2018-04-27 14:39:10,13210.0,2,33372,2,13210.0,1,13215.0,5,S
2018-04-27 14:39:13,13210.0,2,33374,2,13210.0,2,13215.0,5,S
2018-04-27 14:39:14,13205.0,14,33388,-2,13205.0,18,13215.0,3,S
2018-04-27 14:39:15,13205.0,2,33390,2,13205.0,20,13215.0,4,S
2018-04-27 14:39:16,13215.0,4,33394,4,13210.0,3,13220.0,13,B
2018-04-27 14:39:17,13210.0,8,33402,6,13210.0,14,13220.0,11,S
2018-04-27 14:39:19,13210.0,4,33406,0,13210.0,1,13220.0,14,S
2018-04-27 14:39:19,13210.0,2,33408,2,13205.0,16,13210.0,1,S
2018-04-27 14:39:20,13210.0,2,33410,0,13210.0,1,13215.0,4,S
2018-04-27 14:39:27,13215.0,6,33416,-4,13210.0,1,13220.0,14,B
2018-04-27 14:39:28,13215.0,4,33420,0,13215.0,3,13220.0,14,B
2018-04-27 14:39:29,13215.0,6,33426,0,13210.0,10,13215.0,1,B
2018-04-27 14:39:29,13215.0,4,33430,0,13210.0,11,13215.0,3,B
2018-04-27 14:39:30,13215.0,6,33436,6,13210.0,11,13220.0,14,B
2018-04-27 14:39:31,13220.0,4,33440,-4,13215.0,1,13220.0,11,B
2018-04-27 14:39:34,13220.0,2,33442,2,13215.0,2,13220.0,5,B
2018-04-27 14:39:38,13220.0,2,33444,2,13215.0,2,13220.0,4,B
2018-04-27 14:39:40,13215.0,2,33446,2,13215.0,2,13220.0,4,S
2018-04-27 14:39:46,13220.0,6,33452,-4,13215.0,4,13225.0,10,B
2018-04-27 14:39:47,13220.0,8,33460,-4,13220.0,1,13225.0,12,B
2018-04-27 14:39:48,13215.0,2,33462,2,13215.0,12,13220.0,4,S
2018-04-27 14:39:48,13220.0,8,33470,2,13215.0,11,13225.0,12,B
2018-04-27 14:39:53,13220.0,2,33472,2,13220.0,1,13225.0,5,B
2018-04-27 14:39:53,13220.0,2,33474,0,13215.0,17,13225.0,5,B
2018-04-27 14:39:54,13220.0,2,33476,2,13220.0,1,13225.0,4,B
2018-04-27 14:39:56,13225.0,12,33488,-8,13225.0,1,13230.0,27,B
2018-04-27 14:39:56,13220.0,4,33492,0,13220.0,1,13225.0,5,S
2018-04-27 14:39:57,13220.0,2,33494,2,13215.0,17,13225.0,11,S
2018-04-27 14:39:57,13215.0,10,33504,6,13220.0,1,13225.0,7,S
2018-04-27 14:39:58,13215.0,2,33506,2,13215.0,13,13225.0,7,S
2018-04-27 14:39:59,13225.0,4,33510,0,13220.0,3,13225.0,6,B
2018-04-27 14:40:00,13220.0,2,33512,2,13220.0,2,13225.0,6,S
2018-04-27 14:40:00,13220.0,2,33514,2,13220.0,1,13225.0,6,S
2018-04-27 14:40:01,13220.0,2,33516,2,13215.0,13,13225.0,5,S
2018-04-27 14:40:02,13220.0,2,33518,2,13220.0,2,13225.0,5,S
2018-04-27 14:40:03,13220.0,2,33520,2,13220.0,1,13225.0,5,S
2018-04-27 14:40:03,13220.0,2,33522,2,13215.0,14,13225.0,5,S
2018-04-27 14:40:05,13215.0,4,33526,4,13215.0,12,13225.0,9,S
2018-04-27 14:40:06,13215.0,20,33546,-2,13210.0,5,13220.0,20,S
2018-04-27 14:40:28,13215.0,4,33550,-4,13210.0,11,13220.0,12,S
2018-04-27 14:40:30,13215.0,8,33558,-8,13210.0,13,13220.0,12,S
2018-04-27 14:40:31,13220.0,14,33572,-6,13220.0,3,13225.0,17,B
2018-04-27 14:40:31,13215.0,10,33582,6,13215.0,3,13220.0,15,S
2018-04-27 14:40:39,13220.0,4,33586,-4,13215.0,8,13225.0,15,B
2018-04-27 14:40:44,13220.0,2,33588,2,13220.0,6,13225.0,2,B
2018-04-27 14:40:45,13225.0,2,33590,0,13220.0,7,13225.0,1,B
2018-04-27 14:40:54,13225.0,8,33598,-8,13220.0,11,13230.0,30,B
2018-04-27 14:41:03,13225.0,10,33608,0,13220.0,17,13230.0,31,B
2018-04-27 14:41:06,13220.0,4,33612,2,13220.0,2,13225.0,13,S
2018-04-27 14:41:06,13225.0,2,33614,-2,13215.0,13,13225.0,13,B
2018-04-27 14:41:07,13225.0,2,33616,0,13220.0,23,13225.0,5,B
2018-04-27 14:41:07,13225.0,8,33624,-4,13220.0,14,13230.0,32,B
2018-04-27 14:41:18,13220.0,6,33630,-2,13215.0,15,13225.0,11,S
2018-04-27 14:41:23,13220.0,6,33636,4,13215.0,14,13225.0,18,S
2018-04-27 14:41:31,13220.0,2,33638,0,13220.0,7,13225.0,13,S
2018-04-27 14:41:41,13225.0,26,33664,-20,13225.0,27,13230.0,33,B
2018-04-27 14:41:41,13225.0,54,33718,-6,13220.0,8,13225.0,1,B
2018-04-27 14:41:48,13220.0,2,33720,0,13220.0,7,13225.0,4,S
2018-04-27 14:41:50,13225.0,2,33722,-2,13220.0,7,13225.0,3,B
2018-04-27 14:42:02,13220.0,2,33724,2,13220.0,5,13225.0,3,S
2018-04-27 14:42:02,13225.0,2,33726,0,13220.0,5,13225.0,2,B
2018-04-27 14:42:08,13220.0,6,33732,0,13220.0,3,13225.0,4,S
2018-04-27 14:42:10,13220.0,2,33734,2,13220.0,2,13225.0,4,S
2018-04-27 14:42:11,13220.0,2,33736,2,13215.0,15,13225.0,6,S
2018-04-27 14:42:16,13215.0,2,33738,0,13215.0,6,13220.0,4,S
2018-04-27 14:42:18,13215.0,12,33750,2,13210.0,9,13215.0,10,S
2018-04-27 14:42:19,13215.0,20,33770,-12,13210.0,6,13220.0,16,S
2018-04-27 14:42:48,13215.0,2,33772,2,13215.0,4,13220.0,6,S
2018-04-27 14:42:49,13215.0,2,33774,2,13215.0,3,13220.0,6,S
2018-04-27 14:43:21,13215.0,2,33776,-2,13215.0,1,13220.0,5,S
2018-04-27 14:43:24,13215.0,2,33778,2,13215.0,1,13220.0,7,S
2018-04-27 14:43:30,13215.0,2,33780,2,13210.0,34,13220.0,7,S
2018-04-27 14:43:35,13215.0,2,33782,2,13210.0,34,13220.0,16,S
2018-04-27 14:43:39,13215.0,2,33784,2,13215.0,15,13220.0,3,S
2018-04-27 14:43:40,13215.0,2,33786,2,13215.0,14,13220.0,2,S
2018-04-27 14:43:40,13215.0,2,33788,2,13215.0,13,13220.0,2,S
2018-04-27 14:43:41,13215.0,2,33790,2,13215.0,12,13220.0,2,S
2018-04-27 14:43:44,13220.0,4,33794,0,13220.0,3,13225.0,17,B
2018-04-27 14:43:44,13215.0,12,33806,4,13215.0,5,13225.0,15,S
2018-04-27 14:43:46,13215.0,4,33810,0,13215.0,9,13225.0,16,S
2018-04-27 14:43:49,13215.0,2,33812,2,13215.0,13,13225.0,17,S
2018-04-27 14:44:05,13225.0,10,33822,-8,13220.0,2,13225.0,12,B
2018-04-27 14:44:06,13220.0,4,33826,4,13215.0,28,13220.0,3,S
2018-04-27 14:44:15,13220.0,4,33830,4,13215.0,23,13220.0,2,S
2018-04-27 14:44:23,13220.0,6,33836,-2,13215.0,18,13225.0,12,S
2018-04-27 14:44:25,13225.0,2,33838,0,13215.0,18,13225.0,12,B
2018-04-27 14:44:29,13220.0,6,33844,-2,13215.0,27,13225.0,13,S
2018-04-27 14:44:32,13215.0,4,33848,-2,13215.0,25,13225.0,13,S
2018-04-27 14:44:33,13215.0,20,33868,8,13215.0,20,13225.0,9,S
2018-04-27 14:44:41,13225.0,6,33874,-4,13225.0,2,13230.0,30,B
2018-04-27 14:44:41,13220.0,14,33888,0,13215.0,22,13225.0,4,S
2018-04-27 14:44:42,13220.0,2,33890,0,13215.0,20,13220.0,2,S
2018-04-27 14:44:43,13215.0,8,33898,8,13215.0,16,13220.0,2,S
2018-04-27 14:44:53,13225.0,12,33910,-6,13215.0,10,13225.0,17,B
2018-04-27 14:44:54,13215.0,10,33920,8,13220.0,1,13225.0,14,S
2018-04-27 14:45:00,13220.0,2,33922,-2,13220.0,1,13225.0,11,B
2018-04-27 14:45:03,13220.0,16,33938,0,13215.0,18,13220.0,1,B
2018-04-27 14:45:04,13220.0,2,33940,2,13220.0,1,13225.0,1,B
2018-04-27 14:45:06,13220.0,12,33952,10,13215.0,21,13225.0,4,B
2018-04-27 14:45:10,13230.0,18,33970,0,13225.0,18,13230.0,18,B
2018-04-27 14:45:11,13230.0,36,34006,14,13230.0,11,13235.0,15,B
2018-04-27 14:45:11,13230.0,22,34028,0,13230.0,1,13235.0,15,B
2018-04-27 14:45:12,13225.0,10,34038,2,13225.0,19,13235.0,15,S
2018-04-27 14:45:14,13225.0,10,34048,6,13225.0,14,13235.0,21,S
2018-04-27 14:45:17,13235.0,12,34060,-2,13225.0,22,13235.0,15,B
2018-04-27 14:45:17,13225.0,2,34062,2,13225.0,21,13235.0,15,S
2018-04-27 14:45:21,13225.0,4,34066,0,13225.0,23,13235.0,15,S
2018-04-27 14:45:24,13225.0,2,34068,2,13230.0,1,13235.0,11,S
2018-04-27 14:45:24,13225.0,2,34070,2,13225.0,23,13235.0,11,S
2018-04-27 14:45:27,13225.0,4,34074,2,13225.0,22,13235.0,11,S
2018-04-27 14:45:28,13235.0,2,34076,0,13225.0,22,13235.0,10,B
2018-04-27 14:45:33,13235.0,2,34078,0,13225.0,28,13235.0,15,B
2018-04-27 14:45:38,13235.0,2,34080,0,13230.0,1,13235.0,14,B
2018-04-27 14:45:38,13230.0,2,34082,2,13225.0,28,13235.0,14,S
2018-04-27 14:45:39,13235.0,4,34086,-4,13225.0,28,13235.0,12,B
2018-04-27 14:45:48,13235.0,22,34108,10,13230.0,5,13240.0,8,B
2018-04-27 14:45:49,13235.0,2,34110,-2,13230.0,6,13235.0,12,B
2018-04-27 14:45:50,13235.0,8,34118,-8,13230.0,11,13235.0,5,B
2018-04-27 14:46:00,13230.0,20,34138,-16,13230.0,1,13235.0,3,S
2018-04-27 14:46:02,13230.0,2,34140,0,13225.0,20,13230.0,1,S
2018-04-27 14:46:23,13230.0,8,34148,2,13225.0,29,13235.0,13,S
2018-04-27 14:46:24,13230.0,10,34158,-10,13225.0,29,13235.0,17,S
2018-04-27 14:46:25,13230.0,2,34160,-2,13225.0,29,13235.0,17,S
2018-04-27 14:46:27,13230.0,2,34162,0,13230.0,7,13235.0,12,S
2018-04-27 14:46:27,13230.0,2,34164,2,13230.0,2,13235.0,4,S
2018-04-27 14:46:28,13230.0,2,34166,2,13230.0,3,13235.0,2,S
2018-04-27 14:46:28,13230.0,2,34168,2,13230.0,7,13235.0,3,S
2018-04-27 14:46:29,13230.0,2,34170,2,13230.0,6,13235.0,3,S
2018-04-27 14:46:29,13235.0,8,34178,0,13230.0,6,13240.0,13,B
2018-04-27 14:46:30,13230.0,2,34180,2,13230.0,6,13235.0,4,S
2018-04-27 14:46:31,13230.0,2,34182,0,13230.0,5,13235.0,4,S
2018-04-27 14:46:31,13230.0,2,34184,0,13230.0,4,13235.0,4,S
2018-04-27 14:46:32,13230.0,4,34188,0,13230.0,3,13235.0,4,S
2018-04-27 14:46:32,13230.0,2,34190,0,13230.0,1,13235.0,3,S
2018-04-27 14:46:33,13230.0,2,34192,2,13225.0,111,13235.0,5,S
2018-04-27 14:46:34,13230.0,2,34194,0,13230.0,1,13235.0,5,S
2018-04-27 14:46:34,13230.0,2,34196,2,13225.0,116,13235.0,6,S
2018-04-27 14:46:35,13230.0,2,34198,0,13230.0,4,13235.0,9,S
2018-04-27 14:46:36,13230.0,2,34200,0,13230.0,3,13235.0,10,S
2018-04-27 14:46:36,13230.0,2,34202,0,13230.0,2,13235.0,6,S
2018-04-27 14:46:37,13230.0,2,34204,0,13230.0,1,13235.0,6,S
2018-04-27 14:46:37,13235.0,8,34212,-6,13225.0,117,13235.0,3,B
2018-04-27 14:46:40,13230.0,2,34214,2,13225.0,117,13235.0,10,S
2018-04-27 14:46:41,13225.0,2,34216,0,13225.0,116,13235.0,10,S
2018-04-27 14:46:47,13230.0,6,34222,-2,13225.0,108,13235.0,15,B
2018-04-27 14:46:48,13235.0,10,34232,-8,13230.0,1,13235.0,10,B
2018-04-27 14:46:48,13225.0,16,34248,4,13225.0,105,13235.0,10,S
2018-04-27 14:46:49,13230.0,2,34250,-2,13225.0,105,13230.0,1,B
2018-04-27 14:46:50,13230.0,2,34252,0,13225.0,105,13235.0,11,B
2018-04-27 14:46:52,13225.0,2,34254,2,13225.0,105,13235.0,11,S
2018-04-27 14:46:52,13225.0,2,34256,2,13225.0,104,13235.0,11,S
2018-04-27 14:46:53,13225.0,2,34258,2,13230.0,1,13235.0,11,S
2018-04-27 14:46:53,13225.0,4,34262,2,13225.0,102,13235.0,11,S
2018-04-27 14:46:54,13225.0,2,34264,2,13225.0,101,13235.0,12,S
2018-04-27 14:46:56,13235.0,8,34272,-4,13235.0,1,13240.0,19,B
2018-04-27 14:46:57,13225.0,14,34286,6,13225.0,99,13230.0,1,S
2018-04-27 14:46:57,13230.0,2,34288,2,13230.0,2,13235.0,8,B
2018-04-27 14:46:58,13230.0,4,34292,4,13225.0,99,13230.0,1,B
2018-04-27 14:46:58,13230.0,6,34298,6,13230.0,6,13235.0,5,B
2018-04-27 14:46:59,13230.0,2,34300,0,13230.0,7,13235.0,4,B
2018-04-27 14:46:59,13230.0,2,34302,0,13230.0,2,13235.0,4,B
2018-04-27 14:47:00,13230.0,2,34304,2,13230.0,4,13235.0,3,B
2018-04-27 14:47:00,13230.0,2,34306,2,13230.0,4,13235.0,3,B
2018-04-27 14:47:02,13230.0,2,34308,2,13230.0,3,13235.0,5,B
2018-04-27 14:47:02,13230.0,2,34310,0,13230.0,3,13235.0,5,B
2018-04-27 14:47:06,13230.0,24,34334,2,13225.0,112,13240.0,20,B
2018-04-27 14:47:07,13230.0,2,34336,0,13230.0,7,13235.0,2,B
2018-04-27 14:47:08,13230.0,2,34338,2,13230.0,8,13235.0,2,B
2018-04-27 14:47:08,13230.0,2,34340,2,13230.0,7,13235.0,2,B
2018-04-27 14:47:09,13230.0,2,34342,2,13230.0,6,13235.0,2,B
2018-04-27 14:47:09,13230.0,2,34344,2,13230.0,7,13235.0,2,B
2018-04-27 14:47:10,13230.0,2,34346,2,13230.0,6,13235.0,2,B
2018-04-27 14:47:10,13230.0,2,34348,2,13230.0,5,13235.0,2,B
2018-04-27 14:47:11,13230.0,2,34350,2,13230.0,5,13235.0,4,B
2018-04-27 14:47:18,13230.0,18,34368,0,13225.0,112,13230.0,1,B
2018-04-27 14:47:18,13230.0,6,34374,6,13230.0,2,13235.0,22,B
2018-04-27 14:47:19,13230.0,2,34376,2,13230.0,1,13235.0,14,B
2018-04-27 14:47:19,13230.0,2,34378,2,13225.0,113,13235.0,19,B
2018-04-27 14:47:20,13230.0,2,34380,2,13230.0,2,13235.0,18,B
2018-04-27 14:47:21,13230.0,2,34382,2,13230.0,1,13235.0,18,B
2018-04-27 14:47:21,13230.0,2,34384,2,13225.0,113,13235.0,18,B
2018-04-27 14:47:26,13230.0,12,34396,-2,13230.0,1,13235.0,11,B
2018-04-27 14:47:27,13225.0,12,34408,10,13225.0,98,13235.0,11,S
2018-04-27 14:47:29,13235.0,20,34428,-8,13225.0,98,13235.0,4,B
2018-04-27 14:47:31,13230.0,2,34430,2,13230.0,3,13235.0,6,S
2018-04-27 14:47:32,13230.0,2,34432,2,13230.0,3,13235.0,5,S
2018-04-27 14:47:33,13230.0,2,34434,2,13230.0,3,13235.0,3,S
2018-04-27 14:47:34,13230.0,2,34436,2,13230.0,2,13235.0,3,S
2018-04-27 14:47:34,13225.0,2,34438,2,13225.0,97,13235.0,8,S
2018-04-27 14:47:39,13230.0,12,34450,-4,13230.0,2,13235.0,18,B
2018-04-27 14:47:39,13235.0,14,34464,4,13230.0,5,13235.0,3,B
2018-04-27 14:47:40,13235.0,4,34468,-2,13230.0,6,13235.0,1,B
2018-04-27 14:47:40,13230.0,2,34470,0,13230.0,5,13235.0,1,S
2018-04-27 14:47:42,13230.0,6,34476,6,13230.0,8,13235.0,1,S
2018-04-27 14:47:44,13230.0,4,34480,2,13230.0,8,13235.0,2,S
2018-04-27 14:47:47,13235.0,4,34484,-4,13230.0,11,13240.0,17,B
2018-04-27 14:47:48,13235.0,4,34488,0,13230.0,13,13235.0,2,B
2018-04-27 14:47:49,13235.0,4,34492,4,13235.0,3,13240.0,8,B
2018-04-27 14:47:49,13230.0,10,34502,2,13230.0,17,13245.0,9,S
2018-04-27 14:47:50,13245.0,2,34504,2,13235.0,2,13245.0,12,B
2018-04-27 14:47:50,13245.0,8,34512,4,13235.0,3,13245.0,10,B
2018-04-27 14:47:51,13235.0,2,34514,0,13235.0,3,13245.0,10,S
2018-04-27 14:47:52,13240.0,20,34534,16,13240.0,14,13250.0,2,B
2018-04-27 14:47:52,13250.0,6,34540,0,13245.0,4,13255.0,6,B
2018-04-27 14:47:53,13250.0,2,34542,2,13250.0,13,13255.0,6,B
2018-04-27 14:47:53,13250.0,2,34544,2,13250.0,22,13255.0,6,B
2018-04-27 14:47:54,13250.0,46,34590,28,13250.0,4,13255.0,6,B
2018-04-27 14:47:54,13250.0,12,34602,6,13250.0,11,13255.0,3,B
2018-04-27 14:47:55,13245.0,26,34628,16,13245.0,1,13250.0,5,S
2018-04-27 14:47:55,13245.0,12,34640,-8,13240.0,4,13250.0,2,S
2018-04-27 14:47:56,13240.0,2,34642,0,13240.0,4,13250.0,2,S
2018-04-27 14:47:57,13250.0,2,34644,-2,13240.0,4,13250.0,12,B
2018-04-27 14:47:57,13240.0,2,34646,0,13240.0,3,13250.0,12,S
2018-04-27 14:47:58,13240.0,2,34648,2,13240.0,2,13250.0,12,S
2018-04-27 14:47:58,13240.0,2,34650,2,13240.0,9,13250.0,11,S
2018-04-27 14:47:59,13240.0,2,34652,2,13245.0,1,13250.0,6,S
2018-04-27 14:47:59,13240.0,2,34654,2,13240.0,12,13250.0,9,S
2018-04-27 14:48:00,13240.0,2,34656,2,13240.0,11,13245.0,1,S
2018-04-27 14:48:00,13245.0,22,34678,-12,13245.0,1,13250.0,5,B
2018-04-27 14:48:01,13245.0,2,34680,2,13240.0,17,13250.0,6,B
2018-04-27 14:48:01,13240.0,2,34682,0,13240.0,16,13250.0,8,S
2018-04-27 14:48:02,13240.0,2,34684,2,13240.0,14,13245.0,2,S
2018-04-27 14:48:02,13240.0,2,34686,2,13240.0,15,13245.0,2,S
2018-04-27 14:48:03,13245.0,28,34714,-12,13245.0,1,13250.0,5,B
2018-04-27 14:48:03,13245.0,2,34716,2,13240.0,22,13250.0,6,B
2018-04-27 14:48:04,13245.0,2,34718,0,13245.0,1,13250.0,8,B
2018-04-27 14:48:04,13240.0,4,34722,0,13240.0,24,13250.0,8,S
2018-04-27 14:48:05,13240.0,2,34724,2,13240.0,22,13250.0,8,S
2018-04-27 14:48:05,13240.0,2,34726,2,13240.0,21,13245.0,6,S
2018-04-27 14:48:06,13245.0,14,34740,-8,13245.0,8,13250.0,1,B
2018-04-27 14:48:06,13245.0,2,34742,2,13245.0,5,13255.0,15,B
2018-04-27 14:48:07,13245.0,2,34744,2,13245.0,7,13250.0,3,B
2018-04-27 14:48:07,13245.0,2,34746,2,13245.0,6,13250.0,4,B
2018-04-27 14:48:08,13245.0,2,34748,2,13245.0,4,13250.0,4,B
2018-04-27 14:48:08,13245.0,2,34750,2,13245.0,3,13250.0,3,B
2018-04-27 14:48:09,13245.0,2,34752,2,13245.0,2,13250.0,6,B
2018-04-27 14:48:09,13250.0,4,34756,2,13245.0,1,13250.0,7,B
2018-04-27 14:48:10,13245.0,2,34758,2,13240.0,20,13250.0,3,S
2018-04-27 14:48:13,13240.0,4,34762,0,13240.0,14,13245.0,1,S
2018-04-27 14:48:16,13245.0,12,34774,-6,13245.0,2,13250.0,13,B
2018-04-27 14:48:17,13245.0,2,34776,2,13245.0,2,13250.0,9,B
2018-04-27 14:48:18,13250.0,4,34780,-4,13245.0,3,13255.0,14,B
2018-04-27 14:48:19,13250.0,4,34784,-2,13245.0,13,13255.0,12,B
2018-04-27 14:48:20,13255.0,2,34786,0,13245.0,16,13255.0,10,B
2018-04-27 14:48:20,13245.0,2,34788,2,13245.0,15,13255.0,12,S
2018-04-27 14:48:21,13255.0,12,34800,0,13245.0,13,13255.0,8,B
2018-04-27 14:48:22,13250.0,2,34802,0,13250.0,1,13255.0,8,S
2018-04-27 14:48:23,13260.0,10,34812,-6,13250.0,1,13260.0,10,B
2018-04-27 14:48:24,13260.0,2,34814,0,13250.0,4,13260.0,11,B
2018-04-27 14:48:27,13255.0,2,34816,2,13250.0,5,13255.0,5,S
2018-04-27 14:48:28,13250.0,10,34826,-8,13245.0,14,13250.0,2,S
2018-04-27 14:48:31,13250.0,2,34828,-2,13245.0,3,13250.0,3,S
2018-04-27 14:48:32,13255.0,20,34848,-14,13245.0,4,13255.0,12,B
2018-04-27 14:48:34,13250.0,2,34850,0,13245.0,10,13255.0,12,S
2018-04-27 14:48:35,13255.0,14,34864,-2,13255.0,3,13260.0,14,B
2018-04-27 14:48:36,13250.0,8,34872,-6,13250.0,1,13255.0,9,S
2018-04-27 14:48:36,13255.0,4,34876,0,13250.0,1,13255.0,7,B
2018-04-27 14:48:39,13255.0,2,34878,2,13250.0,76,13255.0,6,B
2018-04-27 14:48:42,13255.0,70,34948,-32,13250.0,42,13255.0,18,B
2018-04-27 14:48:42,13250.0,20,34968,-18,13250.0,32,13255.0,20,S
2018-04-27 14:48:43,13255.0,68,35036,-52,13245.0,11,13255.0,19,B
2018-04-27 14:48:43,13245.0,2,35038,0,13245.0,10,13250.0,2,S
2018-04-27 14:48:46,13250.0,2,35040,0,13245.0,7,13250.0,5,B
2018-04-27 14:48:46,13250.0,2,35042,0,13245.0,7,13250.0,1,B
2018-04-27 14:48:47,13250.0,2,35044,-2,13245.0,7,13255.0,15,B
2018-04-27 14:48:49,13250.0,4,35048,-2,13245.0,7,13250.0,4,B
2018-04-27 14:48:51,13250.0,2,35050,0,13245.0,7,13250.0,3,B
2018-04-27 14:48:53,13250.0,6,35056,0,13250.0,2,13255.0,14,B
2018-04-27 14:48:55,13255.0,4,35060,0,13250.0,12,13255.0,1,B
2018-04-27 14:48:56,13250.0,2,35062,0,13250.0,11,13255.0,2,S
2018-04-27 14:48:57,13255.0,6,35068,0,13250.0,7,13255.0,12,B
2018-04-27 14:48:58,13250.0,16,35084,-10,13245.0,13,13250.0,7,S
2018-04-27 14:49:03,13250.0,14,35098,0,13250.0,13,13255.0,15,S
2018-04-27 14:49:03,13250.0,2,35100,2,13250.0,17,13255.0,15,S
2018-04-27 14:49:06,13255.0,4,35104,0,13250.0,17,13255.0,8,B
2018-04-27 14:49:07,13250.0,2,35106,0,13250.0,16,13255.0,9,S
2018-04-27 14:49:07,13255.0,2,35108,0,13250.0,16,13255.0,9,B
2018-04-27 14:49:10,13250.0,2,35110,0,13250.0,15,13255.0,9,S
2018-04-27 14:49:14,13250.0,2,35112,2,13250.0,14,13255.0,9,S
2018-04-27 14:49:15,13250.0,2,35114,2,13250.0,13,13255.0,9,S
2018-04-27 14:49:16,13250.0,4,35118,4,13250.0,11,13255.0,9,S
2018-04-27 14:49:20,13255.0,4,35122,0,13250.0,10,13255.0,8,B
2018-04-27 14:49:21,13250.0,6,35128,6,13250.0,7,13255.0,8,S
2018-04-27 14:49:22,13250.0,14,35142,12,13245.0,36,13250.0,13,S
2018-04-27 14:49:22,13245.0,2,35144,2,13245.0,29,13250.0,11,S
2018-04-27 14:49:23,13250.0,2,35146,2,13245.0,29,13250.0,10,B
2018-04-27 14:49:31,13245.0,2,35148,0,13245.0,26,13250.0,9,S
2018-04-27 14:49:37,13250.0,4,35152,4,13245.0,25,13250.0,8,B
2018-04-27 14:49:42,13245.0,2,35154,-2,13245.0,24,13250.0,11,S
2018-04-27 14:49:45,13250.0,2,35156,0,13245.0,24,13250.0,10,B
2018-04-27 14:49:50,13245.0,2,35158,0,13245.0,23,13250.0,10,S
2018-04-27 14:49:52,13250.0,18,35176,2,13250.0,3,13255.0,21,B
2018-04-27 14:49:53,13245.0,8,35184,6,13245.0,22,13250.0,3,S
2018-04-27 14:49:54,13245.0,16,35200,8,13245.0,14,13250.0,14,S
2018-04-27 14:49:55,13250.0,8,35208,0,13245.0,14,13250.0,12,B
2018-04-27 14:49:57,13250.0,4,35212,2,13245.0,18,13255.0,18,B
2018-04-27 14:49:58,13250.0,2,35214,0,13250.0,7,13255.0,8,B
2018-04-27 14:49:58,13250.0,4,35218,-2,13250.0,5,13255.0,8,B
2018-04-27 14:50:00,13250.0,2,35220,0,13250.0,5,13255.0,8,B
2018-04-27 14:50:04,13250.0,2,35222,0,13250.0,4,13255.0,8,B
2018-04-27 14:50:05,13250.0,2,35224,0,13250.0,3,13255.0,9,B
2018-04-27 14:50:06,13250.0,2,35226,0,13250.0,2,13255.0,9,B
2018-04-27 14:50:06,13250.0,4,35230,-2,13245.0,25,13255.0,9,B
2018-04-27 14:50:15,13245.0,2,35232,2,13245.0,24,13255.0,14,S
2018-04-27 14:50:18,13245.0,2,35234,2,13245.0,23,13255.0,16,S
2018-04-27 14:50:19,13245.0,2,35236,2,13245.0,22,13250.0,2,S
2018-04-27 14:50:19,13245.0,2,35238,2,13245.0,16,13250.0,6,S
2018-04-27 14:50:20,13245.0,2,35240,2,13245.0,13,13250.0,8,S
2018-04-27 14:50:20,13250.0,4,35244,4,13245.0,8,13250.0,7,B
2018-04-27 14:50:22,13245.0,2,35246,2,13245.0,13,13250.0,2,S
2018-04-27 14:50:22,13245.0,2,35248,2,13245.0,12,13250.0,2,S
2018-04-27 14:50:23,13245.0,2,35250,2,13245.0,11,13250.0,2,S
2018-04-27 14:50:24,13245.0,2,35252,2,13245.0,12,13250.0,4,S
2018-04-27 14:50:25,13245.0,2,35254,2,13245.0,5,13250.0,5,S
2018-04-27 14:50:26,13245.0,2,35256,2,13245.0,4,13250.0,5,S
2018-04-27 14:50:26,13245.0,2,35258,0,13245.0,3,13250.0,8,S
2018-04-27 14:50:27,13245.0,2,35260,0,13245.0,2,13250.0,8,S
2018-04-27 14:50:27,13245.0,2,35262,2,13240.0,36,13250.0,8,S
2018-04-27 14:50:28,13245.0,2,35264,0,13245.0,8,13250.0,2,S
2018-04-27 14:50:29,13245.0,2,35266,2,13245.0,7,13250.0,2,S
2018-04-27 14:50:38,13245.0,2,35268,0,13245.0,6,13250.0,5,S
2018-04-27 14:50:38,13250.0,10,35278,-4,13245.0,6,13255.0,24,B
2018-04-27 14:50:39,13250.0,4,35282,-4,13250.0,3,13255.0,24,B
2018-04-27 14:50:39,13245.0,8,35290,-6,13245.0,7,13250.0,2,S
2018-04-27 14:50:41,13250.0,2,35292,0,13250.0,4,13255.0,24,B
2018-04-27 14:50:41,13250.0,2,35294,0,13250.0,8,13255.0,25,B
2018-04-27 14:50:42,13250.0,2,35296,0,13250.0,13,13255.0,24,B
2018-04-27 14:50:42,13250.0,14,35310,0,13250.0,6,13255.0,24,B
2018-04-27 14:50:43,13250.0,6,35316,0,13250.0,3,13255.0,24,B
2018-04-27 14:50:43,13250.0,2,35318,0,13250.0,2,13255.0,19,B
2018-04-27 14:50:44,13250.0,2,35320,0,13250.0,1,13255.0,19,B
2018-04-27 14:50:44,13250.0,2,35322,2,13245.0,12,13255.0,20,B
2018-04-27 14:50:46,13250.0,2,35324,0,13250.0,3,13255.0,19,B
2018-04-27 14:50:47,13250.0,2,35326,0,13250.0,2,13255.0,19,B
2018-04-27 14:50:47,13250.0,2,35328,0,13250.0,1,13255.0,19,B
2018-04-27 14:50:48,13250.0,2,35330,0,13245.0,12,13255.0,19,B
2018-04-27 14:50:52,13245.0,2,35332,2,13245.0,11,13255.0,20,S
2018-04-27 14:50:53,13245.0,2,35334,2,13245.0,10,13255.0,21,S
2018-04-27 14:50:55,13250.0,2,35336,0,13250.0,18,13255.0,15,B
2018-04-27 14:50:55,13250.0,4,35340,0,13250.0,23,13255.0,14,B
2018-04-27 14:50:56,13255.0,2,35342,0,13250.0,23,13255.0,13,B
2018-04-27 14:51:02,13250.0,2,35344,2,13250.0,19,13255.0,13,S
2018-04-27 14:51:09,13250.0,2,35346,2,13250.0,10,13255.0,12,S
2018-04-27 14:51:11,13250.0,2,35348,-2,13250.0,9,13255.0,12,S
2018-04-27 14:51:13,13250.0,2,35350,-2,13250.0,5,13255.0,12,S
2018-04-27 14:51:14,13255.0,2,35352,2,13250.0,5,13255.0,11,B
2018-04-27 14:51:14,13255.0,8,35360,0,13250.0,5,13255.0,17,B
2018-04-27 14:51:15,13250.0,2,35362,-2,13250.0,4,13255.0,17,S
2018-04-27 14:51:23,13250.0,2,35364,0,13250.0,3,13255.0,18,S
2018-04-27 14:51:26,13250.0,2,35366,0,13250.0,2,13255.0,18,S
2018-04-27 14:51:29,13250.0,2,35368,2,13250.0,1,13255.0,18,S
2018-04-27 14:51:36,13250.0,4,35372,4,13250.0,1,13255.0,18,S
2018-04-27 14:51:44,13250.0,2,35374,2,13250.0,3,13255.0,16,S
2018-04-27 14:51:46,13250.0,2,35376,2,13250.0,2,13255.0,15,S
2018-04-27 14:51:47,13250.0,2,35378,2,13250.0,1,13255.0,15,S
2018-04-27 14:51:52,13250.0,2,35380,2,13250.0,1,13255.0,15,S
2018-04-27 14:51:59,13255.0,6,35386,-6,13250.0,3,13255.0,11,B
2018-04-27 14:52:01,13250.0,2,35388,0,13250.0,5,13255.0,11,S
2018-04-27 14:52:03,13255.0,2,35390,0,13250.0,7,13255.0,10,B
2018-04-27 14:52:04,13255.0,20,35410,6,13255.0,3,13260.0,16,B
2018-04-27 14:52:04,13255.0,2,35412,0,13255.0,8,13260.0,16,B
2018-04-27 14:52:05,13255.0,2,35414,0,13255.0,7,13260.0,16,B
2018-04-27 14:52:08,13260.0,20,35434,-10,13260.0,4,13265.0,8,B
2018-04-27 14:52:08,13260.0,2,35436,2,13260.0,6,13265.0,8,B
2018-04-27 14:52:09,13260.0,2,35438,2,13260.0,5,13265.0,8,B
2018-04-27 14:52:10,13260.0,12,35450,-2,13255.0,11,13265.0,8,B
2018-04-27 14:52:13,13260.0,6,35456,-6,13255.0,10,13265.0,17,B
2018-04-27 14:52:15,13265.0,4,35460,-2,13260.0,11,13265.0,9,B
2018-04-27 14:52:18,13265.0,20,35480,-8,13265.0,6,13270.0,15,B
2018-04-27 14:52:19,13270.0,20,35500,-6,13265.0,9,13275.0,11,B
2018-04-27 14:52:20,13275.0,6,35506,0,13270.0,2,13275.0,8,B
2018-04-27 14:52:21,13275.0,6,35512,4,13270.0,2,13275.0,5,B
2018-04-27 14:52:23,13270.0,4,35516,0,13265.0,15,13275.0,17,S
2018-04-27 14:52:26,13270.0,4,35520,-4,13265.0,16,13275.0,7,S
2018-04-27 14:52:27,13275.0,2,35522,-2,13265.0,15,13275.0,14,B
2018-04-27 14:52:28,13275.0,2,35524,-2,13265.0,9,13275.0,14,B
2018-04-27 14:52:36,13270.0,2,35526,0,13265.0,9,13270.0,6,S
2018-04-27 14:52:39,13265.0,16,35542,6,13260.0,6,13265.0,16,S
2018-04-27 14:52:39,13260.0,6,35548,0,13255.0,13,13265.0,21,S
2018-04-27 14:52:41,13260.0,2,35550,-2,13255.0,18,13265.0,18,S
2018-04-27 14:52:48,13260.0,4,35554,-2,13255.0,19,13265.0,7,S
2018-04-27 14:52:52,13260.0,2,35556,0,13255.0,19,13265.0,14,S
2018-04-27 14:52:58,13265.0,2,35558,0,13260.0,15,13265.0,5,B
2018-04-27 14:52:59,13265.0,2,35560,-2,13260.0,16,13265.0,4,B
2018-04-27 14:52:59,13265.0,4,35564,-2,13260.0,16,13265.0,2,B
2018-04-27 14:53:00,13265.0,4,35568,0,13260.0,16,13265.0,1,B
2018-04-27 14:53:00,13265.0,2,35570,0,13265.0,12,13270.0,12,B
2018-04-27 14:53:03,13270.0,10,35580,10,13265.0,22,13270.0,2,B
2018-04-27 14:53:05,13270.0,4,35584,-2,13265.0,22,13270.0,2,B
2018-04-27 14:53:06,13270.0,4,35588,-4,13265.0,22,13275.0,14,B
2018-04-27 14:53:08,13265.0,2,35590,-2,13265.0,16,13270.0,16,S
2018-04-27 14:53:08,13265.0,8,35598,-2,13265.0,13,13270.0,16,S
2018-04-27 14:53:09,13265.0,26,35624,-4,13260.0,12,13270.0,16,S
2018-04-27 14:53:11,13270.0,12,35636,8,13260.0,12,13270.0,12,B
2018-04-27 14:53:12,13270.0,2,35638,0,13265.0,1,13270.0,11,B
2018-04-27 14:53:13,13265.0,2,35640,-2,13260.0,12,13270.0,11,S
2018-04-27 14:53:20,13270.0,6,35646,4,13265.0,7,13270.0,2,B
2018-04-27 14:53:20,13270.0,4,35650,-2,13270.0,13,13275.0,12,B
2018-04-27 14:53:21,13270.0,8,35658,0,13270.0,6,13275.0,8,B
2018-04-27 14:53:23,13270.0,22,35680,0,13265.0,15,13275.0,8,B
2018-04-27 14:53:26,13270.0,4,35684,0,13265.0,3,13270.0,18,B
2018-04-27 14:53:30,13265.0,2,35686,0,13265.0,5,13270.0,16,S
2018-04-27 14:53:31,13270.0,16,35702,-4,13265.0,5,13270.0,8,B
2018-04-27 14:53:33,13265.0,2,35704,0,13265.0,5,13270.0,7,S
2018-04-27 14:53:35,13265.0,8,35712,0,13260.0,6,13265.0,4,S
2018-04-27 14:53:41,13265.0,6,35718,4,13260.0,6,13265.0,3,S
2018-04-27 14:53:48,13265.0,4,35722,0,13260.0,6,13265.0,2,S
2018-04-27 14:53:52,13265.0,6,35728,6,13265.0,3,13270.0,11,S
2018-04-27 14:53:52,13265.0,6,35734,-4,13260.0,8,13270.0,10,S
2018-04-27 14:53:56,13265.0,2,35736,2,13260.0,9,13265.0,2,S
2018-04-27 14:53:57,13265.0,2,35738,0,13260.0,9,13265.0,1,S
2018-04-27 14:53:59,13260.0,4,35742,-4,13260.0,7,13265.0,6,S
2018-04-27 14:54:01,13265.0,2,35744,2,13260.0,16,13265.0,2,B
2018-04-27 14:54:01,13265.0,4,35748,2,13265.0,14,13270.0,9,B
2018-04-27 14:54:07,13265.0,2,35750,-2,13265.0,12,13270.0,7,B
2018-04-27 14:54:09,13270.0,10,35760,4,13265.0,12,13270.0,3,B
2018-04-27 14:54:23,13270.0,4,35764,0,13270.0,3,13275.0,10,B
2018-04-27 14:54:24,13270.0,6,35770,4,13265.0,9,13270.0,2,B
2018-04-27 14:54:35,13270.0,16,35786,16,13265.0,9,13275.0,14,B
2018-04-27 14:54:40,13270.0,2,35788,-2,13270.0,9,13275.0,6,B
2018-04-27 14:54:44,13270.0,4,35792,-4,13270.0,5,13275.0,6,B
2018-04-27 14:54:52,13270.0,2,35794,0,13270.0,8,13275.0,6,B
2018-04-27 14:55:01,13275.0,12,35806,0,13275.0,3,13280.0,24,B
2018-04-27 14:55:01,13275.0,2,35808,0,13275.0,13,13280.0,22,B
2018-04-27 14:55:03,13275.0,8,35816,0,13275.0,9,13280.0,26,B
2018-04-27 14:55:03,13275.0,4,35820,2,13275.0,7,13280.0,26,B
2018-04-27 14:55:05,13275.0,6,35826,-2,13275.0,2,13280.0,26,B
2018-04-27 14:55:10,13280.0,20,35846,-4,13275.0,4,13280.0,16,B
2018-04-27 14:55:10,13280.0,8,35854,-8,13275.0,4,13280.0,14,B
2018-04-27 14:55:11,13280.0,8,35862,-8,13275.0,4,13280.0,10,B
2018-04-27 14:55:12,13275.0,6,35868,0,13275.0,1,13280.0,10,S
2018-04-27 14:55:12,13280.0,10,35878,0,13275.0,1,13280.0,5,B
2018-04-27 14:55:16,13280.0,2,35880,-2,13275.0,2,13280.0,7,B
2018-04-27 14:55:17,13280.0,2,35882,0,13275.0,2,13280.0,6,B
2018-04-27 14:55:19,13280.0,2,35884,-2,13275.0,4,13280.0,14,B
2018-04-27 14:55:21,13280.0,8,35892,-8,13275.0,5,13280.0,11,B
2018-04-27 14:55:24,13275.0,4,35896,-2,13275.0,4,13280.0,11,S
2018-04-27 14:55:25,13275.0,2,35898,0,13275.0,3,13280.0,11,S
2018-04-27 14:55:28,13275.0,2,35900,0,13275.0,2,13280.0,12,S
2018-04-27 14:55:30,13275.0,4,35904,2,13270.0,17,13280.0,12,S
2018-04-27 14:55:31,13275.0,2,35906,-2,13275.0,1,13280.0,12,S
2018-04-27 14:55:35,13275.0,2,35908,-2,13275.0,1,13280.0,12,S
2018-04-27 14:55:35,13275.0,2,35910,2,13275.0,2,13280.0,12,S
2018-04-27 14:55:38,13275.0,4,35914,0,13270.0,19,13280.0,12,S
2018-04-27 14:55:44,13275.0,2,35916,0,13270.0,12,13275.0,6,S
2018-04-27 14:55:56,13270.0,4,35920,0,13270.0,16,13275.0,15,S
2018-04-27 14:55:57,13275.0,2,35922,0,13270.0,16,13275.0,14,B
2018-04-27 14:56:02,13275.0,22,35944,-12,13275.0,11,13280.0,5,B
2018-04-27 14:56:03,13280.0,2,35946,0,13275.0,16,13280.0,3,B
2018-04-27 14:56:04,13280.0,6,35952,2,13280.0,1,13285.0,12,B
2018-04-27 14:56:04,13280.0,2,35954,0,13280.0,3,13285.0,13,B
2018-04-27 14:56:05,13280.0,4,35958,4,13280.0,2,13285.0,13,B
2018-04-27 14:56:05,13280.0,2,35960,0,13280.0,1,13285.0,18,B
2018-04-27 14:56:06,13280.0,2,35962,-2,13275.0,16,13285.0,18,B
2018-04-27 14:56:11,13280.0,6,35968,-6,13275.0,17,13280.0,3,B
2018-04-27 14:56:19,13275.0,16,35984,-14,13275.0,18,13285.0,18,S
2018-04-27 14:56:23,13280.0,2,35986,0,13280.0,10,13285.0,12,B
2018-04-27 14:56:25,13285.0,2,35988,2,13280.0,10,13285.0,11,B
2018-04-27 14:56:32,13285.0,2,35990,0,13280.0,9,13285.0,15,B
2018-04-27 14:56:42,13285.0,2,35992,2,13280.0,14,13285.0,9,B
2018-04-27 14:56:46,13285.0,4,35996,2,13280.0,14,13285.0,8,B
2018-04-27 14:56:47,13280.0,2,35998,0,13280.0,13,13285.0,8,S
2018-04-27 14:56:52,13280.0,2,36000,0,13280.0,10,13285.0,14,S
2018-04-27 14:56:54,13285.0,4,36004,0,13280.0,12,13285.0,13,B
2018-04-27 14:56:54,13285.0,8,36012,-2,13280.0,14,13285.0,7,B
2018-04-27 14:56:55,13285.0,14,36026,-2,13280.0,14,13290.0,21,B
2018-04-27 14:56:59,13290.0,20,36046,20,13280.0,14,13290.0,20,B
2018-04-27 14:57:00,13290.0,20,36066,-14,13280.0,12,13290.0,10,B
2018-04-27 14:57:01,13290.0,2,36068,0,13285.0,2,13290.0,7,B
2018-04-27 14:57:01,13295.0,16,36084,10,13285.0,3,13295.0,5,B
2018-04-27 14:57:04,13285.0,2,36086,0,13280.0,12,13285.0,2,S
2018-04-27 14:57:05,13290.0,6,36092,2,13280.0,12,13290.0,5,B
2018-04-27 14:57:05,13290.0,2,36094,0,13280.0,12,13290.0,5,B
2018-04-27 14:57:07,13285.0,2,36096,-2,13280.0,12,13290.0,13,S
2018-04-27 14:57:10,13285.0,2,36098,-2,13280.0,12,13290.0,13,S
2018-04-27 14:57:12,13285.0,2,36100,2,13280.0,12,13290.0,16,S
2018-04-27 14:57:13,13290.0,8,36108,-6,13280.0,10,13290.0,23,B
2018-04-27 14:57:14,13285.0,2,36110,2,13285.0,9,13290.0,23,S
2018-04-27 14:57:14,13285.0,22,36132,18,13280.0,12,13290.0,22,S
2018-04-27 14:57:18,13290.0,2,36134,-2,13280.0,12,13290.0,21,B
2018-04-27 14:57:20,13280.0,2,36136,-2,13280.0,22,13290.0,21,S
2018-04-27 14:57:24,13285.0,8,36144,-4,13280.0,22,13285.0,4,B
2018-04-27 14:57:24,13285.0,2,36146,0,13280.0,22,13285.0,3,B
2018-04-27 14:57:25,13285.0,6,36152,0,13280.0,22,13290.0,21,B
2018-04-27 14:57:29,13290.0,2,36154,-2,13285.0,3,13290.0,20,B
2018-04-27 14:57:32,13285.0,2,36156,-2,13285.0,6,13290.0,20,S
2018-04-27 14:57:36,13285.0,2,36158,2,13285.0,5,13290.0,15,S
2018-04-27 14:57:37,13290.0,14,36172,-2,13285.0,6,13290.0,8,B
2018-04-27 14:57:37,13290.0,14,36186,0,13285.0,12,13290.0,1,B
2018-04-27 14:57:38,13290.0,2,36188,-2,13285.0,23,13290.0,1,B
2018-04-27 14:57:39,13290.0,2,36190,0,13285.0,23,13295.0,11,B
2018-04-27 14:57:40,13290.0,2,36192,-2,13285.0,21,13290.0,1,B
2018-04-27 14:57:40,13290.0,2,36194,0,13285.0,20,13290.0,5,B
2018-04-27 14:57:42,13295.0,6,36200,-6,13285.0,15,13295.0,8,B
2018-04-27 14:57:43,13290.0,2,36202,0,13290.0,2,13295.0,8,S
2018-04-27 14:57:47,13290.0,2,36204,0,13290.0,3,13295.0,8,S
2018-04-27 14:57:48,13290.0,4,36208,2,13290.0,11,13295.0,8,S
2018-04-27 14:57:53,13295.0,18,36226,12,13290.0,3,13295.0,5,B
2018-04-27 14:58:00,13295.0,2,36228,-2,13290.0,6,13295.0,4,B
2018-04-27 14:58:00,13295.0,10,36238,-10,13290.0,7,13300.0,28,B
2018-04-27 14:58:01,13295.0,40,36278,-40,13295.0,12,13300.0,28,B
2018-04-27 14:58:03,13295.0,14,36292,-14,13295.0,8,13300.0,28,B
2018-04-27 14:58:05,13295.0,2,36294,-2,13295.0,7,13300.0,28,B
2018-04-27 14:58:06,13295.0,14,36308,-10,13290.0,12,13295.0,4,B
2018-04-27 14:58:06,13290.0,8,36316,0,13290.0,11,13295.0,2,S
2018-04-27 14:58:07,13295.0,4,36320,-2,13290.0,11,13300.0,30,B
2018-04-27 14:58:07,13295.0,44,36364,-44,13295.0,9,13300.0,30,B
2018-04-27 14:58:08,13295.0,18,36382,-10,13290.0,11,13300.0,32,B
2018-04-27 14:58:08,13295.0,24,36406,-24,13290.0,7,13295.0,20,B
2018-04-27 14:58:09,13290.0,4,36410,4,13285.0,15,13290.0,13,S
2018-04-27 14:58:10,13290.0,16,36426,-10,13285.0,15,13290.0,15,S
2018-04-27 14:58:11,13290.0,30,36456,0,13285.0,20,13295.0,5,S
2018-04-27 14:58:11,13290.0,14,36470,-12,13285.0,20,13290.0,1,S
2018-04-27 14:58:12,13290.0,2,36472,-2,13285.0,20,13295.0,2,S
2018-04-27 14:58:12,13290.0,8,36480,-4,13285.0,21,13295.0,4,S
2018-04-27 14:58:13,13290.0,2,36482,-2,13285.0,21,13290.0,3,S
2018-04-27 14:58:13,13285.0,2,36484,0,13285.0,20,13290.0,3,S
2018-04-27 14:58:14,13290.0,2,36486,-2,13285.0,20,13290.0,2,B
2018-04-27 14:58:17,13290.0,2,36488,-2,13285.0,18,13290.0,1,B
2018-04-27 14:58:18,13290.0,2,36490,0,13285.0,20,13295.0,7,B
2018-04-27 14:58:18,13290.0,2,36492,-2,13285.0,20,13290.0,5,B
2018-04-27 14:58:19,13290.0,2,36494,-2,13285.0,20,13290.0,4,B
2018-04-27 14:58:20,13290.0,6,36500,0,13285.0,20,13290.0,1,B
2018-04-27 14:58:21,13285.0,40,36540,-16,13280.0,20,13290.0,1,S
2018-04-27 14:58:26,13290.0,2,36542,0,13285.0,5,13295.0,7,B
2018-04-27 14:58:27,13290.0,2,36544,-2,13290.0,1,13295.0,7,B
2018-04-27 14:58:28,13295.0,2,36546,-2,13290.0,3,13295.0,3,B
2018-04-27 14:58:29,13295.0,2,36548,2,13290.0,3,13295.0,21,B
2018-04-27 14:58:30,13290.0,2,36550,0,13290.0,1,13295.0,23,S
2018-04-27 14:58:33,13290.0,2,36552,-2,13285.0,14,13290.0,20,S
2018-04-27 14:58:33,13290.0,4,36556,0,13285.0,14,13290.0,18,S
2018-04-27 14:58:34,13290.0,36,36592,-22,13285.0,14,13295.0,24,S
2018-04-27 14:58:34,13295.0,6,36598,0,13285.0,13,13295.0,23,B
2018-04-27 14:58:35,13295.0,2,36600,0,13290.0,3,13295.0,20,B
2018-04-27 14:58:40,13295.0,2,36602,-2,13290.0,16,13295.0,22,B
2018-04-27 14:58:43,13295.0,2,36604,0,13290.0,17,13295.0,21,B
2018-04-27 14:58:48,13295.0,2,36606,0,13290.0,15,13295.0,19,B
2018-04-27 14:58:49,13290.0,2,36608,0,13290.0,12,13295.0,19,S
2018-04-27 14:58:52,13295.0,2,36610,0,13290.0,12,13295.0,18,B
2018-04-27 14:58:54,13300.0,96,36706,46,13300.0,52,13305.0,2,B
2018-04-27 14:58:54,13300.0,96,36802,42,13300.0,4,13305.0,2,B
2018-04-27 14:58:55,13300.0,8,36810,0,13290.0,10,13300.0,6,B
2018-04-27 14:58:56,13290.0,8,36818,8,13290.0,8,13300.0,3,S
2018-04-27 14:58:57,13295.0,2,36820,-2,13290.0,8,13300.0,3,B
2018-04-27 14:58:59,13295.0,4,36824,2,13290.0,8,13295.0,1,B
2018-04-27 14:59:00,13290.0,4,36828,0,13290.0,6,13295.0,1,S
2018-04-27 14:59:00,13295.0,2,36830,0,13290.0,4,13295.0,1,B
2018-04-27 14:59:01,13300.0,4,36834,-4,13290.0,4,13300.0,7,B
2018-04-27 14:59:01,13290.0,8,36842,-2,13285.0,12,13295.0,2,S
2018-04-27 14:59:02,13285.0,4,36846,0,13285.0,10,13295.0,4,S
2018-04-27 14:59:06,13295.0,6,36852,2,13285.0,12,13295.0,1,B
2018-04-27 14:59:09,13290.0,2,36854,2,13290.0,1,13295.0,4,S
2018-04-27 14:59:09,13290.0,2,36856,-2,13285.0,12,13295.0,5,S
2018-04-27 14:59:11,13290.0,4,36860,0,13290.0,1,13295.0,4,S
2018-04-27 14:59:14,13290.0,2,36862,0,13285.0,12,13290.0,3,S
2018-04-27 14:59:15,13290.0,22,36884,-4,13280.0,30,13290.0,3,S
2018-04-27 14:59:16,13290.0,2,36886,-2,13285.0,1,13290.0,1,S
2018-04-27 14:59:17,13285.0,2,36888,-2,13280.0,30,13290.0,1,S
2018-04-27 14:59:19,13285.0,12,36900,-12,13280.0,30,13290.0,3,S
2018-04-27 14:59:20,13280.0,2,36902,0,13280.0,29,13290.0,3,S
2018-04-27 14:59:23,13285.0,2,36904,0,13280.0,29,13285.0,1,B
2018-04-27 14:59:24,13280.0,2,36906,2,13280.0,28,13285.0,1,S
2018-04-27 14:59:25,13285.0,2,36908,-2,13285.0,2,13290.0,7,B
2018-04-27 14:59:26,13285.0,2,36910,-2,13285.0,1,13290.0,7,B
2018-04-27 14:59:27,13285.0,2,36912,-2,13280.0,28,13290.0,9,B
2018-04-27 14:59:29,13285.0,2,36914,-2,13280.0,24,13290.0,9,B
2018-04-27 14:59:30,13290.0,12,36926,-8,13280.0,24,13290.0,3,B
2018-04-27 14:59:31,13285.0,2,36928,-2,13280.0,24,13290.0,3,S
2018-04-27 14:59:32,13290.0,2,36930,-2,13280.0,24,13290.0,3,B
2018-04-27 14:59:33,13285.0,10,36940,0,13280.0,19,13290.0,4,S
2018-04-27 14:59:33,13280.0,24,36964,-16,13280.0,7,13290.0,4,S
2018-04-27 14:59:34,13290.0,2,36966,-2,13280.0,7,13290.0,5,B
2018-04-27 14:59:35,13280.0,2,36968,-2,13280.0,6,13290.0,5,S
2018-04-27 14:59:36,13290.0,2,36970,0,13280.0,6,13290.0,4,B
2018-04-27 14:59:41,13290.0,12,36982,-8,13285.0,1,13295.0,6,B
2018-04-27 14:59:44,13295.0,10,36992,-8,13290.0,2,13295.0,1,B
2018-04-27 14:59:45,13295.0,2,36994,-2,13290.0,2,13300.0,6,B
2018-04-27 14:59:47,13290.0,4,36998,2,13290.0,1,13295.0,4,S
2018-04-27 14:59:47,13300.0,10,37008,-2,13290.0,1,13300.0,5,B
2018-04-27 14:59:48,13290.0,2,37010,0,13285.0,2,13290.0,4,S
2018-04-27 14:59:49,13285.0,4,37014,0,13280.0,7,13290.0,4,S
2018-04-27 14:59:49,13295.0,10,37024,-4,13280.0,7,13300.0,6,B
2018-04-27 14:59:51,13300.0,10,37034,-4,13285.0,2,13305.0,4,B
2018-04-27 14:59:52,13305.0,6,37040,-4,13285.0,2,13300.0,1,B
2018-04-27 14:59:52,13280.0,14,37054,0,13280.0,3,13300.0,6,S
2018-04-27 14:59:54,13285.0,2,37056,-2,13280.0,3,13300.0,6,B
2018-04-27 14:59:55,13280.0,6,37062,4,13275.0,4,13280.0,7,S
2018-04-27 14:59:56,13280.0,10,37072,0,13275.0,4,13280.0,2,S
2018-04-27 14:59:56,13280.0,2,37074,0,13275.0,3,13280.0,1,S
2018-04-27 14:59:57,13280.0,2,37076,2,13275.0,3,13295.0,1,S
